"filename", "language", "Python", "XML", "Markdown", "YAML", "JSON", "comment", "blank", "total"
"d:\IDEWORK\lvmen\README.md", "Markdown", 0, 0, 5, 0, 0, 0, 7, 12
"d:\IDEWORK\lvmen\lvmen.iml", "XML", 0, 11, 0, 0, 0, 0, 0, 11
"d:\IDEWORK\lvmen\setup.py", "Python", 119, 0, 0, 0, 0, 6, 25, 150
"d:\IDEWORK\lvmen\src\__init__.py", "Python", 0, 0, 0, 0, 0, 0, 1, 1
"d:\IDEWORK\lvmen\src\cluecode\__init__.py", "Python", 0, 0, 0, 0, 0, 0, 1, 1
"d:\IDEWORK\lvmen\src\cluecode\copyrights.py", "Python", 2265, 0, 0, 0, 0, 604, 685, 3554
"d:\IDEWORK\lvmen\src\cluecode\copyrights_hint.py", "Python", 100, 0, 0, 0, 0, 37, 10, 147
"d:\IDEWORK\lvmen\src\cluecode\finder.py", "Python", 428, 0, 0, 0, 0, 26, 114, 568
"d:\IDEWORK\lvmen\src\cluecode\finder_data.py", "Python", 218, 0, 0, 0, 0, 10, 22, 250
"d:\IDEWORK\lvmen\src\data\Ngram_keywords.json", "JSON", 0, 0, 0, 0, 1, 0, 0, 1
"d:\IDEWORK\lvmen\src\fossagents\__init__.py", "Python", 0, 0, 0, 0, 0, 0, 1, 1
"d:\IDEWORK\lvmen\src\fossagents\atarashiAgent.py", "Python", 63, 0, 0, 0, 0, 2, 18, 83
"d:\IDEWORK\lvmen\src\fossagents\cosineSimNgram.py", "Python", 197, 0, 0, 0, 0, 8, 34, 239
"d:\IDEWORK\lvmen\src\fossagents\dameruLevenDist.py", "Python", 113, 0, 0, 0, 0, 13, 24, 150
"d:\IDEWORK\lvmen\src\fossagents\tfidf.py", "Python", 161, 0, 0, 0, 0, 5, 36, 202
"d:\IDEWORK\lvmen\src\fossagents\wordFrequencySimilarity.py", "Python", 139, 0, 0, 0, 0, 18, 24, 181
"d:\IDEWORK\lvmen\src\fossscan\__init__.py", "Python", 0, 0, 0, 0, 0, 0, 1, 1
"d:\IDEWORK\lvmen\src\fossscan\atarashii.py", "Python", 171, 0, 0, 0, 0, 20, 30, 221
"d:\IDEWORK\lvmen\src\fossscan\build_deps.py", "Python", 56, 0, 0, 0, 0, 2, 15, 73
"d:\IDEWORK\lvmen\src\fossscan\imtihaan.py", "Python", 75, 0, 0, 0, 0, 2, 12, 89
"d:\IDEWORK\lvmen\src\libs\__init__.py", "Python", 0, 0, 0, 0, 0, 0, 1, 1
"d:\IDEWORK\lvmen\src\libs\commentPreprocessor.py", "Python", 140, 0, 0, 0, 0, 6, 33, 179
"d:\IDEWORK\lvmen\src\libs\initialmatch.py", "Python", 115, 0, 0, 0, 0, 6, 22, 143
"d:\IDEWORK\lvmen\src\libs\license_clustering.py", "Python", 111, 0, 0, 0, 0, 4, 22, 137
"d:\IDEWORK\lvmen\src\libs\ngram.py", "Python", 133, 0, 0, 0, 0, 3, 35, 171
"d:\IDEWORK\lvmen\src\libs\utils.py", "Python", 52, 0, 0, 0, 0, 2, 16, 70
"d:\IDEWORK\lvmen\src\license\__init__.py", "Python", 0, 0, 0, 0, 0, 0, 1, 1
"d:\IDEWORK\lvmen\src\license\licenseDownloader.py", "Python", 152, 0, 0, 0, 0, 4, 26, 182
"d:\IDEWORK\lvmen\src\license\licenseLoader.py", "Python", 28, 0, 0, 0, 0, 2, 10, 40
"d:\IDEWORK\lvmen\src\license\licensePreprocessor.py", "Python", 95, 0, 0, 0, 0, 2, 21, 118
"d:\IDEWORK\lvmen\src\license\license_merger.py", "Python", 109, 0, 0, 0, 0, 5, 23, 137
"d:\IDEWORK\lvmen\src\licensedcode\__init__.py", "Python", 4, 0, 0, 0, 0, 13, 8, 25
"d:\IDEWORK\lvmen\src\licensedcode\cache.py", "Python", 266, 0, 0, 0, 0, 28, 72, 366
"d:\IDEWORK\lvmen\src\licensedcode\data\licenses\ blender 2.77 features .yml", "YAML", 0, 0, 0, 5, 0, 0, 1, 6
"d:\IDEWORK\lvmen\src\licensedcode\data\licenses\ cc-by-acidburn0 .yml", "YAML", 0, 0, 0, 5, 0, 0, 1, 6
"d:\IDEWORK\lvmen\src\licensedcode\data\licenses\389-exception.yml", "YAML", 0, 0, 0, 42, 0, 0, 1, 43
"d:\IDEWORK\lvmen\src\licensedcode\data\licenses\3com-microcode.yml", "YAML", 0, 0, 0, 7, 0, 0, 1, 8
"d:\IDEWORK\lvmen\src\licensedcode\data\licenses\3dslicer-1.0.yml", "YAML", 0, 0, 0, 15, 0, 0, 1, 16
"d:\IDEWORK\lvmen\src\licensedcode\data\licenses\4k video downloader eula.yml", "YAML", 0, 0, 0, 5, 0, 0, 1, 6
"d:\IDEWORK\lvmen\src\licensedcode\data\licenses\4suite-1.1.yml", "YAML", 0, 0, 0, 18, 0, 0, 1, 19
"d:\IDEWORK\lvmen\src\licensedcode\data\licenses\996-icu-1.0.yml", "YAML", 0, 0, 0, 10, 0, 0, 1, 11
"d:\IDEWORK\lvmen\src\licensedcode\data\licenses\abrms.yml", "YAML", 0, 0, 0, 7, 0, 0, 1, 8
"d:\IDEWORK\lvmen\src\licensedcode\data\licenses\abstyles.yml", "YAML", 0, 0, 0, 9, 0, 0, 1, 10
"d:\IDEWORK\lvmen\src\licensedcode\data\licenses\ac3filter.yml", "YAML", 0, 0, 0, 17, 0, 0, 1, 18
"d:\IDEWORK\lvmen\src\licensedcode\data\licenses\accellera-systemc.yml", "YAML", 0, 0, 0, 21, 0, 0, 1, 22
"d:\IDEWORK\lvmen\src\licensedcode\data\licenses\acdl-1.0.yml", "YAML", 0, 0, 0, 23, 0, 0, 1, 24
"d:\IDEWORK\lvmen\src\licensedcode\data\licenses\ace-tao.yml", "YAML", 0, 0, 0, 21, 0, 0, 1, 22
"d:\IDEWORK\lvmen\src\licensedcode\data\licenses\acroname-bdk.yml", "YAML", 0, 0, 0, 15, 0, 0, 0, 15
"d:\IDEWORK\lvmen\src\licensedcode\data\licenses\activestate-community-2012.yml", "YAML", 0, 0, 0, 17, 0, 0, 1, 18
"d:\IDEWORK\lvmen\src\licensedcode\data\licenses\activestate-community.yml", "YAML", 0, 0, 0, 16, 0, 0, 1, 17
"d:\IDEWORK\lvmen\src\licensedcode\data\licenses\activestate-komodo-edit.yml", "YAML", 0, 0, 0, 13, 0, 0, 1, 14
"d:\IDEWORK\lvmen\src\licensedcode\data\licenses\actuate-birt-ihub-ftype-sla.yml", "YAML", 0, 0, 0, 13, 0, 0, 1, 14
"d:\IDEWORK\lvmen\src\licensedcode\data\licenses\ada-linking-exception.yml", "YAML", 0, 0, 0, 10, 0, 0, 1, 11
"d:\IDEWORK\lvmen\src\licensedcode\data\licenses\adapt-1.0.yml", "YAML", 0, 0, 0, 16, 0, 0, 1, 17
"d:\IDEWORK\lvmen\src\licensedcode\data\licenses\adaptec-downloadable.yml", "YAML", 0, 0, 0, 9, 0, 0, 1, 10
"d:\IDEWORK\lvmen\src\licensedcode\data\licenses\adaptec-eula.yml", "YAML", 0, 0, 0, 7, 0, 0, 1, 8
"d:\IDEWORK\lvmen\src\licensedcode\data\licenses\addthis-mobile-sdk-1.0.yml", "YAML", 0, 0, 0, 14, 0, 0, 1, 15
"d:\IDEWORK\lvmen\src\licensedcode\data\licenses\adi-bsd.yml", "YAML", 0, 0, 0, 19, 0, 0, 1, 20
"d:\IDEWORK\lvmen\src\licensedcode\data\licenses\adobe-acrobat-reader-eula.yml", "YAML", 0, 0, 0, 10, 0, 0, 1, 11
"d:\IDEWORK\lvmen\src\licensedcode\data\licenses\adobe-air-sdk-2014.yml", "YAML", 0, 0, 0, 16, 0, 0, 1, 17
"d:\IDEWORK\lvmen\src\licensedcode\data\licenses\adobe-air-sdk.yml", "YAML", 0, 0, 0, 15, 0, 0, 1, 16
"d:\IDEWORK\lvmen\src\licensedcode\data\licenses\adobe-dng-sdk.yml", "YAML", 0, 0, 0, 12, 0, 0, 1, 13
"d:\IDEWORK\lvmen\src\licensedcode\data\licenses\adobe-eula.yml", "YAML", 0, 0, 0, 13, 0, 0, 1, 14
"d:\IDEWORK\lvmen\src\licensedcode\data\licenses\adobe-flash-player-eula-21.0.yml", "YAML", 0, 0, 0, 26, 0, 0, 1, 27
"d:\IDEWORK\lvmen\src\licensedcode\data\licenses\adobe-flex-4-sdk.yml", "YAML", 0, 0, 0, 14, 0, 0, 1, 15
"d:\IDEWORK\lvmen\src\licensedcode\data\licenses\adobe-flex-sdk.yml", "YAML", 0, 0, 0, 9, 0, 0, 1, 10
"d:\IDEWORK\lvmen\src\licensedcode\data\licenses\adobe-general-tou.yml", "YAML", 0, 0, 0, 21, 0, 0, 1, 22
"d:\IDEWORK\lvmen\src\licensedcode\data\licenses\adobe-glyph.yml", "YAML", 0, 0, 0, 8, 0, 0, 1, 9
"d:\IDEWORK\lvmen\src\licensedcode\data\licenses\adobe-indesign-sdk.yml", "YAML", 0, 0, 0, 10, 0, 0, 1, 11
"d:\IDEWORK\lvmen\src\licensedcode\data\licenses\adobe-postscript.yml", "YAML", 0, 0, 0, 7, 0, 0, 1, 8
"d:\IDEWORK\lvmen\src\licensedcode\data\licenses\adobe-scl.yml", "YAML", 0, 0, 0, 12, 0, 0, 1, 13
"d:\IDEWORK\lvmen\src\licensedcode\data\licenses\adrian.yml", "YAML", 0, 0, 0, 10, 0, 0, 1, 11
"d:\IDEWORK\lvmen\src\licensedcode\data\licenses\adsl.yml", "YAML", 0, 0, 0, 8, 0, 0, 1, 9
"d:\IDEWORK\lvmen\src\licensedcode\data\licenses\aes-128-3.0.yml", "YAML", 0, 0, 0, 7, 0, 0, 1, 8
"d:\IDEWORK\lvmen\src\licensedcode\data\licenses\afl-1.1.yml", "YAML", 0, 0, 0, 23, 0, 0, 1, 24
"d:\IDEWORK\lvmen\src\licensedcode\data\licenses\afl-1.2.yml", "YAML", 0, 0, 0, 22, 0, 0, 1, 23
"d:\IDEWORK\lvmen\src\licensedcode\data\licenses\afl-2.0.yml", "YAML", 0, 0, 0, 15, 0, 0, 1, 16
"d:\IDEWORK\lvmen\src\licensedcode\data\licenses\afl-2.1.yml", "YAML", 0, 0, 0, 20, 0, 0, 1, 21
"d:\IDEWORK\lvmen\src\licensedcode\data\licenses\afl-3.0.yml", "YAML", 0, 0, 0, 23, 0, 0, 1, 24
"d:\IDEWORK\lvmen\src\licensedcode\data\licenses\afmparse.yml", "YAML", 0, 0, 0, 8, 0, 0, 1, 9
"d:\IDEWORK\lvmen\src\licensedcode\data\licenses\afpl-8.0.yml", "YAML", 0, 0, 0, 16, 0, 0, 1, 17
"d:\IDEWORK\lvmen\src\licensedcode\data\licenses\afpl-9.0.yml", "YAML", 0, 0, 0, 14, 0, 0, 1, 15
"d:\IDEWORK\lvmen\src\licensedcode\data\licenses\agate license.yml", "YAML", 0, 0, 0, 5, 0, 0, 1, 6
"d:\IDEWORK\lvmen\src\licensedcode\data\licenses\agentxpp.yml", "YAML", 0, 0, 0, 9, 0, 0, 1, 10
"d:\IDEWORK\lvmen\src\licensedcode\data\licenses\agere-bsd.yml", "YAML", 0, 0, 0, 26, 0, 0, 1, 27
"d:\IDEWORK\lvmen\src\licensedcode\data\licenses\agere-sla.yml", "YAML", 0, 0, 0, 9, 0, 0, 1, 10
"d:\IDEWORK\lvmen\src\licensedcode\data\licenses\agpl-1.0-plus.yml", "YAML", 0, 0, 0, 27, 0, 0, 2, 29
"d:\IDEWORK\lvmen\src\licensedcode\data\licenses\agpl-1.0.yml", "YAML", 0, 0, 0, 22, 0, 0, 1, 23
"d:\IDEWORK\lvmen\src\licensedcode\data\licenses\agpl-2.0.yml", "YAML", 0, 0, 0, 14, 0, 0, 1, 15
"d:\IDEWORK\lvmen\src\licensedcode\data\licenses\agpl-3.0-bacula.yml", "YAML", 0, 0, 0, 10, 0, 0, 1, 11
"d:\IDEWORK\lvmen\src\licensedcode\data\licenses\agpl-3.0-linking-exception.yml", "YAML", 0, 0, 0, 9, 0, 0, 0, 9
"d:\IDEWORK\lvmen\src\licensedcode\data\licenses\agpl-3.0-openssl.yml", "YAML", 0, 0, 0, 8, 0, 0, 0, 8
"d:\IDEWORK\lvmen\src\licensedcode\data\licenses\agpl-3.0-plus.yml", "YAML", 0, 0, 0, 32, 0, 0, 1, 33
"d:\IDEWORK\lvmen\src\licensedcode\data\licenses\agpl-3.0.yml", "YAML", 0, 0, 0, 31, 0, 0, 1, 32
"d:\IDEWORK\lvmen\src\licensedcode\data\licenses\agpl-generic-additional-terms.yml", "YAML", 0, 0, 0, 9, 0, 0, 1, 10
"d:\IDEWORK\lvmen\src\licensedcode\data\licenses\air software eula.yml", "YAML", 0, 0, 0, 5, 0, 0, 1, 6
"d:\IDEWORK\lvmen\src\licensedcode\data\licenses\aladdin-md5.yml", "YAML", 0, 0, 0, 7, 0, 0, 1, 8
"d:\IDEWORK\lvmen\src\licensedcode\data\licenses\alasir.yml", "YAML", 0, 0, 0, 7, 0, 0, 1, 8
"d:\IDEWORK\lvmen\src\licensedcode\data\licenses\alexisisaac-freeware.yml", "YAML", 0, 0, 0, 9, 0, 0, 1, 10
"d:\IDEWORK\lvmen\src\licensedcode\data\licenses\alfresco-exception-0.5.yml", "YAML", 0, 0, 0, 11, 0, 0, 1, 12
"d:\IDEWORK\lvmen\src\licensedcode\data\licenses\all rights served.yml", "YAML", 0, 0, 0, 5, 0, 0, 1, 6
"d:\IDEWORK\lvmen\src\licensedcode\data\licenses\allegro-4.yml", "YAML", 0, 0, 0, 13, 0, 0, 1, 14
"d:\IDEWORK\lvmen\src\licensedcode\data\licenses\altermime.yml", "YAML", 0, 0, 0, 15, 0, 0, 1, 16
"d:\IDEWORK\lvmen\src\licensedcode\data\licenses\altova-eula.yml", "YAML", 0, 0, 0, 16, 0, 0, 1, 17
"d:\IDEWORK\lvmen\src\licensedcode\data\licenses\amazon web services.yml", "YAML", 0, 0, 0, 5, 0, 0, 1, 6
"d:\IDEWORK\lvmen\src\licensedcode\data\licenses\amazon-redshift-jdbc.yml", "YAML", 0, 0, 0, 7, 0, 0, 1, 8
"d:\IDEWORK\lvmen\src\licensedcode\data\licenses\amazon-sl.yml", "YAML", 0, 0, 0, 14, 0, 0, 1, 15
"d:\IDEWORK\lvmen\src\licensedcode\data\licenses\amd-historical.yml", "YAML", 0, 0, 0, 7, 0, 0, 1, 8
"d:\IDEWORK\lvmen\src\licensedcode\data\licenses\amd-linux-firmware-export.yml", "YAML", 0, 0, 0, 11, 0, 0, 1, 12
"d:\IDEWORK\lvmen\src\licensedcode\data\licenses\amd-linux-firmware.yml", "YAML", 0, 0, 0, 7, 0, 0, 1, 8
"d:\IDEWORK\lvmen\src\licensedcode\data\licenses\amdplpa.yml", "YAML", 0, 0, 0, 8, 0, 0, 1, 9
"d:\IDEWORK\lvmen\src\licensedcode\data\licenses\aml.yml", "YAML", 0, 0, 0, 8, 0, 0, 1, 9
"d:\IDEWORK\lvmen\src\licensedcode\data\licenses\amlogic-linux-firmware.yml", "YAML", 0, 0, 0, 7, 0, 0, 1, 8
"d:\IDEWORK\lvmen\src\licensedcode\data\licenses\ampas.yml", "YAML", 0, 0, 0, 10, 0, 0, 1, 11
"d:\IDEWORK\lvmen\src\licensedcode\data\licenses\ams-fonts.yml", "YAML", 0, 0, 0, 9, 0, 0, 1, 10
"d:\IDEWORK\lvmen\src\licensedcode\data\licenses\android-sdk-2009.yml", "YAML", 0, 0, 0, 7, 0, 0, 1, 8
"d:\IDEWORK\lvmen\src\licensedcode\data\licenses\android-sdk-2012.yml", "YAML", 0, 0, 0, 9, 0, 0, 1, 10
"d:\IDEWORK\lvmen\src\licensedcode\data\licenses\android-sdk-license.yml", "YAML", 0, 0, 0, 10, 0, 0, 1, 11
"d:\IDEWORK\lvmen\src\licensedcode\data\licenses\android-sdk-preview-2015.yml", "YAML", 0, 0, 0, 10, 0, 0, 1, 11
"d:\IDEWORK\lvmen\src\licensedcode\data\licenses\anepokis-1.0.yml", "YAML", 0, 0, 0, 17, 0, 0, 1, 18
"d:\IDEWORK\lvmen\src\licensedcode\data\licenses\animacion.yml", "YAML", 0, 0, 0, 5, 0, 0, 1, 6
"d:\IDEWORK\lvmen\src\licensedcode\data\licenses\anti-capitalist-1.4.yml", "YAML", 0, 0, 0, 7, 0, 0, 0, 7
"d:\IDEWORK\lvmen\src\licensedcode\data\licenses\antlr-pd-fallback.yml", "YAML", 0, 0, 0, 15, 0, 0, 1, 16
"d:\IDEWORK\lvmen\src\licensedcode\data\licenses\antlr-pd.yml", "YAML", 0, 0, 0, 21, 0, 0, 1, 22
"d:\IDEWORK\lvmen\src\licensedcode\data\licenses\anu-license.yml", "YAML", 0, 0, 0, 9, 0, 0, 1, 10
"d:\IDEWORK\lvmen\src\licensedcode\data\licenses\aop-pd.yml", "YAML", 0, 0, 0, 6, 0, 0, 1, 7
"d:\IDEWORK\lvmen\src\licensedcode\data\licenses\apache-1.0.yml", "YAML", 0, 0, 0, 18, 0, 0, 1, 19
"d:\IDEWORK\lvmen\src\licensedcode\data\licenses\apache-1.1.yml", "YAML", 0, 0, 0, 28, 0, 0, 1, 29
"d:\IDEWORK\lvmen\src\licensedcode\data\licenses\apache-2.0-linking-exception.yml", "YAML", 0, 0, 0, 8, 0, 0, 1, 9
"d:\IDEWORK\lvmen\src\licensedcode\data\licenses\apache-2.0-runtime-library-exception.yml", "YAML", 0, 0, 0, 10, 0, 0, 1, 11
"d:\IDEWORK\lvmen\src\licensedcode\data\licenses\apache-2.0.yml", "YAML", 0, 0, 0, 23, 0, 0, 1, 24
"d:\IDEWORK\lvmen\src\licensedcode\data\licenses\apache-due-credit.yml", "YAML", 0, 0, 0, 13, 0, 0, 1, 14
"d:\IDEWORK\lvmen\src\licensedcode\data\licenses\apache-exception-llvm.yml", "YAML", 0, 0, 0, 11, 0, 0, 1, 12
"d:\IDEWORK\lvmen\src\licensedcode\data\licenses\apache-patent-provision-exception.yml", "YAML", 0, 0, 0, 8, 0, 0, 1, 9
"d:\IDEWORK\lvmen\src\licensedcode\data\licenses\apafml.yml", "YAML", 0, 0, 0, 8, 0, 0, 1, 9
"d:\IDEWORK\lvmen\src\licensedcode\data\licenses\apl-1.1.yml", "YAML", 0, 0, 0, 15, 0, 0, 1, 16
"d:\IDEWORK\lvmen\src\licensedcode\data\licenses\aplicativo de gerenciamento de websites.yml", "YAML", 0, 0, 0, 5, 0, 0, 1, 6
"d:\IDEWORK\lvmen\src\licensedcode\data\licenses\apostilasobjetiva.yml", "YAML", 0, 0, 0, 5, 0, 0, 1, 6
"d:\IDEWORK\lvmen\src\licensedcode\data\licenses\appfire-eula.yml", "YAML", 0, 0, 0, 18, 0, 0, 1, 19
"d:\IDEWORK\lvmen\src\licensedcode\data\licenses\apple inc. xcode and apple sdks agreement.yml", "YAML", 0, 0, 0, 5, 0, 0, 1, 6
"d:\IDEWORK\lvmen\src\licensedcode\data\licenses\apple-attribution-1997.yml", "YAML", 0, 0, 0, 7, 0, 0, 1, 8
"d:\IDEWORK\lvmen\src\licensedcode\data\licenses\apple-attribution.yml", "YAML", 0, 0, 0, 7, 0, 0, 1, 8
"d:\IDEWORK\lvmen\src\licensedcode\data\licenses\apple-excl.yml", "YAML", 0, 0, 0, 6, 0, 0, 1, 7
"d:\IDEWORK\lvmen\src\licensedcode\data\licenses\apple-mfi-license.yml", "YAML", 0, 0, 0, 6, 0, 0, 1, 7
"d:\IDEWORK\lvmen\src\licensedcode\data\licenses\apple-mpeg-4.yml", "YAML", 0, 0, 0, 10, 0, 0, 1, 11
"d:\IDEWORK\lvmen\src\licensedcode\data\licenses\apple-runtime-library-exception.yml", "YAML", 0, 0, 0, 27, 0, 1, 1, 29
"d:\IDEWORK\lvmen\src\licensedcode\data\licenses\apple-sscl.yml", "YAML", 0, 0, 0, 6, 0, 0, 1, 7
"d:\IDEWORK\lvmen\src\licensedcode\data\licenses\appsflyer-framework.yml", "YAML", 0, 0, 0, 12, 0, 0, 1, 13
"d:\IDEWORK\lvmen\src\licensedcode\data\licenses\apsl-1.0.yml", "YAML", 0, 0, 0, 21, 0, 0, 1, 22
"d:\IDEWORK\lvmen\src\licensedcode\data\licenses\apsl-1.1.yml", "YAML", 0, 0, 0, 24, 0, 0, 1, 25
"d:\IDEWORK\lvmen\src\licensedcode\data\licenses\apsl-1.2.yml", "YAML", 0, 0, 0, 27, 0, 0, 1, 28
"d:\IDEWORK\lvmen\src\licensedcode\data\licenses\apsl-2.0.yml", "YAML", 0, 0, 0, 23, 0, 0, 1, 24
"d:\IDEWORK\lvmen\src\licensedcode\data\licenses\aptana-1.0.yml", "YAML", 0, 0, 0, 9, 0, 0, 1, 10
"d:\IDEWORK\lvmen\src\licensedcode\data\licenses\aptana-exception-3.0.yml", "YAML", 0, 0, 0, 84, 0, 0, 1, 85
"d:\IDEWORK\lvmen\src\licensedcode\data\licenses\aravindan-premkumar.yml", "YAML", 0, 0, 0, 8, 0, 0, 1, 9
"d:\IDEWORK\lvmen\src\licensedcode\data\licenses\argouml.yml", "YAML", 0, 0, 0, 12, 0, 0, 1, 13
"d:\IDEWORK\lvmen\src\licensedcode\data\licenses\arm-cortex-mx.yml", "YAML", 0, 0, 0, 8, 0, 0, 1, 9
"d:\IDEWORK\lvmen\src\licensedcode\data\licenses\arm-llvm-sga.yml", "YAML", 0, 0, 0, 9, 0, 0, 1, 10
"d:\IDEWORK\lvmen\src\licensedcode\data\licenses\armel-cross-toolchain-base.yml", "YAML", 0, 0, 0, 5, 0, 0, 1, 6
"d:\IDEWORK\lvmen\src\licensedcode\data\licenses\arphic-public.yml", "YAML", 0, 0, 0, 9, 0, 0, 1, 10
"d:\IDEWORK\lvmen\src\licensedcode\data\licenses\array-input-method-pl.yml", "YAML", 0, 0, 0, 14, 0, 0, 2, 16
"d:\IDEWORK\lvmen\src\licensedcode\data\licenses\artistic-1.0-cl8.yml", "YAML", 0, 0, 0, 19, 0, 0, 1, 20
"d:\IDEWORK\lvmen\src\licensedcode\data\licenses\artistic-1.0.yml", "YAML", 0, 0, 0, 20, 0, 0, 1, 21
"d:\IDEWORK\lvmen\src\licensedcode\data\licenses\artistic-2.0.yml", "YAML", 0, 0, 0, 28, 0, 0, 1, 29
"d:\IDEWORK\lvmen\src\licensedcode\data\licenses\artistic-clarified.yml", "YAML", 0, 0, 0, 12, 0, 0, 1, 13
"d:\IDEWORK\lvmen\src\licensedcode\data\licenses\artistic-dist-1.0.yml", "YAML", 0, 0, 0, 15, 0, 0, 1, 16
"d:\IDEWORK\lvmen\src\licensedcode\data\licenses\artistic-perl-1.0.yml", "YAML", 0, 0, 0, 14, 0, 0, 1, 15
"d:\IDEWORK\lvmen\src\licensedcode\data\licenses\aslp.yml", "YAML", 0, 0, 0, 7, 0, 0, 1, 8
"d:\IDEWORK\lvmen\src\licensedcode\data\licenses\aslr.yml", "YAML", 0, 0, 0, 7, 0, 0, 1, 8
"d:\IDEWORK\lvmen\src\licensedcode\data\licenses\asmus.yml", "YAML", 0, 0, 0, 8, 0, 0, 1, 9
"d:\IDEWORK\lvmen\src\licensedcode\data\licenses\asn1.yml", "YAML", 0, 0, 0, 30, 0, 0, 1, 31
"d:\IDEWORK\lvmen\src\licensedcode\data\licenses\ati-eula.yml", "YAML", 0, 0, 0, 9, 0, 0, 1, 10
"d:\IDEWORK\lvmen\src\licensedcode\data\licenses\atkinson-hyperlegible-font.yml", "YAML", 0, 0, 0, 11, 0, 0, 1, 12
"d:\IDEWORK\lvmen\src\licensedcode\data\licenses\atlassian customer agreement.yml", "YAML", 0, 0, 0, 5, 0, 0, 1, 6
"d:\IDEWORK\lvmen\src\licensedcode\data\licenses\atlassian-marketplace-tou.yml", "YAML", 0, 0, 0, 12, 0, 0, 1, 13
"d:\IDEWORK\lvmen\src\licensedcode\data\licenses\atmel-firmware.yml", "YAML", 0, 0, 0, 7, 0, 0, 1, 8
"d:\IDEWORK\lvmen\src\licensedcode\data\licenses\atmel-linux-firmware.yml", "YAML", 0, 0, 0, 7, 0, 0, 1, 8
"d:\IDEWORK\lvmen\src\licensedcode\data\licenses\atmel-microcontroller.yml", "YAML", 0, 0, 0, 7, 0, 0, 1, 8
"d:\IDEWORK\lvmen\src\licensedcode\data\licenses\atmosphere-0.4.yml", "YAML", 0, 0, 0, 7, 0, 0, 1, 8
"d:\IDEWORK\lvmen\src\licensedcode\data\licenses\attribution.yml", "YAML", 0, 0, 0, 17, 0, 0, 1, 18
"d:\IDEWORK\lvmen\src\licensedcode\data\licenses\autoconf-exception-2.0.yml", "YAML", 0, 0, 0, 28, 0, 0, 1, 29
"d:\IDEWORK\lvmen\src\licensedcode\data\licenses\autoconf-exception-3.0.yml", "YAML", 0, 0, 0, 61, 0, 0, 1, 62
"d:\IDEWORK\lvmen\src\licensedcode\data\licenses\autoconf-macro-exception.yml", "YAML", 0, 0, 0, 11, 0, 0, 1, 12
"d:\IDEWORK\lvmen\src\licensedcode\data\licenses\autoconf-simple-exception-2.0.yml", "YAML", 0, 0, 0, 9, 0, 0, 1, 10
"d:\IDEWORK\lvmen\src\licensedcode\data\licenses\autoconf-simple-exception.yml", "YAML", 0, 0, 0, 11, 0, 0, 1, 12
"d:\IDEWORK\lvmen\src\licensedcode\data\licenses\autoit-eula.yml", "YAML", 0, 0, 0, 11, 0, 0, 1, 12
"d:\IDEWORK\lvmen\src\licensedcode\data\licenses\autoopts-exception-2.0.yml", "YAML", 0, 0, 0, 40, 0, 0, 1, 41
"d:\IDEWORK\lvmen\src\licensedcode\data\licenses\avisynth-c-interface-exception.yml", "YAML", 0, 0, 0, 8, 0, 0, 1, 9
"d:\IDEWORK\lvmen\src\licensedcode\data\licenses\avisynth-linking-exception.yml", "YAML", 0, 0, 0, 8, 0, 0, 1, 9
"d:\IDEWORK\lvmen\src\licensedcode\data\licenses\bacula-exception.yml", "YAML", 0, 0, 0, 15, 0, 0, 2, 17
"d:\IDEWORK\lvmen\src\licensedcode\data\licenses\baekmuk-fonts.yml", "YAML", 0, 0, 0, 10, 0, 0, 1, 11
"d:\IDEWORK\lvmen\src\licensedcode\data\licenses\bahyph.yml", "YAML", 0, 0, 0, 14, 0, 0, 1, 15
"d:\IDEWORK\lvmen\src\licensedcode\data\licenses\bakoma-fonts-1995.yml", "YAML", 0, 0, 0, 19, 0, 0, 1, 20
"d:\IDEWORK\lvmen\src\licensedcode\data\licenses\bapl-1.0.yml", "YAML", 0, 0, 0, 11, 0, 0, 1, 12
"d:\IDEWORK\lvmen\src\licensedcode\data\licenses\barr-tex.yml", "YAML", 0, 0, 0, 10, 0, 0, 1, 11
"d:\IDEWORK\lvmen\src\licensedcode\data\licenses\bash-exception-gpl.yml", "YAML", 0, 0, 0, 10, 0, 0, 1, 11
"d:\IDEWORK\lvmen\src\licensedcode\data\licenses\bea-2.1.yml", "YAML", 0, 0, 0, 10, 0, 0, 1, 11
"d:\IDEWORK\lvmen\src\licensedcode\data\licenses\beal-screamer.yml", "YAML", 0, 0, 0, 9, 0, 0, 1, 10
"d:\IDEWORK\lvmen\src\licensedcode\data\licenses\beerware.yml", "YAML", 0, 0, 0, 15, 0, 0, 1, 16
"d:\IDEWORK\lvmen\src\licensedcode\data\licenses\bigdigits.yml", "YAML", 0, 0, 0, 27, 0, 0, 1, 28
"d:\IDEWORK\lvmen\src\licensedcode\data\licenses\bigelow-holmes.yml", "YAML", 0, 0, 0, 15, 0, 0, 1, 16
"d:\IDEWORK\lvmen\src\licensedcode\data\licenses\binary-linux-firmware-patent.yml", "YAML", 0, 0, 0, 9, 0, 0, 1, 10
"d:\IDEWORK\lvmen\src\licensedcode\data\licenses\binary-linux-firmware.yml", "YAML", 0, 0, 0, 7, 0, 0, 1, 8
"d:\IDEWORK\lvmen\src\licensedcode\data\licenses\biopython.yml", "YAML", 0, 0, 0, 7, 0, 0, 1, 8
"d:\IDEWORK\lvmen\src\licensedcode\data\licenses\biosl-4.0.yml", "YAML", 0, 0, 0, 19, 0, 0, 1, 20
"d:\IDEWORK\lvmen\src\licensedcode\data\licenses\bison-exception-2.0.yml", "YAML", 0, 0, 0, 24, 0, 0, 1, 25
"d:\IDEWORK\lvmen\src\licensedcode\data\licenses\bison-exception-2.2.yml", "YAML", 0, 0, 0, 34, 0, 0, 1, 35
"d:\IDEWORK\lvmen\src\licensedcode\data\licenses\bitstream.yml", "YAML", 0, 0, 0, 10, 0, 0, 2, 12
"d:\IDEWORK\lvmen\src\licensedcode\data\licenses\bittorrent-1.0.yml", "YAML", 0, 0, 0, 16, 0, 0, 1, 17
"d:\IDEWORK\lvmen\src\licensedcode\data\licenses\bittorrent-1.1.yml", "YAML", 0, 0, 0, 18, 0, 0, 1, 19
"d:\IDEWORK\lvmen\src\licensedcode\data\licenses\bittorrent-1.2.yml", "YAML", 0, 0, 0, 9, 0, 0, 1, 10
"d:\IDEWORK\lvmen\src\licensedcode\data\licenses\bittorrent-eula.yml", "YAML", 0, 0, 0, 12, 0, 0, 1, 13
"d:\IDEWORK\lvmen\src\licensedcode\data\licenses\bitwarden-1.0.yml", "YAML", 0, 0, 0, 8, 0, 0, 1, 9
"d:\IDEWORK\lvmen\src\licensedcode\data\licenses\bitzi-pd.yml", "YAML", 0, 0, 0, 11, 0, 0, 1, 12
"d:\IDEWORK\lvmen\src\licensedcode\data\licenses\blas-2017.yml", "YAML", 0, 0, 0, 11, 0, 0, 1, 12
"d:\IDEWORK\lvmen\src\licensedcode\data\licenses\blessing.yml", "YAML", 0, 0, 0, 11, 0, 0, 1, 12
"d:\IDEWORK\lvmen\src\licensedcode\data\licenses\blitz-artistic.yml", "YAML", 0, 0, 0, 10, 0, 0, 1, 11
"d:\IDEWORK\lvmen\src\licensedcode\data\licenses\bloomberg-blpapi.yml", "YAML", 0, 0, 0, 9, 0, 0, 1, 10
"d:\IDEWORK\lvmen\src\licensedcode\data\licenses\blueoak-1.0.0.yml", "YAML", 0, 0, 0, 12, 0, 0, 1, 13
"d:\IDEWORK\lvmen\src\licensedcode\data\licenses\bohl-0.2.yml", "YAML", 0, 0, 0, 14, 0, 0, 1, 15
"d:\IDEWORK\lvmen\src\licensedcode\data\licenses\boost-1.0.yml", "YAML", 0, 0, 0, 18, 0, 0, 1, 19
"d:\IDEWORK\lvmen\src\licensedcode\data\licenses\boost-original.yml", "YAML", 0, 0, 0, 17, 0, 0, 1, 18
"d:\IDEWORK\lvmen\src\licensedcode\data\licenses\bootloader-exception.yml", "YAML", 0, 0, 0, 60, 0, 8, 1, 69
"d:\IDEWORK\lvmen\src\licensedcode\data\licenses\borceux.yml", "YAML", 0, 0, 0, 12, 0, 0, 1, 13
"d:\IDEWORK\lvmen\src\licensedcode\data\licenses\bpel4ws-spec.yml", "YAML", 0, 0, 0, 20, 0, 0, 1, 21
"d:\IDEWORK\lvmen\src\licensedcode\data\licenses\bpmn-io.yml", "YAML", 0, 0, 0, 9, 0, 0, 1, 10
"d:\IDEWORK\lvmen\src\licensedcode\data\licenses\brad-martinez-vb-32.yml", "YAML", 0, 0, 0, 7, 0, 0, 1, 8
"d:\IDEWORK\lvmen\src\licensedcode\data\licenses\brent-corkum.yml", "YAML", 0, 0, 0, 12, 0, 0, 1, 13
"d:\IDEWORK\lvmen\src\licensedcode\data\licenses\brian-clapper.yml", "YAML", 0, 0, 0, 11, 0, 0, 1, 12
"d:\IDEWORK\lvmen\src\licensedcode\data\licenses\brian-gladman-3-clause.yml", "YAML", 0, 0, 0, 6, 0, 0, 1, 7
"d:\IDEWORK\lvmen\src\licensedcode\data\licenses\brian-gladman-dual.yml", "YAML", 0, 0, 0, 23, 0, 0, 1, 24
"d:\IDEWORK\lvmen\src\licensedcode\data\licenses\brian-gladman.yml", "YAML", 0, 0, 0, 9, 0, 0, 1, 10
"d:\IDEWORK\lvmen\src\licensedcode\data\licenses\brl.yml", "YAML", 0, 0, 0, 5, 0, 0, 1, 6
"d:\IDEWORK\lvmen\src\licensedcode\data\licenses\broadcom-cfe.yml", "YAML", 0, 0, 0, 6, 0, 0, 1, 7
"d:\IDEWORK\lvmen\src\licensedcode\data\licenses\broadcom-commercial.yml", "YAML", 0, 0, 0, 6, 0, 0, 1, 7
"d:\IDEWORK\lvmen\src\licensedcode\data\licenses\broadcom-confidential.yml", "YAML", 0, 0, 0, 6, 0, 0, 1, 7
"d:\IDEWORK\lvmen\src\licensedcode\data\licenses\broadcom-dual.yml", "YAML", 0, 0, 0, 7, 0, 0, 1, 8
"d:\IDEWORK\lvmen\src\licensedcode\data\licenses\broadcom-linking-exception-2.0.yml", "YAML", 0, 0, 0, 26, 0, 0, 1, 27
"d:\IDEWORK\lvmen\src\licensedcode\data\licenses\broadcom-linking-unmodified.yml", "YAML", 0, 0, 0, 8, 0, 0, 1, 9
"d:\IDEWORK\lvmen\src\licensedcode\data\licenses\broadcom-linux-firmware.yml", "YAML", 0, 0, 0, 7, 0, 0, 1, 8
"d:\IDEWORK\lvmen\src\licensedcode\data\licenses\broadcom-linux-timer.yml", "YAML", 0, 0, 0, 10, 0, 0, 1, 11
"d:\IDEWORK\lvmen\src\licensedcode\data\licenses\broadcom-proprietary.yml", "YAML", 0, 0, 0, 6, 0, 0, 1, 7
"d:\IDEWORK\lvmen\src\licensedcode\data\licenses\broadcom-standard-terms.yml", "YAML", 0, 0, 0, 6, 0, 0, 1, 7
"d:\IDEWORK\lvmen\src\licensedcode\data\licenses\broadcom-unpublished-source.yml", "YAML", 0, 0, 0, 7, 0, 0, 1, 8
"d:\IDEWORK\lvmen\src\licensedcode\data\licenses\broadcom-wiced.yml", "YAML", 0, 0, 0, 8, 0, 0, 1, 9
"d:\IDEWORK\lvmen\src\licensedcode\data\licenses\broadleaf-fair-use.yml", "YAML", 0, 0, 0, 9, 0, 0, 1, 10
"d:\IDEWORK\lvmen\src\licensedcode\data\licenses\brocade-firmware.yml", "YAML", 0, 0, 0, 7, 0, 0, 1, 8
"d:\IDEWORK\lvmen\src\licensedcode\data\licenses\bruno-podetti.yml", "YAML", 0, 0, 0, 7, 0, 0, 1, 8
"d:\IDEWORK\lvmen\src\licensedcode\data\licenses\bsd-1-clause-build.yml", "YAML", 0, 0, 0, 7, 0, 0, 1, 8
"d:\IDEWORK\lvmen\src\licensedcode\data\licenses\bsd-1-clause.yml", "YAML", 0, 0, 0, 11, 0, 0, 1, 12
"d:\IDEWORK\lvmen\src\licensedcode\data\licenses\bsd-1988.yml", "YAML", 0, 0, 0, 10, 0, 0, 1, 11
"d:\IDEWORK\lvmen\src\licensedcode\data\licenses\bsd-2-clause-freebsd.yml", "YAML", 0, 0, 0, 18, 0, 0, 1, 19
"d:\IDEWORK\lvmen\src\licensedcode\data\licenses\bsd-2-clause-netbsd.yml", "YAML", 0, 0, 0, 15, 0, 0, 1, 16
"d:\IDEWORK\lvmen\src\licensedcode\data\licenses\bsd-2-clause-plus-advertizing.yml", "YAML", 0, 0, 0, 11, 0, 0, 1, 12
"d:\IDEWORK\lvmen\src\licensedcode\data\licenses\bsd-2-clause-views.yml", "YAML", 0, 0, 0, 18, 0, 0, 1, 19
"d:\IDEWORK\lvmen\src\licensedcode\data\licenses\bsd-3-clause-devine.yml", "YAML", 0, 0, 0, 9, 0, 0, 1, 10
"d:\IDEWORK\lvmen\src\licensedcode\data\licenses\bsd-3-clause-fda.yml", "YAML", 0, 0, 0, 8, 0, 0, 1, 9
"d:\IDEWORK\lvmen\src\licensedcode\data\licenses\bsd-3-clause-jtag.yml", "YAML", 0, 0, 0, 12, 0, 0, 1, 13
"d:\IDEWORK\lvmen\src\licensedcode\data\licenses\bsd-3-clause-no-change.yml", "YAML", 0, 0, 0, 10, 0, 0, 1, 11
"d:\IDEWORK\lvmen\src\licensedcode\data\licenses\bsd-3-clause-no-military.yml", "YAML", 0, 0, 0, 13, 0, 0, 1, 14
"d:\IDEWORK\lvmen\src\licensedcode\data\licenses\bsd-3-clause-no-nuclear-warranty.yml", "YAML", 0, 0, 0, 14, 0, 0, 1, 15
"d:\IDEWORK\lvmen\src\licensedcode\data\licenses\bsd-3-clause-no-trademark.yml", "YAML", 0, 0, 0, 11, 0, 0, 1, 12
"d:\IDEWORK\lvmen\src\licensedcode\data\licenses\bsd-3-clause-open-mpi.yml", "YAML", 0, 0, 0, 11, 0, 0, 1, 12
"d:\IDEWORK\lvmen\src\licensedcode\data\licenses\bsd-3-clause-sun.yml", "YAML", 0, 0, 0, 9, 0, 0, 1, 10
"d:\IDEWORK\lvmen\src\licensedcode\data\licenses\bsd-4-clause-shortened.yml", "YAML", 0, 0, 0, 11, 0, 0, 2, 13
"d:\IDEWORK\lvmen\src\licensedcode\data\licenses\bsd-ack-carrot2.yml", "YAML", 0, 0, 0, 10, 0, 0, 1, 11
"d:\IDEWORK\lvmen\src\licensedcode\data\licenses\bsd-ack.yml", "YAML", 0, 0, 0, 13, 0, 0, 1, 14
"d:\IDEWORK\lvmen\src\licensedcode\data\licenses\bsd-artwork.yml", "YAML", 0, 0, 0, 10, 0, 0, 1, 11
"d:\IDEWORK\lvmen\src\licensedcode\data\licenses\bsd-atmel.yml", "YAML", 0, 0, 0, 9, 0, 0, 1, 10
"d:\IDEWORK\lvmen\src\licensedcode\data\licenses\bsd-axis-nomod.yml", "YAML", 0, 0, 0, 10, 0, 0, 1, 11
"d:\IDEWORK\lvmen\src\licensedcode\data\licenses\bsd-axis.yml", "YAML", 0, 0, 0, 8, 0, 0, 1, 9
"d:\IDEWORK\lvmen\src\licensedcode\data\licenses\bsd-credit.yml", "YAML", 0, 0, 0, 6, 0, 0, 1, 7
"d:\IDEWORK\lvmen\src\licensedcode\data\licenses\bsd-dpt.yml", "YAML", 0, 0, 0, 7, 0, 0, 1, 8
"d:\IDEWORK\lvmen\src\licensedcode\data\licenses\bsd-export.yml", "YAML", 0, 0, 0, 8, 0, 0, 1, 9
"d:\IDEWORK\lvmen\src\licensedcode\data\licenses\bsd-innosys.yml", "YAML", 0, 0, 0, 13, 0, 0, 1, 14
"d:\IDEWORK\lvmen\src\licensedcode\data\licenses\bsd-intel.yml", "YAML", 0, 0, 0, 6, 0, 0, 0, 6
"d:\IDEWORK\lvmen\src\licensedcode\data\licenses\bsd-mylex.yml", "YAML", 0, 0, 0, 11, 0, 0, 1, 12
"d:\IDEWORK\lvmen\src\licensedcode\data\licenses\bsd-new-derivative.yml", "YAML", 0, 0, 0, 9, 0, 0, 1, 10
"d:\IDEWORK\lvmen\src\licensedcode\data\licenses\bsd-new-far-manager.yml", "YAML", 0, 0, 0, 7, 0, 0, 1, 8
"d:\IDEWORK\lvmen\src\licensedcode\data\licenses\bsd-new-nomod.yml", "YAML", 0, 0, 0, 9, 0, 0, 1, 10
"d:\IDEWORK\lvmen\src\licensedcode\data\licenses\bsd-new-tcpdump.yml", "YAML", 0, 0, 0, 7, 0, 0, 1, 8
"d:\IDEWORK\lvmen\src\licensedcode\data\licenses\bsd-new.yml", "YAML", 0, 0, 0, 16, 0, 0, 1, 17
"d:\IDEWORK\lvmen\src\licensedcode\data\licenses\bsd-no-disclaimer-unmodified.yml", "YAML", 0, 0, 0, 8, 0, 0, 1, 9
"d:\IDEWORK\lvmen\src\licensedcode\data\licenses\bsd-no-disclaimer.yml", "YAML", 0, 0, 0, 9, 0, 0, 1, 10
"d:\IDEWORK\lvmen\src\licensedcode\data\licenses\bsd-no-mod.yml", "YAML", 0, 0, 0, 9, 0, 0, 1, 10
"d:\IDEWORK\lvmen\src\licensedcode\data\licenses\bsd-original-muscle.yml", "YAML", 0, 0, 0, 14, 0, 0, 1, 15
"d:\IDEWORK\lvmen\src\licensedcode\data\licenses\bsd-original-uc-1986.yml", "YAML", 0, 0, 0, 6, 0, 0, 1, 7
"d:\IDEWORK\lvmen\src\licensedcode\data\licenses\bsd-original-uc-1990.yml", "YAML", 0, 0, 0, 7, 0, 0, 1, 8
"d:\IDEWORK\lvmen\src\licensedcode\data\licenses\bsd-original-uc.yml", "YAML", 0, 0, 0, 31, 0, 0, 1, 32
"d:\IDEWORK\lvmen\src\licensedcode\data\licenses\bsd-original-voices.yml", "YAML", 0, 0, 0, 10, 0, 0, 1, 11
"d:\IDEWORK\lvmen\src\licensedcode\data\licenses\bsd-original.yml", "YAML", 0, 0, 0, 16, 0, 0, 1, 17
"d:\IDEWORK\lvmen\src\licensedcode\data\licenses\bsd-plus-mod-notice.yml", "YAML", 0, 0, 0, 6, 0, 0, 1, 7
"d:\IDEWORK\lvmen\src\licensedcode\data\licenses\bsd-plus-patent.yml", "YAML", 0, 0, 0, 15, 0, 0, 1, 16
"d:\IDEWORK\lvmen\src\licensedcode\data\licenses\bsd-protection.yml", "YAML", 0, 0, 0, 10, 0, 0, 1, 11
"d:\IDEWORK\lvmen\src\licensedcode\data\licenses\bsd-simplified-darwin.yml", "YAML", 0, 0, 0, 6, 0, 0, 1, 7
"d:\IDEWORK\lvmen\src\licensedcode\data\licenses\bsd-simplified-intel.yml", "YAML", 0, 0, 0, 10, 0, 0, 1, 11
"d:\IDEWORK\lvmen\src\licensedcode\data\licenses\bsd-simplified-source.yml", "YAML", 0, 0, 0, 9, 0, 0, 1, 10
"d:\IDEWORK\lvmen\src\licensedcode\data\licenses\bsd-simplified.yml", "YAML", 0, 0, 0, 19, 0, 0, 1, 20
"d:\IDEWORK\lvmen\src\licensedcode\data\licenses\bsd-source-code.yml", "YAML", 0, 0, 0, 11, 0, 0, 1, 12
"d:\IDEWORK\lvmen\src\licensedcode\data\licenses\bsd-top-gpl-addition.yml", "YAML", 0, 0, 0, 8, 0, 0, 1, 9
"d:\IDEWORK\lvmen\src\licensedcode\data\licenses\bsd-top.yml", "YAML", 0, 0, 0, 10, 0, 0, 0, 10
"d:\IDEWORK\lvmen\src\licensedcode\data\licenses\bsd-unchanged.yml", "YAML", 0, 0, 0, 11, 0, 0, 1, 12
"d:\IDEWORK\lvmen\src\licensedcode\data\licenses\bsd-unmodified.yml", "YAML", 0, 0, 0, 10, 0, 0, 1, 11
"d:\IDEWORK\lvmen\src\licensedcode\data\licenses\bsd-x11.yml", "YAML", 0, 0, 0, 8, 0, 0, 1, 9
"d:\IDEWORK\lvmen\src\licensedcode\data\licenses\bsd-zero.yml", "YAML", 0, 0, 0, 9, 0, 0, 1, 10
"d:\IDEWORK\lvmen\src\licensedcode\data\licenses\bsl-1.0.yml", "YAML", 0, 0, 0, 17, 0, 0, 1, 18
"d:\IDEWORK\lvmen\src\licensedcode\data\licenses\bsl-1.1.yml", "YAML", 0, 0, 0, 18, 0, 0, 1, 19
"d:\IDEWORK\lvmen\src\licensedcode\data\licenses\bsla-no-advert.yml", "YAML", 0, 0, 0, 13, 0, 0, 1, 14
"d:\IDEWORK\lvmen\src\licensedcode\data\licenses\bsla.yml", "YAML", 0, 0, 0, 8, 0, 0, 1, 9
"d:\IDEWORK\lvmen\src\licensedcode\data\licenses\bugsense-sdk.yml", "YAML", 0, 0, 0, 15, 0, 0, 1, 16
"d:\IDEWORK\lvmen\src\licensedcode\data\licenses\bukitjs license.yml", "YAML", 0, 0, 0, 5, 0, 0, 1, 6
"d:\IDEWORK\lvmen\src\licensedcode\data\licenses\bytemark.yml", "YAML", 0, 0, 0, 6, 0, 0, 1, 7
"d:\IDEWORK\lvmen\src\licensedcode\data\licenses\bzip2-libbzip-1.0.5.yml", "YAML", 0, 0, 0, 11, 0, 0, 1, 12
"d:\IDEWORK\lvmen\src\licensedcode\data\licenses\bzip2-libbzip-2010.yml", "YAML", 0, 0, 0, 16, 0, 0, 1, 17
"d:\IDEWORK\lvmen\src\licensedcode\data\licenses\c-fsl-1.1.yml", "YAML", 0, 0, 0, 13, 0, 0, 1, 14
"d:\IDEWORK\lvmen\src\licensedcode\data\licenses\c-uda-1.0.yml", "YAML", 0, 0, 0, 10, 0, 0, 1, 11
"d:\IDEWORK\lvmen\src\licensedcode\data\licenses\ca-tosl-1.1.yml", "YAML", 0, 0, 0, 20, 0, 0, 1, 21
"d:\IDEWORK\lvmen\src\licensedcode\data\licenses\cadence-linux-firmware.yml", "YAML", 0, 0, 0, 7, 0, 0, 1, 8
"d:\IDEWORK\lvmen\src\licensedcode\data\licenses\cal-1.0-combined-work-exception.yml", "YAML", 0, 0, 0, 14, 0, 0, 1, 15
"d:\IDEWORK\lvmen\src\licensedcode\data\licenses\cal-1.0.yml", "YAML", 0, 0, 0, 16, 0, 0, 1, 17
"d:\IDEWORK\lvmen\src\licensedcode\data\licenses\caldera.yml", "YAML", 0, 0, 0, 12, 0, 0, 1, 13
"d:\IDEWORK\lvmen\src\licensedcode\data\licenses\can-ogl-2.0-en.yml", "YAML", 0, 0, 0, 10, 0, 0, 1, 11
"d:\IDEWORK\lvmen\src\licensedcode\data\licenses\can-ogl-alberta-2.1.yml", "YAML", 0, 0, 0, 7, 0, 0, 1, 8
"d:\IDEWORK\lvmen\src\licensedcode\data\licenses\can-ogl-british-columbia-2.0.yml", "YAML", 0, 0, 0, 7, 0, 0, 1, 8
"d:\IDEWORK\lvmen\src\licensedcode\data\licenses\can-ogl-nova-scotia-1.0.yml", "YAML", 0, 0, 0, 7, 0, 0, 1, 8
"d:\IDEWORK\lvmen\src\licensedcode\data\licenses\can-ogl-ontario-1.0.yml", "YAML", 0, 0, 0, 7, 0, 0, 1, 8
"d:\IDEWORK\lvmen\src\licensedcode\data\licenses\can-ogl-toronto-1.0.yml", "YAML", 0, 0, 0, 7, 0, 0, 1, 8
"d:\IDEWORK\lvmen\src\licensedcode\data\licenses\careware.yml", "YAML", 0, 0, 0, 7, 0, 0, 1, 8
"d:\IDEWORK\lvmen\src\licensedcode\data\licenses\carnegie-mellon-contributors.yml", "YAML", 0, 0, 0, 8, 0, 0, 1, 9
"d:\IDEWORK\lvmen\src\licensedcode\data\licenses\carnegie-mellon.yml", "YAML", 0, 0, 0, 6, 0, 0, 1, 7
"d:\IDEWORK\lvmen\src\licensedcode\data\licenses\cavium-linux-firmware.yml", "YAML", 0, 0, 0, 9, 0, 0, 1, 10
"d:\IDEWORK\lvmen\src\licensedcode\data\licenses\cavium-malloc.yml", "YAML", 0, 0, 0, 6, 0, 0, 1, 7
"d:\IDEWORK\lvmen\src\licensedcode\data\licenses\cavium-targeted-hardware.yml", "YAML", 0, 0, 0, 8, 0, 0, 1, 9
"d:\IDEWORK\lvmen\src\licensedcode\data\licenses\cc by-nc 2.0.yml", "YAML", 0, 0, 0, 5, 0, 0, 1, 6
"d:\IDEWORK\lvmen\src\licensedcode\data\licenses\cc by-nc 4.0.yml", "YAML", 0, 0, 0, 5, 0, 0, 1, 6
"d:\IDEWORK\lvmen\src\licensedcode\data\licenses\cc by-nc-sa 4.0.yml", "YAML", 0, 0, 0, 5, 0, 0, 1, 6
"d:\IDEWORK\lvmen\src\licensedcode\data\licenses\cc by-nd 4.0.yml", "YAML", 0, 0, 0, 5, 0, 0, 1, 6
"d:\IDEWORK\lvmen\src\licensedcode\data\licenses\cc by-sa 4.0.yml", "YAML", 0, 0, 0, 5, 0, 0, 1, 6
"d:\IDEWORK\lvmen\src\licensedcode\data\licenses\cc-by-1.0.yml", "YAML", 0, 0, 0, 14, 0, 0, 1, 15
"d:\IDEWORK\lvmen\src\licensedcode\data\licenses\cc-by-2.0-uk.yml", "YAML", 0, 0, 0, 15, 0, 0, 1, 16
"d:\IDEWORK\lvmen\src\licensedcode\data\licenses\cc-by-2.0.yml", "YAML", 0, 0, 0, 14, 0, 0, 1, 15
"d:\IDEWORK\lvmen\src\licensedcode\data\licenses\cc-by-2.5-au.yml", "YAML", 0, 0, 0, 11, 0, 0, 1, 12
"d:\IDEWORK\lvmen\src\licensedcode\data\licenses\cc-by-2.5.yml", "YAML", 0, 0, 0, 14, 0, 0, 1, 15
"d:\IDEWORK\lvmen\src\licensedcode\data\licenses\cc-by-3.0-at.yml", "YAML", 0, 0, 0, 5, 0, 0, 1, 6
"d:\IDEWORK\lvmen\src\licensedcode\data\licenses\cc-by-3.0-us.yml", "YAML", 0, 0, 0, 13, 0, 0, 1, 14
"d:\IDEWORK\lvmen\src\licensedcode\data\licenses\cc-by-3.0.yml", "YAML", 0, 0, 0, 15, 0, 0, 1, 16
"d:\IDEWORK\lvmen\src\licensedcode\data\licenses\cc-by-4.0.yml", "YAML", 0, 0, 0, 12, 0, 0, 1, 13
"d:\IDEWORK\lvmen\src\licensedcode\data\licenses\cc-by-nc-1.0.yml", "YAML", 0, 0, 0, 14, 0, 0, 1, 15
"d:\IDEWORK\lvmen\src\licensedcode\data\licenses\cc-by-nc-2.0.yml", "YAML", 0, 0, 0, 14, 0, 0, 1, 15
"d:\IDEWORK\lvmen\src\licensedcode\data\licenses\cc-by-nc-2.5.yml", "YAML", 0, 0, 0, 14, 0, 0, 1, 15
"d:\IDEWORK\lvmen\src\licensedcode\data\licenses\cc-by-nc-3.0.yml", "YAML", 0, 0, 0, 15, 0, 0, 1, 16
"d:\IDEWORK\lvmen\src\licensedcode\data\licenses\cc-by-nc-4.0.yml", "YAML", 0, 0, 0, 12, 0, 0, 1, 13
"d:\IDEWORK\lvmen\src\licensedcode\data\licenses\cc-by-nc-nd-1.0.yml", "YAML", 0, 0, 0, 15, 0, 0, 1, 16
"d:\IDEWORK\lvmen\src\licensedcode\data\licenses\cc-by-nc-nd-2.0-au.yml", "YAML", 0, 0, 0, 9, 0, 0, 1, 10
"d:\IDEWORK\lvmen\src\licensedcode\data\licenses\cc-by-nc-nd-2.0.yml", "YAML", 0, 0, 0, 14, 0, 0, 1, 15
"d:\IDEWORK\lvmen\src\licensedcode\data\licenses\cc-by-nc-nd-2.5.yml", "YAML", 0, 0, 0, 14, 0, 0, 1, 15
"d:\IDEWORK\lvmen\src\licensedcode\data\licenses\cc-by-nc-nd-3.0-igo.yml", "YAML", 0, 0, 0, 12, 0, 0, 2, 14
"d:\IDEWORK\lvmen\src\licensedcode\data\licenses\cc-by-nc-nd-3.0.yml", "YAML", 0, 0, 0, 14, 0, 0, 1, 15
"d:\IDEWORK\lvmen\src\licensedcode\data\licenses\cc-by-nc-nd-4.0.yml", "YAML", 0, 0, 0, 12, 0, 0, 1, 13
"d:\IDEWORK\lvmen\src\licensedcode\data\licenses\cc-by-nc-sa-1.0.yml", "YAML", 0, 0, 0, 14, 0, 0, 1, 15
"d:\IDEWORK\lvmen\src\licensedcode\data\licenses\cc-by-nc-sa-2.0-uk.yml", "YAML", 0, 0, 0, 11, 0, 0, 1, 12
"d:\IDEWORK\lvmen\src\licensedcode\data\licenses\cc-by-nc-sa-2.0.yml", "YAML", 0, 0, 0, 14, 0, 0, 1, 15
"d:\IDEWORK\lvmen\src\licensedcode\data\licenses\cc-by-nc-sa-2.5.yml", "YAML", 0, 0, 0, 14, 0, 0, 1, 15
"d:\IDEWORK\lvmen\src\licensedcode\data\licenses\cc-by-nc-sa-3.0-igo.yml", "YAML", 0, 0, 0, 13, 0, 0, 1, 14
"d:\IDEWORK\lvmen\src\licensedcode\data\licenses\cc-by-nc-sa-3.0-us.yml", "YAML", 0, 0, 0, 13, 0, 0, 1, 14
"d:\IDEWORK\lvmen\src\licensedcode\data\licenses\cc-by-nc-sa-3.0.yml", "YAML", 0, 0, 0, 14, 0, 0, 1, 15
"d:\IDEWORK\lvmen\src\licensedcode\data\licenses\cc-by-nc-sa-4.0.yml", "YAML", 0, 0, 0, 12, 0, 0, 1, 13
"d:\IDEWORK\lvmen\src\licensedcode\data\licenses\cc-by-nd-1.0.yml", "YAML", 0, 0, 0, 15, 0, 0, 1, 16
"d:\IDEWORK\lvmen\src\licensedcode\data\licenses\cc-by-nd-2.0.yml", "YAML", 0, 0, 0, 14, 0, 0, 1, 15
"d:\IDEWORK\lvmen\src\licensedcode\data\licenses\cc-by-nd-2.5.yml", "YAML", 0, 0, 0, 14, 0, 0, 1, 15
"d:\IDEWORK\lvmen\src\licensedcode\data\licenses\cc-by-nd-3.0.yml", "YAML", 0, 0, 0, 14, 0, 0, 1, 15
"d:\IDEWORK\lvmen\src\licensedcode\data\licenses\cc-by-nd-4.0.yml", "YAML", 0, 0, 0, 12, 0, 0, 1, 13
"d:\IDEWORK\lvmen\src\licensedcode\data\licenses\cc-by-sa-1.0.yml", "YAML", 0, 0, 0, 14, 0, 0, 1, 15
"d:\IDEWORK\lvmen\src\licensedcode\data\licenses\cc-by-sa-2.0-uk.yml", "YAML", 0, 0, 0, 13, 0, 0, 2, 15
"d:\IDEWORK\lvmen\src\licensedcode\data\licenses\cc-by-sa-2.0.yml", "YAML", 0, 0, 0, 14, 0, 0, 1, 15
"d:\IDEWORK\lvmen\src\licensedcode\data\licenses\cc-by-sa-2.1-jp.yml", "YAML", 0, 0, 0, 5, 0, 0, 1, 6
"d:\IDEWORK\lvmen\src\licensedcode\data\licenses\cc-by-sa-2.5.yml", "YAML", 0, 0, 0, 14, 0, 0, 1, 15
"d:\IDEWORK\lvmen\src\licensedcode\data\licenses\cc-by-sa-3.0-at.yml", "YAML", 0, 0, 0, 5, 0, 0, 1, 6
"d:\IDEWORK\lvmen\src\licensedcode\data\licenses\cc-by-sa-3.0.yml", "YAML", 0, 0, 0, 16, 0, 0, 1, 17
"d:\IDEWORK\lvmen\src\licensedcode\data\licenses\cc-by-sa-4.0.yml", "YAML", 0, 0, 0, 12, 0, 0, 1, 13
"d:\IDEWORK\lvmen\src\licensedcode\data\licenses\cc-devnations-2.0.yml", "YAML", 0, 0, 0, 7, 0, 0, 1, 8
"d:\IDEWORK\lvmen\src\licensedcode\data\licenses\cc-nc-nd.yml", "YAML", 0, 0, 0, 5, 0, 0, 1, 6
"d:\IDEWORK\lvmen\src\licensedcode\data\licenses\cc-nc-sa.yml", "YAML", 0, 0, 0, 5, 0, 0, 1, 6
"d:\IDEWORK\lvmen\src\licensedcode\data\licenses\cc-nc-sampling-plus-1.0.yml", "YAML", 0, 0, 0, 7, 0, 0, 1, 8
"d:\IDEWORK\lvmen\src\licensedcode\data\licenses\cc-pd.yml", "YAML", 0, 0, 0, 10, 0, 0, 1, 11
"d:\IDEWORK\lvmen\src\licensedcode\data\licenses\cc-pdm-1.0.yml", "YAML", 0, 0, 0, 8, 0, 0, 1, 9
"d:\IDEWORK\lvmen\src\licensedcode\data\licenses\cc-sa.yml", "YAML", 0, 0, 0, 5, 0, 0, 1, 6
"d:\IDEWORK\lvmen\src\licensedcode\data\licenses\cc-sampling-1.0.yml", "YAML", 0, 0, 0, 7, 0, 0, 1, 8
"d:\IDEWORK\lvmen\src\licensedcode\data\licenses\cc-sampling-plus-1.0.yml", "YAML", 0, 0, 0, 7, 0, 0, 1, 8
"d:\IDEWORK\lvmen\src\licensedcode\data\licenses\cc0-1.0.yml", "YAML", 0, 0, 0, 13, 0, 0, 1, 14
"d:\IDEWORK\lvmen\src\licensedcode\data\licenses\ccrc-1.0.yml", "YAML", 0, 0, 0, 15, 0, 0, 1, 16
"d:\IDEWORK\lvmen\src\licensedcode\data\licenses\cddl-1.0.yml", "YAML", 0, 0, 0, 23, 0, 0, 1, 24
"d:\IDEWORK\lvmen\src\licensedcode\data\licenses\cddl-1.1.yml", "YAML", 0, 0, 0, 16, 0, 0, 1, 17
"d:\IDEWORK\lvmen\src\licensedcode\data\licenses\cdla-permissive-1.0.yml", "YAML", 0, 0, 0, 10, 0, 0, 1, 11
"d:\IDEWORK\lvmen\src\licensedcode\data\licenses\cdla-permissive-2.0.yml", "YAML", 0, 0, 0, 12, 0, 0, 1, 13
"d:\IDEWORK\lvmen\src\licensedcode\data\licenses\cdla-sharing-1.0.yml", "YAML", 0, 0, 0, 10, 0, 0, 1, 11
"d:\IDEWORK\lvmen\src\licensedcode\data\licenses\cecill-1.0.yml", "YAML", 0, 0, 0, 13, 0, 0, 1, 14
"d:\IDEWORK\lvmen\src\licensedcode\data\licenses\cecill-1.1.yml", "YAML", 0, 0, 0, 15, 0, 0, 1, 16
"d:\IDEWORK\lvmen\src\licensedcode\data\licenses\cecill-2.0.yml", "YAML", 0, 0, 0, 16, 0, 0, 1, 17
"d:\IDEWORK\lvmen\src\licensedcode\data\licenses\cecill-2.1.yml", "YAML", 0, 0, 0, 19, 0, 0, 1, 20
"d:\IDEWORK\lvmen\src\licensedcode\data\licenses\cecill-b.yml", "YAML", 0, 0, 0, 17, 0, 0, 1, 18
"d:\IDEWORK\lvmen\src\licensedcode\data\licenses\cecill-c.yml", "YAML", 0, 0, 0, 16, 0, 0, 1, 17
"d:\IDEWORK\lvmen\src\licensedcode\data\licenses\cepl-1.0.yml", "YAML", 0, 0, 0, 5, 0, 0, 1, 6
"d:\IDEWORK\lvmen\src\licensedcode\data\licenses\cern-ohl-1.1.yml", "YAML", 0, 0, 0, 16, 0, 0, 1, 17
"d:\IDEWORK\lvmen\src\licensedcode\data\licenses\cern-ohl-1.2.yml", "YAML", 0, 0, 0, 14, 0, 0, 1, 15
"d:\IDEWORK\lvmen\src\licensedcode\data\licenses\cern-ohl-p-2.0.yml", "YAML", 0, 0, 0, 23, 0, 0, 1, 24
"d:\IDEWORK\lvmen\src\licensedcode\data\licenses\cern-ohl-s-2.0.yml", "YAML", 0, 0, 0, 22, 0, 0, 1, 23
"d:\IDEWORK\lvmen\src\licensedcode\data\licenses\cern-ohl-w-2.0.yml", "YAML", 0, 0, 0, 22, 0, 0, 1, 23
"d:\IDEWORK\lvmen\src\licensedcode\data\licenses\cgic.yml", "YAML", 0, 0, 0, 11, 0, 0, 1, 12
"d:\IDEWORK\lvmen\src\licensedcode\data\licenses\charity software license.yml", "YAML", 0, 0, 0, 5, 0, 0, 1, 6
"d:\IDEWORK\lvmen\src\licensedcode\data\licenses\chartdirector-6.0.yml", "YAML", 0, 0, 0, 17, 0, 0, 1, 18
"d:\IDEWORK\lvmen\src\licensedcode\data\licenses\chelsio-linux-firmware.yml", "YAML", 0, 0, 0, 7, 0, 0, 1, 8
"d:\IDEWORK\lvmen\src\licensedcode\data\licenses\chicken-dl-0.2.yml", "YAML", 0, 0, 0, 9, 0, 0, 1, 10
"d:\IDEWORK\lvmen\src\licensedcode\data\licenses\chris-maunder.yml", "YAML", 0, 0, 0, 9, 0, 0, 1, 10
"d:\IDEWORK\lvmen\src\licensedcode\data\licenses\chris-stoy.yml", "YAML", 0, 0, 0, 6, 0, 0, 1, 7
"d:\IDEWORK\lvmen\src\licensedcode\data\licenses\christopher-velazquez.yml", "YAML", 0, 0, 0, 7, 0, 0, 1, 8
"d:\IDEWORK\lvmen\src\licensedcode\data\licenses\classic-vb.yml", "YAML", 0, 0, 0, 9, 0, 0, 1, 10
"d:\IDEWORK\lvmen\src\licensedcode\data\licenses\classpath-exception-2.0.yml", "YAML", 0, 0, 0, 13, 0, 0, 1, 14
"d:\IDEWORK\lvmen\src\licensedcode\data\licenses\classworlds.yml", "YAML", 0, 0, 0, 12, 0, 0, 1, 13
"d:\IDEWORK\lvmen\src\licensedcode\data\licenses\clause-6-exception-lgpl-2.1.yml", "YAML", 0, 0, 0, 8, 0, 0, 1, 9
"d:\IDEWORK\lvmen\src\licensedcode\data\licenses\clear-bsd-1-clause.yml", "YAML", 0, 0, 0, 9, 0, 0, 1, 10
"d:\IDEWORK\lvmen\src\licensedcode\data\licenses\clear-bsd.yml", "YAML", 0, 0, 0, 11, 0, 0, 1, 12
"d:\IDEWORK\lvmen\src\licensedcode\data\licenses\click-license.yml", "YAML", 0, 0, 0, 8, 0, 0, 1, 9
"d:\IDEWORK\lvmen\src\licensedcode\data\licenses\clisp-exception-2.0.yml", "YAML", 0, 0, 0, 12, 0, 0, 1, 13
"d:\IDEWORK\lvmen\src\licensedcode\data\licenses\cloudera-express.yml", "YAML", 0, 0, 0, 9, 0, 0, 1, 10
"d:\IDEWORK\lvmen\src\licensedcode\data\licenses\cmigemo.yml", "YAML", 0, 0, 0, 16, 0, 0, 1, 17
"d:\IDEWORK\lvmen\src\licensedcode\data\licenses\cmr-no.yml", "YAML", 0, 0, 0, 7, 0, 0, 1, 8
"d:\IDEWORK\lvmen\src\licensedcode\data\licenses\cmu-computing-services.yml", "YAML", 0, 0, 0, 16, 0, 0, 1, 17
"d:\IDEWORK\lvmen\src\licensedcode\data\licenses\cmu-mit.yml", "YAML", 0, 0, 0, 6, 0, 0, 1, 7
"d:\IDEWORK\lvmen\src\licensedcode\data\licenses\cmu-simple.yml", "YAML", 0, 0, 0, 8, 0, 0, 1, 9
"d:\IDEWORK\lvmen\src\licensedcode\data\licenses\cmu-template.yml", "YAML", 0, 0, 0, 9, 0, 0, 1, 10
"d:\IDEWORK\lvmen\src\licensedcode\data\licenses\cmu-uc.yml", "YAML", 0, 0, 0, 10, 0, 0, 1, 11
"d:\IDEWORK\lvmen\src\licensedcode\data\licenses\cnri-jython.yml", "YAML", 0, 0, 0, 14, 0, 0, 1, 15
"d:\IDEWORK\lvmen\src\licensedcode\data\licenses\cnri-python-1.6.1.yml", "YAML", 0, 0, 0, 14, 0, 0, 1, 15
"d:\IDEWORK\lvmen\src\licensedcode\data\licenses\cnri-python-1.6.yml", "YAML", 0, 0, 0, 23, 0, 0, 1, 24
"d:\IDEWORK\lvmen\src\licensedcode\data\licenses\cockroach.yml", "YAML", 0, 0, 0, 13, 0, 0, 1, 14
"d:\IDEWORK\lvmen\src\licensedcode\data\licenses\cockroachdb-use-grant-for-bsl-1.1.yml", "YAML", 0, 0, 0, 15, 0, 0, 1, 16
"d:\IDEWORK\lvmen\src\licensedcode\data\licenses\code-credit-license-1.0.1.yml", "YAML", 0, 0, 0, 14, 0, 0, 2, 16
"d:\IDEWORK\lvmen\src\licensedcode\data\licenses\codeguru-permissions.yml", "YAML", 0, 0, 0, 9, 0, 0, 1, 10
"d:\IDEWORK\lvmen\src\licensedcode\data\licenses\codexia.yml", "YAML", 0, 0, 0, 16, 0, 0, 1, 17
"d:\IDEWORK\lvmen\src\licensedcode\data\licenses\cognitive-web-osl-1.1.yml", "YAML", 0, 0, 0, 19, 0, 0, 1, 20
"d:\IDEWORK\lvmen\src\licensedcode\data\licenses\coil-0.3.yml", "YAML", 0, 0, 0, 5, 0, 0, 1, 6
"d:\IDEWORK\lvmen\src\licensedcode\data\licenses\colt.yml", "YAML", 0, 0, 0, 19, 0, 0, 1, 20
"d:\IDEWORK\lvmen\src\licensedcode\data\licenses\com-oreilly-servlet.yml", "YAML", 0, 0, 0, 14, 0, 0, 1, 15
"d:\IDEWORK\lvmen\src\licensedcode\data\licenses\commercial-license.yml", "YAML", 0, 0, 0, 6, 0, 0, 1, 7
"d:\IDEWORK\lvmen\src\licensedcode\data\licenses\commercial-option.yml", "YAML", 0, 0, 0, 7, 0, 0, 1, 8
"d:\IDEWORK\lvmen\src\licensedcode\data\licenses\commonj-timer.yml", "YAML", 0, 0, 0, 14, 0, 0, 1, 15
"d:\IDEWORK\lvmen\src\licensedcode\data\licenses\commons-clause.yml", "YAML", 0, 0, 0, 18, 0, 0, 1, 19
"d:\IDEWORK\lvmen\src\licensedcode\data\licenses\compass.yml", "YAML", 0, 0, 0, 7, 0, 0, 1, 8
"d:\IDEWORK\lvmen\src\licensedcode\data\licenses\componentace-jcraft.yml", "YAML", 0, 0, 0, 19, 0, 0, 1, 20
"d:\IDEWORK\lvmen\src\licensedcode\data\licenses\compuphase-linking-exception.yml", "YAML", 0, 0, 0, 27, 0, 0, 1, 28
"d:\IDEWORK\lvmen\src\licensedcode\data\licenses\computrace.yml", "YAML", 0, 0, 0, 5, 0, 0, 1, 6
"d:\IDEWORK\lvmen\src\licensedcode\data\licenses\concursive-pl-1.0.yml", "YAML", 0, 0, 0, 6, 0, 0, 1, 7
"d:\IDEWORK\lvmen\src\licensedcode\data\licenses\condor-1.1.yml", "YAML", 0, 0, 0, 26, 0, 0, 1, 27
"d:\IDEWORK\lvmen\src\licensedcode\data\licenses\confluent community license agreement v1.0.yml", "YAML", 0, 0, 0, 4, 0, 0, 1, 5
"d:\IDEWORK\lvmen\src\licensedcode\data\licenses\confluent-community-1.0.yml", "YAML", 0, 0, 0, 13, 0, 0, 1, 14
"d:\IDEWORK\lvmen\src\licensedcode\data\licenses\congrequest.yml", "YAML", 0, 0, 0, 5, 0, 0, 1, 6
"d:\IDEWORK\lvmen\src\licensedcode\data\licenses\cooperative-non-violent-4.0.yml", "YAML", 0, 0, 0, 9, 0, 0, 1, 10
"d:\IDEWORK\lvmen\src\licensedcode\data\licenses\copyheart.yml", "YAML", 0, 0, 0, 9, 0, 0, 1, 10
"d:\IDEWORK\lvmen\src\licensedcode\data\licenses\copyleft-next-0.3.0.yml", "YAML", 0, 0, 0, 13, 0, 0, 1, 14
"d:\IDEWORK\lvmen\src\licensedcode\data\licenses\copyleft-next-0.3.1.yml", "YAML", 0, 0, 0, 12, 0, 0, 1, 13
"d:\IDEWORK\lvmen\src\licensedcode\data\licenses\corporate-accountability-1.1.yml", "YAML", 0, 0, 0, 9, 0, 0, 1, 10
"d:\IDEWORK\lvmen\src\licensedcode\data\licenses\corporate-accountability-commercial-1.1.yml", "YAML", 0, 0, 0, 11, 0, 0, 1, 12
"d:\IDEWORK\lvmen\src\licensedcode\data\licenses\cosl.yml", "YAML", 0, 0, 0, 7, 0, 0, 1, 8
"d:\IDEWORK\lvmen\src\licensedcode\data\licenses\cosli.yml", "YAML", 0, 0, 0, 21, 0, 0, 1, 22
"d:\IDEWORK\lvmen\src\licensedcode\data\licenses\couchbase-community.yml", "YAML", 0, 0, 0, 14, 0, 0, 1, 15
"d:\IDEWORK\lvmen\src\licensedcode\data\licenses\couchbase-enterprise.yml", "YAML", 0, 0, 0, 11, 0, 0, 1, 12
"d:\IDEWORK\lvmen\src\licensedcode\data\licenses\cpal-1.0.yml", "YAML", 0, 0, 0, 16, 0, 0, 1, 17
"d:\IDEWORK\lvmen\src\licensedcode\data\licenses\cpl-0.5.yml", "YAML", 0, 0, 0, 12, 0, 0, 1, 13
"d:\IDEWORK\lvmen\src\licensedcode\data\licenses\cpl-1.0.yml", "YAML", 0, 0, 0, 21, 0, 0, 1, 22
"d:\IDEWORK\lvmen\src\licensedcode\data\licenses\cpol-1.0.yml", "YAML", 0, 0, 0, 12, 0, 0, 1, 13
"d:\IDEWORK\lvmen\src\licensedcode\data\licenses\cpol-1.02.yml", "YAML", 0, 0, 0, 11, 0, 0, 1, 12
"d:\IDEWORK\lvmen\src\licensedcode\data\licenses\cpp-core-guidelines.yml", "YAML", 0, 0, 0, 9, 0, 0, 1, 10
"d:\IDEWORK\lvmen\src\licensedcode\data\licenses\crapl-0.1.yml", "YAML", 0, 0, 0, 11, 0, 0, 1, 12
"d:\IDEWORK\lvmen\src\licensedcode\data\licenses\crashlytics-agreement-2018.yml", "YAML", 0, 0, 0, 15, 0, 0, 1, 16
"d:\IDEWORK\lvmen\src\licensedcode\data\licenses\crcalc.yml", "YAML", 0, 0, 0, 12, 0, 0, 1, 13
"d:\IDEWORK\lvmen\src\licensedcode\data\licenses\creative commons.yml", "YAML", 0, 0, 0, 5, 0, 0, 1, 6
"d:\IDEWORK\lvmen\src\licensedcode\data\licenses\crossword.yml", "YAML", 0, 0, 0, 12, 0, 0, 1, 13
"d:\IDEWORK\lvmen\src\licensedcode\data\licenses\crypto-keys-redistribution.yml", "YAML", 0, 0, 0, 14, 0, 0, 1, 15
"d:\IDEWORK\lvmen\src\licensedcode\data\licenses\cryptopp.yml", "YAML", 0, 0, 0, 10, 0, 0, 1, 11
"d:\IDEWORK\lvmen\src\licensedcode\data\licenses\crystal-stacker.yml", "YAML", 0, 0, 0, 9, 0, 0, 1, 10
"d:\IDEWORK\lvmen\src\licensedcode\data\licenses\csl-1.0.yml", "YAML", 0, 0, 0, 19, 0, 0, 1, 20
"d:\IDEWORK\lvmen\src\licensedcode\data\licenses\csla.yml", "YAML", 0, 0, 0, 15, 0, 0, 1, 16
"d:\IDEWORK\lvmen\src\licensedcode\data\licenses\csprng.yml", "YAML", 0, 0, 0, 8, 0, 0, 1, 9
"d:\IDEWORK\lvmen\src\licensedcode\data\licenses\ctl-linux-firmware.yml", "YAML", 0, 0, 0, 9, 0, 0, 1, 10
"d:\IDEWORK\lvmen\src\licensedcode\data\licenses\cua-opl-1.0.yml", "YAML", 0, 0, 0, 18, 0, 0, 1, 19
"d:\IDEWORK\lvmen\src\licensedcode\data\licenses\cube.yml", "YAML", 0, 0, 0, 12, 0, 0, 1, 13
"d:\IDEWORK\lvmen\src\licensedcode\data\licenses\cubiware-software-1.0.yml", "YAML", 0, 0, 0, 8, 0, 0, 1, 9
"d:\IDEWORK\lvmen\src\licensedcode\data\licenses\cups-apple-os-exception.yml", "YAML", 0, 0, 0, 8, 0, 0, 1, 9
"d:\IDEWORK\lvmen\src\licensedcode\data\licenses\cups.yml", "YAML", 0, 0, 0, 20, 0, 0, 1, 21
"d:\IDEWORK\lvmen\src\licensedcode\data\licenses\curl.yml", "YAML", 0, 0, 0, 16, 0, 0, 1, 17
"d:\IDEWORK\lvmen\src\licensedcode\data\licenses\cve-tou.yml", "YAML", 0, 0, 0, 7, 0, 0, 1, 8
"d:\IDEWORK\lvmen\src\licensedcode\data\licenses\cvwl.yml", "YAML", 0, 0, 0, 16, 0, 0, 1, 17
"d:\IDEWORK\lvmen\src\licensedcode\data\licenses\cwe-tou.yml", "YAML", 0, 0, 0, 7, 0, 0, 1, 8
"d:\IDEWORK\lvmen\src\licensedcode\data\licenses\cximage.yml", "YAML", 0, 0, 0, 16, 0, 0, 1, 17
"d:\IDEWORK\lvmen\src\licensedcode\data\licenses\cygwin-exception-2.0.yml", "YAML", 0, 0, 0, 40, 0, 0, 1, 41
"d:\IDEWORK\lvmen\src\licensedcode\data\licenses\cygwin-exception-3.0.yml", "YAML", 0, 0, 0, 67, 0, 0, 1, 68
"d:\IDEWORK\lvmen\src\licensedcode\data\licenses\cygwin-exception-lgpl-3.0-plus.yml", "YAML", 0, 0, 0, 22, 0, 0, 1, 23
"d:\IDEWORK\lvmen\src\licensedcode\data\licenses\cypress-linux-firmware.yml", "YAML", 0, 0, 0, 9, 0, 0, 1, 10
"d:\IDEWORK\lvmen\src\licensedcode\data\licenses\d-fsl-1.0-en.yml", "YAML", 0, 0, 0, 25, 0, 0, 1, 26
"d:\IDEWORK\lvmen\src\licensedcode\data\licenses\d-fsl-1.0.yml", "YAML", 0, 0, 0, 5, 0, 0, 1, 6
"d:\IDEWORK\lvmen\src\licensedcode\data\licenses\d-zlib.yml", "YAML", 0, 0, 0, 6, 0, 0, 1, 7
"d:\IDEWORK\lvmen\src\licensedcode\data\licenses\damail.yml", "YAML", 0, 0, 0, 7, 0, 0, 1, 8
"d:\IDEWORK\lvmen\src\licensedcode\data\licenses\dannaishot.yml", "YAML", 0, 0, 0, 5, 0, 0, 1, 6
"d:\IDEWORK\lvmen\src\licensedcode\data\licenses\dante-treglia.yml", "YAML", 0, 0, 0, 10, 0, 0, 1, 11
"d:\IDEWORK\lvmen\src\licensedcode\data\licenses\day-spec.yml", "YAML", 0, 0, 0, 15, 0, 0, 1, 16
"d:\IDEWORK\lvmen\src\licensedcode\data\licenses\dbad public license.yml", "YAML", 0, 0, 0, 5, 0, 0, 1, 6
"d:\IDEWORK\lvmen\src\licensedcode\data\licenses\dbad-1.1.yml", "YAML", 0, 0, 0, 7, 0, 0, 1, 8
"d:\IDEWORK\lvmen\src\licensedcode\data\licenses\dbad.yml", "YAML", 0, 0, 0, 8, 0, 0, 1, 9
"d:\IDEWORK\lvmen\src\licensedcode\data\licenses\dbcl-1.0.yml", "YAML", 0, 0, 0, 9, 0, 0, 1, 10
"d:\IDEWORK\lvmen\src\licensedcode\data\licenses\dco-1.1.yml", "YAML", 0, 0, 0, 14, 0, 0, 1, 15
"d:\IDEWORK\lvmen\src\licensedcode\data\licenses\debuglog.yml", "YAML", 0, 0, 0, 5, 0, 0, 1, 6
"d:\IDEWORK\lvmen\src\licensedcode\data\licenses\defensive-patent-1.1.yml", "YAML", 0, 0, 0, 11, 0, 0, 1, 12
"d:\IDEWORK\lvmen\src\licensedcode\data\licenses\dejavu fonts license v1.00.yml", "YAML", 0, 0, 0, 5, 0, 0, 1, 6
"d:\IDEWORK\lvmen\src\licensedcode\data\licenses\dejavu-font.yml", "YAML", 0, 0, 0, 8, 0, 0, 1, 9
"d:\IDEWORK\lvmen\src\licensedcode\data\licenses\delete me.yml", "YAML", 0, 0, 0, 5, 0, 0, 1, 6
"d:\IDEWORK\lvmen\src\licensedcode\data\licenses\delorie-historical.yml", "YAML", 0, 0, 0, 8, 0, 0, 1, 9
"d:\IDEWORK\lvmen\src\licensedcode\data\licenses\dennis-ferguson.yml", "YAML", 0, 0, 0, 9, 0, 0, 1, 10
"d:\IDEWORK\lvmen\src\licensedcode\data\licenses\deploy chi.yml", "YAML", 0, 0, 0, 5, 0, 0, 1, 6
"d:\IDEWORK\lvmen\src\licensedcode\data\licenses\devblocks-1.0.yml", "YAML", 0, 0, 0, 9, 0, 0, 1, 10
"d:\IDEWORK\lvmen\src\licensedcode\data\licenses\dgraph-cla.yml", "YAML", 0, 0, 0, 17, 0, 0, 1, 18
"d:\IDEWORK\lvmen\src\licensedcode\data\licenses\dhtmlab-public.yml", "YAML", 0, 0, 0, 12, 0, 0, 1, 13
"d:\IDEWORK\lvmen\src\licensedcode\data\licenses\diffmark.yml", "YAML", 0, 0, 0, 17, 0, 0, 1, 18
"d:\IDEWORK\lvmen\src\licensedcode\data\licenses\digia-qt-commercial.yml", "YAML", 0, 0, 0, 11, 0, 0, 1, 12
"d:\IDEWORK\lvmen\src\licensedcode\data\licenses\digia-qt-exception-lgpl-2.1.yml", "YAML", 0, 0, 0, 42, 0, 0, 2, 44
"d:\IDEWORK\lvmen\src\licensedcode\data\licenses\digia-qt-preview.yml", "YAML", 0, 0, 0, 8, 0, 0, 1, 9
"d:\IDEWORK\lvmen\src\licensedcode\data\licenses\digirule-foss-exception.yml", "YAML", 0, 0, 0, 77, 0, 0, 1, 78
"d:\IDEWORK\lvmen\src\licensedcode\data\licenses\divx-open-1.0.yml", "YAML", 0, 0, 0, 13, 0, 0, 1, 14
"d:\IDEWORK\lvmen\src\licensedcode\data\licenses\divx-open-2.1.yml", "YAML", 0, 0, 0, 12, 0, 0, 1, 13
"d:\IDEWORK\lvmen\src\licensedcode\data\licenses\dl-de-by-1-0-en.yml", "YAML", 0, 0, 0, 9, 0, 0, 0, 9
"d:\IDEWORK\lvmen\src\licensedcode\data\licenses\dl-de-by-2-0-en.yml", "YAML", 0, 0, 0, 11, 0, 0, 1, 12
"d:\IDEWORK\lvmen\src\licensedcode\data\licenses\dl-de-by-nc-1-0-en.yml", "YAML", 0, 0, 0, 9, 0, 0, 1, 10
"d:\IDEWORK\lvmen\src\licensedcode\data\licenses\dmalloc.yml", "YAML", 0, 0, 0, 9, 0, 0, 1, 10
"d:\IDEWORK\lvmen\src\licensedcode\data\licenses\do-no-harm-0.1.yml", "YAML", 0, 0, 0, 9, 0, 0, 1, 10
"d:\IDEWORK\lvmen\src\licensedcode\data\licenses\docbook.yml", "YAML", 0, 0, 0, 10, 0, 0, 1, 11
"d:\IDEWORK\lvmen\src\licensedcode\data\licenses\dom4j.yml", "YAML", 0, 0, 0, 30, 0, 0, 0, 30
"d:\IDEWORK\lvmen\src\licensedcode\data\licenses\doom source licence.yml", "YAML", 0, 0, 0, 5, 0, 0, 1, 6
"d:\IDEWORK\lvmen\src\licensedcode\data\licenses\dotseqn.yml", "YAML", 0, 0, 0, 8, 0, 0, 1, 9
"d:\IDEWORK\lvmen\src\licensedcode\data\licenses\doug-lea.yml", "YAML", 0, 0, 0, 7, 0, 0, 1, 8
"d:\IDEWORK\lvmen\src\licensedcode\data\licenses\douglas-young.yml", "YAML", 0, 0, 0, 7, 0, 0, 1, 8
"d:\IDEWORK\lvmen\src\licensedcode\data\licenses\dpl-1.1.yml", "YAML", 0, 0, 0, 9, 0, 0, 1, 10
"d:\IDEWORK\lvmen\src\licensedcode\data\licenses\dr-john-maddock.yml", "YAML", 0, 0, 0, 7, 0, 0, 1, 8
"d:\IDEWORK\lvmen\src\licensedcode\data\licenses\drl-1.0.yml", "YAML", 0, 0, 0, 10, 0, 0, 1, 11
"d:\IDEWORK\lvmen\src\licensedcode\data\licenses\dropbear-2016.yml", "YAML", 0, 0, 0, 39, 0, 0, 1, 40
"d:\IDEWORK\lvmen\src\licensedcode\data\licenses\dropbear.yml", "YAML", 0, 0, 0, 43, 0, 0, 1, 44
"d:\IDEWORK\lvmen\src\licensedcode\data\licenses\dsdp.yml", "YAML", 0, 0, 0, 17, 0, 0, 1, 18
"d:\IDEWORK\lvmen\src\licensedcode\data\licenses\dtree.yml", "YAML", 0, 0, 0, 13, 0, 0, 1, 14
"d:\IDEWORK\lvmen\src\licensedcode\data\licenses\dual-bsd-gpl.yml", "YAML", 0, 0, 0, 7, 0, 0, 1, 8
"d:\IDEWORK\lvmen\src\licensedcode\data\licenses\dual-commercial-gpl.yml", "YAML", 0, 0, 0, 8, 0, 0, 1, 9
"d:\IDEWORK\lvmen\src\licensedcode\data\licenses\dune-exception.yml", "YAML", 0, 0, 0, 10, 0, 0, 1, 11
"d:\IDEWORK\lvmen\src\licensedcode\data\licenses\dvipdfm.yml", "YAML", 0, 0, 0, 11, 0, 0, 1, 12
"d:\IDEWORK\lvmen\src\licensedcode\data\licenses\dwtfnmfpl-3.0.yml", "YAML", 0, 0, 0, 8, 0, 0, 1, 9
"d:\IDEWORK\lvmen\src\licensedcode\data\licenses\dynamic-drive-tou.yml", "YAML", 0, 0, 0, 12, 0, 0, 1, 13
"d:\IDEWORK\lvmen\src\licensedcode\data\licenses\dynarch-developer.yml", "YAML", 0, 0, 0, 13, 0, 0, 1, 14
"d:\IDEWORK\lvmen\src\licensedcode\data\licenses\dynarch-linkware.yml", "YAML", 0, 0, 0, 15, 0, 0, 1, 16
"d:\IDEWORK\lvmen\src\licensedcode\data\licenses\ebay india global easybuy addendum.yml", "YAML", 0, 0, 0, 5, 0, 0, 1, 6
"d:\IDEWORK\lvmen\src\licensedcode\data\licenses\ecfonts-1.0.yml", "YAML", 0, 0, 0, 9, 0, 0, 1, 10
"d:\IDEWORK\lvmen\src\licensedcode\data\licenses\ecl-1.0.yml", "YAML", 0, 0, 0, 16, 0, 0, 1, 17
"d:\IDEWORK\lvmen\src\licensedcode\data\licenses\ecl-2.0.yml", "YAML", 0, 0, 0, 25, 0, 0, 1, 26
"d:\IDEWORK\lvmen\src\licensedcode\data\licenses\eclipse-sua-2001.yml", "YAML", 0, 0, 0, 7, 0, 0, 1, 8
"d:\IDEWORK\lvmen\src\licensedcode\data\licenses\eclipse-sua-2002.yml", "YAML", 0, 0, 0, 9, 0, 0, 1, 10
"d:\IDEWORK\lvmen\src\licensedcode\data\licenses\eclipse-sua-2003.yml", "YAML", 0, 0, 0, 13, 0, 0, 1, 14
"d:\IDEWORK\lvmen\src\licensedcode\data\licenses\eclipse-sua-2004.yml", "YAML", 0, 0, 0, 14, 0, 0, 1, 15
"d:\IDEWORK\lvmen\src\licensedcode\data\licenses\eclipse-sua-2005.yml", "YAML", 0, 0, 0, 15, 0, 0, 1, 16
"d:\IDEWORK\lvmen\src\licensedcode\data\licenses\eclipse-sua-2010.yml", "YAML", 0, 0, 0, 15, 0, 0, 1, 16
"d:\IDEWORK\lvmen\src\licensedcode\data\licenses\eclipse-sua-2011.yml", "YAML", 0, 0, 0, 16, 0, 0, 1, 17
"d:\IDEWORK\lvmen\src\licensedcode\data\licenses\eclipse-sua-2014-11.yml", "YAML", 0, 0, 0, 16, 0, 0, 1, 17
"d:\IDEWORK\lvmen\src\licensedcode\data\licenses\eclipse-sua-2014.yml", "YAML", 0, 0, 0, 15, 0, 0, 1, 16
"d:\IDEWORK\lvmen\src\licensedcode\data\licenses\eclipse-sua-2017.yml", "YAML", 0, 0, 0, 18, 0, 0, 1, 19
"d:\IDEWORK\lvmen\src\licensedcode\data\licenses\ecma-documentation.yml", "YAML", 0, 0, 0, 7, 0, 0, 1, 8
"d:\IDEWORK\lvmen\src\licensedcode\data\licenses\ecma-no-patent.yml", "YAML", 0, 0, 0, 10, 0, 0, 1, 11
"d:\IDEWORK\lvmen\src\licensedcode\data\licenses\ecma-patent-coc-0.yml", "YAML", 0, 0, 0, 8, 0, 0, 1, 9
"d:\IDEWORK\lvmen\src\licensedcode\data\licenses\ecma-patent-coc-1.yml", "YAML", 0, 0, 0, 7, 0, 0, 1, 8
"d:\IDEWORK\lvmen\src\licensedcode\data\licenses\ecma-patent-coc-2.yml", "YAML", 0, 0, 0, 7, 0, 0, 1, 8
"d:\IDEWORK\lvmen\src\licensedcode\data\licenses\ecos-exception-2.0.yml", "YAML", 0, 0, 0, 15, 0, 0, 1, 16
"d:\IDEWORK\lvmen\src\licensedcode\data\licenses\ecos.yml", "YAML", 0, 0, 0, 17, 0, 0, 1, 18
"d:\IDEWORK\lvmen\src\licensedcode\data\licenses\ecosrh-1.0.yml", "YAML", 0, 0, 0, 23, 0, 0, 1, 24
"d:\IDEWORK\lvmen\src\licensedcode\data\licenses\ecosrh-1.1.yml", "YAML", 0, 0, 0, 21, 0, 0, 1, 22
"d:\IDEWORK\lvmen\src\licensedcode\data\licenses\efl-1.0.yml", "YAML", 0, 0, 0, 19, 0, 0, 1, 20
"d:\IDEWORK\lvmen\src\licensedcode\data\licenses\efl-2.0.yml", "YAML", 0, 0, 0, 21, 0, 0, 1, 22
"d:\IDEWORK\lvmen\src\licensedcode\data\licenses\efsl-1.0.yml", "YAML", 0, 0, 0, 21, 0, 0, 1, 22
"d:\IDEWORK\lvmen\src\licensedcode\data\licenses\egenix-1.0.0.yml", "YAML", 0, 0, 0, 8, 0, 0, 1, 9
"d:\IDEWORK\lvmen\src\licensedcode\data\licenses\egenix-1.1.0.yml", "YAML", 0, 0, 0, 10, 0, 0, 1, 11
"d:\IDEWORK\lvmen\src\licensedcode\data\licenses\egrappler.yml", "YAML", 0, 0, 0, 7, 0, 0, 1, 8
"d:\IDEWORK\lvmen\src\licensedcode\data\licenses\egreen open source .yml", "YAML", 0, 0, 0, 5, 0, 0, 1, 6
"d:\IDEWORK\lvmen\src\licensedcode\data\licenses\ej-technologies-eula.yml", "YAML", 0, 0, 0, 14, 0, 0, 1, 15
"d:\IDEWORK\lvmen\src\licensedcode\data\licenses\ekiga-exception-2.0-plus.yml", "YAML", 0, 0, 0, 30, 0, 0, 1, 31
"d:\IDEWORK\lvmen\src\licensedcode\data\licenses\ekioh.yml", "YAML", 0, 0, 0, 12, 0, 0, 1, 13
"d:\IDEWORK\lvmen\src\licensedcode\data\licenses\elastic-license-2018.yml", "YAML", 0, 0, 0, 21, 0, 0, 1, 22
"d:\IDEWORK\lvmen\src\licensedcode\data\licenses\elastic-license-v2.yml", "YAML", 0, 0, 0, 14, 0, 0, 2, 16
"d:\IDEWORK\lvmen\src\licensedcode\data\licenses\elib-gpl.yml", "YAML", 0, 0, 0, 14, 0, 0, 1, 15
"d:\IDEWORK\lvmen\src\licensedcode\data\licenses\ellis-lab.yml", "YAML", 0, 0, 0, 7, 0, 0, 1, 8
"d:\IDEWORK\lvmen\src\licensedcode\data\licenses\emit.yml", "YAML", 0, 0, 0, 13, 0, 0, 1, 14
"d:\IDEWORK\lvmen\src\licensedcode\data\licenses\emx-library.yml", "YAML", 0, 0, 0, 9, 0, 0, 1, 10
"d:\IDEWORK\lvmen\src\licensedcode\data\licenses\energyplus-bsd.yml", "YAML", 0, 0, 0, 9, 0, 0, 1, 10
"d:\IDEWORK\lvmen\src\licensedcode\data\licenses\enhydra-1.1.yml", "YAML", 0, 0, 0, 23, 0, 0, 1, 24
"d:\IDEWORK\lvmen\src\licensedcode\data\licenses\enlightenment.yml", "YAML", 0, 0, 0, 19, 0, 0, 1, 20
"d:\IDEWORK\lvmen\src\licensedcode\data\licenses\enna.yml", "YAML", 0, 0, 0, 8, 0, 0, 1, 9
"d:\IDEWORK\lvmen\src\licensedcode\data\licenses\entessa-1.0.yml", "YAML", 0, 0, 0, 29, 0, 0, 1, 30
"d:\IDEWORK\lvmen\src\licensedcode\data\licenses\epaperpress.yml", "YAML", 0, 0, 0, 7, 0, 0, 1, 8
"d:\IDEWORK\lvmen\src\licensedcode\data\licenses\epics.yml", "YAML", 0, 0, 0, 12, 0, 0, 1, 13
"d:\IDEWORK\lvmen\src\licensedcode\data\licenses\epl-1.0.yml", "YAML", 0, 0, 0, 19, 0, 0, 1, 20
"d:\IDEWORK\lvmen\src\licensedcode\data\licenses\epl-2.0.yml", "YAML", 0, 0, 0, 14, 0, 0, 1, 15
"d:\IDEWORK\lvmen\src\licensedcode\data\licenses\epo-osl-2005.1.yml", "YAML", 0, 0, 0, 9, 0, 0, 1, 10
"d:\IDEWORK\lvmen\src\licensedcode\data\licenses\eric-glass.yml", "YAML", 0, 0, 0, 17, 0, 0, 1, 18
"d:\IDEWORK\lvmen\src\licensedcode\data\licenses\erlangpl-1.1.yml", "YAML", 0, 0, 0, 16, 0, 0, 1, 17
"d:\IDEWORK\lvmen\src\licensedcode\data\licenses\errbot-exception.yml", "YAML", 0, 0, 0, 11, 0, 0, 1, 12
"d:\IDEWORK\lvmen\src\licensedcode\data\licenses\esri-devkit.yml", "YAML", 0, 0, 0, 10, 0, 0, 1, 11
"d:\IDEWORK\lvmen\src\licensedcode\data\licenses\esri.yml", "YAML", 0, 0, 0, 27, 0, 0, 1, 28
"d:\IDEWORK\lvmen\src\licensedcode\data\licenses\etalab-2.0.yml", "YAML", 0, 0, 0, 17, 0, 0, 1, 18
"d:\IDEWORK\lvmen\src\licensedcode\data\licenses\eu-datagrid.yml", "YAML", 0, 0, 0, 28, 0, 0, 1, 29
"d:\IDEWORK\lvmen\src\licensedcode\data\licenses\eupl-1.0.yml", "YAML", 0, 0, 0, 16, 0, 0, 1, 17
"d:\IDEWORK\lvmen\src\licensedcode\data\licenses\eupl-1.1.yml", "YAML", 0, 0, 0, 27, 0, 0, 1, 28
"d:\IDEWORK\lvmen\src\licensedcode\data\licenses\eupl-1.2.yml", "YAML", 0, 0, 0, 26, 0, 0, 1, 27
"d:\IDEWORK\lvmen\src\licensedcode\data\licenses\eurosym.yml", "YAML", 0, 0, 0, 10, 0, 0, 1, 11
"d:\IDEWORK\lvmen\src\licensedcode\data\licenses\examdiff.yml", "YAML", 0, 0, 0, 7, 0, 0, 1, 8
"d:\IDEWORK\lvmen\src\licensedcode\data\licenses\excelsior-jet-runtime.yml", "YAML", 0, 0, 0, 10, 0, 0, 1, 11
"d:\IDEWORK\lvmen\src\licensedcode\data\licenses\fabien-tassin.yml", "YAML", 0, 0, 0, 7, 0, 0, 1, 8
"d:\IDEWORK\lvmen\src\licensedcode\data\licenses\fabric-agreement-2017.yml", "YAML", 0, 0, 0, 6, 0, 0, 1, 7
"d:\IDEWORK\lvmen\src\licensedcode\data\licenses\facebook-nuclide.yml", "YAML", 0, 0, 0, 9, 0, 0, 1, 10
"d:\IDEWORK\lvmen\src\licensedcode\data\licenses\facebook-patent-rights-2.yml", "YAML", 0, 0, 0, 17, 0, 0, 1, 18
"d:\IDEWORK\lvmen\src\licensedcode\data\licenses\facebook-software-license.yml", "YAML", 0, 0, 0, 14, 0, 0, 1, 15
"d:\IDEWORK\lvmen\src\licensedcode\data\licenses\factual terms of service.yml", "YAML", 0, 0, 0, 5, 0, 0, 1, 6
"d:\IDEWORK\lvmen\src\licensedcode\data\licenses\fair-source-0.9.yml", "YAML", 0, 0, 0, 5, 0, 0, 1, 6
"d:\IDEWORK\lvmen\src\licensedcode\data\licenses\fair.yml", "YAML", 0, 0, 0, 17, 0, 0, 1, 18
"d:\IDEWORK\lvmen\src\licensedcode\data\licenses\fal.yml", "YAML", 0, 0, 0, 5, 0, 0, 1, 6
"d:\IDEWORK\lvmen\src\licensedcode\data\licenses\fancyzoom.yml", "YAML", 0, 0, 0, 10, 0, 0, 1, 11
"d:\IDEWORK\lvmen\src\licensedcode\data\licenses\far-manager-exception.yml", "YAML", 0, 0, 0, 37, 0, 0, 1, 38
"d:\IDEWORK\lvmen\src\licensedcode\data\licenses\fastbuild-2012-2020.yml", "YAML", 0, 0, 0, 13, 0, 0, 2, 15
"d:\IDEWORK\lvmen\src\licensedcode\data\licenses\fastcgi-devkit.yml", "YAML", 0, 0, 0, 19, 0, 0, 0, 19
"d:\IDEWORK\lvmen\src\licensedcode\data\licenses\fatfs.yml", "YAML", 0, 0, 0, 7, 0, 0, 1, 8
"d:\IDEWORK\lvmen\src\licensedcode\data\licenses\fawkes-runtime-exception.yml", "YAML", 0, 0, 0, 11, 0, 0, 1, 12
"d:\IDEWORK\lvmen\src\licensedcode\data\licenses\fecommonpod.yml", "YAML", 0, 0, 0, 5, 0, 0, 1, 6
"d:\IDEWORK\lvmen\src\licensedcode\data\licenses\fftpack-2004.yml", "YAML", 0, 0, 0, 17, 0, 0, 1, 18
"d:\IDEWORK\lvmen\src\licensedcode\data\licenses\filament-group-mit.yml", "YAML", 0, 0, 0, 14, 0, 0, 1, 15
"d:\IDEWORK\lvmen\src\licensedcode\data\licenses\first-works-appreciative-1.2.yml", "YAML", 0, 0, 0, 13, 0, 0, 1, 14
"d:\IDEWORK\lvmen\src\licensedcode\data\licenses\flatstone tech custom license.yml", "YAML", 0, 0, 0, 5, 0, 0, 1, 6
"d:\IDEWORK\lvmen\src\licensedcode\data\licenses\flex-2.5.yml", "YAML", 0, 0, 0, 12, 0, 0, 1, 13
"d:\IDEWORK\lvmen\src\licensedcode\data\licenses\flex2sdk.yml", "YAML", 0, 0, 0, 13, 0, 0, 1, 14
"d:\IDEWORK\lvmen\src\licensedcode\data\licenses\flora-1.1.yml", "YAML", 0, 0, 0, 15, 0, 0, 1, 16
"d:\IDEWORK\lvmen\src\licensedcode\data\licenses\flowplayer-gpl-3.0.yml", "YAML", 0, 0, 0, 13, 0, 0, 1, 14
"d:\IDEWORK\lvmen\src\licensedcode\data\licenses\fltk-exception-lgpl-2.0.yml", "YAML", 0, 0, 0, 41, 0, 0, 1, 42
"d:\IDEWORK\lvmen\src\licensedcode\data\licenses\font-alias.yml", "YAML", 0, 0, 0, 16, 0, 0, 1, 17
"d:\IDEWORK\lvmen\src\licensedcode\data\licenses\font-exception-gpl.yml", "YAML", 0, 0, 0, 31, 0, 0, 1, 32
"d:\IDEWORK\lvmen\src\licensedcode\data\licenses\foobar2000.yml", "YAML", 0, 0, 0, 7, 0, 0, 1, 8
"d:\IDEWORK\lvmen\src\licensedcode\data\licenses\foxit eula.yml", "YAML", 0, 0, 0, 5, 0, 0, 1, 6
"d:\IDEWORK\lvmen\src\licensedcode\data\licenses\fpl.yml", "YAML", 0, 0, 0, 9, 0, 0, 1, 10
"d:\IDEWORK\lvmen\src\licensedcode\data\licenses\fplot.yml", "YAML", 0, 0, 0, 7, 0, 0, 1, 8
"d:\IDEWORK\lvmen\src\licensedcode\data\licenses\frameworx-1.0.yml", "YAML", 0, 0, 0, 25, 0, 0, 1, 26
"d:\IDEWORK\lvmen\src\licensedcode\data\licenses\fraunhofer-fdk-aac-codec.yml", "YAML", 0, 0, 0, 23, 0, 0, 1, 24
"d:\IDEWORK\lvmen\src\licensedcode\data\licenses\fraunhofer-iso-14496-10.yml", "YAML", 0, 0, 0, 17, 0, 0, 1, 18
"d:\IDEWORK\lvmen\src\licensedcode\data\licenses\free public license 1.0.0.yml", "YAML", 0, 0, 0, 5, 0, 0, 1, 6
"d:\IDEWORK\lvmen\src\licensedcode\data\licenses\free-art-1.3.yml", "YAML", 0, 0, 0, 12, 0, 0, 1, 13
"d:\IDEWORK\lvmen\src\licensedcode\data\licenses\free-fork.yml", "YAML", 0, 0, 0, 12, 0, 0, 1, 13
"d:\IDEWORK\lvmen\src\licensedcode\data\licenses\free-unknown.yml", "YAML", 0, 0, 0, 7, 0, 0, 2, 9
"d:\IDEWORK\lvmen\src\licensedcode\data\licenses\freebsd-boot.yml", "YAML", 0, 0, 0, 11, 0, 0, 1, 12
"d:\IDEWORK\lvmen\src\licensedcode\data\licenses\freebsd-doc.yml", "YAML", 0, 0, 0, 17, 0, 0, 1, 18
"d:\IDEWORK\lvmen\src\licensedcode\data\licenses\freebsd-first.yml", "YAML", 0, 0, 0, 11, 0, 0, 1, 12
"d:\IDEWORK\lvmen\src\licensedcode\data\licenses\freeimage-1.0.yml", "YAML", 0, 0, 0, 12, 0, 0, 1, 13
"d:\IDEWORK\lvmen\src\licensedcode\data\licenses\freemarker.yml", "YAML", 0, 0, 0, 21, 0, 0, 1, 22
"d:\IDEWORK\lvmen\src\licensedcode\data\licenses\freertos-exception-2.0.yml", "YAML", 0, 0, 0, 92, 0, 0, 1, 93
"d:\IDEWORK\lvmen\src\licensedcode\data\licenses\freetts.yml", "YAML", 0, 0, 0, 16, 0, 0, 1, 17
"d:\IDEWORK\lvmen\src\licensedcode\data\licenses\freetype-patent.yml", "YAML", 0, 0, 0, 10, 0, 0, 1, 11
"d:\IDEWORK\lvmen\src\licensedcode\data\licenses\freetype.yml", "YAML", 0, 0, 0, 29, 0, 0, 1, 30
"d:\IDEWORK\lvmen\src\licensedcode\data\licenses\freeware.yml", "YAML", 0, 0, 0, 5, 0, 0, 1, 6
"d:\IDEWORK\lvmen\src\licensedcode\data\licenses\froala-owdl-1.0.yml", "YAML", 0, 0, 0, 13, 0, 0, 1, 14
"d:\IDEWORK\lvmen\src\licensedcode\data\licenses\frontier-1.0.yml", "YAML", 0, 0, 0, 15, 0, 0, 1, 16
"d:\IDEWORK\lvmen\src\licensedcode\data\licenses\fsf-ap.yml", "YAML", 0, 0, 0, 19, 0, 0, 1, 20
"d:\IDEWORK\lvmen\src\licensedcode\data\licenses\fsf-free.yml", "YAML", 0, 0, 0, 10, 0, 0, 1, 11
"d:\IDEWORK\lvmen\src\licensedcode\data\licenses\fsf-notice.yml", "YAML", 0, 0, 0, 10, 0, 0, 1, 11
"d:\IDEWORK\lvmen\src\licensedcode\data\licenses\fsf-unlimited-no-warranty.yml", "YAML", 0, 0, 0, 12, 0, 0, 1, 13
"d:\IDEWORK\lvmen\src\licensedcode\data\licenses\fsf-unlimited.yml", "YAML", 0, 0, 0, 8, 0, 0, 1, 9
"d:\IDEWORK\lvmen\src\licensedcode\data\licenses\ftdi.yml", "YAML", 0, 0, 0, 10, 0, 0, 1, 11
"d:\IDEWORK\lvmen\src\licensedcode\data\licenses\ftpbean.yml", "YAML", 0, 0, 0, 15, 0, 0, 1, 16
"d:\IDEWORK\lvmen\src\licensedcode\data\licenses\fusionlord custom license.yml", "YAML", 0, 0, 0, 5, 0, 0, 1, 6
"d:\IDEWORK\lvmen\src\licensedcode\data\licenses\fwdraggableswipeplayer.yml", "YAML", 0, 0, 0, 5, 0, 0, 1, 6
"d:\IDEWORK\lvmen\src\licensedcode\data\licenses\gareth-mccaughan.yml", "YAML", 0, 0, 0, 11, 0, 0, 1, 12
"d:\IDEWORK\lvmen\src\licensedcode\data\licenses\gary-s-brown.yml", "YAML", 0, 0, 0, 6, 0, 0, 1, 7
"d:\IDEWORK\lvmen\src\licensedcode\data\licenses\gcc-compiler-exception-2.0.yml", "YAML", 0, 0, 0, 28, 0, 0, 1, 29
"d:\IDEWORK\lvmen\src\licensedcode\data\licenses\gcc-exception-3.0.yml", "YAML", 0, 0, 0, 19, 0, 0, 1, 20
"d:\IDEWORK\lvmen\src\licensedcode\data\licenses\gcc-exception-3.1.yml", "YAML", 0, 0, 0, 85, 0, 0, 1, 86
"d:\IDEWORK\lvmen\src\licensedcode\data\licenses\gcc-linking-exception-2.0.yml", "YAML", 0, 0, 0, 30, 0, 0, 1, 31
"d:\IDEWORK\lvmen\src\licensedcode\data\licenses\gco-v3.0.yml", "YAML", 0, 0, 0, 7, 0, 0, 1, 8
"d:\IDEWORK\lvmen\src\licensedcode\data\licenses\gdcl.yml", "YAML", 0, 0, 0, 9, 0, 0, 1, 10
"d:\IDEWORK\lvmen\src\licensedcode\data\licenses\generic-cla.yml", "YAML", 0, 0, 0, 7, 0, 0, 1, 8
"d:\IDEWORK\lvmen\src\licensedcode\data\licenses\generic-exception.yml", "YAML", 0, 0, 0, 9, 0, 0, 1, 10
"d:\IDEWORK\lvmen\src\licensedcode\data\licenses\generic-export-compliance.yml", "YAML", 0, 0, 0, 8, 0, 0, 1, 9
"d:\IDEWORK\lvmen\src\licensedcode\data\licenses\generic-tos.yml", "YAML", 0, 0, 0, 8, 0, 0, 1, 9
"d:\IDEWORK\lvmen\src\licensedcode\data\licenses\generic-trademark.yml", "YAML", 0, 0, 0, 11, 0, 0, 2, 13
"d:\IDEWORK\lvmen\src\licensedcode\data\licenses\genivia-gsoap.yml", "YAML", 0, 0, 0, 13, 0, 0, 1, 14
"d:\IDEWORK\lvmen\src\licensedcode\data\licenses\genode-agpl-3.0-exception.yml", "YAML", 0, 0, 0, 14, 0, 0, 1, 15
"d:\IDEWORK\lvmen\src\licensedcode\data\licenses\geoff-kuenning-1993.yml", "YAML", 0, 0, 0, 13, 0, 0, 1, 14
"d:\IDEWORK\lvmen\src\licensedcode\data\licenses\geoserver-exception-2.0-plus.yml", "YAML", 0, 0, 0, 43, 0, 0, 1, 44
"d:\IDEWORK\lvmen\src\licensedcode\data\licenses\gfdl-1.1-invariants-only.yml", "YAML", 0, 0, 0, 34, 0, 0, 1, 35
"d:\IDEWORK\lvmen\src\licensedcode\data\licenses\gfdl-1.1-invariants-or-later.yml", "YAML", 0, 0, 0, 36, 0, 0, 1, 37
"d:\IDEWORK\lvmen\src\licensedcode\data\licenses\gfdl-1.1-no-invariants-only.yml", "YAML", 0, 0, 0, 33, 0, 0, 1, 34
"d:\IDEWORK\lvmen\src\licensedcode\data\licenses\gfdl-1.1-no-invariants-or-later.yml", "YAML", 0, 0, 0, 34, 0, 0, 1, 35
"d:\IDEWORK\lvmen\src\licensedcode\data\licenses\gfdl-1.1-plus.yml", "YAML", 0, 0, 0, 25, 0, 0, 1, 26
"d:\IDEWORK\lvmen\src\licensedcode\data\licenses\gfdl-1.1.yml", "YAML", 0, 0, 0, 25, 0, 0, 1, 26
"d:\IDEWORK\lvmen\src\licensedcode\data\licenses\gfdl-1.2-invariants-only.yml", "YAML", 0, 0, 0, 29, 0, 0, 1, 30
"d:\IDEWORK\lvmen\src\licensedcode\data\licenses\gfdl-1.2-invariants-or-later.yml", "YAML", 0, 0, 0, 30, 0, 0, 1, 31
"d:\IDEWORK\lvmen\src\licensedcode\data\licenses\gfdl-1.2-no-invariants-only.yml", "YAML", 0, 0, 0, 28, 0, 0, 1, 29
"d:\IDEWORK\lvmen\src\licensedcode\data\licenses\gfdl-1.2-no-invariants-or-later.yml", "YAML", 0, 0, 0, 29, 0, 0, 1, 30
"d:\IDEWORK\lvmen\src\licensedcode\data\licenses\gfdl-1.2-plus.yml", "YAML", 0, 0, 0, 24, 0, 0, 1, 25
"d:\IDEWORK\lvmen\src\licensedcode\data\licenses\gfdl-1.2.yml", "YAML", 0, 0, 0, 24, 0, 0, 1, 25
"d:\IDEWORK\lvmen\src\licensedcode\data\licenses\gfdl-1.3-invariants-only.yml", "YAML", 0, 0, 0, 28, 0, 0, 1, 29
"d:\IDEWORK\lvmen\src\licensedcode\data\licenses\gfdl-1.3-invariants-or-later.yml", "YAML", 0, 0, 0, 29, 0, 0, 1, 30
"d:\IDEWORK\lvmen\src\licensedcode\data\licenses\gfdl-1.3-no-invariants-only.yml", "YAML", 0, 0, 0, 27, 0, 0, 1, 28
"d:\IDEWORK\lvmen\src\licensedcode\data\licenses\gfdl-1.3-no-invariants-or-later.yml", "YAML", 0, 0, 0, 28, 0, 0, 1, 29
"d:\IDEWORK\lvmen\src\licensedcode\data\licenses\gfdl-1.3-plus.yml", "YAML", 0, 0, 0, 23, 0, 0, 1, 24
"d:\IDEWORK\lvmen\src\licensedcode\data\licenses\gfdl-1.3.yml", "YAML", 0, 0, 0, 22, 0, 0, 1, 23
"d:\IDEWORK\lvmen\src\licensedcode\data\licenses\gg1.yml", "YAML", 0, 0, 0, 5, 0, 0, 1, 6
"d:\IDEWORK\lvmen\src\licensedcode\data\licenses\ghostpdl-permissive.yml", "YAML", 0, 0, 0, 7, 0, 0, 1, 8
"d:\IDEWORK\lvmen\src\licensedcode\data\licenses\ghostscript-1988.yml", "YAML", 0, 0, 0, 19, 0, 0, 1, 20
"d:\IDEWORK\lvmen\src\licensedcode\data\licenses\github terms of service.yml", "YAML", 0, 0, 0, 5, 0, 0, 1, 6
"d:\IDEWORK\lvmen\src\licensedcode\data\licenses\gitlab.com terms.yml", "YAML", 0, 0, 0, 5, 0, 0, 1, 6
"d:\IDEWORK\lvmen\src\licensedcode\data\licenses\gl2ps.yml", "YAML", 0, 0, 0, 14, 0, 0, 1, 15
"d:\IDEWORK\lvmen\src\licensedcode\data\licenses\glide.yml", "YAML", 0, 0, 0, 19, 0, 0, 1, 20
"d:\IDEWORK\lvmen\src\licensedcode\data\licenses\glulxe.yml", "YAML", 0, 0, 0, 8, 0, 0, 1, 9
"d:\IDEWORK\lvmen\src\licensedcode\data\licenses\glut.yml", "YAML", 0, 0, 0, 6, 0, 0, 1, 7
"d:\IDEWORK\lvmen\src\licensedcode\data\licenses\glwtpl.yml", "YAML", 0, 0, 0, 14, 0, 0, 2, 16
"d:\IDEWORK\lvmen\src\licensedcode\data\licenses\gnu lesser general public license.yml", "YAML", 0, 0, 0, 5, 0, 0, 1, 6
"d:\IDEWORK\lvmen\src\licensedcode\data\licenses\gnu-emacs-gpl-1988.yml", "YAML", 0, 0, 0, 15, 0, 0, 1, 16
"d:\IDEWORK\lvmen\src\licensedcode\data\licenses\gnu-javamail-exception.yml", "YAML", 0, 0, 0, 17, 0, 0, 1, 18
"d:\IDEWORK\lvmen\src\licensedcode\data\licenses\gnuplot.yml", "YAML", 0, 0, 0, 10, 0, 0, 1, 11
"d:\IDEWORK\lvmen\src\licensedcode\data\licenses\goahead.yml", "YAML", 0, 0, 0, 18, 0, 0, 1, 19
"d:\IDEWORK\lvmen\src\licensedcode\data\licenses\google apis terms of service.yml", "YAML", 0, 0, 0, 5, 0, 0, 1, 6
"d:\IDEWORK\lvmen\src\licensedcode\data\licenses\google apps for education - user end terms of service.yml", "YAML", 0, 0, 0, 5, 0, 0, 1, 6
"d:\IDEWORK\lvmen\src\licensedcode\data\licenses\google play developer distribution agreement.yml", "YAML", 0, 0, 0, 5, 0, 0, 1, 6
"d:\IDEWORK\lvmen\src\licensedcode\data\licenses\google-analytics-tos-2015.yml", "YAML", 0, 0, 0, 16, 0, 0, 1, 17
"d:\IDEWORK\lvmen\src\licensedcode\data\licenses\google-analytics-tos-2016.yml", "YAML", 0, 0, 0, 18, 0, 0, 1, 19
"d:\IDEWORK\lvmen\src\licensedcode\data\licenses\google-analytics-tos-2019.yml", "YAML", 0, 0, 0, 19, 0, 0, 2, 21
"d:\IDEWORK\lvmen\src\licensedcode\data\licenses\google-analytics-tos.yml", "YAML", 0, 0, 0, 17, 0, 0, 1, 18
"d:\IDEWORK\lvmen\src\licensedcode\data\licenses\google-maps-tos-2018-02-07.yml", "YAML", 0, 0, 0, 23, 0, 0, 2, 25
"d:\IDEWORK\lvmen\src\licensedcode\data\licenses\google-maps-tos-2018-05-01.yml", "YAML", 0, 0, 0, 35, 0, 0, 2, 37
"d:\IDEWORK\lvmen\src\licensedcode\data\licenses\google-maps-tos-2018-06-07.yml", "YAML", 0, 0, 0, 34, 0, 0, 2, 36
"d:\IDEWORK\lvmen\src\licensedcode\data\licenses\google-maps-tos-2018-07-09.yml", "YAML", 0, 0, 0, 35, 0, 0, 2, 37
"d:\IDEWORK\lvmen\src\licensedcode\data\licenses\google-maps-tos-2018-07-19.yml", "YAML", 0, 0, 0, 34, 0, 0, 2, 36
"d:\IDEWORK\lvmen\src\licensedcode\data\licenses\google-maps-tos-2018-10-01.yml", "YAML", 0, 0, 0, 34, 0, 0, 2, 36
"d:\IDEWORK\lvmen\src\licensedcode\data\licenses\google-maps-tos-2018-10-31.yml", "YAML", 0, 0, 0, 34, 0, 0, 2, 36
"d:\IDEWORK\lvmen\src\licensedcode\data\licenses\google-maps-tos-2019-05-02.yml", "YAML", 0, 0, 0, 33, 0, 0, 2, 35
"d:\IDEWORK\lvmen\src\licensedcode\data\licenses\google-maps-tos-2019-11-21.yml", "YAML", 0, 0, 0, 33, 0, 0, 2, 35
"d:\IDEWORK\lvmen\src\licensedcode\data\licenses\google-maps-tos-2020-04-02.yml", "YAML", 0, 0, 0, 33, 0, 0, 2, 35
"d:\IDEWORK\lvmen\src\licensedcode\data\licenses\google-maps-tos-2020-04-27.yml", "YAML", 0, 0, 0, 33, 0, 0, 2, 35
"d:\IDEWORK\lvmen\src\licensedcode\data\licenses\google-maps-tos-2020-05-06.yml", "YAML", 0, 0, 0, 34, 0, 0, 2, 36
"d:\IDEWORK\lvmen\src\licensedcode\data\licenses\google-patent-license-fuchsia.yml", "YAML", 0, 0, 0, 10, 0, 0, 1, 11
"d:\IDEWORK\lvmen\src\licensedcode\data\licenses\google-patent-license-fuschia.yml", "YAML", 0, 0, 0, 10, 0, 0, 0, 10
"d:\IDEWORK\lvmen\src\licensedcode\data\licenses\google-patent-license-golang.yml", "YAML", 0, 0, 0, 7, 0, 0, 1, 8
"d:\IDEWORK\lvmen\src\licensedcode\data\licenses\google-patent-license-webm.yml", "YAML", 0, 0, 0, 7, 0, 0, 1, 8
"d:\IDEWORK\lvmen\src\licensedcode\data\licenses\google-patent-license-webrtc.yml", "YAML", 0, 0, 0, 7, 0, 0, 1, 8
"d:\IDEWORK\lvmen\src\licensedcode\data\licenses\google-patent-license.yml", "YAML", 0, 0, 0, 6, 0, 0, 1, 7
"d:\IDEWORK\lvmen\src\licensedcode\data\licenses\google-tos-2013.yml", "YAML", 0, 0, 0, 7, 0, 0, 1, 8
"d:\IDEWORK\lvmen\src\licensedcode\data\licenses\google-tos-2014.yml", "YAML", 0, 0, 0, 7, 0, 0, 1, 8
"d:\IDEWORK\lvmen\src\licensedcode\data\licenses\google-tos-2017.yml", "YAML", 0, 0, 0, 7, 0, 0, 1, 8
"d:\IDEWORK\lvmen\src\licensedcode\data\licenses\google-tos-2019.yml", "YAML", 0, 0, 0, 7, 0, 0, 1, 8
"d:\IDEWORK\lvmen\src\licensedcode\data\licenses\google-tos-2020.yml", "YAML", 0, 0, 0, 7, 0, 0, 1, 8
"d:\IDEWORK\lvmen\src\licensedcode\data\licenses\gopro app.yml", "YAML", 0, 0, 0, 5, 0, 0, 1, 6
"d:\IDEWORK\lvmen\src\licensedcode\data\licenses\gpl-1.0-plus.yml", "YAML", 0, 0, 0, 22, 0, 0, 2, 24
"d:\IDEWORK\lvmen\src\licensedcode\data\licenses\gpl-1.0.yml", "YAML", 0, 0, 0, 23, 0, 0, 1, 24
"d:\IDEWORK\lvmen\src\licensedcode\data\licenses\gpl-2.0-adaptec.yml", "YAML", 0, 0, 0, 8, 0, 0, 1, 9
"d:\IDEWORK\lvmen\src\licensedcode\data\licenses\gpl-2.0-autoconf.yml", "YAML", 0, 0, 0, 11, 0, 0, 0, 11
"d:\IDEWORK\lvmen\src\licensedcode\data\licenses\gpl-2.0-autoopts.yml", "YAML", 0, 0, 0, 8, 0, 0, 1, 9
"d:\IDEWORK\lvmen\src\licensedcode\data\licenses\gpl-2.0-bison-2.2.yml", "YAML", 0, 0, 0, 10, 0, 0, 1, 11
"d:\IDEWORK\lvmen\src\licensedcode\data\licenses\gpl-2.0-bison.yml", "YAML", 0, 0, 0, 11, 0, 0, 1, 12
"d:\IDEWORK\lvmen\src\licensedcode\data\licenses\gpl-2.0-broadcom-linking.yml", "YAML", 0, 0, 0, 8, 0, 0, 1, 9
"d:\IDEWORK\lvmen\src\licensedcode\data\licenses\gpl-2.0-classpath.yml", "YAML", 0, 0, 0, 14, 0, 0, 1, 15
"d:\IDEWORK\lvmen\src\licensedcode\data\licenses\gpl-2.0-cygwin.yml", "YAML", 0, 0, 0, 11, 0, 0, 1, 12
"d:\IDEWORK\lvmen\src\licensedcode\data\licenses\gpl-2.0-djvu.yml", "YAML", 0, 0, 0, 15, 0, 0, 1, 16
"d:\IDEWORK\lvmen\src\licensedcode\data\licenses\gpl-2.0-font.yml", "YAML", 0, 0, 0, 12, 0, 0, 0, 12
"d:\IDEWORK\lvmen\src\licensedcode\data\licenses\gpl-2.0-freertos.yml", "YAML", 0, 0, 0, 11, 0, 0, 1, 12
"d:\IDEWORK\lvmen\src\licensedcode\data\licenses\gpl-2.0-gcc-compiler-exception.yml", "YAML", 0, 0, 0, 10, 0, 0, 0, 10
"d:\IDEWORK\lvmen\src\licensedcode\data\licenses\gpl-2.0-gcc.yml", "YAML", 0, 0, 0, 12, 0, 0, 0, 12
"d:\IDEWORK\lvmen\src\licensedcode\data\licenses\gpl-2.0-glibc.yml", "YAML", 0, 0, 0, 11, 0, 0, 1, 12
"d:\IDEWORK\lvmen\src\licensedcode\data\licenses\gpl-2.0-guile.yml", "YAML", 0, 0, 0, 8, 0, 0, 0, 8
"d:\IDEWORK\lvmen\src\licensedcode\data\licenses\gpl-2.0-ice.yml", "YAML", 0, 0, 0, 11, 0, 0, 1, 12
"d:\IDEWORK\lvmen\src\licensedcode\data\licenses\gpl-2.0-independent-module-linking.yml", "YAML", 0, 0, 0, 9, 0, 0, 1, 10
"d:\IDEWORK\lvmen\src\licensedcode\data\licenses\gpl-2.0-iolib.yml", "YAML", 0, 0, 0, 8, 0, 0, 1, 9
"d:\IDEWORK\lvmen\src\licensedcode\data\licenses\gpl-2.0-iso-cpp.yml", "YAML", 0, 0, 0, 11, 0, 0, 0, 11
"d:\IDEWORK\lvmen\src\licensedcode\data\licenses\gpl-2.0-javascript.yml", "YAML", 0, 0, 0, 11, 0, 0, 1, 12
"d:\IDEWORK\lvmen\src\licensedcode\data\licenses\gpl-2.0-kernel.yml", "YAML", 0, 0, 0, 8, 0, 0, 0, 8
"d:\IDEWORK\lvmen\src\licensedcode\data\licenses\gpl-2.0-koterov.yml", "YAML", 0, 0, 0, 13, 0, 0, 1, 14
"d:\IDEWORK\lvmen\src\licensedcode\data\licenses\gpl-2.0-libgit2.yml", "YAML", 0, 0, 0, 18, 0, 0, 1, 19
"d:\IDEWORK\lvmen\src\licensedcode\data\licenses\gpl-2.0-library.yml", "YAML", 0, 0, 0, 13, 0, 0, 1, 14
"d:\IDEWORK\lvmen\src\licensedcode\data\licenses\gpl-2.0-libtool.yml", "YAML", 0, 0, 0, 8, 0, 0, 0, 8
"d:\IDEWORK\lvmen\src\licensedcode\data\licenses\gpl-2.0-lmbench.yml", "YAML", 0, 0, 0, 8, 0, 0, 1, 9
"d:\IDEWORK\lvmen\src\licensedcode\data\licenses\gpl-2.0-mysql-connector-odbc.yml", "YAML", 0, 0, 0, 11, 0, 0, 0, 11
"d:\IDEWORK\lvmen\src\licensedcode\data\licenses\gpl-2.0-mysql-floss.yml", "YAML", 0, 0, 0, 11, 0, 0, 0, 11
"d:\IDEWORK\lvmen\src\licensedcode\data\licenses\gpl-2.0-openjdk.yml", "YAML", 0, 0, 0, 11, 0, 0, 1, 12
"d:\IDEWORK\lvmen\src\licensedcode\data\licenses\gpl-2.0-openssl.yml", "YAML", 0, 0, 0, 14, 0, 0, 0, 14
"d:\IDEWORK\lvmen\src\licensedcode\data\licenses\gpl-2.0-oracle-mysql-foss.yml", "YAML", 0, 0, 0, 9, 0, 0, 1, 10
"d:\IDEWORK\lvmen\src\licensedcode\data\licenses\gpl-2.0-oracle-openjdk.yml", "YAML", 0, 0, 0, 11, 0, 0, 1, 12
"d:\IDEWORK\lvmen\src\licensedcode\data\licenses\gpl-2.0-plus-ada.yml", "YAML", 0, 0, 0, 10, 0, 0, 1, 11
"d:\IDEWORK\lvmen\src\licensedcode\data\licenses\gpl-2.0-plus-ekiga.yml", "YAML", 0, 0, 0, 8, 0, 0, 1, 9
"d:\IDEWORK\lvmen\src\licensedcode\data\licenses\gpl-2.0-plus-gcc.yml", "YAML", 0, 0, 0, 9, 0, 0, 1, 10
"d:\IDEWORK\lvmen\src\licensedcode\data\licenses\gpl-2.0-plus-geoserver.yml", "YAML", 0, 0, 0, 13, 0, 0, 1, 14
"d:\IDEWORK\lvmen\src\licensedcode\data\licenses\gpl-2.0-plus-linking.yml", "YAML", 0, 0, 0, 8, 0, 0, 1, 9
"d:\IDEWORK\lvmen\src\licensedcode\data\licenses\gpl-2.0-plus-nant.yml", "YAML", 0, 0, 0, 7, 0, 0, 1, 8
"d:\IDEWORK\lvmen\src\licensedcode\data\licenses\gpl-2.0-plus-openmotif.yml", "YAML", 0, 0, 0, 11, 0, 0, 1, 12
"d:\IDEWORK\lvmen\src\licensedcode\data\licenses\gpl-2.0-plus-openssl.yml", "YAML", 0, 0, 0, 9, 0, 0, 1, 10
"d:\IDEWORK\lvmen\src\licensedcode\data\licenses\gpl-2.0-plus-sane.yml", "YAML", 0, 0, 0, 10, 0, 0, 1, 11
"d:\IDEWORK\lvmen\src\licensedcode\data\licenses\gpl-2.0-plus-subcommander.yml", "YAML", 0, 0, 0, 8, 0, 0, 1, 9
"d:\IDEWORK\lvmen\src\licensedcode\data\licenses\gpl-2.0-plus-syntext.yml", "YAML", 0, 0, 0, 8, 0, 0, 1, 9
"d:\IDEWORK\lvmen\src\licensedcode\data\licenses\gpl-2.0-plus-upx.yml", "YAML", 0, 0, 0, 12, 0, 0, 1, 13
"d:\IDEWORK\lvmen\src\licensedcode\data\licenses\gpl-2.0-plus.yml", "YAML", 0, 0, 0, 27, 0, 0, 2, 29
"d:\IDEWORK\lvmen\src\licensedcode\data\licenses\gpl-2.0-proguard.yml", "YAML", 0, 0, 0, 9, 0, 0, 1, 10
"d:\IDEWORK\lvmen\src\licensedcode\data\licenses\gpl-2.0-qt-qca.yml", "YAML", 0, 0, 0, 9, 0, 0, 1, 10
"d:\IDEWORK\lvmen\src\licensedcode\data\licenses\gpl-2.0-redhat.yml", "YAML", 0, 0, 0, 11, 0, 0, 1, 12
"d:\IDEWORK\lvmen\src\licensedcode\data\licenses\gpl-2.0-rrdtool-floss.yml", "YAML", 0, 0, 0, 9, 0, 0, 1, 10
"d:\IDEWORK\lvmen\src\licensedcode\data\licenses\gpl-2.0-uboot.yml", "YAML", 0, 0, 0, 11, 0, 0, 0, 11
"d:\IDEWORK\lvmen\src\licensedcode\data\licenses\gpl-2.0.yml", "YAML", 0, 0, 0, 45, 0, 0, 2, 47
"d:\IDEWORK\lvmen\src\licensedcode\data\licenses\gpl-3.0-aptana.yml", "YAML", 0, 0, 0, 11, 0, 0, 1, 12
"d:\IDEWORK\lvmen\src\licensedcode\data\licenses\gpl-3.0-autoconf.yml", "YAML", 0, 0, 0, 12, 0, 0, 0, 12
"d:\IDEWORK\lvmen\src\licensedcode\data\licenses\gpl-3.0-bison.yml", "YAML", 0, 0, 0, 10, 0, 0, 0, 10
"d:\IDEWORK\lvmen\src\licensedcode\data\licenses\gpl-3.0-cygwin.yml", "YAML", 0, 0, 0, 14, 0, 0, 1, 15
"d:\IDEWORK\lvmen\src\licensedcode\data\licenses\gpl-3.0-font.yml", "YAML", 0, 0, 0, 9, 0, 0, 1, 10
"d:\IDEWORK\lvmen\src\licensedcode\data\licenses\gpl-3.0-gcc.yml", "YAML", 0, 0, 0, 13, 0, 0, 0, 13
"d:\IDEWORK\lvmen\src\licensedcode\data\licenses\gpl-3.0-linking-exception.yml", "YAML", 0, 0, 0, 8, 0, 0, 1, 9
"d:\IDEWORK\lvmen\src\licensedcode\data\licenses\gpl-3.0-linking-source-exception.yml", "YAML", 0, 0, 0, 10, 0, 0, 1, 11
"d:\IDEWORK\lvmen\src\licensedcode\data\licenses\gpl-3.0-openbd.yml", "YAML", 0, 0, 0, 14, 0, 0, 1, 15
"d:\IDEWORK\lvmen\src\licensedcode\data\licenses\gpl-3.0-plus-openssl.yml", "YAML", 0, 0, 0, 8, 0, 0, 1, 9
"d:\IDEWORK\lvmen\src\licensedcode\data\licenses\gpl-3.0-plus.yml", "YAML", 0, 0, 0, 29, 0, 0, 1, 30
"d:\IDEWORK\lvmen\src\licensedcode\data\licenses\gpl-3.0.yml", "YAML", 0, 0, 0, 32, 0, 0, 1, 33
"d:\IDEWORK\lvmen\src\licensedcode\data\licenses\gpl-generic-additional-terms.yml", "YAML", 0, 0, 0, 9, 0, 0, 1, 10
"d:\IDEWORK\lvmen\src\licensedcode\data\licenses\gplcc-1.0.yml", "YAML", 0, 0, 0, 22, 0, 0, 1, 23
"d:\IDEWORK\lvmen\src\licensedcode\data\licenses\graphics-gems.yml", "YAML", 0, 0, 0, 9, 0, 0, 1, 10
"d:\IDEWORK\lvmen\src\licensedcode\data\licenses\greg-roelofs.yml", "YAML", 0, 0, 0, 10, 0, 0, 1, 11
"d:\IDEWORK\lvmen\src\licensedcode\data\licenses\gregory-pietsch.yml", "YAML", 0, 0, 0, 6, 0, 0, 1, 7
"d:\IDEWORK\lvmen\src\licensedcode\data\licenses\gridslider.yml", "YAML", 0, 0, 0, 5, 0, 0, 1, 6
"d:\IDEWORK\lvmen\src\licensedcode\data\licenses\gsoap-1.3a.yml", "YAML", 0, 0, 0, 15, 0, 0, 1, 16
"d:\IDEWORK\lvmen\src\licensedcode\data\licenses\gsoap-1.3b.yml", "YAML", 0, 0, 0, 20, 0, 0, 1, 21
"d:\IDEWORK\lvmen\src\licensedcode\data\licenses\gstreamer-exception-2.0.yml", "YAML", 0, 0, 0, 10, 0, 4, 1, 15
"d:\IDEWORK\lvmen\src\licensedcode\data\licenses\guile-exception-2.0.yml", "YAML", 0, 0, 0, 39, 0, 0, 1, 40
"d:\IDEWORK\lvmen\src\licensedcode\data\licenses\gust-font-1.0.yml", "YAML", 0, 0, 0, 12, 0, 0, 1, 13
"d:\IDEWORK\lvmen\src\licensedcode\data\licenses\gust-font-2006-09-30.yml", "YAML", 0, 0, 0, 12, 0, 0, 1, 13
"d:\IDEWORK\lvmen\src\licensedcode\data\licenses\gutenberg-2020.yml", "YAML", 0, 0, 0, 15, 0, 0, 1, 16
"d:\IDEWORK\lvmen\src\licensedcode\data\licenses\h2-1.0.yml", "YAML", 0, 0, 0, 13, 0, 0, 1, 14
"d:\IDEWORK\lvmen\src\licensedcode\data\licenses\hacos-1.2.yml", "YAML", 0, 0, 0, 13, 0, 0, 1, 14
"d:\IDEWORK\lvmen\src\licensedcode\data\licenses\haskell-report.yml", "YAML", 0, 0, 0, 8, 0, 0, 1, 9
"d:\IDEWORK\lvmen\src\licensedcode\data\licenses\hauppauge-firmware-eula.yml", "YAML", 0, 0, 0, 7, 0, 0, 1, 8
"d:\IDEWORK\lvmen\src\licensedcode\data\licenses\hauppauge-firmware-oem.yml", "YAML", 0, 0, 0, 7, 0, 0, 1, 8
"d:\IDEWORK\lvmen\src\licensedcode\data\licenses\haxcv license.yml", "YAML", 0, 0, 0, 5, 0, 0, 1, 6
"d:\IDEWORK\lvmen\src\licensedcode\data\licenses\hazelcast-community-1.0.yml", "YAML", 0, 0, 0, 9, 0, 0, 1, 10
"d:\IDEWORK\lvmen\src\licensedcode\data\licenses\hbscrollpageview.yml", "YAML", 0, 0, 0, 5, 0, 0, 1, 6
"d:\IDEWORK\lvmen\src\licensedcode\data\licenses\hdf4.yml", "YAML", 0, 0, 0, 55, 0, 0, 1, 56
"d:\IDEWORK\lvmen\src\licensedcode\data\licenses\hdf5.yml", "YAML", 0, 0, 0, 11, 0, 0, 1, 12
"d:\IDEWORK\lvmen\src\licensedcode\data\licenses\hdparm.yml", "YAML", 0, 0, 0, 9, 0, 0, 1, 10
"d:\IDEWORK\lvmen\src\licensedcode\data\licenses\helios-eula.yml", "YAML", 0, 0, 0, 9, 0, 0, 1, 10
"d:\IDEWORK\lvmen\src\licensedcode\data\licenses\helix.yml", "YAML", 0, 0, 0, 15, 0, 0, 1, 16
"d:\IDEWORK\lvmen\src\licensedcode\data\licenses\henry-spencer-1999.yml", "YAML", 0, 0, 0, 10, 0, 0, 0, 10
"d:\IDEWORK\lvmen\src\licensedcode\data\licenses\here-proprietary.yml", "YAML", 0, 0, 0, 8, 0, 0, 1, 9
"d:\IDEWORK\lvmen\src\licensedcode\data\licenses\hessla.yml", "YAML", 0, 0, 0, 9, 0, 0, 1, 10
"d:\IDEWORK\lvmen\src\licensedcode\data\licenses\hidapi.yml", "YAML", 0, 0, 0, 7, 0, 0, 1, 8
"d:\IDEWORK\lvmen\src\licensedcode\data\licenses\hippocratic-1.0.yml", "YAML", 0, 0, 0, 7, 0, 0, 1, 8
"d:\IDEWORK\lvmen\src\licensedcode\data\licenses\hippocratic-1.1.yml", "YAML", 0, 0, 0, 7, 0, 0, 1, 8
"d:\IDEWORK\lvmen\src\licensedcode\data\licenses\hippocratic-1.2.yml", "YAML", 0, 0, 0, 14, 0, 0, 1, 15
"d:\IDEWORK\lvmen\src\licensedcode\data\licenses\hippocratic-2.0.yml", "YAML", 0, 0, 0, 17, 0, 0, 1, 18
"d:\IDEWORK\lvmen\src\licensedcode\data\licenses\hippocratic-2.1.yml", "YAML", 0, 0, 0, 16, 0, 0, 1, 17
"d:\IDEWORK\lvmen\src\licensedcode\data\licenses\historical-ntp.yml", "YAML", 0, 0, 0, 9, 0, 0, 1, 10
"d:\IDEWORK\lvmen\src\licensedcode\data\licenses\historical-sell-variant.yml", "YAML", 0, 0, 0, 11, 0, 1, 1, 13
"d:\IDEWORK\lvmen\src\licensedcode\data\licenses\historical.yml", "YAML", 0, 0, 0, 17, 0, 0, 1, 18
"d:\IDEWORK\lvmen\src\licensedcode\data\licenses\hisuite.yml", "YAML", 0, 0, 0, 5, 0, 0, 1, 6
"d:\IDEWORK\lvmen\src\licensedcode\data\licenses\hot-potato.yml", "YAML", 0, 0, 0, 7, 0, 0, 1, 8
"d:\IDEWORK\lvmen\src\licensedcode\data\licenses\hover figure caption with mouse direction.yml", "YAML", 0, 0, 0, 5, 0, 0, 1, 6
"d:\IDEWORK\lvmen\src\licensedcode\data\licenses\hp-enterprise-eula.yml", "YAML", 0, 0, 0, 15, 0, 0, 1, 16
"d:\IDEWORK\lvmen\src\licensedcode\data\licenses\hp-netperf.yml", "YAML", 0, 0, 0, 13, 0, 0, 1, 14
"d:\IDEWORK\lvmen\src\licensedcode\data\licenses\hp-proliant-essentials.yml", "YAML", 0, 0, 0, 14, 0, 0, 1, 15
"d:\IDEWORK\lvmen\src\licensedcode\data\licenses\hp-snmp-pp.yml", "YAML", 0, 0, 0, 22, 0, 0, 1, 23
"d:\IDEWORK\lvmen\src\licensedcode\data\licenses\hp-software-eula.yml", "YAML", 0, 0, 0, 11, 0, 0, 1, 12
"d:\IDEWORK\lvmen\src\licensedcode\data\licenses\hp-ux-java.yml", "YAML", 0, 0, 0, 13, 0, 0, 1, 14
"d:\IDEWORK\lvmen\src\licensedcode\data\licenses\hp-ux-jre.yml", "YAML", 0, 0, 0, 10, 0, 0, 1, 11
"d:\IDEWORK\lvmen\src\licensedcode\data\licenses\hp.yml", "YAML", 0, 0, 0, 13, 0, 0, 1, 14
"d:\IDEWORK\lvmen\src\licensedcode\data\licenses\hs-regexp-orig.yml", "YAML", 0, 0, 0, 9, 0, 0, 1, 10
"d:\IDEWORK\lvmen\src\licensedcode\data\licenses\hs-regexp.yml", "YAML", 0, 0, 0, 18, 0, 0, 1, 19
"d:\IDEWORK\lvmen\src\licensedcode\data\licenses\html5.yml", "YAML", 0, 0, 0, 11, 0, 0, 1, 12
"d:\IDEWORK\lvmen\src\licensedcode\data\licenses\httpget.yml", "YAML", 0, 0, 0, 13, 0, 0, 1, 14
"d:\IDEWORK\lvmen\src\licensedcode\data\licenses\hx711_spi.yml", "YAML", 0, 0, 0, 5, 0, 0, 1, 6
"d:\IDEWORK\lvmen\src\licensedcode\data\licenses\hxd.yml", "YAML", 0, 0, 0, 9, 0, 0, 1, 10
"d:\IDEWORK\lvmen\src\licensedcode\data\licenses\i2p-gpl-java-exception.yml", "YAML", 0, 0, 0, 30, 0, 0, 1, 31
"d:\IDEWORK\lvmen\src\licensedcode\data\licenses\ian-kaplan.yml", "YAML", 0, 0, 0, 6, 0, 0, 1, 7
"d:\IDEWORK\lvmen\src\licensedcode\data\licenses\ian-piumarta.yml", "YAML", 0, 0, 0, 7, 0, 0, 1, 8
"d:\IDEWORK\lvmen\src\licensedcode\data\licenses\ibm-as-is.yml", "YAML", 0, 0, 0, 10, 0, 0, 1, 11
"d:\IDEWORK\lvmen\src\licensedcode\data\licenses\ibm-developerworks-community-download.yml", "YAML", 0, 0, 0, 9, 0, 0, 1, 10
"d:\IDEWORK\lvmen\src\licensedcode\data\licenses\ibm-dhcp.yml", "YAML", 0, 0, 0, 8, 0, 0, 1, 9
"d:\IDEWORK\lvmen\src\licensedcode\data\licenses\ibm-icu.yml", "YAML", 0, 0, 0, 48, 0, 0, 1, 49
"d:\IDEWORK\lvmen\src\licensedcode\data\licenses\ibm-jre.yml", "YAML", 0, 0, 0, 13, 0, 0, 1, 14
"d:\IDEWORK\lvmen\src\licensedcode\data\licenses\ibm-nwsc.yml", "YAML", 0, 0, 0, 7, 0, 0, 1, 8
"d:\IDEWORK\lvmen\src\licensedcode\data\licenses\ibm-pibs.yml", "YAML", 0, 0, 0, 14, 0, 0, 1, 15
"d:\IDEWORK\lvmen\src\licensedcode\data\licenses\ibm-sample.yml", "YAML", 0, 0, 0, 8, 0, 0, 1, 9
"d:\IDEWORK\lvmen\src\licensedcode\data\licenses\ibmpl-1.0.yml", "YAML", 0, 0, 0, 22, 0, 0, 1, 23
"d:\IDEWORK\lvmen\src\licensedcode\data\licenses\ibpp.yml", "YAML", 0, 0, 0, 7, 0, 0, 1, 8
"d:\IDEWORK\lvmen\src\licensedcode\data\licenses\icann-public.yml", "YAML", 0, 0, 0, 7, 0, 0, 1, 8
"d:\IDEWORK\lvmen\src\licensedcode\data\licenses\ice-exception-2.0.yml", "YAML", 0, 0, 0, 51, 0, 0, 1, 52
"d:\IDEWORK\lvmen\src\licensedcode\data\licenses\icot-free.yml", "YAML", 0, 0, 0, 7, 0, 0, 1, 8
"d:\IDEWORK\lvmen\src\licensedcode\data\licenses\idgaf v1.0.yml", "YAML", 0, 0, 0, 5, 0, 0, 1, 6
"d:\IDEWORK\lvmen\src\licensedcode\data\licenses\idt-notice.yml", "YAML", 0, 0, 0, 6, 0, 0, 1, 7
"d:\IDEWORK\lvmen\src\licensedcode\data\licenses\ietf-trust.yml", "YAML", 0, 0, 0, 32, 0, 0, 1, 33
"d:\IDEWORK\lvmen\src\licensedcode\data\licenses\ietf.yml", "YAML", 0, 0, 0, 10, 0, 0, 1, 11
"d:\IDEWORK\lvmen\src\licensedcode\data\licenses\ijg.yml", "YAML", 0, 0, 0, 25, 0, 0, 1, 26
"d:\IDEWORK\lvmen\src\licensedcode\data\licenses\ilmid.yml", "YAML", 0, 0, 0, 9, 0, 0, 1, 10
"d:\IDEWORK\lvmen\src\licensedcode\data\licenses\imagemagick.yml", "YAML", 0, 0, 0, 18, 0, 0, 1, 19
"d:\IDEWORK\lvmen\src\licensedcode\data\licenses\imagen.yml", "YAML", 0, 0, 0, 6, 0, 0, 1, 7
"d:\IDEWORK\lvmen\src\licensedcode\data\licenses\imlib2.yml", "YAML", 0, 0, 0, 12, 0, 0, 1, 13
"d:\IDEWORK\lvmen\src\licensedcode\data\licenses\independent-module-linking-exception.yml", "YAML", 0, 0, 0, 8, 0, 0, 1, 9
"d:\IDEWORK\lvmen\src\licensedcode\data\licenses\indiana-extreme-1.2.yml", "YAML", 0, 0, 0, 19, 0, 0, 0, 19
"d:\IDEWORK\lvmen\src\licensedcode\data\licenses\indiana-extreme.yml", "YAML", 0, 0, 0, 16, 0, 0, 1, 17
"d:\IDEWORK\lvmen\src\licensedcode\data\licenses\infineon-free.yml", "YAML", 0, 0, 0, 6, 0, 0, 1, 7
"d:\IDEWORK\lvmen\src\licensedcode\data\licenses\info-zip-1997-10.yml", "YAML", 0, 0, 0, 35, 0, 0, 1, 36
"d:\IDEWORK\lvmen\src\licensedcode\data\licenses\info-zip-2001-01.yml", "YAML", 0, 0, 0, 15, 0, 0, 1, 16
"d:\IDEWORK\lvmen\src\licensedcode\data\licenses\info-zip-2002-02.yml", "YAML", 0, 0, 0, 16, 0, 0, 1, 17
"d:\IDEWORK\lvmen\src\licensedcode\data\licenses\info-zip-2003-05.yml", "YAML", 0, 0, 0, 16, 0, 0, 1, 17
"d:\IDEWORK\lvmen\src\licensedcode\data\licenses\info-zip-2004-05.yml", "YAML", 0, 0, 0, 15, 0, 0, 1, 16
"d:\IDEWORK\lvmen\src\licensedcode\data\licenses\info-zip-2005-02.yml", "YAML", 0, 0, 0, 16, 0, 0, 1, 17
"d:\IDEWORK\lvmen\src\licensedcode\data\licenses\info-zip-2007-03.yml", "YAML", 0, 0, 0, 16, 0, 0, 1, 17
"d:\IDEWORK\lvmen\src\licensedcode\data\licenses\info-zip-2009-01.yml", "YAML", 0, 0, 0, 16, 0, 0, 1, 17
"d:\IDEWORK\lvmen\src\licensedcode\data\licenses\info-zip.yml", "YAML", 0, 0, 0, 16, 0, 0, 1, 17
"d:\IDEWORK\lvmen\src\licensedcode\data\licenses\infonode-1.1.yml", "YAML", 0, 0, 0, 16, 0, 0, 1, 17
"d:\IDEWORK\lvmen\src\licensedcode\data\licenses\ingress.yml", "YAML", 0, 0, 0, 5, 0, 0, 1, 6
"d:\IDEWORK\lvmen\src\licensedcode\data\licenses\initial-developer-public.yml", "YAML", 0, 0, 0, 11, 0, 0, 1, 12
"d:\IDEWORK\lvmen\src\licensedcode\data\licenses\inner-net-2.0.yml", "YAML", 0, 0, 0, 10, 0, 0, 0, 10
"d:\IDEWORK\lvmen\src\licensedcode\data\licenses\inno-setup.yml", "YAML", 0, 0, 0, 18, 0, 0, 1, 19
"d:\IDEWORK\lvmen\src\licensedcode\data\licenses\inria-linking-exception.yml", "YAML", 0, 0, 0, 17, 0, 0, 1, 18
"d:\IDEWORK\lvmen\src\licensedcode\data\licenses\installsite.yml", "YAML", 0, 0, 0, 7, 0, 0, 1, 8
"d:\IDEWORK\lvmen\src\licensedcode\data\licenses\intel-acpi.yml", "YAML", 0, 0, 0, 16, 0, 0, 1, 17
"d:\IDEWORK\lvmen\src\licensedcode\data\licenses\intel-bcl.yml", "YAML", 0, 0, 0, 6, 0, 0, 1, 7
"d:\IDEWORK\lvmen\src\licensedcode\data\licenses\intel-bsd-2-clause.yml", "YAML", 0, 0, 0, 11, 0, 0, 1, 12
"d:\IDEWORK\lvmen\src\licensedcode\data\licenses\intel-bsd-export-control.yml", "YAML", 0, 0, 0, 16, 0, 0, 1, 17
"d:\IDEWORK\lvmen\src\licensedcode\data\licenses\intel-bsd.yml", "YAML", 0, 0, 0, 12, 0, 0, 1, 13
"d:\IDEWORK\lvmen\src\licensedcode\data\licenses\intel-code-samples.yml", "YAML", 0, 0, 0, 9, 0, 0, 1, 10
"d:\IDEWORK\lvmen\src\licensedcode\data\licenses\intel-confidential.yml", "YAML", 0, 0, 0, 6, 0, 0, 1, 7
"d:\IDEWORK\lvmen\src\licensedcode\data\licenses\intel-firmware.yml", "YAML", 0, 0, 0, 11, 0, 0, 1, 12
"d:\IDEWORK\lvmen\src\licensedcode\data\licenses\intel-master-eula-sw-dev-2016.yml", "YAML", 0, 0, 0, 13, 0, 0, 1, 14
"d:\IDEWORK\lvmen\src\licensedcode\data\licenses\intel-material.yml", "YAML", 0, 0, 0, 6, 0, 0, 1, 7
"d:\IDEWORK\lvmen\src\licensedcode\data\licenses\intel-mcu-2018.yml", "YAML", 0, 0, 0, 7, 0, 0, 1, 8
"d:\IDEWORK\lvmen\src\licensedcode\data\licenses\intel-microcode.yml", "YAML", 0, 0, 0, 8, 0, 0, 1, 9
"d:\IDEWORK\lvmen\src\licensedcode\data\licenses\intel-osl-1989.yml", "YAML", 0, 0, 0, 10, 0, 0, 1, 11
"d:\IDEWORK\lvmen\src\licensedcode\data\licenses\intel-osl-1993.yml", "YAML", 0, 0, 0, 6, 0, 0, 1, 7
"d:\IDEWORK\lvmen\src\licensedcode\data\licenses\intel-royalty-free.yml", "YAML", 0, 0, 0, 9, 0, 0, 1, 10
"d:\IDEWORK\lvmen\src\licensedcode\data\licenses\intel-sample-source-code-2015.yml", "YAML", 0, 0, 0, 9, 0, 0, 1, 10
"d:\IDEWORK\lvmen\src\licensedcode\data\licenses\intel-scl.yml", "YAML", 0, 0, 0, 8, 0, 0, 1, 9
"d:\IDEWORK\lvmen\src\licensedcode\data\licenses\intel.yml", "YAML", 0, 0, 0, 13, 0, 0, 1, 14
"d:\IDEWORK\lvmen\src\licensedcode\data\licenses\interbase-1.0.yml", "YAML", 0, 0, 0, 22, 0, 0, 1, 23
"d:\IDEWORK\lvmen\src\licensedcode\data\licenses\iolib-exception-2.0.yml", "YAML", 0, 0, 0, 28, 0, 0, 1, 29
"d:\IDEWORK\lvmen\src\licensedcode\data\licenses\iozone.yml", "YAML", 0, 0, 0, 7, 0, 0, 1, 8
"d:\IDEWORK\lvmen\src\licensedcode\data\licenses\ipa-font.yml", "YAML", 0, 0, 0, 15, 0, 0, 1, 16
"d:\IDEWORK\lvmen\src\licensedcode\data\licenses\iptc-2006.yml", "YAML", 0, 0, 0, 9, 0, 0, 1, 10
"d:\IDEWORK\lvmen\src\licensedcode\data\licenses\irfanview-eula.yml", "YAML", 0, 0, 0, 16, 0, 0, 1, 17
"d:\IDEWORK\lvmen\src\licensedcode\data\licenses\isc.yml", "YAML", 0, 0, 0, 23, 0, 0, 1, 24
"d:\IDEWORK\lvmen\src\licensedcode\data\licenses\iso-14496-10.yml", "YAML", 0, 0, 0, 6, 0, 0, 1, 7
"d:\IDEWORK\lvmen\src\licensedcode\data\licenses\iso-8879.yml", "YAML", 0, 0, 0, 6, 0, 0, 1, 7
"d:\IDEWORK\lvmen\src\licensedcode\data\licenses\iso-recorder.yml", "YAML", 0, 0, 0, 9, 0, 0, 1, 10
"d:\IDEWORK\lvmen\src\licensedcode\data\licenses\isotope-cla.yml", "YAML", 0, 0, 0, 7, 0, 0, 1, 8
"d:\IDEWORK\lvmen\src\licensedcode\data\licenses\issl-2018.yml", "YAML", 0, 0, 0, 14, 0, 0, 1, 15
"d:\IDEWORK\lvmen\src\licensedcode\data\licenses\itc-eula.yml", "YAML", 0, 0, 0, 9, 0, 0, 1, 10
"d:\IDEWORK\lvmen\src\licensedcode\data\licenses\itos systems .yml", "YAML", 0, 0, 0, 5, 0, 0, 1, 6
"d:\IDEWORK\lvmen\src\licensedcode\data\licenses\itu-t-gpl.yml", "YAML", 0, 0, 0, 9, 0, 0, 1, 10
"d:\IDEWORK\lvmen\src\licensedcode\data\licenses\itu-t.yml", "YAML", 0, 0, 0, 8, 0, 0, 1, 9
"d:\IDEWORK\lvmen\src\licensedcode\data\licenses\itu.yml", "YAML", 0, 0, 0, 15, 0, 0, 1, 16
"d:\IDEWORK\lvmen\src\licensedcode\data\licenses\itunes.yml", "YAML", 0, 0, 0, 11, 0, 0, 1, 12
"d:\IDEWORK\lvmen\src\licensedcode\data\licenses\itunesboss terms of service.yml", "YAML", 0, 0, 0, 5, 0, 0, 1, 6
"d:\IDEWORK\lvmen\src\licensedcode\data\licenses\ja-sig.yml", "YAML", 0, 0, 0, 15, 0, 0, 1, 16
"d:\IDEWORK\lvmen\src\licensedcode\data\licenses\jahia-1.3.1.yml", "YAML", 0, 0, 0, 14, 0, 0, 1, 15
"d:\IDEWORK\lvmen\src\licensedcode\data\licenses\jam-stapl.yml", "YAML", 0, 0, 0, 7, 0, 0, 1, 8
"d:\IDEWORK\lvmen\src\licensedcode\data\licenses\jam.yml", "YAML", 0, 0, 0, 6, 0, 0, 1, 7
"d:\IDEWORK\lvmen\src\licensedcode\data\licenses\jamon.yml", "YAML", 0, 0, 0, 14, 0, 0, 1, 15
"d:\IDEWORK\lvmen\src\licensedcode\data\licenses\jared m.f. open source public license.yml", "YAML", 0, 0, 0, 5, 0, 0, 1, 6
"d:\IDEWORK\lvmen\src\licensedcode\data\licenses\jared m.f. public license.yml", "YAML", 0, 0, 0, 5, 0, 0, 1, 6
"d:\IDEWORK\lvmen\src\licensedcode\data\licenses\jason-mayes.yml", "YAML", 0, 0, 0, 13, 0, 0, 1, 14
"d:\IDEWORK\lvmen\src\licensedcode\data\licenses\jasper-1.0.yml", "YAML", 0, 0, 0, 17, 0, 0, 1, 18
"d:\IDEWORK\lvmen\src\licensedcode\data\licenses\jasper-2.0.yml", "YAML", 0, 0, 0, 19, 0, 0, 1, 20
"d:\IDEWORK\lvmen\src\licensedcode\data\licenses\java-app-stub.yml", "YAML", 0, 0, 0, 10, 0, 0, 1, 11
"d:\IDEWORK\lvmen\src\licensedcode\data\licenses\java-research-1.5.yml", "YAML", 0, 0, 0, 10, 0, 0, 1, 11
"d:\IDEWORK\lvmen\src\licensedcode\data\licenses\javascript-exception-2.0.yml", "YAML", 0, 0, 0, 31, 0, 0, 1, 32
"d:\IDEWORK\lvmen\src\licensedcode\data\licenses\jboss-eula.yml", "YAML", 0, 0, 0, 18, 0, 0, 1, 19
"d:\IDEWORK\lvmen\src\licensedcode\data\licenses\jdl-1.1.x.yml", "YAML", 0, 0, 0, 5, 0, 0, 1, 6
"d:\IDEWORK\lvmen\src\licensedcode\data\licenses\jdom.yml", "YAML", 0, 0, 0, 15, 0, 0, 1, 16
"d:\IDEWORK\lvmen\src\licensedcode\data\licenses\jdragonsoap.yml", "YAML", 0, 0, 0, 5, 0, 0, 1, 6
"d:\IDEWORK\lvmen\src\licensedcode\data\licenses\jelurida-public-1.1.yml", "YAML", 0, 0, 0, 12, 0, 0, 2, 14
"d:\IDEWORK\lvmen\src\licensedcode\data\licenses\jetbrains-purchase-terms.yml", "YAML", 0, 0, 0, 10, 0, 0, 1, 11
"d:\IDEWORK\lvmen\src\licensedcode\data\licenses\jetbrains-toolbox-open-source-3.yml", "YAML", 0, 0, 0, 13, 0, 0, 1, 14
"d:\IDEWORK\lvmen\src\licensedcode\data\licenses\jetbrains.yml", "YAML", 0, 0, 0, 5, 0, 0, 1, 6
"d:\IDEWORK\lvmen\src\licensedcode\data\licenses\jetty-ccla-1.1.yml", "YAML", 0, 0, 0, 14, 0, 0, 1, 15
"d:\IDEWORK\lvmen\src\licensedcode\data\licenses\jetty.yml", "YAML", 0, 0, 0, 22, 0, 0, 1, 23
"d:\IDEWORK\lvmen\src\licensedcode\data\licenses\jgraph-general.yml", "YAML", 0, 0, 0, 9, 0, 0, 1, 10
"d:\IDEWORK\lvmen\src\licensedcode\data\licenses\jgraph.yml", "YAML", 0, 0, 0, 10, 0, 0, 1, 11
"d:\IDEWORK\lvmen\src\licensedcode\data\licenses\jide-sla.yml", "YAML", 0, 0, 0, 9, 0, 0, 1, 10
"d:\IDEWORK\lvmen\src\licensedcode\data\licenses\jj2000.yml", "YAML", 0, 0, 0, 10, 0, 0, 1, 11
"d:\IDEWORK\lvmen\src\licensedcode\data\licenses\jmagnetic.yml", "YAML", 0, 0, 0, 10, 0, 0, 1, 11
"d:\IDEWORK\lvmen\src\licensedcode\data\licenses\josl-1.0.yml", "YAML", 0, 0, 0, 20, 0, 0, 1, 21
"d:\IDEWORK\lvmen\src\licensedcode\data\licenses\jpnic-idnkit.yml", "YAML", 0, 0, 0, 17, 0, 0, 1, 18
"d:\IDEWORK\lvmen\src\licensedcode\data\licenses\jpnic-mdnkit.yml", "YAML", 0, 0, 0, 15, 0, 0, 1, 16
"d:\IDEWORK\lvmen\src\licensedcode\data\licenses\jprs-oscl-1.1.yml", "YAML", 0, 0, 0, 18, 0, 0, 1, 19
"d:\IDEWORK\lvmen\src\licensedcode\data\licenses\jpython-1.1.yml", "YAML", 0, 0, 0, 16, 0, 0, 1, 17
"d:\IDEWORK\lvmen\src\licensedcode\data\licenses\jquery-pd.yml", "YAML", 0, 0, 0, 7, 0, 0, 1, 8
"d:\IDEWORK\lvmen\src\licensedcode\data\licenses\jrunner.yml", "YAML", 0, 0, 0, 11, 0, 0, 1, 12
"d:\IDEWORK\lvmen\src\licensedcode\data\licenses\jscheme.yml", "YAML", 0, 0, 0, 9, 0, 0, 1, 10
"d:\IDEWORK\lvmen\src\licensedcode\data\licenses\jsfromhell.yml", "YAML", 0, 0, 0, 7, 0, 0, 1, 8
"d:\IDEWORK\lvmen\src\licensedcode\data\licenses\json-js-pd.yml", "YAML", 0, 0, 0, 13, 0, 0, 1, 14
"d:\IDEWORK\lvmen\src\licensedcode\data\licenses\json-pd.yml", "YAML", 0, 0, 0, 13, 0, 0, 1, 14
"d:\IDEWORK\lvmen\src\licensedcode\data\licenses\json.yml", "YAML", 0, 0, 0, 13, 0, 0, 2, 15
"d:\IDEWORK\lvmen\src\licensedcode\data\licenses\jsr-107-jcache-spec-2013.yml", "YAML", 0, 0, 0, 19, 0, 0, 1, 20
"d:\IDEWORK\lvmen\src\licensedcode\data\licenses\jsr-107-jcache-spec.yml", "YAML", 0, 0, 0, 15, 0, 0, 1, 16
"d:\IDEWORK\lvmen\src\licensedcode\data\licenses\jython.yml", "YAML", 0, 0, 0, 24, 0, 0, 1, 25
"d:\IDEWORK\lvmen\src\licensedcode\data\licenses\jzlib.yml", "YAML", 0, 0, 0, 5, 0, 0, 1, 6
"d:\IDEWORK\lvmen\src\licensedcode\data\licenses\kalle-kaukonen.yml", "YAML", 0, 0, 0, 9, 0, 0, 1, 10
"d:\IDEWORK\lvmen\src\licensedcode\data\licenses\karl-peterson.yml", "YAML", 0, 0, 0, 9, 0, 0, 1, 10
"d:\IDEWORK\lvmen\src\licensedcode\data\licenses\kaspersky security network.yml", "YAML", 0, 0, 0, 5, 0, 0, 1, 6
"d:\IDEWORK\lvmen\src\licensedcode\data\licenses\katharos-0.1.0.yml", "YAML", 0, 0, 0, 13, 0, 0, 2, 15
"d:\IDEWORK\lvmen\src\licensedcode\data\licenses\kde-accepted-gpl.yml", "YAML", 0, 0, 0, 10, 0, 0, 1, 11
"d:\IDEWORK\lvmen\src\licensedcode\data\licenses\kde-accepted-lgpl.yml", "YAML", 0, 0, 0, 10, 0, 0, 1, 11
"d:\IDEWORK\lvmen\src\licensedcode\data\licenses\keith-rule.yml", "YAML", 0, 0, 0, 6, 0, 0, 1, 7
"d:\IDEWORK\lvmen\src\licensedcode\data\licenses\kendoui.yml", "YAML", 0, 0, 0, 5, 0, 0, 1, 6
"d:\IDEWORK\lvmen\src\licensedcode\data\licenses\kerberos.yml", "YAML", 0, 0, 0, 22, 0, 0, 1, 23
"d:\IDEWORK\lvmen\src\licensedcode\data\licenses\kevan-stannard.yml", "YAML", 0, 0, 0, 40, 0, 0, 1, 41
"d:\IDEWORK\lvmen\src\licensedcode\data\licenses\kevlin-henney.yml", "YAML", 0, 0, 0, 6, 0, 0, 1, 7
"d:\IDEWORK\lvmen\src\licensedcode\data\licenses\kfkf.yml", "YAML", 0, 0, 0, 5, 0, 0, 1, 6
"d:\IDEWORK\lvmen\src\licensedcode\data\licenses\kfqf-accepted-gpl.yml", "YAML", 0, 0, 0, 13, 0, 0, 1, 14
"d:\IDEWORK\lvmen\src\licensedcode\data\licenses\khronos.yml", "YAML", 0, 0, 0, 13, 0, 0, 1, 14
"d:\IDEWORK\lvmen\src\licensedcode\data\licenses\kingsoft office 2013 license agreement.yml", "YAML", 0, 0, 0, 5, 0, 0, 1, 6
"d:\IDEWORK\lvmen\src\licensedcode\data\licenses\koaned privacy policy.yml", "YAML", 0, 0, 0, 5, 0, 0, 1, 6
"d:\IDEWORK\lvmen\src\licensedcode\data\licenses\kumar-robotics.yml", "YAML", 0, 0, 0, 19, 0, 0, 1, 20
"d:\IDEWORK\lvmen\src\licensedcode\data\licenses\lal-1.2.yml", "YAML", 0, 0, 0, 5, 0, 0, 1, 6
"d:\IDEWORK\lvmen\src\licensedcode\data\licenses\lal-1.3.yml", "YAML", 0, 0, 0, 5, 0, 0, 1, 6
"d:\IDEWORK\lvmen\src\licensedcode\data\licenses\larabie.yml", "YAML", 0, 0, 0, 13, 0, 0, 1, 14
"d:\IDEWORK\lvmen\src\licensedcode\data\licenses\latex2e.yml", "YAML", 0, 0, 0, 9, 0, 0, 1, 10
"d:\IDEWORK\lvmen\src\licensedcode\data\licenses\lavantech.yml", "YAML", 0, 0, 0, 11, 0, 0, 1, 12
"d:\IDEWORK\lvmen\src\licensedcode\data\licenses\lbnl-bsd.yml", "YAML", 0, 0, 0, 16, 0, 0, 2, 18
"d:\IDEWORK\lvmen\src\licensedcode\data\licenses\lcs-telegraphics.yml", "YAML", 0, 0, 0, 6, 0, 0, 1, 7
"d:\IDEWORK\lvmen\src\licensedcode\data\licenses\ldap-sdk-free-use.yml", "YAML", 0, 0, 0, 7, 0, 0, 1, 8
"d:\IDEWORK\lvmen\src\licensedcode\data\licenses\ldpc-1994.yml", "YAML", 0, 0, 0, 9, 0, 0, 1, 10
"d:\IDEWORK\lvmen\src\licensedcode\data\licenses\ldpc-1997.yml", "YAML", 0, 0, 0, 11, 0, 0, 1, 12
"d:\IDEWORK\lvmen\src\licensedcode\data\licenses\ldpc-1999.yml", "YAML", 0, 0, 0, 8, 0, 0, 1, 9
"d:\IDEWORK\lvmen\src\licensedcode\data\licenses\ldpgpl-1.yml", "YAML", 0, 0, 0, 8, 0, 0, 1, 9
"d:\IDEWORK\lvmen\src\licensedcode\data\licenses\ldpgpl-1a.yml", "YAML", 0, 0, 0, 8, 0, 0, 1, 9
"d:\IDEWORK\lvmen\src\licensedcode\data\licenses\ldpl-2.0.yml", "YAML", 0, 0, 0, 13, 0, 0, 1, 14
"d:\IDEWORK\lvmen\src\licensedcode\data\licenses\ldpm-1998.yml", "YAML", 0, 0, 0, 7, 0, 0, 1, 8
"d:\IDEWORK\lvmen\src\licensedcode\data\licenses\leap-motion-sdk-2019.yml", "YAML", 0, 0, 0, 13, 0, 0, 2, 15
"d:\IDEWORK\lvmen\src\licensedcode\data\licenses\leptonica.yml", "YAML", 0, 0, 0, 8, 0, 0, 1, 9
"d:\IDEWORK\lvmen\src\licensedcode\data\licenses\lgpl-2.0-fltk.yml", "YAML", 0, 0, 0, 9, 0, 0, 0, 9
"d:\IDEWORK\lvmen\src\licensedcode\data\licenses\lgpl-2.0-plus-gcc.yml", "YAML", 0, 0, 0, 9, 0, 0, 1, 10
"d:\IDEWORK\lvmen\src\licensedcode\data\licenses\lgpl-2.0-plus.yml", "YAML", 0, 0, 0, 24, 0, 0, 2, 26
"d:\IDEWORK\lvmen\src\licensedcode\data\licenses\lgpl-2.0.yml", "YAML", 0, 0, 0, 28, 0, 0, 1, 29
"d:\IDEWORK\lvmen\src\licensedcode\data\licenses\lgpl-2.1-digia-qt.yml", "YAML", 0, 0, 0, 9, 0, 0, 0, 9
"d:\IDEWORK\lvmen\src\licensedcode\data\licenses\lgpl-2.1-nokia-qt-1.0.yml", "YAML", 0, 0, 0, 8, 0, 0, 1, 9
"d:\IDEWORK\lvmen\src\licensedcode\data\licenses\lgpl-2.1-nokia-qt-1.1.yml", "YAML", 0, 0, 0, 10, 0, 0, 1, 11
"d:\IDEWORK\lvmen\src\licensedcode\data\licenses\lgpl-2.1-nokia-qt.yml", "YAML", 0, 0, 0, 11, 0, 0, 1, 12
"d:\IDEWORK\lvmen\src\licensedcode\data\licenses\lgpl-2.1-plus-linking.yml", "YAML", 0, 0, 0, 12, 0, 0, 1, 13
"d:\IDEWORK\lvmen\src\licensedcode\data\licenses\lgpl-2.1-plus-unlimited-linking.yml", "YAML", 0, 0, 0, 11, 0, 0, 0, 11
"d:\IDEWORK\lvmen\src\licensedcode\data\licenses\lgpl-2.1-plus.yml", "YAML", 0, 0, 0, 27, 0, 0, 2, 29
"d:\IDEWORK\lvmen\src\licensedcode\data\licenses\lgpl-2.1-qt-company-2017.yml", "YAML", 0, 0, 0, 28, 0, 0, 1, 29
"d:\IDEWORK\lvmen\src\licensedcode\data\licenses\lgpl-2.1-qt-company.yml", "YAML", 0, 0, 0, 10, 0, 0, 0, 10
"d:\IDEWORK\lvmen\src\licensedcode\data\licenses\lgpl-2.1-rxtx.yml", "YAML", 0, 0, 0, 11, 0, 0, 0, 11
"d:\IDEWORK\lvmen\src\licensedcode\data\licenses\lgpl-2.1-spell-checker.yml", "YAML", 0, 0, 0, 22, 0, 0, 1, 23
"d:\IDEWORK\lvmen\src\licensedcode\data\licenses\lgpl-2.1.yml", "YAML", 0, 0, 0, 34, 0, 0, 1, 35
"d:\IDEWORK\lvmen\src\licensedcode\data\licenses\lgpl-3-plus-linking.yml", "YAML", 0, 0, 0, 11, 0, 0, 1, 12
"d:\IDEWORK\lvmen\src\licensedcode\data\licenses\lgpl-3.0-cygwin.yml", "YAML", 0, 0, 0, 10, 0, 0, 1, 11
"d:\IDEWORK\lvmen\src\licensedcode\data\licenses\lgpl-3.0-linking-exception.yml", "YAML", 0, 0, 0, 15, 0, 0, 1, 16
"d:\IDEWORK\lvmen\src\licensedcode\data\licenses\lgpl-3.0-plus-openssl.yml", "YAML", 0, 0, 0, 9, 0, 0, 1, 10
"d:\IDEWORK\lvmen\src\licensedcode\data\licenses\lgpl-3.0-plus.yml", "YAML", 0, 0, 0, 27, 0, 0, 2, 29
"d:\IDEWORK\lvmen\src\licensedcode\data\licenses\lgpl-3.0-zeromq.yml", "YAML", 0, 0, 0, 11, 0, 0, 1, 12
"d:\IDEWORK\lvmen\src\licensedcode\data\licenses\lgpl-3.0.yml", "YAML", 0, 0, 0, 30, 0, 0, 2, 32
"d:\IDEWORK\lvmen\src\licensedcode\data\licenses\lgpllr.yml", "YAML", 0, 0, 0, 10, 0, 0, 1, 11
"d:\IDEWORK\lvmen\src\licensedcode\data\licenses\lha.yml", "YAML", 0, 0, 0, 10, 0, 0, 1, 11
"d:\IDEWORK\lvmen\src\licensedcode\data\licenses\liason license agreement.yml", "YAML", 0, 0, 0, 5, 0, 0, 1, 6
"d:\IDEWORK\lvmen\src\licensedcode\data\licenses\libcap.yml", "YAML", 0, 0, 0, 10, 0, 0, 1, 11
"d:\IDEWORK\lvmen\src\licensedcode\data\licenses\liberation-font-exception.yml", "YAML", 0, 0, 0, 15, 0, 0, 1, 16
"d:\IDEWORK\lvmen\src\licensedcode\data\licenses\libgd-2018.yml", "YAML", 0, 0, 0, 46, 0, 0, 1, 47
"d:\IDEWORK\lvmen\src\licensedcode\data\licenses\libgeotiff.yml", "YAML", 0, 0, 0, 15, 0, 0, 1, 16
"d:\IDEWORK\lvmen\src\licensedcode\data\licenses\libmib.yml", "YAML", 0, 0, 0, 14, 0, 0, 1, 15
"d:\IDEWORK\lvmen\src\licensedcode\data\licenses\libmng-2007.yml", "YAML", 0, 0, 0, 48, 0, 0, 1, 49
"d:\IDEWORK\lvmen\src\licensedcode\data\licenses\libpbm.yml", "YAML", 0, 0, 0, 11, 0, 0, 1, 12
"d:\IDEWORK\lvmen\src\licensedcode\data\licenses\libpng-v2.yml", "YAML", 0, 0, 0, 21, 0, 0, 1, 22
"d:\IDEWORK\lvmen\src\licensedcode\data\licenses\libpng.yml", "YAML", 0, 0, 0, 22, 0, 0, 1, 23
"d:\IDEWORK\lvmen\src\licensedcode\data\licenses\librato-exception.yml", "YAML", 0, 0, 0, 7, 0, 0, 1, 8
"d:\IDEWORK\lvmen\src\licensedcode\data\licenses\libselinux-pd.yml", "YAML", 0, 0, 0, 9, 0, 0, 1, 10
"d:\IDEWORK\lvmen\src\licensedcode\data\licenses\libsrv-1.0.2.yml", "YAML", 0, 0, 0, 12, 0, 0, 1, 13
"d:\IDEWORK\lvmen\src\licensedcode\data\licenses\libtool-exception-2.0.yml", "YAML", 0, 0, 0, 28, 0, 0, 1, 29
"d:\IDEWORK\lvmen\src\licensedcode\data\licenses\libtool-exception.yml", "YAML", 0, 0, 0, 10, 0, 0, 1, 11
"d:\IDEWORK\lvmen\src\licensedcode\data\licenses\libwebsockets-exception.yml", "YAML", 0, 0, 0, 53, 0, 0, 1, 54
"d:\IDEWORK\lvmen\src\licensedcode\data\licenses\libzip.yml", "YAML", 0, 0, 0, 7, 0, 0, 1, 8
"d:\IDEWORK\lvmen\src\licensedcode\data\licenses\licence for 6 box js.yml", "YAML", 0, 0, 0, 5, 0, 0, 1, 6
"d:\IDEWORK\lvmen\src\licensedcode\data\licenses\license-file-reference.yml", "YAML", 0, 0, 0, 8, 0, 0, 1, 9
"d:\IDEWORK\lvmen\src\licensedcode\data\licenses\license.yml", "YAML", 0, 0, 0, 5, 0, 0, 1, 6
"d:\IDEWORK\lvmen\src\licensedcode\data\licenses\lil-1.yml", "YAML", 0, 0, 0, 10, 0, 0, 1, 11
"d:\IDEWORK\lvmen\src\licensedcode\data\licenses\liliq-p-1.1.yml", "YAML", 0, 0, 0, 5, 0, 0, 1, 6
"d:\IDEWORK\lvmen\src\licensedcode\data\licenses\liliq-r-1.1.yml", "YAML", 0, 0, 0, 5, 0, 0, 1, 6
"d:\IDEWORK\lvmen\src\licensedcode\data\licenses\liliq-rplus-1.1.yml", "YAML", 0, 0, 0, 5, 0, 0, 1, 6
"d:\IDEWORK\lvmen\src\licensedcode\data\licenses\lilo.yml", "YAML", 0, 0, 0, 10, 0, 0, 1, 11
"d:\IDEWORK\lvmen\src\licensedcode\data\licenses\linking-exception-2.0-plus.yml", "YAML", 0, 0, 0, 27, 0, 0, 1, 28
"d:\IDEWORK\lvmen\src\licensedcode\data\licenses\linking-exception-2.1-plus.yml", "YAML", 0, 0, 0, 29, 0, 0, 1, 30
"d:\IDEWORK\lvmen\src\licensedcode\data\licenses\linking-exception-agpl-3.0.yml", "YAML", 0, 0, 0, 8, 0, 0, 1, 9
"d:\IDEWORK\lvmen\src\licensedcode\data\licenses\linking-exception-lgpl-2.0-plus.yml", "YAML", 0, 0, 0, 25, 0, 0, 1, 26
"d:\IDEWORK\lvmen\src\licensedcode\data\licenses\linking-exception-lgpl-3.0.yml", "YAML", 0, 0, 0, 39, 0, 0, 1, 40
"d:\IDEWORK\lvmen\src\licensedcode\data\licenses\linotype-eula.yml", "YAML", 0, 0, 0, 7, 0, 0, 1, 8
"d:\IDEWORK\lvmen\src\licensedcode\data\licenses\linum.yml", "YAML", 0, 0, 0, 7, 0, 0, 0, 7
"d:\IDEWORK\lvmen\src\licensedcode\data\licenses\linux-device-drivers.yml", "YAML", 0, 0, 0, 6, 0, 0, 1, 7
"d:\IDEWORK\lvmen\src\licensedcode\data\licenses\linux-openib.yml", "YAML", 0, 0, 0, 16, 0, 0, 1, 17
"d:\IDEWORK\lvmen\src\licensedcode\data\licenses\linux-syscall-exception-gpl.yml", "YAML", 0, 0, 0, 37, 0, 0, 1, 38
"d:\IDEWORK\lvmen\src\licensedcode\data\licenses\linuxbios.yml", "YAML", 0, 0, 0, 7, 0, 0, 1, 8
"d:\IDEWORK\lvmen\src\licensedcode\data\licenses\linuxhowtos.yml", "YAML", 0, 0, 0, 8, 0, 0, 1, 9
"d:\IDEWORK\lvmen\src\licensedcode\data\licenses\llgpl.yml", "YAML", 0, 0, 0, 5, 0, 0, 1, 6
"d:\IDEWORK\lvmen\src\licensedcode\data\licenses\llnl.yml", "YAML", 0, 0, 0, 9, 0, 0, 1, 10
"d:\IDEWORK\lvmen\src\licensedcode\data\licenses\llvm-exception.yml", "YAML", 0, 0, 0, 29, 0, 0, 1, 30
"d:\IDEWORK\lvmen\src\licensedcode\data\licenses\lmbench-exception-2.0.yml", "YAML", 0, 0, 0, 24, 0, 0, 1, 25
"d:\IDEWORK\lvmen\src\licensedcode\data\licenses\logica-1.0.yml", "YAML", 0, 0, 0, 13, 0, 0, 1, 14
"d:\IDEWORK\lvmen\src\licensedcode\data\licenses\lontium-linux-firmware.yml", "YAML", 0, 0, 0, 7, 0, 0, 1, 8
"d:\IDEWORK\lvmen\src\licensedcode\data\licenses\lppl-1.0.yml", "YAML", 0, 0, 0, 15, 0, 0, 1, 16
"d:\IDEWORK\lvmen\src\licensedcode\data\licenses\lppl-1.1.yml", "YAML", 0, 0, 0, 17, 0, 0, 1, 18
"d:\IDEWORK\lvmen\src\licensedcode\data\licenses\lppl-1.2.yml", "YAML", 0, 0, 0, 17, 0, 0, 1, 18
"d:\IDEWORK\lvmen\src\licensedcode\data\licenses\lppl-1.3a.yml", "YAML", 0, 0, 0, 17, 0, 0, 1, 18
"d:\IDEWORK\lvmen\src\licensedcode\data\licenses\lppl-1.3c.yml", "YAML", 0, 0, 0, 23, 0, 0, 1, 24
"d:\IDEWORK\lvmen\src\licensedcode\data\licenses\lsi-proprietary-eula.yml", "YAML", 0, 0, 0, 9, 0, 0, 1, 10
"d:\IDEWORK\lvmen\src\licensedcode\data\licenses\lucent-pl-1.0.yml", "YAML", 0, 0, 0, 15, 0, 0, 1, 16
"d:\IDEWORK\lvmen\src\licensedcode\data\licenses\lucent-pl-1.02.yml", "YAML", 0, 0, 0, 19, 0, 0, 1, 20
"d:\IDEWORK\lvmen\src\licensedcode\data\licenses\lucre.yml", "YAML", 0, 0, 0, 12, 0, 0, 1, 13
"d:\IDEWORK\lvmen\src\licensedcode\data\licenses\lumisoft-mail-server.yml", "YAML", 0, 0, 0, 9, 0, 0, 1, 10
"d:\IDEWORK\lvmen\src\licensedcode\data\licenses\luxi.yml", "YAML", 0, 0, 0, 15, 0, 0, 1, 16
"d:\IDEWORK\lvmen\src\licensedcode\data\licenses\lyubinskiy-dropdown.yml", "YAML", 0, 0, 0, 11, 0, 0, 1, 12
"d:\IDEWORK\lvmen\src\licensedcode\data\licenses\lyubinskiy-popup-window.yml", "YAML", 0, 0, 0, 11, 0, 0, 1, 12
"d:\IDEWORK\lvmen\src\licensedcode\data\licenses\lzma-cpl-exception.yml", "YAML", 0, 0, 0, 8, 0, 0, 1, 9
"d:\IDEWORK\lvmen\src\licensedcode\data\licenses\lzma-sdk-2006-exception.yml", "YAML", 0, 0, 0, 11, 0, 0, 1, 12
"d:\IDEWORK\lvmen\src\licensedcode\data\licenses\lzma-sdk-2006.yml", "YAML", 0, 0, 0, 12, 0, 0, 1, 13
"d:\IDEWORK\lvmen\src\licensedcode\data\licenses\lzma-sdk-2008.yml", "YAML", 0, 0, 0, 11, 0, 0, 1, 12
"d:\IDEWORK\lvmen\src\licensedcode\data\licenses\lzma-sdk-original.yml", "YAML", 0, 0, 0, 16, 0, 0, 1, 17
"d:\IDEWORK\lvmen\src\licensedcode\data\licenses\lzma-sdk-pd.yml", "YAML", 0, 0, 0, 6, 0, 0, 1, 7
"d:\IDEWORK\lvmen\src\licensedcode\data\licenses\m-plus.yml", "YAML", 0, 0, 0, 7, 0, 0, 1, 8
"d:\IDEWORK\lvmen\src\licensedcode\data\licenses\madwifi-dual.yml", "YAML", 0, 0, 0, 8, 0, 0, 1, 9
"d:\IDEWORK\lvmen\src\licensedcode\data\licenses\magpie-exception-1.0.yml", "YAML", 0, 0, 0, 8, 0, 0, 1, 9
"d:\IDEWORK\lvmen\src\licensedcode\data\licenses\make-human-exception.yml", "YAML", 0, 0, 0, 12, 0, 0, 1, 13
"d:\IDEWORK\lvmen\src\licensedcode\data\licenses\makeindex.yml", "YAML", 0, 0, 0, 11, 0, 0, 1, 12
"d:\IDEWORK\lvmen\src\licensedcode\data\licenses\mame.yml", "YAML", 0, 0, 0, 7, 0, 0, 1, 8
"d:\IDEWORK\lvmen\src\licensedcode\data\licenses\manfred-klein-fonts-tos.yml", "YAML", 0, 0, 0, 8, 0, 0, 1, 9
"d:\IDEWORK\lvmen\src\licensedcode\data\licenses\marinetraffic user agreement.yml", "YAML", 0, 0, 0, 5, 0, 0, 1, 6
"d:\IDEWORK\lvmen\src\licensedcode\data\licenses\martin-birgmeier.yml", "YAML", 0, 0, 0, 9, 0, 0, 1, 10
"d:\IDEWORK\lvmen\src\licensedcode\data\licenses\marvell-firmware-2019.yml", "YAML", 0, 0, 0, 7, 0, 0, 1, 8
"d:\IDEWORK\lvmen\src\licensedcode\data\licenses\marvell-firmware.yml", "YAML", 0, 0, 0, 7, 0, 0, 1, 8
"d:\IDEWORK\lvmen\src\licensedcode\data\licenses\matt-gallagher-attribution.yml", "YAML", 0, 0, 0, 9, 0, 0, 1, 10
"d:\IDEWORK\lvmen\src\licensedcode\data\licenses\matthew-kwan.yml", "YAML", 0, 0, 0, 10, 0, 0, 1, 11
"d:\IDEWORK\lvmen\src\licensedcode\data\licenses\mattkruse.yml", "YAML", 0, 0, 0, 9, 0, 0, 1, 10
"d:\IDEWORK\lvmen\src\licensedcode\data\licenses\maxmind-geolite2-eula-2019.yml", "YAML", 0, 0, 0, 17, 0, 0, 1, 18
"d:\IDEWORK\lvmen\src\licensedcode\data\licenses\maxmind-odl.yml", "YAML", 0, 0, 0, 11, 0, 0, 1, 12
"d:\IDEWORK\lvmen\src\licensedcode\data\licenses\mcafee-tou.yml", "YAML", 0, 0, 0, 7, 0, 0, 1, 8
"d:\IDEWORK\lvmen\src\licensedcode\data\licenses\mcrae-pl-4-r53.yml", "YAML", 0, 0, 0, 11, 0, 0, 1, 12
"d:\IDEWORK\lvmen\src\licensedcode\data\licenses\mechanical.yml", "YAML", 0, 0, 0, 5, 0, 0, 1, 6
"d:\IDEWORK\lvmen\src\licensedcode\data\licenses\mediainfo-lib.yml", "YAML", 0, 0, 0, 14, 0, 0, 1, 15
"d:\IDEWORK\lvmen\src\licensedcode\data\licenses\melange.yml", "YAML", 0, 0, 0, 14, 0, 0, 1, 15
"d:\IDEWORK\lvmen\src\licensedcode\data\licenses\mentalis.yml", "YAML", 0, 0, 0, 10, 0, 0, 1, 11
"d:\IDEWORK\lvmen\src\licensedcode\data\licenses\merit-network-derivative.yml", "YAML", 0, 0, 0, 68, 0, 0, 1, 69
"d:\IDEWORK\lvmen\src\licensedcode\data\licenses\metageek-inssider-eula.yml", "YAML", 0, 0, 0, 14, 0, 0, 2, 16
"d:\IDEWORK\lvmen\src\licensedcode\data\licenses\metrolink-1.0.yml", "YAML", 0, 0, 0, 13, 0, 0, 1, 14
"d:\IDEWORK\lvmen\src\licensedcode\data\licenses\mgopen-font-license.yml", "YAML", 0, 0, 0, 10, 0, 0, 1, 11
"d:\IDEWORK\lvmen\src\licensedcode\data\licenses\michael-barr.yml", "YAML", 0, 0, 0, 6, 0, 0, 1, 7
"d:\IDEWORK\lvmen\src\licensedcode\data\licenses\michigan-disclaimer.yml", "YAML", 0, 0, 0, 7, 0, 0, 1, 8
"d:\IDEWORK\lvmen\src\licensedcode\data\licenses\microchip-linux-firmware.yml", "YAML", 0, 0, 0, 7, 0, 0, 1, 8
"d:\IDEWORK\lvmen\src\licensedcode\data\licenses\microsoft-enterprise-library-eula.yml", "YAML", 0, 0, 0, 11, 0, 0, 1, 12
"d:\IDEWORK\lvmen\src\licensedcode\data\licenses\microsoft-windows-rally-devkit.yml", "YAML", 0, 0, 0, 10, 0, 0, 1, 11
"d:\IDEWORK\lvmen\src\licensedcode\data\licenses\mif-exception.yml", "YAML", 0, 0, 0, 22, 0, 0, 1, 23
"d:\IDEWORK\lvmen\src\licensedcode\data\licenses\mike95.yml", "YAML", 0, 0, 0, 13, 0, 0, 1, 14
"d:\IDEWORK\lvmen\src\licensedcode\data\licenses\minecraft-mod.yml", "YAML", 0, 0, 0, 8, 0, 0, 1, 9
"d:\IDEWORK\lvmen\src\licensedcode\data\licenses\minecraftforge license.yml", "YAML", 0, 0, 0, 5, 0, 0, 1, 6
"d:\IDEWORK\lvmen\src\licensedcode\data\licenses\mini-xml-exception-lgpl-2.0.yml", "YAML", 0, 0, 0, 41, 0, 0, 1, 42
"d:\IDEWORK\lvmen\src\licensedcode\data\licenses\mini-xml.yml", "YAML", 0, 0, 0, 11, 0, 0, 0, 11
"d:\IDEWORK\lvmen\src\licensedcode\data\licenses\minpack.yml", "YAML", 0, 0, 0, 10, 0, 0, 1, 11
"d:\IDEWORK\lvmen\src\licensedcode\data\licenses\mir-os.yml", "YAML", 0, 0, 0, 16, 0, 0, 1, 17
"d:\IDEWORK\lvmen\src\licensedcode\data\licenses\mit-0.yml", "YAML", 0, 0, 0, 18, 0, 0, 1, 19
"d:\IDEWORK\lvmen\src\licensedcode\data\licenses\mit-ack.yml", "YAML", 0, 0, 0, 10, 0, 0, 1, 11
"d:\IDEWORK\lvmen\src\licensedcode\data\licenses\mit-addition.yml", "YAML", 0, 0, 0, 10, 0, 0, 1, 11
"d:\IDEWORK\lvmen\src\licensedcode\data\licenses\mit-export-control.yml", "YAML", 0, 0, 0, 13, 0, 0, 1, 14
"d:\IDEWORK\lvmen\src\licensedcode\data\licenses\mit-license-1998.yml", "YAML", 0, 0, 0, 6, 0, 0, 1, 7
"d:\IDEWORK\lvmen\src\licensedcode\data\licenses\mit-modern.yml", "YAML", 0, 0, 0, 16, 0, 0, 1, 17
"d:\IDEWORK\lvmen\src\licensedcode\data\licenses\mit-nagy.yml", "YAML", 0, 0, 0, 9, 0, 0, 1, 10
"d:\IDEWORK\lvmen\src\licensedcode\data\licenses\mit-no-advert-export-control.yml", "YAML", 0, 0, 0, 11, 0, 0, 1, 12
"d:\IDEWORK\lvmen\src\licensedcode\data\licenses\mit-no-false-attribs.yml", "YAML", 0, 0, 0, 12, 0, 0, 1, 13
"d:\IDEWORK\lvmen\src\licensedcode\data\licenses\mit-no-trademarks.yml", "YAML", 0, 0, 0, 11, 0, 0, 2, 13
"d:\IDEWORK\lvmen\src\licensedcode\data\licenses\mit-old-style-no-advert.yml", "YAML", 0, 0, 0, 13, 0, 0, 1, 14
"d:\IDEWORK\lvmen\src\licensedcode\data\licenses\mit-old-style-sparse.yml", "YAML", 0, 0, 0, 10, 0, 0, 1, 11
"d:\IDEWORK\lvmen\src\licensedcode\data\licenses\mit-old-style.yml", "YAML", 0, 0, 0, 9, 0, 0, 1, 10
"d:\IDEWORK\lvmen\src\licensedcode\data\licenses\mit-readme.yml", "YAML", 0, 0, 0, 6, 0, 0, 1, 7
"d:\IDEWORK\lvmen\src\licensedcode\data\licenses\mit-specification-disclaimer.yml", "YAML", 0, 0, 0, 8, 0, 0, 1, 9
"d:\IDEWORK\lvmen\src\licensedcode\data\licenses\mit-synopsys.yml", "YAML", 0, 0, 0, 7, 0, 0, 1, 8
"d:\IDEWORK\lvmen\src\licensedcode\data\licenses\mit-taylor-variant.yml", "YAML", 0, 0, 0, 6, 0, 0, 1, 7
"d:\IDEWORK\lvmen\src\licensedcode\data\licenses\mit-veillard-variant.yml", "YAML", 0, 0, 0, 10, 0, 0, 1, 11
"d:\IDEWORK\lvmen\src\licensedcode\data\licenses\mit-with-modification-obligations.yml", "YAML", 0, 0, 0, 7, 0, 0, 1, 8
"d:\IDEWORK\lvmen\src\licensedcode\data\licenses\mit-xfig.yml", "YAML", 0, 0, 0, 15, 0, 0, 1, 16
"d:\IDEWORK\lvmen\src\licensedcode\data\licenses\mit.yml", "YAML", 0, 0, 0, 17, 0, 0, 1, 18
"d:\IDEWORK\lvmen\src\licensedcode\data\licenses\mitty.yml", "YAML", 0, 0, 0, 5, 0, 0, 1, 6
"d:\IDEWORK\lvmen\src\licensedcode\data\licenses\mod-dav-1.0.yml", "YAML", 0, 0, 0, 19, 0, 0, 1, 20
"d:\IDEWORK\lvmen\src\licensedcode\data\licenses\monetdb-1.1.yml", "YAML", 0, 0, 0, 9, 0, 0, 1, 10
"d:\IDEWORK\lvmen\src\licensedcode\data\licenses\mongodb-sspl-1.0.yml", "YAML", 0, 0, 0, 27, 0, 0, 2, 29
"d:\IDEWORK\lvmen\src\licensedcode\data\licenses\moppie.yml", "YAML", 0, 0, 0, 5, 0, 0, 1, 6
"d:\IDEWORK\lvmen\src\licensedcode\data\licenses\motorola.yml", "YAML", 0, 0, 0, 6, 0, 0, 1, 7
"d:\IDEWORK\lvmen\src\licensedcode\data\licenses\motosoto-0.9.1.yml", "YAML", 0, 0, 0, 15, 0, 0, 1, 16
"d:\IDEWORK\lvmen\src\licensedcode\data\licenses\moxa-linux-firmware.yml", "YAML", 0, 0, 0, 7, 0, 0, 1, 8
"d:\IDEWORK\lvmen\src\licensedcode\data\licenses\mozilla-gc.yml", "YAML", 0, 0, 0, 11, 0, 0, 1, 12
"d:\IDEWORK\lvmen\src\licensedcode\data\licenses\mozilla-ospl-1.0.yml", "YAML", 0, 0, 0, 10, 0, 0, 1, 11
"d:\IDEWORK\lvmen\src\licensedcode\data\licenses\mpeg-7.yml", "YAML", 0, 0, 0, 11, 0, 0, 1, 12
"d:\IDEWORK\lvmen\src\licensedcode\data\licenses\mpeg-iso.yml", "YAML", 0, 0, 0, 12, 0, 0, 1, 13
"d:\IDEWORK\lvmen\src\licensedcode\data\licenses\mpeg-ssg.yml", "YAML", 0, 0, 0, 7, 0, 0, 1, 8
"d:\IDEWORK\lvmen\src\licensedcode\data\licenses\mpich.yml", "YAML", 0, 0, 0, 15, 0, 0, 1, 16
"d:\IDEWORK\lvmen\src\licensedcode\data\licenses\mpl-1.0.yml", "YAML", 0, 0, 0, 26, 0, 0, 1, 27
"d:\IDEWORK\lvmen\src\licensedcode\data\licenses\mpl-1.1.yml", "YAML", 0, 0, 0, 24, 0, 0, 1, 25
"d:\IDEWORK\lvmen\src\licensedcode\data\licenses\mpl-2.0-no-copyleft-exception.yml", "YAML", 0, 0, 0, 16, 0, 0, 1, 17
"d:\IDEWORK\lvmen\src\licensedcode\data\licenses\mpl-2.0.yml", "YAML", 0, 0, 0, 25, 0, 0, 1, 26
"d:\IDEWORK\lvmen\src\licensedcode\data\licenses\ms-asp-net-ajax-supplemental-terms.yml", "YAML", 0, 0, 0, 11, 0, 0, 1, 12
"d:\IDEWORK\lvmen\src\licensedcode\data\licenses\ms-asp-net-mvc3.yml", "YAML", 0, 0, 0, 10, 0, 0, 1, 11
"d:\IDEWORK\lvmen\src\licensedcode\data\licenses\ms-asp-net-mvc4-extensions.yml", "YAML", 0, 0, 0, 9, 0, 0, 1, 10
"d:\IDEWORK\lvmen\src\licensedcode\data\licenses\ms-asp-net-mvc4.yml", "YAML", 0, 0, 0, 9, 0, 0, 1, 10
"d:\IDEWORK\lvmen\src\licensedcode\data\licenses\ms-asp-net-software.yml", "YAML", 0, 0, 0, 10, 0, 0, 1, 11
"d:\IDEWORK\lvmen\src\licensedcode\data\licenses\ms-asp-net-tools-pre-release.yml", "YAML", 0, 0, 0, 10, 0, 0, 1, 11
"d:\IDEWORK\lvmen\src\licensedcode\data\licenses\ms-asp-net-web-optimization-framework.yml", "YAML", 0, 0, 0, 9, 0, 0, 1, 10
"d:\IDEWORK\lvmen\src\licensedcode\data\licenses\ms-asp-net-web-pages-2.yml", "YAML", 0, 0, 0, 10, 0, 0, 1, 11
"d:\IDEWORK\lvmen\src\licensedcode\data\licenses\ms-asp-net-web-pages-templates.yml", "YAML", 0, 0, 0, 12, 0, 0, 1, 13
"d:\IDEWORK\lvmen\src\licensedcode\data\licenses\ms-azure-data-studio.yml", "YAML", 0, 0, 0, 7, 0, 0, 1, 8
"d:\IDEWORK\lvmen\src\licensedcode\data\licenses\ms-capicom.yml", "YAML", 0, 0, 0, 10, 0, 0, 1, 11
"d:\IDEWORK\lvmen\src\licensedcode\data\licenses\ms-cl.yml", "YAML", 0, 0, 0, 8, 0, 0, 1, 9
"d:\IDEWORK\lvmen\src\licensedcode\data\licenses\ms-control-spy-2.0.yml", "YAML", 0, 0, 0, 10, 0, 0, 1, 11
"d:\IDEWORK\lvmen\src\licensedcode\data\licenses\ms-developer-services-agreement-2018-06.yml", "YAML", 0, 0, 0, 13, 0, 0, 1, 14
"d:\IDEWORK\lvmen\src\licensedcode\data\licenses\ms-developer-services-agreement.yml", "YAML", 0, 0, 0, 24, 0, 0, 1, 25
"d:\IDEWORK\lvmen\src\licensedcode\data\licenses\ms-device-emulator-3.0.yml", "YAML", 0, 0, 0, 8, 0, 0, 1, 9
"d:\IDEWORK\lvmen\src\licensedcode\data\licenses\ms-directx-sdk-eula.yml", "YAML", 0, 0, 0, 10, 0, 0, 1, 11
"d:\IDEWORK\lvmen\src\licensedcode\data\licenses\ms-entity-framework-4.1.yml", "YAML", 0, 0, 0, 10, 0, 0, 1, 11
"d:\IDEWORK\lvmen\src\licensedcode\data\licenses\ms-entity-framework-5.yml", "YAML", 0, 0, 0, 11, 0, 0, 1, 12
"d:\IDEWORK\lvmen\src\licensedcode\data\licenses\ms-eula-win-script-host.yml", "YAML", 0, 0, 0, 6, 0, 0, 1, 7
"d:\IDEWORK\lvmen\src\licensedcode\data\licenses\ms-exchange-server-2010-sp2-sdk.yml", "YAML", 0, 0, 0, 9, 0, 0, 1, 10
"d:\IDEWORK\lvmen\src\licensedcode\data\licenses\ms-iis-container-images-eula-2020.yml", "YAML", 0, 0, 0, 8, 0, 0, 1, 9
"d:\IDEWORK\lvmen\src\licensedcode\data\licenses\ms-ilmerge.yml", "YAML", 0, 0, 0, 11, 0, 0, 1, 12
"d:\IDEWORK\lvmen\src\licensedcode\data\licenses\ms-invisible-eula-1.0.yml", "YAML", 0, 0, 0, 11, 0, 0, 1, 12
"d:\IDEWORK\lvmen\src\licensedcode\data\licenses\ms-jdbc-driver-40-sql-server.yml", "YAML", 0, 0, 0, 9, 0, 0, 1, 10
"d:\IDEWORK\lvmen\src\licensedcode\data\licenses\ms-jdbc-driver-41-sql-server.yml", "YAML", 0, 0, 0, 9, 0, 0, 1, 10
"d:\IDEWORK\lvmen\src\licensedcode\data\licenses\ms-jdbc-driver-60-sql-server.yml", "YAML", 0, 0, 0, 9, 0, 0, 1, 10
"d:\IDEWORK\lvmen\src\licensedcode\data\licenses\ms-kinext-win-sdk.yml", "YAML", 0, 0, 0, 12, 0, 0, 1, 13
"d:\IDEWORK\lvmen\src\licensedcode\data\licenses\ms-limited-community.yml", "YAML", 0, 0, 0, 10, 0, 0, 1, 11
"d:\IDEWORK\lvmen\src\licensedcode\data\licenses\ms-limited-public.yml", "YAML", 0, 0, 0, 12, 0, 0, 1, 13
"d:\IDEWORK\lvmen\src\licensedcode\data\licenses\ms-lpl.yml", "YAML", 0, 0, 0, 11, 0, 0, 1, 12
"d:\IDEWORK\lvmen\src\licensedcode\data\licenses\ms-msn-webgrease.yml", "YAML", 0, 0, 0, 11, 0, 0, 1, 12
"d:\IDEWORK\lvmen\src\licensedcode\data\licenses\ms-net-framework-4-supplemental-terms.yml", "YAML", 0, 0, 0, 12, 0, 0, 1, 13
"d:\IDEWORK\lvmen\src\licensedcode\data\licenses\ms-net-framework-deployment.yml", "YAML", 0, 0, 0, 6, 0, 0, 1, 7
"d:\IDEWORK\lvmen\src\licensedcode\data\licenses\ms-net-library-2018-11.yml", "YAML", 0, 0, 0, 11, 0, 0, 1, 12
"d:\IDEWORK\lvmen\src\licensedcode\data\licenses\ms-net-library-2019-06.yml", "YAML", 0, 0, 0, 11, 0, 0, 1, 12
"d:\IDEWORK\lvmen\src\licensedcode\data\licenses\ms-net-library-2020-09.yml", "YAML", 0, 0, 0, 11, 0, 0, 2, 13
"d:\IDEWORK\lvmen\src\licensedcode\data\licenses\ms-net-library.yml", "YAML", 0, 0, 0, 9, 0, 0, 1, 10
"d:\IDEWORK\lvmen\src\licensedcode\data\licenses\ms-nt-resource-kit.yml", "YAML", 0, 0, 0, 6, 0, 0, 1, 7
"d:\IDEWORK\lvmen\src\licensedcode\data\licenses\ms-nuget-package-manager.yml", "YAML", 0, 0, 0, 12, 0, 0, 1, 13
"d:\IDEWORK\lvmen\src\licensedcode\data\licenses\ms-nuget.yml", "YAML", 0, 0, 0, 9, 0, 0, 1, 10
"d:\IDEWORK\lvmen\src\licensedcode\data\licenses\ms-office-system-programs-eula.yml", "YAML", 0, 0, 0, 10, 0, 0, 1, 11
"d:\IDEWORK\lvmen\src\licensedcode\data\licenses\ms-patent-promise-mono.yml", "YAML", 0, 0, 0, 9, 0, 0, 1, 10
"d:\IDEWORK\lvmen\src\licensedcode\data\licenses\ms-patent-promise.yml", "YAML", 0, 0, 0, 13, 0, 0, 1, 14
"d:\IDEWORK\lvmen\src\licensedcode\data\licenses\ms-permissive-1.1.yml", "YAML", 0, 0, 0, 8, 0, 0, 1, 9
"d:\IDEWORK\lvmen\src\licensedcode\data\licenses\ms-pl.yml", "YAML", 0, 0, 0, 17, 0, 0, 1, 18
"d:\IDEWORK\lvmen\src\licensedcode\data\licenses\ms-platform-sdk.yml", "YAML", 0, 0, 0, 12, 0, 0, 1, 13
"d:\IDEWORK\lvmen\src\licensedcode\data\licenses\ms-python-vscode-pylance-2021.yml", "YAML", 0, 0, 0, 14, 0, 0, 1, 15
"d:\IDEWORK\lvmen\src\licensedcode\data\licenses\ms-reactive-extensions-eula.yml", "YAML", 0, 0, 0, 9, 0, 0, 1, 10
"d:\IDEWORK\lvmen\src\licensedcode\data\licenses\ms-refl.yml", "YAML", 0, 0, 0, 8, 0, 0, 0, 8
"d:\IDEWORK\lvmen\src\licensedcode\data\licenses\ms-remote-ndis-usb-kit.yml", "YAML", 0, 0, 0, 8, 0, 0, 1, 9
"d:\IDEWORK\lvmen\src\licensedcode\data\licenses\ms-research-shared-source.yml", "YAML", 0, 0, 0, 15, 0, 0, 1, 16
"d:\IDEWORK\lvmen\src\licensedcode\data\licenses\ms-rl.yml", "YAML", 0, 0, 0, 17, 0, 0, 1, 18
"d:\IDEWORK\lvmen\src\licensedcode\data\licenses\ms-rsl.yml", "YAML", 0, 0, 0, 13, 0, 0, 1, 14
"d:\IDEWORK\lvmen\src\licensedcode\data\licenses\ms-silverlight-3.yml", "YAML", 0, 0, 0, 10, 0, 0, 1, 11
"d:\IDEWORK\lvmen\src\licensedcode\data\licenses\ms-sql-server-compact-4.0.yml", "YAML", 0, 0, 0, 9, 0, 0, 1, 10
"d:\IDEWORK\lvmen\src\licensedcode\data\licenses\ms-sql-server-data-tools.yml", "YAML", 0, 0, 0, 11, 0, 0, 1, 12
"d:\IDEWORK\lvmen\src\licensedcode\data\licenses\ms-sspl.yml", "YAML", 0, 0, 0, 6, 0, 0, 1, 7
"d:\IDEWORK\lvmen\src\licensedcode\data\licenses\ms-sysinternals-sla.yml", "YAML", 0, 0, 0, 8, 0, 0, 1, 9
"d:\IDEWORK\lvmen\src\licensedcode\data\licenses\ms-ttf-eula.yml", "YAML", 0, 0, 0, 6, 0, 0, 1, 7
"d:\IDEWORK\lvmen\src\licensedcode\data\licenses\ms-visual-2008-runtime.yml", "YAML", 0, 0, 0, 10, 0, 0, 1, 11
"d:\IDEWORK\lvmen\src\licensedcode\data\licenses\ms-visual-2010-runtime.yml", "YAML", 0, 0, 0, 11, 0, 0, 1, 12
"d:\IDEWORK\lvmen\src\licensedcode\data\licenses\ms-visual-2015-sdk.yml", "YAML", 0, 0, 0, 12, 0, 0, 1, 13
"d:\IDEWORK\lvmen\src\licensedcode\data\licenses\ms-visual-studio-2017-tools.yml", "YAML", 0, 0, 0, 12, 0, 0, 1, 13
"d:\IDEWORK\lvmen\src\licensedcode\data\licenses\ms-visual-studio-2017.yml", "YAML", 0, 0, 0, 20, 0, 0, 1, 21
"d:\IDEWORK\lvmen\src\licensedcode\data\licenses\ms-visual-studio-code.yml", "YAML", 0, 0, 0, 13, 0, 0, 1, 14
"d:\IDEWORK\lvmen\src\licensedcode\data\licenses\ms-web-developer-tools-1.0.yml", "YAML", 0, 0, 0, 9, 0, 0, 1, 10
"d:\IDEWORK\lvmen\src\licensedcode\data\licenses\ms-windows-container-base-image-eula-2020.yml", "YAML", 0, 0, 0, 10, 0, 0, 2, 12
"d:\IDEWORK\lvmen\src\licensedcode\data\licenses\ms-windows-driver-kit.yml", "YAML", 0, 0, 0, 8, 0, 0, 1, 9
"d:\IDEWORK\lvmen\src\licensedcode\data\licenses\ms-windows-identity-foundation.yml", "YAML", 0, 0, 0, 11, 0, 0, 1, 12
"d:\IDEWORK\lvmen\src\licensedcode\data\licenses\ms-windows-os-2018.yml", "YAML", 0, 0, 0, 8, 0, 0, 1, 9
"d:\IDEWORK\lvmen\src\licensedcode\data\licenses\ms-windows-sdk-server-2008-net-3.5.yml", "YAML", 0, 0, 0, 14, 0, 0, 1, 15
"d:\IDEWORK\lvmen\src\licensedcode\data\licenses\ms-windows-sdk-win7-net-4.yml", "YAML", 0, 0, 0, 15, 0, 0, 1, 16
"d:\IDEWORK\lvmen\src\licensedcode\data\licenses\ms-windows-server-2003-ddk.yml", "YAML", 0, 0, 0, 8, 0, 0, 1, 9
"d:\IDEWORK\lvmen\src\licensedcode\data\licenses\ms-windows-server-2003-sdk.yml", "YAML", 0, 0, 0, 12, 0, 0, 1, 13
"d:\IDEWORK\lvmen\src\licensedcode\data\licenses\ms-ws-routing-spec.yml", "YAML", 0, 0, 0, 10, 0, 0, 1, 11
"d:\IDEWORK\lvmen\src\licensedcode\data\licenses\ms-xml-core-4.0.yml", "YAML", 0, 0, 0, 8, 0, 0, 1, 9
"d:\IDEWORK\lvmen\src\licensedcode\data\licenses\msj-sample-code.yml", "YAML", 0, 0, 0, 6, 0, 0, 1, 7
"d:\IDEWORK\lvmen\src\licensedcode\data\licenses\msntp.yml", "YAML", 0, 0, 0, 20, 0, 0, 1, 21
"d:\IDEWORK\lvmen\src\licensedcode\data\licenses\msppl.yml", "YAML", 0, 0, 0, 7, 0, 0, 1, 8
"d:\IDEWORK\lvmen\src\licensedcode\data\licenses\mtll.yml", "YAML", 0, 0, 0, 16, 0, 0, 2, 18
"d:\IDEWORK\lvmen\src\licensedcode\data\licenses\mts.yml", "YAML", 0, 0, 0, 5, 0, 0, 1, 6
"d:\IDEWORK\lvmen\src\licensedcode\data\licenses\mtx-licensing-statement.yml", "YAML", 0, 0, 0, 11, 0, 0, 1, 12
"d:\IDEWORK\lvmen\src\licensedcode\data\licenses\mug foundation open formats license.yml", "YAML", 0, 0, 0, 5, 0, 0, 1, 6
"d:\IDEWORK\lvmen\src\licensedcode\data\licenses\mulanpsl-1.0-en.yml", "YAML", 0, 0, 0, 28, 0, 0, 1, 29
"d:\IDEWORK\lvmen\src\licensedcode\data\licenses\mulanpsl-1.0.yml", "YAML", 0, 0, 0, 16, 0, 0, 2, 18
"d:\IDEWORK\lvmen\src\licensedcode\data\licenses\mulanpsl-2.0-en.yml", "YAML", 0, 0, 0, 21, 0, 0, 1, 22
"d:\IDEWORK\lvmen\src\licensedcode\data\licenses\mulanpsl-2.0.yml", "YAML", 0, 0, 0, 14, 0, 0, 2, 16
"d:\IDEWORK\lvmen\src\licensedcode\data\licenses\mule-source-1.1.3.yml", "YAML", 0, 0, 0, 19, 0, 0, 1, 20
"d:\IDEWORK\lvmen\src\licensedcode\data\licenses\mule-source-1.1.4.yml", "YAML", 0, 0, 0, 21, 0, 0, 1, 22
"d:\IDEWORK\lvmen\src\licensedcode\data\licenses\mulle-kybernetik.yml", "YAML", 0, 0, 0, 7, 0, 0, 1, 8
"d:\IDEWORK\lvmen\src\licensedcode\data\licenses\multics.yml", "YAML", 0, 0, 0, 24, 0, 0, 1, 25
"d:\IDEWORK\lvmen\src\licensedcode\data\licenses\muneto - license.yml", "YAML", 0, 0, 0, 5, 0, 0, 1, 6
"d:\IDEWORK\lvmen\src\licensedcode\data\licenses\mup.yml", "YAML", 0, 0, 0, 15, 0, 0, 1, 16
"d:\IDEWORK\lvmen\src\licensedcode\data\licenses\musl-exception.yml", "YAML", 0, 0, 0, 8, 0, 0, 1, 9
"d:\IDEWORK\lvmen\src\licensedcode\data\licenses\mvt-1.1.yml", "YAML", 0, 0, 0, 9, 0, 0, 1, 10
"d:\IDEWORK\lvmen\src\licensedcode\data\licenses\mx4j.yml", "YAML", 0, 0, 0, 18, 0, 0, 1, 19
"d:\IDEWORK\lvmen\src\licensedcode\data\licenses\mysql-connector-odbc-exception-2.0.yml", "YAML", 0, 0, 0, 14, 0, 0, 2, 16
"d:\IDEWORK\lvmen\src\licensedcode\data\licenses\mysql-floss-exception-2.0.yml", "YAML", 0, 0, 0, 13, 0, 0, 1, 14
"d:\IDEWORK\lvmen\src\licensedcode\data\licenses\mysql-linking-exception-2018.yml", "YAML", 0, 0, 0, 11, 0, 0, 1, 12
"d:\IDEWORK\lvmen\src\licensedcode\data\licenses\naist-2003.yml", "YAML", 0, 0, 0, 13, 0, 0, 1, 14
"d:\IDEWORK\lvmen\src\licensedcode\data\licenses\nant-exception-2.0-plus.yml", "YAML", 0, 0, 0, 43, 0, 0, 1, 44
"d:\IDEWORK\lvmen\src\licensedcode\data\licenses\nasa-1.3.yml", "YAML", 0, 0, 0, 22, 0, 0, 1, 23
"d:\IDEWORK\lvmen\src\licensedcode\data\licenses\naughter.yml", "YAML", 0, 0, 0, 6, 0, 0, 1, 7
"d:\IDEWORK\lvmen\src\licensedcode\data\licenses\naumen.yml", "YAML", 0, 0, 0, 19, 0, 0, 1, 20
"d:\IDEWORK\lvmen\src\licensedcode\data\licenses\nbpl-1.0.yml", "YAML", 0, 0, 0, 17, 0, 0, 1, 18
"d:\IDEWORK\lvmen\src\licensedcode\data\licenses\ncbi.yml", "YAML", 0, 0, 0, 9, 0, 0, 1, 10
"d:\IDEWORK\lvmen\src\licensedcode\data\licenses\ncgl-uk-2.0.yml", "YAML", 0, 0, 0, 11, 0, 0, 1, 12
"d:\IDEWORK\lvmen\src\licensedcode\data\licenses\nero-eula.yml", "YAML", 0, 0, 0, 62, 0, 0, 1, 63
"d:\IDEWORK\lvmen\src\licensedcode\data\licenses\net-snmp.yml", "YAML", 0, 0, 0, 35, 0, 0, 1, 36
"d:\IDEWORK\lvmen\src\licensedcode\data\licenses\netapp-sdk-aug2020.yml", "YAML", 0, 0, 0, 9, 0, 0, 2, 11
"d:\IDEWORK\lvmen\src\licensedcode\data\licenses\netcat.yml", "YAML", 0, 0, 0, 9, 0, 0, 1, 10
"d:\IDEWORK\lvmen\src\licensedcode\data\licenses\netcdf.yml", "YAML", 0, 0, 0, 10, 0, 0, 1, 11
"d:\IDEWORK\lvmen\src\licensedcode\data\licenses\netcomponents.yml", "YAML", 0, 0, 0, 13, 0, 0, 1, 14
"d:\IDEWORK\lvmen\src\licensedcode\data\licenses\netdisco.yml", "YAML", 0, 0, 0, 5, 0, 0, 1, 6
"d:\IDEWORK\lvmen\src\licensedcode\data\licenses\netron.yml", "YAML", 0, 0, 0, 10, 0, 0, 1, 11
"d:\IDEWORK\lvmen\src\licensedcode\data\licenses\netronome-firmware.yml", "YAML", 0, 0, 0, 7, 0, 0, 1, 8
"d:\IDEWORK\lvmen\src\licensedcode\data\licenses\network-time-protocol.yml", "YAML", 0, 0, 0, 10, 0, 0, 1, 11
"d:\IDEWORK\lvmen\src\licensedcode\data\licenses\neve.yml", "YAML", 0, 0, 0, 5, 0, 0, 1, 6
"d:\IDEWORK\lvmen\src\licensedcode\data\licenses\new relic agent license.yml", "YAML", 0, 0, 0, 5, 0, 0, 1, 6
"d:\IDEWORK\lvmen\src\licensedcode\data\licenses\new-relic.yml", "YAML", 0, 0, 0, 11, 0, 0, 1, 12
"d:\IDEWORK\lvmen\src\licensedcode\data\licenses\newlib-historical.yml", "YAML", 0, 0, 0, 8, 0, 0, 1, 9
"d:\IDEWORK\lvmen\src\licensedcode\data\licenses\newran.yml", "YAML", 0, 0, 0, 7, 0, 0, 1, 8
"d:\IDEWORK\lvmen\src\licensedcode\data\licenses\newsletr.yml", "YAML", 0, 0, 0, 12, 0, 0, 1, 13
"d:\IDEWORK\lvmen\src\licensedcode\data\licenses\newton-king-cla.yml", "YAML", 0, 0, 0, 8, 0, 0, 1, 9
"d:\IDEWORK\lvmen\src\licensedcode\data\licenses\nexb-eula-saas-1.1.0.yml", "YAML", 0, 0, 0, 10, 0, 0, 1, 11
"d:\IDEWORK\lvmen\src\licensedcode\data\licenses\nexb-ssla-1.1.0.yml", "YAML", 0, 0, 0, 8, 0, 0, 1, 9
"d:\IDEWORK\lvmen\src\licensedcode\data\licenses\ngoan.yml", "YAML", 0, 0, 0, 5, 0, 0, 1, 6
"d:\IDEWORK\lvmen\src\licensedcode\data\licenses\ngpl.yml", "YAML", 0, 0, 0, 20, 0, 0, 1, 21
"d:\IDEWORK\lvmen\src\licensedcode\data\licenses\nice.yml", "YAML", 0, 0, 0, 7, 0, 0, 1, 8
"d:\IDEWORK\lvmen\src\licensedcode\data\licenses\nicta-exception.yml", "YAML", 0, 0, 0, 8, 0, 0, 1, 9
"d:\IDEWORK\lvmen\src\licensedcode\data\licenses\nicta-psl.yml", "YAML", 0, 0, 0, 15, 0, 0, 1, 16
"d:\IDEWORK\lvmen\src\licensedcode\data\licenses\niels-ferguson.yml", "YAML", 0, 0, 0, 10, 0, 0, 1, 11
"d:\IDEWORK\lvmen\src\licensedcode\data\licenses\nilsson-historical.yml", "YAML", 0, 0, 0, 7, 0, 0, 1, 8
"d:\IDEWORK\lvmen\src\licensedcode\data\licenses\nist-pd-fallback.yml", "YAML", 0, 0, 0, 10, 0, 0, 1, 11
"d:\IDEWORK\lvmen\src\licensedcode\data\licenses\nist-pd.yml", "YAML", 0, 0, 0, 14, 0, 0, 1, 15
"d:\IDEWORK\lvmen\src\licensedcode\data\licenses\nist-srd.yml", "YAML", 0, 0, 0, 9, 0, 0, 1, 10
"d:\IDEWORK\lvmen\src\licensedcode\data\licenses\nlod-1.0.yml", "YAML", 0, 0, 0, 10, 0, 0, 1, 11
"d:\IDEWORK\lvmen\src\licensedcode\data\licenses\nlod-2.0.yml", "YAML", 0, 0, 0, 9, 0, 0, 1, 10
"d:\IDEWORK\lvmen\src\licensedcode\data\licenses\nlpl.yml", "YAML", 0, 0, 0, 17, 0, 0, 1, 18
"d:\IDEWORK\lvmen\src\licensedcode\data\licenses\nmpv1.yml", "YAML", 0, 0, 0, 5, 0, 0, 1, 6
"d:\IDEWORK\lvmen\src\licensedcode\data\licenses\node-js.yml", "YAML", 0, 0, 0, 72, 0, 0, 1, 73
"d:\IDEWORK\lvmen\src\licensedcode\data\licenses\nokia-qt-exception-1.1.yml", "YAML", 0, 0, 0, 34, 0, 0, 2, 36
"d:\IDEWORK\lvmen\src\licensedcode\data\licenses\nokos-1.0a.yml", "YAML", 0, 0, 0, 19, 0, 0, 1, 20
"d:\IDEWORK\lvmen\src\licensedcode\data\licenses\non-violent-4.0.yml", "YAML", 0, 0, 0, 9, 0, 0, 1, 10
"d:\IDEWORK\lvmen\src\licensedcode\data\licenses\nonexclusive.yml", "YAML", 0, 0, 0, 6, 0, 0, 1, 7
"d:\IDEWORK\lvmen\src\licensedcode\data\licenses\nortel-dasa.yml", "YAML", 0, 0, 0, 8, 0, 0, 1, 9
"d:\IDEWORK\lvmen\src\licensedcode\data\licenses\nosl-1.0.yml", "YAML", 0, 0, 0, 12, 0, 0, 1, 13
"d:\IDEWORK\lvmen\src\licensedcode\data\licenses\nosl-3.0.yml", "YAML", 0, 0, 0, 20, 0, 0, 1, 21
"d:\IDEWORK\lvmen\src\licensedcode\data\licenses\notre-dame.yml", "YAML", 0, 0, 0, 13, 0, 0, 1, 14
"d:\IDEWORK\lvmen\src\licensedcode\data\licenses\noweb.yml", "YAML", 0, 0, 0, 10, 0, 0, 1, 11
"d:\IDEWORK\lvmen\src\licensedcode\data\licenses\npl-1.0.yml", "YAML", 0, 0, 0, 19, 0, 0, 1, 20
"d:\IDEWORK\lvmen\src\licensedcode\data\licenses\npl-1.1.yml", "YAML", 0, 0, 0, 19, 0, 0, 1, 20
"d:\IDEWORK\lvmen\src\licensedcode\data\licenses\npsl-exception-0.93.yml", "YAML", 0, 0, 0, 27, 0, 0, 2, 29
"d:\IDEWORK\lvmen\src\licensedcode\data\licenses\nrl-permission.yml", "YAML", 0, 0, 0, 7, 0, 0, 1, 8
"d:\IDEWORK\lvmen\src\licensedcode\data\licenses\nrl.yml", "YAML", 0, 0, 0, 14, 0, 0, 1, 15
"d:\IDEWORK\lvmen\src\licensedcode\data\licenses\ntlm.yml", "YAML", 0, 0, 0, 20, 0, 0, 1, 21
"d:\IDEWORK\lvmen\src\licensedcode\data\licenses\ntp-0.yml", "YAML", 0, 0, 0, 9, 0, 0, 1, 10
"d:\IDEWORK\lvmen\src\licensedcode\data\licenses\ntpl-origin.yml", "YAML", 0, 0, 0, 8, 0, 0, 1, 9
"d:\IDEWORK\lvmen\src\licensedcode\data\licenses\ntpl.yml", "YAML", 0, 0, 0, 15, 0, 0, 0, 15
"d:\IDEWORK\lvmen\src\licensedcode\data\licenses\numerical-recipes-notice.yml", "YAML", 0, 0, 0, 10, 0, 0, 1, 11
"d:\IDEWORK\lvmen\src\licensedcode\data\licenses\nunit-v2.yml", "YAML", 0, 0, 0, 13, 0, 0, 1, 14
"d:\IDEWORK\lvmen\src\licensedcode\data\licenses\nvidia-2002.yml", "YAML", 0, 0, 0, 6, 0, 0, 1, 7
"d:\IDEWORK\lvmen\src\licensedcode\data\licenses\nvidia-apex-sdk-eula-2011.yml", "YAML", 0, 0, 0, 18, 0, 0, 2, 20
"d:\IDEWORK\lvmen\src\licensedcode\data\licenses\nvidia-cuda-supplement-2020.yml", "YAML", 0, 0, 0, 74, 0, 0, 1, 75
"d:\IDEWORK\lvmen\src\licensedcode\data\licenses\nvidia-gov.yml", "YAML", 0, 0, 0, 10, 0, 0, 1, 11
"d:\IDEWORK\lvmen\src\licensedcode\data\licenses\nvidia-isaac-eula-2019.1.yml", "YAML", 0, 0, 0, 10, 0, 0, 2, 12
"d:\IDEWORK\lvmen\src\licensedcode\data\licenses\nvidia-ngx-eula-2019.yml", "YAML", 0, 0, 0, 18, 0, 0, 2, 20
"d:\IDEWORK\lvmen\src\licensedcode\data\licenses\nvidia-sdk-eula-v0.11.yml", "YAML", 0, 0, 0, 44, 0, 0, 1, 45
"d:\IDEWORK\lvmen\src\licensedcode\data\licenses\nvidia-video-codec-agreement.yml", "YAML", 0, 0, 0, 7, 0, 0, 1, 8
"d:\IDEWORK\lvmen\src\licensedcode\data\licenses\nvidia.yml", "YAML", 0, 0, 0, 13, 0, 0, 1, 14
"d:\IDEWORK\lvmen\src\licensedcode\data\licenses\nwhm.yml", "YAML", 0, 0, 0, 8, 0, 0, 1, 9
"d:\IDEWORK\lvmen\src\licensedcode\data\licenses\nxp-firmware-patent.yml", "YAML", 0, 0, 0, 9, 0, 0, 1, 10
"d:\IDEWORK\lvmen\src\licensedcode\data\licenses\nxp-linux-firmware.yml", "YAML", 0, 0, 0, 7, 0, 0, 1, 8
"d:\IDEWORK\lvmen\src\licensedcode\data\licenses\nxp-mc-firmware.yml", "YAML", 0, 0, 0, 13, 0, 0, 1, 14
"d:\IDEWORK\lvmen\src\licensedcode\data\licenses\nxp-microcontroller-proprietary.yml", "YAML", 0, 0, 0, 6, 0, 0, 1, 7
"d:\IDEWORK\lvmen\src\licensedcode\data\licenses\nxp-warranty-disclaimer.yml", "YAML", 0, 0, 0, 6, 0, 0, 1, 7
"d:\IDEWORK\lvmen\src\licensedcode\data\licenses\nysl-0.9982.yml", "YAML", 0, 0, 0, 16, 0, 0, 1, 17
"d:\IDEWORK\lvmen\src\licensedcode\data\licenses\o-uda-1.0.yml", "YAML", 0, 0, 0, 10, 0, 0, 1, 11
"d:\IDEWORK\lvmen\src\licensedcode\data\licenses\o-young-jong.yml", "YAML", 0, 0, 0, 6, 0, 0, 1, 7
"d:\IDEWORK\lvmen\src\licensedcode\data\licenses\oasis-ipr-policy-2014.yml", "YAML", 0, 0, 0, 14, 0, 0, 1, 15
"d:\IDEWORK\lvmen\src\licensedcode\data\licenses\oasis-ws-security-spec.yml", "YAML", 0, 0, 0, 13, 0, 0, 1, 14
"d:\IDEWORK\lvmen\src\licensedcode\data\licenses\ocaml-lgpl-linking-exception.yml", "YAML", 0, 0, 0, 10, 0, 0, 1, 11
"d:\IDEWORK\lvmen\src\licensedcode\data\licenses\ocb-non-military-2013.yml", "YAML", 0, 0, 0, 9, 0, 0, 1, 10
"d:\IDEWORK\lvmen\src\licensedcode\data\licenses\ocb-open-source-2013.yml", "YAML", 0, 0, 0, 9, 0, 0, 1, 10
"d:\IDEWORK\lvmen\src\licensedcode\data\licenses\ocb-patent-openssl-2013.yml", "YAML", 0, 0, 0, 9, 0, 0, 1, 10
"d:\IDEWORK\lvmen\src\licensedcode\data\licenses\occt-exception-1.0.yml", "YAML", 0, 0, 0, 22, 0, 0, 1, 23
"d:\IDEWORK\lvmen\src\licensedcode\data\licenses\occt-pl.yml", "YAML", 0, 0, 0, 14, 0, 0, 1, 15
"d:\IDEWORK\lvmen\src\licensedcode\data\licenses\oclc-1.0.yml", "YAML", 0, 0, 0, 18, 0, 0, 1, 19
"d:\IDEWORK\lvmen\src\licensedcode\data\licenses\oclc-2.0.yml", "YAML", 0, 0, 0, 29, 0, 0, 1, 30
"d:\IDEWORK\lvmen\src\licensedcode\data\licenses\ocsl-1.0.yml", "YAML", 0, 0, 0, 11, 0, 0, 1, 12
"d:\IDEWORK\lvmen\src\licensedcode\data\licenses\oculus-sdk-2020.yml", "YAML", 0, 0, 0, 17, 0, 0, 2, 19
"d:\IDEWORK\lvmen\src\licensedcode\data\licenses\oculus-sdk-3.5.yml", "YAML", 0, 0, 0, 27, 0, 0, 2, 29
"d:\IDEWORK\lvmen\src\licensedcode\data\licenses\oculus-sdk.yml", "YAML", 0, 0, 0, 16, 0, 0, 1, 17
"d:\IDEWORK\lvmen\src\licensedcode\data\licenses\odbl-1.0.yml", "YAML", 0, 0, 0, 12, 0, 0, 1, 13
"d:\IDEWORK\lvmen\src\licensedcode\data\licenses\odc-1.0.yml", "YAML", 0, 0, 0, 10, 0, 0, 1, 11
"d:\IDEWORK\lvmen\src\licensedcode\data\licenses\odc-by-1.0.yml", "YAML", 0, 0, 0, 15, 0, 0, 1, 16
"d:\IDEWORK\lvmen\src\licensedcode\data\licenses\odesk user agreement.yml", "YAML", 0, 0, 0, 5, 0, 0, 1, 6
"d:\IDEWORK\lvmen\src\licensedcode\data\licenses\odl.yml", "YAML", 0, 0, 0, 14, 0, 0, 1, 15
"d:\IDEWORK\lvmen\src\licensedcode\data\licenses\ofl-1.0-no-rfn.yml", "YAML", 0, 0, 0, 18, 0, 0, 1, 19
"d:\IDEWORK\lvmen\src\licensedcode\data\licenses\ofl-1.0-rfn.yml", "YAML", 0, 0, 0, 18, 0, 0, 1, 19
"d:\IDEWORK\lvmen\src\licensedcode\data\licenses\ofl-1.0.yml", "YAML", 0, 0, 0, 15, 0, 0, 1, 16
"d:\IDEWORK\lvmen\src\licensedcode\data\licenses\ofl-1.1-no-rfn.yml", "YAML", 0, 0, 0, 24, 0, 0, 1, 25
"d:\IDEWORK\lvmen\src\licensedcode\data\licenses\ofl-1.1-rfn.yml", "YAML", 0, 0, 0, 24, 0, 0, 1, 25
"d:\IDEWORK\lvmen\src\licensedcode\data\licenses\ofl-1.1.yml", "YAML", 0, 0, 0, 21, 0, 0, 2, 23
"d:\IDEWORK\lvmen\src\licensedcode\data\licenses\ogc-1.0.yml", "YAML", 0, 0, 0, 14, 0, 0, 2, 16
"d:\IDEWORK\lvmen\src\licensedcode\data\licenses\ogc-2006.yml", "YAML", 0, 0, 0, 16, 0, 0, 2, 18
"d:\IDEWORK\lvmen\src\licensedcode\data\licenses\ogc-document-2020.yml", "YAML", 0, 0, 0, 16, 0, 0, 1, 17
"d:\IDEWORK\lvmen\src\licensedcode\data\licenses\ogc.yml", "YAML", 0, 0, 0, 9, 0, 0, 1, 10
"d:\IDEWORK\lvmen\src\licensedcode\data\licenses\ogdl-taiwan-1.0.yml", "YAML", 0, 0, 0, 12, 0, 0, 1, 13
"d:\IDEWORK\lvmen\src\licensedcode\data\licenses\ogl-uk-1.0.yml", "YAML", 0, 0, 0, 10, 0, 0, 1, 11
"d:\IDEWORK\lvmen\src\licensedcode\data\licenses\ogl-uk-2.0.yml", "YAML", 0, 0, 0, 11, 0, 0, 1, 12
"d:\IDEWORK\lvmen\src\licensedcode\data\licenses\ogl-uk-3.0.yml", "YAML", 0, 0, 0, 11, 0, 0, 1, 12
"d:\IDEWORK\lvmen\src\licensedcode\data\licenses\ogl-wpd-3.0.yml", "YAML", 0, 0, 0, 10, 0, 0, 1, 11
"d:\IDEWORK\lvmen\src\licensedcode\data\licenses\ogl.yml", "YAML", 0, 0, 0, 5, 0, 0, 1, 6
"d:\IDEWORK\lvmen\src\licensedcode\data\licenses\ok.yml", "YAML", 0, 0, 0, 5, 0, 0, 1, 6
"d:\IDEWORK\lvmen\src\licensedcode\data\licenses\okl.yml", "YAML", 0, 0, 0, 8, 0, 0, 1, 9
"d:\IDEWORK\lvmen\src\licensedcode\data\licenses\open-diameter.yml", "YAML", 0, 0, 0, 12, 0, 0, 1, 13
"d:\IDEWORK\lvmen\src\licensedcode\data\licenses\open-group.yml", "YAML", 0, 0, 0, 9, 0, 0, 1, 10
"d:\IDEWORK\lvmen\src\licensedcode\data\licenses\open-public.yml", "YAML", 0, 0, 0, 12, 0, 0, 1, 13
"d:\IDEWORK\lvmen\src\licensedcode\data\licenses\openbd-exception-3.0.yml", "YAML", 0, 0, 0, 140, 0, 0, 1, 141
"d:\IDEWORK\lvmen\src\licensedcode\data\licenses\opengroup.yml", "YAML", 0, 0, 0, 17, 0, 0, 1, 18
"d:\IDEWORK\lvmen\src\licensedcode\data\licenses\openjdk-assembly-exception-1.0.yml", "YAML", 0, 0, 0, 36, 0, 0, 1, 37
"d:\IDEWORK\lvmen\src\licensedcode\data\licenses\openjdk-classpath-exception-2.0.yml", "YAML", 0, 0, 0, 88, 0, 0, 1, 89
"d:\IDEWORK\lvmen\src\licensedcode\data\licenses\openjdk-exception.yml", "YAML", 0, 0, 0, 18, 0, 0, 1, 19
"d:\IDEWORK\lvmen\src\licensedcode\data\licenses\openldap-1.1.yml", "YAML", 0, 0, 0, 16, 0, 0, 1, 17
"d:\IDEWORK\lvmen\src\licensedcode\data\licenses\openldap-1.2.yml", "YAML", 0, 0, 0, 18, 0, 0, 1, 19
"d:\IDEWORK\lvmen\src\licensedcode\data\licenses\openldap-1.3.yml", "YAML", 0, 0, 0, 19, 0, 0, 1, 20
"d:\IDEWORK\lvmen\src\licensedcode\data\licenses\openldap-1.4.yml", "YAML", 0, 0, 0, 16, 0, 0, 0, 16
"d:\IDEWORK\lvmen\src\licensedcode\data\licenses\openldap-2.0.1.yml", "YAML", 0, 0, 0, 23, 0, 0, 0, 23
"d:\IDEWORK\lvmen\src\licensedcode\data\licenses\openldap-2.0.yml", "YAML", 0, 0, 0, 20, 0, 0, 0, 20
"d:\IDEWORK\lvmen\src\licensedcode\data\licenses\openldap-2.1.yml", "YAML", 0, 0, 0, 20, 0, 0, 0, 20
"d:\IDEWORK\lvmen\src\licensedcode\data\licenses\openldap-2.2.1.yml", "YAML", 0, 0, 0, 18, 0, 0, 0, 18
"d:\IDEWORK\lvmen\src\licensedcode\data\licenses\openldap-2.2.2.yml", "YAML", 0, 0, 0, 18, 0, 0, 0, 18
"d:\IDEWORK\lvmen\src\licensedcode\data\licenses\openldap-2.2.yml", "YAML", 0, 0, 0, 18, 0, 0, 1, 19
"d:\IDEWORK\lvmen\src\licensedcode\data\licenses\openldap-2.3.yml", "YAML", 0, 0, 0, 18, 0, 0, 0, 18
"d:\IDEWORK\lvmen\src\licensedcode\data\licenses\openldap-2.4.yml", "YAML", 0, 0, 0, 16, 0, 0, 0, 16
"d:\IDEWORK\lvmen\src\licensedcode\data\licenses\openldap-2.5.yml", "YAML", 0, 0, 0, 16, 0, 0, 0, 16
"d:\IDEWORK\lvmen\src\licensedcode\data\licenses\openldap-2.6.yml", "YAML", 0, 0, 0, 16, 0, 0, 0, 16
"d:\IDEWORK\lvmen\src\licensedcode\data\licenses\openldap-2.7.yml", "YAML", 0, 0, 0, 16, 0, 0, 0, 16
"d:\IDEWORK\lvmen\src\licensedcode\data\licenses\openldap-2.8.yml", "YAML", 0, 0, 0, 15, 0, 0, 1, 16
"d:\IDEWORK\lvmen\src\licensedcode\data\licenses\openmap.yml", "YAML", 0, 0, 0, 9, 0, 0, 1, 10
"d:\IDEWORK\lvmen\src\licensedcode\data\licenses\openmarket-fastcgi.yml", "YAML", 0, 0, 0, 13, 0, 0, 1, 14
"d:\IDEWORK\lvmen\src\licensedcode\data\licenses\openmotif-exception-2.0-plus.yml", "YAML", 0, 0, 0, 32, 0, 0, 1, 33
"d:\IDEWORK\lvmen\src\licensedcode\data\licenses\openmrs public license.yml", "YAML", 0, 0, 0, 5, 0, 0, 1, 6
"d:\IDEWORK\lvmen\src\licensedcode\data\licenses\opennetcf-shared-source.yml", "YAML", 0, 0, 0, 11, 0, 0, 1, 12
"d:\IDEWORK\lvmen\src\licensedcode\data\licenses\openorb-1.0.yml", "YAML", 0, 0, 0, 18, 0, 0, 1, 19
"d:\IDEWORK\lvmen\src\licensedcode\data\licenses\openpbs-2.3.yml", "YAML", 0, 0, 0, 23, 0, 0, 1, 24
"d:\IDEWORK\lvmen\src\licensedcode\data\licenses\openpub.yml", "YAML", 0, 0, 0, 19, 0, 0, 1, 20
"d:\IDEWORK\lvmen\src\licensedcode\data\licenses\opensaml-1.0.yml", "YAML", 0, 0, 0, 18, 0, 0, 1, 19
"d:\IDEWORK\lvmen\src\licensedcode\data\licenses\openssh.yml", "YAML", 0, 0, 0, 42, 0, 0, 1, 43
"d:\IDEWORK\lvmen\src\licensedcode\data\licenses\openssl-exception-agpl-3.0-monit.yml", "YAML", 0, 0, 0, 8, 0, 0, 1, 9
"d:\IDEWORK\lvmen\src\licensedcode\data\licenses\openssl-exception-agpl-3.0-plus.yml", "YAML", 0, 0, 0, 7, 0, 0, 1, 8
"d:\IDEWORK\lvmen\src\licensedcode\data\licenses\openssl-exception-agpl-3.0.yml", "YAML", 0, 0, 0, 37, 0, 0, 1, 38
"d:\IDEWORK\lvmen\src\licensedcode\data\licenses\openssl-exception-gpl-2.0-plus.yml", "YAML", 0, 0, 0, 28, 0, 0, 1, 29
"d:\IDEWORK\lvmen\src\licensedcode\data\licenses\openssl-exception-gpl-2.0.yml", "YAML", 0, 0, 0, 39, 0, 0, 1, 40
"d:\IDEWORK\lvmen\src\licensedcode\data\licenses\openssl-exception-gpl-3.0-plus.yml", "YAML", 0, 0, 0, 32, 0, 0, 1, 33
"d:\IDEWORK\lvmen\src\licensedcode\data\licenses\openssl-exception-lgpl-2.0-plus.yml", "YAML", 0, 0, 0, 21, 0, 0, 1, 22
"d:\IDEWORK\lvmen\src\licensedcode\data\licenses\openssl-exception-lgpl-3.0-plus.yml", "YAML", 0, 0, 0, 32, 0, 0, 2, 34
"d:\IDEWORK\lvmen\src\licensedcode\data\licenses\openssl-exception-mongodb-sspl.yml", "YAML", 0, 0, 0, 7, 0, 0, 1, 8
"d:\IDEWORK\lvmen\src\licensedcode\data\licenses\openssl-nokia-psk-contribution.yml", "YAML", 0, 0, 0, 10, 0, 0, 1, 11
"d:\IDEWORK\lvmen\src\licensedcode\data\licenses\openssl-ssleay.yml", "YAML", 0, 0, 0, 33, 0, 0, 1, 34
"d:\IDEWORK\lvmen\src\licensedcode\data\licenses\openssl.yml", "YAML", 0, 0, 0, 22, 0, 0, 1, 23
"d:\IDEWORK\lvmen\src\licensedcode\data\licenses\openvpn-as-eula.yml", "YAML", 0, 0, 0, 15, 0, 0, 1, 16
"d:\IDEWORK\lvmen\src\licensedcode\data\licenses\openvpn-openssl-exception.yml", "YAML", 0, 0, 0, 11, 0, 0, 1, 12
"d:\IDEWORK\lvmen\src\licensedcode\data\licenses\opera-eula-2018.yml", "YAML", 0, 0, 0, 14, 0, 0, 1, 15
"d:\IDEWORK\lvmen\src\licensedcode\data\licenses\opera-eula-eea-2018.yml", "YAML", 0, 0, 0, 14, 0, 0, 1, 15
"d:\IDEWORK\lvmen\src\licensedcode\data\licenses\opera-widget-1.0.yml", "YAML", 0, 0, 0, 11, 0, 0, 1, 12
"d:\IDEWORK\lvmen\src\licensedcode\data\licenses\opl-1.0.yml", "YAML", 0, 0, 0, 13, 0, 0, 1, 14
"d:\IDEWORK\lvmen\src\licensedcode\data\licenses\opml-1.0.yml", "YAML", 0, 0, 0, 7, 0, 0, 1, 8
"d:\IDEWORK\lvmen\src\licensedcode\data\licenses\opnl-1.0.yml", "YAML", 0, 0, 0, 15, 0, 0, 1, 16
"d:\IDEWORK\lvmen\src\licensedcode\data\licenses\opnl-2.0.yml", "YAML", 0, 0, 0, 15, 0, 0, 1, 16
"d:\IDEWORK\lvmen\src\licensedcode\data\licenses\oracle binary code license agreement for the java se platform products and javafx.yml", "YAML", 0, 0, 0, 5, 0, 0, 1, 6
"d:\IDEWORK\lvmen\src\licensedcode\data\licenses\oracle-bcl-javaee.yml", "YAML", 0, 0, 0, 10, 0, 0, 1, 11
"d:\IDEWORK\lvmen\src\licensedcode\data\licenses\oracle-bcl-javase-javafx-2012.yml", "YAML", 0, 0, 0, 20, 0, 0, 1, 21
"d:\IDEWORK\lvmen\src\licensedcode\data\licenses\oracle-bcl-javase-javafx-2013.yml", "YAML", 0, 0, 0, 11, 0, 0, 1, 12
"d:\IDEWORK\lvmen\src\licensedcode\data\licenses\oracle-bcl-javase-platform-javafx-2013.yml", "YAML", 0, 0, 0, 15, 0, 0, 1, 16
"d:\IDEWORK\lvmen\src\licensedcode\data\licenses\oracle-bcl-javase-platform-javafx-2017.yml", "YAML", 0, 0, 0, 18, 0, 0, 1, 19
"d:\IDEWORK\lvmen\src\licensedcode\data\licenses\oracle-bcl-jsse-1.0.3.yml", "YAML", 0, 0, 0, 10, 0, 0, 1, 11
"d:\IDEWORK\lvmen\src\licensedcode\data\licenses\oracle-bsd-no-nuclear.yml", "YAML", 0, 0, 0, 12, 0, 0, 1, 13
"d:\IDEWORK\lvmen\src\licensedcode\data\licenses\oracle-code-samples-bsd.yml", "YAML", 0, 0, 0, 6, 0, 0, 1, 7
"d:\IDEWORK\lvmen\src\licensedcode\data\licenses\oracle-commercial-database-11g2.yml", "YAML", 0, 0, 0, 10, 0, 0, 1, 11
"d:\IDEWORK\lvmen\src\licensedcode\data\licenses\oracle-devtools-vsnet-dev.yml", "YAML", 0, 0, 0, 13, 0, 0, 1, 14
"d:\IDEWORK\lvmen\src\licensedcode\data\licenses\oracle-entitlement-05-15.yml", "YAML", 0, 0, 0, 10, 0, 0, 1, 11
"d:\IDEWORK\lvmen\src\licensedcode\data\licenses\oracle-java-ee-sdk-2010.yml", "YAML", 0, 0, 0, 13, 0, 0, 1, 14
"d:\IDEWORK\lvmen\src\licensedcode\data\licenses\oracle-master-agreement.yml", "YAML", 0, 0, 0, 9, 0, 0, 1, 10
"d:\IDEWORK\lvmen\src\licensedcode\data\licenses\oracle-mysql-foss-exception-2.0.yml", "YAML", 0, 0, 0, 35, 0, 0, 1, 36
"d:\IDEWORK\lvmen\src\licensedcode\data\licenses\oracle-openjdk-classpath-exception-2.0.yml", "YAML", 0, 0, 0, 46, 0, 0, 1, 47
"d:\IDEWORK\lvmen\src\licensedcode\data\licenses\oracle-otn-javase-2019.yml", "YAML", 0, 0, 0, 19, 0, 0, 1, 20
"d:\IDEWORK\lvmen\src\licensedcode\data\licenses\oracle-sql-developer.yml", "YAML", 0, 0, 0, 14, 0, 0, 1, 15
"d:\IDEWORK\lvmen\src\licensedcode\data\licenses\oracle-web-sites-tou.yml", "YAML", 0, 0, 0, 18, 0, 0, 1, 19
"d:\IDEWORK\lvmen\src\licensedcode\data\licenses\oreilly-notice.yml", "YAML", 0, 0, 0, 9, 0, 0, 1, 10
"d:\IDEWORK\lvmen\src\licensedcode\data\licenses\os x el capitan license.yml", "YAML", 0, 0, 0, 5, 0, 0, 1, 6
"d:\IDEWORK\lvmen\src\licensedcode\data\licenses\oset-pl-2.1.yml", "YAML", 0, 0, 0, 19, 0, 0, 2, 21
"d:\IDEWORK\lvmen\src\licensedcode\data\licenses\osetpl-2.1.yml", "YAML", 0, 0, 0, 8, 0, 0, 0, 8
"d:\IDEWORK\lvmen\src\licensedcode\data\licenses\osf-1990.yml", "YAML", 0, 0, 0, 9, 0, 0, 1, 10
"d:\IDEWORK\lvmen\src\licensedcode\data\licenses\osgi-spec-2.0.yml", "YAML", 0, 0, 0, 9, 0, 0, 1, 10
"d:\IDEWORK\lvmen\src\licensedcode\data\licenses\osl-1.0.yml", "YAML", 0, 0, 0, 23, 0, 0, 1, 24
"d:\IDEWORK\lvmen\src\licensedcode\data\licenses\osl-1.1.yml", "YAML", 0, 0, 0, 15, 0, 0, 1, 16
"d:\IDEWORK\lvmen\src\licensedcode\data\licenses\osl-2.0.yml", "YAML", 0, 0, 0, 18, 0, 0, 1, 19
"d:\IDEWORK\lvmen\src\licensedcode\data\licenses\osl-2.1.yml", "YAML", 0, 0, 0, 24, 0, 0, 1, 25
"d:\IDEWORK\lvmen\src\licensedcode\data\licenses\osl-3.0.yml", "YAML", 0, 0, 0, 23, 0, 0, 1, 24
"d:\IDEWORK\lvmen\src\licensedcode\data\licenses\ossn-3.0.yml", "YAML", 0, 0, 0, 16, 0, 0, 1, 17
"d:\IDEWORK\lvmen\src\licensedcode\data\licenses\oswego-concurrent.yml", "YAML", 0, 0, 0, 18, 0, 0, 1, 19
"d:\IDEWORK\lvmen\src\licensedcode\data\licenses\other-copyleft.yml", "YAML", 0, 0, 0, 9, 0, 0, 1, 10
"d:\IDEWORK\lvmen\src\licensedcode\data\licenses\other-permissive.yml", "YAML", 0, 0, 0, 9, 0, 0, 1, 10
"d:\IDEWORK\lvmen\src\licensedcode\data\licenses\otn-dev-dist-2009.yml", "YAML", 0, 0, 0, 14, 0, 0, 1, 15
"d:\IDEWORK\lvmen\src\licensedcode\data\licenses\otn-dev-dist-2014.yml", "YAML", 0, 0, 0, 12, 0, 0, 1, 13
"d:\IDEWORK\lvmen\src\licensedcode\data\licenses\otn-dev-dist-2016.yml", "YAML", 0, 0, 0, 12, 0, 0, 1, 13
"d:\IDEWORK\lvmen\src\licensedcode\data\licenses\otn-dev-dist.yml", "YAML", 0, 0, 0, 16, 0, 0, 1, 17
"d:\IDEWORK\lvmen\src\licensedcode\data\licenses\otn-early-adopter-development.yml", "YAML", 0, 0, 0, 13, 0, 0, 1, 14
"d:\IDEWORK\lvmen\src\licensedcode\data\licenses\otn-standard-2014-09.yml", "YAML", 0, 0, 0, 12, 0, 0, 1, 13
"d:\IDEWORK\lvmen\src\licensedcode\data\licenses\owal-1.0.yml", "YAML", 0, 0, 0, 11, 0, 0, 1, 12
"d:\IDEWORK\lvmen\src\licensedcode\data\licenses\owfa-1.0.yml", "YAML", 0, 0, 0, 10, 0, 0, 1, 11
"d:\IDEWORK\lvmen\src\licensedcode\data\licenses\owtchart.yml", "YAML", 0, 0, 0, 26, 0, 0, 1, 27
"d:\IDEWORK\lvmen\src\licensedcode\data\licenses\oxgroup.yml", "YAML", 0, 0, 0, 5, 0, 0, 1, 6
"d:\IDEWORK\lvmen\src\licensedcode\data\licenses\oxygen-xml-webhelp-eula.yml", "YAML", 0, 0, 0, 14, 0, 0, 1, 15
"d:\IDEWORK\lvmen\src\licensedcode\data\licenses\ozplb-1.0.yml", "YAML", 0, 0, 0, 19, 0, 0, 1, 20
"d:\IDEWORK\lvmen\src\licensedcode\data\licenses\ozplb-1.1.yml", "YAML", 0, 0, 0, 18, 0, 0, 1, 19
"d:\IDEWORK\lvmen\src\licensedcode\data\licenses\paint-net.yml", "YAML", 0, 0, 0, 12, 0, 0, 1, 13
"d:\IDEWORK\lvmen\src\licensedcode\data\licenses\paolo-messina-2000.yml", "YAML", 0, 0, 0, 6, 0, 0, 1, 7
"d:\IDEWORK\lvmen\src\licensedcode\data\licenses\paragraph 4 - 5 fulltext.yml", "YAML", 0, 0, 0, 7, 0, 0, 1, 8
"d:\IDEWORK\lvmen\src\licensedcode\data\licenses\paraview-1.2.yml", "YAML", 0, 0, 0, 26, 0, 0, 1, 27
"d:\IDEWORK\lvmen\src\licensedcode\data\licenses\parity-6.0.0.yml", "YAML", 0, 0, 0, 10, 0, 0, 0, 10
"d:\IDEWORK\lvmen\src\licensedcode\data\licenses\parity-7.0.0.yml", "YAML", 0, 0, 0, 8, 0, 0, 0, 8
"d:\IDEWORK\lvmen\src\licensedcode\data\licenses\passive-aggressive.yml", "YAML", 0, 0, 0, 7, 0, 0, 1, 8
"d:\IDEWORK\lvmen\src\licensedcode\data\licenses\patent-disclaimer.yml", "YAML", 0, 0, 0, 6, 0, 0, 1, 7
"d:\IDEWORK\lvmen\src\licensedcode\data\licenses\paul-hsieh-derivative.yml", "YAML", 0, 0, 0, 11, 0, 0, 1, 12
"d:\IDEWORK\lvmen\src\licensedcode\data\licenses\paul-hsieh-exposition.yml", "YAML", 0, 0, 0, 11, 0, 0, 1, 12
"d:\IDEWORK\lvmen\src\licensedcode\data\licenses\paul-mackerras-binary.yml", "YAML", 0, 0, 0, 11, 0, 0, 1, 12
"d:\IDEWORK\lvmen\src\licensedcode\data\licenses\paul-mackerras-new.yml", "YAML", 0, 0, 0, 7, 0, 0, 1, 8
"d:\IDEWORK\lvmen\src\licensedcode\data\licenses\paul-mackerras-simplified.yml", "YAML", 0, 0, 0, 7, 0, 0, 1, 8
"d:\IDEWORK\lvmen\src\licensedcode\data\licenses\paul-mackerras.yml", "YAML", 0, 0, 0, 12, 0, 0, 1, 13
"d:\IDEWORK\lvmen\src\licensedcode\data\licenses\paulo-soares.yml", "YAML", 0, 0, 0, 8, 0, 0, 1, 9
"d:\IDEWORK\lvmen\src\licensedcode\data\licenses\paypal-sdk-2013-2016.yml", "YAML", 0, 0, 0, 15, 0, 0, 2, 17
"d:\IDEWORK\lvmen\src\licensedcode\data\licenses\pbl-1.0.yml", "YAML", 0, 0, 0, 9, 0, 0, 1, 10
"d:\IDEWORK\lvmen\src\licensedcode\data\licenses\pcre.yml", "YAML", 0, 0, 0, 21, 0, 0, 1, 22
"d:\IDEWORK\lvmen\src\licensedcode\data\licenses\pd-mit.yml", "YAML", 0, 0, 0, 9, 0, 0, 1, 10
"d:\IDEWORK\lvmen\src\licensedcode\data\licenses\pd-programming.yml", "YAML", 0, 0, 0, 8, 0, 0, 1, 9
"d:\IDEWORK\lvmen\src\licensedcode\data\licenses\pddl-1.0.yml", "YAML", 0, 0, 0, 13, 0, 0, 1, 14
"d:\IDEWORK\lvmen\src\licensedcode\data\licenses\pdf-creator-pilot.yml", "YAML", 0, 0, 0, 13, 0, 0, 1, 14
"d:\IDEWORK\lvmen\src\licensedcode\data\licenses\pdl-1.0.yml", "YAML", 0, 0, 0, 11, 0, 0, 1, 12
"d:\IDEWORK\lvmen\src\licensedcode\data\licenses\peer production license.yml", "YAML", 0, 0, 0, 5, 0, 0, 1, 6
"d:\IDEWORK\lvmen\src\licensedcode\data\licenses\perl-1.0.yml", "YAML", 0, 0, 0, 10, 0, 0, 1, 11
"d:\IDEWORK\lvmen\src\licensedcode\data\licenses\personal -amp business tos.yml", "YAML", 0, 0, 0, 5, 0, 0, 1, 6
"d:\IDEWORK\lvmen\src\licensedcode\data\licenses\peter-deutsch-document.yml", "YAML", 0, 0, 0, 9, 0, 0, 1, 10
"d:\IDEWORK\lvmen\src\licensedcode\data\licenses\pfe-proprietary-notice.yml", "YAML", 0, 0, 0, 7, 0, 0, 1, 8
"d:\IDEWORK\lvmen\src\licensedcode\data\licenses\pftijah-1.1.yml", "YAML", 0, 0, 0, 9, 0, 0, 1, 10
"d:\IDEWORK\lvmen\src\licensedcode\data\licenses\pftus-1.1.yml", "YAML", 0, 0, 0, 7, 0, 0, 1, 8
"d:\IDEWORK\lvmen\src\licensedcode\data\licenses\phil-bunce.yml", "YAML", 0, 0, 0, 7, 0, 0, 1, 8
"d:\IDEWORK\lvmen\src\licensedcode\data\licenses\philippe-de-muyter.yml", "YAML", 0, 0, 0, 7, 0, 0, 1, 8
"d:\IDEWORK\lvmen\src\licensedcode\data\licenses\philips-proprietary-notice-2000.yml", "YAML", 0, 0, 0, 6, 0, 0, 1, 7
"d:\IDEWORK\lvmen\src\licensedcode\data\licenses\phorum-2.0.yml", "YAML", 0, 0, 0, 25, 0, 0, 2, 27
"d:\IDEWORK\lvmen\src\licensedcode\data\licenses\php license 3.0.1.yml", "YAML", 0, 0, 0, 5, 0, 0, 1, 6
"d:\IDEWORK\lvmen\src\licensedcode\data\licenses\php-2.0.2.yml", "YAML", 0, 0, 0, 19, 0, 0, 1, 20
"d:\IDEWORK\lvmen\src\licensedcode\data\licenses\php-3.0.yml", "YAML", 0, 0, 0, 27, 0, 0, 1, 28
"d:\IDEWORK\lvmen\src\licensedcode\data\licenses\php-3.01.yml", "YAML", 0, 0, 0, 28, 0, 0, 0, 28
"d:\IDEWORK\lvmen\src\licensedcode\data\licenses\pine.yml", "YAML", 0, 0, 0, 15, 0, 0, 1, 16
"d:\IDEWORK\lvmen\src\licensedcode\data\licenses\pivotal-tou.yml", "YAML", 0, 0, 0, 10, 0, 0, 1, 11
"d:\IDEWORK\lvmen\src\licensedcode\data\licenses\pixabay-content.yml", "YAML", 0, 0, 0, 7, 0, 0, 1, 8
"d:\IDEWORK\lvmen\src\licensedcode\data\licenses\planet-source-code.yml", "YAML", 0, 0, 0, 6, 0, 0, 1, 7
"d:\IDEWORK\lvmen\src\licensedcode\data\licenses\pmsdklicense.yml", "YAML", 0, 0, 0, 5, 0, 0, 1, 6
"d:\IDEWORK\lvmen\src\licensedcode\data\licenses\pngsuite.yml", "YAML", 0, 0, 0, 6, 0, 0, 1, 7
"d:\IDEWORK\lvmen\src\licensedcode\data\licenses\pokemon 3d rendered.yml", "YAML", 0, 0, 0, 5, 0, 0, 1, 6
"d:\IDEWORK\lvmen\src\licensedcode\data\licenses\pokerstar.yml", "YAML", 0, 0, 0, 5, 0, 0, 1, 6
"d:\IDEWORK\lvmen\src\licensedcode\data\licenses\politepix-pl-1.0.yml", "YAML", 0, 0, 0, 11, 0, 0, 1, 12
"d:\IDEWORK\lvmen\src\licensedcode\data\licenses\polyform-defensive-1.0.0.yml", "YAML", 0, 0, 0, 14, 0, 0, 1, 15
"d:\IDEWORK\lvmen\src\licensedcode\data\licenses\polyform-free-trial-1.0.0.yml", "YAML", 0, 0, 0, 11, 0, 0, 1, 12
"d:\IDEWORK\lvmen\src\licensedcode\data\licenses\polyform-internal-use-1.0.0.yml", "YAML", 0, 0, 0, 11, 0, 0, 1, 12
"d:\IDEWORK\lvmen\src\licensedcode\data\licenses\polyform-noncommercial-1.0.0.yml", "YAML", 0, 0, 0, 18, 0, 0, 0, 18
"d:\IDEWORK\lvmen\src\licensedcode\data\licenses\polyform-perimeter-1.0.0.yml", "YAML", 0, 0, 0, 15, 0, 0, 1, 16
"d:\IDEWORK\lvmen\src\licensedcode\data\licenses\polyform-shield-1.0.0.yml", "YAML", 0, 0, 0, 17, 0, 0, 1, 18
"d:\IDEWORK\lvmen\src\licensedcode\data\licenses\polyform-small-business-1.0.0.yml", "YAML", 0, 0, 0, 18, 0, 0, 0, 18
"d:\IDEWORK\lvmen\src\licensedcode\data\licenses\polyform-strict-1.0.0.yml", "YAML", 0, 0, 0, 11, 0, 0, 1, 12
"d:\IDEWORK\lvmen\src\licensedcode\data\licenses\postgresql.yml", "YAML", 0, 0, 0, 22, 0, 0, 1, 23
"d:\IDEWORK\lvmen\src\licensedcode\data\licenses\powervr-tools-software-eula.yml", "YAML", 0, 0, 0, 10, 0, 0, 1, 11
"d:\IDEWORK\lvmen\src\licensedcode\data\licenses\ppp.yml", "YAML", 0, 0, 0, 7, 0, 0, 1, 8
"d:\IDEWORK\lvmen\src\licensedcode\data\licenses\proguard-exception-2.0.yml", "YAML", 0, 0, 0, 34, 0, 0, 1, 35
"d:\IDEWORK\lvmen\src\licensedcode\data\licenses\proprietary-license.yml", "YAML", 0, 0, 0, 7, 0, 0, 1, 8
"d:\IDEWORK\lvmen\src\licensedcode\data\licenses\proprietary.yml", "YAML", 0, 0, 0, 7, 0, 0, 1, 8
"d:\IDEWORK\lvmen\src\licensedcode\data\licenses\prosperity-1.0.1.yml", "YAML", 0, 0, 0, 11, 0, 0, 1, 12
"d:\IDEWORK\lvmen\src\licensedcode\data\licenses\prosperity-2.0.yml", "YAML", 0, 0, 0, 9, 0, 0, 1, 10
"d:\IDEWORK\lvmen\src\licensedcode\data\licenses\prosperity-3.0.yml", "YAML", 0, 0, 0, 14, 0, 0, 1, 15
"d:\IDEWORK\lvmen\src\licensedcode\data\licenses\protobuf.yml", "YAML", 0, 0, 0, 8, 0, 0, 1, 9
"d:\IDEWORK\lvmen\src\licensedcode\data\licenses\ps-or-pdf-font-exception-20170817.yml", "YAML", 0, 0, 0, 10, 0, 0, 1, 11
"d:\IDEWORK\lvmen\src\licensedcode\data\licenses\psf-2.0.yml", "YAML", 0, 0, 0, 12, 0, 0, 1, 13
"d:\IDEWORK\lvmen\src\licensedcode\data\licenses\psf-3.7.2.yml", "YAML", 0, 0, 0, 11, 0, 0, 1, 12
"d:\IDEWORK\lvmen\src\licensedcode\data\licenses\psfrag.yml", "YAML", 0, 0, 0, 11, 0, 0, 1, 12
"d:\IDEWORK\lvmen\src\licensedcode\data\licenses\psutils.yml", "YAML", 0, 0, 0, 14, 0, 0, 1, 15
"d:\IDEWORK\lvmen\src\licensedcode\data\licenses\psytec-freesoft.yml", "YAML", 0, 0, 0, 9, 0, 0, 1, 10
"d:\IDEWORK\lvmen\src\licensedcode\data\licenses\public-domain-disclaimer.yml", "YAML", 0, 0, 0, 8, 0, 0, 0, 8
"d:\IDEWORK\lvmen\src\licensedcode\data\licenses\public-domain.yml", "YAML", 0, 0, 0, 12, 0, 0, 1, 13
"d:\IDEWORK\lvmen\src\licensedcode\data\licenses\purdue-bsd.yml", "YAML", 0, 0, 0, 8, 0, 0, 1, 9
"d:\IDEWORK\lvmen\src\licensedcode\data\licenses\pycrypto.yml", "YAML", 0, 0, 0, 7, 0, 0, 1, 8
"d:\IDEWORK\lvmen\src\licensedcode\data\licenses\pygres-2.2.yml", "YAML", 0, 0, 0, 18, 0, 0, 1, 19
"d:\IDEWORK\lvmen\src\licensedcode\data\licenses\python-cwi.yml", "YAML", 0, 0, 0, 12, 0, 0, 1, 13
"d:\IDEWORK\lvmen\src\licensedcode\data\licenses\python.yml", "YAML", 0, 0, 0, 26, 0, 0, 1, 27
"d:\IDEWORK\lvmen\src\licensedcode\data\licenses\qaplug.yml", "YAML", 0, 0, 0, 7, 0, 0, 1, 8
"d:\IDEWORK\lvmen\src\licensedcode\data\licenses\qca-linux-firmware.yml", "YAML", 0, 0, 0, 11, 0, 0, 1, 12
"d:\IDEWORK\lvmen\src\licensedcode\data\licenses\qca-technology.yml", "YAML", 0, 0, 0, 7, 0, 0, 1, 8
"d:\IDEWORK\lvmen\src\licensedcode\data\licenses\qcad-exception-gpl.yml", "YAML", 0, 0, 0, 8, 0, 0, 1, 9
"d:\IDEWORK\lvmen\src\licensedcode\data\licenses\qhull.yml", "YAML", 0, 0, 0, 21, 0, 0, 1, 22
"d:\IDEWORK\lvmen\src\licensedcode\data\licenses\qlogic-firmware.yml", "YAML", 0, 0, 0, 9, 0, 0, 1, 10
"d:\IDEWORK\lvmen\src\licensedcode\data\licenses\qlogic-microcode.yml", "YAML", 0, 0, 0, 7, 0, 0, 1, 8
"d:\IDEWORK\lvmen\src\licensedcode\data\licenses\qpl-1.0.yml", "YAML", 0, 0, 0, 21, 0, 0, 1, 22
"d:\IDEWORK\lvmen\src\licensedcode\data\licenses\qpopper.yml", "YAML", 0, 0, 0, 17, 0, 0, 1, 18
"d:\IDEWORK\lvmen\src\licensedcode\data\licenses\qt-commercial-1.1.yml", "YAML", 0, 0, 0, 16, 0, 0, 1, 17
"d:\IDEWORK\lvmen\src\licensedcode\data\licenses\qt-company-exception-2017-lgpl-2.1.yml", "YAML", 0, 0, 0, 10, 0, 0, 1, 11
"d:\IDEWORK\lvmen\src\licensedcode\data\licenses\qt-company-exception-lgpl-2.1.yml", "YAML", 0, 0, 0, 30, 0, 0, 2, 32
"d:\IDEWORK\lvmen\src\licensedcode\data\licenses\qt-gpl-exception-1.0.yml", "YAML", 0, 0, 0, 8, 0, 0, 1, 9
"d:\IDEWORK\lvmen\src\licensedcode\data\licenses\qt-kde-linking-exception.yml", "YAML", 0, 0, 0, 24, 0, 0, 1, 25
"d:\IDEWORK\lvmen\src\licensedcode\data\licenses\qt-lgpl-exception-1.1.yml", "YAML", 0, 0, 0, 10, 0, 0, 1, 11
"d:\IDEWORK\lvmen\src\licensedcode\data\licenses\qt-qca-exception-2.0.yml", "YAML", 0, 0, 0, 32, 0, 0, 1, 33
"d:\IDEWORK\lvmen\src\licensedcode\data\licenses\qti-linux-firmware.yml", "YAML", 0, 0, 0, 7, 0, 0, 1, 8
"d:\IDEWORK\lvmen\src\licensedcode\data\licenses\qualcomm-iso.yml", "YAML", 0, 0, 0, 14, 0, 0, 1, 15
"d:\IDEWORK\lvmen\src\licensedcode\data\licenses\qualcomm-turing.yml", "YAML", 0, 0, 0, 11, 0, 0, 1, 12
"d:\IDEWORK\lvmen\src\licensedcode\data\licenses\quchaogu base.yml", "YAML", 0, 0, 0, 5, 0, 0, 1, 6
"d:\IDEWORK\lvmen\src\licensedcode\data\licenses\quicktime.yml", "YAML", 0, 0, 0, 9, 0, 0, 1, 10
"d:\IDEWORK\lvmen\src\licensedcode\data\licenses\quin-street.yml", "YAML", 0, 0, 0, 19, 0, 0, 1, 20
"d:\IDEWORK\lvmen\src\licensedcode\data\licenses\quirksmode.yml", "YAML", 0, 0, 0, 10, 0, 0, 1, 11
"d:\IDEWORK\lvmen\src\licensedcode\data\licenses\qwt-1.0.yml", "YAML", 0, 0, 0, 8, 0, 0, 0, 8
"d:\IDEWORK\lvmen\src\licensedcode\data\licenses\qwt-exception-1.0.yml", "YAML", 0, 0, 0, 40, 0, 0, 1, 41
"d:\IDEWORK\lvmen\src\licensedcode\data\licenses\rackspace.yml", "YAML", 0, 0, 0, 6, 0, 0, 1, 7
"d:\IDEWORK\lvmen\src\licensedcode\data\licenses\radvd.yml", "YAML", 0, 0, 0, 11, 0, 0, 1, 12
"d:\IDEWORK\lvmen\src\licensedcode\data\licenses\ralf-corsepius.yml", "YAML", 0, 0, 0, 6, 0, 0, 0, 6
"d:\IDEWORK\lvmen\src\licensedcode\data\licenses\ralink-firmware.yml", "YAML", 0, 0, 0, 9, 0, 0, 1, 10
"d:\IDEWORK\lvmen\src\licensedcode\data\licenses\rar-winrar-eula.yml", "YAML", 0, 0, 0, 7, 0, 0, 1, 8
"d:\IDEWORK\lvmen\src\licensedcode\data\licenses\rcsl-2.0.yml", "YAML", 0, 0, 0, 13, 0, 0, 1, 14
"d:\IDEWORK\lvmen\src\licensedcode\data\licenses\rcsl-3.0.yml", "YAML", 0, 0, 0, 19, 0, 0, 1, 20
"d:\IDEWORK\lvmen\src\licensedcode\data\licenses\rdisc.yml", "YAML", 0, 0, 0, 13, 0, 0, 1, 14
"d:\IDEWORK\lvmen\src\licensedcode\data\licenses\readcube terms of use.yml", "YAML", 0, 0, 0, 5, 0, 0, 1, 6
"d:\IDEWORK\lvmen\src\licensedcode\data\licenses\realm-platform-extension-2017.yml", "YAML", 0, 0, 0, 14, 0, 0, 2, 16
"d:\IDEWORK\lvmen\src\licensedcode\data\licenses\red-hat-attribution.yml", "YAML", 0, 0, 0, 7, 0, 0, 1, 8
"d:\IDEWORK\lvmen\src\licensedcode\data\licenses\red-hat-bsd-simplified.yml", "YAML", 0, 0, 0, 9, 0, 0, 1, 10
"d:\IDEWORK\lvmen\src\licensedcode\data\licenses\red-hat-logos.yml", "YAML", 0, 0, 0, 7, 0, 0, 1, 8
"d:\IDEWORK\lvmen\src\licensedcode\data\licenses\red-hat-trademarks.yml", "YAML", 0, 0, 0, 6, 0, 0, 1, 7
"d:\IDEWORK\lvmen\src\licensedcode\data\licenses\redis-source-available-1.0.yml", "YAML", 0, 0, 0, 11, 0, 0, 1, 12
"d:\IDEWORK\lvmen\src\licensedcode\data\licenses\regexp.yml", "YAML", 0, 0, 0, 11, 0, 0, 0, 11
"d:\IDEWORK\lvmen\src\licensedcode\data\licenses\reportbug.yml", "YAML", 0, 0, 0, 10, 0, 0, 1, 11
"d:\IDEWORK\lvmen\src\licensedcode\data\licenses\repoze.yml", "YAML", 0, 0, 0, 16, 0, 0, 2, 18
"d:\IDEWORK\lvmen\src\licensedcode\data\licenses\repzone.yml", "YAML", 0, 0, 0, 5, 0, 0, 1, 6
"d:\IDEWORK\lvmen\src\licensedcode\data\licenses\rh-eula-lgpl.yml", "YAML", 0, 0, 0, 14, 0, 0, 1, 15
"d:\IDEWORK\lvmen\src\licensedcode\data\licenses\rh-eula.yml", "YAML", 0, 0, 0, 17, 0, 0, 1, 18
"d:\IDEWORK\lvmen\src\licensedcode\data\licenses\richard-black.yml", "YAML", 0, 0, 0, 11, 0, 0, 1, 12
"d:\IDEWORK\lvmen\src\licensedcode\data\licenses\ricoh-1.0.yml", "YAML", 0, 0, 0, 22, 0, 0, 1, 23
"d:\IDEWORK\lvmen\src\licensedcode\data\licenses\riverbank-sip.yml", "YAML", 0, 0, 0, 10, 0, 0, 1, 11
"d:\IDEWORK\lvmen\src\licensedcode\data\licenses\robert-hubley.yml", "YAML", 0, 0, 0, 7, 0, 0, 1, 8
"d:\IDEWORK\lvmen\src\licensedcode\data\licenses\rogue-wave.yml", "YAML", 0, 0, 0, 12, 0, 0, 1, 13
"d:\IDEWORK\lvmen\src\licensedcode\data\licenses\rpl-1.1.yml", "YAML", 0, 0, 0, 25, 0, 0, 0, 25
"d:\IDEWORK\lvmen\src\licensedcode\data\licenses\rpl-1.5.yml", "YAML", 0, 0, 0, 23, 0, 0, 1, 24
"d:\IDEWORK\lvmen\src\licensedcode\data\licenses\rpsl-1.0.yml", "YAML", 0, 0, 0, 28, 0, 0, 1, 29
"d:\IDEWORK\lvmen\src\licensedcode\data\licenses\rrdtool-floss-exception-2.0.yml", "YAML", 0, 0, 0, 12, 0, 0, 1, 13
"d:\IDEWORK\lvmen\src\licensedcode\data\licenses\rsa-1990.yml", "YAML", 0, 0, 0, 9, 0, 0, 1, 10
"d:\IDEWORK\lvmen\src\licensedcode\data\licenses\rsa-cryptoki.yml", "YAML", 0, 0, 0, 9, 0, 0, 1, 10
"d:\IDEWORK\lvmen\src\licensedcode\data\licenses\rsa-demo.yml", "YAML", 0, 0, 0, 6, 0, 0, 1, 7
"d:\IDEWORK\lvmen\src\licensedcode\data\licenses\rsa-md2.yml", "YAML", 0, 0, 0, 6, 0, 0, 1, 7
"d:\IDEWORK\lvmen\src\licensedcode\data\licenses\rsa-md4.yml", "YAML", 0, 0, 0, 6, 0, 0, 1, 7
"d:\IDEWORK\lvmen\src\licensedcode\data\licenses\rsa-md5.yml", "YAML", 0, 0, 0, 12, 0, 0, 0, 12
"d:\IDEWORK\lvmen\src\licensedcode\data\licenses\rsa-proprietary.yml", "YAML", 0, 0, 0, 11, 0, 0, 1, 12
"d:\IDEWORK\lvmen\src\licensedcode\data\licenses\rtools-util.yml", "YAML", 0, 0, 0, 8, 0, 0, 1, 9
"d:\IDEWORK\lvmen\src\licensedcode\data\licenses\ruby.yml", "YAML", 0, 0, 0, 20, 0, 0, 1, 21
"d:\IDEWORK\lvmen\src\licensedcode\data\licenses\rubyencoder-commercial.yml", "YAML", 0, 0, 0, 13, 0, 0, 1, 14
"d:\IDEWORK\lvmen\src\licensedcode\data\licenses\rubyencoder-loader.yml", "YAML", 0, 0, 0, 16, 0, 0, 1, 17
"d:\IDEWORK\lvmen\src\licensedcode\data\licenses\rute.yml", "YAML", 0, 0, 0, 14, 0, 0, 1, 15
"d:\IDEWORK\lvmen\src\licensedcode\data\licenses\rxtx-exception-lgpl-2.1.yml", "YAML", 0, 0, 0, 50, 0, 0, 1, 51
"d:\IDEWORK\lvmen\src\licensedcode\data\licenses\ryszard-szopa.yml", "YAML", 0, 0, 0, 6, 0, 0, 1, 7
"d:\IDEWORK\lvmen\src\licensedcode\data\licenses\saas-mit.yml", "YAML", 0, 0, 0, 8, 0, 0, 1, 9
"d:\IDEWORK\lvmen\src\licensedcode\data\licenses\saf.yml", "YAML", 0, 0, 0, 10, 0, 0, 1, 11
"d:\IDEWORK\lvmen\src\licensedcode\data\licenses\safecopy-eula.yml", "YAML", 0, 0, 0, 7, 0, 0, 1, 8
"d:\IDEWORK\lvmen\src\licensedcode\data\licenses\san-francisco-font.yml", "YAML", 0, 0, 0, 7, 0, 0, 1, 8
"d:\IDEWORK\lvmen\src\licensedcode\data\licenses\sandeep.yml", "YAML", 0, 0, 0, 13, 0, 0, 1, 14
"d:\IDEWORK\lvmen\src\licensedcode\data\licenses\sane-exception-2.0-plus.yml", "YAML", 0, 0, 0, 41, 0, 0, 1, 42
"d:\IDEWORK\lvmen\src\licensedcode\data\licenses\sash.yml", "YAML", 0, 0, 0, 7, 0, 0, 1, 8
"d:\IDEWORK\lvmen\src\licensedcode\data\licenses\sata.yml", "YAML", 0, 0, 0, 20, 0, 0, 1, 21
"d:\IDEWORK\lvmen\src\licensedcode\data\licenses\sax-pd.yml", "YAML", 0, 0, 0, 10, 0, 0, 1, 11
"d:\IDEWORK\lvmen\src\licensedcode\data\licenses\saxpath.yml", "YAML", 0, 0, 0, 19, 0, 0, 0, 19
"d:\IDEWORK\lvmen\src\licensedcode\data\licenses\sbia-b.yml", "YAML", 0, 0, 0, 8, 0, 0, 1, 9
"d:\IDEWORK\lvmen\src\licensedcode\data\licenses\scancode-acknowledgment.yml", "YAML", 0, 0, 0, 10, 0, 0, 1, 11
"d:\IDEWORK\lvmen\src\licensedcode\data\licenses\scanlogd-license.yml", "YAML", 0, 0, 0, 8, 0, 0, 1, 9
"d:\IDEWORK\lvmen\src\licensedcode\data\licenses\scansoft-1.2.yml", "YAML", 0, 0, 0, 16, 0, 0, 1, 17
"d:\IDEWORK\lvmen\src\licensedcode\data\licenses\scea-1.0.yml", "YAML", 0, 0, 0, 14, 0, 0, 0, 14
"d:\IDEWORK\lvmen\src\licensedcode\data\licenses\scheduall software license.yml", "YAML", 0, 0, 0, 5, 0, 0, 1, 6
"d:\IDEWORK\lvmen\src\licensedcode\data\licenses\scilab-en-2005.yml", "YAML", 0, 0, 0, 17, 0, 0, 1, 18
"d:\IDEWORK\lvmen\src\licensedcode\data\licenses\scola-en.yml", "YAML", 0, 0, 0, 9, 0, 0, 1, 10
"d:\IDEWORK\lvmen\src\licensedcode\data\licenses\scribbles.yml", "YAML", 0, 0, 0, 6, 0, 0, 1, 7
"d:\IDEWORK\lvmen\src\licensedcode\data\licenses\script-asylum.yml", "YAML", 0, 0, 0, 7, 0, 0, 1, 8
"d:\IDEWORK\lvmen\src\licensedcode\data\licenses\script-nikhilk.yml", "YAML", 0, 0, 0, 12, 0, 0, 1, 13
"d:\IDEWORK\lvmen\src\licensedcode\data\licenses\scrub.yml", "YAML", 0, 0, 0, 11, 0, 0, 1, 12
"d:\IDEWORK\lvmen\src\licensedcode\data\licenses\scsl-3.0.yml", "YAML", 0, 0, 0, 10, 0, 0, 1, 11
"d:\IDEWORK\lvmen\src\licensedcode\data\licenses\secret-labs-2011.yml", "YAML", 0, 0, 0, 7, 0, 0, 1, 8
"d:\IDEWORK\lvmen\src\licensedcode\data\licenses\see-license.yml", "YAML", 0, 0, 0, 8, 0, 0, 0, 8
"d:\IDEWORK\lvmen\src\licensedcode\data\licenses\selinux-nsa-declaration-1.0.yml", "YAML", 0, 0, 0, 8, 0, 0, 1, 9
"d:\IDEWORK\lvmen\src\licensedcode\data\licenses\sencha-app-floss-exception.yml", "YAML", 0, 0, 0, 12, 0, 0, 1, 13
"d:\IDEWORK\lvmen\src\licensedcode\data\licenses\sencha-commercial-3.17.yml", "YAML", 0, 0, 0, 10, 0, 0, 1, 11
"d:\IDEWORK\lvmen\src\licensedcode\data\licenses\sencha-commercial-3.9.yml", "YAML", 0, 0, 0, 9, 0, 0, 1, 10
"d:\IDEWORK\lvmen\src\licensedcode\data\licenses\sencha-commercial.yml", "YAML", 0, 0, 0, 9, 0, 0, 1, 10
"d:\IDEWORK\lvmen\src\licensedcode\data\licenses\sencha-dev-floss-exception.yml", "YAML", 0, 0, 0, 14, 0, 0, 1, 15
"d:\IDEWORK\lvmen\src\licensedcode\data\licenses\sendmail-8.23.yml", "YAML", 0, 0, 0, 20, 0, 0, 0, 20
"d:\IDEWORK\lvmen\src\licensedcode\data\licenses\sendmail.yml", "YAML", 0, 0, 0, 23, 0, 0, 1, 24
"d:\IDEWORK\lvmen\src\licensedcode\data\licenses\service-comp-arch.yml", "YAML", 0, 0, 0, 10, 0, 0, 1, 11
"d:\IDEWORK\lvmen\src\licensedcode\data\licenses\sfl-license.yml", "YAML", 0, 0, 0, 21, 0, 0, 1, 22
"d:\IDEWORK\lvmen\src\licensedcode\data\licenses\sgi-cid-1.0.yml", "YAML", 0, 0, 0, 17, 0, 0, 1, 18
"d:\IDEWORK\lvmen\src\licensedcode\data\licenses\sgi-freeb-1.1.yml", "YAML", 0, 0, 0, 17, 0, 0, 0, 17
"d:\IDEWORK\lvmen\src\licensedcode\data\licenses\sgi-freeb-2.0.yml", "YAML", 0, 0, 0, 15, 0, 0, 1, 16
"d:\IDEWORK\lvmen\src\licensedcode\data\licenses\sgi-fslb-1.0.yml", "YAML", 0, 0, 0, 11, 0, 0, 0, 11
"d:\IDEWORK\lvmen\src\licensedcode\data\licenses\sgi-glx-1.0.yml", "YAML", 0, 0, 0, 17, 0, 0, 1, 18
"d:\IDEWORK\lvmen\src\licensedcode\data\licenses\sglib.yml", "YAML", 0, 0, 0, 10, 0, 0, 1, 11
"d:\IDEWORK\lvmen\src\licensedcode\data\licenses\shaky shaky - daddy yankee.yml", "YAML", 0, 0, 0, 5, 0, 0, 1, 6
"d:\IDEWORK\lvmen\src\licensedcode\data\licenses\shavlik-eula.yml", "YAML", 0, 0, 0, 9, 0, 0, 1, 10
"d:\IDEWORK\lvmen\src\licensedcode\data\licenses\shinobicontrols license.yml", "YAML", 0, 0, 0, 5, 0, 0, 1, 6
"d:\IDEWORK\lvmen\src\licensedcode\data\licenses\shital-shah.yml", "YAML", 0, 0, 0, 9, 0, 0, 1, 10
"d:\IDEWORK\lvmen\src\licensedcode\data\licenses\shl-0.5.yml", "YAML", 0, 0, 0, 23, 0, 0, 0, 23
"d:\IDEWORK\lvmen\src\licensedcode\data\licenses\shl-0.51.yml", "YAML", 0, 0, 0, 23, 0, 0, 0, 23
"d:\IDEWORK\lvmen\src\licensedcode\data\licenses\shl-2.0.yml", "YAML", 0, 0, 0, 10, 0, 0, 2, 12
"d:\IDEWORK\lvmen\src\licensedcode\data\licenses\shl-2.1.yml", "YAML", 0, 0, 0, 11, 0, 0, 2, 13
"d:\IDEWORK\lvmen\src\licensedcode\data\licenses\simpl-1.1.yml", "YAML", 0, 0, 0, 14, 0, 0, 2, 16
"d:\IDEWORK\lvmen\src\licensedcode\data\licenses\simpl-2.0.yml", "YAML", 0, 0, 0, 15, 0, 0, 1, 16
"d:\IDEWORK\lvmen\src\licensedcode\data\licenses\sip.yml", "YAML", 0, 0, 0, 5, 0, 0, 1, 6
"d:\IDEWORK\lvmen\src\licensedcode\data\licenses\skype terms of use.yml", "YAML", 0, 0, 0, 5, 0, 0, 1, 6
"d:\IDEWORK\lvmen\src\licensedcode\data\licenses\sleepycat.yml", "YAML", 0, 0, 0, 17, 0, 0, 1, 18
"d:\IDEWORK\lvmen\src\licensedcode\data\licenses\slf4j-2005.yml", "YAML", 0, 0, 0, 8, 0, 0, 1, 9
"d:\IDEWORK\lvmen\src\licensedcode\data\licenses\slf4j-2008.yml", "YAML", 0, 0, 0, 8, 0, 0, 1, 9
"d:\IDEWORK\lvmen\src\licensedcode\data\licenses\slysoft-eula.yml", "YAML", 0, 0, 0, 7, 0, 0, 1, 8
"d:\IDEWORK\lvmen\src\licensedcode\data\licenses\smail-gpl.yml", "YAML", 0, 0, 0, 15, 0, 0, 1, 16
"d:\IDEWORK\lvmen\src\licensedcode\data\licenses\smartlabs-freeware.yml", "YAML", 0, 0, 0, 9, 0, 0, 1, 10
"d:\IDEWORK\lvmen\src\licensedcode\data\licenses\smppl.yml", "YAML", 0, 0, 0, 14, 0, 0, 1, 15
"d:\IDEWORK\lvmen\src\licensedcode\data\licenses\sncl.yml", "YAML", 0, 0, 0, 5, 0, 0, 1, 6
"d:\IDEWORK\lvmen\src\licensedcode\data\licenses\snia.yml", "YAML", 0, 0, 0, 33, 0, 0, 0, 33
"d:\IDEWORK\lvmen\src\licensedcode\data\licenses\snmp4j-smi.yml", "YAML", 0, 0, 0, 13, 0, 0, 1, 14
"d:\IDEWORK\lvmen\src\licensedcode\data\licenses\snprintf.yml", "YAML", 0, 0, 0, 6, 0, 0, 1, 7
"d:\IDEWORK\lvmen\src\licensedcode\data\licenses\softerra-ldap-browser-eula.yml", "YAML", 0, 0, 0, 7, 0, 0, 1, 8
"d:\IDEWORK\lvmen\src\licensedcode\data\licenses\softfloat-2.0.yml", "YAML", 0, 0, 0, 14, 0, 0, 1, 15
"d:\IDEWORK\lvmen\src\licensedcode\data\licenses\softfloat.yml", "YAML", 0, 0, 0, 11, 0, 0, 1, 12
"d:\IDEWORK\lvmen\src\licensedcode\data\licenses\softsurfer.yml", "YAML", 0, 0, 0, 9, 0, 0, 1, 10
"d:\IDEWORK\lvmen\src\licensedcode\data\licenses\solace-software-eula-2020.yml", "YAML", 0, 0, 0, 17, 0, 0, 2, 19
"d:\IDEWORK\lvmen\src\licensedcode\data\licenses\solidworks eula.yml", "YAML", 0, 0, 0, 5, 0, 0, 1, 6
"d:\IDEWORK\lvmen\src\licensedcode\data\licenses\space engineers end user license agreement.yml", "YAML", 0, 0, 0, 5, 0, 0, 1, 6
"d:\IDEWORK\lvmen\src\licensedcode\data\licenses\spark-jive.yml", "YAML", 0, 0, 0, 8, 0, 0, 1, 9
"d:\IDEWORK\lvmen\src\licensedcode\data\licenses\sparky.yml", "YAML", 0, 0, 0, 15, 0, 0, 1, 16
"d:\IDEWORK\lvmen\src\licensedcode\data\licenses\speechworks-1.1.yml", "YAML", 0, 0, 0, 16, 0, 0, 1, 17
"d:\IDEWORK\lvmen\src\licensedcode\data\licenses\spell-checker-exception-lgpl-2.1-plus.yml", "YAML", 0, 0, 0, 34, 0, 0, 1, 35
"d:\IDEWORK\lvmen\src\licensedcode\data\licenses\spice-1.1.yml", "YAML", 0, 0, 0, 5, 0, 0, 1, 6
"d:\IDEWORK\lvmen\src\licensedcode\data\licenses\spl-1.0.yml", "YAML", 0, 0, 0, 21, 0, 0, 1, 22
"d:\IDEWORK\lvmen\src\licensedcode\data\licenses\splunk-3pp-eula.yml", "YAML", 0, 0, 0, 9, 0, 0, 1, 10
"d:\IDEWORK\lvmen\src\licensedcode\data\licenses\splunk-mint-tos-2018.yml", "YAML", 0, 0, 0, 15, 0, 0, 1, 16
"d:\IDEWORK\lvmen\src\licensedcode\data\licenses\splunk-sla.yml", "YAML", 0, 0, 0, 16, 0, 0, 1, 17
"d:\IDEWORK\lvmen\src\licensedcode\data\licenses\spotify privacy policy.yml", "YAML", 0, 0, 0, 5, 0, 0, 1, 6
"d:\IDEWORK\lvmen\src\licensedcode\data\licenses\squeak.yml", "YAML", 0, 0, 0, 9, 0, 0, 1, 10
"d:\IDEWORK\lvmen\src\licensedcode\data\licenses\srgb.yml", "YAML", 0, 0, 0, 9, 0, 0, 1, 10
"d:\IDEWORK\lvmen\src\licensedcode\data\licenses\ssleay-windows.yml", "YAML", 0, 0, 0, 21, 0, 0, 2, 23
"d:\IDEWORK\lvmen\src\licensedcode\data\licenses\ssleay.yml", "YAML", 0, 0, 0, 18, 0, 0, 2, 20
"d:\IDEWORK\lvmen\src\licensedcode\data\licenses\st-bsd-restricted.yml", "YAML", 0, 0, 0, 7, 0, 0, 1, 8
"d:\IDEWORK\lvmen\src\licensedcode\data\licenses\st-mcd-2.0.yml", "YAML", 0, 0, 0, 34, 0, 0, 6, 40
"d:\IDEWORK\lvmen\src\licensedcode\data\licenses\standard-ml-nj.yml", "YAML", 0, 0, 0, 27, 0, 0, 1, 28
"d:\IDEWORK\lvmen\src\licensedcode\data\licenses\stanford-mrouted.yml", "YAML", 0, 0, 0, 12, 0, 0, 1, 13
"d:\IDEWORK\lvmen\src\licensedcode\data\licenses\stanford-pvrg.yml", "YAML", 0, 0, 0, 7, 0, 0, 1, 8
"d:\IDEWORK\lvmen\src\licensedcode\data\licenses\statewizard.yml", "YAML", 0, 0, 0, 19, 0, 0, 1, 20
"d:\IDEWORK\lvmen\src\licensedcode\data\licenses\stax.yml", "YAML", 0, 0, 0, 13, 0, 0, 1, 14
"d:\IDEWORK\lvmen\src\licensedcode\data\licenses\stlport-2000.yml", "YAML", 0, 0, 0, 17, 0, 0, 1, 18
"d:\IDEWORK\lvmen\src\licensedcode\data\licenses\stlport-4.5.yml", "YAML", 0, 0, 0, 7, 0, 0, 1, 8
"d:\IDEWORK\lvmen\src\licensedcode\data\licenses\stmicroelectronics-centrallabs.yml", "YAML", 0, 0, 0, 9, 0, 0, 1, 10
"d:\IDEWORK\lvmen\src\licensedcode\data\licenses\stmicroelectronics-linux-firmware.yml", "YAML", 0, 0, 0, 9, 0, 0, 1, 10
"d:\IDEWORK\lvmen\src\licensedcode\data\licenses\stream-benchmark.yml", "YAML", 0, 0, 0, 15, 0, 0, 1, 16
"d:\IDEWORK\lvmen\src\licensedcode\data\licenses\strongswan-exception.yml", "YAML", 0, 0, 0, 7, 0, 0, 1, 8
"d:\IDEWORK\lvmen\src\licensedcode\data\licenses\stu-nicholls.yml", "YAML", 0, 0, 0, 14, 0, 0, 1, 15
"d:\IDEWORK\lvmen\src\licensedcode\data\licenses\subcommander-exception-2.0-plus.yml", "YAML", 0, 0, 0, 32, 0, 0, 1, 33
"d:\IDEWORK\lvmen\src\licensedcode\data\licenses\submit a new code license or terms of service.yml", "YAML", 0, 0, 0, 5, 0, 0, 1, 6
"d:\IDEWORK\lvmen\src\licensedcode\data\licenses\sugarcrm-1.1.3.yml", "YAML", 0, 0, 0, 21, 0, 0, 1, 22
"d:\IDEWORK\lvmen\src\licensedcode\data\licenses\sun-bcl-11-06.yml", "YAML", 0, 0, 0, 8, 0, 0, 1, 9
"d:\IDEWORK\lvmen\src\licensedcode\data\licenses\sun-bcl-11-07.yml", "YAML", 0, 0, 0, 8, 0, 0, 1, 9
"d:\IDEWORK\lvmen\src\licensedcode\data\licenses\sun-bcl-11-08.yml", "YAML", 0, 0, 0, 12, 0, 0, 1, 13
"d:\IDEWORK\lvmen\src\licensedcode\data\licenses\sun-bcl-j2re-1.2.x.yml", "YAML", 0, 0, 0, 8, 0, 0, 1, 9
"d:\IDEWORK\lvmen\src\licensedcode\data\licenses\sun-bcl-j2re-1.4.2.yml", "YAML", 0, 0, 0, 8, 0, 0, 1, 9
"d:\IDEWORK\lvmen\src\licensedcode\data\licenses\sun-bcl-j2re-1.4.x.yml", "YAML", 0, 0, 0, 9, 0, 0, 1, 10
"d:\IDEWORK\lvmen\src\licensedcode\data\licenses\sun-bcl-j2re-5.0.yml", "YAML", 0, 0, 0, 11, 0, 0, 1, 12
"d:\IDEWORK\lvmen\src\licensedcode\data\licenses\sun-bcl-java-servlet-imp-2.1.1.yml", "YAML", 0, 0, 0, 8, 0, 0, 1, 9
"d:\IDEWORK\lvmen\src\licensedcode\data\licenses\sun-bcl-javahelp.yml", "YAML", 0, 0, 0, 9, 0, 0, 1, 10
"d:\IDEWORK\lvmen\src\licensedcode\data\licenses\sun-bcl-jimi-sdk.yml", "YAML", 0, 0, 0, 8, 0, 0, 1, 9
"d:\IDEWORK\lvmen\src\licensedcode\data\licenses\sun-bcl-jre6.yml", "YAML", 0, 0, 0, 9, 0, 0, 1, 10
"d:\IDEWORK\lvmen\src\licensedcode\data\licenses\sun-bcl-jsmq.yml", "YAML", 0, 0, 0, 8, 0, 0, 1, 9
"d:\IDEWORK\lvmen\src\licensedcode\data\licenses\sun-bcl-opendmk.yml", "YAML", 0, 0, 0, 7, 0, 0, 1, 8
"d:\IDEWORK\lvmen\src\licensedcode\data\licenses\sun-bcl-openjdk.yml", "YAML", 0, 0, 0, 11, 0, 0, 1, 12
"d:\IDEWORK\lvmen\src\licensedcode\data\licenses\sun-bcl-sdk-1.3.yml", "YAML", 0, 0, 0, 8, 0, 0, 1, 9
"d:\IDEWORK\lvmen\src\licensedcode\data\licenses\sun-bcl-sdk-1.4.2.yml", "YAML", 0, 0, 0, 12, 0, 0, 1, 13
"d:\IDEWORK\lvmen\src\licensedcode\data\licenses\sun-bcl-sdk-5.0.yml", "YAML", 0, 0, 0, 15, 0, 0, 1, 16
"d:\IDEWORK\lvmen\src\licensedcode\data\licenses\sun-bcl-sdk-6.0.yml", "YAML", 0, 0, 0, 13, 0, 0, 1, 14
"d:\IDEWORK\lvmen\src\licensedcode\data\licenses\sun-bcl-web-start.yml", "YAML", 0, 0, 0, 8, 0, 0, 1, 9
"d:\IDEWORK\lvmen\src\licensedcode\data\licenses\sun-bsd-extra.yml", "YAML", 0, 0, 0, 7, 0, 0, 1, 8
"d:\IDEWORK\lvmen\src\licensedcode\data\licenses\sun-bsd-no-nuclear.yml", "YAML", 0, 0, 0, 11, 0, 0, 1, 12
"d:\IDEWORK\lvmen\src\licensedcode\data\licenses\sun-communications-api.yml", "YAML", 0, 0, 0, 12, 0, 0, 1, 13
"d:\IDEWORK\lvmen\src\licensedcode\data\licenses\sun-ejb-spec-2.1.yml", "YAML", 0, 0, 0, 12, 0, 0, 1, 13
"d:\IDEWORK\lvmen\src\licensedcode\data\licenses\sun-ejb-spec-3.0.yml", "YAML", 0, 0, 0, 11, 0, 0, 1, 12
"d:\IDEWORK\lvmen\src\licensedcode\data\licenses\sun-entitlement-03-15.yml", "YAML", 0, 0, 0, 10, 0, 0, 1, 11
"d:\IDEWORK\lvmen\src\licensedcode\data\licenses\sun-entitlement-jaf.yml", "YAML", 0, 0, 0, 9, 0, 0, 1, 10
"d:\IDEWORK\lvmen\src\licensedcode\data\licenses\sun-glassfish.yml", "YAML", 0, 0, 0, 12, 0, 0, 1, 13
"d:\IDEWORK\lvmen\src\licensedcode\data\licenses\sun-iiop.yml", "YAML", 0, 0, 0, 6, 0, 0, 1, 7
"d:\IDEWORK\lvmen\src\licensedcode\data\licenses\sun-java-transaction-api.yml", "YAML", 0, 0, 0, 9, 0, 0, 1, 10
"d:\IDEWORK\lvmen\src\licensedcode\data\licenses\sun-java-web-services-dev-pack-1.6.yml", "YAML", 0, 0, 0, 9, 0, 0, 1, 10
"d:\IDEWORK\lvmen\src\licensedcode\data\licenses\sun-javamail.yml", "YAML", 0, 0, 0, 8, 0, 0, 1, 9
"d:\IDEWORK\lvmen\src\licensedcode\data\licenses\sun-jsr-spec-04-2006.yml", "YAML", 0, 0, 0, 12, 0, 0, 1, 13
"d:\IDEWORK\lvmen\src\licensedcode\data\licenses\sun-jta-spec-1.0.1.yml", "YAML", 0, 0, 0, 14, 0, 0, 1, 15
"d:\IDEWORK\lvmen\src\licensedcode\data\licenses\sun-jta-spec-1.0.1B.yml", "YAML", 0, 0, 0, 12, 0, 0, 1, 13
"d:\IDEWORK\lvmen\src\licensedcode\data\licenses\sun-no-high-risk-activities.yml", "YAML", 0, 0, 0, 10, 0, 0, 1, 11
"d:\IDEWORK\lvmen\src\licensedcode\data\licenses\sun-project-x.yml", "YAML", 0, 0, 0, 6, 0, 0, 1, 7
"d:\IDEWORK\lvmen\src\licensedcode\data\licenses\sun-prop-non-commercial.yml", "YAML", 0, 0, 0, 6, 0, 0, 1, 7
"d:\IDEWORK\lvmen\src\licensedcode\data\licenses\sun-proprietary-jdk.yml", "YAML", 0, 0, 0, 6, 0, 0, 1, 7
"d:\IDEWORK\lvmen\src\licensedcode\data\licenses\sun-rpc.yml", "YAML", 0, 0, 0, 9, 0, 0, 1, 10
"d:\IDEWORK\lvmen\src\licensedcode\data\licenses\sun-sdk-spec-1.1.yml", "YAML", 0, 0, 0, 12, 0, 0, 1, 13
"d:\IDEWORK\lvmen\src\licensedcode\data\licenses\sun-sissl-1.0.yml", "YAML", 0, 0, 0, 10, 0, 0, 1, 11
"d:\IDEWORK\lvmen\src\licensedcode\data\licenses\sun-sissl-1.1.yml", "YAML", 0, 0, 0, 17, 0, 0, 0, 17
"d:\IDEWORK\lvmen\src\licensedcode\data\licenses\sun-sissl-1.2.yml", "YAML", 0, 0, 0, 15, 0, 0, 1, 16
"d:\IDEWORK\lvmen\src\licensedcode\data\licenses\sun-source.yml", "YAML", 0, 0, 0, 14, 0, 0, 1, 15
"d:\IDEWORK\lvmen\src\licensedcode\data\licenses\sun-ssscfr-1.1.yml", "YAML", 0, 0, 0, 9, 0, 0, 1, 10
"d:\IDEWORK\lvmen\src\licensedcode\data\licenses\sunpro.yml", "YAML", 0, 0, 0, 6, 0, 0, 1, 7
"d:\IDEWORK\lvmen\src\licensedcode\data\licenses\sunsoft.yml", "YAML", 0, 0, 0, 7, 0, 0, 1, 8
"d:\IDEWORK\lvmen\src\licensedcode\data\licenses\supervisor.yml", "YAML", 0, 0, 0, 30, 0, 0, 1, 31
"d:\IDEWORK\lvmen\src\licensedcode\data\licenses\svndiff.yml", "YAML", 0, 0, 0, 7, 0, 0, 1, 8
"d:\IDEWORK\lvmen\src\licensedcode\data\licenses\swig.yml", "YAML", 0, 0, 0, 14, 0, 0, 1, 15
"d:\IDEWORK\lvmen\src\licensedcode\data\licenses\swl.yml", "YAML", 0, 0, 0, 18, 0, 0, 0, 18
"d:\IDEWORK\lvmen\src\licensedcode\data\licenses\sybase.yml", "YAML", 0, 0, 0, 22, 0, 0, 1, 23
"d:\IDEWORK\lvmen\src\licensedcode\data\licenses\sycl.yml", "YAML", 0, 0, 0, 5, 0, 0, 1, 6
"d:\IDEWORK\lvmen\src\licensedcode\data\licenses\symphonysoft.yml", "YAML", 0, 0, 0, 13, 0, 0, 1, 14
"d:\IDEWORK\lvmen\src\licensedcode\data\licenses\synopsys-attribution.yml", "YAML", 0, 0, 0, 6, 0, 0, 1, 7
"d:\IDEWORK\lvmen\src\licensedcode\data\licenses\synopsys-mit.yml", "YAML", 0, 0, 0, 7, 0, 0, 1, 8
"d:\IDEWORK\lvmen\src\licensedcode\data\licenses\syntext-serna-exception-1.0.yml", "YAML", 0, 0, 0, 105, 0, 0, 1, 106
"d:\IDEWORK\lvmen\src\licensedcode\data\licenses\synthesis-toolkit.yml", "YAML", 0, 0, 0, 11, 0, 0, 1, 12
"d:\IDEWORK\lvmen\src\licensedcode\data\licenses\system with xfce platform apache and sql.yml", "YAML", 0, 0, 0, 5, 0, 0, 1, 6
"d:\IDEWORK\lvmen\src\licensedcode\data\licenses\takao-abe.yml", "YAML", 0, 0, 0, 6, 0, 0, 1, 7
"d:\IDEWORK\lvmen\src\licensedcode\data\licenses\takuya-ooura.yml", "YAML", 0, 0, 0, 7, 0, 0, 1, 8
"d:\IDEWORK\lvmen\src\licensedcode\data\licenses\taligent-jdk.yml", "YAML", 0, 0, 0, 8, 0, 0, 1, 9
"d:\IDEWORK\lvmen\src\licensedcode\data\licenses\tanuki-community-sla-1.0.yml", "YAML", 0, 0, 0, 16, 0, 0, 1, 17
"d:\IDEWORK\lvmen\src\licensedcode\data\licenses\tanuki-community-sla-1.1.yml", "YAML", 0, 0, 0, 18, 0, 0, 1, 19
"d:\IDEWORK\lvmen\src\licensedcode\data\licenses\tanuki-community-sla-1.2.yml", "YAML", 0, 0, 0, 18, 0, 0, 1, 19
"d:\IDEWORK\lvmen\src\licensedcode\data\licenses\tanuki-community-sla-1.3.yml", "YAML", 0, 0, 0, 21, 0, 0, 1, 22
"d:\IDEWORK\lvmen\src\licensedcode\data\licenses\tapr-ohl-1.0.yml", "YAML", 0, 0, 0, 16, 0, 0, 0, 16
"d:\IDEWORK\lvmen\src\licensedcode\data\licenses\tatu-ylonen.yml", "YAML", 0, 0, 0, 11, 0, 0, 0, 11
"d:\IDEWORK\lvmen\src\licensedcode\data\licenses\tcl.yml", "YAML", 0, 0, 0, 19, 0, 0, 1, 20
"d:\IDEWORK\lvmen\src\licensedcode\data\licenses\tcp-wrappers.yml", "YAML", 0, 0, 0, 14, 0, 0, 0, 14
"d:\IDEWORK\lvmen\src\licensedcode\data\licenses\teamdev-services.yml", "YAML", 0, 0, 0, 16, 0, 0, 1, 17
"d:\IDEWORK\lvmen\src\licensedcode\data\licenses\tekhvc.yml", "YAML", 0, 0, 0, 8, 0, 0, 1, 9
"d:\IDEWORK\lvmen\src\licensedcode\data\licenses\telepi.yml", "YAML", 0, 0, 0, 5, 0, 0, 1, 6
"d:\IDEWORK\lvmen\src\licensedcode\data\licenses\telerik-eula.yml", "YAML", 0, 0, 0, 13, 0, 0, 1, 14
"d:\IDEWORK\lvmen\src\licensedcode\data\licenses\tenable-nessus.yml", "YAML", 0, 0, 0, 16, 0, 0, 1, 17
"d:\IDEWORK\lvmen\src\licensedcode\data\licenses\term-readkey.yml", "YAML", 0, 0, 0, 6, 0, 0, 1, 7
"d:\IDEWORK\lvmen\src\licensedcode\data\licenses\test license.yml", "YAML", 0, 0, 0, 5, 0, 0, 1, 6
"d:\IDEWORK\lvmen\src\licensedcode\data\licenses\test.yml", "YAML", 0, 0, 0, 5, 0, 0, 1, 6
"d:\IDEWORK\lvmen\src\licensedcode\data\licenses\testcocopods.yml", "YAML", 0, 0, 0, 5, 0, 0, 1, 6
"d:\IDEWORK\lvmen\src\licensedcode\data\licenses\tested-software.yml", "YAML", 0, 0, 0, 6, 0, 0, 1, 7
"d:\IDEWORK\lvmen\src\licensedcode\data\licenses\tex-exception.yml", "YAML", 0, 0, 0, 7, 0, 0, 1, 8
"d:\IDEWORK\lvmen\src\licensedcode\data\licenses\tex-live.yml", "YAML", 0, 0, 0, 19, 0, 0, 1, 20
"d:\IDEWORK\lvmen\src\licensedcode\data\licenses\tfl.yml", "YAML", 0, 0, 0, 12, 0, 0, 1, 13
"d:\IDEWORK\lvmen\src\licensedcode\data\licenses\tgppl-1.0.yml", "YAML", 0, 0, 0, 14, 0, 0, 1, 15
"d:\IDEWORK\lvmen\src\licensedcode\data\licenses\the apache software foundation licenses .yml", "YAML", 0, 0, 0, 5, 0, 0, 1, 6
"d:\IDEWORK\lvmen\src\licensedcode\data\licenses\themeforest regular license.yml", "YAML", 0, 0, 0, 5, 0, 0, 1, 6
"d:\IDEWORK\lvmen\src\licensedcode\data\licenses\things-i-made-public-license.yml", "YAML", 0, 0, 0, 14, 0, 0, 1, 15
"d:\IDEWORK\lvmen\src\licensedcode\data\licenses\thomas-bandt.yml", "YAML", 0, 0, 0, 7, 0, 0, 1, 8
"d:\IDEWORK\lvmen\src\licensedcode\data\licenses\ti-broadband-apps.yml", "YAML", 0, 0, 0, 8, 0, 0, 1, 9
"d:\IDEWORK\lvmen\src\licensedcode\data\licenses\ti-linux-firmware.yml", "YAML", 0, 0, 0, 11, 0, 0, 1, 12
"d:\IDEWORK\lvmen\src\licensedcode\data\licenses\ti-restricted.yml", "YAML", 0, 0, 0, 7, 0, 0, 1, 8
"d:\IDEWORK\lvmen\src\licensedcode\data\licenses\tidy.yml", "YAML", 0, 0, 0, 8, 0, 0, 1, 9
"d:\IDEWORK\lvmen\src\licensedcode\data\licenses\tiger-crypto.yml", "YAML", 0, 0, 0, 11, 0, 0, 1, 12
"d:\IDEWORK\lvmen\src\licensedcode\data\licenses\tigra-calendar-3.2.yml", "YAML", 0, 0, 0, 7, 0, 0, 1, 8
"d:\IDEWORK\lvmen\src\licensedcode\data\licenses\tigra-calendar-4.0.yml", "YAML", 0, 0, 0, 9, 0, 0, 1, 10
"d:\IDEWORK\lvmen\src\licensedcode\data\licenses\tim-janik-2003.yml", "YAML", 0, 0, 0, 7, 0, 0, 1, 8
"d:\IDEWORK\lvmen\src\licensedcode\data\licenses\timestamp-picker.yml", "YAML", 0, 0, 0, 6, 0, 0, 1, 7
"d:\IDEWORK\lvmen\src\licensedcode\data\licenses\tizen-sdk.yml", "YAML", 0, 0, 0, 7, 0, 0, 1, 8
"d:\IDEWORK\lvmen\src\licensedcode\data\licenses\tmate.yml", "YAML", 0, 0, 0, 16, 0, 0, 0, 16
"d:\IDEWORK\lvmen\src\licensedcode\data\licenses\torque-1.1.yml", "YAML", 0, 0, 0, 37, 0, 0, 1, 38
"d:\IDEWORK\lvmen\src\licensedcode\data\licenses\tosg-2.00.yml", "YAML", 0, 0, 0, 5, 0, 0, 1, 6
"d:\IDEWORK\lvmen\src\licensedcode\data\licenses\tosl.yml", "YAML", 0, 0, 0, 25, 0, 0, 0, 25
"d:\IDEWORK\lvmen\src\licensedcode\data\licenses\tpl-1.0.yml", "YAML", 0, 0, 0, 14, 0, 0, 1, 15
"d:\IDEWORK\lvmen\src\licensedcode\data\licenses\trackingteam licence.yml", "YAML", 0, 0, 0, 5, 0, 0, 1, 6
"d:\IDEWORK\lvmen\src\licensedcode\data\licenses\trademark-notice.yml", "YAML", 0, 0, 0, 7, 0, 0, 0, 7
"d:\IDEWORK\lvmen\src\licensedcode\data\licenses\trca-odl-1.0.yml", "YAML", 0, 0, 0, 9, 0, 0, 1, 10
"d:\IDEWORK\lvmen\src\licensedcode\data\licenses\trdrlegal terms of servis.yml", "YAML", 0, 0, 0, 5, 0, 0, 1, 6
"d:\IDEWORK\lvmen\src\licensedcode\data\licenses\treeview-developer.yml", "YAML", 0, 0, 0, 16, 0, 0, 1, 17
"d:\IDEWORK\lvmen\src\licensedcode\data\licenses\treeview-distributor.yml", "YAML", 0, 0, 0, 16, 0, 0, 1, 17
"d:\IDEWORK\lvmen\src\licensedcode\data\licenses\triptracker.yml", "YAML", 0, 0, 0, 9, 0, 0, 1, 10
"d:\IDEWORK\lvmen\src\licensedcode\data\licenses\trolltech-gpl-exception-1.0.yml", "YAML", 0, 0, 0, 9, 0, 0, 1, 10
"d:\IDEWORK\lvmen\src\licensedcode\data\licenses\trolltech-gpl-exception-1.1.yml", "YAML", 0, 0, 0, 9, 0, 0, 1, 10
"d:\IDEWORK\lvmen\src\licensedcode\data\licenses\trolltech-gpl-exception-1.2.yml", "YAML", 0, 0, 0, 8, 0, 0, 1, 9
"d:\IDEWORK\lvmen\src\licensedcode\data\licenses\truecrypt license version 3.0.yml", "YAML", 0, 0, 0, 5, 0, 0, 1, 6
"d:\IDEWORK\lvmen\src\licensedcode\data\licenses\truecrypt-3.1.yml", "YAML", 0, 0, 0, 19, 0, 0, 1, 20
"d:\IDEWORK\lvmen\src\licensedcode\data\licenses\tsl-2018.yml", "YAML", 0, 0, 0, 13, 0, 0, 1, 14
"d:\IDEWORK\lvmen\src\licensedcode\data\licenses\tsl-2020.yml", "YAML", 0, 0, 0, 10, 0, 0, 1, 11
"d:\IDEWORK\lvmen\src\licensedcode\data\licenses\tso-license.yml", "YAML", 0, 0, 0, 8, 0, 0, 1, 9
"d:\IDEWORK\lvmen\src\licensedcode\data\licenses\ttcl.yml", "YAML", 0, 0, 0, 11, 0, 0, 1, 12
"d:\IDEWORK\lvmen\src\licensedcode\data\licenses\ttf2pt1.yml", "YAML", 0, 0, 0, 8, 0, 0, 1, 9
"d:\IDEWORK\lvmen\src\licensedcode\data\licenses\ttyp0.yml", "YAML", 0, 0, 0, 10, 0, 0, 1, 11
"d:\IDEWORK\lvmen\src\licensedcode\data\licenses\tu-berlin-2.0.yml", "YAML", 0, 0, 0, 10, 0, 0, 0, 10
"d:\IDEWORK\lvmen\src\licensedcode\data\licenses\tu-berlin.yml", "YAML", 0, 0, 0, 11, 0, 0, 0, 11
"d:\IDEWORK\lvmen\src\licensedcode\data\licenses\tumbolia.yml", "YAML", 0, 0, 0, 16, 0, 0, 2, 18
"d:\IDEWORK\lvmen\src\licensedcode\data\licenses\twisted-snmp.yml", "YAML", 0, 0, 0, 8, 0, 0, 1, 9
"d:\IDEWORK\lvmen\src\licensedcode\data\licenses\txl-10.5.yml", "YAML", 0, 0, 0, 14, 0, 0, 1, 15
"d:\IDEWORK\lvmen\src\licensedcode\data\licenses\u-boot-exception-2.0.yml", "YAML", 0, 0, 0, 41, 0, 0, 1, 42
"d:\IDEWORK\lvmen\src\licensedcode\data\licenses\ubc.yml", "YAML", 0, 0, 0, 9, 0, 0, 1, 10
"d:\IDEWORK\lvmen\src\licensedcode\data\licenses\ubdl.yml", "YAML", 0, 0, 0, 11, 0, 0, 1, 12
"d:\IDEWORK\lvmen\src\licensedcode\data\licenses\ubuntu-font-1.0.yml", "YAML", 0, 0, 0, 16, 0, 0, 1, 17
"d:\IDEWORK\lvmen\src\licensedcode\data\licenses\ucl-1.0.yml", "YAML", 0, 0, 0, 20, 0, 0, 0, 20
"d:\IDEWORK\lvmen\src\licensedcode\data\licenses\ufl-1.0.yml", "YAML", 0, 0, 0, 5, 0, 0, 1, 6
"d:\IDEWORK\lvmen\src\licensedcode\data\licenses\unbuntu-font-1.0.yml", "YAML", 0, 0, 0, 13, 0, 0, 1, 14
"d:\IDEWORK\lvmen\src\licensedcode\data\licenses\unicode-data-software.yml", "YAML", 0, 0, 0, 10, 0, 0, 1, 11
"d:\IDEWORK\lvmen\src\licensedcode\data\licenses\unicode-dfs-2015.yml", "YAML", 0, 0, 0, 20, 0, 0, 0, 20
"d:\IDEWORK\lvmen\src\licensedcode\data\licenses\unicode-dfs-2016.yml", "YAML", 0, 0, 0, 23, 0, 0, 0, 23
"d:\IDEWORK\lvmen\src\licensedcode\data\licenses\unicode-icu-58.yml", "YAML", 0, 0, 0, 48, 0, 0, 1, 49
"d:\IDEWORK\lvmen\src\licensedcode\data\licenses\unicode-mappings.yml", "YAML", 0, 0, 0, 6, 0, 0, 1, 7
"d:\IDEWORK\lvmen\src\licensedcode\data\licenses\unicode-tou.yml", "YAML", 0, 0, 0, 12, 0, 0, 0, 12
"d:\IDEWORK\lvmen\src\licensedcode\data\licenses\unicode.yml", "YAML", 0, 0, 0, 20, 0, 0, 1, 21
"d:\IDEWORK\lvmen\src\licensedcode\data\licenses\universal-foss-exception-1.0.yml", "YAML", 0, 0, 0, 10, 0, 0, 1, 11
"d:\IDEWORK\lvmen\src\licensedcode\data\licenses\unknown-license-reference.yml", "YAML", 0, 0, 0, 9, 0, 0, 1, 10
"d:\IDEWORK\lvmen\src\licensedcode\data\licenses\unknown-spdx.yml", "YAML", 0, 0, 0, 9, 0, 0, 0, 9
"d:\IDEWORK\lvmen\src\licensedcode\data\licenses\unknown.yml", "YAML", 0, 0, 0, 8, 0, 0, 1, 9
"d:\IDEWORK\lvmen\src\licensedcode\data\licenses\unlicence.yml", "YAML", 0, 0, 0, 5, 0, 0, 1, 6
"d:\IDEWORK\lvmen\src\licensedcode\data\licenses\unlicense.yml", "YAML", 0, 0, 0, 14, 0, 0, 1, 15
"d:\IDEWORK\lvmen\src\licensedcode\data\licenses\unlimited-binary-linking.yml", "YAML", 0, 0, 0, 7, 0, 0, 1, 8
"d:\IDEWORK\lvmen\src\licensedcode\data\licenses\unlimited-linking-exception-gpl.yml", "YAML", 0, 0, 0, 8, 0, 0, 1, 9
"d:\IDEWORK\lvmen\src\licensedcode\data\licenses\unlimited-linking-exception-lgpl.yml", "YAML", 0, 0, 0, 35, 0, 0, 1, 36
"d:\IDEWORK\lvmen\src\licensedcode\data\licenses\unpbook.yml", "YAML", 0, 0, 0, 7, 0, 0, 1, 8
"d:\IDEWORK\lvmen\src\licensedcode\data\licenses\unpublished-source.yml", "YAML", 0, 0, 0, 6, 0, 0, 1, 7
"d:\IDEWORK\lvmen\src\licensedcode\data\licenses\unrar.yml", "YAML", 0, 0, 0, 8, 0, 0, 1, 9
"d:\IDEWORK\lvmen\src\licensedcode\data\licenses\unreal engine end user license agreement v9.yml", "YAML", 0, 0, 0, 5, 0, 0, 1, 6
"d:\IDEWORK\lvmen\src\licensedcode\data\licenses\uofu-rfpl.yml", "YAML", 0, 0, 0, 15, 0, 0, 1, 16
"d:\IDEWORK\lvmen\src\licensedcode\data\licenses\uoi-ncsa.yml", "YAML", 0, 0, 0, 19, 0, 0, 1, 20
"d:\IDEWORK\lvmen\src\licensedcode\data\licenses\upl-1.0.yml", "YAML", 0, 0, 0, 14, 0, 0, 1, 15
"d:\IDEWORK\lvmen\src\licensedcode\data\licenses\upx-exception-2.0-plus.yml", "YAML", 0, 0, 0, 94, 0, 0, 1, 95
"d:\IDEWORK\lvmen\src\licensedcode\data\licenses\us-govt-public-domain.yml", "YAML", 0, 0, 0, 13, 0, 0, 1, 14
"d:\IDEWORK\lvmen\src\licensedcode\data\licenses\us-govt-unlimited-rights.yml", "YAML", 0, 0, 0, 11, 0, 0, 1, 12
"d:\IDEWORK\lvmen\src\licensedcode\data\licenses\use license.yml", "YAML", 0, 0, 0, 5, 0, 0, 1, 6
"d:\IDEWORK\lvmen\src\licensedcode\data\licenses\usrobotics-permissive.yml", "YAML", 0, 0, 0, 25, 0, 0, 1, 26
"d:\IDEWORK\lvmen\src\licensedcode\data\licenses\utopia.yml", "YAML", 0, 0, 0, 16, 0, 0, 1, 17
"d:\IDEWORK\lvmen\src\licensedcode\data\licenses\valve corporation steamworks sdk access agreement.yml", "YAML", 0, 0, 0, 5, 0, 0, 1, 6
"d:\IDEWORK\lvmen\src\licensedcode\data\licenses\vatspy eula.yml", "YAML", 0, 0, 0, 5, 0, 0, 1, 6
"d:\IDEWORK\lvmen\src\licensedcode\data\licenses\vbaccelerator.yml", "YAML", 0, 0, 0, 7, 0, 0, 1, 8
"d:\IDEWORK\lvmen\src\licensedcode\data\licenses\vcalendar.yml", "YAML", 0, 0, 0, 7, 0, 0, 1, 8
"d:\IDEWORK\lvmen\src\licensedcode\data\licenses\verbatim-manual.yml", "YAML", 0, 0, 0, 12, 0, 0, 1, 13
"d:\IDEWORK\lvmen\src\licensedcode\data\licenses\verisign.yml", "YAML", 0, 0, 0, 14, 0, 0, 1, 15
"d:\IDEWORK\lvmen\src\licensedcode\data\licenses\vhfpl-1.1.yml", "YAML", 0, 0, 0, 18, 0, 0, 2, 20
"d:\IDEWORK\lvmen\src\licensedcode\data\licenses\vic-metcalfe-pd.yml", "YAML", 0, 0, 0, 13, 0, 0, 1, 14
"d:\IDEWORK\lvmen\src\licensedcode\data\licenses\vicomsoft-software.yml", "YAML", 0, 0, 0, 7, 0, 0, 1, 8
"d:\IDEWORK\lvmen\src\licensedcode\data\licenses\vidio68.yml", "YAML", 0, 0, 0, 5, 0, 0, 1, 6
"d:\IDEWORK\lvmen\src\licensedcode\data\licenses\viewflow-agpl-3.0-exception.yml", "YAML", 0, 0, 0, 14, 0, 0, 1, 15
"d:\IDEWORK\lvmen\src\licensedcode\data\licenses\vim.yml", "YAML", 0, 0, 0, 15, 0, 0, 0, 15
"d:\IDEWORK\lvmen\src\licensedcode\data\licenses\visual-idiot.yml", "YAML", 0, 0, 0, 7, 0, 0, 1, 8
"d:\IDEWORK\lvmen\src\licensedcode\data\licenses\visual-numerics.yml", "YAML", 0, 0, 0, 8, 0, 0, 1, 9
"d:\IDEWORK\lvmen\src\licensedcode\data\licenses\vitesse-prop.yml", "YAML", 0, 0, 0, 6, 0, 0, 1, 7
"d:\IDEWORK\lvmen\src\licensedcode\data\licenses\vivaldi browser eula.yml", "YAML", 0, 0, 0, 5, 0, 0, 1, 6
"d:\IDEWORK\lvmen\src\licensedcode\data\licenses\vixie-cron.yml", "YAML", 0, 0, 0, 8, 0, 0, 1, 9
"d:\IDEWORK\lvmen\src\licensedcode\data\licenses\vmware vsphere end user license agreement.yml", "YAML", 0, 0, 0, 5, 0, 0, 1, 6
"d:\IDEWORK\lvmen\src\licensedcode\data\licenses\vnc-viewer-ios.yml", "YAML", 0, 0, 0, 9, 0, 0, 1, 10
"d:\IDEWORK\lvmen\src\licensedcode\data\licenses\volatility-vsl-v1.0.yml", "YAML", 0, 0, 0, 15, 0, 0, 1, 16
"d:\IDEWORK\lvmen\src\licensedcode\data\licenses\vostrom.yml", "YAML", 0, 0, 0, 16, 0, 0, 0, 16
"d:\IDEWORK\lvmen\src\licensedcode\data\licenses\vpl-1.1.yml", "YAML", 0, 0, 0, 16, 0, 0, 1, 17
"d:\IDEWORK\lvmen\src\licensedcode\data\licenses\vpl-1.2.yml", "YAML", 0, 0, 0, 14, 0, 0, 1, 15
"d:\IDEWORK\lvmen\src\licensedcode\data\licenses\vs10x-code-map.yml", "YAML", 0, 0, 0, 7, 0, 0, 1, 8
"d:\IDEWORK\lvmen\src\licensedcode\data\licenses\vsl-1.0.yml", "YAML", 0, 0, 0, 25, 0, 0, 1, 26
"d:\IDEWORK\lvmen\src\licensedcode\data\licenses\vspl.yml", "YAML", 0, 0, 0, 5, 0, 0, 1, 6
"d:\IDEWORK\lvmen\src\licensedcode\data\licenses\vuforia-2013-07-29.yml", "YAML", 0, 0, 0, 14, 0, 0, 1, 15
"d:\IDEWORK\lvmen\src\licensedcode\data\licenses\w3c-docs-19990405.yml", "YAML", 0, 0, 0, 17, 0, 0, 1, 18
"d:\IDEWORK\lvmen\src\licensedcode\data\licenses\w3c-docs-20021231.yml", "YAML", 0, 0, 0, 15, 0, 0, 1, 16
"d:\IDEWORK\lvmen\src\licensedcode\data\licenses\w3c-documentation.yml", "YAML", 0, 0, 0, 19, 0, 0, 1, 20
"d:\IDEWORK\lvmen\src\licensedcode\data\licenses\w3c-software-19980720.yml", "YAML", 0, 0, 0, 20, 0, 0, 0, 20
"d:\IDEWORK\lvmen\src\licensedcode\data\licenses\w3c-software-20021231.yml", "YAML", 0, 0, 0, 8, 0, 0, 1, 9
"d:\IDEWORK\lvmen\src\licensedcode\data\licenses\w3c-software-doc-20150513.yml", "YAML", 0, 0, 0, 21, 0, 0, 0, 21
"d:\IDEWORK\lvmen\src\licensedcode\data\licenses\w3c.yml", "YAML", 0, 0, 0, 19, 0, 0, 1, 20
"d:\IDEWORK\lvmen\src\licensedcode\data\licenses\warranty-disclaimer.yml", "YAML", 0, 0, 0, 9, 0, 0, 1, 10
"d:\IDEWORK\lvmen\src\licensedcode\data\licenses\waterfall-feed-parser.yml", "YAML", 0, 0, 0, 7, 0, 0, 1, 8
"d:\IDEWORK\lvmen\src\licensedcode\data\licenses\webressources.yml", "YAML", 0, 0, 0, 5, 0, 0, 1, 6
"d:\IDEWORK\lvmen\src\licensedcode\data\licenses\westhawk.yml", "YAML", 0, 0, 0, 9, 0, 0, 1, 10
"d:\IDEWORK\lvmen\src\licensedcode\data\licenses\whistle.yml", "YAML", 0, 0, 0, 6, 0, 0, 1, 7
"d:\IDEWORK\lvmen\src\licensedcode\data\licenses\whitecat.yml", "YAML", 0, 0, 0, 7, 0, 0, 1, 8
"d:\IDEWORK\lvmen\src\licensedcode\data\licenses\wide-license.yml", "YAML", 0, 0, 0, 8, 0, 0, 1, 9
"d:\IDEWORK\lvmen\src\licensedcode\data\licenses\wifi-alliance.yml", "YAML", 0, 0, 0, 8, 0, 0, 1, 9
"d:\IDEWORK\lvmen\src\licensedcode\data\licenses\william-alexander.yml", "YAML", 0, 0, 0, 11, 0, 0, 1, 12
"d:\IDEWORK\lvmen\src\licensedcode\data\licenses\wince-50-shared-source.yml", "YAML", 0, 0, 0, 9, 0, 0, 1, 10
"d:\IDEWORK\lvmen\src\licensedcode\data\licenses\windriver-commercial.yml", "YAML", 0, 0, 0, 9, 0, 0, 1, 10
"d:\IDEWORK\lvmen\src\licensedcode\data\licenses\wingo.yml", "YAML", 0, 0, 0, 16, 0, 0, 1, 17
"d:\IDEWORK\lvmen\src\licensedcode\data\licenses\wink.yml", "YAML", 0, 0, 0, 7, 0, 0, 1, 8
"d:\IDEWORK\lvmen\src\licensedcode\data\licenses\winzip-eula.yml", "YAML", 0, 0, 0, 20, 0, 0, 1, 21
"d:\IDEWORK\lvmen\src\licensedcode\data\licenses\winzip-self-extractor.yml", "YAML", 0, 0, 0, 7, 0, 0, 1, 8
"d:\IDEWORK\lvmen\src\licensedcode\data\licenses\wizardry license.yml", "YAML", 0, 0, 0, 5, 0, 0, 1, 6
"d:\IDEWORK\lvmen\src\licensedcode\data\licenses\wol.yml", "YAML", 0, 0, 0, 9, 0, 0, 1, 10
"d:\IDEWORK\lvmen\src\licensedcode\data\licenses\wordnet.yml", "YAML", 0, 0, 0, 13, 0, 0, 1, 14
"d:\IDEWORK\lvmen\src\licensedcode\data\licenses\wrox-download.yml", "YAML", 0, 0, 0, 8, 0, 0, 1, 9
"d:\IDEWORK\lvmen\src\licensedcode\data\licenses\wrox.yml", "YAML", 0, 0, 0, 16, 0, 0, 1, 17
"d:\IDEWORK\lvmen\src\licensedcode\data\licenses\ws-addressing-spec.yml", "YAML", 0, 0, 0, 12, 0, 0, 1, 13
"d:\IDEWORK\lvmen\src\licensedcode\data\licenses\ws-policy-specification.yml", "YAML", 0, 0, 0, 9, 0, 0, 1, 10
"d:\IDEWORK\lvmen\src\licensedcode\data\licenses\ws-trust-specification.yml", "YAML", 0, 0, 0, 9, 0, 0, 1, 10
"d:\IDEWORK\lvmen\src\licensedcode\data\licenses\wsuipa.yml", "YAML", 0, 0, 0, 11, 0, 0, 0, 11
"d:\IDEWORK\lvmen\src\licensedcode\data\licenses\wtfpl-1.0.yml", "YAML", 0, 0, 0, 25, 0, 0, 1, 26
"d:\IDEWORK\lvmen\src\licensedcode\data\licenses\wtfpl-2.0.yml", "YAML", 0, 0, 0, 5, 0, 0, 1, 6
"d:\IDEWORK\lvmen\src\licensedcode\data\licenses\wthpl-1.0.yml", "YAML", 0, 0, 0, 9, 0, 0, 1, 10
"d:\IDEWORK\lvmen\src\licensedcode\data\licenses\wxwidgets.yml", "YAML", 0, 0, 0, 15, 0, 0, 1, 16
"d:\IDEWORK\lvmen\src\licensedcode\data\licenses\wxwindows-exception-3.1.yml", "YAML", 0, 0, 0, 52, 0, 0, 1, 53
"d:\IDEWORK\lvmen\src\licensedcode\data\licenses\wxwindows-r-3.0.yml", "YAML", 0, 0, 0, 14, 0, 0, 1, 15
"d:\IDEWORK\lvmen\src\licensedcode\data\licenses\wxwindows-u-3.0.yml", "YAML", 0, 0, 0, 15, 0, 0, 1, 16
"d:\IDEWORK\lvmen\src\licensedcode\data\licenses\wxwindows.yml", "YAML", 0, 0, 0, 5, 0, 0, 1, 6
"d:\IDEWORK\lvmen\src\licensedcode\data\licenses\x11-acer.yml", "YAML", 0, 0, 0, 9, 0, 0, 1, 10
"d:\IDEWORK\lvmen\src\licensedcode\data\licenses\x11-adobe-dec.yml", "YAML", 0, 0, 0, 7, 0, 0, 1, 8
"d:\IDEWORK\lvmen\src\licensedcode\data\licenses\x11-adobe.yml", "YAML", 0, 0, 0, 9, 0, 0, 1, 10
"d:\IDEWORK\lvmen\src\licensedcode\data\licenses\x11-bitstream.yml", "YAML", 0, 0, 0, 11, 0, 0, 1, 12
"d:\IDEWORK\lvmen\src\licensedcode\data\licenses\x11-dec1.yml", "YAML", 0, 0, 0, 10, 0, 0, 1, 11
"d:\IDEWORK\lvmen\src\licensedcode\data\licenses\x11-dec2.yml", "YAML", 0, 0, 0, 10, 0, 0, 1, 11
"d:\IDEWORK\lvmen\src\licensedcode\data\licenses\x11-doc.yml", "YAML", 0, 0, 0, 13, 0, 0, 1, 14
"d:\IDEWORK\lvmen\src\licensedcode\data\licenses\x11-dsc.yml", "YAML", 0, 0, 0, 13, 0, 0, 1, 14
"d:\IDEWORK\lvmen\src\licensedcode\data\licenses\x11-fsf.yml", "YAML", 0, 0, 0, 7, 0, 0, 1, 8
"d:\IDEWORK\lvmen\src\licensedcode\data\licenses\x11-hanson.yml", "YAML", 0, 0, 0, 8, 0, 0, 1, 9
"d:\IDEWORK\lvmen\src\licensedcode\data\licenses\x11-ibm.yml", "YAML", 0, 0, 0, 10, 0, 0, 1, 11
"d:\IDEWORK\lvmen\src\licensedcode\data\licenses\x11-keith-packard.yml", "YAML", 0, 0, 0, 10, 0, 0, 1, 11
"d:\IDEWORK\lvmen\src\licensedcode\data\licenses\x11-lucent-variant.yml", "YAML", 0, 0, 0, 7, 0, 0, 1, 8
"d:\IDEWORK\lvmen\src\licensedcode\data\licenses\x11-lucent.yml", "YAML", 0, 0, 0, 7, 0, 0, 1, 8
"d:\IDEWORK\lvmen\src\licensedcode\data\licenses\x11-oar.yml", "YAML", 0, 0, 0, 9, 0, 0, 1, 10
"d:\IDEWORK\lvmen\src\licensedcode\data\licenses\x11-opengl.yml", "YAML", 0, 0, 0, 7, 0, 0, 1, 8
"d:\IDEWORK\lvmen\src\licensedcode\data\licenses\x11-opengroup.yml", "YAML", 0, 0, 0, 18, 0, 0, 1, 19
"d:\IDEWORK\lvmen\src\licensedcode\data\licenses\x11-quarterdeck.yml", "YAML", 0, 0, 0, 7, 0, 0, 1, 8
"d:\IDEWORK\lvmen\src\licensedcode\data\licenses\x11-r75.yml", "YAML", 0, 0, 0, 14, 0, 0, 1, 15
"d:\IDEWORK\lvmen\src\licensedcode\data\licenses\x11-realmode.yml", "YAML", 0, 0, 0, 11, 0, 0, 1, 12
"d:\IDEWORK\lvmen\src\licensedcode\data\licenses\x11-sg.yml", "YAML", 0, 0, 0, 10, 0, 0, 1, 11
"d:\IDEWORK\lvmen\src\licensedcode\data\licenses\x11-stanford.yml", "YAML", 0, 0, 0, 9, 0, 0, 1, 10
"d:\IDEWORK\lvmen\src\licensedcode\data\licenses\x11-tektronix.yml", "YAML", 0, 0, 0, 10, 0, 0, 1, 11
"d:\IDEWORK\lvmen\src\licensedcode\data\licenses\x11-tiff.yml", "YAML", 0, 0, 0, 10, 0, 0, 1, 11
"d:\IDEWORK\lvmen\src\licensedcode\data\licenses\x11-x11r5.yml", "YAML", 0, 0, 0, 10, 0, 0, 1, 11
"d:\IDEWORK\lvmen\src\licensedcode\data\licenses\x11-xconsortium.yml", "YAML", 0, 0, 0, 13, 0, 0, 1, 14
"d:\IDEWORK\lvmen\src\licensedcode\data\licenses\x11-xconsortium_veillard.yml", "YAML", 0, 0, 0, 11, 0, 0, 1, 12
"d:\IDEWORK\lvmen\src\licensedcode\data\licenses\x11.yml", "YAML", 0, 0, 0, 15, 0, 0, 1, 16
"d:\IDEWORK\lvmen\src\licensedcode\data\licenses\x11r5-authors.yml", "YAML", 0, 0, 0, 9, 0, 0, 0, 9
"d:\IDEWORK\lvmen\src\licensedcode\data\licenses\xenomai-gpl-exception.yml", "YAML", 0, 0, 0, 8, 0, 0, 1, 9
"d:\IDEWORK\lvmen\src\licensedcode\data\licenses\xfree86-1.0.yml", "YAML", 0, 0, 0, 10, 0, 0, 2, 12
"d:\IDEWORK\lvmen\src\licensedcode\data\licenses\xfree86-1.1.yml", "YAML", 0, 0, 0, 16, 0, 0, 1, 17
"d:\IDEWORK\lvmen\src\licensedcode\data\licenses\xilinx-2016.yml", "YAML", 0, 0, 0, 6, 0, 0, 1, 7
"d:\IDEWORK\lvmen\src\licensedcode\data\licenses\xinetd.yml", "YAML", 0, 0, 0, 18, 0, 0, 1, 19
"d:\IDEWORK\lvmen\src\licensedcode\data\licenses\xming.yml", "YAML", 0, 0, 0, 7, 0, 0, 1, 8
"d:\IDEWORK\lvmen\src\licensedcode\data\licenses\xmldb-1.0.yml", "YAML", 0, 0, 0, 22, 0, 0, 1, 23
"d:\IDEWORK\lvmen\src\licensedcode\data\licenses\xnet.yml", "YAML", 0, 0, 0, 18, 0, 0, 1, 19
"d:\IDEWORK\lvmen\src\licensedcode\data\licenses\xskat.yml", "YAML", 0, 0, 0, 20, 0, 0, 1, 21
"d:\IDEWORK\lvmen\src\licensedcode\data\licenses\xubuntu vers. .yml", "YAML", 0, 0, 0, 5, 0, 0, 1, 6
"d:\IDEWORK\lvmen\src\licensedcode\data\licenses\xxd.yml", "YAML", 0, 0, 0, 7, 0, 0, 1, 8
"d:\IDEWORK\lvmen\src\licensedcode\data\licenses\yahoo-browserplus-eula.yml", "YAML", 0, 0, 0, 13, 0, 0, 1, 14
"d:\IDEWORK\lvmen\src\licensedcode\data\licenses\yahoo-messenger-eula.yml", "YAML", 0, 0, 0, 11, 0, 0, 1, 12
"d:\IDEWORK\lvmen\src\licensedcode\data\licenses\yale-cas.yml", "YAML", 0, 0, 0, 9, 0, 0, 1, 10
"d:\IDEWORK\lvmen\src\licensedcode\data\licenses\yensdesign.yml", "YAML", 0, 0, 0, 7, 0, 0, 1, 8
"d:\IDEWORK\lvmen\src\licensedcode\data\licenses\yolo-1.0.yml", "YAML", 0, 0, 0, 9, 0, 0, 1, 10
"d:\IDEWORK\lvmen\src\licensedcode\data\licenses\yolo-2.0.yml", "YAML", 0, 0, 0, 7, 0, 0, 1, 8
"d:\IDEWORK\lvmen\src\licensedcode\data\licenses\youtube partner program terms.yml", "YAML", 0, 0, 0, 5, 0, 0, 1, 6
"d:\IDEWORK\lvmen\src\licensedcode\data\licenses\ypl-1.0.yml", "YAML", 0, 0, 0, 10, 0, 0, 0, 10
"d:\IDEWORK\lvmen\src\licensedcode\data\licenses\ypl-1.1.yml", "YAML", 0, 0, 0, 12, 0, 0, 1, 13
"d:\IDEWORK\lvmen\src\licensedcode\data\licenses\yyy.yml", "YAML", 0, 0, 0, 5, 0, 0, 1, 6
"d:\IDEWORK\lvmen\src\licensedcode\data\licenses\zapatec-calendar.yml", "YAML", 0, 0, 0, 15, 0, 0, 1, 16
"d:\IDEWORK\lvmen\src\licensedcode\data\licenses\zebra sdk.yml", "YAML", 0, 0, 0, 5, 0, 0, 1, 6
"d:\IDEWORK\lvmen\src\licensedcode\data\licenses\zed.yml", "YAML", 0, 0, 0, 10, 0, 0, 1, 11
"d:\IDEWORK\lvmen\src\licensedcode\data\licenses\zend-2.0.yml", "YAML", 0, 0, 0, 18, 0, 0, 0, 18
"d:\IDEWORK\lvmen\src\licensedcode\data\licenses\zeromq-exception-lgpl-3.0.yml", "YAML", 0, 0, 0, 30, 0, 0, 4, 34
"d:\IDEWORK\lvmen\src\licensedcode\data\licenses\zeusbench.yml", "YAML", 0, 0, 0, 6, 0, 0, 1, 7
"d:\IDEWORK\lvmen\src\licensedcode\data\licenses\zhorn-stickies.yml", "YAML", 0, 0, 0, 7, 0, 0, 1, 8
"d:\IDEWORK\lvmen\src\licensedcode\data\licenses\zimbra-1.3.yml", "YAML", 0, 0, 0, 12, 0, 0, 1, 13
"d:\IDEWORK\lvmen\src\licensedcode\data\licenses\zimbra-1.4.yml", "YAML", 0, 0, 0, 8, 0, 0, 1, 9
"d:\IDEWORK\lvmen\src\licensedcode\data\licenses\zipeg.yml", "YAML", 0, 0, 0, 9, 0, 0, 1, 10
"d:\IDEWORK\lvmen\src\licensedcode\data\licenses\ziplist5-geocode-duplication-addendum.yml", "YAML", 0, 0, 0, 10, 0, 0, 1, 11
"d:\IDEWORK\lvmen\src\licensedcode\data\licenses\ziplist5-geocode-end-user-enterprise.yml", "YAML", 0, 0, 0, 10, 0, 0, 1, 11
"d:\IDEWORK\lvmen\src\licensedcode\data\licenses\ziplist5-geocode-end-user-workstation.yml", "YAML", 0, 0, 0, 10, 0, 0, 1, 11
"d:\IDEWORK\lvmen\src\licensedcode\data\licenses\zlib-acknowledgement.yml", "YAML", 0, 0, 0, 27, 0, 0, 0, 27
"d:\IDEWORK\lvmen\src\licensedcode\data\licenses\zlib.yml", "YAML", 0, 0, 0, 17, 0, 0, 2, 19
"d:\IDEWORK\lvmen\src\licensedcode\data\licenses\zpl-1.0.yml", "YAML", 0, 0, 0, 16, 0, 0, 1, 17
"d:\IDEWORK\lvmen\src\licensedcode\data\licenses\zpl-1.1.yml", "YAML", 0, 0, 0, 21, 0, 0, 1, 22
"d:\IDEWORK\lvmen\src\licensedcode\data\licenses\zpl-2.0.yml", "YAML", 0, 0, 0, 19, 0, 0, 1, 20
"d:\IDEWORK\lvmen\src\licensedcode\data\licenses\zpl-2.1.yml", "YAML", 0, 0, 0, 15, 0, 0, 1, 16
"d:\IDEWORK\lvmen\src\licensedcode\data\licenses\zsh.yml", "YAML", 0, 0, 0, 14, 0, 0, 2, 16
"d:\IDEWORK\lvmen\src\licensedcode\data\licenses\zunga license.yml", "YAML", 0, 0, 0, 5, 0, 0, 1, 6
"d:\IDEWORK\lvmen\src\licensedcode\data\licenses\zuora-software.yml", "YAML", 0, 0, 0, 7, 0, 0, 1, 8
"d:\IDEWORK\lvmen\src\licensedcode\data\licenses\zveno-research.yml", "YAML", 0, 0, 0, 8, 0, 0, 1, 9
"d:\IDEWORK\lvmen\src\licensedcode\data\rules\389-exception_url_1.yml", "YAML", 0, 0, 0, 5, 0, 0, 1, 6
"d:\IDEWORK\lvmen\src\licensedcode\data\rules\389-exception_url_2.yml", "YAML", 0, 0, 0, 5, 0, 0, 1, 6
"d:\IDEWORK\lvmen\src\licensedcode\data\rules\3com-microcode.yml", "YAML", 0, 0, 0, 3, 0, 0, 1, 4
"d:\IDEWORK\lvmen\src\licensedcode\data\rules\3com-microcode2.yml", "YAML", 0, 0, 0, 3, 0, 0, 1, 4
"d:\IDEWORK\lvmen\src\licensedcode\data\rules\3com-microcode3.yml", "YAML", 0, 0, 0, 3, 0, 0, 1, 4
"d:\IDEWORK\lvmen\src\licensedcode\data\rules\3dslicer-1.0_1.yml", "YAML", 0, 0, 0, 7, 0, 0, 1, 8
"d:\IDEWORK\lvmen\src\licensedcode\data\rules\996-icu-1.0_1.yml", "YAML", 0, 0, 0, 4, 0, 0, 1, 5
"d:\IDEWORK\lvmen\src\licensedcode\data\rules\abstyles_url_1.yml", "YAML", 0, 0, 0, 5, 0, 0, 1, 6
"d:\IDEWORK\lvmen\src\licensedcode\data\rules\abstyles_url_2.yml", "YAML", 0, 0, 0, 5, 0, 0, 1, 6
"d:\IDEWORK\lvmen\src\licensedcode\data\rules\acdl-1.0.yml", "YAML", 0, 0, 0, 5, 0, 0, 1, 6
"d:\IDEWORK\lvmen\src\licensedcode\data\rules\acdl-1.0_1.yml", "YAML", 0, 0, 0, 5, 0, 0, 1, 6
"d:\IDEWORK\lvmen\src\licensedcode\data\rules\acdl-1.0_2.yml", "YAML", 0, 0, 0, 9, 0, 0, 1, 10
"d:\IDEWORK\lvmen\src\licensedcode\data\rules\acdl-1.0_3.yml", "YAML", 0, 0, 0, 3, 0, 0, 1, 4
"d:\IDEWORK\lvmen\src\licensedcode\data\rules\ace-tao.SPDX.yml", "YAML", 0, 0, 0, 12, 0, 0, 1, 13
"d:\IDEWORK\lvmen\src\licensedcode\data\rules\ace-tao_1.yml", "YAML", 0, 0, 0, 5, 0, 0, 1, 6
"d:\IDEWORK\lvmen\src\licensedcode\data\rules\ace-tao_2.yml", "YAML", 0, 0, 0, 4, 0, 0, 1, 5
"d:\IDEWORK\lvmen\src\licensedcode\data\rules\ace-tao_3.yml", "YAML", 0, 0, 0, 3, 0, 0, 1, 4
"d:\IDEWORK\lvmen\src\licensedcode\data\rules\ace-tao_4.yml", "YAML", 0, 0, 0, 3, 0, 0, 1, 4
"d:\IDEWORK\lvmen\src\licensedcode\data\rules\ace-tao_url_1.yml", "YAML", 0, 0, 0, 5, 0, 0, 1, 6
"d:\IDEWORK\lvmen\src\licensedcode\data\rules\ace-tao_url_2.yml", "YAML", 0, 0, 0, 5, 0, 0, 1, 6
"d:\IDEWORK\lvmen\src\licensedcode\data\rules\adapt-1.0_1.yml", "YAML", 0, 0, 0, 5, 0, 0, 1, 6
"d:\IDEWORK\lvmen\src\licensedcode\data\rules\adapt-1.0_2.yml", "YAML", 0, 0, 0, 3, 0, 0, 1, 4
"d:\IDEWORK\lvmen\src\licensedcode\data\rules\adapt-1.0_3.yml", "YAML", 0, 0, 0, 3, 0, 0, 1, 4
"d:\IDEWORK\lvmen\src\licensedcode\data\rules\adapt-1.0_url_1.yml", "YAML", 0, 0, 0, 5, 0, 0, 1, 6
"d:\IDEWORK\lvmen\src\licensedcode\data\rules\adapt-1.0_url_2.yml", "YAML", 0, 0, 0, 5, 0, 0, 1, 6
"d:\IDEWORK\lvmen\src\licensedcode\data\rules\adapt-1.0_url_glc_140.yml", "YAML", 0, 0, 0, 5, 0, 0, 1, 6
"d:\IDEWORK\lvmen\src\licensedcode\data\rules\adapt-1.0_url_glc_141.yml", "YAML", 0, 0, 0, 5, 0, 0, 1, 6
"d:\IDEWORK\lvmen\src\licensedcode\data\rules\adi-bsd.yml", "YAML", 0, 0, 0, 5, 0, 0, 1, 6
"d:\IDEWORK\lvmen\src\licensedcode\data\rules\adi-bsd2.yml", "YAML", 0, 0, 0, 3, 0, 0, 1, 4
"d:\IDEWORK\lvmen\src\licensedcode\data\rules\adi-bsd_or_gpl-2.0-plus_1.yml", "YAML", 0, 0, 0, 3, 0, 0, 1, 4
"d:\IDEWORK\lvmen\src\licensedcode\data\rules\adobe-acrobat-reader-eula.yml", "YAML", 0, 0, 0, 4, 0, 0, 1, 5
"d:\IDEWORK\lvmen\src\licensedcode\data\rules\adobe-dng-sdk_1.yml", "YAML", 0, 0, 0, 4, 0, 0, 1, 5
"d:\IDEWORK\lvmen\src\licensedcode\data\rules\adobe-dng-sdk_2.yml", "YAML", 0, 0, 0, 3, 0, 0, 1, 4
"d:\IDEWORK\lvmen\src\licensedcode\data\rules\adobe-dng-sdk_3.yml", "YAML", 0, 0, 0, 4, 0, 0, 1, 5
"d:\IDEWORK\lvmen\src\licensedcode\data\rules\adobe-eula.yml", "YAML", 0, 0, 0, 2, 0, 0, 1, 3
"d:\IDEWORK\lvmen\src\licensedcode\data\rules\adobe-eula_2.yml", "YAML", 0, 0, 0, 5, 0, 0, 1, 6
"d:\IDEWORK\lvmen\src\licensedcode\data\rules\adobe-eula_and_gpl-1.0-plus.yml", "YAML", 0, 0, 0, 10, 0, 0, 1, 11
"d:\IDEWORK\lvmen\src\licensedcode\data\rules\adobe-glyph_url_1.yml", "YAML", 0, 0, 0, 5, 0, 0, 1, 6
"d:\IDEWORK\lvmen\src\licensedcode\data\rules\adobe-glyph_url_2.yml", "YAML", 0, 0, 0, 5, 0, 0, 1, 6
"d:\IDEWORK\lvmen\src\licensedcode\data\rules\adobe-scl_1.yml", "YAML", 0, 0, 0, 5, 0, 0, 1, 6
"d:\IDEWORK\lvmen\src\licensedcode\data\rules\adobe-scl_2.yml", "YAML", 0, 0, 0, 4, 0, 0, 1, 5
"d:\IDEWORK\lvmen\src\licensedcode\data\rules\adobe-scl_url_1.yml", "YAML", 0, 0, 0, 5, 0, 0, 1, 6
"d:\IDEWORK\lvmen\src\licensedcode\data\rules\adobe-scl_url_2.yml", "YAML", 0, 0, 0, 5, 0, 0, 1, 6
"d:\IDEWORK\lvmen\src\licensedcode\data\rules\adsl_url_1.yml", "YAML", 0, 0, 0, 5, 0, 0, 1, 6
"d:\IDEWORK\lvmen\src\licensedcode\data\rules\adsl_url_2.yml", "YAML", 0, 0, 0, 5, 0, 0, 1, 6
"d:\IDEWORK\lvmen\src\licensedcode\data\rules\afl-1.1_1.yml", "YAML", 0, 0, 0, 3, 0, 0, 1, 4
"d:\IDEWORK\lvmen\src\licensedcode\data\rules\afl-1.1_2.yml", "YAML", 0, 0, 0, 5, 0, 0, 1, 6
"d:\IDEWORK\lvmen\src\licensedcode\data\rules\afl-1.1_3.yml", "YAML", 0, 0, 0, 7, 0, 0, 1, 8
"d:\IDEWORK\lvmen\src\licensedcode\data\rules\afl-1.1_4.yml", "YAML", 0, 0, 0, 8, 0, 0, 1, 9
"d:\IDEWORK\lvmen\src\licensedcode\data\rules\afl-1.1_5.yml", "YAML", 0, 0, 0, 3, 0, 0, 1, 4
"d:\IDEWORK\lvmen\src\licensedcode\data\rules\afl-1.1_url_1.yml", "YAML", 0, 0, 0, 5, 0, 0, 1, 6
"d:\IDEWORK\lvmen\src\licensedcode\data\rules\afl-1.1_url_2.yml", "YAML", 0, 0, 0, 5, 0, 0, 1, 6
"d:\IDEWORK\lvmen\src\licensedcode\data\rules\afl-1.2_1.yml", "YAML", 0, 0, 0, 3, 0, 0, 1, 4
"d:\IDEWORK\lvmen\src\licensedcode\data\rules\afl-1.2_2.yml", "YAML", 0, 0, 0, 3, 0, 0, 1, 4
"d:\IDEWORK\lvmen\src\licensedcode\data\rules\afl-1.2_url_1.yml", "YAML", 0, 0, 0, 5, 0, 0, 1, 6
"d:\IDEWORK\lvmen\src\licensedcode\data\rules\afl-1.2_url_2.yml", "YAML", 0, 0, 0, 5, 0, 0, 1, 6
"d:\IDEWORK\lvmen\src\licensedcode\data\rules\afl-2.0.SPDX.yml", "YAML", 0, 0, 0, 8, 0, 0, 1, 9
"d:\IDEWORK\lvmen\src\licensedcode\data\rules\afl-2.0_1.yml", "YAML", 0, 0, 0, 3, 0, 0, 1, 4
"d:\IDEWORK\lvmen\src\licensedcode\data\rules\afl-2.0_3.yml", "YAML", 0, 0, 0, 3, 0, 0, 1, 4
"d:\IDEWORK\lvmen\src\licensedcode\data\rules\afl-2.0_4.yml", "YAML", 0, 0, 0, 5, 0, 0, 1, 6
"d:\IDEWORK\lvmen\src\licensedcode\data\rules\afl-2.0_or_lgpl-2.0-plus.yml", "YAML", 0, 0, 0, 4, 0, 0, 1, 5
"d:\IDEWORK\lvmen\src\licensedcode\data\rules\afl-2.0_or_lgpl-2.0-plus_1.yml", "YAML", 0, 0, 0, 6, 0, 0, 1, 7
"d:\IDEWORK\lvmen\src\licensedcode\data\rules\afl-2.0_or_lgpl-2.0-plus_2.yml", "YAML", 0, 0, 0, 5, 0, 0, 1, 6
"d:\IDEWORK\lvmen\src\licensedcode\data\rules\afl-2.0_or_lgpl-2.0-plus_3.yml", "YAML", 0, 0, 0, 7, 0, 0, 1, 8
"d:\IDEWORK\lvmen\src\licensedcode\data\rules\afl-2.0_url_1.yml", "YAML", 0, 0, 0, 5, 0, 0, 1, 6
"d:\IDEWORK\lvmen\src\licensedcode\data\rules\afl-2.0_url_2.yml", "YAML", 0, 0, 0, 5, 0, 0, 1, 6
"d:\IDEWORK\lvmen\src\licensedcode\data\rules\afl-2.1_1.yml", "YAML", 0, 0, 0, 3, 0, 0, 1, 4
"d:\IDEWORK\lvmen\src\licensedcode\data\rules\afl-2.1_10.yml", "YAML", 0, 0, 0, 3, 0, 0, 1, 4
"d:\IDEWORK\lvmen\src\licensedcode\data\rules\afl-2.1_11.yml", "YAML", 0, 0, 0, 3, 0, 0, 1, 4
"d:\IDEWORK\lvmen\src\licensedcode\data\rules\afl-2.1_12.yml", "YAML", 0, 0, 0, 3, 0, 0, 1, 4
"d:\IDEWORK\lvmen\src\licensedcode\data\rules\afl-2.1_2.yml", "YAML", 0, 0, 0, 6, 0, 0, 1, 7
"d:\IDEWORK\lvmen\src\licensedcode\data\rules\afl-2.1_3.yml", "YAML", 0, 0, 0, 5, 0, 0, 1, 6
"d:\IDEWORK\lvmen\src\licensedcode\data\rules\afl-2.1_4.yml", "YAML", 0, 0, 0, 5, 0, 0, 1, 6
"d:\IDEWORK\lvmen\src\licensedcode\data\rules\afl-2.1_5.yml", "YAML", 0, 0, 0, 3, 0, 0, 1, 4
"d:\IDEWORK\lvmen\src\licensedcode\data\rules\afl-2.1_6.yml", "YAML", 0, 0, 0, 6, 0, 0, 1, 7
"d:\IDEWORK\lvmen\src\licensedcode\data\rules\afl-2.1_7.yml", "YAML", 0, 0, 0, 3, 0, 0, 1, 4
"d:\IDEWORK\lvmen\src\licensedcode\data\rules\afl-2.1_8.yml", "YAML", 0, 0, 0, 7, 0, 0, 1, 8
"d:\IDEWORK\lvmen\src\licensedcode\data\rules\afl-2.1_9.yml", "YAML", 0, 0, 0, 3, 0, 0, 1, 4
"d:\IDEWORK\lvmen\src\licensedcode\data\rules\afl-2.1_and_gpl-2.0-plus_1.yml", "YAML", 0, 0, 0, 3, 0, 0, 1, 4
"d:\IDEWORK\lvmen\src\licensedcode\data\rules\afl-2.1_or_bsd-new.yml", "YAML", 0, 0, 0, 4, 0, 0, 1, 5
"d:\IDEWORK\lvmen\src\licensedcode\data\rules\afl-2.1_or_bsd-new_1.yml", "YAML", 0, 0, 0, 5, 0, 0, 1, 6
"d:\IDEWORK\lvmen\src\licensedcode\data\rules\afl-2.1_or_bsd-new_2.yml", "YAML", 0, 0, 0, 3, 0, 0, 1, 4
"d:\IDEWORK\lvmen\src\licensedcode\data\rules\afl-2.1_or_bsd-new_3.yml", "YAML", 0, 0, 0, 5, 0, 0, 1, 6
"d:\IDEWORK\lvmen\src\licensedcode\data\rules\afl-2.1_or_bsd-new_4.yml", "YAML", 0, 0, 0, 3, 0, 0, 1, 4
"d:\IDEWORK\lvmen\src\licensedcode\data\rules\afl-2.1_or_bsd-new_5.yml", "YAML", 0, 0, 0, 3, 0, 0, 1, 4
"d:\IDEWORK\lvmen\src\licensedcode\data\rules\afl-2.1_or_bsd-new_6.yml", "YAML", 0, 0, 0, 5, 0, 0, 1, 6
"d:\IDEWORK\lvmen\src\licensedcode\data\rules\afl-2.1_or_bsd-new_7.yml", "YAML", 0, 0, 0, 5, 0, 0, 1, 6
"d:\IDEWORK\lvmen\src\licensedcode\data\rules\afl-2.1_or_gpl-2.0_1.yml", "YAML", 0, 0, 0, 2, 0, 0, 1, 3
"d:\IDEWORK\lvmen\src\licensedcode\data\rules\afl-2.1_or_gpl-2.0_and_gpl-2.0_1.yml", "YAML", 0, 0, 0, 2, 0, 0, 1, 3
"d:\IDEWORK\lvmen\src\licensedcode\data\rules\afl-2.1_or_gpl-2.0_and_gpl-2.0_2.yml", "YAML", 0, 0, 0, 2, 0, 0, 1, 3
"d:\IDEWORK\lvmen\src\licensedcode\data\rules\afl-2.1_url_1.yml", "YAML", 0, 0, 0, 5, 0, 0, 1, 6
"d:\IDEWORK\lvmen\src\licensedcode\data\rules\afl-2.1_url_2.yml", "YAML", 0, 0, 0, 5, 0, 0, 1, 6
"d:\IDEWORK\lvmen\src\licensedcode\data\rules\afl-3.0.SPDX.yml", "YAML", 0, 0, 0, 8, 0, 0, 1, 9
"d:\IDEWORK\lvmen\src\licensedcode\data\rules\afl-3.0.yml", "YAML", 0, 0, 0, 5, 0, 0, 1, 6
"d:\IDEWORK\lvmen\src\licensedcode\data\rules\afl-3.0_1.yml", "YAML", 0, 0, 0, 5, 0, 0, 1, 6
"d:\IDEWORK\lvmen\src\licensedcode\data\rules\afl-3.0_10.yml", "YAML", 0, 0, 0, 5, 0, 0, 1, 6
"d:\IDEWORK\lvmen\src\licensedcode\data\rules\afl-3.0_11.yml", "YAML", 0, 0, 0, 9, 0, 0, 1, 10
"d:\IDEWORK\lvmen\src\licensedcode\data\rules\afl-3.0_12.yml", "YAML", 0, 0, 0, 3, 0, 0, 1, 4
"d:\IDEWORK\lvmen\src\licensedcode\data\rules\afl-3.0_13.yml", "YAML", 0, 0, 0, 7, 0, 0, 1, 8
"d:\IDEWORK\lvmen\src\licensedcode\data\rules\afl-3.0_14.yml", "YAML", 0, 0, 0, 7, 0, 0, 1, 8
"d:\IDEWORK\lvmen\src\licensedcode\data\rules\afl-3.0_15.yml", "YAML", 0, 0, 0, 7, 0, 0, 1, 8
"d:\IDEWORK\lvmen\src\licensedcode\data\rules\afl-3.0_16.yml", "YAML", 0, 0, 0, 5, 0, 0, 1, 6
"d:\IDEWORK\lvmen\src\licensedcode\data\rules\afl-3.0_17.yml", "YAML", 0, 0, 0, 7, 0, 0, 1, 8
"d:\IDEWORK\lvmen\src\licensedcode\data\rules\afl-3.0_18.yml", "YAML", 0, 0, 0, 7, 0, 0, 1, 8
"d:\IDEWORK\lvmen\src\licensedcode\data\rules\afl-3.0_19.yml", "YAML", 0, 0, 0, 7, 0, 0, 1, 8
"d:\IDEWORK\lvmen\src\licensedcode\data\rules\afl-3.0_2.yml", "YAML", 0, 0, 0, 3, 0, 0, 1, 4
"d:\IDEWORK\lvmen\src\licensedcode\data\rules\afl-3.0_20.yml", "YAML", 0, 0, 0, 5, 0, 0, 1, 6
"d:\IDEWORK\lvmen\src\licensedcode\data\rules\afl-3.0_21.yml", "YAML", 0, 0, 0, 5, 0, 0, 1, 6
"d:\IDEWORK\lvmen\src\licensedcode\data\rules\afl-3.0_22.yml", "YAML", 0, 0, 0, 5, 0, 0, 1, 6
"d:\IDEWORK\lvmen\src\licensedcode\data\rules\afl-3.0_23.yml", "YAML", 0, 0, 0, 3, 0, 0, 1, 4
"d:\IDEWORK\lvmen\src\licensedcode\data\rules\afl-3.0_24.yml", "YAML", 0, 0, 0, 5, 0, 0, 1, 6
"d:\IDEWORK\lvmen\src\licensedcode\data\rules\afl-3.0_25.yml", "YAML", 0, 0, 0, 3, 0, 0, 1, 4
"d:\IDEWORK\lvmen\src\licensedcode\data\rules\afl-3.0_26.yml", "YAML", 0, 0, 0, 3, 0, 0, 1, 4
"d:\IDEWORK\lvmen\src\licensedcode\data\rules\afl-3.0_27.yml", "YAML", 0, 0, 0, 5, 0, 0, 1, 6
"d:\IDEWORK\lvmen\src\licensedcode\data\rules\afl-3.0_28.yml", "YAML", 0, 0, 0, 5, 0, 0, 1, 6
"d:\IDEWORK\lvmen\src\licensedcode\data\rules\afl-3.0_29.yml", "YAML", 0, 0, 0, 5, 0, 0, 1, 6
"d:\IDEWORK\lvmen\src\licensedcode\data\rules\afl-3.0_3.yml", "YAML", 0, 0, 0, 4, 0, 0, 1, 5
"d:\IDEWORK\lvmen\src\licensedcode\data\rules\afl-3.0_30.yml", "YAML", 0, 0, 0, 5, 0, 0, 1, 6
"d:\IDEWORK\lvmen\src\licensedcode\data\rules\afl-3.0_31.yml", "YAML", 0, 0, 0, 3, 0, 0, 1, 4
"d:\IDEWORK\lvmen\src\licensedcode\data\rules\afl-3.0_32.yml", "YAML", 0, 0, 0, 9, 0, 0, 1, 10
"d:\IDEWORK\lvmen\src\licensedcode\data\rules\afl-3.0_4.yml", "YAML", 0, 0, 0, 3, 0, 0, 1, 4
"d:\IDEWORK\lvmen\src\licensedcode\data\rules\afl-3.0_5.yml", "YAML", 0, 0, 0, 3, 0, 0, 1, 4
"d:\IDEWORK\lvmen\src\licensedcode\data\rules\afl-3.0_6.yml", "YAML", 0, 0, 0, 6, 0, 0, 1, 7
"d:\IDEWORK\lvmen\src\licensedcode\data\rules\afl-3.0_7.yml", "YAML", 0, 0, 0, 5, 0, 0, 1, 6
"d:\IDEWORK\lvmen\src\licensedcode\data\rules\afl-3.0_8.yml", "YAML", 0, 0, 0, 5, 0, 0, 1, 6
"d:\IDEWORK\lvmen\src\licensedcode\data\rules\afl-3.0_9.yml", "YAML", 0, 0, 0, 5, 0, 0, 1, 6
"d:\IDEWORK\lvmen\src\licensedcode\data\rules\afl-3.0_or_bsd-new_1.yml", "YAML", 0, 0, 0, 5, 0, 0, 1, 6
"d:\IDEWORK\lvmen\src\licensedcode\data\rules\afl-3.0_url_1.yml", "YAML", 0, 0, 0, 5, 0, 0, 1, 6
"d:\IDEWORK\lvmen\src\licensedcode\data\rules\afl-3.0_url_2.yml", "YAML", 0, 0, 0, 5, 0, 0, 1, 6
"d:\IDEWORK\lvmen\src\licensedcode\data\rules\afl-3.0_url_glc_248.yml", "YAML", 0, 0, 0, 5, 0, 0, 1, 6
"d:\IDEWORK\lvmen\src\licensedcode\data\rules\afl-3.0_url_glc_249.yml", "YAML", 0, 0, 0, 5, 0, 0, 1, 6
"d:\IDEWORK\lvmen\src\licensedcode\data\rules\afmparse_url_1.yml", "YAML", 0, 0, 0, 5, 0, 0, 1, 6
"d:\IDEWORK\lvmen\src\licensedcode\data\rules\afmparse_url_2.yml", "YAML", 0, 0, 0, 5, 0, 0, 1, 6
"d:\IDEWORK\lvmen\src\licensedcode\data\rules\afpl-8.0_1.yml", "YAML", 0, 0, 0, 3, 0, 0, 1, 4
"d:\IDEWORK\lvmen\src\licensedcode\data\rules\afpl-8.0_2.yml", "YAML", 0, 0, 0, 3, 0, 0, 1, 4
"d:\IDEWORK\lvmen\src\licensedcode\data\rules\afpl-8.0_3.yml", "YAML", 0, 0, 0, 4, 0, 0, 1, 5
"d:\IDEWORK\lvmen\src\licensedcode\data\rules\afpl-8.0_url_1.yml", "YAML", 0, 0, 0, 5, 0, 0, 1, 6
"d:\IDEWORK\lvmen\src\licensedcode\data\rules\afpl-8.0_url_2.yml", "YAML", 0, 0, 0, 5, 0, 0, 1, 6
"d:\IDEWORK\lvmen\src\licensedcode\data\rules\afpl-9.0_1.yml", "YAML", 0, 0, 0, 5, 0, 0, 1, 6
"d:\IDEWORK\lvmen\src\licensedcode\data\rules\afpl-9.0_10.yml", "YAML", 0, 0, 0, 3, 0, 0, 1, 4
"d:\IDEWORK\lvmen\src\licensedcode\data\rules\afpl-9.0_2.yml", "YAML", 0, 0, 0, 5, 0, 0, 1, 6
"d:\IDEWORK\lvmen\src\licensedcode\data\rules\afpl-9.0_3.yml", "YAML", 0, 0, 0, 3, 0, 0, 1, 4
"d:\IDEWORK\lvmen\src\licensedcode\data\rules\afpl-9.0_4.yml", "YAML", 0, 0, 0, 3, 0, 0, 1, 4
"d:\IDEWORK\lvmen\src\licensedcode\data\rules\afpl-9.0_5.yml", "YAML", 0, 0, 0, 3, 0, 0, 1, 4
"d:\IDEWORK\lvmen\src\licensedcode\data\rules\afpl-9.0_6.yml", "YAML", 0, 0, 0, 3, 0, 0, 1, 4
"d:\IDEWORK\lvmen\src\licensedcode\data\rules\afpl-9.0_7.yml", "YAML", 0, 0, 0, 5, 0, 0, 1, 6
"d:\IDEWORK\lvmen\src\licensedcode\data\rules\afpl-9.0_8.yml", "YAML", 0, 0, 0, 5, 0, 0, 1, 6
"d:\IDEWORK\lvmen\src\licensedcode\data\rules\afpl-9.0_9.yml", "YAML", 0, 0, 0, 3, 0, 0, 1, 4
"d:\IDEWORK\lvmen\src\licensedcode\data\rules\afpl-9.0_or_gpl-1.0-plus_1.yml", "YAML", 0, 0, 0, 3, 0, 0, 1, 4
"d:\IDEWORK\lvmen\src\licensedcode\data\rules\agere-bsd_1.yml", "YAML", 0, 0, 0, 4, 0, 0, 2, 6
"d:\IDEWORK\lvmen\src\licensedcode\data\rules\agere-bsd_2.yml", "YAML", 0, 0, 0, 8, 0, 0, 1, 9
"d:\IDEWORK\lvmen\src\licensedcode\data\rules\agere-sla.yml", "YAML", 0, 0, 0, 5, 0, 0, 1, 6
"d:\IDEWORK\lvmen\src\licensedcode\data\rules\agpl-1.0-plus_1.yml", "YAML", 0, 0, 0, 3, 0, 0, 1, 4
"d:\IDEWORK\lvmen\src\licensedcode\data\rules\agpl-1.0-plus_10.yml", "YAML", 0, 0, 0, 3, 0, 0, 1, 4
"d:\IDEWORK\lvmen\src\licensedcode\data\rules\agpl-1.0-plus_11.yml", "YAML", 0, 0, 0, 3, 0, 0, 1, 4
"d:\IDEWORK\lvmen\src\licensedcode\data\rules\agpl-1.0-plus_12.yml", "YAML", 0, 0, 0, 3, 0, 0, 1, 4
"d:\IDEWORK\lvmen\src\licensedcode\data\rules\agpl-1.0-plus_13.yml", "YAML", 0, 0, 0, 3, 0, 0, 1, 4
"d:\IDEWORK\lvmen\src\licensedcode\data\rules\agpl-1.0-plus_14.yml", "YAML", 0, 0, 0, 3, 0, 0, 1, 4
"d:\IDEWORK\lvmen\src\licensedcode\data\rules\agpl-1.0-plus_15.yml", "YAML", 0, 0, 0, 3, 0, 0, 1, 4
"d:\IDEWORK\lvmen\src\licensedcode\data\rules\agpl-1.0-plus_16.yml", "YAML", 0, 0, 0, 3, 0, 0, 1, 4
"d:\IDEWORK\lvmen\src\licensedcode\data\rules\agpl-1.0-plus_17.yml", "YAML", 0, 0, 0, 3, 0, 0, 1, 4
"d:\IDEWORK\lvmen\src\licensedcode\data\rules\agpl-1.0-plus_18.yml", "YAML", 0, 0, 0, 3, 0, 0, 1, 4
"d:\IDEWORK\lvmen\src\licensedcode\data\rules\agpl-1.0-plus_19.yml", "YAML", 0, 0, 0, 3, 0, 0, 1, 4
"d:\IDEWORK\lvmen\src\licensedcode\data\rules\agpl-1.0-plus_2.yml", "YAML", 0, 0, 0, 3, 0, 0, 1, 4
"d:\IDEWORK\lvmen\src\licensedcode\data\rules\agpl-1.0-plus_20.yml", "YAML", 0, 0, 0, 3, 0, 0, 1, 4
"d:\IDEWORK\lvmen\src\licensedcode\data\rules\agpl-1.0-plus_21.yml", "YAML", 0, 0, 0, 3, 0, 0, 1, 4
"d:\IDEWORK\lvmen\src\licensedcode\data\rules\agpl-1.0-plus_22.yml", "YAML", 0, 0, 0, 3, 0, 0, 1, 4
"d:\IDEWORK\lvmen\src\licensedcode\data\rules\agpl-1.0-plus_23.yml", "YAML", 0, 0, 0, 3, 0, 0, 1, 4
"d:\IDEWORK\lvmen\src\licensedcode\data\rules\agpl-1.0-plus_24.yml", "YAML", 0, 0, 0, 3, 0, 0, 1, 4
"d:\IDEWORK\lvmen\src\licensedcode\data\rules\agpl-1.0-plus_25.yml", "YAML", 0, 0, 0, 3, 0, 0, 1, 4
"d:\IDEWORK\lvmen\src\licensedcode\data\rules\agpl-1.0-plus_26.yml", "YAML", 0, 0, 0, 3, 0, 0, 1, 4
"d:\IDEWORK\lvmen\src\licensedcode\data\rules\agpl-1.0-plus_27.yml", "YAML", 0, 0, 0, 3, 0, 0, 1, 4
"d:\IDEWORK\lvmen\src\licensedcode\data\rules\agpl-1.0-plus_28.yml", "YAML", 0, 0, 0, 3, 0, 0, 1, 4
"d:\IDEWORK\lvmen\src\licensedcode\data\rules\agpl-1.0-plus_29.yml", "YAML", 0, 0, 0, 3, 0, 0, 1, 4
"d:\IDEWORK\lvmen\src\licensedcode\data\rules\agpl-1.0-plus_3.yml", "YAML", 0, 0, 0, 3, 0, 0, 1, 4
"d:\IDEWORK\lvmen\src\licensedcode\data\rules\agpl-1.0-plus_30.yml", "YAML", 0, 0, 0, 3, 0, 0, 1, 4
"d:\IDEWORK\lvmen\src\licensedcode\data\rules\agpl-1.0-plus_31.yml", "YAML", 0, 0, 0, 3, 0, 0, 1, 4
"d:\IDEWORK\lvmen\src\licensedcode\data\rules\agpl-1.0-plus_32.yml", "YAML", 0, 0, 0, 3, 0, 0, 1, 4
"d:\IDEWORK\lvmen\src\licensedcode\data\rules\agpl-1.0-plus_33.yml", "YAML", 0, 0, 0, 3, 0, 0, 1, 4
"d:\IDEWORK\lvmen\src\licensedcode\data\rules\agpl-1.0-plus_34.yml", "YAML", 0, 0, 0, 3, 0, 0, 1, 4
"d:\IDEWORK\lvmen\src\licensedcode\data\rules\agpl-1.0-plus_35.yml", "YAML", 0, 0, 0, 3, 0, 0, 1, 4
"d:\IDEWORK\lvmen\src\licensedcode\data\rules\agpl-1.0-plus_36.yml", "YAML", 0, 0, 0, 3, 0, 0, 1, 4
"d:\IDEWORK\lvmen\src\licensedcode\data\rules\agpl-1.0-plus_37.yml", "YAML", 0, 0, 0, 3, 0, 0, 1, 4
"d:\IDEWORK\lvmen\src\licensedcode\data\rules\agpl-1.0-plus_38.yml", "YAML", 0, 0, 0, 3, 0, 0, 1, 4
"d:\IDEWORK\lvmen\src\licensedcode\data\rules\agpl-1.0-plus_39.yml", "YAML", 0, 0, 0, 3, 0, 0, 1, 4
"d:\IDEWORK\lvmen\src\licensedcode\data\rules\agpl-1.0-plus_4.yml", "YAML", 0, 0, 0, 3, 0, 0, 1, 4
"d:\IDEWORK\lvmen\src\licensedcode\data\rules\agpl-1.0-plus_40.yml", "YAML", 0, 0, 0, 3, 0, 0, 1, 4
"d:\IDEWORK\lvmen\src\licensedcode\data\rules\agpl-1.0-plus_41.yml", "YAML", 0, 0, 0, 3, 0, 0, 1, 4
"d:\IDEWORK\lvmen\src\licensedcode\data\rules\agpl-1.0-plus_42.yml", "YAML", 0, 0, 0, 3, 0, 0, 1, 4
"d:\IDEWORK\lvmen\src\licensedcode\data\rules\agpl-1.0-plus_43.yml", "YAML", 0, 0, 0, 3, 0, 0, 1, 4
"d:\IDEWORK\lvmen\src\licensedcode\data\rules\agpl-1.0-plus_44.yml", "YAML", 0, 0, 0, 3, 0, 0, 1, 4
"d:\IDEWORK\lvmen\src\licensedcode\data\rules\agpl-1.0-plus_45.yml", "YAML", 0, 0, 0, 3, 0, 0, 1, 4
"d:\IDEWORK\lvmen\src\licensedcode\data\rules\agpl-1.0-plus_46.yml", "YAML", 0, 0, 0, 3, 0, 0, 1, 4
"d:\IDEWORK\lvmen\src\licensedcode\data\rules\agpl-1.0-plus_47.yml", "YAML", 0, 0, 0, 3, 0, 0, 1, 4
"d:\IDEWORK\lvmen\src\licensedcode\data\rules\agpl-1.0-plus_48.yml", "YAML", 0, 0, 0, 3, 0, 0, 1, 4
"d:\IDEWORK\lvmen\src\licensedcode\data\rules\agpl-1.0-plus_49.yml", "YAML", 0, 0, 0, 3, 0, 0, 1, 4
"d:\IDEWORK\lvmen\src\licensedcode\data\rules\agpl-1.0-plus_5.yml", "YAML", 0, 0, 0, 3, 0, 0, 1, 4
"d:\IDEWORK\lvmen\src\licensedcode\data\rules\agpl-1.0-plus_50.yml", "YAML", 0, 0, 0, 3, 0, 0, 1, 4
"d:\IDEWORK\lvmen\src\licensedcode\data\rules\agpl-1.0-plus_51.yml", "YAML", 0, 0, 0, 3, 0, 0, 1, 4
"d:\IDEWORK\lvmen\src\licensedcode\data\rules\agpl-1.0-plus_52.yml", "YAML", 0, 0, 0, 3, 0, 0, 1, 4
"d:\IDEWORK\lvmen\src\licensedcode\data\rules\agpl-1.0-plus_53.yml", "YAML", 0, 0, 0, 3, 0, 0, 1, 4
"d:\IDEWORK\lvmen\src\licensedcode\data\rules\agpl-1.0-plus_54.yml", "YAML", 0, 0, 0, 3, 0, 0, 1, 4
"d:\IDEWORK\lvmen\src\licensedcode\data\rules\agpl-1.0-plus_55.yml", "YAML", 0, 0, 0, 3, 0, 0, 1, 4
"d:\IDEWORK\lvmen\src\licensedcode\data\rules\agpl-1.0-plus_56.yml", "YAML", 0, 0, 0, 3, 0, 0, 1, 4
"d:\IDEWORK\lvmen\src\licensedcode\data\rules\agpl-1.0-plus_57.yml", "YAML", 0, 0, 0, 3, 0, 0, 1, 4
"d:\IDEWORK\lvmen\src\licensedcode\data\rules\agpl-1.0-plus_58.yml", "YAML", 0, 0, 0, 3, 0, 0, 1, 4
"d:\IDEWORK\lvmen\src\licensedcode\data\rules\agpl-1.0-plus_59.yml", "YAML", 0, 0, 0, 3, 0, 0, 1, 4
"d:\IDEWORK\lvmen\src\licensedcode\data\rules\agpl-1.0-plus_6.yml", "YAML", 0, 0, 0, 3, 0, 0, 1, 4
"d:\IDEWORK\lvmen\src\licensedcode\data\rules\agpl-1.0-plus_60.yml", "YAML", 0, 0, 0, 3, 0, 0, 1, 4
"d:\IDEWORK\lvmen\src\licensedcode\data\rules\agpl-1.0-plus_61.yml", "YAML", 0, 0, 0, 3, 0, 0, 1, 4
"d:\IDEWORK\lvmen\src\licensedcode\data\rules\agpl-1.0-plus_7.yml", "YAML", 0, 0, 0, 3, 0, 0, 1, 4
"d:\IDEWORK\lvmen\src\licensedcode\data\rules\agpl-1.0-plus_8.yml", "YAML", 0, 0, 0, 3, 0, 0, 1, 4
"d:\IDEWORK\lvmen\src\licensedcode\data\rules\agpl-1.0-plus_9.yml", "YAML", 0, 0, 0, 3, 0, 0, 1, 4
"d:\IDEWORK\lvmen\src\licensedcode\data\rules\agpl-1.0-plus_url_1.yml", "YAML", 0, 0, 0, 5, 0, 0, 1, 6
"d:\IDEWORK\lvmen\src\licensedcode\data\rules\agpl-1.0-plus_url_2.yml", "YAML", 0, 0, 0, 5, 0, 0, 1, 6
"d:\IDEWORK\lvmen\src\licensedcode\data\rules\agpl-1.0_1.yml", "YAML", 0, 0, 0, 3, 0, 0, 1, 4
"d:\IDEWORK\lvmen\src\licensedcode\data\rules\agpl-1.0_10.yml", "YAML", 0, 0, 0, 3, 0, 0, 1, 4
"d:\IDEWORK\lvmen\src\licensedcode\data\rules\agpl-1.0_11.yml", "YAML", 0, 0, 0, 3, 0, 0, 1, 4
"d:\IDEWORK\lvmen\src\licensedcode\data\rules\agpl-1.0_12.yml", "YAML", 0, 0, 0, 3, 0, 0, 1, 4
"d:\IDEWORK\lvmen\src\licensedcode\data\rules\agpl-1.0_13.yml", "YAML", 0, 0, 0, 3, 0, 0, 1, 4
"d:\IDEWORK\lvmen\src\licensedcode\data\rules\agpl-1.0_14.yml", "YAML", 0, 0, 0, 3, 0, 0, 1, 4
"d:\IDEWORK\lvmen\src\licensedcode\data\rules\agpl-1.0_15.yml", "YAML", 0, 0, 0, 3, 0, 0, 1, 4
"d:\IDEWORK\lvmen\src\licensedcode\data\rules\agpl-1.0_16.yml", "YAML", 0, 0, 0, 3, 0, 0, 1, 4
"d:\IDEWORK\lvmen\src\licensedcode\data\rules\agpl-1.0_17.yml", "YAML", 0, 0, 0, 3, 0, 0, 1, 4
"d:\IDEWORK\lvmen\src\licensedcode\data\rules\agpl-1.0_18.yml", "YAML", 0, 0, 0, 3, 0, 0, 1, 4
"d:\IDEWORK\lvmen\src\licensedcode\data\rules\agpl-1.0_19.yml", "YAML", 0, 0, 0, 3, 0, 0, 1, 4
"d:\IDEWORK\lvmen\src\licensedcode\data\rules\agpl-1.0_2.yml", "YAML", 0, 0, 0, 4, 0, 0, 1, 5
"d:\IDEWORK\lvmen\src\licensedcode\data\rules\agpl-1.0_20.yml", "YAML", 0, 0, 0, 3, 0, 0, 1, 4
"d:\IDEWORK\lvmen\src\licensedcode\data\rules\agpl-1.0_21.yml", "YAML", 0, 0, 0, 3, 0, 0, 1, 4
"d:\IDEWORK\lvmen\src\licensedcode\data\rules\agpl-1.0_22.yml", "YAML", 0, 0, 0, 3, 0, 0, 1, 4
"d:\IDEWORK\lvmen\src\licensedcode\data\rules\agpl-1.0_23.yml", "YAML", 0, 0, 0, 3, 0, 0, 1, 4
"d:\IDEWORK\lvmen\src\licensedcode\data\rules\agpl-1.0_24.yml", "YAML", 0, 0, 0, 3, 0, 0, 1, 4
"d:\IDEWORK\lvmen\src\licensedcode\data\rules\agpl-1.0_25.yml", "YAML", 0, 0, 0, 3, 0, 0, 1, 4
"d:\IDEWORK\lvmen\src\licensedcode\data\rules\agpl-1.0_26.yml", "YAML", 0, 0, 0, 3, 0, 0, 1, 4
"d:\IDEWORK\lvmen\src\licensedcode\data\rules\agpl-1.0_27.yml", "YAML", 0, 0, 0, 3, 0, 0, 1, 4
"d:\IDEWORK\lvmen\src\licensedcode\data\rules\agpl-1.0_28.yml", "YAML", 0, 0, 0, 3, 0, 0, 1, 4
"d:\IDEWORK\lvmen\src\licensedcode\data\rules\agpl-1.0_29.yml", "YAML", 0, 0, 0, 3, 0, 0, 1, 4
"d:\IDEWORK\lvmen\src\licensedcode\data\rules\agpl-1.0_3.yml", "YAML", 0, 0, 0, 3, 0, 0, 1, 4
"d:\IDEWORK\lvmen\src\licensedcode\data\rules\agpl-1.0_4.yml", "YAML", 0, 0, 0, 3, 0, 0, 1, 4
"d:\IDEWORK\lvmen\src\licensedcode\data\rules\agpl-1.0_5.yml", "YAML", 0, 0, 0, 4, 0, 0, 1, 5
"d:\IDEWORK\lvmen\src\licensedcode\data\rules\agpl-1.0_6.yml", "YAML", 0, 0, 0, 5, 0, 0, 1, 6
"d:\IDEWORK\lvmen\src\licensedcode\data\rules\agpl-1.0_7.yml", "YAML", 0, 0, 0, 3, 0, 0, 1, 4
"d:\IDEWORK\lvmen\src\licensedcode\data\rules\agpl-1.0_8.yml", "YAML", 0, 0, 0, 3, 0, 0, 1, 4
"d:\IDEWORK\lvmen\src\licensedcode\data\rules\agpl-1.0_9.yml", "YAML", 0, 0, 0, 3, 0, 0, 1, 4
"d:\IDEWORK\lvmen\src\licensedcode\data\rules\agpl-1.0_url_1.yml", "YAML", 0, 0, 0, 5, 0, 0, 1, 6
"d:\IDEWORK\lvmen\src\licensedcode\data\rules\agpl-1.0_url_2.yml", "YAML", 0, 0, 0, 5, 0, 0, 1, 6
"d:\IDEWORK\lvmen\src\licensedcode\data\rules\agpl-2.0_1.yml", "YAML", 0, 0, 0, 3, 0, 0, 1, 4
"d:\IDEWORK\lvmen\src\licensedcode\data\rules\agpl-2.0_10.yml", "YAML", 0, 0, 0, 3, 0, 0, 1, 4
"d:\IDEWORK\lvmen\src\licensedcode\data\rules\agpl-2.0_11.yml", "YAML", 0, 0, 0, 3, 0, 0, 1, 4
"d:\IDEWORK\lvmen\src\licensedcode\data\rules\agpl-2.0_12.yml", "YAML", 0, 0, 0, 3, 0, 0, 1, 4
"d:\IDEWORK\lvmen\src\licensedcode\data\rules\agpl-2.0_13.yml", "YAML", 0, 0, 0, 3, 0, 0, 1, 4
"d:\IDEWORK\lvmen\src\licensedcode\data\rules\agpl-2.0_14.yml", "YAML", 0, 0, 0, 3, 0, 0, 1, 4
"d:\IDEWORK\lvmen\src\licensedcode\data\rules\agpl-2.0_15.yml", "YAML", 0, 0, 0, 3, 0, 0, 1, 4
"d:\IDEWORK\lvmen\src\licensedcode\data\rules\agpl-2.0_16.yml", "YAML", 0, 0, 0, 3, 0, 0, 1, 4
"d:\IDEWORK\lvmen\src\licensedcode\data\rules\agpl-2.0_17.yml", "YAML", 0, 0, 0, 3, 0, 0, 1, 4
"d:\IDEWORK\lvmen\src\licensedcode\data\rules\agpl-2.0_18.yml", "YAML", 0, 0, 0, 3, 0, 0, 1, 4
"d:\IDEWORK\lvmen\src\licensedcode\data\rules\agpl-2.0_19.yml", "YAML", 0, 0, 0, 3, 0, 0, 1, 4
"d:\IDEWORK\lvmen\src\licensedcode\data\rules\agpl-2.0_2.yml", "YAML", 0, 0, 0, 3, 0, 0, 1, 4
"d:\IDEWORK\lvmen\src\licensedcode\data\rules\agpl-2.0_20.yml", "YAML", 0, 0, 0, 3, 0, 0, 1, 4
"d:\IDEWORK\lvmen\src\licensedcode\data\rules\agpl-2.0_21.yml", "YAML", 0, 0, 0, 3, 0, 0, 1, 4
"d:\IDEWORK\lvmen\src\licensedcode\data\rules\agpl-2.0_22.yml", "YAML", 0, 0, 0, 3, 0, 0, 1, 4
"d:\IDEWORK\lvmen\src\licensedcode\data\rules\agpl-2.0_23.yml", "YAML", 0, 0, 0, 3, 0, 0, 1, 4
"d:\IDEWORK\lvmen\src\licensedcode\data\rules\agpl-2.0_24.yml", "YAML", 0, 0, 0, 3, 0, 0, 1, 4
"d:\IDEWORK\lvmen\src\licensedcode\data\rules\agpl-2.0_25.yml", "YAML", 0, 0, 0, 3, 0, 0, 1, 4
"d:\IDEWORK\lvmen\src\licensedcode\data\rules\agpl-2.0_26.yml", "YAML", 0, 0, 0, 3, 0, 0, 1, 4
"d:\IDEWORK\lvmen\src\licensedcode\data\rules\agpl-2.0_27.yml", "YAML", 0, 0, 0, 3, 0, 0, 1, 4
"d:\IDEWORK\lvmen\src\licensedcode\data\rules\agpl-2.0_28.yml", "YAML", 0, 0, 0, 3, 0, 0, 1, 4
"d:\IDEWORK\lvmen\src\licensedcode\data\rules\agpl-2.0_29.yml", "YAML", 0, 0, 0, 3, 0, 0, 1, 4
"d:\IDEWORK\lvmen\src\licensedcode\data\rules\agpl-2.0_3.yml", "YAML", 0, 0, 0, 5, 0, 0, 1, 6
"d:\IDEWORK\lvmen\src\licensedcode\data\rules\agpl-2.0_30.yml", "YAML", 0, 0, 0, 3, 0, 0, 1, 4
"d:\IDEWORK\lvmen\src\licensedcode\data\rules\agpl-2.0_31.yml", "YAML", 0, 0, 0, 3, 0, 0, 1, 4
"d:\IDEWORK\lvmen\src\licensedcode\data\rules\agpl-2.0_32.yml", "YAML", 0, 0, 0, 3, 0, 0, 1, 4
"d:\IDEWORK\lvmen\src\licensedcode\data\rules\agpl-2.0_33.yml", "YAML", 0, 0, 0, 3, 0, 0, 1, 4
"d:\IDEWORK\lvmen\src\licensedcode\data\rules\agpl-2.0_4.yml", "YAML", 0, 0, 0, 3, 0, 0, 1, 4
"d:\IDEWORK\lvmen\src\licensedcode\data\rules\agpl-2.0_5.yml", "YAML", 0, 0, 0, 5, 0, 0, 1, 6
"d:\IDEWORK\lvmen\src\licensedcode\data\rules\agpl-2.0_6.yml", "YAML", 0, 0, 0, 3, 0, 0, 1, 4
"d:\IDEWORK\lvmen\src\licensedcode\data\rules\agpl-2.0_7.yml", "YAML", 0, 0, 0, 3, 0, 0, 1, 4
"d:\IDEWORK\lvmen\src\licensedcode\data\rules\agpl-2.0_8.yml", "YAML", 0, 0, 0, 3, 0, 0, 1, 4
"d:\IDEWORK\lvmen\src\licensedcode\data\rules\agpl-2.0_9.yml", "YAML", 0, 0, 0, 3, 0, 0, 1, 4
"d:\IDEWORK\lvmen\src\licensedcode\data\rules\agpl-3.0-plus_1.yml", "YAML", 0, 0, 0, 5, 0, 0, 1, 6
"d:\IDEWORK\lvmen\src\licensedcode\data\rules\agpl-3.0-plus_10.yml", "YAML", 0, 0, 0, 3, 0, 0, 1, 4
"d:\IDEWORK\lvmen\src\licensedcode\data\rules\agpl-3.0-plus_100.yml", "YAML", 0, 0, 0, 7, 0, 0, 1, 8
"d:\IDEWORK\lvmen\src\licensedcode\data\rules\agpl-3.0-plus_101.yml", "YAML", 0, 0, 0, 3, 0, 0, 1, 4
"d:\IDEWORK\lvmen\src\licensedcode\data\rules\agpl-3.0-plus_102.yml", "YAML", 0, 0, 0, 3, 0, 0, 1, 4
"d:\IDEWORK\lvmen\src\licensedcode\data\rules\agpl-3.0-plus_103.yml", "YAML", 0, 0, 0, 3, 0, 0, 1, 4
"d:\IDEWORK\lvmen\src\licensedcode\data\rules\agpl-3.0-plus_104.yml", "YAML", 0, 0, 0, 3, 0, 0, 1, 4
"d:\IDEWORK\lvmen\src\licensedcode\data\rules\agpl-3.0-plus_105.yml", "YAML", 0, 0, 0, 3, 0, 0, 1, 4
"d:\IDEWORK\lvmen\src\licensedcode\data\rules\agpl-3.0-plus_106.yml", "YAML", 0, 0, 0, 3, 0, 0, 1, 4
"d:\IDEWORK\lvmen\src\licensedcode\data\rules\agpl-3.0-plus_107.yml", "YAML", 0, 0, 0, 3, 0, 0, 1, 4
"d:\IDEWORK\lvmen\src\licensedcode\data\rules\agpl-3.0-plus_108.yml", "YAML", 0, 0, 0, 5, 0, 0, 1, 6
"d:\IDEWORK\lvmen\src\licensedcode\data\rules\agpl-3.0-plus_109.yml", "YAML", 0, 0, 0, 5, 0, 0, 1, 6
"d:\IDEWORK\lvmen\src\licensedcode\data\rules\agpl-3.0-plus_11.yml", "YAML", 0, 0, 0, 4, 0, 0, 1, 5
"d:\IDEWORK\lvmen\src\licensedcode\data\rules\agpl-3.0-plus_110.yml", "YAML", 0, 0, 0, 3, 0, 0, 1, 4
"d:\IDEWORK\lvmen\src\licensedcode\data\rules\agpl-3.0-plus_111.yml", "YAML", 0, 0, 0, 3, 0, 0, 1, 4
"d:\IDEWORK\lvmen\src\licensedcode\data\rules\agpl-3.0-plus_112.yml", "YAML", 0, 0, 0, 6, 0, 0, 1, 7
"d:\IDEWORK\lvmen\src\licensedcode\data\rules\agpl-3.0-plus_113.yml", "YAML", 0, 0, 0, 3, 0, 0, 1, 4
"d:\IDEWORK\lvmen\src\licensedcode\data\rules\agpl-3.0-plus_114.yml", "YAML", 0, 0, 0, 3, 0, 0, 1, 4
"d:\IDEWORK\lvmen\src\licensedcode\data\rules\agpl-3.0-plus_115.yml", "YAML", 0, 0, 0, 5, 0, 0, 1, 6
"d:\IDEWORK\lvmen\src\licensedcode\data\rules\agpl-3.0-plus_116.yml", "YAML", 0, 0, 0, 5, 0, 0, 1, 6
"d:\IDEWORK\lvmen\src\licensedcode\data\rules\agpl-3.0-plus_117.yml", "YAML", 0, 0, 0, 7, 0, 0, 1, 8
"d:\IDEWORK\lvmen\src\licensedcode\data\rules\agpl-3.0-plus_118.yml", "YAML", 0, 0, 0, 3, 0, 0, 1, 4
"d:\IDEWORK\lvmen\src\licensedcode\data\rules\agpl-3.0-plus_119.yml", "YAML", 0, 0, 0, 5, 0, 0, 1, 6
"d:\IDEWORK\lvmen\src\licensedcode\data\rules\agpl-3.0-plus_12.yml", "YAML", 0, 0, 0, 2, 0, 0, 1, 3
"d:\IDEWORK\lvmen\src\licensedcode\data\rules\agpl-3.0-plus_120.yml", "YAML", 0, 0, 0, 3, 0, 0, 1, 4
"d:\IDEWORK\lvmen\src\licensedcode\data\rules\agpl-3.0-plus_121.yml", "YAML", 0, 0, 0, 7, 0, 0, 1, 8
"d:\IDEWORK\lvmen\src\licensedcode\data\rules\agpl-3.0-plus_122.yml", "YAML", 0, 0, 0, 7, 0, 0, 1, 8
"d:\IDEWORK\lvmen\src\licensedcode\data\rules\agpl-3.0-plus_123.yml", "YAML", 0, 0, 0, 4, 0, 0, 1, 5
"d:\IDEWORK\lvmen\src\licensedcode\data\rules\agpl-3.0-plus_124.yml", "YAML", 0, 0, 0, 3, 0, 0, 1, 4
"d:\IDEWORK\lvmen\src\licensedcode\data\rules\agpl-3.0-plus_125.yml", "YAML", 0, 0, 0, 5, 0, 0, 1, 6
"d:\IDEWORK\lvmen\src\licensedcode\data\rules\agpl-3.0-plus_126.yml", "YAML", 0, 0, 0, 3, 0, 0, 1, 4
"d:\IDEWORK\lvmen\src\licensedcode\data\rules\agpl-3.0-plus_127.yml", "YAML", 0, 0, 0, 5, 0, 0, 1, 6
"d:\IDEWORK\lvmen\src\licensedcode\data\rules\agpl-3.0-plus_128.yml", "YAML", 0, 0, 0, 3, 0, 0, 1, 4
"d:\IDEWORK\lvmen\src\licensedcode\data\rules\agpl-3.0-plus_129.yml", "YAML", 0, 0, 0, 5, 0, 0, 1, 6
"d:\IDEWORK\lvmen\src\licensedcode\data\rules\agpl-3.0-plus_13.yml", "YAML", 0, 0, 0, 3, 0, 0, 1, 4
"d:\IDEWORK\lvmen\src\licensedcode\data\rules\agpl-3.0-plus_130.yml", "YAML", 0, 0, 0, 3, 0, 0, 1, 4
"d:\IDEWORK\lvmen\src\licensedcode\data\rules\agpl-3.0-plus_131.yml", "YAML", 0, 0, 0, 3, 0, 0, 1, 4
"d:\IDEWORK\lvmen\src\licensedcode\data\rules\agpl-3.0-plus_132.yml", "YAML", 0, 0, 0, 3, 0, 0, 1, 4
"d:\IDEWORK\lvmen\src\licensedcode\data\rules\agpl-3.0-plus_133.yml", "YAML", 0, 0, 0, 3, 0, 0, 1, 4
"d:\IDEWORK\lvmen\src\licensedcode\data\rules\agpl-3.0-plus_134.yml", "YAML", 0, 0, 0, 3, 0, 0, 1, 4
"d:\IDEWORK\lvmen\src\licensedcode\data\rules\agpl-3.0-plus_135.yml", "YAML", 0, 0, 0, 5, 0, 0, 1, 6
"d:\IDEWORK\lvmen\src\licensedcode\data\rules\agpl-3.0-plus_136.yml", "YAML", 0, 0, 0, 5, 0, 0, 1, 6
"d:\IDEWORK\lvmen\src\licensedcode\data\rules\agpl-3.0-plus_137.yml", "YAML", 0, 0, 0, 5, 0, 0, 1, 6
"d:\IDEWORK\lvmen\src\licensedcode\data\rules\agpl-3.0-plus_138.yml", "YAML", 0, 0, 0, 5, 0, 0, 1, 6
"d:\IDEWORK\lvmen\src\licensedcode\data\rules\agpl-3.0-plus_139.yml", "YAML", 0, 0, 0, 5, 0, 0, 1, 6
"d:\IDEWORK\lvmen\src\licensedcode\data\rules\agpl-3.0-plus_14.yml", "YAML", 0, 0, 0, 3, 0, 0, 1, 4
"d:\IDEWORK\lvmen\src\licensedcode\data\rules\agpl-3.0-plus_140.yml", "YAML", 0, 0, 0, 4, 0, 0, 1, 5
"d:\IDEWORK\lvmen\src\licensedcode\data\rules\agpl-3.0-plus_141.yml", "YAML", 0, 0, 0, 5, 0, 0, 1, 6
"d:\IDEWORK\lvmen\src\licensedcode\data\rules\agpl-3.0-plus_142.yml", "YAML", 0, 0, 0, 3, 0, 0, 1, 4
"d:\IDEWORK\lvmen\src\licensedcode\data\rules\agpl-3.0-plus_143.yml", "YAML", 0, 0, 0, 4, 0, 0, 1, 5
"d:\IDEWORK\lvmen\src\licensedcode\data\rules\agpl-3.0-plus_144.yml", "YAML", 0, 0, 0, 3, 0, 0, 1, 4
"d:\IDEWORK\lvmen\src\licensedcode\data\rules\agpl-3.0-plus_145.yml", "YAML", 0, 0, 0, 4, 0, 0, 1, 5
"d:\IDEWORK\lvmen\src\licensedcode\data\rules\agpl-3.0-plus_146.yml", "YAML", 0, 0, 0, 3, 0, 0, 1, 4
"d:\IDEWORK\lvmen\src\licensedcode\data\rules\agpl-3.0-plus_147.yml", "YAML", 0, 0, 0, 3, 0, 0, 1, 4
"d:\IDEWORK\lvmen\src\licensedcode\data\rules\agpl-3.0-plus_148.yml", "YAML", 0, 0, 0, 8, 0, 0, 1, 9
"d:\IDEWORK\lvmen\src\licensedcode\data\rules\agpl-3.0-plus_149.yml", "YAML", 0, 0, 0, 6, 0, 0, 1, 7
"d:\IDEWORK\lvmen\src\licensedcode\data\rules\agpl-3.0-plus_15.yml", "YAML", 0, 0, 0, 3, 0, 0, 1, 4
"d:\IDEWORK\lvmen\src\licensedcode\data\rules\agpl-3.0-plus_150.yml", "YAML", 0, 0, 0, 5, 0, 0, 1, 6
"d:\IDEWORK\lvmen\src\licensedcode\data\rules\agpl-3.0-plus_151.yml", "YAML", 0, 0, 0, 5, 0, 0, 1, 6
"d:\IDEWORK\lvmen\src\licensedcode\data\rules\agpl-3.0-plus_152.yml", "YAML", 0, 0, 0, 5, 0, 0, 1, 6
"d:\IDEWORK\lvmen\src\licensedcode\data\rules\agpl-3.0-plus_153.yml", "YAML", 0, 0, 0, 3, 0, 0, 1, 4
"d:\IDEWORK\lvmen\src\licensedcode\data\rules\agpl-3.0-plus_154.yml", "YAML", 0, 0, 0, 3, 0, 0, 1, 4
"d:\IDEWORK\lvmen\src\licensedcode\data\rules\agpl-3.0-plus_155.yml", "YAML", 0, 0, 0, 3, 0, 0, 1, 4
"d:\IDEWORK\lvmen\src\licensedcode\data\rules\agpl-3.0-plus_156.yml", "YAML", 0, 0, 0, 3, 0, 0, 1, 4
"d:\IDEWORK\lvmen\src\licensedcode\data\rules\agpl-3.0-plus_157.yml", "YAML", 0, 0, 0, 3, 0, 0, 1, 4
"d:\IDEWORK\lvmen\src\licensedcode\data\rules\agpl-3.0-plus_158.yml", "YAML", 0, 0, 0, 3, 0, 0, 1, 4
"d:\IDEWORK\lvmen\src\licensedcode\data\rules\agpl-3.0-plus_159.yml", "YAML", 0, 0, 0, 3, 0, 0, 1, 4
"d:\IDEWORK\lvmen\src\licensedcode\data\rules\agpl-3.0-plus_16.yml", "YAML", 0, 0, 0, 6, 0, 0, 1, 7
"d:\IDEWORK\lvmen\src\licensedcode\data\rules\agpl-3.0-plus_160.yml", "YAML", 0, 0, 0, 3, 0, 0, 1, 4
"d:\IDEWORK\lvmen\src\licensedcode\data\rules\agpl-3.0-plus_161.yml", "YAML", 0, 0, 0, 5, 0, 0, 1, 6
"d:\IDEWORK\lvmen\src\licensedcode\data\rules\agpl-3.0-plus_162.yml", "YAML", 0, 0, 0, 3, 0, 0, 1, 4
"d:\IDEWORK\lvmen\src\licensedcode\data\rules\agpl-3.0-plus_163.yml", "YAML", 0, 0, 0, 5, 0, 0, 1, 6
"d:\IDEWORK\lvmen\src\licensedcode\data\rules\agpl-3.0-plus_164.yml", "YAML", 0, 0, 0, 5, 0, 0, 1, 6
"d:\IDEWORK\lvmen\src\licensedcode\data\rules\agpl-3.0-plus_165.yml", "YAML", 0, 0, 0, 3, 0, 0, 1, 4
"d:\IDEWORK\lvmen\src\licensedcode\data\rules\agpl-3.0-plus_166.yml", "YAML", 0, 0, 0, 3, 0, 0, 1, 4
"d:\IDEWORK\lvmen\src\licensedcode\data\rules\agpl-3.0-plus_167.yml", "YAML", 0, 0, 0, 3, 0, 0, 1, 4
"d:\IDEWORK\lvmen\src\licensedcode\data\rules\agpl-3.0-plus_168.yml", "YAML", 0, 0, 0, 3, 0, 0, 1, 4
"d:\IDEWORK\lvmen\src\licensedcode\data\rules\agpl-3.0-plus_169.yml", "YAML", 0, 0, 0, 3, 0, 0, 1, 4
"d:\IDEWORK\lvmen\src\licensedcode\data\rules\agpl-3.0-plus_17.yml", "YAML", 0, 0, 0, 3, 0, 0, 1, 4
"d:\IDEWORK\lvmen\src\licensedcode\data\rules\agpl-3.0-plus_170.yml", "YAML", 0, 0, 0, 3, 0, 0, 1, 4
"d:\IDEWORK\lvmen\src\licensedcode\data\rules\agpl-3.0-plus_171.yml", "YAML", 0, 0, 0, 3, 0, 0, 1, 4
"d:\IDEWORK\lvmen\src\licensedcode\data\rules\agpl-3.0-plus_172.yml", "YAML", 0, 0, 0, 7, 0, 0, 1, 8
"d:\IDEWORK\lvmen\src\licensedcode\data\rules\agpl-3.0-plus_173.yml", "YAML", 0, 0, 0, 3, 0, 0, 1, 4
"d:\IDEWORK\lvmen\src\licensedcode\data\rules\agpl-3.0-plus_174.yml", "YAML", 0, 0, 0, 3, 0, 0, 1, 4
"d:\IDEWORK\lvmen\src\licensedcode\data\rules\agpl-3.0-plus_175.yml", "YAML", 0, 0, 0, 5, 0, 0, 1, 6
"d:\IDEWORK\lvmen\src\licensedcode\data\rules\agpl-3.0-plus_176.yml", "YAML", 0, 0, 0, 3, 0, 0, 1, 4
"d:\IDEWORK\lvmen\src\licensedcode\data\rules\agpl-3.0-plus_177.yml", "YAML", 0, 0, 0, 3, 0, 0, 1, 4
"d:\IDEWORK\lvmen\src\licensedcode\data\rules\agpl-3.0-plus_178.yml", "YAML", 0, 0, 0, 3, 0, 0, 1, 4
"d:\IDEWORK\lvmen\src\licensedcode\data\rules\agpl-3.0-plus_179.yml", "YAML", 0, 0, 0, 3, 0, 0, 1, 4
"d:\IDEWORK\lvmen\src\licensedcode\data\rules\agpl-3.0-plus_18.yml", "YAML", 0, 0, 0, 3, 0, 0, 1, 4
"d:\IDEWORK\lvmen\src\licensedcode\data\rules\agpl-3.0-plus_180.yml", "YAML", 0, 0, 0, 5, 0, 0, 1, 6
"d:\IDEWORK\lvmen\src\licensedcode\data\rules\agpl-3.0-plus_181.yml", "YAML", 0, 0, 0, 5, 0, 0, 1, 6
"d:\IDEWORK\lvmen\src\licensedcode\data\rules\agpl-3.0-plus_182.yml", "YAML", 0, 0, 0, 5, 0, 0, 1, 6
"d:\IDEWORK\lvmen\src\licensedcode\data\rules\agpl-3.0-plus_183.yml", "YAML", 0, 0, 0, 5, 0, 0, 1, 6
"d:\IDEWORK\lvmen\src\licensedcode\data\rules\agpl-3.0-plus_184.yml", "YAML", 0, 0, 0, 5, 0, 0, 1, 6
"d:\IDEWORK\lvmen\src\licensedcode\data\rules\agpl-3.0-plus_185.yml", "YAML", 0, 0, 0, 5, 0, 0, 1, 6
"d:\IDEWORK\lvmen\src\licensedcode\data\rules\agpl-3.0-plus_186.yml", "YAML", 0, 0, 0, 7, 0, 0, 1, 8
"d:\IDEWORK\lvmen\src\licensedcode\data\rules\agpl-3.0-plus_187.yml", "YAML", 0, 0, 0, 5, 0, 0, 1, 6
"d:\IDEWORK\lvmen\src\licensedcode\data\rules\agpl-3.0-plus_188.yml", "YAML", 0, 0, 0, 5, 0, 0, 1, 6
"d:\IDEWORK\lvmen\src\licensedcode\data\rules\agpl-3.0-plus_189.yml", "YAML", 0, 0, 0, 3, 0, 0, 1, 4
"d:\IDEWORK\lvmen\src\licensedcode\data\rules\agpl-3.0-plus_19.yml", "YAML", 0, 0, 0, 4, 0, 0, 1, 5
"d:\IDEWORK\lvmen\src\licensedcode\data\rules\agpl-3.0-plus_190.yml", "YAML", 0, 0, 0, 5, 0, 0, 1, 6
"d:\IDEWORK\lvmen\src\licensedcode\data\rules\agpl-3.0-plus_191.yml", "YAML", 0, 0, 0, 5, 0, 0, 1, 6
"d:\IDEWORK\lvmen\src\licensedcode\data\rules\agpl-3.0-plus_192.yml", "YAML", 0, 0, 0, 5, 0, 0, 1, 6
"d:\IDEWORK\lvmen\src\licensedcode\data\rules\agpl-3.0-plus_193.yml", "YAML", 0, 0, 0, 7, 0, 0, 1, 8
"d:\IDEWORK\lvmen\src\licensedcode\data\rules\agpl-3.0-plus_194.yml", "YAML", 0, 0, 0, 7, 0, 0, 1, 8
"d:\IDEWORK\lvmen\src\licensedcode\data\rules\agpl-3.0-plus_195.yml", "YAML", 0, 0, 0, 5, 0, 0, 1, 6
"d:\IDEWORK\lvmen\src\licensedcode\data\rules\agpl-3.0-plus_196.yml", "YAML", 0, 0, 0, 3, 0, 0, 1, 4
"d:\IDEWORK\lvmen\src\licensedcode\data\rules\agpl-3.0-plus_197.yml", "YAML", 0, 0, 0, 5, 0, 0, 1, 6
"d:\IDEWORK\lvmen\src\licensedcode\data\rules\agpl-3.0-plus_198.yml", "YAML", 0, 0, 0, 5, 0, 0, 1, 6
"d:\IDEWORK\lvmen\src\licensedcode\data\rules\agpl-3.0-plus_199.yml", "YAML", 0, 0, 0, 4, 0, 0, 2, 6
"d:\IDEWORK\lvmen\src\licensedcode\data\rules\agpl-3.0-plus_2.yml", "YAML", 0, 0, 0, 5, 0, 0, 1, 6
"d:\IDEWORK\lvmen\src\licensedcode\data\rules\agpl-3.0-plus_20.yml", "YAML", 0, 0, 0, 3, 0, 0, 1, 4
"d:\IDEWORK\lvmen\src\licensedcode\data\rules\agpl-3.0-plus_200.yml", "YAML", 0, 0, 0, 3, 0, 0, 1, 4
"d:\IDEWORK\lvmen\src\licensedcode\data\rules\agpl-3.0-plus_201.yml", "YAML", 0, 0, 0, 3, 0, 0, 1, 4
"d:\IDEWORK\lvmen\src\licensedcode\data\rules\agpl-3.0-plus_202.yml", "YAML", 0, 0, 0, 3, 0, 0, 1, 4
"d:\IDEWORK\lvmen\src\licensedcode\data\rules\agpl-3.0-plus_203.yml", "YAML", 0, 0, 0, 3, 0, 0, 1, 4
"d:\IDEWORK\lvmen\src\licensedcode\data\rules\agpl-3.0-plus_204.yml", "YAML", 0, 0, 0, 3, 0, 0, 1, 4
"d:\IDEWORK\lvmen\src\licensedcode\data\rules\agpl-3.0-plus_205.yml", "YAML", 0, 0, 0, 3, 0, 0, 1, 4
"d:\IDEWORK\lvmen\src\licensedcode\data\rules\agpl-3.0-plus_206.yml", "YAML", 0, 0, 0, 3, 0, 0, 1, 4
"d:\IDEWORK\lvmen\src\licensedcode\data\rules\agpl-3.0-plus_207.yml", "YAML", 0, 0, 0, 3, 0, 0, 1, 4
"d:\IDEWORK\lvmen\src\licensedcode\data\rules\agpl-3.0-plus_208.yml", "YAML", 0, 0, 0, 3, 0, 0, 1, 4
"d:\IDEWORK\lvmen\src\licensedcode\data\rules\agpl-3.0-plus_209.yml", "YAML", 0, 0, 0, 3, 0, 0, 1, 4
"d:\IDEWORK\lvmen\src\licensedcode\data\rules\agpl-3.0-plus_21.yml", "YAML", 0, 0, 0, 3, 0, 0, 1, 4
"d:\IDEWORK\lvmen\src\licensedcode\data\rules\agpl-3.0-plus_210.yml", "YAML", 0, 0, 0, 3, 0, 0, 1, 4
"d:\IDEWORK\lvmen\src\licensedcode\data\rules\agpl-3.0-plus_211.yml", "YAML", 0, 0, 0, 3, 0, 0, 1, 4
"d:\IDEWORK\lvmen\src\licensedcode\data\rules\agpl-3.0-plus_212.yml", "YAML", 0, 0, 0, 3, 0, 0, 1, 4
"d:\IDEWORK\lvmen\src\licensedcode\data\rules\agpl-3.0-plus_213.yml", "YAML", 0, 0, 0, 3, 0, 0, 1, 4
"d:\IDEWORK\lvmen\src\licensedcode\data\rules\agpl-3.0-plus_214.yml", "YAML", 0, 0, 0, 5, 0, 0, 1, 6
"d:\IDEWORK\lvmen\src\licensedcode\data\rules\agpl-3.0-plus_215.yml", "YAML", 0, 0, 0, 3, 0, 0, 1, 4
"d:\IDEWORK\lvmen\src\licensedcode\data\rules\agpl-3.0-plus_216.yml", "YAML", 0, 0, 0, 3, 0, 0, 1, 4
"d:\IDEWORK\lvmen\src\licensedcode\data\rules\agpl-3.0-plus_217.yml", "YAML", 0, 0, 0, 3, 0, 0, 1, 4
"d:\IDEWORK\lvmen\src\licensedcode\data\rules\agpl-3.0-plus_218.yml", "YAML", 0, 0, 0, 3, 0, 0, 1, 4
"d:\IDEWORK\lvmen\src\licensedcode\data\rules\agpl-3.0-plus_219.yml", "YAML", 0, 0, 0, 3, 0, 0, 1, 4
"d:\IDEWORK\lvmen\src\licensedcode\data\rules\agpl-3.0-plus_22.yml", "YAML", 0, 0, 0, 3, 0, 0, 1, 4
"d:\IDEWORK\lvmen\src\licensedcode\data\rules\agpl-3.0-plus_220.yml", "YAML", 0, 0, 0, 3, 0, 0, 1, 4
"d:\IDEWORK\lvmen\src\licensedcode\data\rules\agpl-3.0-plus_221.yml", "YAML", 0, 0, 0, 3, 0, 0, 1, 4
"d:\IDEWORK\lvmen\src\licensedcode\data\rules\agpl-3.0-plus_222.yml", "YAML", 0, 0, 0, 5, 0, 0, 1, 6
"d:\IDEWORK\lvmen\src\licensedcode\data\rules\agpl-3.0-plus_223.yml", "YAML", 0, 0, 0, 8, 0, 0, 1, 9
"d:\IDEWORK\lvmen\src\licensedcode\data\rules\agpl-3.0-plus_224.yml", "YAML", 0, 0, 0, 8, 0, 0, 1, 9
"d:\IDEWORK\lvmen\src\licensedcode\data\rules\agpl-3.0-plus_225.yml", "YAML", 0, 0, 0, 3, 0, 0, 1, 4
"d:\IDEWORK\lvmen\src\licensedcode\data\rules\agpl-3.0-plus_226.yml", "YAML", 0, 0, 0, 3, 0, 0, 1, 4
"d:\IDEWORK\lvmen\src\licensedcode\data\rules\agpl-3.0-plus_227.yml", "YAML", 0, 0, 0, 3, 0, 0, 1, 4
"d:\IDEWORK\lvmen\src\licensedcode\data\rules\agpl-3.0-plus_228.yml", "YAML", 0, 0, 0, 3, 0, 0, 1, 4
"d:\IDEWORK\lvmen\src\licensedcode\data\rules\agpl-3.0-plus_229.yml", "YAML", 0, 0, 0, 3, 0, 0, 1, 4
"d:\IDEWORK\lvmen\src\licensedcode\data\rules\agpl-3.0-plus_23.yml", "YAML", 0, 0, 0, 3, 0, 0, 1, 4
"d:\IDEWORK\lvmen\src\licensedcode\data\rules\agpl-3.0-plus_230.yml", "YAML", 0, 0, 0, 3, 0, 0, 1, 4
"d:\IDEWORK\lvmen\src\licensedcode\data\rules\agpl-3.0-plus_231.yml", "YAML", 0, 0, 0, 3, 0, 0, 1, 4
"d:\IDEWORK\lvmen\src\licensedcode\data\rules\agpl-3.0-plus_232.yml", "YAML", 0, 0, 0, 4, 0, 0, 1, 5
"d:\IDEWORK\lvmen\src\licensedcode\data\rules\agpl-3.0-plus_233.yml", "YAML", 0, 0, 0, 3, 0, 0, 1, 4
"d:\IDEWORK\lvmen\src\licensedcode\data\rules\agpl-3.0-plus_234.yml", "YAML", 0, 0, 0, 3, 0, 0, 1, 4
"d:\IDEWORK\lvmen\src\licensedcode\data\rules\agpl-3.0-plus_235.yml", "YAML", 0, 0, 0, 3, 0, 0, 1, 4
"d:\IDEWORK\lvmen\src\licensedcode\data\rules\agpl-3.0-plus_236.yml", "YAML", 0, 0, 0, 3, 0, 0, 1, 4
"d:\IDEWORK\lvmen\src\licensedcode\data\rules\agpl-3.0-plus_237.yml", "YAML", 0, 0, 0, 3, 0, 0, 1, 4
"d:\IDEWORK\lvmen\src\licensedcode\data\rules\agpl-3.0-plus_238.yml", "YAML", 0, 0, 0, 3, 0, 0, 1, 4
"d:\IDEWORK\lvmen\src\licensedcode\data\rules\agpl-3.0-plus_239.yml", "YAML", 0, 0, 0, 3, 0, 0, 1, 4
"d:\IDEWORK\lvmen\src\licensedcode\data\rules\agpl-3.0-plus_24.yml", "YAML", 0, 0, 0, 3, 0, 0, 1, 4
"d:\IDEWORK\lvmen\src\licensedcode\data\rules\agpl-3.0-plus_240.yml", "YAML", 0, 0, 0, 3, 0, 0, 1, 4
"d:\IDEWORK\lvmen\src\licensedcode\data\rules\agpl-3.0-plus_241.yml", "YAML", 0, 0, 0, 3, 0, 0, 1, 4
"d:\IDEWORK\lvmen\src\licensedcode\data\rules\agpl-3.0-plus_242.yml", "YAML", 0, 0, 0, 3, 0, 0, 1, 4
"d:\IDEWORK\lvmen\src\licensedcode\data\rules\agpl-3.0-plus_243.yml", "YAML", 0, 0, 0, 4, 0, 0, 1, 5
"d:\IDEWORK\lvmen\src\licensedcode\data\rules\agpl-3.0-plus_244.yml", "YAML", 0, 0, 0, 2, 0, 0, 1, 3
"d:\IDEWORK\lvmen\src\licensedcode\data\rules\agpl-3.0-plus_245.yml", "YAML", 0, 0, 0, 2, 0, 0, 1, 3
"d:\IDEWORK\lvmen\src\licensedcode\data\rules\agpl-3.0-plus_246.yml", "YAML", 0, 0, 0, 2, 0, 0, 1, 3
"d:\IDEWORK\lvmen\src\licensedcode\data\rules\agpl-3.0-plus_247.yml", "YAML", 0, 0, 0, 2, 0, 0, 1, 3
"d:\IDEWORK\lvmen\src\licensedcode\data\rules\agpl-3.0-plus_248.yml", "YAML", 0, 0, 0, 8, 0, 0, 1, 9
"d:\IDEWORK\lvmen\src\licensedcode\data\rules\agpl-3.0-plus_249.yml", "YAML", 0, 0, 0, 5, 0, 0, 1, 6
"d:\IDEWORK\lvmen\src\licensedcode\data\rules\agpl-3.0-plus_25.yml", "YAML", 0, 0, 0, 3, 0, 0, 1, 4
"d:\IDEWORK\lvmen\src\licensedcode\data\rules\agpl-3.0-plus_250.yml", "YAML", 0, 0, 0, 5, 0, 0, 1, 6
"d:\IDEWORK\lvmen\src\licensedcode\data\rules\agpl-3.0-plus_251.yml", "YAML", 0, 0, 0, 7, 0, 0, 1, 8
"d:\IDEWORK\lvmen\src\licensedcode\data\rules\agpl-3.0-plus_252.yml", "YAML", 0, 0, 0, 6, 0, 0, 1, 7
"d:\IDEWORK\lvmen\src\licensedcode\data\rules\agpl-3.0-plus_253.yml", "YAML", 0, 0, 0, 6, 0, 0, 1, 7
"d:\IDEWORK\lvmen\src\licensedcode\data\rules\agpl-3.0-plus_254.yml", "YAML", 0, 0, 0, 8, 0, 0, 1, 9
"d:\IDEWORK\lvmen\src\licensedcode\data\rules\agpl-3.0-plus_255.yml", "YAML", 0, 0, 0, 5, 0, 0, 1, 6
"d:\IDEWORK\lvmen\src\licensedcode\data\rules\agpl-3.0-plus_26.yml", "YAML", 0, 0, 0, 3, 0, 0, 1, 4
"d:\IDEWORK\lvmen\src\licensedcode\data\rules\agpl-3.0-plus_27.yml", "YAML", 0, 0, 0, 3, 0, 0, 1, 4
"d:\IDEWORK\lvmen\src\licensedcode\data\rules\agpl-3.0-plus_28.yml", "YAML", 0, 0, 0, 3, 0, 0, 1, 4
"d:\IDEWORK\lvmen\src\licensedcode\data\rules\agpl-3.0-plus_29.yml", "YAML", 0, 0, 0, 3, 0, 0, 1, 4
"d:\IDEWORK\lvmen\src\licensedcode\data\rules\agpl-3.0-plus_3.yml", "YAML", 0, 0, 0, 4, 0, 0, 1, 5
"d:\IDEWORK\lvmen\src\licensedcode\data\rules\agpl-3.0-plus_30.yml", "YAML", 0, 0, 0, 3, 0, 0, 1, 4
"d:\IDEWORK\lvmen\src\licensedcode\data\rules\agpl-3.0-plus_31.yml", "YAML", 0, 0, 0, 3, 0, 0, 1, 4
"d:\IDEWORK\lvmen\src\licensedcode\data\rules\agpl-3.0-plus_32.yml", "YAML", 0, 0, 0, 3, 0, 0, 1, 4
"d:\IDEWORK\lvmen\src\licensedcode\data\rules\agpl-3.0-plus_33.yml", "YAML", 0, 0, 0, 3, 0, 0, 1, 4
"d:\IDEWORK\lvmen\src\licensedcode\data\rules\agpl-3.0-plus_34.yml", "YAML", 0, 0, 0, 3, 0, 0, 1, 4
"d:\IDEWORK\lvmen\src\licensedcode\data\rules\agpl-3.0-plus_35.yml", "YAML", 0, 0, 0, 3, 0, 0, 1, 4
"d:\IDEWORK\lvmen\src\licensedcode\data\rules\agpl-3.0-plus_36.yml", "YAML", 0, 0, 0, 3, 0, 0, 1, 4
"d:\IDEWORK\lvmen\src\licensedcode\data\rules\agpl-3.0-plus_37.yml", "YAML", 0, 0, 0, 3, 0, 0, 1, 4
"d:\IDEWORK\lvmen\src\licensedcode\data\rules\agpl-3.0-plus_38.yml", "YAML", 0, 0, 0, 3, 0, 0, 1, 4
"d:\IDEWORK\lvmen\src\licensedcode\data\rules\agpl-3.0-plus_39.yml", "YAML", 0, 0, 0, 3, 0, 0, 1, 4
"d:\IDEWORK\lvmen\src\licensedcode\data\rules\agpl-3.0-plus_4.yml", "YAML", 0, 0, 0, 5, 0, 0, 1, 6
"d:\IDEWORK\lvmen\src\licensedcode\data\rules\agpl-3.0-plus_40.yml", "YAML", 0, 0, 0, 3, 0, 0, 1, 4
"d:\IDEWORK\lvmen\src\licensedcode\data\rules\agpl-3.0-plus_41.yml", "YAML", 0, 0, 0, 3, 0, 0, 1, 4
"d:\IDEWORK\lvmen\src\licensedcode\data\rules\agpl-3.0-plus_42.yml", "YAML", 0, 0, 0, 3, 0, 0, 1, 4
"d:\IDEWORK\lvmen\src\licensedcode\data\rules\agpl-3.0-plus_43.yml", "YAML", 0, 0, 0, 3, 0, 0, 1, 4
"d:\IDEWORK\lvmen\src\licensedcode\data\rules\agpl-3.0-plus_44.yml", "YAML", 0, 0, 0, 3, 0, 0, 1, 4
"d:\IDEWORK\lvmen\src\licensedcode\data\rules\agpl-3.0-plus_45.yml", "YAML", 0, 0, 0, 3, 0, 0, 1, 4
"d:\IDEWORK\lvmen\src\licensedcode\data\rules\agpl-3.0-plus_46.yml", "YAML", 0, 0, 0, 3, 0, 0, 1, 4
"d:\IDEWORK\lvmen\src\licensedcode\data\rules\agpl-3.0-plus_47.yml", "YAML", 0, 0, 0, 3, 0, 0, 1, 4
"d:\IDEWORK\lvmen\src\licensedcode\data\rules\agpl-3.0-plus_48.yml", "YAML", 0, 0, 0, 3, 0, 0, 1, 4
"d:\IDEWORK\lvmen\src\licensedcode\data\rules\agpl-3.0-plus_49.yml", "YAML", 0, 0, 0, 3, 0, 0, 1, 4
"d:\IDEWORK\lvmen\src\licensedcode\data\rules\agpl-3.0-plus_5.yml", "YAML", 0, 0, 0, 5, 0, 0, 1, 6
"d:\IDEWORK\lvmen\src\licensedcode\data\rules\agpl-3.0-plus_50.yml", "YAML", 0, 0, 0, 3, 0, 0, 1, 4
"d:\IDEWORK\lvmen\src\licensedcode\data\rules\agpl-3.0-plus_51.yml", "YAML", 0, 0, 0, 3, 0, 0, 1, 4
"d:\IDEWORK\lvmen\src\licensedcode\data\rules\agpl-3.0-plus_52.yml", "YAML", 0, 0, 0, 3, 0, 0, 1, 4
"d:\IDEWORK\lvmen\src\licensedcode\data\rules\agpl-3.0-plus_53.yml", "YAML", 0, 0, 0, 3, 0, 0, 1, 4
"d:\IDEWORK\lvmen\src\licensedcode\data\rules\agpl-3.0-plus_54.yml", "YAML", 0, 0, 0, 3, 0, 0, 1, 4
"d:\IDEWORK\lvmen\src\licensedcode\data\rules\agpl-3.0-plus_55.yml", "YAML", 0, 0, 0, 3, 0, 0, 1, 4
"d:\IDEWORK\lvmen\src\licensedcode\data\rules\agpl-3.0-plus_56.yml", "YAML", 0, 0, 0, 3, 0, 0, 1, 4
"d:\IDEWORK\lvmen\src\licensedcode\data\rules\agpl-3.0-plus_57.yml", "YAML", 0, 0, 0, 3, 0, 0, 1, 4
"d:\IDEWORK\lvmen\src\licensedcode\data\rules\agpl-3.0-plus_58.yml", "YAML", 0, 0, 0, 3, 0, 0, 1, 4
"d:\IDEWORK\lvmen\src\licensedcode\data\rules\agpl-3.0-plus_59.yml", "YAML", 0, 0, 0, 3, 0, 0, 1, 4
"d:\IDEWORK\lvmen\src\licensedcode\data\rules\agpl-3.0-plus_6.yml", "YAML", 0, 0, 0, 4, 0, 0, 1, 5
"d:\IDEWORK\lvmen\src\licensedcode\data\rules\agpl-3.0-plus_60.yml", "YAML", 0, 0, 0, 3, 0, 0, 1, 4
"d:\IDEWORK\lvmen\src\licensedcode\data\rules\agpl-3.0-plus_61.yml", "YAML", 0, 0, 0, 3, 0, 0, 1, 4
"d:\IDEWORK\lvmen\src\licensedcode\data\rules\agpl-3.0-plus_62.yml", "YAML", 0, 0, 0, 3, 0, 0, 1, 4
"d:\IDEWORK\lvmen\src\licensedcode\data\rules\agpl-3.0-plus_63.yml", "YAML", 0, 0, 0, 3, 0, 0, 1, 4
"d:\IDEWORK\lvmen\src\licensedcode\data\rules\agpl-3.0-plus_64.yml", "YAML", 0, 0, 0, 3, 0, 0, 1, 4
"d:\IDEWORK\lvmen\src\licensedcode\data\rules\agpl-3.0-plus_65.yml", "YAML", 0, 0, 0, 3, 0, 0, 1, 4
"d:\IDEWORK\lvmen\src\licensedcode\data\rules\agpl-3.0-plus_66.yml", "YAML", 0, 0, 0, 3, 0, 0, 1, 4
"d:\IDEWORK\lvmen\src\licensedcode\data\rules\agpl-3.0-plus_67.yml", "YAML", 0, 0, 0, 3, 0, 0, 1, 4
"d:\IDEWORK\lvmen\src\licensedcode\data\rules\agpl-3.0-plus_68.yml", "YAML", 0, 0, 0, 3, 0, 0, 1, 4
"d:\IDEWORK\lvmen\src\licensedcode\data\rules\agpl-3.0-plus_69.yml", "YAML", 0, 0, 0, 3, 0, 0, 1, 4
"d:\IDEWORK\lvmen\src\licensedcode\data\rules\agpl-3.0-plus_7.yml", "YAML", 0, 0, 0, 4, 0, 0, 1, 5
"d:\IDEWORK\lvmen\src\licensedcode\data\rules\agpl-3.0-plus_70.yml", "YAML", 0, 0, 0, 3, 0, 0, 1, 4
"d:\IDEWORK\lvmen\src\licensedcode\data\rules\agpl-3.0-plus_71.yml", "YAML", 0, 0, 0, 3, 0, 0, 1, 4
"d:\IDEWORK\lvmen\src\licensedcode\data\rules\agpl-3.0-plus_72.yml", "YAML", 0, 0, 0, 3, 0, 0, 1, 4
"d:\IDEWORK\lvmen\src\licensedcode\data\rules\agpl-3.0-plus_73.yml", "YAML", 0, 0, 0, 3, 0, 0, 1, 4
"d:\IDEWORK\lvmen\src\licensedcode\data\rules\agpl-3.0-plus_74.yml", "YAML", 0, 0, 0, 3, 0, 0, 1, 4
"d:\IDEWORK\lvmen\src\licensedcode\data\rules\agpl-3.0-plus_75.yml", "YAML", 0, 0, 0, 3, 0, 0, 1, 4
"d:\IDEWORK\lvmen\src\licensedcode\data\rules\agpl-3.0-plus_76.yml", "YAML", 0, 0, 0, 3, 0, 0, 1, 4
"d:\IDEWORK\lvmen\src\licensedcode\data\rules\agpl-3.0-plus_77.yml", "YAML", 0, 0, 0, 3, 0, 0, 1, 4
"d:\IDEWORK\lvmen\src\licensedcode\data\rules\agpl-3.0-plus_78.yml", "YAML", 0, 0, 0, 3, 0, 0, 1, 4
"d:\IDEWORK\lvmen\src\licensedcode\data\rules\agpl-3.0-plus_79.yml", "YAML", 0, 0, 0, 3, 0, 0, 1, 4
"d:\IDEWORK\lvmen\src\licensedcode\data\rules\agpl-3.0-plus_8.yml", "YAML", 0, 0, 0, 4, 0, 0, 1, 5
"d:\IDEWORK\lvmen\src\licensedcode\data\rules\agpl-3.0-plus_80.yml", "YAML", 0, 0, 0, 3, 0, 0, 1, 4
"d:\IDEWORK\lvmen\src\licensedcode\data\rules\agpl-3.0-plus_81.yml", "YAML", 0, 0, 0, 3, 0, 0, 1, 4
"d:\IDEWORK\lvmen\src\licensedcode\data\rules\agpl-3.0-plus_82.yml", "YAML", 0, 0, 0, 3, 0, 0, 1, 4
"d:\IDEWORK\lvmen\src\licensedcode\data\rules\agpl-3.0-plus_83.yml", "YAML", 0, 0, 0, 3, 0, 0, 1, 4
"d:\IDEWORK\lvmen\src\licensedcode\data\rules\agpl-3.0-plus_84.yml", "YAML", 0, 0, 0, 3, 0, 0, 1, 4
"d:\IDEWORK\lvmen\src\licensedcode\data\rules\agpl-3.0-plus_85.yml", "YAML", 0, 0, 0, 3, 0, 0, 1, 4
"d:\IDEWORK\lvmen\src\licensedcode\data\rules\agpl-3.0-plus_86.yml", "YAML", 0, 0, 0, 3, 0, 0, 1, 4
"d:\IDEWORK\lvmen\src\licensedcode\data\rules\agpl-3.0-plus_87.yml", "YAML", 0, 0, 0, 3, 0, 0, 1, 4
"d:\IDEWORK\lvmen\src\licensedcode\data\rules\agpl-3.0-plus_88.yml", "YAML", 0, 0, 0, 3, 0, 0, 1, 4
"d:\IDEWORK\lvmen\src\licensedcode\data\rules\agpl-3.0-plus_89.yml", "YAML", 0, 0, 0, 3, 0, 0, 1, 4
"d:\IDEWORK\lvmen\src\licensedcode\data\rules\agpl-3.0-plus_9.yml", "YAML", 0, 0, 0, 4, 0, 0, 1, 5
"d:\IDEWORK\lvmen\src\licensedcode\data\rules\agpl-3.0-plus_90.yml", "YAML", 0, 0, 0, 3, 0, 0, 1, 4
"d:\IDEWORK\lvmen\src\licensedcode\data\rules\agpl-3.0-plus_91.yml", "YAML", 0, 0, 0, 3, 0, 0, 1, 4
"d:\IDEWORK\lvmen\src\licensedcode\data\rules\agpl-3.0-plus_92.yml", "YAML", 0, 0, 0, 3, 0, 0, 1, 4
"d:\IDEWORK\lvmen\src\licensedcode\data\rules\agpl-3.0-plus_93.yml", "YAML", 0, 0, 0, 3, 0, 0, 1, 4
"d:\IDEWORK\lvmen\src\licensedcode\data\rules\agpl-3.0-plus_94.yml", "YAML", 0, 0, 0, 3, 0, 0, 1, 4
"d:\IDEWORK\lvmen\src\licensedcode\data\rules\agpl-3.0-plus_95.yml", "YAML", 0, 0, 0, 3, 0, 0, 1, 4
"d:\IDEWORK\lvmen\src\licensedcode\data\rules\agpl-3.0-plus_96.yml", "YAML", 0, 0, 0, 3, 0, 0, 1, 4
"d:\IDEWORK\lvmen\src\licensedcode\data\rules\agpl-3.0-plus_97.yml", "YAML", 0, 0, 0, 3, 0, 0, 1, 4
"d:\IDEWORK\lvmen\src\licensedcode\data\rules\agpl-3.0-plus_98.yml", "YAML", 0, 0, 0, 3, 0, 0, 1, 4
"d:\IDEWORK\lvmen\src\licensedcode\data\rules\agpl-3.0-plus_99.yml", "YAML", 0, 0, 0, 3, 0, 0, 1, 4
"d:\IDEWORK\lvmen\src\licensedcode\data\rules\agpl-3.0-plus_and_other-permissive_or_other-copyleft_1.yml", "YAML", 0, 0, 0, 4, 0, 0, 1, 5
"d:\IDEWORK\lvmen\src\licensedcode\data\rules\agpl-3.0-plus_njs.yml", "YAML", 0, 0, 0, 3, 0, 0, 1, 4
"d:\IDEWORK\lvmen\src\licensedcode\data\rules\agpl-3.0-plus_or_afpl-9.0_1.yml", "YAML", 0, 0, 0, 5, 0, 0, 1, 6
"d:\IDEWORK\lvmen\src\licensedcode\data\rules\agpl-3.0-plus_or_afpl-9.0_2.yml", "YAML", 0, 0, 0, 5, 0, 0, 1, 6
"d:\IDEWORK\lvmen\src\licensedcode\data\rules\agpl-3.0-plus_or_apache-2.0_1.yml", "YAML", 0, 0, 0, 7, 0, 0, 1, 8
"d:\IDEWORK\lvmen\src\licensedcode\data\rules\agpl-3.0-plus_or_apache-2.0_2.yml", "YAML", 0, 0, 0, 7, 0, 0, 1, 8
"d:\IDEWORK\lvmen\src\licensedcode\data\rules\agpl-3.0-plus_or_apache-2.0_3.yml", "YAML", 0, 0, 0, 7, 0, 0, 1, 8
"d:\IDEWORK\lvmen\src\licensedcode\data\rules\agpl-3.0-plus_or_apache-2.0_4.yml", "YAML", 0, 0, 0, 7, 0, 0, 1, 8
"d:\IDEWORK\lvmen\src\licensedcode\data\rules\agpl-3.0-plus_or_bsd-new_1.yml", "YAML", 0, 0, 0, 6, 0, 0, 1, 7
"d:\IDEWORK\lvmen\src\licensedcode\data\rules\agpl-3.0-plus_or_bsd-new_2.yml", "YAML", 0, 0, 0, 6, 0, 0, 1, 7
"d:\IDEWORK\lvmen\src\licensedcode\data\rules\agpl-3.0-plus_or_bsd-new_3.yml", "YAML", 0, 0, 0, 6, 0, 0, 1, 7
"d:\IDEWORK\lvmen\src\licensedcode\data\rules\agpl-3.0-plus_or_bsd-new_4.yml", "YAML", 0, 0, 0, 6, 0, 0, 1, 7
"d:\IDEWORK\lvmen\src\licensedcode\data\rules\agpl-3.0-plus_or_bsd-new_5.yml", "YAML", 0, 0, 0, 3, 0, 0, 1, 4
"d:\IDEWORK\lvmen\src\licensedcode\data\rules\agpl-3.0-plus_or_bsd-new_6.yml", "YAML", 0, 0, 0, 3, 0, 0, 1, 4
"d:\IDEWORK\lvmen\src\licensedcode\data\rules\agpl-3.0-plus_or_commercial-license_1.yml", "YAML", 0, 0, 0, 3, 0, 0, 1, 4
"d:\IDEWORK\lvmen\src\licensedcode\data\rules\agpl-3.0-plus_or_commercial-license_2.yml", "YAML", 0, 0, 0, 3, 0, 0, 1, 4
"d:\IDEWORK\lvmen\src\licensedcode\data\rules\agpl-3.0-plus_or_commercial-license_3.yml", "YAML", 0, 0, 0, 5, 0, 0, 1, 6
"d:\IDEWORK\lvmen\src\licensedcode\data\rules\agpl-3.0-plus_or_commercial-license_4.yml", "YAML", 0, 0, 0, 5, 0, 0, 1, 6
"d:\IDEWORK\lvmen\src\licensedcode\data\rules\agpl-3.0-plus_or_commercial-license_5.yml", "YAML", 0, 0, 0, 5, 0, 0, 1, 6
"d:\IDEWORK\lvmen\src\licensedcode\data\rules\agpl-3.0-plus_or_commercial-license_6.yml", "YAML", 0, 0, 0, 7, 0, 0, 1, 8
"d:\IDEWORK\lvmen\src\licensedcode\data\rules\agpl-3.0-plus_or_commercial-license_7.yml", "YAML", 0, 0, 0, 3, 0, 0, 1, 4
"d:\IDEWORK\lvmen\src\licensedcode\data\rules\agpl-3.0-plus_or_commercial-license_8.yml", "YAML", 0, 0, 0, 7, 0, 0, 1, 8
"d:\IDEWORK\lvmen\src\licensedcode\data\rules\agpl-3.0-plus_or_commercial-license_9.yml", "YAML", 0, 0, 0, 5, 0, 0, 1, 6
"d:\IDEWORK\lvmen\src\licensedcode\data\rules\agpl-3.0-plus_or_commercial-license_and_proprietary-license_1.yml", "YAML", 0, 0, 0, 7, 0, 0, 1, 8
"d:\IDEWORK\lvmen\src\licensedcode\data\rules\agpl-3.0-plus_or_vim_1.yml", "YAML", 0, 0, 0, 3, 0, 0, 1, 4
"d:\IDEWORK\lvmen\src\licensedcode\data\rules\agpl-3.0-plus_url_1.yml", "YAML", 0, 0, 0, 5, 0, 0, 1, 6
"d:\IDEWORK\lvmen\src\licensedcode\data\rules\agpl-3.0-plus_url_2.yml", "YAML", 0, 0, 0, 5, 0, 0, 1, 6
"d:\IDEWORK\lvmen\src\licensedcode\data\rules\agpl-3.0-plus_with_agpl-3.0-linking-exception_1.yml", "YAML", 0, 0, 0, 3, 0, 0, 1, 4
"d:\IDEWORK\lvmen\src\licensedcode\data\rules\agpl-3.0-plus_with_agpl-3.0-linking-exception_2.yml", "YAML", 0, 0, 0, 2, 0, 0, 1, 3
"d:\IDEWORK\lvmen\src\licensedcode\data\rules\agpl-3.0-plus_with_agpl-3.0-linking-exception_3.yml", "YAML", 0, 0, 0, 4, 0, 0, 1, 5
"d:\IDEWORK\lvmen\src\licensedcode\data\rules\agpl-3.0-plus_with_agpl-3.0-linking-exception_4.yml", "YAML", 0, 0, 0, 3, 0, 0, 1, 4
"d:\IDEWORK\lvmen\src\licensedcode\data\rules\agpl-3.0-plus_with_agpl-generic-additional-terms_1.yml", "YAML", 0, 0, 0, 5, 0, 0, 1, 6
"d:\IDEWORK\lvmen\src\licensedcode\data\rules\agpl-3.0-plus_with_agpl-generic-additional-terms_10.yml", "YAML", 0, 0, 0, 3, 0, 0, 1, 4
"d:\IDEWORK\lvmen\src\licensedcode\data\rules\agpl-3.0-plus_with_agpl-generic-additional-terms_11.yml", "YAML", 0, 0, 0, 5, 0, 0, 1, 6
"d:\IDEWORK\lvmen\src\licensedcode\data\rules\agpl-3.0-plus_with_agpl-generic-additional-terms_12.yml", "YAML", 0, 0, 0, 5, 0, 0, 1, 6
"d:\IDEWORK\lvmen\src\licensedcode\data\rules\agpl-3.0-plus_with_agpl-generic-additional-terms_13.yml", "YAML", 0, 0, 0, 3, 0, 0, 1, 4
"d:\IDEWORK\lvmen\src\licensedcode\data\rules\agpl-3.0-plus_with_agpl-generic-additional-terms_14.yml", "YAML", 0, 0, 0, 5, 0, 0, 1, 6
"d:\IDEWORK\lvmen\src\licensedcode\data\rules\agpl-3.0-plus_with_agpl-generic-additional-terms_15.yml", "YAML", 0, 0, 0, 3, 0, 0, 1, 4
"d:\IDEWORK\lvmen\src\licensedcode\data\rules\agpl-3.0-plus_with_agpl-generic-additional-terms_16.yml", "YAML", 0, 0, 0, 3, 0, 0, 1, 4
"d:\IDEWORK\lvmen\src\licensedcode\data\rules\agpl-3.0-plus_with_agpl-generic-additional-terms_17.yml", "YAML", 0, 0, 0, 3, 0, 0, 1, 4
"d:\IDEWORK\lvmen\src\licensedcode\data\rules\agpl-3.0-plus_with_agpl-generic-additional-terms_18.yml", "YAML", 0, 0, 0, 5, 0, 0, 1, 6
"d:\IDEWORK\lvmen\src\licensedcode\data\rules\agpl-3.0-plus_with_agpl-generic-additional-terms_19.yml", "YAML", 0, 0, 0, 5, 0, 0, 1, 6
"d:\IDEWORK\lvmen\src\licensedcode\data\rules\agpl-3.0-plus_with_agpl-generic-additional-terms_2.yml", "YAML", 0, 0, 0, 8, 0, 0, 1, 9
"d:\IDEWORK\lvmen\src\licensedcode\data\rules\agpl-3.0-plus_with_agpl-generic-additional-terms_20.yml", "YAML", 0, 0, 0, 5, 0, 0, 1, 6
"d:\IDEWORK\lvmen\src\licensedcode\data\rules\agpl-3.0-plus_with_agpl-generic-additional-terms_21.yml", "YAML", 0, 0, 0, 5, 0, 0, 1, 6
"d:\IDEWORK\lvmen\src\licensedcode\data\rules\agpl-3.0-plus_with_agpl-generic-additional-terms_22.yml", "YAML", 0, 0, 0, 5, 0, 0, 1, 6
"d:\IDEWORK\lvmen\src\licensedcode\data\rules\agpl-3.0-plus_with_agpl-generic-additional-terms_23.yml", "YAML", 0, 0, 0, 8, 0, 0, 1, 9
"d:\IDEWORK\lvmen\src\licensedcode\data\rules\agpl-3.0-plus_with_agpl-generic-additional-terms_24.yml", "YAML", 0, 0, 0, 5, 0, 0, 1, 6
"d:\IDEWORK\lvmen\src\licensedcode\data\rules\agpl-3.0-plus_with_agpl-generic-additional-terms_3.yml", "YAML", 0, 0, 0, 5, 0, 0, 1, 6
"d:\IDEWORK\lvmen\src\licensedcode\data\rules\agpl-3.0-plus_with_agpl-generic-additional-terms_4.yml", "YAML", 0, 0, 0, 5, 0, 0, 1, 6
"d:\IDEWORK\lvmen\src\licensedcode\data\rules\agpl-3.0-plus_with_agpl-generic-additional-terms_5.yml", "YAML", 0, 0, 0, 7, 0, 0, 1, 8
"d:\IDEWORK\lvmen\src\licensedcode\data\rules\agpl-3.0-plus_with_agpl-generic-additional-terms_6.yml", "YAML", 0, 0, 0, 7, 0, 0, 1, 8
"d:\IDEWORK\lvmen\src\licensedcode\data\rules\agpl-3.0-plus_with_agpl-generic-additional-terms_7.yml", "YAML", 0, 0, 0, 3, 0, 0, 1, 4
"d:\IDEWORK\lvmen\src\licensedcode\data\rules\agpl-3.0-plus_with_agpl-generic-additional-terms_8.yml", "YAML", 0, 0, 0, 3, 0, 0, 1, 4
"d:\IDEWORK\lvmen\src\licensedcode\data\rules\agpl-3.0-plus_with_agpl-generic-additional-terms_9.yml", "YAML", 0, 0, 0, 3, 0, 0, 1, 4
"d:\IDEWORK\lvmen\src\licensedcode\data\rules\agpl-3.0-plus_with_agpl-generic-additional-terms_and_lucre_1.yml", "YAML", 0, 0, 0, 6, 0, 0, 1, 7
"d:\IDEWORK\lvmen\src\licensedcode\data\rules\agpl-3.0-plus_with_agpl-generic-additional-terms_and_lucre_2.yml", "YAML", 0, 0, 0, 6, 0, 0, 1, 7
"d:\IDEWORK\lvmen\src\licensedcode\data\rules\agpl-3.0-plus_with_linking-exception-agpl-3.0_1.yml", "YAML", 0, 0, 0, 5, 0, 0, 1, 6
"d:\IDEWORK\lvmen\src\licensedcode\data\rules\agpl-3.0-plus_with_magpie-exception-1.0_1.yml", "YAML", 0, 0, 0, 5, 0, 0, 1, 6
"d:\IDEWORK\lvmen\src\licensedcode\data\rules\agpl-3.0-plus_with_openssl-exception-agpl-3.0_1.yml", "YAML", 0, 0, 0, 5, 0, 0, 1, 6
"d:\IDEWORK\lvmen\src\licensedcode\data\rules\agpl-3.0.SPDX.yml", "YAML", 0, 0, 0, 11, 0, 0, 1, 12
"d:\IDEWORK\lvmen\src\licensedcode\data\rules\agpl-3.0.yml", "YAML", 0, 0, 0, 2, 0, 0, 1, 3
"d:\IDEWORK\lvmen\src\licensedcode\data\rules\agpl-3.0_0.yml", "YAML", 0, 0, 0, 5, 0, 0, 1, 6
"d:\IDEWORK\lvmen\src\licensedcode\data\rules\agpl-3.0_01.yml", "YAML", 0, 0, 0, 3, 0, 0, 1, 4
"d:\IDEWORK\lvmen\src\licensedcode\data\rules\agpl-3.0_1.yml", "YAML", 0, 0, 0, 3, 0, 0, 1, 4
"d:\IDEWORK\lvmen\src\licensedcode\data\rules\agpl-3.0_10.yml", "YAML", 0, 0, 0, 3, 0, 0, 1, 4
"d:\IDEWORK\lvmen\src\licensedcode\data\rules\agpl-3.0_100.yml", "YAML", 0, 0, 0, 3, 0, 0, 1, 4
"d:\IDEWORK\lvmen\src\licensedcode\data\rules\agpl-3.0_101.yml", "YAML", 0, 0, 0, 12, 0, 0, 1, 13
"d:\IDEWORK\lvmen\src\licensedcode\data\rules\agpl-3.0_102.yml", "YAML", 0, 0, 0, 5, 0, 0, 1, 6
"d:\IDEWORK\lvmen\src\licensedcode\data\rules\agpl-3.0_103.yml", "YAML", 0, 0, 0, 3, 0, 0, 1, 4
"d:\IDEWORK\lvmen\src\licensedcode\data\rules\agpl-3.0_104.yml", "YAML", 0, 0, 0, 5, 0, 0, 1, 6
"d:\IDEWORK\lvmen\src\licensedcode\data\rules\agpl-3.0_105.yml", "YAML", 0, 0, 0, 5, 0, 0, 1, 6
"d:\IDEWORK\lvmen\src\licensedcode\data\rules\agpl-3.0_106.yml", "YAML", 0, 0, 0, 5, 0, 0, 1, 6
"d:\IDEWORK\lvmen\src\licensedcode\data\rules\agpl-3.0_107.yml", "YAML", 0, 0, 0, 5, 0, 0, 1, 6
"d:\IDEWORK\lvmen\src\licensedcode\data\rules\agpl-3.0_108.yml", "YAML", 0, 0, 0, 5, 0, 0, 1, 6
"d:\IDEWORK\lvmen\src\licensedcode\data\rules\agpl-3.0_109.yml", "YAML", 0, 0, 0, 5, 0, 0, 1, 6
"d:\IDEWORK\lvmen\src\licensedcode\data\rules\agpl-3.0_11.yml", "YAML", 0, 0, 0, 3, 0, 0, 1, 4
"d:\IDEWORK\lvmen\src\licensedcode\data\rules\agpl-3.0_110.yml", "YAML", 0, 0, 0, 5, 0, 0, 1, 6
"d:\IDEWORK\lvmen\src\licensedcode\data\rules\agpl-3.0_111.yml", "YAML", 0, 0, 0, 5, 0, 0, 1, 6
"d:\IDEWORK\lvmen\src\licensedcode\data\rules\agpl-3.0_112.yml", "YAML", 0, 0, 0, 5, 0, 0, 1, 6
"d:\IDEWORK\lvmen\src\licensedcode\data\rules\agpl-3.0_113.yml", "YAML", 0, 0, 0, 5, 0, 0, 1, 6
"d:\IDEWORK\lvmen\src\licensedcode\data\rules\agpl-3.0_114.yml", "YAML", 0, 0, 0, 5, 0, 0, 1, 6
"d:\IDEWORK\lvmen\src\licensedcode\data\rules\agpl-3.0_115.yml", "YAML", 0, 0, 0, 3, 0, 0, 1, 4
"d:\IDEWORK\lvmen\src\licensedcode\data\rules\agpl-3.0_116.yml", "YAML", 0, 0, 0, 3, 0, 0, 1, 4
"d:\IDEWORK\lvmen\src\licensedcode\data\rules\agpl-3.0_117.yml", "YAML", 0, 0, 0, 5, 0, 0, 1, 6
"d:\IDEWORK\lvmen\src\licensedcode\data\rules\agpl-3.0_118.yml", "YAML", 0, 0, 0, 3, 0, 0, 1, 4
"d:\IDEWORK\lvmen\src\licensedcode\data\rules\agpl-3.0_119.yml", "YAML", 0, 0, 0, 3, 0, 0, 1, 4
"d:\IDEWORK\lvmen\src\licensedcode\data\rules\agpl-3.0_12.yml", "YAML", 0, 0, 0, 5, 0, 0, 1, 6
"d:\IDEWORK\lvmen\src\licensedcode\data\rules\agpl-3.0_120.yml", "YAML", 0, 0, 0, 3, 0, 0, 1, 4
"d:\IDEWORK\lvmen\src\licensedcode\data\rules\agpl-3.0_121.yml", "YAML", 0, 0, 0, 3, 0, 0, 1, 4
"d:\IDEWORK\lvmen\src\licensedcode\data\rules\agpl-3.0_122.yml", "YAML", 0, 0, 0, 3, 0, 0, 1, 4
"d:\IDEWORK\lvmen\src\licensedcode\data\rules\agpl-3.0_123.yml", "YAML", 0, 0, 0, 3, 0, 0, 1, 4
"d:\IDEWORK\lvmen\src\licensedcode\data\rules\agpl-3.0_124.yml", "YAML", 0, 0, 0, 3, 0, 0, 1, 4
"d:\IDEWORK\lvmen\src\licensedcode\data\rules\agpl-3.0_125.yml", "YAML", 0, 0, 0, 3, 0, 0, 1, 4
"d:\IDEWORK\lvmen\src\licensedcode\data\rules\agpl-3.0_126.yml", "YAML", 0, 0, 0, 5, 0, 0, 1, 6
"d:\IDEWORK\lvmen\src\licensedcode\data\rules\agpl-3.0_127.yml", "YAML", 0, 0, 0, 3, 0, 0, 1, 4
"d:\IDEWORK\lvmen\src\licensedcode\data\rules\agpl-3.0_128.yml", "YAML", 0, 0, 0, 3, 0, 0, 1, 4
"d:\IDEWORK\lvmen\src\licensedcode\data\rules\agpl-3.0_129.yml", "YAML", 0, 0, 0, 3, 0, 0, 1, 4
"d:\IDEWORK\lvmen\src\licensedcode\data\rules\agpl-3.0_13.yml", "YAML", 0, 0, 0, 3, 0, 0, 1, 4
"d:\IDEWORK\lvmen\src\licensedcode\data\rules\agpl-3.0_130.yml", "YAML", 0, 0, 0, 3, 0, 0, 1, 4
"d:\IDEWORK\lvmen\src\licensedcode\data\rules\agpl-3.0_131.yml", "YAML", 0, 0, 0, 3, 0, 0, 1, 4
"d:\IDEWORK\lvmen\src\licensedcode\data\rules\agpl-3.0_132.yml", "YAML", 0, 0, 0, 3, 0, 0, 1, 4
"d:\IDEWORK\lvmen\src\licensedcode\data\rules\agpl-3.0_133.yml", "YAML", 0, 0, 0, 5, 0, 0, 1, 6
"d:\IDEWORK\lvmen\src\licensedcode\data\rules\agpl-3.0_134.yml", "YAML", 0, 0, 0, 3, 0, 0, 1, 4
"d:\IDEWORK\lvmen\src\licensedcode\data\rules\agpl-3.0_135.yml", "YAML", 0, 0, 0, 3, 0, 0, 1, 4
"d:\IDEWORK\lvmen\src\licensedcode\data\rules\agpl-3.0_136.yml", "YAML", 0, 0, 0, 3, 0, 0, 1, 4
"d:\IDEWORK\lvmen\src\licensedcode\data\rules\agpl-3.0_137.yml", "YAML", 0, 0, 0, 3, 0, 0, 1, 4
"d:\IDEWORK\lvmen\src\licensedcode\data\rules\agpl-3.0_138.yml", "YAML", 0, 0, 0, 3, 0, 0, 1, 4
"d:\IDEWORK\lvmen\src\licensedcode\data\rules\agpl-3.0_139.yml", "YAML", 0, 0, 0, 3, 0, 0, 1, 4
"d:\IDEWORK\lvmen\src\licensedcode\data\rules\agpl-3.0_14.yml", "YAML", 0, 0, 0, 3, 0, 0, 1, 4
"d:\IDEWORK\lvmen\src\licensedcode\data\rules\agpl-3.0_140.yml", "YAML", 0, 0, 0, 3, 0, 0, 1, 4
"d:\IDEWORK\lvmen\src\licensedcode\data\rules\agpl-3.0_141.yml", "YAML", 0, 0, 0, 3, 0, 0, 1, 4
"d:\IDEWORK\lvmen\src\licensedcode\data\rules\agpl-3.0_142.yml", "YAML", 0, 0, 0, 3, 0, 0, 1, 4
"d:\IDEWORK\lvmen\src\licensedcode\data\rules\agpl-3.0_143.yml", "YAML", 0, 0, 0, 3, 0, 0, 1, 4
"d:\IDEWORK\lvmen\src\licensedcode\data\rules\agpl-3.0_144.yml", "YAML", 0, 0, 0, 3, 0, 0, 1, 4
"d:\IDEWORK\lvmen\src\licensedcode\data\rules\agpl-3.0_145.yml", "YAML", 0, 0, 0, 3, 0, 0, 1, 4
"d:\IDEWORK\lvmen\src\licensedcode\data\rules\agpl-3.0_146.yml", "YAML", 0, 0, 0, 3, 0, 0, 1, 4
"d:\IDEWORK\lvmen\src\licensedcode\data\rules\agpl-3.0_147.yml", "YAML", 0, 0, 0, 3, 0, 0, 1, 4
"d:\IDEWORK\lvmen\src\licensedcode\data\rules\agpl-3.0_148.yml", "YAML", 0, 0, 0, 3, 0, 0, 1, 4
"d:\IDEWORK\lvmen\src\licensedcode\data\rules\agpl-3.0_149.yml", "YAML", 0, 0, 0, 10, 0, 0, 1, 11
"d:\IDEWORK\lvmen\src\licensedcode\data\rules\agpl-3.0_15.yml", "YAML", 0, 0, 0, 3, 0, 0, 1, 4
"d:\IDEWORK\lvmen\src\licensedcode\data\rules\agpl-3.0_150.yml", "YAML", 0, 0, 0, 11, 0, 0, 1, 12
"d:\IDEWORK\lvmen\src\licensedcode\data\rules\agpl-3.0_151.yml", "YAML", 0, 0, 0, 3, 0, 0, 1, 4
"d:\IDEWORK\lvmen\src\licensedcode\data\rules\agpl-3.0_152.yml", "YAML", 0, 0, 0, 3, 0, 0, 1, 4
"d:\IDEWORK\lvmen\src\licensedcode\data\rules\agpl-3.0_153.yml", "YAML", 0, 0, 0, 3, 0, 0, 1, 4
"d:\IDEWORK\lvmen\src\licensedcode\data\rules\agpl-3.0_154.yml", "YAML", 0, 0, 0, 3, 0, 0, 1, 4
"d:\IDEWORK\lvmen\src\licensedcode\data\rules\agpl-3.0_155.yml", "YAML", 0, 0, 0, 3, 0, 0, 1, 4
"d:\IDEWORK\lvmen\src\licensedcode\data\rules\agpl-3.0_156.yml", "YAML", 0, 0, 0, 10, 0, 0, 1, 11
"d:\IDEWORK\lvmen\src\licensedcode\data\rules\agpl-3.0_157.yml", "YAML", 0, 0, 0, 10, 0, 0, 1, 11
"d:\IDEWORK\lvmen\src\licensedcode\data\rules\agpl-3.0_158.yml", "YAML", 0, 0, 0, 10, 0, 0, 1, 11
"d:\IDEWORK\lvmen\src\licensedcode\data\rules\agpl-3.0_159.yml", "YAML", 0, 0, 0, 10, 0, 0, 1, 11
"d:\IDEWORK\lvmen\src\licensedcode\data\rules\agpl-3.0_16.yml", "YAML", 0, 0, 0, 5, 0, 0, 1, 6
"d:\IDEWORK\lvmen\src\licensedcode\data\rules\agpl-3.0_160.yml", "YAML", 0, 0, 0, 10, 0, 0, 1, 11
"d:\IDEWORK\lvmen\src\licensedcode\data\rules\agpl-3.0_161.yml", "YAML", 0, 0, 0, 3, 0, 0, 1, 4
"d:\IDEWORK\lvmen\src\licensedcode\data\rules\agpl-3.0_162.yml", "YAML", 0, 0, 0, 7, 0, 0, 1, 8
"d:\IDEWORK\lvmen\src\licensedcode\data\rules\agpl-3.0_163.yml", "YAML", 0, 0, 0, 3, 0, 0, 1, 4
"d:\IDEWORK\lvmen\src\licensedcode\data\rules\agpl-3.0_164.yml", "YAML", 0, 0, 0, 5, 0, 0, 1, 6
"d:\IDEWORK\lvmen\src\licensedcode\data\rules\agpl-3.0_165.yml", "YAML", 0, 0, 0, 7, 0, 0, 1, 8
"d:\IDEWORK\lvmen\src\licensedcode\data\rules\agpl-3.0_166.yml", "YAML", 0, 0, 0, 3, 0, 0, 1, 4
"d:\IDEWORK\lvmen\src\licensedcode\data\rules\agpl-3.0_167.yml", "YAML", 0, 0, 0, 3, 0, 0, 1, 4
"d:\IDEWORK\lvmen\src\licensedcode\data\rules\agpl-3.0_168.yml", "YAML", 0, 0, 0, 5, 0, 0, 1, 6
"d:\IDEWORK\lvmen\src\licensedcode\data\rules\agpl-3.0_169.yml", "YAML", 0, 0, 0, 5, 0, 0, 1, 6
"d:\IDEWORK\lvmen\src\licensedcode\data\rules\agpl-3.0_17.yml", "YAML", 0, 0, 0, 5, 0, 0, 1, 6
"d:\IDEWORK\lvmen\src\licensedcode\data\rules\agpl-3.0_170.yml", "YAML", 0, 0, 0, 3, 0, 0, 1, 4
"d:\IDEWORK\lvmen\src\licensedcode\data\rules\agpl-3.0_171.yml", "YAML", 0, 0, 0, 3, 0, 0, 1, 4
"d:\IDEWORK\lvmen\src\licensedcode\data\rules\agpl-3.0_172.yml", "YAML", 0, 0, 0, 3, 0, 0, 1, 4
"d:\IDEWORK\lvmen\src\licensedcode\data\rules\agpl-3.0_173.yml", "YAML", 0, 0, 0, 3, 0, 0, 1, 4
"d:\IDEWORK\lvmen\src\licensedcode\data\rules\agpl-3.0_174.yml", "YAML", 0, 0, 0, 3, 0, 0, 1, 4
"d:\IDEWORK\lvmen\src\licensedcode\data\rules\agpl-3.0_175.yml", "YAML", 0, 0, 0, 5, 0, 0, 1, 6
"d:\IDEWORK\lvmen\src\licensedcode\data\rules\agpl-3.0_176.yml", "YAML", 0, 0, 0, 3, 0, 0, 1, 4
"d:\IDEWORK\lvmen\src\licensedcode\data\rules\agpl-3.0_177.yml", "YAML", 0, 0, 0, 3, 0, 0, 1, 4
"d:\IDEWORK\lvmen\src\licensedcode\data\rules\agpl-3.0_178.yml", "YAML", 0, 0, 0, 3, 0, 0, 1, 4
"d:\IDEWORK\lvmen\src\licensedcode\data\rules\agpl-3.0_179.yml", "YAML", 0, 0, 0, 5, 0, 0, 1, 6
"d:\IDEWORK\lvmen\src\licensedcode\data\rules\agpl-3.0_18.yml", "YAML", 0, 0, 0, 5, 0, 0, 1, 6
"d:\IDEWORK\lvmen\src\licensedcode\data\rules\agpl-3.0_180.yml", "YAML", 0, 0, 0, 3, 0, 0, 1, 4
"d:\IDEWORK\lvmen\src\licensedcode\data\rules\agpl-3.0_181.yml", "YAML", 0, 0, 0, 5, 0, 0, 1, 6
"d:\IDEWORK\lvmen\src\licensedcode\data\rules\agpl-3.0_182.yml", "YAML", 0, 0, 0, 3, 0, 0, 1, 4
"d:\IDEWORK\lvmen\src\licensedcode\data\rules\agpl-3.0_183.yml", "YAML", 0, 0, 0, 3, 0, 0, 1, 4
"d:\IDEWORK\lvmen\src\licensedcode\data\rules\agpl-3.0_184.yml", "YAML", 0, 0, 0, 5, 0, 0, 1, 6
"d:\IDEWORK\lvmen\src\licensedcode\data\rules\agpl-3.0_185.yml", "YAML", 0, 0, 0, 5, 0, 0, 1, 6
"d:\IDEWORK\lvmen\src\licensedcode\data\rules\agpl-3.0_186.yml", "YAML", 0, 0, 0, 5, 0, 0, 1, 6
"d:\IDEWORK\lvmen\src\licensedcode\data\rules\agpl-3.0_187.yml", "YAML", 0, 0, 0, 5, 0, 0, 1, 6
"d:\IDEWORK\lvmen\src\licensedcode\data\rules\agpl-3.0_188.yml", "YAML", 0, 0, 0, 5, 0, 0, 1, 6
"d:\IDEWORK\lvmen\src\licensedcode\data\rules\agpl-3.0_189.yml", "YAML", 0, 0, 0, 6, 0, 0, 1, 7
"d:\IDEWORK\lvmen\src\licensedcode\data\rules\agpl-3.0_19.yml", "YAML", 0, 0, 0, 3, 0, 0, 1, 4
"d:\IDEWORK\lvmen\src\licensedcode\data\rules\agpl-3.0_190.yml", "YAML", 0, 0, 0, 5, 0, 0, 1, 6
"d:\IDEWORK\lvmen\src\licensedcode\data\rules\agpl-3.0_191.yml", "YAML", 0, 0, 0, 3, 0, 0, 1, 4
"d:\IDEWORK\lvmen\src\licensedcode\data\rules\agpl-3.0_192.yml", "YAML", 0, 0, 0, 5, 0, 0, 1, 6
"d:\IDEWORK\lvmen\src\licensedcode\data\rules\agpl-3.0_193.yml", "YAML", 0, 0, 0, 5, 0, 0, 1, 6
"d:\IDEWORK\lvmen\src\licensedcode\data\rules\agpl-3.0_194.yml", "YAML", 0, 0, 0, 5, 0, 0, 1, 6
"d:\IDEWORK\lvmen\src\licensedcode\data\rules\agpl-3.0_195.yml", "YAML", 0, 0, 0, 3, 0, 0, 1, 4
"d:\IDEWORK\lvmen\src\licensedcode\data\rules\agpl-3.0_196.yml", "YAML", 0, 0, 0, 5, 0, 0, 1, 6
"d:\IDEWORK\lvmen\src\licensedcode\data\rules\agpl-3.0_197.yml", "YAML", 0, 0, 0, 5, 0, 0, 1, 6
"d:\IDEWORK\lvmen\src\licensedcode\data\rules\agpl-3.0_198.yml", "YAML", 0, 0, 0, 3, 0, 0, 1, 4
"d:\IDEWORK\lvmen\src\licensedcode\data\rules\agpl-3.0_199.yml", "YAML", 0, 0, 0, 3, 0, 0, 1, 4
"d:\IDEWORK\lvmen\src\licensedcode\data\rules\agpl-3.0_2.yml", "YAML", 0, 0, 0, 5, 0, 0, 1, 6
"d:\IDEWORK\lvmen\src\licensedcode\data\rules\agpl-3.0_20.yml", "YAML", 0, 0, 0, 3, 0, 0, 1, 4
"d:\IDEWORK\lvmen\src\licensedcode\data\rules\agpl-3.0_200.yml", "YAML", 0, 0, 0, 3, 0, 0, 1, 4
"d:\IDEWORK\lvmen\src\licensedcode\data\rules\agpl-3.0_201.yml", "YAML", 0, 0, 0, 3, 0, 0, 1, 4
"d:\IDEWORK\lvmen\src\licensedcode\data\rules\agpl-3.0_202.yml", "YAML", 0, 0, 0, 3, 0, 0, 1, 4
"d:\IDEWORK\lvmen\src\licensedcode\data\rules\agpl-3.0_203.yml", "YAML", 0, 0, 0, 3, 0, 0, 1, 4
"d:\IDEWORK\lvmen\src\licensedcode\data\rules\agpl-3.0_204.yml", "YAML", 0, 0, 0, 3, 0, 0, 1, 4
"d:\IDEWORK\lvmen\src\licensedcode\data\rules\agpl-3.0_205.yml", "YAML", 0, 0, 0, 6, 0, 0, 1, 7
"d:\IDEWORK\lvmen\src\licensedcode\data\rules\agpl-3.0_206.yml", "YAML", 0, 0, 0, 3, 0, 0, 1, 4
"d:\IDEWORK\lvmen\src\licensedcode\data\rules\agpl-3.0_207.yml", "YAML", 0, 0, 0, 3, 0, 0, 1, 4
"d:\IDEWORK\lvmen\src\licensedcode\data\rules\agpl-3.0_208.yml", "YAML", 0, 0, 0, 6, 0, 0, 1, 7
"d:\IDEWORK\lvmen\src\licensedcode\data\rules\agpl-3.0_209.yml", "YAML", 0, 0, 0, 6, 0, 0, 1, 7
"d:\IDEWORK\lvmen\src\licensedcode\data\rules\agpl-3.0_21.yml", "YAML", 0, 0, 0, 3, 0, 0, 1, 4
"d:\IDEWORK\lvmen\src\licensedcode\data\rules\agpl-3.0_210.yml", "YAML", 0, 0, 0, 6, 0, 0, 1, 7
"d:\IDEWORK\lvmen\src\licensedcode\data\rules\agpl-3.0_211.yml", "YAML", 0, 0, 0, 3, 0, 0, 1, 4
"d:\IDEWORK\lvmen\src\licensedcode\data\rules\agpl-3.0_212.yml", "YAML", 0, 0, 0, 3, 0, 0, 1, 4
"d:\IDEWORK\lvmen\src\licensedcode\data\rules\agpl-3.0_213.yml", "YAML", 0, 0, 0, 6, 0, 0, 1, 7
"d:\IDEWORK\lvmen\src\licensedcode\data\rules\agpl-3.0_214.yml", "YAML", 0, 0, 0, 5, 0, 0, 1, 6
"d:\IDEWORK\lvmen\src\licensedcode\data\rules\agpl-3.0_215.yml", "YAML", 0, 0, 0, 3, 0, 0, 1, 4
"d:\IDEWORK\lvmen\src\licensedcode\data\rules\agpl-3.0_216.yml", "YAML", 0, 0, 0, 3, 0, 0, 1, 4
"d:\IDEWORK\lvmen\src\licensedcode\data\rules\agpl-3.0_217.yml", "YAML", 0, 0, 0, 3, 0, 0, 1, 4
"d:\IDEWORK\lvmen\src\licensedcode\data\rules\agpl-3.0_218.yml", "YAML", 0, 0, 0, 3, 0, 0, 1, 4
"d:\IDEWORK\lvmen\src\licensedcode\data\rules\agpl-3.0_219.yml", "YAML", 0, 0, 0, 3, 0, 0, 1, 4
"d:\IDEWORK\lvmen\src\licensedcode\data\rules\agpl-3.0_22.yml", "YAML", 0, 0, 0, 3, 0, 0, 1, 4
"d:\IDEWORK\lvmen\src\licensedcode\data\rules\agpl-3.0_220.yml", "YAML", 0, 0, 0, 5, 0, 0, 1, 6
"d:\IDEWORK\lvmen\src\licensedcode\data\rules\agpl-3.0_221.yml", "YAML", 0, 0, 0, 3, 0, 0, 1, 4
"d:\IDEWORK\lvmen\src\licensedcode\data\rules\agpl-3.0_222.yml", "YAML", 0, 0, 0, 3, 0, 0, 1, 4
"d:\IDEWORK\lvmen\src\licensedcode\data\rules\agpl-3.0_223.yml", "YAML", 0, 0, 0, 3, 0, 0, 1, 4
"d:\IDEWORK\lvmen\src\licensedcode\data\rules\agpl-3.0_224.yml", "YAML", 0, 0, 0, 6, 0, 0, 1, 7
"d:\IDEWORK\lvmen\src\licensedcode\data\rules\agpl-3.0_225.yml", "YAML", 0, 0, 0, 3, 0, 0, 1, 4
"d:\IDEWORK\lvmen\src\licensedcode\data\rules\agpl-3.0_226.yml", "YAML", 0, 0, 0, 5, 0, 0, 1, 6
"d:\IDEWORK\lvmen\src\licensedcode\data\rules\agpl-3.0_227.yml", "YAML", 0, 0, 0, 3, 0, 0, 1, 4
"d:\IDEWORK\lvmen\src\licensedcode\data\rules\agpl-3.0_228.yml", "YAML", 0, 0, 0, 6, 0, 0, 1, 7
"d:\IDEWORK\lvmen\src\licensedcode\data\rules\agpl-3.0_229.yml", "YAML", 0, 0, 0, 5, 0, 0, 1, 6
"d:\IDEWORK\lvmen\src\licensedcode\data\rules\agpl-3.0_23.yml", "YAML", 0, 0, 0, 3, 0, 0, 1, 4
"d:\IDEWORK\lvmen\src\licensedcode\data\rules\agpl-3.0_230.yml", "YAML", 0, 0, 0, 3, 0, 0, 1, 4
"d:\IDEWORK\lvmen\src\licensedcode\data\rules\agpl-3.0_231.yml", "YAML", 0, 0, 0, 3, 0, 0, 1, 4
"d:\IDEWORK\lvmen\src\licensedcode\data\rules\agpl-3.0_232.yml", "YAML", 0, 0, 0, 5, 0, 0, 1, 6
"d:\IDEWORK\lvmen\src\licensedcode\data\rules\agpl-3.0_233.yml", "YAML", 0, 0, 0, 5, 0, 0, 1, 6
"d:\IDEWORK\lvmen\src\licensedcode\data\rules\agpl-3.0_234.yml", "YAML", 0, 0, 0, 5, 0, 0, 1, 6
"d:\IDEWORK\lvmen\src\licensedcode\data\rules\agpl-3.0_235.yml", "YAML", 0, 0, 0, 5, 0, 0, 1, 6
"d:\IDEWORK\lvmen\src\licensedcode\data\rules\agpl-3.0_236.yml", "YAML", 0, 0, 0, 5, 0, 0, 1, 6
"d:\IDEWORK\lvmen\src\licensedcode\data\rules\agpl-3.0_237.yml", "YAML", 0, 0, 0, 5, 0, 0, 1, 6
"d:\IDEWORK\lvmen\src\licensedcode\data\rules\agpl-3.0_238.yml", "YAML", 0, 0, 0, 3, 0, 0, 1, 4
"d:\IDEWORK\lvmen\src\licensedcode\data\rules\agpl-3.0_239.yml", "YAML", 0, 0, 0, 5, 0, 0, 1, 6
"d:\IDEWORK\lvmen\src\licensedcode\data\rules\agpl-3.0_24.yml", "YAML", 0, 0, 0, 3, 0, 0, 1, 4
"d:\IDEWORK\lvmen\src\licensedcode\data\rules\agpl-3.0_240.yml", "YAML", 0, 0, 0, 3, 0, 0, 1, 4
"d:\IDEWORK\lvmen\src\licensedcode\data\rules\agpl-3.0_241.yml", "YAML", 0, 0, 0, 5, 0, 0, 1, 6
"d:\IDEWORK\lvmen\src\licensedcode\data\rules\agpl-3.0_242.yml", "YAML", 0, 0, 0, 3, 0, 0, 1, 4
"d:\IDEWORK\lvmen\src\licensedcode\data\rules\agpl-3.0_243.yml", "YAML", 0, 0, 0, 5, 0, 0, 1, 6
"d:\IDEWORK\lvmen\src\licensedcode\data\rules\agpl-3.0_244.yml", "YAML", 0, 0, 0, 4, 0, 0, 1, 5
"d:\IDEWORK\lvmen\src\licensedcode\data\rules\agpl-3.0_245.yml", "YAML", 0, 0, 0, 4, 0, 0, 1, 5
"d:\IDEWORK\lvmen\src\licensedcode\data\rules\agpl-3.0_246.yml", "YAML", 0, 0, 0, 4, 0, 0, 1, 5
"d:\IDEWORK\lvmen\src\licensedcode\data\rules\agpl-3.0_247.yml", "YAML", 0, 0, 0, 4, 0, 0, 1, 5
"d:\IDEWORK\lvmen\src\licensedcode\data\rules\agpl-3.0_248.yml", "YAML", 0, 0, 0, 4, 0, 0, 1, 5
"d:\IDEWORK\lvmen\src\licensedcode\data\rules\agpl-3.0_249.yml", "YAML", 0, 0, 0, 4, 0, 0, 1, 5
"d:\IDEWORK\lvmen\src\licensedcode\data\rules\agpl-3.0_25.yml", "YAML", 0, 0, 0, 3, 0, 0, 1, 4
"d:\IDEWORK\lvmen\src\licensedcode\data\rules\agpl-3.0_250.yml", "YAML", 0, 0, 0, 4, 0, 0, 1, 5
"d:\IDEWORK\lvmen\src\licensedcode\data\rules\agpl-3.0_251.yml", "YAML", 0, 0, 0, 4, 0, 0, 1, 5
"d:\IDEWORK\lvmen\src\licensedcode\data\rules\agpl-3.0_252.yml", "YAML", 0, 0, 0, 4, 0, 0, 1, 5
"d:\IDEWORK\lvmen\src\licensedcode\data\rules\agpl-3.0_253.yml", "YAML", 0, 0, 0, 3, 0, 0, 1, 4
"d:\IDEWORK\lvmen\src\licensedcode\data\rules\agpl-3.0_254.yml", "YAML", 0, 0, 0, 4, 0, 0, 1, 5
"d:\IDEWORK\lvmen\src\licensedcode\data\rules\agpl-3.0_255.yml", "YAML", 0, 0, 0, 4, 0, 0, 1, 5
"d:\IDEWORK\lvmen\src\licensedcode\data\rules\agpl-3.0_256.yml", "YAML", 0, 0, 0, 3, 0, 0, 1, 4
"d:\IDEWORK\lvmen\src\licensedcode\data\rules\agpl-3.0_257.yml", "YAML", 0, 0, 0, 5, 0, 0, 1, 6
"d:\IDEWORK\lvmen\src\licensedcode\data\rules\agpl-3.0_258.yml", "YAML", 0, 0, 0, 5, 0, 0, 1, 6
"d:\IDEWORK\lvmen\src\licensedcode\data\rules\agpl-3.0_259.yml", "YAML", 0, 0, 0, 3, 0, 0, 1, 4
"d:\IDEWORK\lvmen\src\licensedcode\data\rules\agpl-3.0_26.yml", "YAML", 0, 0, 0, 3, 0, 0, 1, 4
"d:\IDEWORK\lvmen\src\licensedcode\data\rules\agpl-3.0_260.yml", "YAML", 0, 0, 0, 3, 0, 0, 1, 4
"d:\IDEWORK\lvmen\src\licensedcode\data\rules\agpl-3.0_261.yml", "YAML", 0, 0, 0, 5, 0, 0, 1, 6
"d:\IDEWORK\lvmen\src\licensedcode\data\rules\agpl-3.0_262.yml", "YAML", 0, 0, 0, 3, 0, 0, 1, 4
"d:\IDEWORK\lvmen\src\licensedcode\data\rules\agpl-3.0_263.yml", "YAML", 0, 0, 0, 3, 0, 0, 1, 4
"d:\IDEWORK\lvmen\src\licensedcode\data\rules\agpl-3.0_264.yml", "YAML", 0, 0, 0, 3, 0, 0, 1, 4
"d:\IDEWORK\lvmen\src\licensedcode\data\rules\agpl-3.0_265.yml", "YAML", 0, 0, 0, 3, 0, 0, 1, 4
"d:\IDEWORK\lvmen\src\licensedcode\data\rules\agpl-3.0_266.yml", "YAML", 0, 0, 0, 3, 0, 0, 1, 4
"d:\IDEWORK\lvmen\src\licensedcode\data\rules\agpl-3.0_267.yml", "YAML", 0, 0, 0, 3, 0, 0, 1, 4
"d:\IDEWORK\lvmen\src\licensedcode\data\rules\agpl-3.0_268.yml", "YAML", 0, 0, 0, 3, 0, 0, 1, 4
"d:\IDEWORK\lvmen\src\licensedcode\data\rules\agpl-3.0_269.yml", "YAML", 0, 0, 0, 3, 0, 0, 1, 4
"d:\IDEWORK\lvmen\src\licensedcode\data\rules\agpl-3.0_27.yml", "YAML", 0, 0, 0, 9, 0, 0, 1, 10
"d:\IDEWORK\lvmen\src\licensedcode\data\rules\agpl-3.0_270.yml", "YAML", 0, 0, 0, 5, 0, 0, 1, 6
"d:\IDEWORK\lvmen\src\licensedcode\data\rules\agpl-3.0_271.yml", "YAML", 0, 0, 0, 5, 0, 0, 1, 6
"d:\IDEWORK\lvmen\src\licensedcode\data\rules\agpl-3.0_272.yml", "YAML", 0, 0, 0, 5, 0, 0, 1, 6
"d:\IDEWORK\lvmen\src\licensedcode\data\rules\agpl-3.0_273.yml", "YAML", 0, 0, 0, 5, 0, 0, 1, 6
"d:\IDEWORK\lvmen\src\licensedcode\data\rules\agpl-3.0_274.yml", "YAML", 0, 0, 0, 3, 0, 0, 1, 4
"d:\IDEWORK\lvmen\src\licensedcode\data\rules\agpl-3.0_275.yml", "YAML", 0, 0, 0, 3, 0, 0, 1, 4
"d:\IDEWORK\lvmen\src\licensedcode\data\rules\agpl-3.0_276.yml", "YAML", 0, 0, 0, 5, 0, 0, 1, 6
"d:\IDEWORK\lvmen\src\licensedcode\data\rules\agpl-3.0_277.yml", "YAML", 0, 0, 0, 3, 0, 0, 1, 4
"d:\IDEWORK\lvmen\src\licensedcode\data\rules\agpl-3.0_278.yml", "YAML", 0, 0, 0, 3, 0, 0, 1, 4
"d:\IDEWORK\lvmen\src\licensedcode\data\rules\agpl-3.0_279.yml", "YAML", 0, 0, 0, 11, 0, 0, 1, 12
"d:\IDEWORK\lvmen\src\licensedcode\data\rules\agpl-3.0_28.yml", "YAML", 0, 0, 0, 5, 0, 0, 1, 6
"d:\IDEWORK\lvmen\src\licensedcode\data\rules\agpl-3.0_280.yml", "YAML", 0, 0, 0, 3, 0, 0, 1, 4
"d:\IDEWORK\lvmen\src\licensedcode\data\rules\agpl-3.0_281.yml", "YAML", 0, 0, 0, 3, 0, 0, 1, 4
"d:\IDEWORK\lvmen\src\licensedcode\data\rules\agpl-3.0_282.yml", "YAML", 0, 0, 0, 3, 0, 0, 1, 4
"d:\IDEWORK\lvmen\src\licensedcode\data\rules\agpl-3.0_283.yml", "YAML", 0, 0, 0, 5, 0, 0, 1, 6
"d:\IDEWORK\lvmen\src\licensedcode\data\rules\agpl-3.0_284.yml", "YAML", 0, 0, 0, 5, 0, 0, 1, 6
"d:\IDEWORK\lvmen\src\licensedcode\data\rules\agpl-3.0_285.yml", "YAML", 0, 0, 0, 3, 0, 0, 1, 4
"d:\IDEWORK\lvmen\src\licensedcode\data\rules\agpl-3.0_286.yml", "YAML", 0, 0, 0, 3, 0, 0, 1, 4
"d:\IDEWORK\lvmen\src\licensedcode\data\rules\agpl-3.0_287.yml", "YAML", 0, 0, 0, 3, 0, 0, 1, 4
"d:\IDEWORK\lvmen\src\licensedcode\data\rules\agpl-3.0_288.yml", "YAML", 0, 0, 0, 3, 0, 0, 1, 4
"d:\IDEWORK\lvmen\src\licensedcode\data\rules\agpl-3.0_289.yml", "YAML", 0, 0, 0, 3, 0, 0, 1, 4
"d:\IDEWORK\lvmen\src\licensedcode\data\rules\agpl-3.0_29.yml", "YAML", 0, 0, 0, 4, 0, 0, 1, 5
"d:\IDEWORK\lvmen\src\licensedcode\data\rules\agpl-3.0_290.yml", "YAML", 0, 0, 0, 3, 0, 0, 1, 4
"d:\IDEWORK\lvmen\src\licensedcode\data\rules\agpl-3.0_291.yml", "YAML", 0, 0, 0, 3, 0, 0, 1, 4
"d:\IDEWORK\lvmen\src\licensedcode\data\rules\agpl-3.0_292.yml", "YAML", 0, 0, 0, 3, 0, 0, 1, 4
"d:\IDEWORK\lvmen\src\licensedcode\data\rules\agpl-3.0_293.yml", "YAML", 0, 0, 0, 3, 0, 0, 1, 4
"d:\IDEWORK\lvmen\src\licensedcode\data\rules\agpl-3.0_294.yml", "YAML", 0, 0, 0, 3, 0, 0, 1, 4
"d:\IDEWORK\lvmen\src\licensedcode\data\rules\agpl-3.0_295.yml", "YAML", 0, 0, 0, 7, 0, 0, 1, 8
"d:\IDEWORK\lvmen\src\licensedcode\data\rules\agpl-3.0_296.yml", "YAML", 0, 0, 0, 4, 0, 0, 1, 5
"d:\IDEWORK\lvmen\src\licensedcode\data\rules\agpl-3.0_297.yml", "YAML", 0, 0, 0, 4, 0, 0, 1, 5
"d:\IDEWORK\lvmen\src\licensedcode\data\rules\agpl-3.0_298.yml", "YAML", 0, 0, 0, 3, 0, 0, 1, 4
"d:\IDEWORK\lvmen\src\licensedcode\data\rules\agpl-3.0_299.yml", "YAML", 0, 0, 0, 3, 0, 0, 1, 4
"d:\IDEWORK\lvmen\src\licensedcode\data\rules\agpl-3.0_3.yml", "YAML", 0, 0, 0, 6, 0, 0, 1, 7
"d:\IDEWORK\lvmen\src\licensedcode\data\rules\agpl-3.0_30.yml", "YAML", 0, 0, 0, 4, 0, 0, 1, 5
"d:\IDEWORK\lvmen\src\licensedcode\data\rules\agpl-3.0_300.yml", "YAML", 0, 0, 0, 3, 0, 0, 1, 4
"d:\IDEWORK\lvmen\src\licensedcode\data\rules\agpl-3.0_301.yml", "YAML", 0, 0, 0, 6, 0, 0, 2, 8
"d:\IDEWORK\lvmen\src\licensedcode\data\rules\agpl-3.0_302.yml", "YAML", 0, 0, 0, 3, 0, 0, 1, 4
"d:\IDEWORK\lvmen\src\licensedcode\data\rules\agpl-3.0_303.yml", "YAML", 0, 0, 0, 3, 0, 0, 1, 4
"d:\IDEWORK\lvmen\src\licensedcode\data\rules\agpl-3.0_304.yml", "YAML", 0, 0, 0, 3, 0, 0, 1, 4
"d:\IDEWORK\lvmen\src\licensedcode\data\rules\agpl-3.0_305.yml", "YAML", 0, 0, 0, 5, 0, 0, 1, 6
"d:\IDEWORK\lvmen\src\licensedcode\data\rules\agpl-3.0_306.yml", "YAML", 0, 0, 0, 3, 0, 0, 1, 4
"d:\IDEWORK\lvmen\src\licensedcode\data\rules\agpl-3.0_307.yml", "YAML", 0, 0, 0, 3, 0, 0, 1, 4
"d:\IDEWORK\lvmen\src\licensedcode\data\rules\agpl-3.0_308.yml", "YAML", 0, 0, 0, 3, 0, 0, 1, 4
"d:\IDEWORK\lvmen\src\licensedcode\data\rules\agpl-3.0_309.yml", "YAML", 0, 0, 0, 3, 0, 0, 1, 4
"d:\IDEWORK\lvmen\src\licensedcode\data\rules\agpl-3.0_31.yml", "YAML", 0, 0, 0, 3, 0, 0, 1, 4
"d:\IDEWORK\lvmen\src\licensedcode\data\rules\agpl-3.0_310.yml", "YAML", 0, 0, 0, 5, 0, 0, 1, 6
"d:\IDEWORK\lvmen\src\licensedcode\data\rules\agpl-3.0_311.yml", "YAML", 0, 0, 0, 5, 0, 0, 1, 6
"d:\IDEWORK\lvmen\src\licensedcode\data\rules\agpl-3.0_312.yml", "YAML", 0, 0, 0, 5, 0, 0, 1, 6
"d:\IDEWORK\lvmen\src\licensedcode\data\rules\agpl-3.0_313.yml", "YAML", 0, 0, 0, 3, 0, 0, 1, 4
"d:\IDEWORK\lvmen\src\licensedcode\data\rules\agpl-3.0_314.yml", "YAML", 0, 0, 0, 5, 0, 0, 1, 6
"d:\IDEWORK\lvmen\src\licensedcode\data\rules\agpl-3.0_315.yml", "YAML", 0, 0, 0, 3, 0, 0, 1, 4
"d:\IDEWORK\lvmen\src\licensedcode\data\rules\agpl-3.0_316.yml", "YAML", 0, 0, 0, 3, 0, 0, 1, 4
"d:\IDEWORK\lvmen\src\licensedcode\data\rules\agpl-3.0_317.yml", "YAML", 0, 0, 0, 3, 0, 0, 1, 4
"d:\IDEWORK\lvmen\src\licensedcode\data\rules\agpl-3.0_318.yml", "YAML", 0, 0, 0, 3, 0, 0, 1, 4
"d:\IDEWORK\lvmen\src\licensedcode\data\rules\agpl-3.0_319.yml", "YAML", 0, 0, 0, 5, 0, 0, 1, 6
"d:\IDEWORK\lvmen\src\licensedcode\data\rules\agpl-3.0_32.yml", "YAML", 0, 0, 0, 3, 0, 0, 1, 4
"d:\IDEWORK\lvmen\src\licensedcode\data\rules\agpl-3.0_320.yml", "YAML", 0, 0, 0, 3, 0, 0, 1, 4
"d:\IDEWORK\lvmen\src\licensedcode\data\rules\agpl-3.0_321.yml", "YAML", 0, 0, 0, 5, 0, 0, 1, 6
"d:\IDEWORK\lvmen\src\licensedcode\data\rules\agpl-3.0_322.yml", "YAML", 0, 0, 0, 2, 0, 0, 1, 3
"d:\IDEWORK\lvmen\src\licensedcode\data\rules\agpl-3.0_323.yml", "YAML", 0, 0, 0, 3, 0, 0, 1, 4
"d:\IDEWORK\lvmen\src\licensedcode\data\rules\agpl-3.0_324.yml", "YAML", 0, 0, 0, 3, 0, 0, 1, 4
"d:\IDEWORK\lvmen\src\licensedcode\data\rules\agpl-3.0_325.yml", "YAML", 0, 0, 0, 5, 0, 0, 1, 6
"d:\IDEWORK\lvmen\src\licensedcode\data\rules\agpl-3.0_326.yml", "YAML", 0, 0, 0, 6, 0, 0, 1, 7
"d:\IDEWORK\lvmen\src\licensedcode\data\rules\agpl-3.0_327.yml", "YAML", 0, 0, 0, 5, 0, 0, 1, 6
"d:\IDEWORK\lvmen\src\licensedcode\data\rules\agpl-3.0_328.yml", "YAML", 0, 0, 0, 5, 0, 0, 1, 6
"d:\IDEWORK\lvmen\src\licensedcode\data\rules\agpl-3.0_329.yml", "YAML", 0, 0, 0, 5, 0, 0, 1, 6
"d:\IDEWORK\lvmen\src\licensedcode\data\rules\agpl-3.0_33.yml", "YAML", 0, 0, 0, 3, 0, 0, 1, 4
"d:\IDEWORK\lvmen\src\licensedcode\data\rules\agpl-3.0_330.yml", "YAML", 0, 0, 0, 6, 0, 0, 1, 7
"d:\IDEWORK\lvmen\src\licensedcode\data\rules\agpl-3.0_331.yml", "YAML", 0, 0, 0, 5, 0, 0, 1, 6
"d:\IDEWORK\lvmen\src\licensedcode\data\rules\agpl-3.0_332.yml", "YAML", 0, 0, 0, 5, 0, 0, 1, 6
"d:\IDEWORK\lvmen\src\licensedcode\data\rules\agpl-3.0_333.yml", "YAML", 0, 0, 0, 5, 0, 0, 1, 6
"d:\IDEWORK\lvmen\src\licensedcode\data\rules\agpl-3.0_334.yml", "YAML", 0, 0, 0, 5, 0, 0, 1, 6
"d:\IDEWORK\lvmen\src\licensedcode\data\rules\agpl-3.0_335.yml", "YAML", 0, 0, 0, 11, 0, 0, 1, 12
"d:\IDEWORK\lvmen\src\licensedcode\data\rules\agpl-3.0_336.yml", "YAML", 0, 0, 0, 5, 0, 0, 1, 6
"d:\IDEWORK\lvmen\src\licensedcode\data\rules\agpl-3.0_337.yml", "YAML", 0, 0, 0, 5, 0, 0, 1, 6
"d:\IDEWORK\lvmen\src\licensedcode\data\rules\agpl-3.0_338.yml", "YAML", 0, 0, 0, 12, 0, 0, 1, 13
"d:\IDEWORK\lvmen\src\licensedcode\data\rules\agpl-3.0_339.yml", "YAML", 0, 0, 0, 5, 0, 0, 1, 6
"d:\IDEWORK\lvmen\src\licensedcode\data\rules\agpl-3.0_34.yml", "YAML", 0, 0, 0, 3, 0, 0, 1, 4
"d:\IDEWORK\lvmen\src\licensedcode\data\rules\agpl-3.0_340.yml", "YAML", 0, 0, 0, 7, 0, 0, 1, 8
"d:\IDEWORK\lvmen\src\licensedcode\data\rules\agpl-3.0_341.yml", "YAML", 0, 0, 0, 5, 0, 0, 1, 6
"d:\IDEWORK\lvmen\src\licensedcode\data\rules\agpl-3.0_342.yml", "YAML", 0, 0, 0, 7, 0, 0, 1, 8
"d:\IDEWORK\lvmen\src\licensedcode\data\rules\agpl-3.0_343.yml", "YAML", 0, 0, 0, 7, 0, 0, 1, 8
"d:\IDEWORK\lvmen\src\licensedcode\data\rules\agpl-3.0_344.yml", "YAML", 0, 0, 0, 5, 0, 0, 1, 6
"d:\IDEWORK\lvmen\src\licensedcode\data\rules\agpl-3.0_345.yml", "YAML", 0, 0, 0, 5, 0, 0, 1, 6
"d:\IDEWORK\lvmen\src\licensedcode\data\rules\agpl-3.0_346.yml", "YAML", 0, 0, 0, 6, 0, 0, 1, 7
"d:\IDEWORK\lvmen\src\licensedcode\data\rules\agpl-3.0_347.yml", "YAML", 0, 0, 0, 5, 0, 0, 1, 6
"d:\IDEWORK\lvmen\src\licensedcode\data\rules\agpl-3.0_348.yml", "YAML", 0, 0, 0, 5, 0, 0, 1, 6
"d:\IDEWORK\lvmen\src\licensedcode\data\rules\agpl-3.0_349.yml", "YAML", 0, 0, 0, 5, 0, 0, 1, 6
"d:\IDEWORK\lvmen\src\licensedcode\data\rules\agpl-3.0_35.yml", "YAML", 0, 0, 0, 4, 0, 0, 1, 5
"d:\IDEWORK\lvmen\src\licensedcode\data\rules\agpl-3.0_350.yml", "YAML", 0, 0, 0, 5, 0, 0, 1, 6
"d:\IDEWORK\lvmen\src\licensedcode\data\rules\agpl-3.0_351.yml", "YAML", 0, 0, 0, 10, 0, 0, 1, 11
"d:\IDEWORK\lvmen\src\licensedcode\data\rules\agpl-3.0_352.yml", "YAML", 0, 0, 0, 10, 0, 0, 1, 11
"d:\IDEWORK\lvmen\src\licensedcode\data\rules\agpl-3.0_36.yml", "YAML", 0, 0, 0, 3, 0, 0, 1, 4
"d:\IDEWORK\lvmen\src\licensedcode\data\rules\agpl-3.0_37.yml", "YAML", 0, 0, 0, 4, 0, 0, 1, 5
"d:\IDEWORK\lvmen\src\licensedcode\data\rules\agpl-3.0_38.yml", "YAML", 0, 0, 0, 5, 0, 0, 1, 6
"d:\IDEWORK\lvmen\src\licensedcode\data\rules\agpl-3.0_39.yml", "YAML", 0, 0, 0, 3, 0, 0, 1, 4
"d:\IDEWORK\lvmen\src\licensedcode\data\rules\agpl-3.0_4.yml", "YAML", 0, 0, 0, 11, 0, 0, 1, 12
"d:\IDEWORK\lvmen\src\licensedcode\data\rules\agpl-3.0_40.yml", "YAML", 0, 0, 0, 2, 0, 0, 1, 3
"d:\IDEWORK\lvmen\src\licensedcode\data\rules\agpl-3.0_41.yml", "YAML", 0, 0, 0, 4, 0, 0, 1, 5
"d:\IDEWORK\lvmen\src\licensedcode\data\rules\agpl-3.0_42.yml", "YAML", 0, 0, 0, 3, 0, 0, 1, 4
"d:\IDEWORK\lvmen\src\licensedcode\data\rules\agpl-3.0_43.yml", "YAML", 0, 0, 0, 5, 0, 0, 1, 6
"d:\IDEWORK\lvmen\src\licensedcode\data\rules\agpl-3.0_44.yml", "YAML", 0, 0, 0, 3, 0, 0, 1, 4
"d:\IDEWORK\lvmen\src\licensedcode\data\rules\agpl-3.0_45.yml", "YAML", 0, 0, 0, 3, 0, 0, 1, 4
"d:\IDEWORK\lvmen\src\licensedcode\data\rules\agpl-3.0_46.yml", "YAML", 0, 0, 0, 5, 0, 0, 1, 6
"d:\IDEWORK\lvmen\src\licensedcode\data\rules\agpl-3.0_47.yml", "YAML", 0, 0, 0, 3, 0, 0, 1, 4
"d:\IDEWORK\lvmen\src\licensedcode\data\rules\agpl-3.0_48.yml", "YAML", 0, 0, 0, 3, 0, 0, 1, 4
"d:\IDEWORK\lvmen\src\licensedcode\data\rules\agpl-3.0_49.yml", "YAML", 0, 0, 0, 3, 0, 0, 1, 4
"d:\IDEWORK\lvmen\src\licensedcode\data\rules\agpl-3.0_5.yml", "YAML", 0, 0, 0, 3, 0, 0, 1, 4
"d:\IDEWORK\lvmen\src\licensedcode\data\rules\agpl-3.0_50.yml", "YAML", 0, 0, 0, 3, 0, 0, 1, 4
"d:\IDEWORK\lvmen\src\licensedcode\data\rules\agpl-3.0_500.yml", "YAML", 0, 0, 0, 5, 0, 0, 1, 6
"d:\IDEWORK\lvmen\src\licensedcode\data\rules\agpl-3.0_501.yml", "YAML", 0, 0, 0, 7, 0, 0, 1, 8
"d:\IDEWORK\lvmen\src\licensedcode\data\rules\agpl-3.0_51.yml", "YAML", 0, 0, 0, 5, 0, 0, 1, 6
"d:\IDEWORK\lvmen\src\licensedcode\data\rules\agpl-3.0_52.yml", "YAML", 0, 0, 0, 5, 0, 0, 1, 6
"d:\IDEWORK\lvmen\src\licensedcode\data\rules\agpl-3.0_53.yml", "YAML", 0, 0, 0, 5, 0, 0, 1, 6
"d:\IDEWORK\lvmen\src\licensedcode\data\rules\agpl-3.0_54.yml", "YAML", 0, 0, 0, 5, 0, 0, 1, 6
"d:\IDEWORK\lvmen\src\licensedcode\data\rules\agpl-3.0_55.yml", "YAML", 0, 0, 0, 3, 0, 0, 1, 4
"d:\IDEWORK\lvmen\src\licensedcode\data\rules\agpl-3.0_56.yml", "YAML", 0, 0, 0, 3, 0, 0, 1, 4
"d:\IDEWORK\lvmen\src\licensedcode\data\rules\agpl-3.0_57.yml", "YAML", 0, 0, 0, 5, 0, 0, 1, 6
"d:\IDEWORK\lvmen\src\licensedcode\data\rules\agpl-3.0_58.yml", "YAML", 0, 0, 0, 5, 0, 0, 1, 6
"d:\IDEWORK\lvmen\src\licensedcode\data\rules\agpl-3.0_59.yml", "YAML", 0, 0, 0, 3, 0, 0, 1, 4
"d:\IDEWORK\lvmen\src\licensedcode\data\rules\agpl-3.0_6.yml", "YAML", 0, 0, 0, 3, 0, 0, 1, 4
"d:\IDEWORK\lvmen\src\licensedcode\data\rules\agpl-3.0_60.yml", "YAML", 0, 0, 0, 3, 0, 0, 1, 4
"d:\IDEWORK\lvmen\src\licensedcode\data\rules\agpl-3.0_61.yml", "YAML", 0, 0, 0, 3, 0, 0, 1, 4
"d:\IDEWORK\lvmen\src\licensedcode\data\rules\agpl-3.0_62.yml", "YAML", 0, 0, 0, 3, 0, 0, 1, 4
"d:\IDEWORK\lvmen\src\licensedcode\data\rules\agpl-3.0_63.yml", "YAML", 0, 0, 0, 3, 0, 0, 1, 4
"d:\IDEWORK\lvmen\src\licensedcode\data\rules\agpl-3.0_64.yml", "YAML", 0, 0, 0, 3, 0, 0, 1, 4
"d:\IDEWORK\lvmen\src\licensedcode\data\rules\agpl-3.0_65.yml", "YAML", 0, 0, 0, 3, 0, 0, 1, 4
"d:\IDEWORK\lvmen\src\licensedcode\data\rules\agpl-3.0_66.yml", "YAML", 0, 0, 0, 3, 0, 0, 1, 4
"d:\IDEWORK\lvmen\src\licensedcode\data\rules\agpl-3.0_67.yml", "YAML", 0, 0, 0, 3, 0, 0, 1, 4
"d:\IDEWORK\lvmen\src\licensedcode\data\rules\agpl-3.0_68.yml", "YAML", 0, 0, 0, 3, 0, 0, 1, 4
"d:\IDEWORK\lvmen\src\licensedcode\data\rules\agpl-3.0_69.yml", "YAML", 0, 0, 0, 3, 0, 0, 1, 4
"d:\IDEWORK\lvmen\src\licensedcode\data\rules\agpl-3.0_7.yml", "YAML", 0, 0, 0, 5, 0, 0, 1, 6
"d:\IDEWORK\lvmen\src\licensedcode\data\rules\agpl-3.0_70.yml", "YAML", 0, 0, 0, 3, 0, 0, 1, 4
"d:\IDEWORK\lvmen\src\licensedcode\data\rules\agpl-3.0_71.yml", "YAML", 0, 0, 0, 3, 0, 0, 1, 4
"d:\IDEWORK\lvmen\src\licensedcode\data\rules\agpl-3.0_72.yml", "YAML", 0, 0, 0, 3, 0, 0, 1, 4
"d:\IDEWORK\lvmen\src\licensedcode\data\rules\agpl-3.0_73.yml", "YAML", 0, 0, 0, 3, 0, 0, 1, 4
"d:\IDEWORK\lvmen\src\licensedcode\data\rules\agpl-3.0_74.yml", "YAML", 0, 0, 0, 3, 0, 0, 1, 4
"d:\IDEWORK\lvmen\src\licensedcode\data\rules\agpl-3.0_75.yml", "YAML", 0, 0, 0, 3, 0, 0, 1, 4
"d:\IDEWORK\lvmen\src\licensedcode\data\rules\agpl-3.0_76.yml", "YAML", 0, 0, 0, 3, 0, 0, 1, 4
"d:\IDEWORK\lvmen\src\licensedcode\data\rules\agpl-3.0_77.yml", "YAML", 0, 0, 0, 3, 0, 0, 1, 4
"d:\IDEWORK\lvmen\src\licensedcode\data\rules\agpl-3.0_78.yml", "YAML", 0, 0, 0, 3, 0, 0, 1, 4
"d:\IDEWORK\lvmen\src\licensedcode\data\rules\agpl-3.0_79.yml", "YAML", 0, 0, 0, 3, 0, 0, 1, 4
"d:\IDEWORK\lvmen\src\licensedcode\data\rules\agpl-3.0_8.yml", "YAML", 0, 0, 0, 5, 0, 0, 1, 6
"d:\IDEWORK\lvmen\src\licensedcode\data\rules\agpl-3.0_80.yml", "YAML", 0, 0, 0, 3, 0, 0, 1, 4
"d:\IDEWORK\lvmen\src\licensedcode\data\rules\agpl-3.0_81.yml", "YAML", 0, 0, 0, 3, 0, 0, 1, 4
"d:\IDEWORK\lvmen\src\licensedcode\data\rules\agpl-3.0_82.yml", "YAML", 0, 0, 0, 3, 0, 0, 1, 4
"d:\IDEWORK\lvmen\src\licensedcode\data\rules\agpl-3.0_83.yml", "YAML", 0, 0, 0, 3, 0, 0, 1, 4
"d:\IDEWORK\lvmen\src\licensedcode\data\rules\agpl-3.0_84.yml", "YAML", 0, 0, 0, 3, 0, 0, 1, 4
"d:\IDEWORK\lvmen\src\licensedcode\data\rules\agpl-3.0_85.yml", "YAML", 0, 0, 0, 3, 0, 0, 1, 4
"d:\IDEWORK\lvmen\src\licensedcode\data\rules\agpl-3.0_86.yml", "YAML", 0, 0, 0, 5, 0, 0, 1, 6
"d:\IDEWORK\lvmen\src\licensedcode\data\rules\agpl-3.0_87.yml", "YAML", 0, 0, 0, 5, 0, 0, 1, 6
"d:\IDEWORK\lvmen\src\licensedcode\data\rules\agpl-3.0_88.yml", "YAML", 0, 0, 0, 5, 0, 0, 1, 6
"d:\IDEWORK\lvmen\src\licensedcode\data\rules\agpl-3.0_89.yml", "YAML", 0, 0, 0, 5, 0, 0, 1, 6
"d:\IDEWORK\lvmen\src\licensedcode\data\rules\agpl-3.0_9.yml", "YAML", 0, 0, 0, 5, 0, 0, 1, 6
"d:\IDEWORK\lvmen\src\licensedcode\data\rules\agpl-3.0_90.yml", "YAML", 0, 0, 0, 3, 0, 0, 1, 4
"d:\IDEWORK\lvmen\src\licensedcode\data\rules\agpl-3.0_91.yml", "YAML", 0, 0, 0, 5, 0, 0, 1, 6
"d:\IDEWORK\lvmen\src\licensedcode\data\rules\agpl-3.0_92.yml", "YAML", 0, 0, 0, 5, 0, 0, 1, 6
"d:\IDEWORK\lvmen\src\licensedcode\data\rules\agpl-3.0_93.yml", "YAML", 0, 0, 0, 5, 0, 0, 1, 6
"d:\IDEWORK\lvmen\src\licensedcode\data\rules\agpl-3.0_94.yml", "YAML", 0, 0, 0, 5, 0, 0, 1, 6
"d:\IDEWORK\lvmen\src\licensedcode\data\rules\agpl-3.0_95.yml", "YAML", 0, 0, 0, 5, 0, 0, 1, 6
"d:\IDEWORK\lvmen\src\licensedcode\data\rules\agpl-3.0_96.yml", "YAML", 0, 0, 0, 5, 0, 0, 1, 6
"d:\IDEWORK\lvmen\src\licensedcode\data\rules\agpl-3.0_97.yml", "YAML", 0, 0, 0, 5, 0, 0, 1, 6
"d:\IDEWORK\lvmen\src\licensedcode\data\rules\agpl-3.0_98.yml", "YAML", 0, 0, 0, 5, 0, 0, 1, 6
"d:\IDEWORK\lvmen\src\licensedcode\data\rules\agpl-3.0_99.yml", "YAML", 0, 0, 0, 3, 0, 0, 1, 4
"d:\IDEWORK\lvmen\src\licensedcode\data\rules\agpl-3.0_and_afpl-9.0_1.yml", "YAML", 0, 0, 0, 3, 0, 0, 1, 4
"d:\IDEWORK\lvmen\src\licensedcode\data\rules\agpl-3.0_and_bsd-new_and_lgpl-2.0-plus_1.yml", "YAML", 0, 0, 0, 3, 0, 0, 1, 4
"d:\IDEWORK\lvmen\src\licensedcode\data\rules\agpl-3.0_and_bsd-new_and_lgpl-2.0-plus_2.yml", "YAML", 0, 0, 0, 3, 0, 0, 1, 4
"d:\IDEWORK\lvmen\src\licensedcode\data\rules\agpl-3.0_and_other-copyleft_1.yml", "YAML", 0, 0, 0, 7, 0, 0, 1, 8
"d:\IDEWORK\lvmen\src\licensedcode\data\rules\agpl-3.0_and_other-copyleft_2.yml", "YAML", 0, 0, 0, 8, 0, 0, 1, 9
"d:\IDEWORK\lvmen\src\licensedcode\data\rules\agpl-3.0_and_other-copyleft_and_proprietary-license_1.yml", "YAML", 0, 0, 0, 13, 0, 0, 1, 14
"d:\IDEWORK\lvmen\src\licensedcode\data\rules\agpl-3.0_and_other-copyleft_and_unknown_1.yml", "YAML", 0, 0, 0, 7, 0, 0, 1, 8
"d:\IDEWORK\lvmen\src\licensedcode\data\rules\agpl-3.0_and_other-copyleft_and_unknown_2.yml", "YAML", 0, 0, 0, 7, 0, 0, 1, 8
"d:\IDEWORK\lvmen\src\licensedcode\data\rules\agpl-3.0_and_other-permissive_1.yml", "YAML", 0, 0, 0, 3, 0, 0, 1, 4
"d:\IDEWORK\lvmen\src\licensedcode\data\rules\agpl-3.0_and_other-permissive_and_other-copyleft_1.yml", "YAML", 0, 0, 0, 5, 0, 0, 1, 6
"d:\IDEWORK\lvmen\src\licensedcode\data\rules\agpl-3.0_and_other-permissive_and_other-copyleft_2.yml", "YAML", 0, 0, 0, 5, 0, 0, 1, 6
"d:\IDEWORK\lvmen\src\licensedcode\data\rules\agpl-3.0_and_proprietary-license_1.yml", "YAML", 0, 0, 0, 6, 0, 0, 1, 7
"d:\IDEWORK\lvmen\src\licensedcode\data\rules\agpl-3.0_and_proprietary-license_2.yml", "YAML", 0, 0, 0, 6, 0, 0, 1, 7
"d:\IDEWORK\lvmen\src\licensedcode\data\rules\agpl-3.0_and_proprietary-license_3.yml", "YAML", 0, 0, 0, 5, 0, 0, 1, 6
"d:\IDEWORK\lvmen\src\licensedcode\data\rules\agpl-3.0_and_proprietary-license_4.yml", "YAML", 0, 0, 0, 6, 0, 0, 1, 7
"d:\IDEWORK\lvmen\src\licensedcode\data\rules\agpl-3.0_and_proprietary-license_5.yml", "YAML", 0, 0, 0, 6, 0, 0, 1, 7
"d:\IDEWORK\lvmen\src\licensedcode\data\rules\agpl-3.0_and_proprietary-license_6.yml", "YAML", 0, 0, 0, 5, 0, 0, 1, 6
"d:\IDEWORK\lvmen\src\licensedcode\data\rules\agpl-3.0_and_unknown_1.yml", "YAML", 0, 0, 0, 6, 0, 0, 1, 7
"d:\IDEWORK\lvmen\src\licensedcode\data\rules\agpl-3.0_jqh_1.yml", "YAML", 0, 0, 0, 6, 0, 0, 1, 7
"d:\IDEWORK\lvmen\src\licensedcode\data\rules\agpl-3.0_or_commercial-license.yml", "YAML", 0, 0, 0, 3, 0, 0, 1, 4
"d:\IDEWORK\lvmen\src\licensedcode\data\rules\agpl-3.0_or_commercial-license_1.yml", "YAML", 0, 0, 0, 5, 0, 0, 1, 6
"d:\IDEWORK\lvmen\src\licensedcode\data\rules\agpl-3.0_or_commercial-license_2.yml", "YAML", 0, 0, 0, 5, 0, 0, 1, 6
"d:\IDEWORK\lvmen\src\licensedcode\data\rules\agpl-3.0_or_commercial-license_3.yml", "YAML", 0, 0, 0, 5, 0, 0, 1, 6
"d:\IDEWORK\lvmen\src\licensedcode\data\rules\agpl-3.0_or_commercial-license_4.yml", "YAML", 0, 0, 0, 5, 0, 0, 1, 6
"d:\IDEWORK\lvmen\src\licensedcode\data\rules\agpl-3.0_or_commercial-license_5.yml", "YAML", 0, 0, 0, 3, 0, 0, 1, 4
"d:\IDEWORK\lvmen\src\licensedcode\data\rules\agpl-3.0_or_commercial-license_6.yml", "YAML", 0, 0, 0, 5, 0, 0, 1, 6
"d:\IDEWORK\lvmen\src\licensedcode\data\rules\agpl-3.0_or_proprietary-license_1.yml", "YAML", 0, 0, 0, 3, 0, 0, 1, 4
"d:\IDEWORK\lvmen\src\licensedcode\data\rules\agpl-3.0_url_1.yml", "YAML", 0, 0, 0, 5, 0, 0, 1, 6
"d:\IDEWORK\lvmen\src\licensedcode\data\rules\agpl-3.0_url_2.yml", "YAML", 0, 0, 0, 5, 0, 0, 1, 6
"d:\IDEWORK\lvmen\src\licensedcode\data\rules\agpl-3.0_url_badge.yml", "YAML", 0, 0, 0, 5, 0, 0, 1, 6
"d:\IDEWORK\lvmen\src\licensedcode\data\rules\agpl-3.0_url_glc_119.yml", "YAML", 0, 0, 0, 5, 0, 0, 1, 6
"d:\IDEWORK\lvmen\src\licensedcode\data\rules\agpl-3.0_url_glc_138.yml", "YAML", 0, 0, 0, 5, 0, 0, 1, 6
"d:\IDEWORK\lvmen\src\licensedcode\data\rules\agpl-3.0_url_glc_139.yml", "YAML", 0, 0, 0, 5, 0, 0, 1, 6
"d:\IDEWORK\lvmen\src\licensedcode\data\rules\agpl-3.0_with_agpl-generic-additional-terms_1.yml", "YAML", 0, 0, 0, 15, 0, 0, 1, 16
"d:\IDEWORK\lvmen\src\licensedcode\data\rules\agpl-3.0_with_agpl-generic-additional-terms_10.yml", "YAML", 0, 0, 0, 5, 0, 0, 1, 6
"d:\IDEWORK\lvmen\src\licensedcode\data\rules\agpl-3.0_with_agpl-generic-additional-terms_11.yml", "YAML", 0, 0, 0, 5, 0, 0, 1, 6
"d:\IDEWORK\lvmen\src\licensedcode\data\rules\agpl-3.0_with_agpl-generic-additional-terms_12.yml", "YAML", 0, 0, 0, 7, 0, 0, 1, 8
"d:\IDEWORK\lvmen\src\licensedcode\data\rules\agpl-3.0_with_agpl-generic-additional-terms_13.yml", "YAML", 0, 0, 0, 7, 0, 0, 1, 8
"d:\IDEWORK\lvmen\src\licensedcode\data\rules\agpl-3.0_with_agpl-generic-additional-terms_14.yml", "YAML", 0, 0, 0, 5, 0, 0, 1, 6
"d:\IDEWORK\lvmen\src\licensedcode\data\rules\agpl-3.0_with_agpl-generic-additional-terms_15.yml", "YAML", 0, 0, 0, 3, 0, 0, 1, 4
"d:\IDEWORK\lvmen\src\licensedcode\data\rules\agpl-3.0_with_agpl-generic-additional-terms_16.yml", "YAML", 0, 0, 0, 3, 0, 0, 1, 4
"d:\IDEWORK\lvmen\src\licensedcode\data\rules\agpl-3.0_with_agpl-generic-additional-terms_17.yml", "YAML", 0, 0, 0, 3, 0, 0, 1, 4
"d:\IDEWORK\lvmen\src\licensedcode\data\rules\agpl-3.0_with_agpl-generic-additional-terms_18.yml", "YAML", 0, 0, 0, 5, 0, 0, 1, 6
"d:\IDEWORK\lvmen\src\licensedcode\data\rules\agpl-3.0_with_agpl-generic-additional-terms_19.yml", "YAML", 0, 0, 0, 4, 0, 0, 1, 5
"d:\IDEWORK\lvmen\src\licensedcode\data\rules\agpl-3.0_with_agpl-generic-additional-terms_2.yml", "YAML", 0, 0, 0, 5, 0, 0, 1, 6
"d:\IDEWORK\lvmen\src\licensedcode\data\rules\agpl-3.0_with_agpl-generic-additional-terms_20.yml", "YAML", 0, 0, 0, 5, 0, 0, 1, 6
"d:\IDEWORK\lvmen\src\licensedcode\data\rules\agpl-3.0_with_agpl-generic-additional-terms_21.yml", "YAML", 0, 0, 0, 7, 0, 0, 1, 8
"d:\IDEWORK\lvmen\src\licensedcode\data\rules\agpl-3.0_with_agpl-generic-additional-terms_22.yml", "YAML", 0, 0, 0, 7, 0, 0, 1, 8
"d:\IDEWORK\lvmen\src\licensedcode\data\rules\agpl-3.0_with_agpl-generic-additional-terms_23.yml", "YAML", 0, 0, 0, 8, 0, 0, 1, 9
"d:\IDEWORK\lvmen\src\licensedcode\data\rules\agpl-3.0_with_agpl-generic-additional-terms_24.yml", "YAML", 0, 0, 0, 5, 0, 0, 1, 6
"d:\IDEWORK\lvmen\src\licensedcode\data\rules\agpl-3.0_with_agpl-generic-additional-terms_25.yml", "YAML", 0, 0, 0, 8, 0, 0, 1, 9
"d:\IDEWORK\lvmen\src\licensedcode\data\rules\agpl-3.0_with_agpl-generic-additional-terms_26.yml", "YAML", 0, 0, 0, 5, 0, 0, 1, 6
"d:\IDEWORK\lvmen\src\licensedcode\data\rules\agpl-3.0_with_agpl-generic-additional-terms_3.yml", "YAML", 0, 0, 0, 8, 0, 0, 1, 9
"d:\IDEWORK\lvmen\src\licensedcode\data\rules\agpl-3.0_with_agpl-generic-additional-terms_4.yml", "YAML", 0, 0, 0, 8, 0, 0, 1, 9
"d:\IDEWORK\lvmen\src\licensedcode\data\rules\agpl-3.0_with_agpl-generic-additional-terms_5.yml", "YAML", 0, 0, 0, 9, 0, 0, 1, 10
"d:\IDEWORK\lvmen\src\licensedcode\data\rules\agpl-3.0_with_agpl-generic-additional-terms_6.yml", "YAML", 0, 0, 0, 3, 0, 0, 1, 4
"d:\IDEWORK\lvmen\src\licensedcode\data\rules\agpl-3.0_with_agpl-generic-additional-terms_7.yml", "YAML", 0, 0, 0, 3, 0, 0, 1, 4
"d:\IDEWORK\lvmen\src\licensedcode\data\rules\agpl-3.0_with_agpl-generic-additional-terms_8.yml", "YAML", 0, 0, 0, 3, 0, 0, 1, 4
"d:\IDEWORK\lvmen\src\licensedcode\data\rules\agpl-3.0_with_agpl-generic-additional-terms_9.yml", "YAML", 0, 0, 0, 3, 0, 0, 1, 4
"d:\IDEWORK\lvmen\src\licensedcode\data\rules\agpl-3.0_with_agpl-generic-additional-terms_and_cc0-1.0_1.yml", "YAML", 0, 0, 0, 3, 0, 0, 1, 4
"d:\IDEWORK\lvmen\src\licensedcode\data\rules\agpl-3.0_with_agpl-generic-additional-terms_or_commercial-license_1.yml", "YAML", 0, 0, 0, 4, 0, 0, 1, 5
"d:\IDEWORK\lvmen\src\licensedcode\data\rules\agpl-3.0_with_nicta-exception_1.yml", "YAML", 0, 0, 0, 3, 0, 0, 1, 4
"d:\IDEWORK\lvmen\src\licensedcode\data\rules\agpl-3.0_with_nicta-exception_2.yml", "YAML", 0, 0, 0, 5, 0, 0, 1, 6
"d:\IDEWORK\lvmen\src\licensedcode\data\rules\agpl-3.0_with_nicta-exception_3.yml", "YAML", 0, 0, 0, 5, 0, 0, 1, 6
"d:\IDEWORK\lvmen\src\licensedcode\data\rules\agpl-3.0_with_nicta-exception_4.yml", "YAML", 0, 0, 0, 3, 0, 0, 1, 4
"d:\IDEWORK\lvmen\src\licensedcode\data\rules\agpl-3.0_with_nicta-exception_5.yml", "YAML", 0, 0, 0, 5, 0, 0, 1, 6
"d:\IDEWORK\lvmen\src\licensedcode\data\rules\agpl-3.0_with_nicta-exception_6.yml", "YAML", 0, 0, 0, 5, 0, 0, 1, 6
"d:\IDEWORK\lvmen\src\licensedcode\data\rules\agpl-3.0_with_openssl-exception-agpl-3.0-monit_1.yml", "YAML", 0, 0, 0, 6, 0, 0, 2, 8
"d:\IDEWORK\lvmen\src\licensedcode\data\rules\agpl-3.0_with_openssl-exception-agpl-3.0-monit_2.yml", "YAML", 0, 0, 0, 4, 0, 0, 1, 5
"d:\IDEWORK\lvmen\src\licensedcode\data\rules\agpl-3.0_with_openssl-exception-agpl-3.0-monit_3.yml", "YAML", 0, 0, 0, 6, 0, 0, 1, 7
"d:\IDEWORK\lvmen\src\licensedcode\data\rules\agpl-3.0_with_openssl-exception-agpl-3.0_1.yml", "YAML", 0, 0, 0, 4, 0, 0, 1, 5
"d:\IDEWORK\lvmen\src\licensedcode\data\rules\agpl-3.0_with_openssl-exception-agpl-3.0_2.yml", "YAML", 0, 0, 0, 5, 0, 0, 1, 6
"d:\IDEWORK\lvmen\src\licensedcode\data\rules\agpl-3.0_with_ps-or-pdf-font-exception-20170817_1.yml", "YAML", 0, 0, 0, 3, 0, 0, 1, 4
"d:\IDEWORK\lvmen\src\licensedcode\data\rules\agpl-3.0_with_ps-or-pdf-font-exception-20170817_2.yml", "YAML", 0, 0, 0, 7, 0, 0, 1, 8
"d:\IDEWORK\lvmen\src\licensedcode\data\rules\agpl-3.0_with_ps-or-pdf-font-exception-20170817_3.yml", "YAML", 0, 0, 0, 4, 0, 0, 1, 5
"d:\IDEWORK\lvmen\src\licensedcode\data\rules\agpl-3.0_with_ps-or-pdf-font-exception-20170817_4.yml", "YAML", 0, 0, 0, 2, 0, 0, 1, 3
"d:\IDEWORK\lvmen\src\licensedcode\data\rules\agpl-generic-additional-terms_1.yml", "YAML", 0, 0, 0, 3, 0, 0, 1, 4
"d:\IDEWORK\lvmen\src\licensedcode\data\rules\aladdin-md5.yml", "YAML", 0, 0, 0, 4, 0, 0, 1, 5
"d:\IDEWORK\lvmen\src\licensedcode\data\rules\allegro-4_url_1.yml", "YAML", 0, 0, 0, 5, 0, 0, 1, 6
"d:\IDEWORK\lvmen\src\licensedcode\data\rules\allegro-4_url_2.yml", "YAML", 0, 0, 0, 5, 0, 0, 1, 6
"d:\IDEWORK\lvmen\src\licensedcode\data\rules\amazon-sl.yml", "YAML", 0, 0, 0, 5, 0, 0, 1, 6
"d:\IDEWORK\lvmen\src\licensedcode\data\rules\amazon-sl_1.yml", "YAML", 0, 0, 0, 2, 0, 0, 1, 3
"d:\IDEWORK\lvmen\src\licensedcode\data\rules\amazon-sl_2.yml", "YAML", 0, 0, 0, 4, 0, 0, 1, 5
"d:\IDEWORK\lvmen\src\licensedcode\data\rules\amazon-sl_3.yml", "YAML", 0, 0, 0, 3, 0, 0, 1, 4
"d:\IDEWORK\lvmen\src\licensedcode\data\rules\amazon-sl_4.yml", "YAML", 0, 0, 0, 6, 0, 0, 1, 7
"d:\IDEWORK\lvmen\src\licensedcode\data\rules\amazon-sl_5.yml", "YAML", 0, 0, 0, 3, 0, 0, 1, 4
"d:\IDEWORK\lvmen\src\licensedcode\data\rules\amazon-sl_6.yml", "YAML", 0, 0, 0, 3, 0, 0, 1, 4
"d:\IDEWORK\lvmen\src\licensedcode\data\rules\amazon-sl_7.yml", "YAML", 0, 0, 0, 3, 0, 0, 1, 4
"d:\IDEWORK\lvmen\src\licensedcode\data\rules\amazon-sl_8.yml", "YAML", 0, 0, 0, 3, 0, 0, 1, 4
"d:\IDEWORK\lvmen\src\licensedcode\data\rules\amazon-sl_9.yml", "YAML", 0, 0, 0, 2, 0, 0, 1, 3
"d:\IDEWORK\lvmen\src\licensedcode\data\rules\amd-historical1.yml", "YAML", 0, 0, 0, 3, 0, 0, 1, 4
"d:\IDEWORK\lvmen\src\licensedcode\data\rules\amd-historical2.yml", "YAML", 0, 0, 0, 3, 0, 0, 1, 4
"d:\IDEWORK\lvmen\src\licensedcode\data\rules\amd-historical3.yml", "YAML", 0, 0, 0, 2, 0, 0, 1, 3
"d:\IDEWORK\lvmen\src\licensedcode\data\rules\amd-historical4.yml", "YAML", 0, 0, 0, 2, 0, 0, 1, 3
"d:\IDEWORK\lvmen\src\licensedcode\data\rules\amd-historical_1.yml", "YAML", 0, 0, 0, 4, 0, 0, 1, 5
"d:\IDEWORK\lvmen\src\licensedcode\data\rules\amdplpa_url_1.yml", "YAML", 0, 0, 0, 5, 0, 0, 1, 6
"d:\IDEWORK\lvmen\src\licensedcode\data\rules\amdplpa_url_2.yml", "YAML", 0, 0, 0, 5, 0, 0, 1, 6
"d:\IDEWORK\lvmen\src\licensedcode\data\rules\aml_1.yml", "YAML", 0, 0, 0, 4, 0, 0, 1, 5
"d:\IDEWORK\lvmen\src\licensedcode\data\rules\aml_url_1.yml", "YAML", 0, 0, 0, 5, 0, 0, 1, 6
"d:\IDEWORK\lvmen\src\licensedcode\data\rules\aml_url_2.yml", "YAML", 0, 0, 0, 5, 0, 0, 1, 6
"d:\IDEWORK\lvmen\src\licensedcode\data\rules\ampas_url_1.yml", "YAML", 0, 0, 0, 5, 0, 0, 1, 6
"d:\IDEWORK\lvmen\src\licensedcode\data\rules\ampas_url_2.yml", "YAML", 0, 0, 0, 5, 0, 0, 1, 6
"d:\IDEWORK\lvmen\src\licensedcode\data\rules\android-sdk-2012_1.yml", "YAML", 0, 0, 0, 3, 0, 0, 1, 4
"d:\IDEWORK\lvmen\src\licensedcode\data\rules\android-sdk-preview-2015_1.yml", "YAML", 0, 0, 0, 5, 0, 0, 1, 6
"d:\IDEWORK\lvmen\src\licensedcode\data\rules\android-sdk-preview-2015_2.yml", "YAML", 0, 0, 0, 3, 0, 0, 1, 4
"d:\IDEWORK\lvmen\src\licensedcode\data\rules\android-sdk-preview-2015_3.yml", "YAML", 0, 0, 0, 3, 0, 0, 1, 4
"d:\IDEWORK\lvmen\src\licensedcode\data\rules\android-sdk-preview-2015_4.yml", "YAML", 0, 0, 0, 4, 0, 0, 1, 5
"d:\IDEWORK\lvmen\src\licensedcode\data\rules\anti_capitalist1.yml", "YAML", 0, 0, 0, 2, 0, 0, 0, 2
"d:\IDEWORK\lvmen\src\licensedcode\data\rules\anti_capitalist2.yml", "YAML", 0, 0, 0, 2, 0, 0, 0, 2
"d:\IDEWORK\lvmen\src\licensedcode\data\rules\anti_capitalist3.yml", "YAML", 0, 0, 0, 2, 0, 0, 0, 2
"d:\IDEWORK\lvmen\src\licensedcode\data\rules\anti_capitalist4.yml", "YAML", 0, 0, 0, 3, 0, 0, 1, 4
"d:\IDEWORK\lvmen\src\licensedcode\data\rules\antlr-pd_1.yml", "YAML", 0, 0, 0, 5, 0, 0, 1, 6
"d:\IDEWORK\lvmen\src\licensedcode\data\rules\antlr-pd_2.yml", "YAML", 0, 0, 0, 3, 0, 0, 1, 4
"d:\IDEWORK\lvmen\src\licensedcode\data\rules\antlr-pd_3.yml", "YAML", 0, 0, 0, 3, 0, 0, 1, 4
"d:\IDEWORK\lvmen\src\licensedcode\data\rules\antlr-pd_4.yml", "YAML", 0, 0, 0, 2, 0, 0, 1, 3
"d:\IDEWORK\lvmen\src\licensedcode\data\rules\antlr-pd_5.yml", "YAML", 0, 0, 0, 2, 0, 0, 1, 3
"d:\IDEWORK\lvmen\src\licensedcode\data\rules\antlr-pd_6.yml", "YAML", 0, 0, 0, 2, 0, 0, 1, 3
"d:\IDEWORK\lvmen\src\licensedcode\data\rules\antlr-pd_7.yml", "YAML", 0, 0, 0, 2, 0, 0, 1, 3
"d:\IDEWORK\lvmen\src\licensedcode\data\rules\antlr-pd_url_1.yml", "YAML", 0, 0, 0, 5, 0, 0, 1, 6
"d:\IDEWORK\lvmen\src\licensedcode\data\rules\antlr-pd_url_2.yml", "YAML", 0, 0, 0, 5, 0, 0, 1, 6
"d:\IDEWORK\lvmen\src\licensedcode\data\rules\anu-license.yml", "YAML", 0, 0, 0, 5, 0, 0, 1, 6
"d:\IDEWORK\lvmen\src\licensedcode\data\rules\apache-1.0.yml", "YAML", 0, 0, 0, 5, 0, 0, 1, 6
"d:\IDEWORK\lvmen\src\licensedcode\data\rules\apache-1.0_1.yml", "YAML", 0, 0, 0, 3, 0, 0, 1, 4
"d:\IDEWORK\lvmen\src\licensedcode\data\rules\apache-1.0_2.yml", "YAML", 0, 0, 0, 3, 0, 0, 1, 4
"d:\IDEWORK\lvmen\src\licensedcode\data\rules\apache-1.0_3.yml", "YAML", 0, 0, 0, 5, 0, 0, 1, 6
"d:\IDEWORK\lvmen\src\licensedcode\data\rules\apache-1.0_4.yml", "YAML", 0, 0, 0, 5, 0, 0, 1, 6
"d:\IDEWORK\lvmen\src\licensedcode\data\rules\apache-1.0_5.yml", "YAML", 0, 0, 0, 5, 0, 0, 1, 6
"d:\IDEWORK\lvmen\src\licensedcode\data\rules\apache-1.0_6.yml", "YAML", 0, 0, 0, 9, 0, 0, 1, 10
"d:\IDEWORK\lvmen\src\licensedcode\data\rules\apache-1.0_7.yml", "YAML", 0, 0, 0, 9, 0, 0, 1, 10
"d:\IDEWORK\lvmen\src\licensedcode\data\rules\apache-1.0_or_apache-1.1_or_apache-2.0_1.yml", "YAML", 0, 0, 0, 3, 0, 0, 1, 4
"d:\IDEWORK\lvmen\src\licensedcode\data\rules\apache-1.0_url_1.yml", "YAML", 0, 0, 0, 5, 0, 0, 1, 6
"d:\IDEWORK\lvmen\src\licensedcode\data\rules\apache-1.0_url_2.yml", "YAML", 0, 0, 0, 5, 0, 0, 1, 6
"d:\IDEWORK\lvmen\src\licensedcode\data\rules\apache-1.1.SPDX.yml", "YAML", 0, 0, 0, 14, 0, 0, 1, 15
"d:\IDEWORK\lvmen\src\licensedcode\data\rules\apache-1.1.yml", "YAML", 0, 0, 0, 3, 0, 0, 1, 4
"d:\IDEWORK\lvmen\src\licensedcode\data\rules\apache-1.1_0.yml", "YAML", 0, 0, 0, 3, 0, 0, 1, 4
"d:\IDEWORK\lvmen\src\licensedcode\data\rules\apache-1.1_1.yml", "YAML", 0, 0, 0, 2, 0, 0, 1, 3
"d:\IDEWORK\lvmen\src\licensedcode\data\rules\apache-1.1_10.yml", "YAML", 0, 0, 0, 5, 0, 0, 1, 6
"d:\IDEWORK\lvmen\src\licensedcode\data\rules\apache-1.1_11.yml", "YAML", 0, 0, 0, 12, 0, 0, 1, 13
"d:\IDEWORK\lvmen\src\licensedcode\data\rules\apache-1.1_12.yml", "YAML", 0, 0, 0, 12, 0, 0, 1, 13
"d:\IDEWORK\lvmen\src\licensedcode\data\rules\apache-1.1_13.yml", "YAML", 0, 0, 0, 13, 0, 0, 1, 14
"d:\IDEWORK\lvmen\src\licensedcode\data\rules\apache-1.1_14.yml", "YAML", 0, 0, 0, 12, 0, 0, 1, 13
"d:\IDEWORK\lvmen\src\licensedcode\data\rules\apache-1.1_15.yml", "YAML", 0, 0, 0, 2, 0, 0, 1, 3
"d:\IDEWORK\lvmen\src\licensedcode\data\rules\apache-1.1_16.yml", "YAML", 0, 0, 0, 3, 0, 0, 1, 4
"d:\IDEWORK\lvmen\src\licensedcode\data\rules\apache-1.1_17.yml", "YAML", 0, 0, 0, 10, 0, 0, 1, 11
"d:\IDEWORK\lvmen\src\licensedcode\data\rules\apache-1.1_18.yml", "YAML", 0, 0, 0, 12, 0, 0, 1, 13
"d:\IDEWORK\lvmen\src\licensedcode\data\rules\apache-1.1_19.yml", "YAML", 0, 0, 0, 11, 0, 0, 1, 12
"d:\IDEWORK\lvmen\src\licensedcode\data\rules\apache-1.1_2.yml", "YAML", 0, 0, 0, 6, 0, 0, 1, 7
"d:\IDEWORK\lvmen\src\licensedcode\data\rules\apache-1.1_20.yml", "YAML", 0, 0, 0, 3, 0, 0, 1, 4
"d:\IDEWORK\lvmen\src\licensedcode\data\rules\apache-1.1_21.yml", "YAML", 0, 0, 0, 13, 0, 0, 1, 14
"d:\IDEWORK\lvmen\src\licensedcode\data\rules\apache-1.1_22.yml", "YAML", 0, 0, 0, 10, 0, 0, 1, 11
"d:\IDEWORK\lvmen\src\licensedcode\data\rules\apache-1.1_22_os.yml", "YAML", 0, 0, 0, 10, 0, 0, 1, 11
"d:\IDEWORK\lvmen\src\licensedcode\data\rules\apache-1.1_23.yml", "YAML", 0, 0, 0, 16, 0, 0, 1, 17
"d:\IDEWORK\lvmen\src\licensedcode\data\rules\apache-1.1_24.yml", "YAML", 0, 0, 0, 4, 0, 0, 1, 5
"d:\IDEWORK\lvmen\src\licensedcode\data\rules\apache-1.1_25.yml", "YAML", 0, 0, 0, 13, 0, 0, 1, 14
"d:\IDEWORK\lvmen\src\licensedcode\data\rules\apache-1.1_26.yml", "YAML", 0, 0, 0, 6, 0, 0, 1, 7
"d:\IDEWORK\lvmen\src\licensedcode\data\rules\apache-1.1_27.yml", "YAML", 0, 0, 0, 10, 0, 0, 1, 11
"d:\IDEWORK\lvmen\src\licensedcode\data\rules\apache-1.1_28.yml", "YAML", 0, 0, 0, 4, 0, 0, 1, 5
"d:\IDEWORK\lvmen\src\licensedcode\data\rules\apache-1.1_29.yml", "YAML", 0, 0, 0, 13, 0, 0, 1, 14
"d:\IDEWORK\lvmen\src\licensedcode\data\rules\apache-1.1_3.yml", "YAML", 0, 0, 0, 12, 0, 0, 1, 13
"d:\IDEWORK\lvmen\src\licensedcode\data\rules\apache-1.1_30.yml", "YAML", 0, 0, 0, 15, 0, 0, 1, 16
"d:\IDEWORK\lvmen\src\licensedcode\data\rules\apache-1.1_31.yml", "YAML", 0, 0, 0, 7, 0, 0, 1, 8
"d:\IDEWORK\lvmen\src\licensedcode\data\rules\apache-1.1_32.yml", "YAML", 0, 0, 0, 5, 0, 0, 1, 6
"d:\IDEWORK\lvmen\src\licensedcode\data\rules\apache-1.1_33.yml", "YAML", 0, 0, 0, 9, 0, 0, 1, 10
"d:\IDEWORK\lvmen\src\licensedcode\data\rules\apache-1.1_34.yml", "YAML", 0, 0, 0, 4, 0, 0, 1, 5
"d:\IDEWORK\lvmen\src\licensedcode\data\rules\apache-1.1_35.yml", "YAML", 0, 0, 0, 13, 0, 0, 1, 14
"d:\IDEWORK\lvmen\src\licensedcode\data\rules\apache-1.1_36.yml", "YAML", 0, 0, 0, 7, 0, 0, 1, 8
"d:\IDEWORK\lvmen\src\licensedcode\data\rules\apache-1.1_37.yml", "YAML", 0, 0, 0, 6, 0, 0, 1, 7
"d:\IDEWORK\lvmen\src\licensedcode\data\rules\apache-1.1_37_1.yml", "YAML", 0, 0, 0, 4, 0, 0, 1, 5
"d:\IDEWORK\lvmen\src\licensedcode\data\rules\apache-1.1_38.yml", "YAML", 0, 0, 0, 8, 0, 0, 1, 9
"d:\IDEWORK\lvmen\src\licensedcode\data\rules\apache-1.1_39.yml", "YAML", 0, 0, 0, 8, 0, 0, 1, 9
"d:\IDEWORK\lvmen\src\licensedcode\data\rules\apache-1.1_4.yml", "YAML", 0, 0, 0, 5, 0, 0, 1, 6
"d:\IDEWORK\lvmen\src\licensedcode\data\rules\apache-1.1_40.yml", "YAML", 0, 0, 0, 9, 0, 0, 1, 10
"d:\IDEWORK\lvmen\src\licensedcode\data\rules\apache-1.1_41.yml", "YAML", 0, 0, 0, 9, 0, 0, 1, 10
"d:\IDEWORK\lvmen\src\licensedcode\data\rules\apache-1.1_42.yml", "YAML", 0, 0, 0, 4, 0, 0, 1, 5
"d:\IDEWORK\lvmen\src\licensedcode\data\rules\apache-1.1_43.yml", "YAML", 0, 0, 0, 12, 0, 0, 1, 13
"d:\IDEWORK\lvmen\src\licensedcode\data\rules\apache-1.1_44.yml", "YAML", 0, 0, 0, 4, 0, 0, 1, 5
"d:\IDEWORK\lvmen\src\licensedcode\data\rules\apache-1.1_45.yml", "YAML", 0, 0, 0, 6, 0, 0, 1, 7
"d:\IDEWORK\lvmen\src\licensedcode\data\rules\apache-1.1_46.yml", "YAML", 0, 0, 0, 16, 0, 0, 1, 17
"d:\IDEWORK\lvmen\src\licensedcode\data\rules\apache-1.1_47.yml", "YAML", 0, 0, 0, 9, 0, 0, 1, 10
"d:\IDEWORK\lvmen\src\licensedcode\data\rules\apache-1.1_48.yml", "YAML", 0, 0, 0, 4, 0, 0, 1, 5
"d:\IDEWORK\lvmen\src\licensedcode\data\rules\apache-1.1_49.yml", "YAML", 0, 0, 0, 5, 0, 0, 1, 6
"d:\IDEWORK\lvmen\src\licensedcode\data\rules\apache-1.1_5.yml", "YAML", 0, 0, 0, 2, 0, 0, 1, 3
"d:\IDEWORK\lvmen\src\licensedcode\data\rules\apache-1.1_50.yml", "YAML", 0, 0, 0, 3, 0, 0, 1, 4
"d:\IDEWORK\lvmen\src\licensedcode\data\rules\apache-1.1_51.yml", "YAML", 0, 0, 0, 3, 0, 0, 1, 4
"d:\IDEWORK\lvmen\src\licensedcode\data\rules\apache-1.1_52.yml", "YAML", 0, 0, 0, 8, 0, 0, 1, 9
"d:\IDEWORK\lvmen\src\licensedcode\data\rules\apache-1.1_53.yml", "YAML", 0, 0, 0, 12, 0, 0, 1, 13
"d:\IDEWORK\lvmen\src\licensedcode\data\rules\apache-1.1_54.yml", "YAML", 0, 0, 0, 2, 0, 0, 1, 3
"d:\IDEWORK\lvmen\src\licensedcode\data\rules\apache-1.1_55.yml", "YAML", 0, 0, 0, 3, 0, 0, 1, 4
"d:\IDEWORK\lvmen\src\licensedcode\data\rules\apache-1.1_56.yml", "YAML", 0, 0, 0, 2, 0, 0, 1, 3
"d:\IDEWORK\lvmen\src\licensedcode\data\rules\apache-1.1_57.yml", "YAML", 0, 0, 0, 7, 0, 0, 1, 8
"d:\IDEWORK\lvmen\src\licensedcode\data\rules\apache-1.1_58.yml", "YAML", 0, 0, 0, 12, 0, 0, 1, 13
"d:\IDEWORK\lvmen\src\licensedcode\data\rules\apache-1.1_59.yml", "YAML", 0, 0, 0, 12, 0, 0, 1, 13
"d:\IDEWORK\lvmen\src\licensedcode\data\rules\apache-1.1_6.yml", "YAML", 0, 0, 0, 5, 0, 0, 1, 6
"d:\IDEWORK\lvmen\src\licensedcode\data\rules\apache-1.1_60.yml", "YAML", 0, 0, 0, 3, 0, 0, 2, 5
"d:\IDEWORK\lvmen\src\licensedcode\data\rules\apache-1.1_61.yml", "YAML", 0, 0, 0, 13, 0, 0, 1, 14
"d:\IDEWORK\lvmen\src\licensedcode\data\rules\apache-1.1_62.yml", "YAML", 0, 0, 0, 12, 0, 0, 1, 13
"d:\IDEWORK\lvmen\src\licensedcode\data\rules\apache-1.1_63.yml", "YAML", 0, 0, 0, 15, 0, 0, 1, 16
"d:\IDEWORK\lvmen\src\licensedcode\data\rules\apache-1.1_64.yml", "YAML", 0, 0, 0, 5, 0, 0, 1, 6
"d:\IDEWORK\lvmen\src\licensedcode\data\rules\apache-1.1_65.yml", "YAML", 0, 0, 0, 5, 0, 0, 1, 6
"d:\IDEWORK\lvmen\src\licensedcode\data\rules\apache-1.1_66.yml", "YAML", 0, 0, 0, 3, 0, 0, 1, 4
"d:\IDEWORK\lvmen\src\licensedcode\data\rules\apache-1.1_67.yml", "YAML", 0, 0, 0, 3, 0, 0, 1, 4
"d:\IDEWORK\lvmen\src\licensedcode\data\rules\apache-1.1_68.yml", "YAML", 0, 0, 0, 3, 0, 0, 1, 4
"d:\IDEWORK\lvmen\src\licensedcode\data\rules\apache-1.1_69.yml", "YAML", 0, 0, 0, 12, 0, 0, 1, 13
"d:\IDEWORK\lvmen\src\licensedcode\data\rules\apache-1.1_7.yml", "YAML", 0, 0, 0, 6, 0, 0, 1, 7
"d:\IDEWORK\lvmen\src\licensedcode\data\rules\apache-1.1_70.yml", "YAML", 0, 0, 0, 4, 0, 0, 1, 5
"d:\IDEWORK\lvmen\src\licensedcode\data\rules\apache-1.1_71.yml", "YAML", 0, 0, 0, 12, 0, 0, 1, 13
"d:\IDEWORK\lvmen\src\licensedcode\data\rules\apache-1.1_72.yml", "YAML", 0, 0, 0, 12, 0, 0, 1, 13
"d:\IDEWORK\lvmen\src\licensedcode\data\rules\apache-1.1_73.yml", "YAML", 0, 0, 0, 5, 0, 0, 1, 6
"d:\IDEWORK\lvmen\src\licensedcode\data\rules\apache-1.1_74.yml", "YAML", 0, 0, 0, 9, 0, 0, 1, 10
"d:\IDEWORK\lvmen\src\licensedcode\data\rules\apache-1.1_75.yml", "YAML", 0, 0, 0, 9, 0, 0, 1, 10
"d:\IDEWORK\lvmen\src\licensedcode\data\rules\apache-1.1_76.yml", "YAML", 0, 0, 0, 3, 0, 0, 1, 4
"d:\IDEWORK\lvmen\src\licensedcode\data\rules\apache-1.1_77.yml", "YAML", 0, 0, 0, 5, 0, 0, 2, 7
"d:\IDEWORK\lvmen\src\licensedcode\data\rules\apache-1.1_78.yml", "YAML", 0, 0, 0, 11, 0, 0, 1, 12
"d:\IDEWORK\lvmen\src\licensedcode\data\rules\apache-1.1_79.yml", "YAML", 0, 0, 0, 3, 0, 0, 1, 4
"d:\IDEWORK\lvmen\src\licensedcode\data\rules\apache-1.1_8.yml", "YAML", 0, 0, 0, 8, 0, 0, 1, 9
"d:\IDEWORK\lvmen\src\licensedcode\data\rules\apache-1.1_80.yml", "YAML", 0, 0, 0, 3, 0, 0, 1, 4
"d:\IDEWORK\lvmen\src\licensedcode\data\rules\apache-1.1_81.yml", "YAML", 0, 0, 0, 9, 0, 0, 1, 10
"d:\IDEWORK\lvmen\src\licensedcode\data\rules\apache-1.1_82.yml", "YAML", 0, 0, 0, 13, 0, 0, 1, 14
"d:\IDEWORK\lvmen\src\licensedcode\data\rules\apache-1.1_83.yml", "YAML", 0, 0, 0, 4, 0, 0, 1, 5
"d:\IDEWORK\lvmen\src\licensedcode\data\rules\apache-1.1_84.yml", "YAML", 0, 0, 0, 6, 0, 0, 1, 7
"d:\IDEWORK\lvmen\src\licensedcode\data\rules\apache-1.1_85.yml", "YAML", 0, 0, 0, 7, 0, 0, 1, 8
"d:\IDEWORK\lvmen\src\licensedcode\data\rules\apache-1.1_86.yml", "YAML", 0, 0, 0, 6, 0, 0, 1, 7
"d:\IDEWORK\lvmen\src\licensedcode\data\rules\apache-1.1_87.yml", "YAML", 0, 0, 0, 5, 0, 0, 1, 6
"d:\IDEWORK\lvmen\src\licensedcode\data\rules\apache-1.1_88.yml", "YAML", 0, 0, 0, 4, 0, 0, 1, 5
"d:\IDEWORK\lvmen\src\licensedcode\data\rules\apache-1.1_89.yml", "YAML", 0, 0, 0, 13, 0, 0, 1, 14
"d:\IDEWORK\lvmen\src\licensedcode\data\rules\apache-1.1_9.yml", "YAML", 0, 0, 0, 3, 0, 0, 1, 4
"d:\IDEWORK\lvmen\src\licensedcode\data\rules\apache-1.1_90.yml", "YAML", 0, 0, 0, 5, 0, 0, 1, 6
"d:\IDEWORK\lvmen\src\licensedcode\data\rules\apache-1.1_91.yml", "YAML", 0, 0, 0, 3, 0, 0, 1, 4
"d:\IDEWORK\lvmen\src\licensedcode\data\rules\apache-1.1_92.yml", "YAML", 0, 0, 0, 12, 0, 0, 1, 13
"d:\IDEWORK\lvmen\src\licensedcode\data\rules\apache-1.1_and_proprietary.yml", "YAML", 0, 0, 0, 6, 0, 0, 1, 7
"d:\IDEWORK\lvmen\src\licensedcode\data\rules\apache-1.1_cyberneko_1.yml", "YAML", 0, 0, 0, 4, 0, 0, 1, 5
"d:\IDEWORK\lvmen\src\licensedcode\data\rules\apache-1.1_cyberneko_2.yml", "YAML", 0, 0, 0, 3, 0, 0, 1, 4
"d:\IDEWORK\lvmen\src\licensedcode\data\rules\apache-1.1_cyberneko_3.yml", "YAML", 0, 0, 0, 3, 0, 0, 1, 4
"d:\IDEWORK\lvmen\src\licensedcode\data\rules\apache-1.1_url_1.yml", "YAML", 0, 0, 0, 5, 0, 0, 1, 6
"d:\IDEWORK\lvmen\src\licensedcode\data\rules\apache-1.1_url_2.yml", "YAML", 0, 0, 0, 5, 0, 0, 1, 6
"d:\IDEWORK\lvmen\src\licensedcode\data\rules\apache-1.1_url_glc_64.yml", "YAML", 0, 0, 0, 5, 0, 0, 1, 6
"d:\IDEWORK\lvmen\src\licensedcode\data\rules\apache-1.1_url_glc_65.yml", "YAML", 0, 0, 0, 5, 0, 0, 1, 6
"d:\IDEWORK\lvmen\src\licensedcode\data\rules\apache-2.0-oracle-glassfish.yml", "YAML", 0, 0, 0, 4, 0, 0, 1, 5
"d:\IDEWORK\lvmen\src\licensedcode\data\rules\apache-2.0.yml", "YAML", 0, 0, 0, 4, 0, 0, 1, 5
"d:\IDEWORK\lvmen\src\licensedcode\data\rules\apache-2.0_0.yml", "YAML", 0, 0, 0, 3, 0, 0, 1, 4
"d:\IDEWORK\lvmen\src\licensedcode\data\rules\apache-2.0_1.yml", "YAML", 0, 0, 0, 5, 0, 0, 1, 6
"d:\IDEWORK\lvmen\src\licensedcode\data\rules\apache-2.0_10.yml", "YAML", 0, 0, 0, 3, 0, 0, 1, 4
"d:\IDEWORK\lvmen\src\licensedcode\data\rules\apache-2.0_100.yml", "YAML", 0, 0, 0, 3, 0, 0, 1, 4
"d:\IDEWORK\lvmen\src\licensedcode\data\rules\apache-2.0_1000.yml", "YAML", 0, 0, 0, 8, 0, 0, 1, 9
"d:\IDEWORK\lvmen\src\licensedcode\data\rules\apache-2.0_1001.yml", "YAML", 0, 0, 0, 6, 0, 0, 1, 7
"d:\IDEWORK\lvmen\src\licensedcode\data\rules\apache-2.0_1002.yml", "YAML", 0, 0, 0, 8, 0, 0, 1, 9
"d:\IDEWORK\lvmen\src\licensedcode\data\rules\apache-2.0_1003.yml", "YAML", 0, 0, 0, 8, 0, 0, 1, 9
"d:\IDEWORK\lvmen\src\licensedcode\data\rules\apache-2.0_1004.yml", "YAML", 0, 0, 0, 8, 0, 0, 1, 9
"d:\IDEWORK\lvmen\src\licensedcode\data\rules\apache-2.0_1005.yml", "YAML", 0, 0, 0, 7, 0, 0, 1, 8
"d:\IDEWORK\lvmen\src\licensedcode\data\rules\apache-2.0_1006.yml", "YAML", 0, 0, 0, 8, 0, 0, 1, 9
"d:\IDEWORK\lvmen\src\licensedcode\data\rules\apache-2.0_1007.yml", "YAML", 0, 0, 0, 8, 0, 0, 1, 9
"d:\IDEWORK\lvmen\src\licensedcode\data\rules\apache-2.0_1008.yml", "YAML", 0, 0, 0, 5, 0, 0, 1, 6
"d:\IDEWORK\lvmen\src\licensedcode\data\rules\apache-2.0_1009.yml", "YAML", 0, 0, 0, 7, 0, 0, 1, 8
"d:\IDEWORK\lvmen\src\licensedcode\data\rules\apache-2.0_101.yml", "YAML", 0, 0, 0, 3, 0, 0, 1, 4
"d:\IDEWORK\lvmen\src\licensedcode\data\rules\apache-2.0_1010.yml", "YAML", 0, 0, 0, 6, 0, 0, 1, 7
"d:\IDEWORK\lvmen\src\licensedcode\data\rules\apache-2.0_1011.yml", "YAML", 0, 0, 0, 7, 0, 0, 1, 8
"d:\IDEWORK\lvmen\src\licensedcode\data\rules\apache-2.0_1012.yml", "YAML", 0, 0, 0, 5, 0, 0, 1, 6
"d:\IDEWORK\lvmen\src\licensedcode\data\rules\apache-2.0_1013.yml", "YAML", 0, 0, 0, 6, 0, 0, 1, 7
"d:\IDEWORK\lvmen\src\licensedcode\data\rules\apache-2.0_1014.yml", "YAML", 0, 0, 0, 6, 0, 0, 1, 7
"d:\IDEWORK\lvmen\src\licensedcode\data\rules\apache-2.0_1015.yml", "YAML", 0, 0, 0, 5, 0, 0, 1, 6
"d:\IDEWORK\lvmen\src\licensedcode\data\rules\apache-2.0_1016.yml", "YAML", 0, 0, 0, 7, 0, 0, 1, 8
"d:\IDEWORK\lvmen\src\licensedcode\data\rules\apache-2.0_1017.yml", "YAML", 0, 0, 0, 5, 0, 0, 1, 6
"d:\IDEWORK\lvmen\src\licensedcode\data\rules\apache-2.0_1018.yml", "YAML", 0, 0, 0, 4, 0, 0, 1, 5
"d:\IDEWORK\lvmen\src\licensedcode\data\rules\apache-2.0_1019.yml", "YAML", 0, 0, 0, 6, 0, 0, 1, 7
"d:\IDEWORK\lvmen\src\licensedcode\data\rules\apache-2.0_102.yml", "YAML", 0, 0, 0, 3, 0, 0, 1, 4
"d:\IDEWORK\lvmen\src\licensedcode\data\rules\apache-2.0_1020.yml", "YAML", 0, 0, 0, 4, 0, 0, 1, 5
"d:\IDEWORK\lvmen\src\licensedcode\data\rules\apache-2.0_1021.yml", "YAML", 0, 0, 0, 2, 0, 0, 1, 3
"d:\IDEWORK\lvmen\src\licensedcode\data\rules\apache-2.0_1022.yml", "YAML", 0, 0, 0, 3, 0, 0, 1, 4
"d:\IDEWORK\lvmen\src\licensedcode\data\rules\apache-2.0_1023.yml", "YAML", 0, 0, 0, 2, 0, 0, 1, 3
"d:\IDEWORK\lvmen\src\licensedcode\data\rules\apache-2.0_1024.yml", "YAML", 0, 0, 0, 3, 0, 0, 1, 4
"d:\IDEWORK\lvmen\src\licensedcode\data\rules\apache-2.0_1025.yml", "YAML", 0, 0, 0, 3, 0, 0, 1, 4
"d:\IDEWORK\lvmen\src\licensedcode\data\rules\apache-2.0_103.yml", "YAML", 0, 0, 0, 3, 0, 0, 1, 4
"d:\IDEWORK\lvmen\src\licensedcode\data\rules\apache-2.0_104.yml", "YAML", 0, 0, 0, 3, 0, 0, 1, 4
"d:\IDEWORK\lvmen\src\licensedcode\data\rules\apache-2.0_105.yml", "YAML", 0, 0, 0, 3, 0, 0, 1, 4
"d:\IDEWORK\lvmen\src\licensedcode\data\rules\apache-2.0_106.yml", "YAML", 0, 0, 0, 4, 0, 0, 1, 5
"d:\IDEWORK\lvmen\src\licensedcode\data\rules\apache-2.0_107.yml", "YAML", 0, 0, 0, 4, 0, 0, 1, 5
"d:\IDEWORK\lvmen\src\licensedcode\data\rules\apache-2.0_108.yml", "YAML", 0, 0, 0, 4, 0, 0, 1, 5
"d:\IDEWORK\lvmen\src\licensedcode\data\rules\apache-2.0_109.yml", "YAML", 0, 0, 0, 4, 0, 0, 1, 5
"d:\IDEWORK\lvmen\src\licensedcode\data\rules\apache-2.0_11.yml", "YAML", 0, 0, 0, 3, 0, 0, 1, 4
"d:\IDEWORK\lvmen\src\licensedcode\data\rules\apache-2.0_110.yml", "YAML", 0, 0, 0, 4, 0, 0, 1, 5
"d:\IDEWORK\lvmen\src\licensedcode\data\rules\apache-2.0_111.yml", "YAML", 0, 0, 0, 4, 0, 0, 1, 5
"d:\IDEWORK\lvmen\src\licensedcode\data\rules\apache-2.0_112.yml", "YAML", 0, 0, 0, 4, 0, 0, 1, 5
"d:\IDEWORK\lvmen\src\licensedcode\data\rules\apache-2.0_113.yml", "YAML", 0, 0, 0, 4, 0, 0, 1, 5
"d:\IDEWORK\lvmen\src\licensedcode\data\rules\apache-2.0_114.yml", "YAML", 0, 0, 0, 4, 0, 0, 1, 5
"d:\IDEWORK\lvmen\src\licensedcode\data\rules\apache-2.0_115.yml", "YAML", 0, 0, 0, 3, 0, 0, 1, 4
"d:\IDEWORK\lvmen\src\licensedcode\data\rules\apache-2.0_116.yml", "YAML", 0, 0, 0, 4, 0, 0, 1, 5
"d:\IDEWORK\lvmen\src\licensedcode\data\rules\apache-2.0_117.yml", "YAML", 0, 0, 0, 5, 0, 0, 1, 6
"d:\IDEWORK\lvmen\src\licensedcode\data\rules\apache-2.0_118.yml", "YAML", 0, 0, 0, 3, 0, 0, 1, 4
"d:\IDEWORK\lvmen\src\licensedcode\data\rules\apache-2.0_119.yml", "YAML", 0, 0, 0, 3, 0, 0, 1, 4
"d:\IDEWORK\lvmen\src\licensedcode\data\rules\apache-2.0_12.yml", "YAML", 0, 0, 0, 6, 0, 0, 1, 7
"d:\IDEWORK\lvmen\src\licensedcode\data\rules\apache-2.0_120.yml", "YAML", 0, 0, 0, 5, 0, 0, 1, 6
"d:\IDEWORK\lvmen\src\licensedcode\data\rules\apache-2.0_121.yml", "YAML", 0, 0, 0, 4, 0, 0, 1, 5
"d:\IDEWORK\lvmen\src\licensedcode\data\rules\apache-2.0_122.yml", "YAML", 0, 0, 0, 5, 0, 0, 1, 6
"d:\IDEWORK\lvmen\src\licensedcode\data\rules\apache-2.0_122_2.yml", "YAML", 0, 0, 0, 5, 0, 0, 1, 6
"d:\IDEWORK\lvmen\src\licensedcode\data\rules\apache-2.0_122_3.yml", "YAML", 0, 0, 0, 5, 0, 0, 1, 6
"d:\IDEWORK\lvmen\src\licensedcode\data\rules\apache-2.0_123.yml", "YAML", 0, 0, 0, 5, 0, 0, 1, 6
"d:\IDEWORK\lvmen\src\licensedcode\data\rules\apache-2.0_124.yml", "YAML", 0, 0, 0, 4, 0, 0, 1, 5
"d:\IDEWORK\lvmen\src\licensedcode\data\rules\apache-2.0_125.yml", "YAML", 0, 0, 0, 5, 0, 0, 1, 6
"d:\IDEWORK\lvmen\src\licensedcode\data\rules\apache-2.0_126.yml", "YAML", 0, 0, 0, 5, 0, 0, 1, 6
"d:\IDEWORK\lvmen\src\licensedcode\data\rules\apache-2.0_127.yml", "YAML", 0, 0, 0, 5, 0, 0, 1, 6
"d:\IDEWORK\lvmen\src\licensedcode\data\rules\apache-2.0_128.yml", "YAML", 0, 0, 0, 5, 0, 0, 1, 6
"d:\IDEWORK\lvmen\src\licensedcode\data\rules\apache-2.0_129.yml", "YAML", 0, 0, 0, 5, 0, 0, 1, 6
"d:\IDEWORK\lvmen\src\licensedcode\data\rules\apache-2.0_13.yml", "YAML", 0, 0, 0, 5, 0, 0, 1, 6
"d:\IDEWORK\lvmen\src\licensedcode\data\rules\apache-2.0_130.yml", "YAML", 0, 0, 0, 5, 0, 0, 1, 6
"d:\IDEWORK\lvmen\src\licensedcode\data\rules\apache-2.0_131.yml", "YAML", 0, 0, 0, 5, 0, 0, 1, 6
"d:\IDEWORK\lvmen\src\licensedcode\data\rules\apache-2.0_132.yml", "YAML", 0, 0, 0, 3, 0, 0, 1, 4
"d:\IDEWORK\lvmen\src\licensedcode\data\rules\apache-2.0_133.yml", "YAML", 0, 0, 0, 4, 0, 0, 1, 5
"d:\IDEWORK\lvmen\src\licensedcode\data\rules\apache-2.0_134.yml", "YAML", 0, 0, 0, 4, 0, 0, 1, 5
"d:\IDEWORK\lvmen\src\licensedcode\data\rules\apache-2.0_135.yml", "YAML", 0, 0, 0, 3, 0, 0, 1, 4
"d:\IDEWORK\lvmen\src\licensedcode\data\rules\apache-2.0_135_1.yml", "YAML", 0, 0, 0, 8, 0, 0, 1, 9
"d:\IDEWORK\lvmen\src\licensedcode\data\rules\apache-2.0_136.yml", "YAML", 0, 0, 0, 5, 0, 0, 1, 6
"d:\IDEWORK\lvmen\src\licensedcode\data\rules\apache-2.0_137.yml", "YAML", 0, 0, 0, 3, 0, 0, 1, 4
"d:\IDEWORK\lvmen\src\licensedcode\data\rules\apache-2.0_138.yml", "YAML", 0, 0, 0, 3, 0, 0, 1, 4
"d:\IDEWORK\lvmen\src\licensedcode\data\rules\apache-2.0_139.yml", "YAML", 0, 0, 0, 4, 0, 0, 1, 5
"d:\IDEWORK\lvmen\src\licensedcode\data\rules\apache-2.0_14.yml", "YAML", 0, 0, 0, 4, 0, 0, 1, 5
"d:\IDEWORK\lvmen\src\licensedcode\data\rules\apache-2.0_140.yml", "YAML", 0, 0, 0, 4, 0, 0, 1, 5
"d:\IDEWORK\lvmen\src\licensedcode\data\rules\apache-2.0_141.yml", "YAML", 0, 0, 0, 3, 0, 0, 1, 4
"d:\IDEWORK\lvmen\src\licensedcode\data\rules\apache-2.0_142.yml", "YAML", 0, 0, 0, 3, 0, 0, 1, 4
"d:\IDEWORK\lvmen\src\licensedcode\data\rules\apache-2.0_143.yml", "YAML", 0, 0, 0, 5, 0, 0, 1, 6
"d:\IDEWORK\lvmen\src\licensedcode\data\rules\apache-2.0_144.yml", "YAML", 0, 0, 0, 5, 0, 0, 1, 6
"d:\IDEWORK\lvmen\src\licensedcode\data\rules\apache-2.0_145.yml", "YAML", 0, 0, 0, 5, 0, 0, 1, 6
"d:\IDEWORK\lvmen\src\licensedcode\data\rules\apache-2.0_146.yml", "YAML", 0, 0, 0, 5, 0, 0, 1, 6
"d:\IDEWORK\lvmen\src\licensedcode\data\rules\apache-2.0_147.yml", "YAML", 0, 0, 0, 5, 0, 0, 1, 6
"d:\IDEWORK\lvmen\src\licensedcode\data\rules\apache-2.0_148.yml", "YAML", 0, 0, 0, 3, 0, 0, 1, 4
"d:\IDEWORK\lvmen\src\licensedcode\data\rules\apache-2.0_149.yml", "YAML", 0, 0, 0, 6, 0, 0, 1, 7
"d:\IDEWORK\lvmen\src\licensedcode\data\rules\apache-2.0_15.yml", "YAML", 0, 0, 0, 5, 0, 0, 1, 6
"d:\IDEWORK\lvmen\src\licensedcode\data\rules\apache-2.0_150.yml", "YAML", 0, 0, 0, 3, 0, 0, 1, 4
"d:\IDEWORK\lvmen\src\licensedcode\data\rules\apache-2.0_151.yml", "YAML", 0, 0, 0, 3, 0, 0, 1, 4
"d:\IDEWORK\lvmen\src\licensedcode\data\rules\apache-2.0_152.yml", "YAML", 0, 0, 0, 3, 0, 0, 1, 4
"d:\IDEWORK\lvmen\src\licensedcode\data\rules\apache-2.0_153.yml", "YAML", 0, 0, 0, 3, 0, 0, 1, 4
"d:\IDEWORK\lvmen\src\licensedcode\data\rules\apache-2.0_154.yml", "YAML", 0, 0, 0, 6, 0, 0, 1, 7
"d:\IDEWORK\lvmen\src\licensedcode\data\rules\apache-2.0_155.yml", "YAML", 0, 0, 0, 3, 0, 0, 1, 4
"d:\IDEWORK\lvmen\src\licensedcode\data\rules\apache-2.0_156.yml", "YAML", 0, 0, 0, 3, 0, 0, 1, 4
"d:\IDEWORK\lvmen\src\licensedcode\data\rules\apache-2.0_157.yml", "YAML", 0, 0, 0, 5, 0, 0, 1, 6
"d:\IDEWORK\lvmen\src\licensedcode\data\rules\apache-2.0_158.yml", "YAML", 0, 0, 0, 5, 0, 0, 1, 6
"d:\IDEWORK\lvmen\src\licensedcode\data\rules\apache-2.0_159.yml", "YAML", 0, 0, 0, 5, 0, 0, 1, 6
"d:\IDEWORK\lvmen\src\licensedcode\data\rules\apache-2.0_16.yml", "YAML", 0, 0, 0, 3, 0, 0, 1, 4
"d:\IDEWORK\lvmen\src\licensedcode\data\rules\apache-2.0_160.yml", "YAML", 0, 0, 0, 5, 0, 0, 1, 6
"d:\IDEWORK\lvmen\src\licensedcode\data\rules\apache-2.0_161.yml", "YAML", 0, 0, 0, 3, 0, 0, 1, 4
"d:\IDEWORK\lvmen\src\licensedcode\data\rules\apache-2.0_162.yml", "YAML", 0, 0, 0, 4, 0, 0, 1, 5
"d:\IDEWORK\lvmen\src\licensedcode\data\rules\apache-2.0_163.yml", "YAML", 0, 0, 0, 2, 0, 0, 1, 3
"d:\IDEWORK\lvmen\src\licensedcode\data\rules\apache-2.0_164.yml", "YAML", 0, 0, 0, 6, 0, 0, 1, 7
"d:\IDEWORK\lvmen\src\licensedcode\data\rules\apache-2.0_165.yml", "YAML", 0, 0, 0, 5, 0, 0, 1, 6
"d:\IDEWORK\lvmen\src\licensedcode\data\rules\apache-2.0_166.yml", "YAML", 0, 0, 0, 5, 0, 0, 1, 6
"d:\IDEWORK\lvmen\src\licensedcode\data\rules\apache-2.0_167.yml", "YAML", 0, 0, 0, 5, 0, 0, 1, 6
"d:\IDEWORK\lvmen\src\licensedcode\data\rules\apache-2.0_168.yml", "YAML", 0, 0, 0, 3, 0, 0, 1, 4
"d:\IDEWORK\lvmen\src\licensedcode\data\rules\apache-2.0_169.yml", "YAML", 0, 0, 0, 5, 0, 0, 1, 6
"d:\IDEWORK\lvmen\src\licensedcode\data\rules\apache-2.0_17.yml", "YAML", 0, 0, 0, 4, 0, 0, 1, 5
"d:\IDEWORK\lvmen\src\licensedcode\data\rules\apache-2.0_170.yml", "YAML", 0, 0, 0, 5, 0, 0, 1, 6
"d:\IDEWORK\lvmen\src\licensedcode\data\rules\apache-2.0_171.yml", "YAML", 0, 0, 0, 5, 0, 0, 1, 6
"d:\IDEWORK\lvmen\src\licensedcode\data\rules\apache-2.0_172.yml", "YAML", 0, 0, 0, 5, 0, 0, 1, 6
"d:\IDEWORK\lvmen\src\licensedcode\data\rules\apache-2.0_173.yml", "YAML", 0, 0, 0, 5, 0, 0, 1, 6
"d:\IDEWORK\lvmen\src\licensedcode\data\rules\apache-2.0_174.yml", "YAML", 0, 0, 0, 3, 0, 0, 1, 4
"d:\IDEWORK\lvmen\src\licensedcode\data\rules\apache-2.0_175.yml", "YAML", 0, 0, 0, 3, 0, 0, 1, 4
"d:\IDEWORK\lvmen\src\licensedcode\data\rules\apache-2.0_176.yml", "YAML", 0, 0, 0, 3, 0, 0, 1, 4
"d:\IDEWORK\lvmen\src\licensedcode\data\rules\apache-2.0_177.yml", "YAML", 0, 0, 0, 5, 0, 0, 1, 6
"d:\IDEWORK\lvmen\src\licensedcode\data\rules\apache-2.0_178.yml", "YAML", 0, 0, 0, 5, 0, 0, 1, 6
"d:\IDEWORK\lvmen\src\licensedcode\data\rules\apache-2.0_179.yml", "YAML", 0, 0, 0, 5, 0, 0, 1, 6
"d:\IDEWORK\lvmen\src\licensedcode\data\rules\apache-2.0_18.yml", "YAML", 0, 0, 0, 3, 0, 0, 1, 4
"d:\IDEWORK\lvmen\src\licensedcode\data\rules\apache-2.0_180.yml", "YAML", 0, 0, 0, 3, 0, 0, 1, 4
"d:\IDEWORK\lvmen\src\licensedcode\data\rules\apache-2.0_181.yml", "YAML", 0, 0, 0, 5, 0, 0, 1, 6
"d:\IDEWORK\lvmen\src\licensedcode\data\rules\apache-2.0_182.yml", "YAML", 0, 0, 0, 3, 0, 0, 1, 4
"d:\IDEWORK\lvmen\src\licensedcode\data\rules\apache-2.0_183.yml", "YAML", 0, 0, 0, 3, 0, 0, 1, 4
"d:\IDEWORK\lvmen\src\licensedcode\data\rules\apache-2.0_184.yml", "YAML", 0, 0, 0, 5, 0, 0, 1, 6
"d:\IDEWORK\lvmen\src\licensedcode\data\rules\apache-2.0_185.yml", "YAML", 0, 0, 0, 3, 0, 0, 1, 4
"d:\IDEWORK\lvmen\src\licensedcode\data\rules\apache-2.0_186.yml", "YAML", 0, 0, 0, 5, 0, 0, 1, 6
"d:\IDEWORK\lvmen\src\licensedcode\data\rules\apache-2.0_187.yml", "YAML", 0, 0, 0, 5, 0, 0, 1, 6
"d:\IDEWORK\lvmen\src\licensedcode\data\rules\apache-2.0_188.yml", "YAML", 0, 0, 0, 5, 0, 0, 1, 6
"d:\IDEWORK\lvmen\src\licensedcode\data\rules\apache-2.0_189.yml", "YAML", 0, 0, 0, 5, 0, 0, 1, 6
"d:\IDEWORK\lvmen\src\licensedcode\data\rules\apache-2.0_19.yml", "YAML", 0, 0, 0, 6, 0, 0, 1, 7
"d:\IDEWORK\lvmen\src\licensedcode\data\rules\apache-2.0_190.yml", "YAML", 0, 0, 0, 5, 0, 0, 1, 6
"d:\IDEWORK\lvmen\src\licensedcode\data\rules\apache-2.0_191.yml", "YAML", 0, 0, 0, 5, 0, 0, 1, 6
"d:\IDEWORK\lvmen\src\licensedcode\data\rules\apache-2.0_192.yml", "YAML", 0, 0, 0, 5, 0, 0, 1, 6
"d:\IDEWORK\lvmen\src\licensedcode\data\rules\apache-2.0_193.yml", "YAML", 0, 0, 0, 5, 0, 0, 1, 6
"d:\IDEWORK\lvmen\src\licensedcode\data\rules\apache-2.0_194.yml", "YAML", 0, 0, 0, 5, 0, 0, 1, 6
"d:\IDEWORK\lvmen\src\licensedcode\data\rules\apache-2.0_195.yml", "YAML", 0, 0, 0, 5, 0, 0, 1, 6
"d:\IDEWORK\lvmen\src\licensedcode\data\rules\apache-2.0_196.yml", "YAML", 0, 0, 0, 5, 0, 0, 1, 6
"d:\IDEWORK\lvmen\src\licensedcode\data\rules\apache-2.0_197.yml", "YAML", 0, 0, 0, 5, 0, 0, 1, 6
"d:\IDEWORK\lvmen\src\licensedcode\data\rules\apache-2.0_198.yml", "YAML", 0, 0, 0, 5, 0, 0, 1, 6
"d:\IDEWORK\lvmen\src\licensedcode\data\rules\apache-2.0_199.yml", "YAML", 0, 0, 0, 5, 0, 0, 1, 6
"d:\IDEWORK\lvmen\src\licensedcode\data\rules\apache-2.0_2.yml", "YAML", 0, 0, 0, 7, 0, 0, 1, 8
"d:\IDEWORK\lvmen\src\licensedcode\data\rules\apache-2.0_20.yml", "YAML", 0, 0, 0, 5, 0, 0, 1, 6
"d:\IDEWORK\lvmen\src\licensedcode\data\rules\apache-2.0_200.yml", "YAML", 0, 0, 0, 5, 0, 0, 1, 6
"d:\IDEWORK\lvmen\src\licensedcode\data\rules\apache-2.0_201.yml", "YAML", 0, 0, 0, 5, 0, 0, 1, 6
"d:\IDEWORK\lvmen\src\licensedcode\data\rules\apache-2.0_202.yml", "YAML", 0, 0, 0, 5, 0, 0, 1, 6
"d:\IDEWORK\lvmen\src\licensedcode\data\rules\apache-2.0_203.yml", "YAML", 0, 0, 0, 5, 0, 0, 1, 6
"d:\IDEWORK\lvmen\src\licensedcode\data\rules\apache-2.0_204.yml", "YAML", 0, 0, 0, 5, 0, 0, 1, 6
"d:\IDEWORK\lvmen\src\licensedcode\data\rules\apache-2.0_205.yml", "YAML", 0, 0, 0, 5, 0, 0, 1, 6
"d:\IDEWORK\lvmen\src\licensedcode\data\rules\apache-2.0_206.yml", "YAML", 0, 0, 0, 5, 0, 0, 1, 6
"d:\IDEWORK\lvmen\src\licensedcode\data\rules\apache-2.0_207.yml", "YAML", 0, 0, 0, 5, 0, 0, 1, 6
"d:\IDEWORK\lvmen\src\licensedcode\data\rules\apache-2.0_208.yml", "YAML", 0, 0, 0, 5, 0, 0, 1, 6
"d:\IDEWORK\lvmen\src\licensedcode\data\rules\apache-2.0_209.yml", "YAML", 0, 0, 0, 3, 0, 0, 1, 4
"d:\IDEWORK\lvmen\src\licensedcode\data\rules\apache-2.0_21.yml", "YAML", 0, 0, 0, 5, 0, 0, 1, 6
"d:\IDEWORK\lvmen\src\licensedcode\data\rules\apache-2.0_210.yml", "YAML", 0, 0, 0, 5, 0, 0, 1, 6
"d:\IDEWORK\lvmen\src\licensedcode\data\rules\apache-2.0_211.yml", "YAML", 0, 0, 0, 5, 0, 0, 1, 6
"d:\IDEWORK\lvmen\src\licensedcode\data\rules\apache-2.0_212.yml", "YAML", 0, 0, 0, 5, 0, 0, 1, 6
"d:\IDEWORK\lvmen\src\licensedcode\data\rules\apache-2.0_213.yml", "YAML", 0, 0, 0, 5, 0, 0, 1, 6
"d:\IDEWORK\lvmen\src\licensedcode\data\rules\apache-2.0_214.yml", "YAML", 0, 0, 0, 5, 0, 0, 1, 6
"d:\IDEWORK\lvmen\src\licensedcode\data\rules\apache-2.0_215.yml", "YAML", 0, 0, 0, 3, 0, 0, 1, 4
"d:\IDEWORK\lvmen\src\licensedcode\data\rules\apache-2.0_216.yml", "YAML", 0, 0, 0, 5, 0, 0, 1, 6
"d:\IDEWORK\lvmen\src\licensedcode\data\rules\apache-2.0_217.yml", "YAML", 0, 0, 0, 5, 0, 0, 1, 6
"d:\IDEWORK\lvmen\src\licensedcode\data\rules\apache-2.0_218.yml", "YAML", 0, 0, 0, 3, 0, 0, 1, 4
"d:\IDEWORK\lvmen\src\licensedcode\data\rules\apache-2.0_219.yml", "YAML", 0, 0, 0, 4, 0, 0, 1, 5
"d:\IDEWORK\lvmen\src\licensedcode\data\rules\apache-2.0_22.yml", "YAML", 0, 0, 0, 5, 0, 0, 1, 6
"d:\IDEWORK\lvmen\src\licensedcode\data\rules\apache-2.0_220.yml", "YAML", 0, 0, 0, 3, 0, 0, 1, 4
"d:\IDEWORK\lvmen\src\licensedcode\data\rules\apache-2.0_221.yml", "YAML", 0, 0, 0, 3, 0, 0, 1, 4
"d:\IDEWORK\lvmen\src\licensedcode\data\rules\apache-2.0_222.yml", "YAML", 0, 0, 0, 5, 0, 0, 1, 6
"d:\IDEWORK\lvmen\src\licensedcode\data\rules\apache-2.0_223.yml", "YAML", 0, 0, 0, 3, 0, 0, 1, 4
"d:\IDEWORK\lvmen\src\licensedcode\data\rules\apache-2.0_224.yml", "YAML", 0, 0, 0, 3, 0, 0, 1, 4
"d:\IDEWORK\lvmen\src\licensedcode\data\rules\apache-2.0_225.yml", "YAML", 0, 0, 0, 3, 0, 0, 1, 4
"d:\IDEWORK\lvmen\src\licensedcode\data\rules\apache-2.0_226.yml", "YAML", 0, 0, 0, 6, 0, 0, 1, 7
"d:\IDEWORK\lvmen\src\licensedcode\data\rules\apache-2.0_227.yml", "YAML", 0, 0, 0, 6, 0, 0, 1, 7
"d:\IDEWORK\lvmen\src\licensedcode\data\rules\apache-2.0_228.yml", "YAML", 0, 0, 0, 4, 0, 0, 1, 5
"d:\IDEWORK\lvmen\src\licensedcode\data\rules\apache-2.0_229.yml", "YAML", 0, 0, 0, 5, 0, 0, 1, 6
"d:\IDEWORK\lvmen\src\licensedcode\data\rules\apache-2.0_23.yml", "YAML", 0, 0, 0, 4, 0, 0, 1, 5
"d:\IDEWORK\lvmen\src\licensedcode\data\rules\apache-2.0_230.yml", "YAML", 0, 0, 0, 3, 0, 0, 1, 4
"d:\IDEWORK\lvmen\src\licensedcode\data\rules\apache-2.0_231.yml", "YAML", 0, 0, 0, 8, 0, 0, 1, 9
"d:\IDEWORK\lvmen\src\licensedcode\data\rules\apache-2.0_232.yml", "YAML", 0, 0, 0, 6, 0, 0, 1, 7
"d:\IDEWORK\lvmen\src\licensedcode\data\rules\apache-2.0_233.yml", "YAML", 0, 0, 0, 4, 0, 0, 1, 5
"d:\IDEWORK\lvmen\src\licensedcode\data\rules\apache-2.0_234.yml", "YAML", 0, 0, 0, 3, 0, 0, 1, 4
"d:\IDEWORK\lvmen\src\licensedcode\data\rules\apache-2.0_235.yml", "YAML", 0, 0, 0, 5, 0, 0, 1, 6
"d:\IDEWORK\lvmen\src\licensedcode\data\rules\apache-2.0_236.yml", "YAML", 0, 0, 0, 5, 0, 0, 1, 6
"d:\IDEWORK\lvmen\src\licensedcode\data\rules\apache-2.0_237.yml", "YAML", 0, 0, 0, 3, 0, 0, 1, 4
"d:\IDEWORK\lvmen\src\licensedcode\data\rules\apache-2.0_238.yml", "YAML", 0, 0, 0, 3, 0, 0, 1, 4
"d:\IDEWORK\lvmen\src\licensedcode\data\rules\apache-2.0_239.yml", "YAML", 0, 0, 0, 3, 0, 0, 1, 4
"d:\IDEWORK\lvmen\src\licensedcode\data\rules\apache-2.0_24.yml", "YAML", 0, 0, 0, 5, 0, 0, 1, 6
"d:\IDEWORK\lvmen\src\licensedcode\data\rules\apache-2.0_240.yml", "YAML", 0, 0, 0, 6, 0, 0, 1, 7
"d:\IDEWORK\lvmen\src\licensedcode\data\rules\apache-2.0_241.yml", "YAML", 0, 0, 0, 8, 0, 0, 1, 9
"d:\IDEWORK\lvmen\src\licensedcode\data\rules\apache-2.0_242.yml", "YAML", 0, 0, 0, 5, 0, 0, 1, 6
"d:\IDEWORK\lvmen\src\licensedcode\data\rules\apache-2.0_243.yml", "YAML", 0, 0, 0, 5, 0, 0, 1, 6
"d:\IDEWORK\lvmen\src\licensedcode\data\rules\apache-2.0_244.yml", "YAML", 0, 0, 0, 5, 0, 0, 1, 6
"d:\IDEWORK\lvmen\src\licensedcode\data\rules\apache-2.0_245.yml", "YAML", 0, 0, 0, 5, 0, 0, 1, 6
"d:\IDEWORK\lvmen\src\licensedcode\data\rules\apache-2.0_246.yml", "YAML", 0, 0, 0, 5, 0, 0, 1, 6
"d:\IDEWORK\lvmen\src\licensedcode\data\rules\apache-2.0_247.yml", "YAML", 0, 0, 0, 3, 0, 0, 1, 4
"d:\IDEWORK\lvmen\src\licensedcode\data\rules\apache-2.0_248.yml", "YAML", 0, 0, 0, 5, 0, 0, 1, 6
"d:\IDEWORK\lvmen\src\licensedcode\data\rules\apache-2.0_249.yml", "YAML", 0, 0, 0, 5, 0, 0, 1, 6
"d:\IDEWORK\lvmen\src\licensedcode\data\rules\apache-2.0_25.yml", "YAML", 0, 0, 0, 5, 0, 0, 1, 6
"d:\IDEWORK\lvmen\src\licensedcode\data\rules\apache-2.0_250.yml", "YAML", 0, 0, 0, 3, 0, 0, 1, 4
"d:\IDEWORK\lvmen\src\licensedcode\data\rules\apache-2.0_251.yml", "YAML", 0, 0, 0, 3, 0, 0, 1, 4
"d:\IDEWORK\lvmen\src\licensedcode\data\rules\apache-2.0_252.yml", "YAML", 0, 0, 0, 3, 0, 0, 1, 4
"d:\IDEWORK\lvmen\src\licensedcode\data\rules\apache-2.0_253.yml", "YAML", 0, 0, 0, 5, 0, 0, 1, 6
"d:\IDEWORK\lvmen\src\licensedcode\data\rules\apache-2.0_254.yml", "YAML", 0, 0, 0, 5, 0, 0, 1, 6
"d:\IDEWORK\lvmen\src\licensedcode\data\rules\apache-2.0_255.yml", "YAML", 0, 0, 0, 6, 0, 0, 1, 7
"d:\IDEWORK\lvmen\src\licensedcode\data\rules\apache-2.0_256.yml", "YAML", 0, 0, 0, 5, 0, 0, 1, 6
"d:\IDEWORK\lvmen\src\licensedcode\data\rules\apache-2.0_257.yml", "YAML", 0, 0, 0, 5, 0, 0, 1, 6
"d:\IDEWORK\lvmen\src\licensedcode\data\rules\apache-2.0_258.yml", "YAML", 0, 0, 0, 5, 0, 0, 1, 6
"d:\IDEWORK\lvmen\src\licensedcode\data\rules\apache-2.0_259.yml", "YAML", 0, 0, 0, 6, 0, 0, 1, 7
"d:\IDEWORK\lvmen\src\licensedcode\data\rules\apache-2.0_25_notice.yml", "YAML", 0, 0, 0, 6, 0, 0, 1, 7
"d:\IDEWORK\lvmen\src\licensedcode\data\rules\apache-2.0_26.yml", "YAML", 0, 0, 0, 3, 0, 0, 1, 4
"d:\IDEWORK\lvmen\src\licensedcode\data\rules\apache-2.0_260.yml", "YAML", 0, 0, 0, 4, 0, 0, 1, 5
"d:\IDEWORK\lvmen\src\licensedcode\data\rules\apache-2.0_261.yml", "YAML", 0, 0, 0, 3, 0, 0, 1, 4
"d:\IDEWORK\lvmen\src\licensedcode\data\rules\apache-2.0_262.yml", "YAML", 0, 0, 0, 3, 0, 0, 1, 4
"d:\IDEWORK\lvmen\src\licensedcode\data\rules\apache-2.0_263.yml", "YAML", 0, 0, 0, 5, 0, 0, 1, 6
"d:\IDEWORK\lvmen\src\licensedcode\data\rules\apache-2.0_264.yml", "YAML", 0, 0, 0, 3, 0, 0, 1, 4
"d:\IDEWORK\lvmen\src\licensedcode\data\rules\apache-2.0_265.yml", "YAML", 0, 0, 0, 5, 0, 0, 1, 6
"d:\IDEWORK\lvmen\src\licensedcode\data\rules\apache-2.0_266.yml", "YAML", 0, 0, 0, 3, 0, 0, 1, 4
"d:\IDEWORK\lvmen\src\licensedcode\data\rules\apache-2.0_267.yml", "YAML", 0, 0, 0, 3, 0, 0, 1, 4
"d:\IDEWORK\lvmen\src\licensedcode\data\rules\apache-2.0_268.yml", "YAML", 0, 0, 0, 5, 0, 0, 1, 6
"d:\IDEWORK\lvmen\src\licensedcode\data\rules\apache-2.0_269.yml", "YAML", 0, 0, 0, 5, 0, 0, 1, 6
"d:\IDEWORK\lvmen\src\licensedcode\data\rules\apache-2.0_27.yml", "YAML", 0, 0, 0, 3, 0, 0, 1, 4
"d:\IDEWORK\lvmen\src\licensedcode\data\rules\apache-2.0_270.yml", "YAML", 0, 0, 0, 5, 0, 0, 1, 6
"d:\IDEWORK\lvmen\src\licensedcode\data\rules\apache-2.0_271.yml", "YAML", 0, 0, 0, 5, 0, 0, 1, 6
"d:\IDEWORK\lvmen\src\licensedcode\data\rules\apache-2.0_272.yml", "YAML", 0, 0, 0, 5, 0, 0, 1, 6
"d:\IDEWORK\lvmen\src\licensedcode\data\rules\apache-2.0_273.yml", "YAML", 0, 0, 0, 5, 0, 0, 1, 6
"d:\IDEWORK\lvmen\src\licensedcode\data\rules\apache-2.0_274.yml", "YAML", 0, 0, 0, 5, 0, 0, 1, 6
"d:\IDEWORK\lvmen\src\licensedcode\data\rules\apache-2.0_275.yml", "YAML", 0, 0, 0, 5, 0, 0, 1, 6
"d:\IDEWORK\lvmen\src\licensedcode\data\rules\apache-2.0_276.yml", "YAML", 0, 0, 0, 5, 0, 0, 1, 6
"d:\IDEWORK\lvmen\src\licensedcode\data\rules\apache-2.0_277.yml", "YAML", 0, 0, 0, 5, 0, 0, 1, 6
"d:\IDEWORK\lvmen\src\licensedcode\data\rules\apache-2.0_278.yml", "YAML", 0, 0, 0, 5, 0, 0, 1, 6
"d:\IDEWORK\lvmen\src\licensedcode\data\rules\apache-2.0_279.yml", "YAML", 0, 0, 0, 5, 0, 0, 1, 6
"d:\IDEWORK\lvmen\src\licensedcode\data\rules\apache-2.0_28.yml", "YAML", 0, 0, 0, 3, 0, 0, 1, 4
"d:\IDEWORK\lvmen\src\licensedcode\data\rules\apache-2.0_280.yml", "YAML", 0, 0, 0, 5, 0, 0, 1, 6
"d:\IDEWORK\lvmen\src\licensedcode\data\rules\apache-2.0_281.yml", "YAML", 0, 0, 0, 5, 0, 0, 1, 6
"d:\IDEWORK\lvmen\src\licensedcode\data\rules\apache-2.0_282.yml", "YAML", 0, 0, 0, 5, 0, 0, 1, 6
"d:\IDEWORK\lvmen\src\licensedcode\data\rules\apache-2.0_283.yml", "YAML", 0, 0, 0, 5, 0, 0, 1, 6
"d:\IDEWORK\lvmen\src\licensedcode\data\rules\apache-2.0_284.yml", "YAML", 0, 0, 0, 3, 0, 0, 1, 4
"d:\IDEWORK\lvmen\src\licensedcode\data\rules\apache-2.0_285.yml", "YAML", 0, 0, 0, 5, 0, 0, 1, 6
"d:\IDEWORK\lvmen\src\licensedcode\data\rules\apache-2.0_286.yml", "YAML", 0, 0, 0, 5, 0, 0, 1, 6
"d:\IDEWORK\lvmen\src\licensedcode\data\rules\apache-2.0_287.yml", "YAML", 0, 0, 0, 5, 0, 0, 1, 6
"d:\IDEWORK\lvmen\src\licensedcode\data\rules\apache-2.0_288.yml", "YAML", 0, 0, 0, 5, 0, 0, 1, 6
"d:\IDEWORK\lvmen\src\licensedcode\data\rules\apache-2.0_289.yml", "YAML", 0, 0, 0, 5, 0, 0, 1, 6
"d:\IDEWORK\lvmen\src\licensedcode\data\rules\apache-2.0_29.yml", "YAML", 0, 0, 0, 3, 0, 0, 1, 4
"d:\IDEWORK\lvmen\src\licensedcode\data\rules\apache-2.0_290.yml", "YAML", 0, 0, 0, 3, 0, 0, 1, 4
"d:\IDEWORK\lvmen\src\licensedcode\data\rules\apache-2.0_291.yml", "YAML", 0, 0, 0, 3, 0, 0, 1, 4
"d:\IDEWORK\lvmen\src\licensedcode\data\rules\apache-2.0_292.yml", "YAML", 0, 0, 0, 3, 0, 0, 1, 4
"d:\IDEWORK\lvmen\src\licensedcode\data\rules\apache-2.0_293.yml", "YAML", 0, 0, 0, 3, 0, 0, 1, 4
"d:\IDEWORK\lvmen\src\licensedcode\data\rules\apache-2.0_294.yml", "YAML", 0, 0, 0, 5, 0, 0, 1, 6
"d:\IDEWORK\lvmen\src\licensedcode\data\rules\apache-2.0_295.yml", "YAML", 0, 0, 0, 5, 0, 0, 1, 6
"d:\IDEWORK\lvmen\src\licensedcode\data\rules\apache-2.0_296.yml", "YAML", 0, 0, 0, 5, 0, 0, 1, 6
"d:\IDEWORK\lvmen\src\licensedcode\data\rules\apache-2.0_297.yml", "YAML", 0, 0, 0, 5, 0, 0, 1, 6
"d:\IDEWORK\lvmen\src\licensedcode\data\rules\apache-2.0_298.yml", "YAML", 0, 0, 0, 5, 0, 0, 1, 6
"d:\IDEWORK\lvmen\src\licensedcode\data\rules\apache-2.0_299.yml", "YAML", 0, 0, 0, 3, 0, 0, 1, 4
"d:\IDEWORK\lvmen\src\licensedcode\data\rules\apache-2.0_2_1.yml", "YAML", 0, 0, 0, 5, 0, 0, 1, 6
"d:\IDEWORK\lvmen\src\licensedcode\data\rules\apache-2.0_3.yml", "YAML", 0, 0, 0, 3, 0, 0, 1, 4
"d:\IDEWORK\lvmen\src\licensedcode\data\rules\apache-2.0_30.yml", "YAML", 0, 0, 0, 4, 0, 0, 1, 5
"d:\IDEWORK\lvmen\src\licensedcode\data\rules\apache-2.0_300.yml", "YAML", 0, 0, 0, 3, 0, 0, 1, 4
"d:\IDEWORK\lvmen\src\licensedcode\data\rules\apache-2.0_301.yml", "YAML", 0, 0, 0, 8, 0, 0, 1, 9
"d:\IDEWORK\lvmen\src\licensedcode\data\rules\apache-2.0_302.yml", "YAML", 0, 0, 0, 3, 0, 0, 1, 4
"d:\IDEWORK\lvmen\src\licensedcode\data\rules\apache-2.0_303.yml", "YAML", 0, 0, 0, 3, 0, 0, 1, 4
"d:\IDEWORK\lvmen\src\licensedcode\data\rules\apache-2.0_304.yml", "YAML", 0, 0, 0, 5, 0, 0, 1, 6
"d:\IDEWORK\lvmen\src\licensedcode\data\rules\apache-2.0_305.yml", "YAML", 0, 0, 0, 3, 0, 0, 1, 4
"d:\IDEWORK\lvmen\src\licensedcode\data\rules\apache-2.0_306.yml", "YAML", 0, 0, 0, 3, 0, 0, 1, 4
"d:\IDEWORK\lvmen\src\licensedcode\data\rules\apache-2.0_307.yml", "YAML", 0, 0, 0, 8, 0, 0, 1, 9
"d:\IDEWORK\lvmen\src\licensedcode\data\rules\apache-2.0_308.yml", "YAML", 0, 0, 0, 6, 0, 0, 1, 7
"d:\IDEWORK\lvmen\src\licensedcode\data\rules\apache-2.0_309.yml", "YAML", 0, 0, 0, 5, 0, 0, 1, 6
"d:\IDEWORK\lvmen\src\licensedcode\data\rules\apache-2.0_31.yml", "YAML", 0, 0, 0, 3, 0, 0, 1, 4
"d:\IDEWORK\lvmen\src\licensedcode\data\rules\apache-2.0_310.yml", "YAML", 0, 0, 0, 5, 0, 0, 1, 6
"d:\IDEWORK\lvmen\src\licensedcode\data\rules\apache-2.0_311.yml", "YAML", 0, 0, 0, 5, 0, 0, 1, 6
"d:\IDEWORK\lvmen\src\licensedcode\data\rules\apache-2.0_312.yml", "YAML", 0, 0, 0, 3, 0, 0, 1, 4
"d:\IDEWORK\lvmen\src\licensedcode\data\rules\apache-2.0_313.yml", "YAML", 0, 0, 0, 3, 0, 0, 1, 4
"d:\IDEWORK\lvmen\src\licensedcode\data\rules\apache-2.0_314.yml", "YAML", 0, 0, 0, 5, 0, 0, 1, 6
"d:\IDEWORK\lvmen\src\licensedcode\data\rules\apache-2.0_315.yml", "YAML", 0, 0, 0, 3, 0, 0, 1, 4
"d:\IDEWORK\lvmen\src\licensedcode\data\rules\apache-2.0_316.yml", "YAML", 0, 0, 0, 5, 0, 0, 1, 6
"d:\IDEWORK\lvmen\src\licensedcode\data\rules\apache-2.0_317.yml", "YAML", 0, 0, 0, 5, 0, 0, 1, 6
"d:\IDEWORK\lvmen\src\licensedcode\data\rules\apache-2.0_318.yml", "YAML", 0, 0, 0, 3, 0, 0, 1, 4
"d:\IDEWORK\lvmen\src\licensedcode\data\rules\apache-2.0_319.yml", "YAML", 0, 0, 0, 3, 0, 0, 1, 4
"d:\IDEWORK\lvmen\src\licensedcode\data\rules\apache-2.0_32.yml", "YAML", 0, 0, 0, 4, 0, 0, 1, 5
"d:\IDEWORK\lvmen\src\licensedcode\data\rules\apache-2.0_320.yml", "YAML", 0, 0, 0, 3, 0, 0, 1, 4
"d:\IDEWORK\lvmen\src\licensedcode\data\rules\apache-2.0_321.yml", "YAML", 0, 0, 0, 5, 0, 0, 1, 6
"d:\IDEWORK\lvmen\src\licensedcode\data\rules\apache-2.0_322.yml", "YAML", 0, 0, 0, 3, 0, 0, 1, 4
"d:\IDEWORK\lvmen\src\licensedcode\data\rules\apache-2.0_323.yml", "YAML", 0, 0, 0, 3, 0, 0, 1, 4
"d:\IDEWORK\lvmen\src\licensedcode\data\rules\apache-2.0_324.yml", "YAML", 0, 0, 0, 5, 0, 0, 1, 6
"d:\IDEWORK\lvmen\src\licensedcode\data\rules\apache-2.0_325.yml", "YAML", 0, 0, 0, 6, 0, 0, 1, 7
"d:\IDEWORK\lvmen\src\licensedcode\data\rules\apache-2.0_326.yml", "YAML", 0, 0, 0, 5, 0, 0, 1, 6
"d:\IDEWORK\lvmen\src\licensedcode\data\rules\apache-2.0_327.yml", "YAML", 0, 0, 0, 5, 0, 0, 1, 6
"d:\IDEWORK\lvmen\src\licensedcode\data\rules\apache-2.0_328.yml", "YAML", 0, 0, 0, 4, 0, 0, 1, 5
"d:\IDEWORK\lvmen\src\licensedcode\data\rules\apache-2.0_329.yml", "YAML", 0, 0, 0, 3, 0, 0, 1, 4
"d:\IDEWORK\lvmen\src\licensedcode\data\rules\apache-2.0_33.yml", "YAML", 0, 0, 0, 8, 0, 0, 1, 9
"d:\IDEWORK\lvmen\src\licensedcode\data\rules\apache-2.0_330.yml", "YAML", 0, 0, 0, 6, 0, 0, 1, 7
"d:\IDEWORK\lvmen\src\licensedcode\data\rules\apache-2.0_331.yml", "YAML", 0, 0, 0, 6, 0, 0, 1, 7
"d:\IDEWORK\lvmen\src\licensedcode\data\rules\apache-2.0_332.yml", "YAML", 0, 0, 0, 3, 0, 0, 1, 4
"d:\IDEWORK\lvmen\src\licensedcode\data\rules\apache-2.0_333.yml", "YAML", 0, 0, 0, 6, 0, 0, 1, 7
"d:\IDEWORK\lvmen\src\licensedcode\data\rules\apache-2.0_334.yml", "YAML", 0, 0, 0, 8, 0, 0, 1, 9
"d:\IDEWORK\lvmen\src\licensedcode\data\rules\apache-2.0_335.yml", "YAML", 0, 0, 0, 6, 0, 0, 1, 7
"d:\IDEWORK\lvmen\src\licensedcode\data\rules\apache-2.0_336.yml", "YAML", 0, 0, 0, 3, 0, 0, 1, 4
"d:\IDEWORK\lvmen\src\licensedcode\data\rules\apache-2.0_337.yml", "YAML", 0, 0, 0, 3, 0, 0, 1, 4
"d:\IDEWORK\lvmen\src\licensedcode\data\rules\apache-2.0_338.yml", "YAML", 0, 0, 0, 5, 0, 0, 1, 6
"d:\IDEWORK\lvmen\src\licensedcode\data\rules\apache-2.0_339.yml", "YAML", 0, 0, 0, 5, 0, 0, 1, 6
"d:\IDEWORK\lvmen\src\licensedcode\data\rules\apache-2.0_34.yml", "YAML", 0, 0, 0, 4, 0, 0, 1, 5
"d:\IDEWORK\lvmen\src\licensedcode\data\rules\apache-2.0_340.yml", "YAML", 0, 0, 0, 5, 0, 0, 1, 6
"d:\IDEWORK\lvmen\src\licensedcode\data\rules\apache-2.0_341.yml", "YAML", 0, 0, 0, 3, 0, 0, 1, 4
"d:\IDEWORK\lvmen\src\licensedcode\data\rules\apache-2.0_342.yml", "YAML", 0, 0, 0, 5, 0, 0, 1, 6
"d:\IDEWORK\lvmen\src\licensedcode\data\rules\apache-2.0_343.yml", "YAML", 0, 0, 0, 3, 0, 0, 1, 4
"d:\IDEWORK\lvmen\src\licensedcode\data\rules\apache-2.0_344.yml", "YAML", 0, 0, 0, 5, 0, 0, 1, 6
"d:\IDEWORK\lvmen\src\licensedcode\data\rules\apache-2.0_345.yml", "YAML", 0, 0, 0, 3, 0, 0, 1, 4
"d:\IDEWORK\lvmen\src\licensedcode\data\rules\apache-2.0_346.yml", "YAML", 0, 0, 0, 3, 0, 0, 1, 4
"d:\IDEWORK\lvmen\src\licensedcode\data\rules\apache-2.0_347.yml", "YAML", 0, 0, 0, 3, 0, 0, 1, 4
"d:\IDEWORK\lvmen\src\licensedcode\data\rules\apache-2.0_348.yml", "YAML", 0, 0, 0, 3, 0, 0, 1, 4
"d:\IDEWORK\lvmen\src\licensedcode\data\rules\apache-2.0_349.yml", "YAML", 0, 0, 0, 5, 0, 0, 1, 6
"d:\IDEWORK\lvmen\src\licensedcode\data\rules\apache-2.0_35.yml", "YAML", 0, 0, 0, 6, 0, 0, 1, 7
"d:\IDEWORK\lvmen\src\licensedcode\data\rules\apache-2.0_350.yml", "YAML", 0, 0, 0, 5, 0, 0, 1, 6
"d:\IDEWORK\lvmen\src\licensedcode\data\rules\apache-2.0_351.yml", "YAML", 0, 0, 0, 5, 0, 0, 1, 6
"d:\IDEWORK\lvmen\src\licensedcode\data\rules\apache-2.0_352.yml", "YAML", 0, 0, 0, 5, 0, 0, 1, 6
"d:\IDEWORK\lvmen\src\licensedcode\data\rules\apache-2.0_353.yml", "YAML", 0, 0, 0, 5, 0, 0, 1, 6
"d:\IDEWORK\lvmen\src\licensedcode\data\rules\apache-2.0_354.yml", "YAML", 0, 0, 0, 5, 0, 0, 1, 6
"d:\IDEWORK\lvmen\src\licensedcode\data\rules\apache-2.0_355.yml", "YAML", 0, 0, 0, 5, 0, 0, 1, 6
"d:\IDEWORK\lvmen\src\licensedcode\data\rules\apache-2.0_356.yml", "YAML", 0, 0, 0, 5, 0, 0, 1, 6
"d:\IDEWORK\lvmen\src\licensedcode\data\rules\apache-2.0_357.yml", "YAML", 0, 0, 0, 5, 0, 0, 1, 6
"d:\IDEWORK\lvmen\src\licensedcode\data\rules\apache-2.0_358.yml", "YAML", 0, 0, 0, 6, 0, 0, 1, 7
"d:\IDEWORK\lvmen\src\licensedcode\data\rules\apache-2.0_359.yml", "YAML", 0, 0, 0, 5, 0, 0, 1, 6
"d:\IDEWORK\lvmen\src\licensedcode\data\rules\apache-2.0_36.yml", "YAML", 0, 0, 0, 4, 0, 0, 1, 5
"d:\IDEWORK\lvmen\src\licensedcode\data\rules\apache-2.0_360.yml", "YAML", 0, 0, 0, 3, 0, 0, 1, 4
"d:\IDEWORK\lvmen\src\licensedcode\data\rules\apache-2.0_361.yml", "YAML", 0, 0, 0, 5, 0, 0, 1, 6
"d:\IDEWORK\lvmen\src\licensedcode\data\rules\apache-2.0_362.yml", "YAML", 0, 0, 0, 5, 0, 0, 1, 6
"d:\IDEWORK\lvmen\src\licensedcode\data\rules\apache-2.0_363.yml", "YAML", 0, 0, 0, 3, 0, 0, 1, 4
"d:\IDEWORK\lvmen\src\licensedcode\data\rules\apache-2.0_364.yml", "YAML", 0, 0, 0, 5, 0, 0, 1, 6
"d:\IDEWORK\lvmen\src\licensedcode\data\rules\apache-2.0_365.yml", "YAML", 0, 0, 0, 4, 0, 0, 1, 5
"d:\IDEWORK\lvmen\src\licensedcode\data\rules\apache-2.0_366.yml", "YAML", 0, 0, 0, 3, 0, 0, 1, 4
"d:\IDEWORK\lvmen\src\licensedcode\data\rules\apache-2.0_367.yml", "YAML", 0, 0, 0, 3, 0, 0, 1, 4
"d:\IDEWORK\lvmen\src\licensedcode\data\rules\apache-2.0_368.yml", "YAML", 0, 0, 0, 5, 0, 0, 1, 6
"d:\IDEWORK\lvmen\src\licensedcode\data\rules\apache-2.0_369.yml", "YAML", 0, 0, 0, 5, 0, 0, 1, 6
"d:\IDEWORK\lvmen\src\licensedcode\data\rules\apache-2.0_37.yml", "YAML", 0, 0, 0, 2, 0, 0, 1, 3
"d:\IDEWORK\lvmen\src\licensedcode\data\rules\apache-2.0_370.yml", "YAML", 0, 0, 0, 3, 0, 0, 1, 4
"d:\IDEWORK\lvmen\src\licensedcode\data\rules\apache-2.0_371.yml", "YAML", 0, 0, 0, 3, 0, 0, 1, 4
"d:\IDEWORK\lvmen\src\licensedcode\data\rules\apache-2.0_372.yml", "YAML", 0, 0, 0, 3, 0, 0, 1, 4
"d:\IDEWORK\lvmen\src\licensedcode\data\rules\apache-2.0_373.yml", "YAML", 0, 0, 0, 3, 0, 0, 1, 4
"d:\IDEWORK\lvmen\src\licensedcode\data\rules\apache-2.0_374.yml", "YAML", 0, 0, 0, 7, 0, 0, 1, 8
"d:\IDEWORK\lvmen\src\licensedcode\data\rules\apache-2.0_375.yml", "YAML", 0, 0, 0, 5, 0, 0, 1, 6
"d:\IDEWORK\lvmen\src\licensedcode\data\rules\apache-2.0_376.yml", "YAML", 0, 0, 0, 3, 0, 0, 1, 4
"d:\IDEWORK\lvmen\src\licensedcode\data\rules\apache-2.0_377.yml", "YAML", 0, 0, 0, 3, 0, 0, 1, 4
"d:\IDEWORK\lvmen\src\licensedcode\data\rules\apache-2.0_378.yml", "YAML", 0, 0, 0, 3, 0, 0, 1, 4
"d:\IDEWORK\lvmen\src\licensedcode\data\rules\apache-2.0_379.yml", "YAML", 0, 0, 0, 3, 0, 0, 1, 4
"d:\IDEWORK\lvmen\src\licensedcode\data\rules\apache-2.0_38.yml", "YAML", 0, 0, 0, 5, 0, 0, 1, 6
"d:\IDEWORK\lvmen\src\licensedcode\data\rules\apache-2.0_380.yml", "YAML", 0, 0, 0, 11, 0, 0, 1, 12
"d:\IDEWORK\lvmen\src\licensedcode\data\rules\apache-2.0_381.yml", "YAML", 0, 0, 0, 5, 0, 0, 1, 6
"d:\IDEWORK\lvmen\src\licensedcode\data\rules\apache-2.0_382.yml", "YAML", 0, 0, 0, 3, 0, 0, 1, 4
"d:\IDEWORK\lvmen\src\licensedcode\data\rules\apache-2.0_383.yml", "YAML", 0, 0, 0, 3, 0, 0, 1, 4
"d:\IDEWORK\lvmen\src\licensedcode\data\rules\apache-2.0_384.yml", "YAML", 0, 0, 0, 3, 0, 0, 1, 4
"d:\IDEWORK\lvmen\src\licensedcode\data\rules\apache-2.0_385.yml", "YAML", 0, 0, 0, 3, 0, 0, 1, 4
"d:\IDEWORK\lvmen\src\licensedcode\data\rules\apache-2.0_386.yml", "YAML", 0, 0, 0, 3, 0, 0, 1, 4
"d:\IDEWORK\lvmen\src\licensedcode\data\rules\apache-2.0_387.yml", "YAML", 0, 0, 0, 3, 0, 0, 1, 4
"d:\IDEWORK\lvmen\src\licensedcode\data\rules\apache-2.0_388.yml", "YAML", 0, 0, 0, 3, 0, 0, 1, 4
"d:\IDEWORK\lvmen\src\licensedcode\data\rules\apache-2.0_389.yml", "YAML", 0, 0, 0, 3, 0, 0, 1, 4
"d:\IDEWORK\lvmen\src\licensedcode\data\rules\apache-2.0_39.yml", "YAML", 0, 0, 0, 6, 0, 0, 1, 7
"d:\IDEWORK\lvmen\src\licensedcode\data\rules\apache-2.0_390.yml", "YAML", 0, 0, 0, 3, 0, 0, 1, 4
"d:\IDEWORK\lvmen\src\licensedcode\data\rules\apache-2.0_391.yml", "YAML", 0, 0, 0, 3, 0, 0, 1, 4
"d:\IDEWORK\lvmen\src\licensedcode\data\rules\apache-2.0_392.yml", "YAML", 0, 0, 0, 3, 0, 0, 1, 4
"d:\IDEWORK\lvmen\src\licensedcode\data\rules\apache-2.0_393.yml", "YAML", 0, 0, 0, 6, 0, 0, 1, 7
"d:\IDEWORK\lvmen\src\licensedcode\data\rules\apache-2.0_394.yml", "YAML", 0, 0, 0, 5, 0, 0, 1, 6
"d:\IDEWORK\lvmen\src\licensedcode\data\rules\apache-2.0_395.yml", "YAML", 0, 0, 0, 5, 0, 0, 1, 6
"d:\IDEWORK\lvmen\src\licensedcode\data\rules\apache-2.0_396.yml", "YAML", 0, 0, 0, 5, 0, 0, 1, 6
"d:\IDEWORK\lvmen\src\licensedcode\data\rules\apache-2.0_397.yml", "YAML", 0, 0, 0, 7, 0, 0, 1, 8
"d:\IDEWORK\lvmen\src\licensedcode\data\rules\apache-2.0_398.yml", "YAML", 0, 0, 0, 3, 0, 0, 1, 4
"d:\IDEWORK\lvmen\src\licensedcode\data\rules\apache-2.0_399.yml", "YAML", 0, 0, 0, 3, 0, 0, 1, 4
"d:\IDEWORK\lvmen\src\licensedcode\data\rules\apache-2.0_4.yml", "YAML", 0, 0, 0, 3, 0, 0, 1, 4
"d:\IDEWORK\lvmen\src\licensedcode\data\rules\apache-2.0_40.yml", "YAML", 0, 0, 0, 4, 0, 0, 1, 5
"d:\IDEWORK\lvmen\src\licensedcode\data\rules\apache-2.0_400.yml", "YAML", 0, 0, 0, 8, 0, 0, 1, 9
"d:\IDEWORK\lvmen\src\licensedcode\data\rules\apache-2.0_401.yml", "YAML", 0, 0, 0, 7, 0, 0, 1, 8
"d:\IDEWORK\lvmen\src\licensedcode\data\rules\apache-2.0_402.yml", "YAML", 0, 0, 0, 3, 0, 0, 1, 4
"d:\IDEWORK\lvmen\src\licensedcode\data\rules\apache-2.0_403.yml", "YAML", 0, 0, 0, 5, 0, 0, 1, 6
"d:\IDEWORK\lvmen\src\licensedcode\data\rules\apache-2.0_404.yml", "YAML", 0, 0, 0, 5, 0, 0, 1, 6
"d:\IDEWORK\lvmen\src\licensedcode\data\rules\apache-2.0_405.yml", "YAML", 0, 0, 0, 3, 0, 0, 1, 4
"d:\IDEWORK\lvmen\src\licensedcode\data\rules\apache-2.0_406.yml", "YAML", 0, 0, 0, 5, 0, 0, 1, 6
"d:\IDEWORK\lvmen\src\licensedcode\data\rules\apache-2.0_407.yml", "YAML", 0, 0, 0, 3, 0, 0, 1, 4
"d:\IDEWORK\lvmen\src\licensedcode\data\rules\apache-2.0_408.yml", "YAML", 0, 0, 0, 3, 0, 0, 1, 4
"d:\IDEWORK\lvmen\src\licensedcode\data\rules\apache-2.0_409.yml", "YAML", 0, 0, 0, 7, 0, 0, 1, 8
"d:\IDEWORK\lvmen\src\licensedcode\data\rules\apache-2.0_40_1.yml", "YAML", 0, 0, 0, 4, 0, 0, 1, 5
"d:\IDEWORK\lvmen\src\licensedcode\data\rules\apache-2.0_41.yml", "YAML", 0, 0, 0, 8, 0, 0, 1, 9
"d:\IDEWORK\lvmen\src\licensedcode\data\rules\apache-2.0_410.yml", "YAML", 0, 0, 0, 6, 0, 0, 1, 7
"d:\IDEWORK\lvmen\src\licensedcode\data\rules\apache-2.0_411.yml", "YAML", 0, 0, 0, 3, 0, 0, 1, 4
"d:\IDEWORK\lvmen\src\licensedcode\data\rules\apache-2.0_412.yml", "YAML", 0, 0, 0, 3, 0, 0, 1, 4
"d:\IDEWORK\lvmen\src\licensedcode\data\rules\apache-2.0_413.yml", "YAML", 0, 0, 0, 3, 0, 0, 1, 4
"d:\IDEWORK\lvmen\src\licensedcode\data\rules\apache-2.0_414.yml", "YAML", 0, 0, 0, 3, 0, 0, 1, 4
"d:\IDEWORK\lvmen\src\licensedcode\data\rules\apache-2.0_415.yml", "YAML", 0, 0, 0, 3, 0, 0, 1, 4
"d:\IDEWORK\lvmen\src\licensedcode\data\rules\apache-2.0_416.yml", "YAML", 0, 0, 0, 3, 0, 0, 1, 4
"d:\IDEWORK\lvmen\src\licensedcode\data\rules\apache-2.0_417.yml", "YAML", 0, 0, 0, 3, 0, 0, 1, 4
"d:\IDEWORK\lvmen\src\licensedcode\data\rules\apache-2.0_418.yml", "YAML", 0, 0, 0, 6, 0, 0, 1, 7
"d:\IDEWORK\lvmen\src\licensedcode\data\rules\apache-2.0_419.yml", "YAML", 0, 0, 0, 5, 0, 0, 1, 6
"d:\IDEWORK\lvmen\src\licensedcode\data\rules\apache-2.0_42.yml", "YAML", 0, 0, 0, 5, 0, 0, 1, 6
"d:\IDEWORK\lvmen\src\licensedcode\data\rules\apache-2.0_420.yml", "YAML", 0, 0, 0, 3, 0, 0, 1, 4
"d:\IDEWORK\lvmen\src\licensedcode\data\rules\apache-2.0_421.yml", "YAML", 0, 0, 0, 3, 0, 0, 1, 4
"d:\IDEWORK\lvmen\src\licensedcode\data\rules\apache-2.0_422.yml", "YAML", 0, 0, 0, 5, 0, 0, 1, 6
"d:\IDEWORK\lvmen\src\licensedcode\data\rules\apache-2.0_423.yml", "YAML", 0, 0, 0, 3, 0, 0, 1, 4
"d:\IDEWORK\lvmen\src\licensedcode\data\rules\apache-2.0_424.yml", "YAML", 0, 0, 0, 5, 0, 0, 1, 6
"d:\IDEWORK\lvmen\src\licensedcode\data\rules\apache-2.0_425.yml", "YAML", 0, 0, 0, 6, 0, 0, 1, 7
"d:\IDEWORK\lvmen\src\licensedcode\data\rules\apache-2.0_426.yml", "YAML", 0, 0, 0, 6, 0, 0, 1, 7
"d:\IDEWORK\lvmen\src\licensedcode\data\rules\apache-2.0_427.yml", "YAML", 0, 0, 0, 6, 0, 0, 1, 7
"d:\IDEWORK\lvmen\src\licensedcode\data\rules\apache-2.0_428.yml", "YAML", 0, 0, 0, 6, 0, 0, 1, 7
"d:\IDEWORK\lvmen\src\licensedcode\data\rules\apache-2.0_429.yml", "YAML", 0, 0, 0, 6, 0, 0, 1, 7
"d:\IDEWORK\lvmen\src\licensedcode\data\rules\apache-2.0_43.yml", "YAML", 0, 0, 0, 8, 0, 0, 1, 9
"d:\IDEWORK\lvmen\src\licensedcode\data\rules\apache-2.0_430.yml", "YAML", 0, 0, 0, 6, 0, 0, 1, 7
"d:\IDEWORK\lvmen\src\licensedcode\data\rules\apache-2.0_431.yml", "YAML", 0, 0, 0, 6, 0, 0, 1, 7
"d:\IDEWORK\lvmen\src\licensedcode\data\rules\apache-2.0_432.yml", "YAML", 0, 0, 0, 6, 0, 0, 1, 7
"d:\IDEWORK\lvmen\src\licensedcode\data\rules\apache-2.0_433.yml", "YAML", 0, 0, 0, 6, 0, 0, 1, 7
"d:\IDEWORK\lvmen\src\licensedcode\data\rules\apache-2.0_434.yml", "YAML", 0, 0, 0, 6, 0, 0, 1, 7
"d:\IDEWORK\lvmen\src\licensedcode\data\rules\apache-2.0_435.yml", "YAML", 0, 0, 0, 6, 0, 0, 1, 7
"d:\IDEWORK\lvmen\src\licensedcode\data\rules\apache-2.0_436.yml", "YAML", 0, 0, 0, 6, 0, 0, 1, 7
"d:\IDEWORK\lvmen\src\licensedcode\data\rules\apache-2.0_437.yml", "YAML", 0, 0, 0, 6, 0, 0, 1, 7
"d:\IDEWORK\lvmen\src\licensedcode\data\rules\apache-2.0_438.yml", "YAML", 0, 0, 0, 6, 0, 0, 1, 7
"d:\IDEWORK\lvmen\src\licensedcode\data\rules\apache-2.0_439.yml", "YAML", 0, 0, 0, 6, 0, 0, 1, 7
"d:\IDEWORK\lvmen\src\licensedcode\data\rules\apache-2.0_44.yml", "YAML", 0, 0, 0, 3, 0, 0, 1, 4
"d:\IDEWORK\lvmen\src\licensedcode\data\rules\apache-2.0_440.yml", "YAML", 0, 0, 0, 6, 0, 0, 1, 7
"d:\IDEWORK\lvmen\src\licensedcode\data\rules\apache-2.0_441.yml", "YAML", 0, 0, 0, 4, 0, 0, 1, 5
"d:\IDEWORK\lvmen\src\licensedcode\data\rules\apache-2.0_442.yml", "YAML", 0, 0, 0, 3, 0, 0, 1, 4
"d:\IDEWORK\lvmen\src\licensedcode\data\rules\apache-2.0_443.yml", "YAML", 0, 0, 0, 6, 0, 0, 1, 7
"d:\IDEWORK\lvmen\src\licensedcode\data\rules\apache-2.0_444.yml", "YAML", 0, 0, 0, 3, 0, 0, 1, 4
"d:\IDEWORK\lvmen\src\licensedcode\data\rules\apache-2.0_445.yml", "YAML", 0, 0, 0, 5, 0, 0, 1, 6
"d:\IDEWORK\lvmen\src\licensedcode\data\rules\apache-2.0_446.yml", "YAML", 0, 0, 0, 6, 0, 0, 1, 7
"d:\IDEWORK\lvmen\src\licensedcode\data\rules\apache-2.0_447.yml", "YAML", 0, 0, 0, 5, 0, 0, 1, 6
"d:\IDEWORK\lvmen\src\licensedcode\data\rules\apache-2.0_448.yml", "YAML", 0, 0, 0, 5, 0, 0, 1, 6
"d:\IDEWORK\lvmen\src\licensedcode\data\rules\apache-2.0_449.yml", "YAML", 0, 0, 0, 5, 0, 0, 1, 6
"d:\IDEWORK\lvmen\src\licensedcode\data\rules\apache-2.0_45.yml", "YAML", 0, 0, 0, 3, 0, 0, 1, 4
"d:\IDEWORK\lvmen\src\licensedcode\data\rules\apache-2.0_450.yml", "YAML", 0, 0, 0, 3, 0, 0, 1, 4
"d:\IDEWORK\lvmen\src\licensedcode\data\rules\apache-2.0_451.yml", "YAML", 0, 0, 0, 5, 0, 0, 1, 6
"d:\IDEWORK\lvmen\src\licensedcode\data\rules\apache-2.0_452.yml", "YAML", 0, 0, 0, 5, 0, 0, 1, 6
"d:\IDEWORK\lvmen\src\licensedcode\data\rules\apache-2.0_453.yml", "YAML", 0, 0, 0, 5, 0, 0, 1, 6
"d:\IDEWORK\lvmen\src\licensedcode\data\rules\apache-2.0_454.yml", "YAML", 0, 0, 0, 5, 0, 0, 1, 6
"d:\IDEWORK\lvmen\src\licensedcode\data\rules\apache-2.0_455.yml", "YAML", 0, 0, 0, 3, 0, 0, 1, 4
"d:\IDEWORK\lvmen\src\licensedcode\data\rules\apache-2.0_456.yml", "YAML", 0, 0, 0, 5, 0, 0, 1, 6
"d:\IDEWORK\lvmen\src\licensedcode\data\rules\apache-2.0_457.yml", "YAML", 0, 0, 0, 5, 0, 0, 1, 6
"d:\IDEWORK\lvmen\src\licensedcode\data\rules\apache-2.0_458.yml", "YAML", 0, 0, 0, 5, 0, 0, 1, 6
"d:\IDEWORK\lvmen\src\licensedcode\data\rules\apache-2.0_459.yml", "YAML", 0, 0, 0, 5, 0, 0, 1, 6
"d:\IDEWORK\lvmen\src\licensedcode\data\rules\apache-2.0_46.yml", "YAML", 0, 0, 0, 4, 0, 0, 1, 5
"d:\IDEWORK\lvmen\src\licensedcode\data\rules\apache-2.0_460.yml", "YAML", 0, 0, 0, 5, 0, 0, 1, 6
"d:\IDEWORK\lvmen\src\licensedcode\data\rules\apache-2.0_461.yml", "YAML", 0, 0, 0, 3, 0, 0, 1, 4
"d:\IDEWORK\lvmen\src\licensedcode\data\rules\apache-2.0_462.yml", "YAML", 0, 0, 0, 5, 0, 0, 1, 6
"d:\IDEWORK\lvmen\src\licensedcode\data\rules\apache-2.0_463.yml", "YAML", 0, 0, 0, 5, 0, 0, 1, 6
"d:\IDEWORK\lvmen\src\licensedcode\data\rules\apache-2.0_464.yml", "YAML", 0, 0, 0, 5, 0, 0, 1, 6
"d:\IDEWORK\lvmen\src\licensedcode\data\rules\apache-2.0_465.yml", "YAML", 0, 0, 0, 5, 0, 0, 1, 6
"d:\IDEWORK\lvmen\src\licensedcode\data\rules\apache-2.0_466.yml", "YAML", 0, 0, 0, 6, 0, 0, 1, 7
"d:\IDEWORK\lvmen\src\licensedcode\data\rules\apache-2.0_467.yml", "YAML", 0, 0, 0, 5, 0, 0, 1, 6
"d:\IDEWORK\lvmen\src\licensedcode\data\rules\apache-2.0_468.yml", "YAML", 0, 0, 0, 5, 0, 0, 1, 6
"d:\IDEWORK\lvmen\src\licensedcode\data\rules\apache-2.0_469.yml", "YAML", 0, 0, 0, 5, 0, 0, 1, 6
"d:\IDEWORK\lvmen\src\licensedcode\data\rules\apache-2.0_47.yml", "YAML", 0, 0, 0, 4, 0, 0, 1, 5
"d:\IDEWORK\lvmen\src\licensedcode\data\rules\apache-2.0_470.yml", "YAML", 0, 0, 0, 3, 0, 0, 1, 4
"d:\IDEWORK\lvmen\src\licensedcode\data\rules\apache-2.0_471.yml", "YAML", 0, 0, 0, 3, 0, 0, 1, 4
"d:\IDEWORK\lvmen\src\licensedcode\data\rules\apache-2.0_472.yml", "YAML", 0, 0, 0, 3, 0, 0, 1, 4
"d:\IDEWORK\lvmen\src\licensedcode\data\rules\apache-2.0_473.yml", "YAML", 0, 0, 0, 3, 0, 0, 1, 4
"d:\IDEWORK\lvmen\src\licensedcode\data\rules\apache-2.0_474.yml", "YAML", 0, 0, 0, 6, 0, 0, 1, 7
"d:\IDEWORK\lvmen\src\licensedcode\data\rules\apache-2.0_475.yml", "YAML", 0, 0, 0, 5, 0, 0, 1, 6
"d:\IDEWORK\lvmen\src\licensedcode\data\rules\apache-2.0_476.yml", "YAML", 0, 0, 0, 5, 0, 0, 1, 6
"d:\IDEWORK\lvmen\src\licensedcode\data\rules\apache-2.0_477.yml", "YAML", 0, 0, 0, 5, 0, 0, 1, 6
"d:\IDEWORK\lvmen\src\licensedcode\data\rules\apache-2.0_478.yml", "YAML", 0, 0, 0, 5, 0, 0, 1, 6
"d:\IDEWORK\lvmen\src\licensedcode\data\rules\apache-2.0_479.yml", "YAML", 0, 0, 0, 5, 0, 0, 1, 6
"d:\IDEWORK\lvmen\src\licensedcode\data\rules\apache-2.0_48.yml", "YAML", 0, 0, 0, 3, 0, 0, 1, 4
"d:\IDEWORK\lvmen\src\licensedcode\data\rules\apache-2.0_480.yml", "YAML", 0, 0, 0, 5, 0, 0, 1, 6
"d:\IDEWORK\lvmen\src\licensedcode\data\rules\apache-2.0_481.yml", "YAML", 0, 0, 0, 5, 0, 0, 1, 6
"d:\IDEWORK\lvmen\src\licensedcode\data\rules\apache-2.0_482.yml", "YAML", 0, 0, 0, 5, 0, 0, 1, 6
"d:\IDEWORK\lvmen\src\licensedcode\data\rules\apache-2.0_483.yml", "YAML", 0, 0, 0, 3, 0, 0, 1, 4
"d:\IDEWORK\lvmen\src\licensedcode\data\rules\apache-2.0_484.yml", "YAML", 0, 0, 0, 3, 0, 0, 1, 4
"d:\IDEWORK\lvmen\src\licensedcode\data\rules\apache-2.0_485.yml", "YAML", 0, 0, 0, 3, 0, 0, 1, 4
"d:\IDEWORK\lvmen\src\licensedcode\data\rules\apache-2.0_486.yml", "YAML", 0, 0, 0, 3, 0, 0, 1, 4
"d:\IDEWORK\lvmen\src\licensedcode\data\rules\apache-2.0_487.yml", "YAML", 0, 0, 0, 3, 0, 0, 1, 4
"d:\IDEWORK\lvmen\src\licensedcode\data\rules\apache-2.0_488.yml", "YAML", 0, 0, 0, 5, 0, 0, 1, 6
"d:\IDEWORK\lvmen\src\licensedcode\data\rules\apache-2.0_489.yml", "YAML", 0, 0, 0, 3, 0, 0, 1, 4
"d:\IDEWORK\lvmen\src\licensedcode\data\rules\apache-2.0_49.yml", "YAML", 0, 0, 0, 3, 0, 0, 1, 4
"d:\IDEWORK\lvmen\src\licensedcode\data\rules\apache-2.0_490.yml", "YAML", 0, 0, 0, 3, 0, 0, 1, 4
"d:\IDEWORK\lvmen\src\licensedcode\data\rules\apache-2.0_491.yml", "YAML", 0, 0, 0, 5, 0, 0, 1, 6
"d:\IDEWORK\lvmen\src\licensedcode\data\rules\apache-2.0_492.yml", "YAML", 0, 0, 0, 3, 0, 0, 1, 4
"d:\IDEWORK\lvmen\src\licensedcode\data\rules\apache-2.0_493.yml", "YAML", 0, 0, 0, 3, 0, 0, 1, 4
"d:\IDEWORK\lvmen\src\licensedcode\data\rules\apache-2.0_494.yml", "YAML", 0, 0, 0, 3, 0, 0, 1, 4
"d:\IDEWORK\lvmen\src\licensedcode\data\rules\apache-2.0_495.yml", "YAML", 0, 0, 0, 3, 0, 0, 1, 4
"d:\IDEWORK\lvmen\src\licensedcode\data\rules\apache-2.0_496.yml", "YAML", 0, 0, 0, 3, 0, 0, 1, 4
"d:\IDEWORK\lvmen\src\licensedcode\data\rules\apache-2.0_497.yml", "YAML", 0, 0, 0, 3, 0, 0, 1, 4
"d:\IDEWORK\lvmen\src\licensedcode\data\rules\apache-2.0_498.yml", "YAML", 0, 0, 0, 5, 0, 0, 1, 6
"d:\IDEWORK\lvmen\src\licensedcode\data\rules\apache-2.0_499.yml", "YAML", 0, 0, 0, 3, 0, 0, 1, 4
"d:\IDEWORK\lvmen\src\licensedcode\data\rules\apache-2.0_5.yml", "YAML", 0, 0, 0, 3, 0, 0, 1, 4
"d:\IDEWORK\lvmen\src\licensedcode\data\rules\apache-2.0_50.yml", "YAML", 0, 0, 0, 3, 0, 0, 1, 4
"d:\IDEWORK\lvmen\src\licensedcode\data\rules\apache-2.0_500.yml", "YAML", 0, 0, 0, 5, 0, 0, 1, 6
"d:\IDEWORK\lvmen\src\licensedcode\data\rules\apache-2.0_501.yml", "YAML", 0, 0, 0, 5, 0, 0, 1, 6
"d:\IDEWORK\lvmen\src\licensedcode\data\rules\apache-2.0_502.yml", "YAML", 0, 0, 0, 3, 0, 0, 1, 4
"d:\IDEWORK\lvmen\src\licensedcode\data\rules\apache-2.0_503.yml", "YAML", 0, 0, 0, 3, 0, 0, 1, 4
"d:\IDEWORK\lvmen\src\licensedcode\data\rules\apache-2.0_504.yml", "YAML", 0, 0, 0, 5, 0, 0, 1, 6
"d:\IDEWORK\lvmen\src\licensedcode\data\rules\apache-2.0_505.yml", "YAML", 0, 0, 0, 3, 0, 0, 1, 4
"d:\IDEWORK\lvmen\src\licensedcode\data\rules\apache-2.0_506.yml", "YAML", 0, 0, 0, 3, 0, 0, 1, 4
"d:\IDEWORK\lvmen\src\licensedcode\data\rules\apache-2.0_507.yml", "YAML", 0, 0, 0, 3, 0, 0, 1, 4
"d:\IDEWORK\lvmen\src\licensedcode\data\rules\apache-2.0_508.yml", "YAML", 0, 0, 0, 3, 0, 0, 1, 4
"d:\IDEWORK\lvmen\src\licensedcode\data\rules\apache-2.0_509.yml", "YAML", 0, 0, 0, 3, 0, 0, 1, 4
"d:\IDEWORK\lvmen\src\licensedcode\data\rules\apache-2.0_51.yml", "YAML", 0, 0, 0, 6, 0, 0, 1, 7
"d:\IDEWORK\lvmen\src\licensedcode\data\rules\apache-2.0_510.yml", "YAML", 0, 0, 0, 5, 0, 0, 1, 6
"d:\IDEWORK\lvmen\src\licensedcode\data\rules\apache-2.0_511.yml", "YAML", 0, 0, 0, 5, 0, 0, 1, 6
"d:\IDEWORK\lvmen\src\licensedcode\data\rules\apache-2.0_512.yml", "YAML", 0, 0, 0, 3, 0, 0, 1, 4
"d:\IDEWORK\lvmen\src\licensedcode\data\rules\apache-2.0_513.yml", "YAML", 0, 0, 0, 5, 0, 0, 1, 6
"d:\IDEWORK\lvmen\src\licensedcode\data\rules\apache-2.0_514.yml", "YAML", 0, 0, 0, 5, 0, 0, 1, 6
"d:\IDEWORK\lvmen\src\licensedcode\data\rules\apache-2.0_515.yml", "YAML", 0, 0, 0, 5, 0, 0, 1, 6
"d:\IDEWORK\lvmen\src\licensedcode\data\rules\apache-2.0_516.yml", "YAML", 0, 0, 0, 5, 0, 0, 1, 6
"d:\IDEWORK\lvmen\src\licensedcode\data\rules\apache-2.0_517.yml", "YAML", 0, 0, 0, 5, 0, 0, 1, 6
"d:\IDEWORK\lvmen\src\licensedcode\data\rules\apache-2.0_518.yml", "YAML", 0, 0, 0, 3, 0, 0, 1, 4
"d:\IDEWORK\lvmen\src\licensedcode\data\rules\apache-2.0_519.yml", "YAML", 0, 0, 0, 5, 0, 0, 1, 6
"d:\IDEWORK\lvmen\src\licensedcode\data\rules\apache-2.0_52.yml", "YAML", 0, 0, 0, 5, 0, 0, 1, 6
"d:\IDEWORK\lvmen\src\licensedcode\data\rules\apache-2.0_520.yml", "YAML", 0, 0, 0, 5, 0, 0, 1, 6
"d:\IDEWORK\lvmen\src\licensedcode\data\rules\apache-2.0_521.yml", "YAML", 0, 0, 0, 5, 0, 0, 1, 6
"d:\IDEWORK\lvmen\src\licensedcode\data\rules\apache-2.0_522.yml", "YAML", 0, 0, 0, 8, 0, 0, 1, 9
"d:\IDEWORK\lvmen\src\licensedcode\data\rules\apache-2.0_523.yml", "YAML", 0, 0, 0, 7, 0, 0, 1, 8
"d:\IDEWORK\lvmen\src\licensedcode\data\rules\apache-2.0_524.yml", "YAML", 0, 0, 0, 5, 0, 0, 1, 6
"d:\IDEWORK\lvmen\src\licensedcode\data\rules\apache-2.0_525.yml", "YAML", 0, 0, 0, 8, 0, 0, 1, 9
"d:\IDEWORK\lvmen\src\licensedcode\data\rules\apache-2.0_526.yml", "YAML", 0, 0, 0, 8, 0, 0, 1, 9
"d:\IDEWORK\lvmen\src\licensedcode\data\rules\apache-2.0_527.yml", "YAML", 0, 0, 0, 8, 0, 0, 1, 9
"d:\IDEWORK\lvmen\src\licensedcode\data\rules\apache-2.0_528.yml", "YAML", 0, 0, 0, 7, 0, 0, 1, 8
"d:\IDEWORK\lvmen\src\licensedcode\data\rules\apache-2.0_529.yml", "YAML", 0, 0, 0, 5, 0, 0, 1, 6
"d:\IDEWORK\lvmen\src\licensedcode\data\rules\apache-2.0_53.yml", "YAML", 0, 0, 0, 3, 0, 0, 1, 4
"d:\IDEWORK\lvmen\src\licensedcode\data\rules\apache-2.0_530.yml", "YAML", 0, 0, 0, 3, 0, 0, 1, 4
"d:\IDEWORK\lvmen\src\licensedcode\data\rules\apache-2.0_531.yml", "YAML", 0, 0, 0, 3, 0, 0, 1, 4
"d:\IDEWORK\lvmen\src\licensedcode\data\rules\apache-2.0_532.yml", "YAML", 0, 0, 0, 5, 0, 0, 1, 6
"d:\IDEWORK\lvmen\src\licensedcode\data\rules\apache-2.0_533.yml", "YAML", 0, 0, 0, 5, 0, 0, 1, 6
"d:\IDEWORK\lvmen\src\licensedcode\data\rules\apache-2.0_534.yml", "YAML", 0, 0, 0, 3, 0, 0, 1, 4
"d:\IDEWORK\lvmen\src\licensedcode\data\rules\apache-2.0_535.yml", "YAML", 0, 0, 0, 3, 0, 0, 1, 4
"d:\IDEWORK\lvmen\src\licensedcode\data\rules\apache-2.0_536.yml", "YAML", 0, 0, 0, 5, 0, 0, 1, 6
"d:\IDEWORK\lvmen\src\licensedcode\data\rules\apache-2.0_537.yml", "YAML", 0, 0, 0, 5, 0, 0, 1, 6
"d:\IDEWORK\lvmen\src\licensedcode\data\rules\apache-2.0_538.yml", "YAML", 0, 0, 0, 3, 0, 0, 1, 4
"d:\IDEWORK\lvmen\src\licensedcode\data\rules\apache-2.0_539.yml", "YAML", 0, 0, 0, 3, 0, 0, 1, 4
"d:\IDEWORK\lvmen\src\licensedcode\data\rules\apache-2.0_54.yml", "YAML", 0, 0, 0, 3, 0, 0, 1, 4
"d:\IDEWORK\lvmen\src\licensedcode\data\rules\apache-2.0_540.yml", "YAML", 0, 0, 0, 3, 0, 0, 1, 4
"d:\IDEWORK\lvmen\src\licensedcode\data\rules\apache-2.0_541.yml", "YAML", 0, 0, 0, 4, 0, 0, 1, 5
"d:\IDEWORK\lvmen\src\licensedcode\data\rules\apache-2.0_542.yml", "YAML", 0, 0, 0, 3, 0, 0, 1, 4
"d:\IDEWORK\lvmen\src\licensedcode\data\rules\apache-2.0_543.yml", "YAML", 0, 0, 0, 3, 0, 0, 1, 4
"d:\IDEWORK\lvmen\src\licensedcode\data\rules\apache-2.0_544.yml", "YAML", 0, 0, 0, 4, 0, 0, 1, 5
"d:\IDEWORK\lvmen\src\licensedcode\data\rules\apache-2.0_545.yml", "YAML", 0, 0, 0, 7, 0, 0, 1, 8
"d:\IDEWORK\lvmen\src\licensedcode\data\rules\apache-2.0_546.yml", "YAML", 0, 0, 0, 5, 0, 0, 1, 6
"d:\IDEWORK\lvmen\src\licensedcode\data\rules\apache-2.0_547.yml", "YAML", 0, 0, 0, 5, 0, 0, 1, 6
"d:\IDEWORK\lvmen\src\licensedcode\data\rules\apache-2.0_548.yml", "YAML", 0, 0, 0, 3, 0, 0, 1, 4
"d:\IDEWORK\lvmen\src\licensedcode\data\rules\apache-2.0_549.yml", "YAML", 0, 0, 0, 5, 0, 0, 1, 6
"d:\IDEWORK\lvmen\src\licensedcode\data\rules\apache-2.0_55.yml", "YAML", 0, 0, 0, 4, 0, 0, 1, 5
"d:\IDEWORK\lvmen\src\licensedcode\data\rules\apache-2.0_550.yml", "YAML", 0, 0, 0, 3, 0, 0, 1, 4
"d:\IDEWORK\lvmen\src\licensedcode\data\rules\apache-2.0_551.yml", "YAML", 0, 0, 0, 3, 0, 0, 1, 4
"d:\IDEWORK\lvmen\src\licensedcode\data\rules\apache-2.0_552.yml", "YAML", 0, 0, 0, 5, 0, 0, 1, 6
"d:\IDEWORK\lvmen\src\licensedcode\data\rules\apache-2.0_553.yml", "YAML", 0, 0, 0, 3, 0, 0, 1, 4
"d:\IDEWORK\lvmen\src\licensedcode\data\rules\apache-2.0_554.yml", "YAML", 0, 0, 0, 5, 0, 0, 1, 6
"d:\IDEWORK\lvmen\src\licensedcode\data\rules\apache-2.0_555.yml", "YAML", 0, 0, 0, 5, 0, 0, 1, 6
"d:\IDEWORK\lvmen\src\licensedcode\data\rules\apache-2.0_556.yml", "YAML", 0, 0, 0, 3, 0, 0, 1, 4
"d:\IDEWORK\lvmen\src\licensedcode\data\rules\apache-2.0_557.yml", "YAML", 0, 0, 0, 3, 0, 0, 1, 4
"d:\IDEWORK\lvmen\src\licensedcode\data\rules\apache-2.0_558.yml", "YAML", 0, 0, 0, 5, 0, 0, 1, 6
"d:\IDEWORK\lvmen\src\licensedcode\data\rules\apache-2.0_559.yml", "YAML", 0, 0, 0, 3, 0, 0, 1, 4
"d:\IDEWORK\lvmen\src\licensedcode\data\rules\apache-2.0_56.yml", "YAML", 0, 0, 0, 4, 0, 0, 1, 5
"d:\IDEWORK\lvmen\src\licensedcode\data\rules\apache-2.0_560.yml", "YAML", 0, 0, 0, 5, 0, 0, 1, 6
"d:\IDEWORK\lvmen\src\licensedcode\data\rules\apache-2.0_561.yml", "YAML", 0, 0, 0, 3, 0, 0, 1, 4
"d:\IDEWORK\lvmen\src\licensedcode\data\rules\apache-2.0_562.yml", "YAML", 0, 0, 0, 5, 0, 0, 1, 6
"d:\IDEWORK\lvmen\src\licensedcode\data\rules\apache-2.0_563.yml", "YAML", 0, 0, 0, 6, 0, 0, 1, 7
"d:\IDEWORK\lvmen\src\licensedcode\data\rules\apache-2.0_564.yml", "YAML", 0, 0, 0, 4, 0, 0, 1, 5
"d:\IDEWORK\lvmen\src\licensedcode\data\rules\apache-2.0_565.yml", "YAML", 0, 0, 0, 3, 0, 0, 1, 4
"d:\IDEWORK\lvmen\src\licensedcode\data\rules\apache-2.0_566.yml", "YAML", 0, 0, 0, 3, 0, 0, 1, 4
"d:\IDEWORK\lvmen\src\licensedcode\data\rules\apache-2.0_567.yml", "YAML", 0, 0, 0, 3, 0, 0, 1, 4
"d:\IDEWORK\lvmen\src\licensedcode\data\rules\apache-2.0_568.yml", "YAML", 0, 0, 0, 3, 0, 0, 1, 4
"d:\IDEWORK\lvmen\src\licensedcode\data\rules\apache-2.0_569.yml", "YAML", 0, 0, 0, 3, 0, 0, 1, 4
"d:\IDEWORK\lvmen\src\licensedcode\data\rules\apache-2.0_57.yml", "YAML", 0, 0, 0, 5, 0, 0, 1, 6
"d:\IDEWORK\lvmen\src\licensedcode\data\rules\apache-2.0_570.yml", "YAML", 0, 0, 0, 5, 0, 0, 1, 6
"d:\IDEWORK\lvmen\src\licensedcode\data\rules\apache-2.0_571.yml", "YAML", 0, 0, 0, 5, 0, 0, 1, 6
"d:\IDEWORK\lvmen\src\licensedcode\data\rules\apache-2.0_572.yml", "YAML", 0, 0, 0, 5, 0, 0, 1, 6
"d:\IDEWORK\lvmen\src\licensedcode\data\rules\apache-2.0_573.yml", "YAML", 0, 0, 0, 3, 0, 0, 1, 4
"d:\IDEWORK\lvmen\src\licensedcode\data\rules\apache-2.0_574.yml", "YAML", 0, 0, 0, 3, 0, 0, 1, 4
"d:\IDEWORK\lvmen\src\licensedcode\data\rules\apache-2.0_575.yml", "YAML", 0, 0, 0, 3, 0, 0, 1, 4
"d:\IDEWORK\lvmen\src\licensedcode\data\rules\apache-2.0_576.yml", "YAML", 0, 0, 0, 3, 0, 0, 1, 4
"d:\IDEWORK\lvmen\src\licensedcode\data\rules\apache-2.0_577.yml", "YAML", 0, 0, 0, 3, 0, 0, 1, 4
"d:\IDEWORK\lvmen\src\licensedcode\data\rules\apache-2.0_578.yml", "YAML", 0, 0, 0, 3, 0, 0, 1, 4
"d:\IDEWORK\lvmen\src\licensedcode\data\rules\apache-2.0_579.yml", "YAML", 0, 0, 0, 3, 0, 0, 1, 4
"d:\IDEWORK\lvmen\src\licensedcode\data\rules\apache-2.0_58.yml", "YAML", 0, 0, 0, 5, 0, 0, 1, 6
"d:\IDEWORK\lvmen\src\licensedcode\data\rules\apache-2.0_580.yml", "YAML", 0, 0, 0, 4, 0, 0, 1, 5
"d:\IDEWORK\lvmen\src\licensedcode\data\rules\apache-2.0_581.yml", "YAML", 0, 0, 0, 4, 0, 0, 1, 5
"d:\IDEWORK\lvmen\src\licensedcode\data\rules\apache-2.0_582.yml", "YAML", 0, 0, 0, 3, 0, 0, 1, 4
"d:\IDEWORK\lvmen\src\licensedcode\data\rules\apache-2.0_583.yml", "YAML", 0, 0, 0, 5, 0, 0, 1, 6
"d:\IDEWORK\lvmen\src\licensedcode\data\rules\apache-2.0_584.yml", "YAML", 0, 0, 0, 7, 0, 0, 1, 8
"d:\IDEWORK\lvmen\src\licensedcode\data\rules\apache-2.0_585.yml", "YAML", 0, 0, 0, 6, 0, 0, 1, 7
"d:\IDEWORK\lvmen\src\licensedcode\data\rules\apache-2.0_586.yml", "YAML", 0, 0, 0, 5, 0, 0, 1, 6
"d:\IDEWORK\lvmen\src\licensedcode\data\rules\apache-2.0_587.yml", "YAML", 0, 0, 0, 6, 0, 0, 1, 7
"d:\IDEWORK\lvmen\src\licensedcode\data\rules\apache-2.0_588.yml", "YAML", 0, 0, 0, 7, 0, 0, 1, 8
"d:\IDEWORK\lvmen\src\licensedcode\data\rules\apache-2.0_589.yml", "YAML", 0, 0, 0, 6, 0, 0, 1, 7
"d:\IDEWORK\lvmen\src\licensedcode\data\rules\apache-2.0_59.yml", "YAML", 0, 0, 0, 6, 0, 0, 1, 7
"d:\IDEWORK\lvmen\src\licensedcode\data\rules\apache-2.0_590.yml", "YAML", 0, 0, 0, 5, 0, 0, 1, 6
"d:\IDEWORK\lvmen\src\licensedcode\data\rules\apache-2.0_591.yml", "YAML", 0, 0, 0, 3, 0, 0, 1, 4
"d:\IDEWORK\lvmen\src\licensedcode\data\rules\apache-2.0_592.yml", "YAML", 0, 0, 0, 4, 0, 0, 1, 5
"d:\IDEWORK\lvmen\src\licensedcode\data\rules\apache-2.0_593.yml", "YAML", 0, 0, 0, 3, 0, 0, 1, 4
"d:\IDEWORK\lvmen\src\licensedcode\data\rules\apache-2.0_594.yml", "YAML", 0, 0, 0, 3, 0, 0, 1, 4
"d:\IDEWORK\lvmen\src\licensedcode\data\rules\apache-2.0_595.yml", "YAML", 0, 0, 0, 3, 0, 0, 1, 4
"d:\IDEWORK\lvmen\src\licensedcode\data\rules\apache-2.0_596.yml", "YAML", 0, 0, 0, 3, 0, 0, 1, 4
"d:\IDEWORK\lvmen\src\licensedcode\data\rules\apache-2.0_597.yml", "YAML", 0, 0, 0, 3, 0, 0, 1, 4
"d:\IDEWORK\lvmen\src\licensedcode\data\rules\apache-2.0_598.yml", "YAML", 0, 0, 0, 5, 0, 0, 1, 6
"d:\IDEWORK\lvmen\src\licensedcode\data\rules\apache-2.0_599.yml", "YAML", 0, 0, 0, 3, 0, 0, 1, 4
"d:\IDEWORK\lvmen\src\licensedcode\data\rules\apache-2.0_6.yml", "YAML", 0, 0, 0, 3, 0, 0, 1, 4
"d:\IDEWORK\lvmen\src\licensedcode\data\rules\apache-2.0_60.yml", "YAML", 0, 0, 0, 5, 0, 0, 1, 6
"d:\IDEWORK\lvmen\src\licensedcode\data\rules\apache-2.0_600.yml", "YAML", 0, 0, 0, 3, 0, 0, 1, 4
"d:\IDEWORK\lvmen\src\licensedcode\data\rules\apache-2.0_601.yml", "YAML", 0, 0, 0, 5, 0, 0, 1, 6
"d:\IDEWORK\lvmen\src\licensedcode\data\rules\apache-2.0_602.yml", "YAML", 0, 0, 0, 3, 0, 0, 1, 4
"d:\IDEWORK\lvmen\src\licensedcode\data\rules\apache-2.0_603.yml", "YAML", 0, 0, 0, 3, 0, 0, 1, 4
"d:\IDEWORK\lvmen\src\licensedcode\data\rules\apache-2.0_604.yml", "YAML", 0, 0, 0, 3, 0, 0, 1, 4
"d:\IDEWORK\lvmen\src\licensedcode\data\rules\apache-2.0_605.yml", "YAML", 0, 0, 0, 3, 0, 0, 1, 4
"d:\IDEWORK\lvmen\src\licensedcode\data\rules\apache-2.0_606.yml", "YAML", 0, 0, 0, 3, 0, 0, 1, 4
"d:\IDEWORK\lvmen\src\licensedcode\data\rules\apache-2.0_607.yml", "YAML", 0, 0, 0, 5, 0, 0, 1, 6
"d:\IDEWORK\lvmen\src\licensedcode\data\rules\apache-2.0_608.yml", "YAML", 0, 0, 0, 3, 0, 0, 1, 4
"d:\IDEWORK\lvmen\src\licensedcode\data\rules\apache-2.0_609.yml", "YAML", 0, 0, 0, 3, 0, 0, 1, 4
"d:\IDEWORK\lvmen\src\licensedcode\data\rules\apache-2.0_61.yml", "YAML", 0, 0, 0, 3, 0, 0, 1, 4
"d:\IDEWORK\lvmen\src\licensedcode\data\rules\apache-2.0_610.yml", "YAML", 0, 0, 0, 5, 0, 0, 1, 6
"d:\IDEWORK\lvmen\src\licensedcode\data\rules\apache-2.0_611.yml", "YAML", 0, 0, 0, 3, 0, 0, 1, 4
"d:\IDEWORK\lvmen\src\licensedcode\data\rules\apache-2.0_612.yml", "YAML", 0, 0, 0, 3, 0, 0, 1, 4
"d:\IDEWORK\lvmen\src\licensedcode\data\rules\apache-2.0_613.yml", "YAML", 0, 0, 0, 3, 0, 0, 1, 4
"d:\IDEWORK\lvmen\src\licensedcode\data\rules\apache-2.0_614.yml", "YAML", 0, 0, 0, 3, 0, 0, 1, 4
"d:\IDEWORK\lvmen\src\licensedcode\data\rules\apache-2.0_615.yml", "YAML", 0, 0, 0, 3, 0, 0, 1, 4
"d:\IDEWORK\lvmen\src\licensedcode\data\rules\apache-2.0_616.yml", "YAML", 0, 0, 0, 5, 0, 0, 1, 6
"d:\IDEWORK\lvmen\src\licensedcode\data\rules\apache-2.0_617.yml", "YAML", 0, 0, 0, 3, 0, 0, 1, 4
"d:\IDEWORK\lvmen\src\licensedcode\data\rules\apache-2.0_618.yml", "YAML", 0, 0, 0, 3, 0, 0, 1, 4
"d:\IDEWORK\lvmen\src\licensedcode\data\rules\apache-2.0_619.yml", "YAML", 0, 0, 0, 5, 0, 0, 1, 6
"d:\IDEWORK\lvmen\src\licensedcode\data\rules\apache-2.0_62.yml", "YAML", 0, 0, 0, 6, 0, 0, 1, 7
"d:\IDEWORK\lvmen\src\licensedcode\data\rules\apache-2.0_620.yml", "YAML", 0, 0, 0, 5, 0, 0, 1, 6
"d:\IDEWORK\lvmen\src\licensedcode\data\rules\apache-2.0_621.yml", "YAML", 0, 0, 0, 5, 0, 0, 1, 6
"d:\IDEWORK\lvmen\src\licensedcode\data\rules\apache-2.0_622.yml", "YAML", 0, 0, 0, 5, 0, 0, 1, 6
"d:\IDEWORK\lvmen\src\licensedcode\data\rules\apache-2.0_623.yml", "YAML", 0, 0, 0, 5, 0, 0, 1, 6
"d:\IDEWORK\lvmen\src\licensedcode\data\rules\apache-2.0_624.yml", "YAML", 0, 0, 0, 5, 0, 0, 1, 6
"d:\IDEWORK\lvmen\src\licensedcode\data\rules\apache-2.0_625.yml", "YAML", 0, 0, 0, 5, 0, 0, 1, 6
"d:\IDEWORK\lvmen\src\licensedcode\data\rules\apache-2.0_626.yml", "YAML", 0, 0, 0, 5, 0, 0, 1, 6
"d:\IDEWORK\lvmen\src\licensedcode\data\rules\apache-2.0_627.yml", "YAML", 0, 0, 0, 5, 0, 0, 1, 6
"d:\IDEWORK\lvmen\src\licensedcode\data\rules\apache-2.0_628.yml", "YAML", 0, 0, 0, 5, 0, 0, 1, 6
"d:\IDEWORK\lvmen\src\licensedcode\data\rules\apache-2.0_629.yml", "YAML", 0, 0, 0, 5, 0, 0, 1, 6
"d:\IDEWORK\lvmen\src\licensedcode\data\rules\apache-2.0_63.yml", "YAML", 0, 0, 0, 3, 0, 0, 1, 4
"d:\IDEWORK\lvmen\src\licensedcode\data\rules\apache-2.0_630.yml", "YAML", 0, 0, 0, 5, 0, 0, 1, 6
"d:\IDEWORK\lvmen\src\licensedcode\data\rules\apache-2.0_631.yml", "YAML", 0, 0, 0, 5, 0, 0, 1, 6
"d:\IDEWORK\lvmen\src\licensedcode\data\rules\apache-2.0_632.yml", "YAML", 0, 0, 0, 3, 0, 0, 1, 4
"d:\IDEWORK\lvmen\src\licensedcode\data\rules\apache-2.0_633.yml", "YAML", 0, 0, 0, 3, 0, 0, 1, 4
"d:\IDEWORK\lvmen\src\licensedcode\data\rules\apache-2.0_634.yml", "YAML", 0, 0, 0, 3, 0, 0, 1, 4
"d:\IDEWORK\lvmen\src\licensedcode\data\rules\apache-2.0_635.yml", "YAML", 0, 0, 0, 3, 0, 0, 1, 4
"d:\IDEWORK\lvmen\src\licensedcode\data\rules\apache-2.0_636.yml", "YAML", 0, 0, 0, 3, 0, 0, 1, 4
"d:\IDEWORK\lvmen\src\licensedcode\data\rules\apache-2.0_637.yml", "YAML", 0, 0, 0, 3, 0, 0, 1, 4
"d:\IDEWORK\lvmen\src\licensedcode\data\rules\apache-2.0_638.yml", "YAML", 0, 0, 0, 3, 0, 0, 1, 4
"d:\IDEWORK\lvmen\src\licensedcode\data\rules\apache-2.0_639.yml", "YAML", 0, 0, 0, 3, 0, 0, 1, 4
"d:\IDEWORK\lvmen\src\licensedcode\data\rules\apache-2.0_64.yml", "YAML", 0, 0, 0, 8, 0, 0, 1, 9
"d:\IDEWORK\lvmen\src\licensedcode\data\rules\apache-2.0_640.yml", "YAML", 0, 0, 0, 3, 0, 0, 1, 4
"d:\IDEWORK\lvmen\src\licensedcode\data\rules\apache-2.0_641.yml", "YAML", 0, 0, 0, 4, 0, 0, 1, 5
"d:\IDEWORK\lvmen\src\licensedcode\data\rules\apache-2.0_642.yml", "YAML", 0, 0, 0, 3, 0, 0, 1, 4
"d:\IDEWORK\lvmen\src\licensedcode\data\rules\apache-2.0_643.yml", "YAML", 0, 0, 0, 3, 0, 0, 1, 4
"d:\IDEWORK\lvmen\src\licensedcode\data\rules\apache-2.0_644.yml", "YAML", 0, 0, 0, 3, 0, 0, 1, 4
"d:\IDEWORK\lvmen\src\licensedcode\data\rules\apache-2.0_645.yml", "YAML", 0, 0, 0, 3, 0, 0, 1, 4
"d:\IDEWORK\lvmen\src\licensedcode\data\rules\apache-2.0_646.yml", "YAML", 0, 0, 0, 3, 0, 0, 1, 4
"d:\IDEWORK\lvmen\src\licensedcode\data\rules\apache-2.0_647.yml", "YAML", 0, 0, 0, 3, 0, 0, 1, 4
"d:\IDEWORK\lvmen\src\licensedcode\data\rules\apache-2.0_648.yml", "YAML", 0, 0, 0, 3, 0, 0, 1, 4
"d:\IDEWORK\lvmen\src\licensedcode\data\rules\apache-2.0_649.yml", "YAML", 0, 0, 0, 3, 0, 0, 1, 4
"d:\IDEWORK\lvmen\src\licensedcode\data\rules\apache-2.0_65.yml", "YAML", 0, 0, 0, 3, 0, 0, 1, 4
"d:\IDEWORK\lvmen\src\licensedcode\data\rules\apache-2.0_650.yml", "YAML", 0, 0, 0, 5, 0, 0, 1, 6
"d:\IDEWORK\lvmen\src\licensedcode\data\rules\apache-2.0_651.yml", "YAML", 0, 0, 0, 3, 0, 0, 1, 4
"d:\IDEWORK\lvmen\src\licensedcode\data\rules\apache-2.0_652.yml", "YAML", 0, 0, 0, 3, 0, 0, 1, 4
"d:\IDEWORK\lvmen\src\licensedcode\data\rules\apache-2.0_653.yml", "YAML", 0, 0, 0, 3, 0, 0, 1, 4
"d:\IDEWORK\lvmen\src\licensedcode\data\rules\apache-2.0_654.yml", "YAML", 0, 0, 0, 3, 0, 0, 1, 4
"d:\IDEWORK\lvmen\src\licensedcode\data\rules\apache-2.0_655.yml", "YAML", 0, 0, 0, 3, 0, 0, 1, 4
"d:\IDEWORK\lvmen\src\licensedcode\data\rules\apache-2.0_656.yml", "YAML", 0, 0, 0, 3, 0, 0, 1, 4
"d:\IDEWORK\lvmen\src\licensedcode\data\rules\apache-2.0_657.yml", "YAML", 0, 0, 0, 3, 0, 0, 1, 4
"d:\IDEWORK\lvmen\src\licensedcode\data\rules\apache-2.0_658.yml", "YAML", 0, 0, 0, 3, 0, 0, 1, 4
"d:\IDEWORK\lvmen\src\licensedcode\data\rules\apache-2.0_659.yml", "YAML", 0, 0, 0, 3, 0, 0, 1, 4
"d:\IDEWORK\lvmen\src\licensedcode\data\rules\apache-2.0_66.yml", "YAML", 0, 0, 0, 3, 0, 0, 1, 4
"d:\IDEWORK\lvmen\src\licensedcode\data\rules\apache-2.0_660.yml", "YAML", 0, 0, 0, 5, 0, 0, 1, 6
"d:\IDEWORK\lvmen\src\licensedcode\data\rules\apache-2.0_661.yml", "YAML", 0, 0, 0, 3, 0, 0, 1, 4
"d:\IDEWORK\lvmen\src\licensedcode\data\rules\apache-2.0_662.yml", "YAML", 0, 0, 0, 3, 0, 0, 1, 4
"d:\IDEWORK\lvmen\src\licensedcode\data\rules\apache-2.0_663.yml", "YAML", 0, 0, 0, 8, 0, 0, 1, 9
"d:\IDEWORK\lvmen\src\licensedcode\data\rules\apache-2.0_664.yml", "YAML", 0, 0, 0, 6, 0, 0, 1, 7
"d:\IDEWORK\lvmen\src\licensedcode\data\rules\apache-2.0_665.yml", "YAML", 0, 0, 0, 5, 0, 0, 1, 6
"d:\IDEWORK\lvmen\src\licensedcode\data\rules\apache-2.0_666.yml", "YAML", 0, 0, 0, 3, 0, 0, 1, 4
"d:\IDEWORK\lvmen\src\licensedcode\data\rules\apache-2.0_667.yml", "YAML", 0, 0, 0, 3, 0, 0, 1, 4
"d:\IDEWORK\lvmen\src\licensedcode\data\rules\apache-2.0_668.yml", "YAML", 0, 0, 0, 3, 0, 0, 1, 4
"d:\IDEWORK\lvmen\src\licensedcode\data\rules\apache-2.0_669.yml", "YAML", 0, 0, 0, 3, 0, 0, 1, 4
"d:\IDEWORK\lvmen\src\licensedcode\data\rules\apache-2.0_67.yml", "YAML", 0, 0, 0, 8, 0, 0, 1, 9
"d:\IDEWORK\lvmen\src\licensedcode\data\rules\apache-2.0_670.yml", "YAML", 0, 0, 0, 3, 0, 0, 1, 4
"d:\IDEWORK\lvmen\src\licensedcode\data\rules\apache-2.0_671.yml", "YAML", 0, 0, 0, 3, 0, 0, 1, 4
"d:\IDEWORK\lvmen\src\licensedcode\data\rules\apache-2.0_672.yml", "YAML", 0, 0, 0, 3, 0, 0, 1, 4
"d:\IDEWORK\lvmen\src\licensedcode\data\rules\apache-2.0_673.yml", "YAML", 0, 0, 0, 3, 0, 0, 1, 4
"d:\IDEWORK\lvmen\src\licensedcode\data\rules\apache-2.0_674.yml", "YAML", 0, 0, 0, 5, 0, 0, 1, 6
"d:\IDEWORK\lvmen\src\licensedcode\data\rules\apache-2.0_675.yml", "YAML", 0, 0, 0, 5, 0, 0, 1, 6
"d:\IDEWORK\lvmen\src\licensedcode\data\rules\apache-2.0_676.yml", "YAML", 0, 0, 0, 7, 0, 0, 1, 8
"d:\IDEWORK\lvmen\src\licensedcode\data\rules\apache-2.0_677.yml", "YAML", 0, 0, 0, 3, 0, 0, 1, 4
"d:\IDEWORK\lvmen\src\licensedcode\data\rules\apache-2.0_678.yml", "YAML", 0, 0, 0, 3, 0, 0, 1, 4
"d:\IDEWORK\lvmen\src\licensedcode\data\rules\apache-2.0_679.yml", "YAML", 0, 0, 0, 7, 0, 0, 1, 8
"d:\IDEWORK\lvmen\src\licensedcode\data\rules\apache-2.0_68.yml", "YAML", 0, 0, 0, 3, 0, 0, 1, 4
"d:\IDEWORK\lvmen\src\licensedcode\data\rules\apache-2.0_680.yml", "YAML", 0, 0, 0, 3, 0, 0, 1, 4
"d:\IDEWORK\lvmen\src\licensedcode\data\rules\apache-2.0_681.yml", "YAML", 0, 0, 0, 5, 0, 0, 1, 6
"d:\IDEWORK\lvmen\src\licensedcode\data\rules\apache-2.0_682.yml", "YAML", 0, 0, 0, 5, 0, 0, 1, 6
"d:\IDEWORK\lvmen\src\licensedcode\data\rules\apache-2.0_683.yml", "YAML", 0, 0, 0, 5, 0, 0, 1, 6
"d:\IDEWORK\lvmen\src\licensedcode\data\rules\apache-2.0_684.yml", "YAML", 0, 0, 0, 3, 0, 0, 1, 4
"d:\IDEWORK\lvmen\src\licensedcode\data\rules\apache-2.0_685.yml", "YAML", 0, 0, 0, 5, 0, 0, 1, 6
"d:\IDEWORK\lvmen\src\licensedcode\data\rules\apache-2.0_686.yml", "YAML", 0, 0, 0, 7, 0, 0, 1, 8
"d:\IDEWORK\lvmen\src\licensedcode\data\rules\apache-2.0_687.yml", "YAML", 0, 0, 0, 7, 0, 0, 1, 8
"d:\IDEWORK\lvmen\src\licensedcode\data\rules\apache-2.0_688.yml", "YAML", 0, 0, 0, 7, 0, 0, 1, 8
"d:\IDEWORK\lvmen\src\licensedcode\data\rules\apache-2.0_689.yml", "YAML", 0, 0, 0, 8, 0, 0, 1, 9
"d:\IDEWORK\lvmen\src\licensedcode\data\rules\apache-2.0_69.yml", "YAML", 0, 0, 0, 5, 0, 0, 1, 6
"d:\IDEWORK\lvmen\src\licensedcode\data\rules\apache-2.0_690.yml", "YAML", 0, 0, 0, 7, 0, 0, 1, 8
"d:\IDEWORK\lvmen\src\licensedcode\data\rules\apache-2.0_691.yml", "YAML", 0, 0, 0, 3, 0, 0, 1, 4
"d:\IDEWORK\lvmen\src\licensedcode\data\rules\apache-2.0_692.yml", "YAML", 0, 0, 0, 3, 0, 0, 1, 4
"d:\IDEWORK\lvmen\src\licensedcode\data\rules\apache-2.0_693.yml", "YAML", 0, 0, 0, 5, 0, 0, 1, 6
"d:\IDEWORK\lvmen\src\licensedcode\data\rules\apache-2.0_694.yml", "YAML", 0, 0, 0, 5, 0, 0, 1, 6
"d:\IDEWORK\lvmen\src\licensedcode\data\rules\apache-2.0_695.yml", "YAML", 0, 0, 0, 3, 0, 0, 1, 4
"d:\IDEWORK\lvmen\src\licensedcode\data\rules\apache-2.0_696.yml", "YAML", 0, 0, 0, 5, 0, 0, 1, 6
"d:\IDEWORK\lvmen\src\licensedcode\data\rules\apache-2.0_697.yml", "YAML", 0, 0, 0, 5, 0, 0, 1, 6
"d:\IDEWORK\lvmen\src\licensedcode\data\rules\apache-2.0_698.yml", "YAML", 0, 0, 0, 3, 0, 0, 1, 4
"d:\IDEWORK\lvmen\src\licensedcode\data\rules\apache-2.0_699.yml", "YAML", 0, 0, 0, 3, 0, 0, 1, 4
"d:\IDEWORK\lvmen\src\licensedcode\data\rules\apache-2.0_7.yml", "YAML", 0, 0, 0, 5, 0, 0, 1, 6
"d:\IDEWORK\lvmen\src\licensedcode\data\rules\apache-2.0_70.yml", "YAML", 0, 0, 0, 4, 0, 0, 1, 5
"d:\IDEWORK\lvmen\src\licensedcode\data\rules\apache-2.0_700.yml", "YAML", 0, 0, 0, 3, 0, 0, 1, 4
"d:\IDEWORK\lvmen\src\licensedcode\data\rules\apache-2.0_701.yml", "YAML", 0, 0, 0, 3, 0, 0, 1, 4
"d:\IDEWORK\lvmen\src\licensedcode\data\rules\apache-2.0_702.yml", "YAML", 0, 0, 0, 3, 0, 0, 1, 4
"d:\IDEWORK\lvmen\src\licensedcode\data\rules\apache-2.0_703.yml", "YAML", 0, 0, 0, 3, 0, 0, 1, 4
"d:\IDEWORK\lvmen\src\licensedcode\data\rules\apache-2.0_704.yml", "YAML", 0, 0, 0, 4, 0, 0, 1, 5
"d:\IDEWORK\lvmen\src\licensedcode\data\rules\apache-2.0_705.yml", "YAML", 0, 0, 0, 4, 0, 0, 1, 5
"d:\IDEWORK\lvmen\src\licensedcode\data\rules\apache-2.0_706.yml", "YAML", 0, 0, 0, 3, 0, 0, 1, 4
"d:\IDEWORK\lvmen\src\licensedcode\data\rules\apache-2.0_707.yml", "YAML", 0, 0, 0, 5, 0, 0, 1, 6
"d:\IDEWORK\lvmen\src\licensedcode\data\rules\apache-2.0_708.yml", "YAML", 0, 0, 0, 5, 0, 0, 1, 6
"d:\IDEWORK\lvmen\src\licensedcode\data\rules\apache-2.0_709.yml", "YAML", 0, 0, 0, 4, 0, 0, 1, 5
"d:\IDEWORK\lvmen\src\licensedcode\data\rules\apache-2.0_71.yml", "YAML", 0, 0, 0, 5, 0, 0, 1, 6
"d:\IDEWORK\lvmen\src\licensedcode\data\rules\apache-2.0_710.yml", "YAML", 0, 0, 0, 5, 0, 0, 1, 6
"d:\IDEWORK\lvmen\src\licensedcode\data\rules\apache-2.0_711.yml", "YAML", 0, 0, 0, 5, 0, 0, 1, 6
"d:\IDEWORK\lvmen\src\licensedcode\data\rules\apache-2.0_712.yml", "YAML", 0, 0, 0, 4, 0, 0, 1, 5
"d:\IDEWORK\lvmen\src\licensedcode\data\rules\apache-2.0_713.yml", "YAML", 0, 0, 0, 3, 0, 0, 1, 4
"d:\IDEWORK\lvmen\src\licensedcode\data\rules\apache-2.0_714.yml", "YAML", 0, 0, 0, 3, 0, 0, 1, 4
"d:\IDEWORK\lvmen\src\licensedcode\data\rules\apache-2.0_715.yml", "YAML", 0, 0, 0, 5, 0, 0, 1, 6
"d:\IDEWORK\lvmen\src\licensedcode\data\rules\apache-2.0_716.yml", "YAML", 0, 0, 0, 7, 0, 0, 1, 8
"d:\IDEWORK\lvmen\src\licensedcode\data\rules\apache-2.0_717.yml", "YAML", 0, 0, 0, 3, 0, 0, 1, 4
"d:\IDEWORK\lvmen\src\licensedcode\data\rules\apache-2.0_718.yml", "YAML", 0, 0, 0, 3, 0, 0, 1, 4
"d:\IDEWORK\lvmen\src\licensedcode\data\rules\apache-2.0_719.yml", "YAML", 0, 0, 0, 3, 0, 0, 1, 4
"d:\IDEWORK\lvmen\src\licensedcode\data\rules\apache-2.0_72.yml", "YAML", 0, 0, 0, 2, 0, 0, 1, 3
"d:\IDEWORK\lvmen\src\licensedcode\data\rules\apache-2.0_720.yml", "YAML", 0, 0, 0, 5, 0, 0, 1, 6
"d:\IDEWORK\lvmen\src\licensedcode\data\rules\apache-2.0_721.yml", "YAML", 0, 0, 0, 5, 0, 0, 1, 6
"d:\IDEWORK\lvmen\src\licensedcode\data\rules\apache-2.0_722.yml", "YAML", 0, 0, 0, 6, 0, 0, 1, 7
"d:\IDEWORK\lvmen\src\licensedcode\data\rules\apache-2.0_723.yml", "YAML", 0, 0, 0, 5, 0, 0, 1, 6
"d:\IDEWORK\lvmen\src\licensedcode\data\rules\apache-2.0_724.yml", "YAML", 0, 0, 0, 5, 0, 0, 1, 6
"d:\IDEWORK\lvmen\src\licensedcode\data\rules\apache-2.0_725.yml", "YAML", 0, 0, 0, 8, 0, 0, 1, 9
"d:\IDEWORK\lvmen\src\licensedcode\data\rules\apache-2.0_726.yml", "YAML", 0, 0, 0, 6, 0, 0, 1, 7
"d:\IDEWORK\lvmen\src\licensedcode\data\rules\apache-2.0_727.yml", "YAML", 0, 0, 0, 5, 0, 0, 1, 6
"d:\IDEWORK\lvmen\src\licensedcode\data\rules\apache-2.0_728.yml", "YAML", 0, 0, 0, 7, 0, 0, 1, 8
"d:\IDEWORK\lvmen\src\licensedcode\data\rules\apache-2.0_729.yml", "YAML", 0, 0, 0, 6, 0, 0, 1, 7
"d:\IDEWORK\lvmen\src\licensedcode\data\rules\apache-2.0_73.yml", "YAML", 0, 0, 0, 3, 0, 0, 1, 4
"d:\IDEWORK\lvmen\src\licensedcode\data\rules\apache-2.0_730.yml", "YAML", 0, 0, 0, 5, 0, 0, 1, 6
"d:\IDEWORK\lvmen\src\licensedcode\data\rules\apache-2.0_731.yml", "YAML", 0, 0, 0, 7, 0, 0, 1, 8
"d:\IDEWORK\lvmen\src\licensedcode\data\rules\apache-2.0_732.yml", "YAML", 0, 0, 0, 6, 0, 0, 1, 7
"d:\IDEWORK\lvmen\src\licensedcode\data\rules\apache-2.0_733.yml", "YAML", 0, 0, 0, 5, 0, 0, 1, 6
"d:\IDEWORK\lvmen\src\licensedcode\data\rules\apache-2.0_734.yml", "YAML", 0, 0, 0, 3, 0, 0, 1, 4
"d:\IDEWORK\lvmen\src\licensedcode\data\rules\apache-2.0_735.yml", "YAML", 0, 0, 0, 5, 0, 0, 1, 6
"d:\IDEWORK\lvmen\src\licensedcode\data\rules\apache-2.0_736.yml", "YAML", 0, 0, 0, 8, 0, 0, 1, 9
"d:\IDEWORK\lvmen\src\licensedcode\data\rules\apache-2.0_737.yml", "YAML", 0, 0, 0, 5, 0, 0, 1, 6
"d:\IDEWORK\lvmen\src\licensedcode\data\rules\apache-2.0_738.yml", "YAML", 0, 0, 0, 6, 0, 0, 1, 7
"d:\IDEWORK\lvmen\src\licensedcode\data\rules\apache-2.0_739.yml", "YAML", 0, 0, 0, 5, 0, 0, 1, 6
"d:\IDEWORK\lvmen\src\licensedcode\data\rules\apache-2.0_74.yml", "YAML", 0, 0, 0, 3, 0, 0, 1, 4
"d:\IDEWORK\lvmen\src\licensedcode\data\rules\apache-2.0_740.yml", "YAML", 0, 0, 0, 5, 0, 0, 1, 6
"d:\IDEWORK\lvmen\src\licensedcode\data\rules\apache-2.0_741.yml", "YAML", 0, 0, 0, 7, 0, 0, 1, 8
"d:\IDEWORK\lvmen\src\licensedcode\data\rules\apache-2.0_742.yml", "YAML", 0, 0, 0, 5, 0, 0, 1, 6
"d:\IDEWORK\lvmen\src\licensedcode\data\rules\apache-2.0_743.yml", "YAML", 0, 0, 0, 5, 0, 0, 1, 6
"d:\IDEWORK\lvmen\src\licensedcode\data\rules\apache-2.0_744.yml", "YAML", 0, 0, 0, 8, 0, 0, 1, 9
"d:\IDEWORK\lvmen\src\licensedcode\data\rules\apache-2.0_745.yml", "YAML", 0, 0, 0, 5, 0, 0, 1, 6
"d:\IDEWORK\lvmen\src\licensedcode\data\rules\apache-2.0_746.yml", "YAML", 0, 0, 0, 5, 0, 0, 1, 6
"d:\IDEWORK\lvmen\src\licensedcode\data\rules\apache-2.0_747.yml", "YAML", 0, 0, 0, 5, 0, 0, 1, 6
"d:\IDEWORK\lvmen\src\licensedcode\data\rules\apache-2.0_748.yml", "YAML", 0, 0, 0, 7, 0, 0, 1, 8
"d:\IDEWORK\lvmen\src\licensedcode\data\rules\apache-2.0_749.yml", "YAML", 0, 0, 0, 5, 0, 0, 1, 6
"d:\IDEWORK\lvmen\src\licensedcode\data\rules\apache-2.0_75.yml", "YAML", 0, 0, 0, 4, 0, 0, 1, 5
"d:\IDEWORK\lvmen\src\licensedcode\data\rules\apache-2.0_750.yml", "YAML", 0, 0, 0, 5, 0, 0, 1, 6
"d:\IDEWORK\lvmen\src\licensedcode\data\rules\apache-2.0_751.yml", "YAML", 0, 0, 0, 4, 0, 0, 1, 5
"d:\IDEWORK\lvmen\src\licensedcode\data\rules\apache-2.0_752.yml", "YAML", 0, 0, 0, 5, 0, 0, 1, 6
"d:\IDEWORK\lvmen\src\licensedcode\data\rules\apache-2.0_753.yml", "YAML", 0, 0, 0, 5, 0, 0, 1, 6
"d:\IDEWORK\lvmen\src\licensedcode\data\rules\apache-2.0_754.yml", "YAML", 0, 0, 0, 6, 0, 0, 1, 7
"d:\IDEWORK\lvmen\src\licensedcode\data\rules\apache-2.0_755.yml", "YAML", 0, 0, 0, 5, 0, 0, 1, 6
"d:\IDEWORK\lvmen\src\licensedcode\data\rules\apache-2.0_756.yml", "YAML", 0, 0, 0, 5, 0, 0, 1, 6
"d:\IDEWORK\lvmen\src\licensedcode\data\rules\apache-2.0_757.yml", "YAML", 0, 0, 0, 4, 0, 0, 1, 5
"d:\IDEWORK\lvmen\src\licensedcode\data\rules\apache-2.0_758.yml", "YAML", 0, 0, 0, 4, 0, 0, 1, 5
"d:\IDEWORK\lvmen\src\licensedcode\data\rules\apache-2.0_759.yml", "YAML", 0, 0, 0, 6, 0, 0, 1, 7
"d:\IDEWORK\lvmen\src\licensedcode\data\rules\apache-2.0_76.yml", "YAML", 0, 0, 0, 6, 0, 0, 1, 7
"d:\IDEWORK\lvmen\src\licensedcode\data\rules\apache-2.0_760.yml", "YAML", 0, 0, 0, 5, 0, 0, 1, 6
"d:\IDEWORK\lvmen\src\licensedcode\data\rules\apache-2.0_761.yml", "YAML", 0, 0, 0, 5, 0, 0, 1, 6
"d:\IDEWORK\lvmen\src\licensedcode\data\rules\apache-2.0_762.yml", "YAML", 0, 0, 0, 3, 0, 0, 1, 4
"d:\IDEWORK\lvmen\src\licensedcode\data\rules\apache-2.0_763.yml", "YAML", 0, 0, 0, 5, 0, 0, 1, 6
"d:\IDEWORK\lvmen\src\licensedcode\data\rules\apache-2.0_764.yml", "YAML", 0, 0, 0, 5, 0, 0, 1, 6
"d:\IDEWORK\lvmen\src\licensedcode\data\rules\apache-2.0_765.yml", "YAML", 0, 0, 0, 5, 0, 0, 1, 6
"d:\IDEWORK\lvmen\src\licensedcode\data\rules\apache-2.0_766.yml", "YAML", 0, 0, 0, 5, 0, 0, 1, 6
"d:\IDEWORK\lvmen\src\licensedcode\data\rules\apache-2.0_767.yml", "YAML", 0, 0, 0, 5, 0, 0, 1, 6
"d:\IDEWORK\lvmen\src\licensedcode\data\rules\apache-2.0_768.yml", "YAML", 0, 0, 0, 5, 0, 0, 1, 6
"d:\IDEWORK\lvmen\src\licensedcode\data\rules\apache-2.0_769.yml", "YAML", 0, 0, 0, 3, 0, 0, 1, 4
"d:\IDEWORK\lvmen\src\licensedcode\data\rules\apache-2.0_77.yml", "YAML", 0, 0, 0, 5, 0, 0, 1, 6
"d:\IDEWORK\lvmen\src\licensedcode\data\rules\apache-2.0_770.yml", "YAML", 0, 0, 0, 5, 0, 0, 1, 6
"d:\IDEWORK\lvmen\src\licensedcode\data\rules\apache-2.0_771.yml", "YAML", 0, 0, 0, 5, 0, 0, 1, 6
"d:\IDEWORK\lvmen\src\licensedcode\data\rules\apache-2.0_772.yml", "YAML", 0, 0, 0, 4, 0, 0, 1, 5
"d:\IDEWORK\lvmen\src\licensedcode\data\rules\apache-2.0_773.yml", "YAML", 0, 0, 0, 5, 0, 0, 1, 6
"d:\IDEWORK\lvmen\src\licensedcode\data\rules\apache-2.0_774.yml", "YAML", 0, 0, 0, 5, 0, 0, 1, 6
"d:\IDEWORK\lvmen\src\licensedcode\data\rules\apache-2.0_775.yml", "YAML", 0, 0, 0, 5, 0, 0, 1, 6
"d:\IDEWORK\lvmen\src\licensedcode\data\rules\apache-2.0_776.yml", "YAML", 0, 0, 0, 5, 0, 0, 1, 6
"d:\IDEWORK\lvmen\src\licensedcode\data\rules\apache-2.0_777.yml", "YAML", 0, 0, 0, 5, 0, 0, 1, 6
"d:\IDEWORK\lvmen\src\licensedcode\data\rules\apache-2.0_778.yml", "YAML", 0, 0, 0, 3, 0, 0, 1, 4
"d:\IDEWORK\lvmen\src\licensedcode\data\rules\apache-2.0_779.yml", "YAML", 0, 0, 0, 9, 0, 0, 1, 10
"d:\IDEWORK\lvmen\src\licensedcode\data\rules\apache-2.0_78.yml", "YAML", 0, 0, 0, 4, 0, 0, 1, 5
"d:\IDEWORK\lvmen\src\licensedcode\data\rules\apache-2.0_780.yml", "YAML", 0, 0, 0, 5, 0, 0, 1, 6
"d:\IDEWORK\lvmen\src\licensedcode\data\rules\apache-2.0_781.yml", "YAML", 0, 0, 0, 5, 0, 0, 1, 6
"d:\IDEWORK\lvmen\src\licensedcode\data\rules\apache-2.0_782.yml", "YAML", 0, 0, 0, 11, 0, 0, 1, 12
"d:\IDEWORK\lvmen\src\licensedcode\data\rules\apache-2.0_783.yml", "YAML", 0, 0, 0, 8, 0, 0, 1, 9
"d:\IDEWORK\lvmen\src\licensedcode\data\rules\apache-2.0_784.yml", "YAML", 0, 0, 0, 8, 0, 0, 1, 9
"d:\IDEWORK\lvmen\src\licensedcode\data\rules\apache-2.0_785.yml", "YAML", 0, 0, 0, 5, 0, 0, 1, 6
"d:\IDEWORK\lvmen\src\licensedcode\data\rules\apache-2.0_786.yml", "YAML", 0, 0, 0, 5, 0, 0, 1, 6
"d:\IDEWORK\lvmen\src\licensedcode\data\rules\apache-2.0_787.yml", "YAML", 0, 0, 0, 8, 0, 0, 1, 9
"d:\IDEWORK\lvmen\src\licensedcode\data\rules\apache-2.0_788.yml", "YAML", 0, 0, 0, 5, 0, 0, 1, 6
"d:\IDEWORK\lvmen\src\licensedcode\data\rules\apache-2.0_789.yml", "YAML", 0, 0, 0, 6, 0, 0, 1, 7
"d:\IDEWORK\lvmen\src\licensedcode\data\rules\apache-2.0_79.yml", "YAML", 0, 0, 0, 4, 0, 0, 1, 5
"d:\IDEWORK\lvmen\src\licensedcode\data\rules\apache-2.0_790.yml", "YAML", 0, 0, 0, 5, 0, 0, 1, 6
"d:\IDEWORK\lvmen\src\licensedcode\data\rules\apache-2.0_791.yml", "YAML", 0, 0, 0, 5, 0, 0, 1, 6
"d:\IDEWORK\lvmen\src\licensedcode\data\rules\apache-2.0_792.yml", "YAML", 0, 0, 0, 6, 0, 0, 1, 7
"d:\IDEWORK\lvmen\src\licensedcode\data\rules\apache-2.0_793.yml", "YAML", 0, 0, 0, 7, 0, 0, 1, 8
"d:\IDEWORK\lvmen\src\licensedcode\data\rules\apache-2.0_794.yml", "YAML", 0, 0, 0, 5, 0, 0, 1, 6
"d:\IDEWORK\lvmen\src\licensedcode\data\rules\apache-2.0_795.yml", "YAML", 0, 0, 0, 4, 0, 0, 1, 5
"d:\IDEWORK\lvmen\src\licensedcode\data\rules\apache-2.0_796.yml", "YAML", 0, 0, 0, 5, 0, 0, 1, 6
"d:\IDEWORK\lvmen\src\licensedcode\data\rules\apache-2.0_797.yml", "YAML", 0, 0, 0, 5, 0, 0, 1, 6
"d:\IDEWORK\lvmen\src\licensedcode\data\rules\apache-2.0_798.yml", "YAML", 0, 0, 0, 5, 0, 0, 1, 6
"d:\IDEWORK\lvmen\src\licensedcode\data\rules\apache-2.0_799.yml", "YAML", 0, 0, 0, 6, 0, 0, 1, 7
"d:\IDEWORK\lvmen\src\licensedcode\data\rules\apache-2.0_8.yml", "YAML", 0, 0, 0, 5, 0, 0, 1, 6
"d:\IDEWORK\lvmen\src\licensedcode\data\rules\apache-2.0_80.yml", "YAML", 0, 0, 0, 3, 0, 0, 1, 4
"d:\IDEWORK\lvmen\src\licensedcode\data\rules\apache-2.0_800.yml", "YAML", 0, 0, 0, 5, 0, 0, 1, 6
"d:\IDEWORK\lvmen\src\licensedcode\data\rules\apache-2.0_801.yml", "YAML", 0, 0, 0, 4, 0, 0, 1, 5
"d:\IDEWORK\lvmen\src\licensedcode\data\rules\apache-2.0_802.yml", "YAML", 0, 0, 0, 5, 0, 0, 1, 6
"d:\IDEWORK\lvmen\src\licensedcode\data\rules\apache-2.0_803.yml", "YAML", 0, 0, 0, 5, 0, 0, 1, 6
"d:\IDEWORK\lvmen\src\licensedcode\data\rules\apache-2.0_804.yml", "YAML", 0, 0, 0, 5, 0, 0, 1, 6
"d:\IDEWORK\lvmen\src\licensedcode\data\rules\apache-2.0_805.yml", "YAML", 0, 0, 0, 5, 0, 0, 1, 6
"d:\IDEWORK\lvmen\src\licensedcode\data\rules\apache-2.0_806.yml", "YAML", 0, 0, 0, 6, 0, 0, 1, 7
"d:\IDEWORK\lvmen\src\licensedcode\data\rules\apache-2.0_807.yml", "YAML", 0, 0, 0, 5, 0, 0, 1, 6
"d:\IDEWORK\lvmen\src\licensedcode\data\rules\apache-2.0_808.yml", "YAML", 0, 0, 0, 5, 0, 0, 1, 6
"d:\IDEWORK\lvmen\src\licensedcode\data\rules\apache-2.0_809.yml", "YAML", 0, 0, 0, 5, 0, 0, 1, 6
"d:\IDEWORK\lvmen\src\licensedcode\data\rules\apache-2.0_81.yml", "YAML", 0, 0, 0, 3, 0, 0, 1, 4
"d:\IDEWORK\lvmen\src\licensedcode\data\rules\apache-2.0_810.yml", "YAML", 0, 0, 0, 5, 0, 0, 1, 6
"d:\IDEWORK\lvmen\src\licensedcode\data\rules\apache-2.0_811.yml", "YAML", 0, 0, 0, 4, 0, 0, 1, 5
"d:\IDEWORK\lvmen\src\licensedcode\data\rules\apache-2.0_812.yml", "YAML", 0, 0, 0, 5, 0, 0, 1, 6
"d:\IDEWORK\lvmen\src\licensedcode\data\rules\apache-2.0_813.yml", "YAML", 0, 0, 0, 5, 0, 0, 1, 6
"d:\IDEWORK\lvmen\src\licensedcode\data\rules\apache-2.0_814.yml", "YAML", 0, 0, 0, 5, 0, 0, 1, 6
"d:\IDEWORK\lvmen\src\licensedcode\data\rules\apache-2.0_815.yml", "YAML", 0, 0, 0, 5, 0, 0, 1, 6
"d:\IDEWORK\lvmen\src\licensedcode\data\rules\apache-2.0_816.yml", "YAML", 0, 0, 0, 5, 0, 0, 1, 6
"d:\IDEWORK\lvmen\src\licensedcode\data\rules\apache-2.0_817.yml", "YAML", 0, 0, 0, 3, 0, 0, 1, 4
"d:\IDEWORK\lvmen\src\licensedcode\data\rules\apache-2.0_818.yml", "YAML", 0, 0, 0, 4, 0, 0, 1, 5
"d:\IDEWORK\lvmen\src\licensedcode\data\rules\apache-2.0_819.yml", "YAML", 0, 0, 0, 7, 0, 0, 1, 8
"d:\IDEWORK\lvmen\src\licensedcode\data\rules\apache-2.0_82.yml", "YAML", 0, 0, 0, 3, 0, 0, 1, 4
"d:\IDEWORK\lvmen\src\licensedcode\data\rules\apache-2.0_820.yml", "YAML", 0, 0, 0, 8, 0, 0, 1, 9
"d:\IDEWORK\lvmen\src\licensedcode\data\rules\apache-2.0_821.yml", "YAML", 0, 0, 0, 6, 0, 0, 1, 7
"d:\IDEWORK\lvmen\src\licensedcode\data\rules\apache-2.0_822.yml", "YAML", 0, 0, 0, 5, 0, 0, 1, 6
"d:\IDEWORK\lvmen\src\licensedcode\data\rules\apache-2.0_823.yml", "YAML", 0, 0, 0, 6, 0, 0, 1, 7
"d:\IDEWORK\lvmen\src\licensedcode\data\rules\apache-2.0_824.yml", "YAML", 0, 0, 0, 6, 0, 0, 1, 7
"d:\IDEWORK\lvmen\src\licensedcode\data\rules\apache-2.0_825.yml", "YAML", 0, 0, 0, 5, 0, 0, 1, 6
"d:\IDEWORK\lvmen\src\licensedcode\data\rules\apache-2.0_826.yml", "YAML", 0, 0, 0, 7, 0, 0, 1, 8
"d:\IDEWORK\lvmen\src\licensedcode\data\rules\apache-2.0_827.yml", "YAML", 0, 0, 0, 5, 0, 0, 1, 6
"d:\IDEWORK\lvmen\src\licensedcode\data\rules\apache-2.0_828.yml", "YAML", 0, 0, 0, 5, 0, 0, 1, 6
"d:\IDEWORK\lvmen\src\licensedcode\data\rules\apache-2.0_829.yml", "YAML", 0, 0, 0, 4, 0, 0, 1, 5
"d:\IDEWORK\lvmen\src\licensedcode\data\rules\apache-2.0_83.yml", "YAML", 0, 0, 0, 5, 0, 0, 1, 6
"d:\IDEWORK\lvmen\src\licensedcode\data\rules\apache-2.0_830.yml", "YAML", 0, 0, 0, 5, 0, 0, 1, 6
"d:\IDEWORK\lvmen\src\licensedcode\data\rules\apache-2.0_831.yml", "YAML", 0, 0, 0, 5, 0, 0, 1, 6
"d:\IDEWORK\lvmen\src\licensedcode\data\rules\apache-2.0_832.yml", "YAML", 0, 0, 0, 5, 0, 0, 1, 6
"d:\IDEWORK\lvmen\src\licensedcode\data\rules\apache-2.0_833.yml", "YAML", 0, 0, 0, 5, 0, 0, 1, 6
"d:\IDEWORK\lvmen\src\licensedcode\data\rules\apache-2.0_834.yml", "YAML", 0, 0, 0, 5, 0, 0, 1, 6
"d:\IDEWORK\lvmen\src\licensedcode\data\rules\apache-2.0_835.yml", "YAML", 0, 0, 0, 6, 0, 0, 1, 7
"d:\IDEWORK\lvmen\src\licensedcode\data\rules\apache-2.0_836.yml", "YAML", 0, 0, 0, 5, 0, 0, 1, 6
"d:\IDEWORK\lvmen\src\licensedcode\data\rules\apache-2.0_837.yml", "YAML", 0, 0, 0, 4, 0, 0, 1, 5
"d:\IDEWORK\lvmen\src\licensedcode\data\rules\apache-2.0_838.yml", "YAML", 0, 0, 0, 5, 0, 0, 1, 6
"d:\IDEWORK\lvmen\src\licensedcode\data\rules\apache-2.0_839.yml", "YAML", 0, 0, 0, 5, 0, 0, 1, 6
"d:\IDEWORK\lvmen\src\licensedcode\data\rules\apache-2.0_84.yml", "YAML", 0, 0, 0, 3, 0, 0, 1, 4
"d:\IDEWORK\lvmen\src\licensedcode\data\rules\apache-2.0_840.yml", "YAML", 0, 0, 0, 7, 0, 0, 1, 8
"d:\IDEWORK\lvmen\src\licensedcode\data\rules\apache-2.0_841.yml", "YAML", 0, 0, 0, 5, 0, 0, 1, 6
"d:\IDEWORK\lvmen\src\licensedcode\data\rules\apache-2.0_842.yml", "YAML", 0, 0, 0, 5, 0, 0, 1, 6
"d:\IDEWORK\lvmen\src\licensedcode\data\rules\apache-2.0_843.yml", "YAML", 0, 0, 0, 5, 0, 0, 1, 6
"d:\IDEWORK\lvmen\src\licensedcode\data\rules\apache-2.0_844.yml", "YAML", 0, 0, 0, 5, 0, 0, 1, 6
"d:\IDEWORK\lvmen\src\licensedcode\data\rules\apache-2.0_845.yml", "YAML", 0, 0, 0, 7, 0, 0, 1, 8
"d:\IDEWORK\lvmen\src\licensedcode\data\rules\apache-2.0_846.yml", "YAML", 0, 0, 0, 5, 0, 0, 1, 6
"d:\IDEWORK\lvmen\src\licensedcode\data\rules\apache-2.0_847.yml", "YAML", 0, 0, 0, 8, 0, 0, 1, 9
"d:\IDEWORK\lvmen\src\licensedcode\data\rules\apache-2.0_848.yml", "YAML", 0, 0, 0, 5, 0, 0, 1, 6
"d:\IDEWORK\lvmen\src\licensedcode\data\rules\apache-2.0_849.yml", "YAML", 0, 0, 0, 5, 0, 0, 1, 6
"d:\IDEWORK\lvmen\src\licensedcode\data\rules\apache-2.0_85.yml", "YAML", 0, 0, 0, 5, 0, 0, 1, 6
"d:\IDEWORK\lvmen\src\licensedcode\data\rules\apache-2.0_850.yml", "YAML", 0, 0, 0, 6, 0, 0, 1, 7
"d:\IDEWORK\lvmen\src\licensedcode\data\rules\apache-2.0_851.yml", "YAML", 0, 0, 0, 5, 0, 0, 1, 6
"d:\IDEWORK\lvmen\src\licensedcode\data\rules\apache-2.0_852.yml", "YAML", 0, 0, 0, 5, 0, 0, 1, 6
"d:\IDEWORK\lvmen\src\licensedcode\data\rules\apache-2.0_853.yml", "YAML", 0, 0, 0, 5, 0, 0, 1, 6
"d:\IDEWORK\lvmen\src\licensedcode\data\rules\apache-2.0_854.yml", "YAML", 0, 0, 0, 6, 0, 0, 1, 7
"d:\IDEWORK\lvmen\src\licensedcode\data\rules\apache-2.0_855.yml", "YAML", 0, 0, 0, 5, 0, 0, 1, 6
"d:\IDEWORK\lvmen\src\licensedcode\data\rules\apache-2.0_856.yml", "YAML", 0, 0, 0, 6, 0, 0, 1, 7
"d:\IDEWORK\lvmen\src\licensedcode\data\rules\apache-2.0_857.yml", "YAML", 0, 0, 0, 6, 0, 0, 1, 7
"d:\IDEWORK\lvmen\src\licensedcode\data\rules\apache-2.0_858.yml", "YAML", 0, 0, 0, 8, 0, 0, 1, 9
"d:\IDEWORK\lvmen\src\licensedcode\data\rules\apache-2.0_859.yml", "YAML", 0, 0, 0, 5, 0, 0, 1, 6
"d:\IDEWORK\lvmen\src\licensedcode\data\rules\apache-2.0_86.yml", "YAML", 0, 0, 0, 3, 0, 0, 1, 4
"d:\IDEWORK\lvmen\src\licensedcode\data\rules\apache-2.0_860.yml", "YAML", 0, 0, 0, 5, 0, 0, 1, 6
"d:\IDEWORK\lvmen\src\licensedcode\data\rules\apache-2.0_861.yml", "YAML", 0, 0, 0, 4, 0, 0, 1, 5
"d:\IDEWORK\lvmen\src\licensedcode\data\rules\apache-2.0_862.yml", "YAML", 0, 0, 0, 5, 0, 0, 1, 6
"d:\IDEWORK\lvmen\src\licensedcode\data\rules\apache-2.0_863.yml", "YAML", 0, 0, 0, 6, 0, 0, 1, 7
"d:\IDEWORK\lvmen\src\licensedcode\data\rules\apache-2.0_864.yml", "YAML", 0, 0, 0, 5, 0, 0, 1, 6
"d:\IDEWORK\lvmen\src\licensedcode\data\rules\apache-2.0_865.yml", "YAML", 0, 0, 0, 5, 0, 0, 1, 6
"d:\IDEWORK\lvmen\src\licensedcode\data\rules\apache-2.0_866.yml", "YAML", 0, 0, 0, 6, 0, 0, 1, 7
"d:\IDEWORK\lvmen\src\licensedcode\data\rules\apache-2.0_867.yml", "YAML", 0, 0, 0, 5, 0, 0, 1, 6
"d:\IDEWORK\lvmen\src\licensedcode\data\rules\apache-2.0_868.yml", "YAML", 0, 0, 0, 5, 0, 0, 1, 6
"d:\IDEWORK\lvmen\src\licensedcode\data\rules\apache-2.0_869.yml", "YAML", 0, 0, 0, 7, 0, 0, 1, 8
"d:\IDEWORK\lvmen\src\licensedcode\data\rules\apache-2.0_87.yml", "YAML", 0, 0, 0, 5, 0, 0, 1, 6
"d:\IDEWORK\lvmen\src\licensedcode\data\rules\apache-2.0_870.yml", "YAML", 0, 0, 0, 5, 0, 0, 1, 6
"d:\IDEWORK\lvmen\src\licensedcode\data\rules\apache-2.0_871.yml", "YAML", 0, 0, 0, 5, 0, 0, 1, 6
"d:\IDEWORK\lvmen\src\licensedcode\data\rules\apache-2.0_872.yml", "YAML", 0, 0, 0, 7, 0, 0, 1, 8
"d:\IDEWORK\lvmen\src\licensedcode\data\rules\apache-2.0_873.yml", "YAML", 0, 0, 0, 5, 0, 0, 1, 6
"d:\IDEWORK\lvmen\src\licensedcode\data\rules\apache-2.0_874.yml", "YAML", 0, 0, 0, 5, 0, 0, 1, 6
"d:\IDEWORK\lvmen\src\licensedcode\data\rules\apache-2.0_875.yml", "YAML", 0, 0, 0, 4, 0, 0, 1, 5
"d:\IDEWORK\lvmen\src\licensedcode\data\rules\apache-2.0_876.yml", "YAML", 0, 0, 0, 5, 0, 0, 1, 6
"d:\IDEWORK\lvmen\src\licensedcode\data\rules\apache-2.0_877.yml", "YAML", 0, 0, 0, 6, 0, 0, 1, 7
"d:\IDEWORK\lvmen\src\licensedcode\data\rules\apache-2.0_878.yml", "YAML", 0, 0, 0, 8, 0, 0, 1, 9
"d:\IDEWORK\lvmen\src\licensedcode\data\rules\apache-2.0_879.yml", "YAML", 0, 0, 0, 5, 0, 0, 1, 6
"d:\IDEWORK\lvmen\src\licensedcode\data\rules\apache-2.0_88.yml", "YAML", 0, 0, 0, 5, 0, 0, 1, 6
"d:\IDEWORK\lvmen\src\licensedcode\data\rules\apache-2.0_880.yml", "YAML", 0, 0, 0, 5, 0, 0, 1, 6
"d:\IDEWORK\lvmen\src\licensedcode\data\rules\apache-2.0_881.yml", "YAML", 0, 0, 0, 5, 0, 0, 1, 6
"d:\IDEWORK\lvmen\src\licensedcode\data\rules\apache-2.0_882.yml", "YAML", 0, 0, 0, 5, 0, 0, 1, 6
"d:\IDEWORK\lvmen\src\licensedcode\data\rules\apache-2.0_883.yml", "YAML", 0, 0, 0, 8, 0, 0, 1, 9
"d:\IDEWORK\lvmen\src\licensedcode\data\rules\apache-2.0_884.yml", "YAML", 0, 0, 0, 4, 0, 0, 1, 5
"d:\IDEWORK\lvmen\src\licensedcode\data\rules\apache-2.0_885.yml", "YAML", 0, 0, 0, 5, 0, 0, 1, 6
"d:\IDEWORK\lvmen\src\licensedcode\data\rules\apache-2.0_886.yml", "YAML", 0, 0, 0, 5, 0, 0, 1, 6
"d:\IDEWORK\lvmen\src\licensedcode\data\rules\apache-2.0_887.yml", "YAML", 0, 0, 0, 5, 0, 0, 1, 6
"d:\IDEWORK\lvmen\src\licensedcode\data\rules\apache-2.0_888.yml", "YAML", 0, 0, 0, 6, 0, 0, 1, 7
"d:\IDEWORK\lvmen\src\licensedcode\data\rules\apache-2.0_889.yml", "YAML", 0, 0, 0, 5, 0, 0, 1, 6
"d:\IDEWORK\lvmen\src\licensedcode\data\rules\apache-2.0_89.yml", "YAML", 0, 0, 0, 5, 0, 0, 1, 6
"d:\IDEWORK\lvmen\src\licensedcode\data\rules\apache-2.0_890.yml", "YAML", 0, 0, 0, 4, 0, 0, 1, 5
"d:\IDEWORK\lvmen\src\licensedcode\data\rules\apache-2.0_891.yml", "YAML", 0, 0, 0, 5, 0, 0, 1, 6
"d:\IDEWORK\lvmen\src\licensedcode\data\rules\apache-2.0_892.yml", "YAML", 0, 0, 0, 5, 0, 0, 1, 6
"d:\IDEWORK\lvmen\src\licensedcode\data\rules\apache-2.0_893.yml", "YAML", 0, 0, 0, 5, 0, 0, 1, 6
"d:\IDEWORK\lvmen\src\licensedcode\data\rules\apache-2.0_894.yml", "YAML", 0, 0, 0, 5, 0, 0, 1, 6
"d:\IDEWORK\lvmen\src\licensedcode\data\rules\apache-2.0_895.yml", "YAML", 0, 0, 0, 5, 0, 0, 1, 6
"d:\IDEWORK\lvmen\src\licensedcode\data\rules\apache-2.0_896.yml", "YAML", 0, 0, 0, 7, 0, 0, 1, 8
"d:\IDEWORK\lvmen\src\licensedcode\data\rules\apache-2.0_897.yml", "YAML", 0, 0, 0, 7, 0, 0, 1, 8
"d:\IDEWORK\lvmen\src\licensedcode\data\rules\apache-2.0_898.yml", "YAML", 0, 0, 0, 6, 0, 0, 1, 7
"d:\IDEWORK\lvmen\src\licensedcode\data\rules\apache-2.0_899.yml", "YAML", 0, 0, 0, 5, 0, 0, 1, 6
"d:\IDEWORK\lvmen\src\licensedcode\data\rules\apache-2.0_9.yml", "YAML", 0, 0, 0, 3, 0, 0, 1, 4
"d:\IDEWORK\lvmen\src\licensedcode\data\rules\apache-2.0_90.yml", "YAML", 0, 0, 0, 3, 0, 0, 1, 4
"d:\IDEWORK\lvmen\src\licensedcode\data\rules\apache-2.0_900.yml", "YAML", 0, 0, 0, 5, 0, 0, 1, 6
"d:\IDEWORK\lvmen\src\licensedcode\data\rules\apache-2.0_901.yml", "YAML", 0, 0, 0, 5, 0, 0, 1, 6
"d:\IDEWORK\lvmen\src\licensedcode\data\rules\apache-2.0_902.yml", "YAML", 0, 0, 0, 7, 0, 0, 1, 8
"d:\IDEWORK\lvmen\src\licensedcode\data\rules\apache-2.0_903.yml", "YAML", 0, 0, 0, 5, 0, 0, 1, 6
"d:\IDEWORK\lvmen\src\licensedcode\data\rules\apache-2.0_904.yml", "YAML", 0, 0, 0, 4, 0, 0, 1, 5
"d:\IDEWORK\lvmen\src\licensedcode\data\rules\apache-2.0_905.yml", "YAML", 0, 0, 0, 5, 0, 0, 1, 6
"d:\IDEWORK\lvmen\src\licensedcode\data\rules\apache-2.0_906.yml", "YAML", 0, 0, 0, 5, 0, 0, 1, 6
"d:\IDEWORK\lvmen\src\licensedcode\data\rules\apache-2.0_907.yml", "YAML", 0, 0, 0, 5, 0, 0, 1, 6
"d:\IDEWORK\lvmen\src\licensedcode\data\rules\apache-2.0_908.yml", "YAML", 0, 0, 0, 5, 0, 0, 1, 6
"d:\IDEWORK\lvmen\src\licensedcode\data\rules\apache-2.0_909.yml", "YAML", 0, 0, 0, 5, 0, 0, 1, 6
"d:\IDEWORK\lvmen\src\licensedcode\data\rules\apache-2.0_91.yml", "YAML", 0, 0, 0, 3, 0, 0, 1, 4
"d:\IDEWORK\lvmen\src\licensedcode\data\rules\apache-2.0_910.yml", "YAML", 0, 0, 0, 7, 0, 0, 1, 8
"d:\IDEWORK\lvmen\src\licensedcode\data\rules\apache-2.0_911.yml", "YAML", 0, 0, 0, 4, 0, 0, 1, 5
"d:\IDEWORK\lvmen\src\licensedcode\data\rules\apache-2.0_912.yml", "YAML", 0, 0, 0, 5, 0, 0, 1, 6
"d:\IDEWORK\lvmen\src\licensedcode\data\rules\apache-2.0_913.yml", "YAML", 0, 0, 0, 5, 0, 0, 1, 6
"d:\IDEWORK\lvmen\src\licensedcode\data\rules\apache-2.0_914.yml", "YAML", 0, 0, 0, 5, 0, 0, 1, 6
"d:\IDEWORK\lvmen\src\licensedcode\data\rules\apache-2.0_915.yml", "YAML", 0, 0, 0, 4, 0, 0, 1, 5
"d:\IDEWORK\lvmen\src\licensedcode\data\rules\apache-2.0_916.yml", "YAML", 0, 0, 0, 7, 0, 0, 1, 8
"d:\IDEWORK\lvmen\src\licensedcode\data\rules\apache-2.0_917.yml", "YAML", 0, 0, 0, 5, 0, 0, 1, 6
"d:\IDEWORK\lvmen\src\licensedcode\data\rules\apache-2.0_918.yml", "YAML", 0, 0, 0, 10, 0, 0, 1, 11
"d:\IDEWORK\lvmen\src\licensedcode\data\rules\apache-2.0_919.yml", "YAML", 0, 0, 0, 4, 0, 0, 1, 5
"d:\IDEWORK\lvmen\src\licensedcode\data\rules\apache-2.0_92.yml", "YAML", 0, 0, 0, 5, 0, 0, 1, 6
"d:\IDEWORK\lvmen\src\licensedcode\data\rules\apache-2.0_920.yml", "YAML", 0, 0, 0, 4, 0, 0, 1, 5
"d:\IDEWORK\lvmen\src\licensedcode\data\rules\apache-2.0_921.yml", "YAML", 0, 0, 0, 4, 0, 0, 2, 6
"d:\IDEWORK\lvmen\src\licensedcode\data\rules\apache-2.0_922.yml", "YAML", 0, 0, 0, 6, 0, 0, 1, 7
"d:\IDEWORK\lvmen\src\licensedcode\data\rules\apache-2.0_923.yml", "YAML", 0, 0, 0, 6, 0, 0, 1, 7
"d:\IDEWORK\lvmen\src\licensedcode\data\rules\apache-2.0_924.yml", "YAML", 0, 0, 0, 6, 0, 0, 1, 7
"d:\IDEWORK\lvmen\src\licensedcode\data\rules\apache-2.0_925.yml", "YAML", 0, 0, 0, 7, 0, 0, 1, 8
"d:\IDEWORK\lvmen\src\licensedcode\data\rules\apache-2.0_926.yml", "YAML", 0, 0, 0, 3, 0, 0, 1, 4
"d:\IDEWORK\lvmen\src\licensedcode\data\rules\apache-2.0_927.yml", "YAML", 0, 0, 0, 6, 0, 0, 1, 7
"d:\IDEWORK\lvmen\src\licensedcode\data\rules\apache-2.0_928.yml", "YAML", 0, 0, 0, 6, 0, 0, 1, 7
"d:\IDEWORK\lvmen\src\licensedcode\data\rules\apache-2.0_929.yml", "YAML", 0, 0, 0, 4, 0, 0, 1, 5
"d:\IDEWORK\lvmen\src\licensedcode\data\rules\apache-2.0_93.yml", "YAML", 0, 0, 0, 4, 0, 0, 1, 5
"d:\IDEWORK\lvmen\src\licensedcode\data\rules\apache-2.0_930.yml", "YAML", 0, 0, 0, 5, 0, 0, 1, 6
"d:\IDEWORK\lvmen\src\licensedcode\data\rules\apache-2.0_931.yml", "YAML", 0, 0, 0, 5, 0, 0, 1, 6
"d:\IDEWORK\lvmen\src\licensedcode\data\rules\apache-2.0_932.yml", "YAML", 0, 0, 0, 6, 0, 0, 1, 7
"d:\IDEWORK\lvmen\src\licensedcode\data\rules\apache-2.0_933.yml", "YAML", 0, 0, 0, 3, 0, 0, 1, 4
"d:\IDEWORK\lvmen\src\licensedcode\data\rules\apache-2.0_934.yml", "YAML", 0, 0, 0, 5, 0, 0, 1, 6
"d:\IDEWORK\lvmen\src\licensedcode\data\rules\apache-2.0_935.yml", "YAML", 0, 0, 0, 5, 0, 0, 1, 6
"d:\IDEWORK\lvmen\src\licensedcode\data\rules\apache-2.0_936.yml", "YAML", 0, 0, 0, 5, 0, 0, 1, 6
"d:\IDEWORK\lvmen\src\licensedcode\data\rules\apache-2.0_937.yml", "YAML", 0, 0, 0, 5, 0, 0, 1, 6
"d:\IDEWORK\lvmen\src\licensedcode\data\rules\apache-2.0_938.yml", "YAML", 0, 0, 0, 5, 0, 0, 1, 6
"d:\IDEWORK\lvmen\src\licensedcode\data\rules\apache-2.0_939.yml", "YAML", 0, 0, 0, 7, 0, 0, 1, 8
"d:\IDEWORK\lvmen\src\licensedcode\data\rules\apache-2.0_94.yml", "YAML", 0, 0, 0, 3, 0, 0, 1, 4
"d:\IDEWORK\lvmen\src\licensedcode\data\rules\apache-2.0_940.yml", "YAML", 0, 0, 0, 3, 0, 0, 1, 4
"d:\IDEWORK\lvmen\src\licensedcode\data\rules\apache-2.0_941.yml", "YAML", 0, 0, 0, 3, 0, 0, 1, 4
"d:\IDEWORK\lvmen\src\licensedcode\data\rules\apache-2.0_942.yml", "YAML", 0, 0, 0, 3, 0, 0, 1, 4
"d:\IDEWORK\lvmen\src\licensedcode\data\rules\apache-2.0_943.yml", "YAML", 0, 0, 0, 4, 0, 0, 1, 5
"d:\IDEWORK\lvmen\src\licensedcode\data\rules\apache-2.0_944.yml", "YAML", 0, 0, 0, 5, 0, 0, 1, 6
"d:\IDEWORK\lvmen\src\licensedcode\data\rules\apache-2.0_945.yml", "YAML", 0, 0, 0, 4, 0, 0, 1, 5
"d:\IDEWORK\lvmen\src\licensedcode\data\rules\apache-2.0_946.yml", "YAML", 0, 0, 0, 3, 0, 0, 1, 4
"d:\IDEWORK\lvmen\src\licensedcode\data\rules\apache-2.0_947.yml", "YAML", 0, 0, 0, 5, 0, 0, 1, 6
"d:\IDEWORK\lvmen\src\licensedcode\data\rules\apache-2.0_948.yml", "YAML", 0, 0, 0, 4, 0, 0, 1, 5
"d:\IDEWORK\lvmen\src\licensedcode\data\rules\apache-2.0_949.yml", "YAML", 0, 0, 0, 6, 0, 0, 1, 7
"d:\IDEWORK\lvmen\src\licensedcode\data\rules\apache-2.0_95.yml", "YAML", 0, 0, 0, 4, 0, 0, 1, 5
"d:\IDEWORK\lvmen\src\licensedcode\data\rules\apache-2.0_950.yml", "YAML", 0, 0, 0, 4, 0, 0, 1, 5
"d:\IDEWORK\lvmen\src\licensedcode\data\rules\apache-2.0_951.yml", "YAML", 0, 0, 0, 6, 0, 0, 1, 7
"d:\IDEWORK\lvmen\src\licensedcode\data\rules\apache-2.0_952.yml", "YAML", 0, 0, 0, 4, 0, 0, 1, 5
"d:\IDEWORK\lvmen\src\licensedcode\data\rules\apache-2.0_953.yml", "YAML", 0, 0, 0, 3, 0, 0, 1, 4
"d:\IDEWORK\lvmen\src\licensedcode\data\rules\apache-2.0_954.yml", "YAML", 0, 0, 0, 3, 0, 0, 1, 4
"d:\IDEWORK\lvmen\src\licensedcode\data\rules\apache-2.0_955.yml", "YAML", 0, 0, 0, 3, 0, 0, 1, 4
"d:\IDEWORK\lvmen\src\licensedcode\data\rules\apache-2.0_956.yml", "YAML", 0, 0, 0, 3, 0, 0, 1, 4
"d:\IDEWORK\lvmen\src\licensedcode\data\rules\apache-2.0_957.yml", "YAML", 0, 0, 0, 6, 0, 0, 1, 7
"d:\IDEWORK\lvmen\src\licensedcode\data\rules\apache-2.0_958.yml", "YAML", 0, 0, 0, 5, 0, 0, 1, 6
"d:\IDEWORK\lvmen\src\licensedcode\data\rules\apache-2.0_959.yml", "YAML", 0, 0, 0, 4, 0, 0, 1, 5
"d:\IDEWORK\lvmen\src\licensedcode\data\rules\apache-2.0_96.yml", "YAML", 0, 0, 0, 3, 0, 0, 1, 4
"d:\IDEWORK\lvmen\src\licensedcode\data\rules\apache-2.0_960.yml", "YAML", 0, 0, 0, 3, 0, 0, 1, 4
"d:\IDEWORK\lvmen\src\licensedcode\data\rules\apache-2.0_961.yml", "YAML", 0, 0, 0, 5, 0, 0, 1, 6
"d:\IDEWORK\lvmen\src\licensedcode\data\rules\apache-2.0_962.yml", "YAML", 0, 0, 0, 4, 0, 0, 1, 5
"d:\IDEWORK\lvmen\src\licensedcode\data\rules\apache-2.0_963.yml", "YAML", 0, 0, 0, 4, 0, 0, 1, 5
"d:\IDEWORK\lvmen\src\licensedcode\data\rules\apache-2.0_964.yml", "YAML", 0, 0, 0, 6, 0, 0, 1, 7
"d:\IDEWORK\lvmen\src\licensedcode\data\rules\apache-2.0_965.yml", "YAML", 0, 0, 0, 4, 0, 0, 1, 5
"d:\IDEWORK\lvmen\src\licensedcode\data\rules\apache-2.0_966.yml", "YAML", 0, 0, 0, 4, 0, 0, 1, 5
"d:\IDEWORK\lvmen\src\licensedcode\data\rules\apache-2.0_967.yml", "YAML", 0, 0, 0, 5, 0, 0, 1, 6
"d:\IDEWORK\lvmen\src\licensedcode\data\rules\apache-2.0_968.yml", "YAML", 0, 0, 0, 7, 0, 0, 1, 8
"d:\IDEWORK\lvmen\src\licensedcode\data\rules\apache-2.0_969.yml", "YAML", 0, 0, 0, 8, 0, 0, 1, 9
"d:\IDEWORK\lvmen\src\licensedcode\data\rules\apache-2.0_97.yml", "YAML", 0, 0, 0, 3, 0, 0, 1, 4
"d:\IDEWORK\lvmen\src\licensedcode\data\rules\apache-2.0_970.yml", "YAML", 0, 0, 0, 6, 0, 0, 1, 7
"d:\IDEWORK\lvmen\src\licensedcode\data\rules\apache-2.0_971.yml", "YAML", 0, 0, 0, 6, 0, 0, 1, 7
"d:\IDEWORK\lvmen\src\licensedcode\data\rules\apache-2.0_972.yml", "YAML", 0, 0, 0, 7, 0, 0, 1, 8
"d:\IDEWORK\lvmen\src\licensedcode\data\rules\apache-2.0_973.yml", "YAML", 0, 0, 0, 6, 0, 0, 1, 7
"d:\IDEWORK\lvmen\src\licensedcode\data\rules\apache-2.0_974.yml", "YAML", 0, 0, 0, 5, 0, 0, 1, 6
"d:\IDEWORK\lvmen\src\licensedcode\data\rules\apache-2.0_975.yml", "YAML", 0, 0, 0, 8, 0, 0, 1, 9
"d:\IDEWORK\lvmen\src\licensedcode\data\rules\apache-2.0_976.yml", "YAML", 0, 0, 0, 7, 0, 0, 1, 8
"d:\IDEWORK\lvmen\src\licensedcode\data\rules\apache-2.0_977.yml", "YAML", 0, 0, 0, 7, 0, 0, 1, 8
"d:\IDEWORK\lvmen\src\licensedcode\data\rules\apache-2.0_978.yml", "YAML", 0, 0, 0, 6, 0, 0, 1, 7
"d:\IDEWORK\lvmen\src\licensedcode\data\rules\apache-2.0_979.yml", "YAML", 0, 0, 0, 4, 0, 0, 1, 5
"d:\IDEWORK\lvmen\src\licensedcode\data\rules\apache-2.0_98.yml", "YAML", 0, 0, 0, 3, 0, 0, 1, 4
"d:\IDEWORK\lvmen\src\licensedcode\data\rules\apache-2.0_980.yml", "YAML", 0, 0, 0, 8, 0, 0, 1, 9
"d:\IDEWORK\lvmen\src\licensedcode\data\rules\apache-2.0_981.yml", "YAML", 0, 0, 0, 5, 0, 0, 1, 6
"d:\IDEWORK\lvmen\src\licensedcode\data\rules\apache-2.0_982.yml", "YAML", 0, 0, 0, 5, 0, 0, 1, 6
"d:\IDEWORK\lvmen\src\licensedcode\data\rules\apache-2.0_983.yml", "YAML", 0, 0, 0, 5, 0, 0, 1, 6
"d:\IDEWORK\lvmen\src\licensedcode\data\rules\apache-2.0_984.yml", "YAML", 0, 0, 0, 8, 0, 0, 1, 9
"d:\IDEWORK\lvmen\src\licensedcode\data\rules\apache-2.0_985.yml", "YAML", 0, 0, 0, 6, 0, 0, 1, 7
"d:\IDEWORK\lvmen\src\licensedcode\data\rules\apache-2.0_986.yml", "YAML", 0, 0, 0, 8, 0, 0, 1, 9
"d:\IDEWORK\lvmen\src\licensedcode\data\rules\apache-2.0_987.yml", "YAML", 0, 0, 0, 7, 0, 0, 1, 8
"d:\IDEWORK\lvmen\src\licensedcode\data\rules\apache-2.0_988.yml", "YAML", 0, 0, 0, 8, 0, 0, 1, 9
"d:\IDEWORK\lvmen\src\licensedcode\data\rules\apache-2.0_989.yml", "YAML", 0, 0, 0, 6, 0, 0, 1, 7
"d:\IDEWORK\lvmen\src\licensedcode\data\rules\apache-2.0_99.yml", "YAML", 0, 0, 0, 3, 0, 0, 1, 4
"d:\IDEWORK\lvmen\src\licensedcode\data\rules\apache-2.0_990.yml", "YAML", 0, 0, 0, 7, 0, 0, 1, 8
"d:\IDEWORK\lvmen\src\licensedcode\data\rules\apache-2.0_991.yml", "YAML", 0, 0, 0, 8, 0, 0, 1, 9
"d:\IDEWORK\lvmen\src\licensedcode\data\rules\apache-2.0_992.yml", "YAML", 0, 0, 0, 5, 0, 0, 1, 6
"d:\IDEWORK\lvmen\src\licensedcode\data\rules\apache-2.0_993.yml", "YAML", 0, 0, 0, 5, 0, 0, 1, 6
"d:\IDEWORK\lvmen\src\licensedcode\data\rules\apache-2.0_994.yml", "YAML", 0, 0, 0, 5, 0, 0, 1, 6
"d:\IDEWORK\lvmen\src\licensedcode\data\rules\apache-2.0_995.yml", "YAML", 0, 0, 0, 7, 0, 0, 1, 8
"d:\IDEWORK\lvmen\src\licensedcode\data\rules\apache-2.0_996.yml", "YAML", 0, 0, 0, 5, 0, 0, 1, 6
"d:\IDEWORK\lvmen\src\licensedcode\data\rules\apache-2.0_997.yml", "YAML", 0, 0, 0, 7, 0, 0, 1, 8
"d:\IDEWORK\lvmen\src\licensedcode\data\rules\apache-2.0_998.yml", "YAML", 0, 0, 0, 5, 0, 0, 1, 6
"d:\IDEWORK\lvmen\src\licensedcode\data\rules\apache-2.0_999.yml", "YAML", 0, 0, 0, 5, 0, 0, 1, 6
"d:\IDEWORK\lvmen\src\licensedcode\data\rules\apache-2.0_and_bsd-new_1.yml", "YAML", 0, 0, 0, 3, 0, 0, 1, 4
"d:\IDEWORK\lvmen\src\licensedcode\data\rules\apache-2.0_and_bsd-new_2.yml", "YAML", 0, 0, 0, 3, 0, 0, 1, 4
"d:\IDEWORK\lvmen\src\licensedcode\data\rules\apache-2.0_and_bsd-new_and_mit_1.yml", "YAML", 0, 0, 0, 5, 0, 0, 1, 6
"d:\IDEWORK\lvmen\src\licensedcode\data\rules\apache-2.0_and_bsd-new_and_mit_2.yml", "YAML", 0, 0, 0, 6, 0, 0, 1, 7
"d:\IDEWORK\lvmen\src\licensedcode\data\rules\apache-2.0_and_bsd-new_and_mit_url_1.yml", "YAML", 0, 0, 0, 5, 0, 0, 1, 6
"d:\IDEWORK\lvmen\src\licensedcode\data\rules\apache-2.0_and_bsd-new_and_mit_url_2.yml", "YAML", 0, 0, 0, 5, 0, 0, 1, 6
"d:\IDEWORK\lvmen\src\licensedcode\data\rules\apache-2.0_and_bsd-new_and_mit_url_3.yml", "YAML", 0, 0, 0, 5, 0, 0, 1, 6
"d:\IDEWORK\lvmen\src\licensedcode\data\rules\apache-2.0_and_bsd-new_and_mit_url_4.yml", "YAML", 0, 0, 0, 5, 0, 0, 1, 6
"d:\IDEWORK\lvmen\src\licensedcode\data\rules\apache-2.0_and_cc-by-2.5_1.yml", "YAML", 0, 0, 0, 8, 0, 0, 1, 9
"d:\IDEWORK\lvmen\src\licensedcode\data\rules\apache-2.0_and_cc-by-2.5_2.yml", "YAML", 0, 0, 0, 8, 0, 0, 1, 9
"d:\IDEWORK\lvmen\src\licensedcode\data\rules\apache-2.0_and_cc-by-4.0_1.yml", "YAML", 0, 0, 0, 7, 0, 0, 1, 8
"d:\IDEWORK\lvmen\src\licensedcode\data\rules\apache-2.0_and_cc-by-nc-nd-3.0_and_other-permissive_and_proprietary-license_1.yml", "YAML", 0, 0, 0, 5, 0, 0, 1, 6
"d:\IDEWORK\lvmen\src\licensedcode\data\rules\apache-2.0_and_cc-by-sa-3.0_1.yml", "YAML", 0, 0, 0, 3, 0, 0, 1, 4
"d:\IDEWORK\lvmen\src\licensedcode\data\rules\apache-2.0_and_cc-by-sa-4.0_1.yml", "YAML", 0, 0, 0, 6, 0, 0, 1, 7
"d:\IDEWORK\lvmen\src\licensedcode\data\rules\apache-2.0_and_cc-by-sa-4.0_2.yml", "YAML", 0, 0, 0, 9, 0, 0, 1, 10
"d:\IDEWORK\lvmen\src\licensedcode\data\rules\apache-2.0_and_cc-by-sa-4.0_3.yml", "YAML", 0, 0, 0, 6, 0, 0, 1, 7
"d:\IDEWORK\lvmen\src\licensedcode\data\rules\apache-2.0_and_cddl-1.0_1.yml", "YAML", 0, 0, 0, 3, 0, 0, 1, 4
"d:\IDEWORK\lvmen\src\licensedcode\data\rules\apache-2.0_and_cockroach_and_mit_and_bsd-new_1.yml", "YAML", 0, 0, 0, 3, 0, 0, 1, 4
"d:\IDEWORK\lvmen\src\licensedcode\data\rules\apache-2.0_and_dco-1.1_1.yml", "YAML", 0, 0, 0, 3, 0, 0, 1, 4
"d:\IDEWORK\lvmen\src\licensedcode\data\rules\apache-2.0_and_dco-1.1_2.yml", "YAML", 0, 0, 0, 8, 0, 0, 1, 9
"d:\IDEWORK\lvmen\src\licensedcode\data\rules\apache-2.0_and_dgraph-cla_1.yml", "YAML", 0, 0, 0, 3, 0, 0, 1, 4
"d:\IDEWORK\lvmen\src\licensedcode\data\rules\apache-2.0_and_elastic-license-2018_1.yml", "YAML", 0, 0, 0, 6, 0, 0, 1, 7
"d:\IDEWORK\lvmen\src\licensedcode\data\rules\apache-2.0_and_elastic-license-2018_2.yml", "YAML", 0, 0, 0, 6, 0, 0, 1, 7
"d:\IDEWORK\lvmen\src\licensedcode\data\rules\apache-2.0_and_elastic-license-2018_3.yml", "YAML", 0, 0, 0, 5, 0, 0, 1, 6
"d:\IDEWORK\lvmen\src\licensedcode\data\rules\apache-2.0_and_elastic-license-2018_4.yml", "YAML", 0, 0, 0, 3, 0, 0, 1, 4
"d:\IDEWORK\lvmen\src\licensedcode\data\rules\apache-2.0_and_elastic-license-2018_and_other-permissive_1.yml", "YAML", 0, 0, 0, 3, 0, 0, 1, 4
"d:\IDEWORK\lvmen\src\licensedcode\data\rules\apache-2.0_and_free-unknown_1.yml", "YAML", 0, 0, 0, 3, 0, 0, 1, 4
"d:\IDEWORK\lvmen\src\licensedcode\data\rules\apache-2.0_and_free-unknown_2.yml", "YAML", 0, 0, 0, 7, 0, 0, 1, 8
"d:\IDEWORK\lvmen\src\licensedcode\data\rules\apache-2.0_and_free-unknown_zulip.yml", "YAML", 0, 0, 0, 7, 0, 0, 1, 8
"d:\IDEWORK\lvmen\src\licensedcode\data\rules\apache-2.0_and_generic-cla_1.yml", "YAML", 0, 0, 0, 3, 0, 0, 1, 4
"d:\IDEWORK\lvmen\src\licensedcode\data\rules\apache-2.0_and_gpl-2.0_1.yml", "YAML", 0, 0, 0, 4, 0, 0, 1, 5
"d:\IDEWORK\lvmen\src\licensedcode\data\rules\apache-2.0_and_isc_1.yml", "YAML", 0, 0, 0, 5, 0, 0, 1, 6
"d:\IDEWORK\lvmen\src\licensedcode\data\rules\apache-2.0_and_isc_and_mit_1.yml", "YAML", 0, 0, 0, 7, 0, 0, 1, 8
"d:\IDEWORK\lvmen\src\licensedcode\data\rules\apache-2.0_and_jmx_and_nsis_and_ecj.yml", "YAML", 0, 0, 0, 11, 0, 0, 1, 12
"d:\IDEWORK\lvmen\src\licensedcode\data\rules\apache-2.0_and_lgpl-2.0-plus.yml", "YAML", 0, 0, 0, 2, 0, 0, 1, 3
"d:\IDEWORK\lvmen\src\licensedcode\data\rules\apache-2.0_and_lgpl-2.1_1.yml", "YAML", 0, 0, 0, 6, 0, 0, 1, 7
"d:\IDEWORK\lvmen\src\licensedcode\data\rules\apache-2.0_and_lgpl-2.1_2.yml", "YAML", 0, 0, 0, 8, 0, 0, 1, 9
"d:\IDEWORK\lvmen\src\licensedcode\data\rules\apache-2.0_and_lgpl-2.1_3.yml", "YAML", 0, 0, 0, 6, 0, 0, 1, 7
"d:\IDEWORK\lvmen\src\licensedcode\data\rules\apache-2.0_and_lgpl-2.1_4.yml", "YAML", 0, 0, 0, 9, 0, 0, 1, 10
"d:\IDEWORK\lvmen\src\licensedcode\data\rules\apache-2.0_and_lgpl-2.1_5.yml", "YAML", 0, 0, 0, 6, 0, 0, 1, 7
"d:\IDEWORK\lvmen\src\licensedcode\data\rules\apache-2.0_and_lgpl-3.0_1.yml", "YAML", 0, 0, 0, 6, 0, 0, 1, 7
"d:\IDEWORK\lvmen\src\licensedcode\data\rules\apache-2.0_and_maxmind-odl_1.yml", "YAML", 0, 0, 0, 10, 0, 0, 1, 11
"d:\IDEWORK\lvmen\src\licensedcode\data\rules\apache-2.0_and_maxmind-odl_2.yml", "YAML", 0, 0, 0, 10, 0, 0, 1, 11
"d:\IDEWORK\lvmen\src\licensedcode\data\rules\apache-2.0_and_mit_1.yml", "YAML", 0, 0, 0, 3, 0, 0, 1, 4
"d:\IDEWORK\lvmen\src\licensedcode\data\rules\apache-2.0_and_mit_and_bsd-simplified_and_epl-1.0_and_public-domain_and_and_others_1.yml", "YAML", 0, 0, 0, 6, 0, 0, 1, 7
"d:\IDEWORK\lvmen\src\licensedcode\data\rules\apache-2.0_and_mit_nuget_url_1.yml", "YAML", 0, 0, 0, 5, 0, 0, 1, 6
"d:\IDEWORK\lvmen\src\licensedcode\data\rules\apache-2.0_and_ms-pl_or_apache-2.0_and_ms-pl_nuget_url_1.yml", "YAML", 0, 0, 0, 5, 0, 0, 1, 6
"d:\IDEWORK\lvmen\src\licensedcode\data\rules\apache-2.0_and_ofl-1.1_nuget_url_1.yml", "YAML", 0, 0, 0, 5, 0, 0, 1, 6
"d:\IDEWORK\lvmen\src\licensedcode\data\rules\apache-2.0_and_other-permissive_1.yml", "YAML", 0, 0, 0, 5, 0, 0, 1, 6
"d:\IDEWORK\lvmen\src\licensedcode\data\rules\apache-2.0_and_other-permissive_2.yml", "YAML", 0, 0, 0, 3, 0, 0, 1, 4
"d:\IDEWORK\lvmen\src\licensedcode\data\rules\apache-2.0_and_other-permissive_and_gpl-3.0_and_other-copyleft_1.yml", "YAML", 0, 0, 0, 5, 0, 0, 1, 6
"d:\IDEWORK\lvmen\src\licensedcode\data\rules\apache-2.0_and_polyform-free-trial-1.0.0_1.yml", "YAML", 0, 0, 0, 3, 0, 0, 1, 4
"d:\IDEWORK\lvmen\src\licensedcode\data\rules\apache-2.0_and_proprietary-license_1.yml", "YAML", 0, 0, 0, 3, 0, 0, 1, 4
"d:\IDEWORK\lvmen\src\licensedcode\data\rules\apache-2.0_and_proprietary-license_2.yml", "YAML", 0, 0, 0, 7, 0, 0, 1, 8
"d:\IDEWORK\lvmen\src\licensedcode\data\rules\apache-2.0_and_proprietary-license_3.yml", "YAML", 0, 0, 0, 5, 0, 0, 1, 6
"d:\IDEWORK\lvmen\src\licensedcode\data\rules\apache-2.0_and_proprietary-license_4.yml", "YAML", 0, 0, 0, 7, 0, 0, 1, 8
"d:\IDEWORK\lvmen\src\licensedcode\data\rules\apache-2.0_and_proprietary-license_5.yml", "YAML", 0, 0, 0, 7, 0, 0, 1, 8
"d:\IDEWORK\lvmen\src\licensedcode\data\rules\apache-2.0_and_scancode-acknowledgment.yml", "YAML", 0, 0, 0, 6, 0, 0, 1, 7
"d:\IDEWORK\lvmen\src\licensedcode\data\rules\apache-2.0_and_scancode-acknowledgment_1.yml", "YAML", 0, 0, 0, 3, 0, 0, 1, 4
"d:\IDEWORK\lvmen\src\licensedcode\data\rules\apache-2.0_and_scancode-acknowledgment_2.yml", "YAML", 0, 0, 0, 4, 0, 0, 1, 5
"d:\IDEWORK\lvmen\src\licensedcode\data\rules\apache-2.0_and_scancode-acknowledgment_3.yml", "YAML", 0, 0, 0, 11, 0, 0, 1, 12
"d:\IDEWORK\lvmen\src\licensedcode\data\rules\apache-2.0_and_scancode-acknowledgment_4.yml", "YAML", 0, 0, 0, 3, 0, 0, 1, 4
"d:\IDEWORK\lvmen\src\licensedcode\data\rules\apache-2.0_and_scancode-acknowledgment_5.yml", "YAML", 0, 0, 0, 3, 0, 0, 1, 4
"d:\IDEWORK\lvmen\src\licensedcode\data\rules\apache-2.0_and_scancode-acknowledgment_6.yml", "YAML", 0, 0, 0, 3, 0, 0, 1, 4
"d:\IDEWORK\lvmen\src\licensedcode\data\rules\apache-2.0_and_trademark-notice_1.yml", "YAML", 0, 0, 0, 6, 0, 0, 1, 7
"d:\IDEWORK\lvmen\src\licensedcode\data\rules\apache-2.0_and_trademark-notice_2.yml", "YAML", 0, 0, 0, 6, 0, 0, 1, 7
"d:\IDEWORK\lvmen\src\licensedcode\data\rules\apache-2.0_and_unknown-license-reference_1.yml", "YAML", 0, 0, 0, 6, 0, 0, 1, 7
"d:\IDEWORK\lvmen\src\licensedcode\data\rules\apache-2.0_and_vim_1.yml", "YAML", 0, 0, 0, 3, 0, 0, 1, 4
"d:\IDEWORK\lvmen\src\licensedcode\data\rules\apache-2.0_and_vim_2.yml", "YAML", 0, 0, 0, 3, 0, 0, 1, 4
"d:\IDEWORK\lvmen\src\licensedcode\data\rules\apache-2.0_and_vim_3.yml", "YAML", 0, 0, 0, 3, 0, 0, 1, 4
"d:\IDEWORK\lvmen\src\licensedcode\data\rules\apache-2.0_and_vim_4.yml", "YAML", 0, 0, 0, 3, 0, 0, 1, 4
"d:\IDEWORK\lvmen\src\licensedcode\data\rules\apache-2.0_and_vim_5.yml", "YAML", 0, 0, 0, 4, 0, 0, 1, 5
"d:\IDEWORK\lvmen\src\licensedcode\data\rules\apache-2.0_ant.yml", "YAML", 0, 0, 0, 12, 0, 0, 1, 13
"d:\IDEWORK\lvmen\src\licensedcode\data\rules\apache-2.0_distributed.yml", "YAML", 0, 0, 0, 3, 0, 0, 1, 4
"d:\IDEWORK\lvmen\src\licensedcode\data\rules\apache-2.0_easyeclipse.yml", "YAML", 0, 0, 0, 10, 0, 0, 1, 11
"d:\IDEWORK\lvmen\src\licensedcode\data\rules\apache-2.0_elastic.yml", "YAML", 0, 0, 0, 7, 0, 0, 1, 8
"d:\IDEWORK\lvmen\src\licensedcode\data\rules\apache-2.0_governed.yml", "YAML", 0, 0, 0, 4, 0, 0, 1, 5
"d:\IDEWORK\lvmen\src\licensedcode\data\rules\apache-2.0_jna1.yml", "YAML", 0, 0, 0, 6, 0, 0, 1, 7
"d:\IDEWORK\lvmen\src\licensedcode\data\rules\apache-2.0_not_gpl.yml", "YAML", 0, 0, 0, 3, 0, 0, 1, 4
"d:\IDEWORK\lvmen\src\licensedcode\data\rules\apache-2.0_not_gpl_1.yml", "YAML", 0, 0, 0, 7, 0, 0, 1, 8
"d:\IDEWORK\lvmen\src\licensedcode\data\rules\apache-2.0_notice_1.yml", "YAML", 0, 0, 0, 4, 0, 0, 1, 5
"d:\IDEWORK\lvmen\src\licensedcode\data\rules\apache-2.0_nuget_url_1.yml", "YAML", 0, 0, 0, 5, 0, 0, 1, 6
"d:\IDEWORK\lvmen\src\licensedcode\data\rules\apache-2.0_nuget_url_10.yml", "YAML", 0, 0, 0, 5, 0, 0, 1, 6
"d:\IDEWORK\lvmen\src\licensedcode\data\rules\apache-2.0_nuget_url_11.yml", "YAML", 0, 0, 0, 5, 0, 0, 1, 6
"d:\IDEWORK\lvmen\src\licensedcode\data\rules\apache-2.0_nuget_url_12.yml", "YAML", 0, 0, 0, 5, 0, 0, 1, 6
"d:\IDEWORK\lvmen\src\licensedcode\data\rules\apache-2.0_nuget_url_13.yml", "YAML", 0, 0, 0, 5, 0, 0, 1, 6
"d:\IDEWORK\lvmen\src\licensedcode\data\rules\apache-2.0_nuget_url_14.yml", "YAML", 0, 0, 0, 5, 0, 0, 1, 6
"d:\IDEWORK\lvmen\src\licensedcode\data\rules\apache-2.0_nuget_url_15.yml", "YAML", 0, 0, 0, 5, 0, 0, 1, 6
"d:\IDEWORK\lvmen\src\licensedcode\data\rules\apache-2.0_nuget_url_16.yml", "YAML", 0, 0, 0, 5, 0, 0, 1, 6
"d:\IDEWORK\lvmen\src\licensedcode\data\rules\apache-2.0_nuget_url_17.yml", "YAML", 0, 0, 0, 5, 0, 0, 1, 6
"d:\IDEWORK\lvmen\src\licensedcode\data\rules\apache-2.0_nuget_url_18.yml", "YAML", 0, 0, 0, 5, 0, 0, 1, 6
"d:\IDEWORK\lvmen\src\licensedcode\data\rules\apache-2.0_nuget_url_19.yml", "YAML", 0, 0, 0, 5, 0, 0, 1, 6
"d:\IDEWORK\lvmen\src\licensedcode\data\rules\apache-2.0_nuget_url_2.yml", "YAML", 0, 0, 0, 5, 0, 0, 1, 6
"d:\IDEWORK\lvmen\src\licensedcode\data\rules\apache-2.0_nuget_url_20.yml", "YAML", 0, 0, 0, 5, 0, 0, 1, 6
"d:\IDEWORK\lvmen\src\licensedcode\data\rules\apache-2.0_nuget_url_21.yml", "YAML", 0, 0, 0, 5, 0, 0, 1, 6
"d:\IDEWORK\lvmen\src\licensedcode\data\rules\apache-2.0_nuget_url_22.yml", "YAML", 0, 0, 0, 5, 0, 0, 1, 6
"d:\IDEWORK\lvmen\src\licensedcode\data\rules\apache-2.0_nuget_url_23.yml", "YAML", 0, 0, 0, 5, 0, 0, 1, 6
"d:\IDEWORK\lvmen\src\licensedcode\data\rules\apache-2.0_nuget_url_24.yml", "YAML", 0, 0, 0, 5, 0, 0, 1, 6
"d:\IDEWORK\lvmen\src\licensedcode\data\rules\apache-2.0_nuget_url_25.yml", "YAML", 0, 0, 0, 5, 0, 0, 1, 6
"d:\IDEWORK\lvmen\src\licensedcode\data\rules\apache-2.0_nuget_url_26.yml", "YAML", 0, 0, 0, 5, 0, 0, 1, 6
"d:\IDEWORK\lvmen\src\licensedcode\data\rules\apache-2.0_nuget_url_27.yml", "YAML", 0, 0, 0, 5, 0, 0, 1, 6
"d:\IDEWORK\lvmen\src\licensedcode\data\rules\apache-2.0_nuget_url_28.yml", "YAML", 0, 0, 0, 5, 0, 0, 1, 6
"d:\IDEWORK\lvmen\src\licensedcode\data\rules\apache-2.0_nuget_url_29.yml", "YAML", 0, 0, 0, 5, 0, 0, 1, 6
"d:\IDEWORK\lvmen\src\licensedcode\data\rules\apache-2.0_nuget_url_3.yml", "YAML", 0, 0, 0, 5, 0, 0, 1, 6
"d:\IDEWORK\lvmen\src\licensedcode\data\rules\apache-2.0_nuget_url_30.yml", "YAML", 0, 0, 0, 5, 0, 0, 1, 6
"d:\IDEWORK\lvmen\src\licensedcode\data\rules\apache-2.0_nuget_url_31.yml", "YAML", 0, 0, 0, 5, 0, 0, 1, 6
"d:\IDEWORK\lvmen\src\licensedcode\data\rules\apache-2.0_nuget_url_32.yml", "YAML", 0, 0, 0, 5, 0, 0, 1, 6
"d:\IDEWORK\lvmen\src\licensedcode\data\rules\apache-2.0_nuget_url_33.yml", "YAML", 0, 0, 0, 5, 0, 0, 1, 6
"d:\IDEWORK\lvmen\src\licensedcode\data\rules\apache-2.0_nuget_url_34.yml", "YAML", 0, 0, 0, 5, 0, 0, 1, 6
"d:\IDEWORK\lvmen\src\licensedcode\data\rules\apache-2.0_nuget_url_35.yml", "YAML", 0, 0, 0, 5, 0, 0, 1, 6
"d:\IDEWORK\lvmen\src\licensedcode\data\rules\apache-2.0_nuget_url_36.yml", "YAML", 0, 0, 0, 5, 0, 0, 1, 6
"d:\IDEWORK\lvmen\src\licensedcode\data\rules\apache-2.0_nuget_url_37.yml", "YAML", 0, 0, 0, 5, 0, 0, 1, 6
"d:\IDEWORK\lvmen\src\licensedcode\data\rules\apache-2.0_nuget_url_38.yml", "YAML", 0, 0, 0, 5, 0, 0, 1, 6
"d:\IDEWORK\lvmen\src\licensedcode\data\rules\apache-2.0_nuget_url_39.yml", "YAML", 0, 0, 0, 5, 0, 0, 1, 6
"d:\IDEWORK\lvmen\src\licensedcode\data\rules\apache-2.0_nuget_url_4.yml", "YAML", 0, 0, 0, 5, 0, 0, 1, 6
"d:\IDEWORK\lvmen\src\licensedcode\data\rules\apache-2.0_nuget_url_40.yml", "YAML", 0, 0, 0, 5, 0, 0, 1, 6
"d:\IDEWORK\lvmen\src\licensedcode\data\rules\apache-2.0_nuget_url_41.yml", "YAML", 0, 0, 0, 5, 0, 0, 1, 6
"d:\IDEWORK\lvmen\src\licensedcode\data\rules\apache-2.0_nuget_url_5.yml", "YAML", 0, 0, 0, 5, 0, 0, 1, 6
"d:\IDEWORK\lvmen\src\licensedcode\data\rules\apache-2.0_nuget_url_6.yml", "YAML", 0, 0, 0, 5, 0, 0, 1, 6
"d:\IDEWORK\lvmen\src\licensedcode\data\rules\apache-2.0_nuget_url_7.yml", "YAML", 0, 0, 0, 5, 0, 0, 1, 6
"d:\IDEWORK\lvmen\src\licensedcode\data\rules\apache-2.0_nuget_url_8.yml", "YAML", 0, 0, 0, 5, 0, 0, 1, 6
"d:\IDEWORK\lvmen\src\licensedcode\data\rules\apache-2.0_nuget_url_9.yml", "YAML", 0, 0, 0, 5, 0, 0, 1, 6
"d:\IDEWORK\lvmen\src\licensedcode\data\rules\apache-2.0_opticon.yml", "YAML", 0, 0, 0, 6, 0, 0, 1, 7
"d:\IDEWORK\lvmen\src\licensedcode\data\rules\apache-2.0_or_bsd-new.yml", "YAML", 0, 0, 0, 3, 0, 0, 1, 4
"d:\IDEWORK\lvmen\src\licensedcode\data\rules\apache-2.0_or_bsd-new2.yml", "YAML", 0, 0, 0, 5, 0, 0, 1, 6
"d:\IDEWORK\lvmen\src\licensedcode\data\rules\apache-2.0_or_bsd-new3.yml", "YAML", 0, 0, 0, 2, 0, 0, 1, 3
"d:\IDEWORK\lvmen\src\licensedcode\data\rules\apache-2.0_or_bsd-new_1.yml", "YAML", 0, 0, 0, 2, 0, 0, 1, 3
"d:\IDEWORK\lvmen\src\licensedcode\data\rules\apache-2.0_or_bsd-new_2.yml", "YAML", 0, 0, 0, 2, 0, 0, 1, 3
"d:\IDEWORK\lvmen\src\licensedcode\data\rules\apache-2.0_or_bsd-new_3.yml", "YAML", 0, 0, 0, 2, 0, 0, 1, 3
"d:\IDEWORK\lvmen\src\licensedcode\data\rules\apache-2.0_or_bsd-new_4.yml", "YAML", 0, 0, 0, 2, 0, 0, 1, 3
"d:\IDEWORK\lvmen\src\licensedcode\data\rules\apache-2.0_or_bsd-new_5.yml", "YAML", 0, 0, 0, 3, 0, 0, 1, 4
"d:\IDEWORK\lvmen\src\licensedcode\data\rules\apache-2.0_or_bsd-new_6.yml", "YAML", 0, 0, 0, 3, 0, 0, 1, 4
"d:\IDEWORK\lvmen\src\licensedcode\data\rules\apache-2.0_or_bsd-new_7.yml", "YAML", 0, 0, 0, 3, 0, 0, 1, 4
"d:\IDEWORK\lvmen\src\licensedcode\data\rules\apache-2.0_or_bsd-new_8.yml", "YAML", 0, 0, 0, 6, 0, 0, 1, 7
"d:\IDEWORK\lvmen\src\licensedcode\data\rules\apache-2.0_or_bsd-new_9.yml", "YAML", 0, 0, 0, 5, 0, 0, 1, 6
"d:\IDEWORK\lvmen\src\licensedcode\data\rules\apache-2.0_or_bsd-new_or_cc-by-nc-sa-4.0_or_epl-1.0_1.yml", "YAML", 0, 0, 0, 7, 0, 0, 1, 8
"d:\IDEWORK\lvmen\src\licensedcode\data\rules\apache-2.0_or_epl-1.0_1.yml", "YAML", 0, 0, 0, 3, 0, 0, 1, 4
"d:\IDEWORK\lvmen\src\licensedcode\data\rules\apache-2.0_or_epl-2.0_1.yml", "YAML", 0, 0, 0, 6, 0, 0, 1, 7
"d:\IDEWORK\lvmen\src\licensedcode\data\rules\apache-2.0_or_epl-2.0_2.yml", "YAML", 0, 0, 0, 6, 0, 0, 1, 7
"d:\IDEWORK\lvmen\src\licensedcode\data\rules\apache-2.0_or_free-unknown_1.yml", "YAML", 0, 0, 0, 3, 0, 0, 1, 4
"d:\IDEWORK\lvmen\src\licensedcode\data\rules\apache-2.0_or_free-unknown_2.yml", "YAML", 0, 0, 0, 3, 0, 0, 1, 4
"d:\IDEWORK\lvmen\src\licensedcode\data\rules\apache-2.0_or_gpl-1.0-plus_1.yml", "YAML", 0, 0, 0, 3, 0, 0, 1, 4
"d:\IDEWORK\lvmen\src\licensedcode\data\rules\apache-2.0_or_gpl-1.0-plus_2.yml", "YAML", 0, 0, 0, 6, 0, 0, 1, 7
"d:\IDEWORK\lvmen\src\licensedcode\data\rules\apache-2.0_or_gpl-1.0-plus_3.yml", "YAML", 0, 0, 0, 6, 0, 0, 1, 7
"d:\IDEWORK\lvmen\src\licensedcode\data\rules\apache-2.0_or_gpl-1.0-plus_4.yml", "YAML", 0, 0, 0, 6, 0, 0, 1, 7
"d:\IDEWORK\lvmen\src\licensedcode\data\rules\apache-2.0_or_gpl-1.0-plus_5.yml", "YAML", 0, 0, 0, 6, 0, 0, 1, 7
"d:\IDEWORK\lvmen\src\licensedcode\data\rules\apache-2.0_or_gpl-2.0-plus_1.yml", "YAML", 0, 0, 0, 3, 0, 0, 1, 4
"d:\IDEWORK\lvmen\src\licensedcode\data\rules\apache-2.0_or_gpl-2.0-plus_10.yml", "YAML", 0, 0, 0, 6, 0, 0, 1, 7
"d:\IDEWORK\lvmen\src\licensedcode\data\rules\apache-2.0_or_gpl-2.0-plus_11.yml", "YAML", 0, 0, 0, 7, 0, 0, 1, 8
"d:\IDEWORK\lvmen\src\licensedcode\data\rules\apache-2.0_or_gpl-2.0-plus_12.yml", "YAML", 0, 0, 0, 7, 0, 0, 1, 8
"d:\IDEWORK\lvmen\src\licensedcode\data\rules\apache-2.0_or_gpl-2.0-plus_13.yml", "YAML", 0, 0, 0, 7, 0, 0, 1, 8
"d:\IDEWORK\lvmen\src\licensedcode\data\rules\apache-2.0_or_gpl-2.0-plus_2.yml", "YAML", 0, 0, 0, 3, 0, 0, 1, 4
"d:\IDEWORK\lvmen\src\licensedcode\data\rules\apache-2.0_or_gpl-2.0-plus_3.yml", "YAML", 0, 0, 0, 3, 0, 0, 1, 4
"d:\IDEWORK\lvmen\src\licensedcode\data\rules\apache-2.0_or_gpl-2.0-plus_4.yml", "YAML", 0, 0, 0, 7, 0, 0, 1, 8
"d:\IDEWORK\lvmen\src\licensedcode\data\rules\apache-2.0_or_gpl-2.0-plus_5.yml", "YAML", 0, 0, 0, 4, 0, 0, 1, 5
"d:\IDEWORK\lvmen\src\licensedcode\data\rules\apache-2.0_or_gpl-2.0-plus_6.yml", "YAML", 0, 0, 0, 5, 0, 0, 1, 6
"d:\IDEWORK\lvmen\src\licensedcode\data\rules\apache-2.0_or_gpl-2.0-plus_7.yml", "YAML", 0, 0, 0, 4, 0, 0, 1, 5
"d:\IDEWORK\lvmen\src\licensedcode\data\rules\apache-2.0_or_gpl-2.0-plus_8.yml", "YAML", 0, 0, 0, 4, 0, 0, 1, 5
"d:\IDEWORK\lvmen\src\licensedcode\data\rules\apache-2.0_or_gpl-2.0-plus_9.yml", "YAML", 0, 0, 0, 3, 0, 0, 1, 4
"d:\IDEWORK\lvmen\src\licensedcode\data\rules\apache-2.0_or_gpl-2.0-plus_with_classpath-exception-2.0_1.yml", "YAML", 0, 0, 0, 8, 0, 0, 1, 9
"d:\IDEWORK\lvmen\src\licensedcode\data\rules\apache-2.0_or_gpl-2.0-plus_with_classpath-exception-2.0_10.yml", "YAML", 0, 0, 0, 7, 0, 0, 1, 8
"d:\IDEWORK\lvmen\src\licensedcode\data\rules\apache-2.0_or_gpl-2.0-plus_with_classpath-exception-2.0_2.yml", "YAML", 0, 0, 0, 6, 0, 0, 1, 7
"d:\IDEWORK\lvmen\src\licensedcode\data\rules\apache-2.0_or_gpl-2.0-plus_with_classpath-exception-2.0_3.yml", "YAML", 0, 0, 0, 2, 0, 0, 1, 3
"d:\IDEWORK\lvmen\src\licensedcode\data\rules\apache-2.0_or_gpl-2.0-plus_with_classpath-exception-2.0_4.yml", "YAML", 0, 0, 0, 2, 0, 0, 1, 3
"d:\IDEWORK\lvmen\src\licensedcode\data\rules\apache-2.0_or_gpl-2.0-plus_with_classpath-exception-2.0_5.yml", "YAML", 0, 0, 0, 8, 0, 0, 1, 9
"d:\IDEWORK\lvmen\src\licensedcode\data\rules\apache-2.0_or_gpl-2.0-plus_with_classpath-exception-2.0_6.yml", "YAML", 0, 0, 0, 6, 0, 0, 1, 7
"d:\IDEWORK\lvmen\src\licensedcode\data\rules\apache-2.0_or_gpl-2.0-plus_with_classpath-exception-2.0_7.yml", "YAML", 0, 0, 0, 7, 0, 0, 1, 8
"d:\IDEWORK\lvmen\src\licensedcode\data\rules\apache-2.0_or_gpl-2.0-plus_with_classpath-exception-2.0_8.yml", "YAML", 0, 0, 0, 9, 0, 0, 1, 10
"d:\IDEWORK\lvmen\src\licensedcode\data\rules\apache-2.0_or_gpl-2.0-plus_with_classpath-exception-2.0_9.yml", "YAML", 0, 0, 0, 9, 0, 0, 1, 10
"d:\IDEWORK\lvmen\src\licensedcode\data\rules\apache-2.0_or_gpl-2.0.yml", "YAML", 0, 0, 0, 2, 0, 0, 1, 3
"d:\IDEWORK\lvmen\src\licensedcode\data\rules\apache-2.0_or_gpl-2.0_1.yml", "YAML", 0, 0, 0, 5, 0, 0, 1, 6
"d:\IDEWORK\lvmen\src\licensedcode\data\rules\apache-2.0_or_gpl-2.0_10.yml", "YAML", 0, 0, 0, 5, 0, 0, 1, 6
"d:\IDEWORK\lvmen\src\licensedcode\data\rules\apache-2.0_or_gpl-2.0_11.yml", "YAML", 0, 0, 0, 5, 0, 0, 1, 6
"d:\IDEWORK\lvmen\src\licensedcode\data\rules\apache-2.0_or_gpl-2.0_12.yml", "YAML", 0, 0, 0, 6, 0, 0, 1, 7
"d:\IDEWORK\lvmen\src\licensedcode\data\rules\apache-2.0_or_gpl-2.0_13.yml", "YAML", 0, 0, 0, 5, 0, 0, 1, 6
"d:\IDEWORK\lvmen\src\licensedcode\data\rules\apache-2.0_or_gpl-2.0_14.yml", "YAML", 0, 0, 0, 6, 0, 0, 1, 7
"d:\IDEWORK\lvmen\src\licensedcode\data\rules\apache-2.0_or_gpl-2.0_15.yml", "YAML", 0, 0, 0, 6, 0, 0, 1, 7
"d:\IDEWORK\lvmen\src\licensedcode\data\rules\apache-2.0_or_gpl-2.0_16.yml", "YAML", 0, 0, 0, 6, 0, 0, 1, 7
"d:\IDEWORK\lvmen\src\licensedcode\data\rules\apache-2.0_or_gpl-2.0_17.yml", "YAML", 0, 0, 0, 6, 0, 0, 1, 7
"d:\IDEWORK\lvmen\src\licensedcode\data\rules\apache-2.0_or_gpl-2.0_18.yml", "YAML", 0, 0, 0, 6, 0, 0, 1, 7
"d:\IDEWORK\lvmen\src\licensedcode\data\rules\apache-2.0_or_gpl-2.0_19.yml", "YAML", 0, 0, 0, 6, 0, 0, 1, 7
"d:\IDEWORK\lvmen\src\licensedcode\data\rules\apache-2.0_or_gpl-2.0_2.yml", "YAML", 0, 0, 0, 2, 0, 0, 1, 3
"d:\IDEWORK\lvmen\src\licensedcode\data\rules\apache-2.0_or_gpl-2.0_20.yml", "YAML", 0, 0, 0, 6, 0, 0, 1, 7
"d:\IDEWORK\lvmen\src\licensedcode\data\rules\apache-2.0_or_gpl-2.0_21.yml", "YAML", 0, 0, 0, 6, 0, 0, 1, 7
"d:\IDEWORK\lvmen\src\licensedcode\data\rules\apache-2.0_or_gpl-2.0_22.yml", "YAML", 0, 0, 0, 6, 0, 0, 1, 7
"d:\IDEWORK\lvmen\src\licensedcode\data\rules\apache-2.0_or_gpl-2.0_23.yml", "YAML", 0, 0, 0, 6, 0, 0, 1, 7
"d:\IDEWORK\lvmen\src\licensedcode\data\rules\apache-2.0_or_gpl-2.0_24.yml", "YAML", 0, 0, 0, 6, 0, 0, 1, 7
"d:\IDEWORK\lvmen\src\licensedcode\data\rules\apache-2.0_or_gpl-2.0_25.yml", "YAML", 0, 0, 0, 6, 0, 0, 1, 7
"d:\IDEWORK\lvmen\src\licensedcode\data\rules\apache-2.0_or_gpl-2.0_3.yml", "YAML", 0, 0, 0, 3, 0, 0, 1, 4
"d:\IDEWORK\lvmen\src\licensedcode\data\rules\apache-2.0_or_gpl-2.0_4.yml", "YAML", 0, 0, 0, 5, 0, 0, 1, 6
"d:\IDEWORK\lvmen\src\licensedcode\data\rules\apache-2.0_or_gpl-2.0_5.yml", "YAML", 0, 0, 0, 6, 0, 0, 1, 7
"d:\IDEWORK\lvmen\src\licensedcode\data\rules\apache-2.0_or_gpl-2.0_6.yml", "YAML", 0, 0, 0, 6, 0, 0, 1, 7
"d:\IDEWORK\lvmen\src\licensedcode\data\rules\apache-2.0_or_gpl-2.0_7.yml", "YAML", 0, 0, 0, 6, 0, 0, 1, 7
"d:\IDEWORK\lvmen\src\licensedcode\data\rules\apache-2.0_or_gpl-2.0_8.yml", "YAML", 0, 0, 0, 6, 0, 0, 1, 7
"d:\IDEWORK\lvmen\src\licensedcode\data\rules\apache-2.0_or_gpl-2.0_9.yml", "YAML", 0, 0, 0, 5, 0, 0, 1, 6
"d:\IDEWORK\lvmen\src\licensedcode\data\rules\apache-2.0_or_lgpl-3.0_1.yml", "YAML", 0, 0, 0, 6, 0, 0, 1, 7
"d:\IDEWORK\lvmen\src\licensedcode\data\rules\apache-2.0_or_lgpl-3.0_2.yml", "YAML", 0, 0, 0, 10, 0, 0, 1, 11
"d:\IDEWORK\lvmen\src\licensedcode\data\rules\apache-2.0_or_lgpl-3.0_3.yml", "YAML", 0, 0, 0, 6, 0, 0, 1, 7
"d:\IDEWORK\lvmen\src\licensedcode\data\rules\apache-2.0_or_lgpl-3.0_4.yml", "YAML", 0, 0, 0, 10, 0, 0, 1, 11
"d:\IDEWORK\lvmen\src\licensedcode\data\rules\apache-2.0_or_lgpl-3.0_5.yml", "YAML", 0, 0, 0, 10, 0, 0, 1, 11
"d:\IDEWORK\lvmen\src\licensedcode\data\rules\apache-2.0_or_lgpl-3.0_6.yml", "YAML", 0, 0, 0, 10, 0, 0, 1, 11
"d:\IDEWORK\lvmen\src\licensedcode\data\rules\apache-2.0_or_mit.yml", "YAML", 0, 0, 0, 3, 0, 0, 1, 4
"d:\IDEWORK\lvmen\src\licensedcode\data\rules\apache-2.0_or_mit2.yml", "YAML", 0, 0, 0, 5, 0, 0, 1, 6
"d:\IDEWORK\lvmen\src\licensedcode\data\rules\apache-2.0_or_mit3.yml", "YAML", 0, 0, 0, 2, 0, 0, 1, 3
"d:\IDEWORK\lvmen\src\licensedcode\data\rules\apache-2.0_or_mit4.yml", "YAML", 0, 0, 0, 3, 0, 0, 1, 4
"d:\IDEWORK\lvmen\src\licensedcode\data\rules\apache-2.0_or_mit5.yml", "YAML", 0, 0, 0, 3, 0, 0, 1, 4
"d:\IDEWORK\lvmen\src\licensedcode\data\rules\apache-2.0_or_mit7.yml", "YAML", 0, 0, 0, 5, 0, 0, 1, 6
"d:\IDEWORK\lvmen\src\licensedcode\data\rules\apache-2.0_or_mit8.yml", "YAML", 0, 0, 0, 3, 0, 0, 1, 4
"d:\IDEWORK\lvmen\src\licensedcode\data\rules\apache-2.0_or_mit9.yml", "YAML", 0, 0, 0, 3, 0, 0, 1, 4
"d:\IDEWORK\lvmen\src\licensedcode\data\rules\apache-2.0_or_mit_1.yml", "YAML", 0, 0, 0, 9, 0, 0, 1, 10
"d:\IDEWORK\lvmen\src\licensedcode\data\rules\apache-2.0_or_mit_10.yml", "YAML", 0, 0, 0, 3, 0, 0, 1, 4
"d:\IDEWORK\lvmen\src\licensedcode\data\rules\apache-2.0_or_mit_11.yml", "YAML", 0, 0, 0, 6, 0, 0, 1, 7
"d:\IDEWORK\lvmen\src\licensedcode\data\rules\apache-2.0_or_mit_12.yml", "YAML", 0, 0, 0, 10, 0, 0, 1, 11
"d:\IDEWORK\lvmen\src\licensedcode\data\rules\apache-2.0_or_mit_13.yml", "YAML", 0, 0, 0, 10, 0, 0, 1, 11
"d:\IDEWORK\lvmen\src\licensedcode\data\rules\apache-2.0_or_mit_14.yml", "YAML", 0, 0, 0, 11, 0, 0, 1, 12
"d:\IDEWORK\lvmen\src\licensedcode\data\rules\apache-2.0_or_mit_15.yml", "YAML", 0, 0, 0, 9, 0, 0, 1, 10
"d:\IDEWORK\lvmen\src\licensedcode\data\rules\apache-2.0_or_mit_16.yml", "YAML", 0, 0, 0, 9, 0, 0, 1, 10
"d:\IDEWORK\lvmen\src\licensedcode\data\rules\apache-2.0_or_mit_17.yml", "YAML", 0, 0, 0, 9, 0, 0, 1, 10
"d:\IDEWORK\lvmen\src\licensedcode\data\rules\apache-2.0_or_mit_18.yml", "YAML", 0, 0, 0, 7, 0, 0, 1, 8
"d:\IDEWORK\lvmen\src\licensedcode\data\rules\apache-2.0_or_mit_19.yml", "YAML", 0, 0, 0, 10, 0, 0, 1, 11
"d:\IDEWORK\lvmen\src\licensedcode\data\rules\apache-2.0_or_mit_2.yml", "YAML", 0, 0, 0, 8, 0, 0, 1, 9
"d:\IDEWORK\lvmen\src\licensedcode\data\rules\apache-2.0_or_mit_20.yml", "YAML", 0, 0, 0, 5, 0, 0, 1, 6
"d:\IDEWORK\lvmen\src\licensedcode\data\rules\apache-2.0_or_mit_21.yml", "YAML", 0, 0, 0, 8, 0, 0, 1, 9
"d:\IDEWORK\lvmen\src\licensedcode\data\rules\apache-2.0_or_mit_22.yml", "YAML", 0, 0, 0, 9, 0, 0, 1, 10
"d:\IDEWORK\lvmen\src\licensedcode\data\rules\apache-2.0_or_mit_23.yml", "YAML", 0, 0, 0, 11, 0, 0, 1, 12
"d:\IDEWORK\lvmen\src\licensedcode\data\rules\apache-2.0_or_mit_24.yml", "YAML", 0, 0, 0, 10, 0, 0, 1, 11
"d:\IDEWORK\lvmen\src\licensedcode\data\rules\apache-2.0_or_mit_25.yml", "YAML", 0, 0, 0, 6, 0, 0, 1, 7
"d:\IDEWORK\lvmen\src\licensedcode\data\rules\apache-2.0_or_mit_26.yml", "YAML", 0, 0, 0, 9, 0, 0, 1, 10
"d:\IDEWORK\lvmen\src\licensedcode\data\rules\apache-2.0_or_mit_27.yml", "YAML", 0, 0, 0, 9, 0, 0, 1, 10
"d:\IDEWORK\lvmen\src\licensedcode\data\rules\apache-2.0_or_mit_28.yml", "YAML", 0, 0, 0, 9, 0, 0, 1, 10
"d:\IDEWORK\lvmen\src\licensedcode\data\rules\apache-2.0_or_mit_29.yml", "YAML", 0, 0, 0, 6, 0, 0, 1, 7
"d:\IDEWORK\lvmen\src\licensedcode\data\rules\apache-2.0_or_mit_3.yml", "YAML", 0, 0, 0, 7, 0, 0, 1, 8
"d:\IDEWORK\lvmen\src\licensedcode\data\rules\apache-2.0_or_mit_30.yml", "YAML", 0, 0, 0, 9, 0, 0, 1, 10
"d:\IDEWORK\lvmen\src\licensedcode\data\rules\apache-2.0_or_mit_31.yml", "YAML", 0, 0, 0, 9, 0, 0, 1, 10
"d:\IDEWORK\lvmen\src\licensedcode\data\rules\apache-2.0_or_mit_32.yml", "YAML", 0, 0, 0, 9, 0, 0, 1, 10
"d:\IDEWORK\lvmen\src\licensedcode\data\rules\apache-2.0_or_mit_33.yml", "YAML", 0, 0, 0, 3, 0, 0, 1, 4
"d:\IDEWORK\lvmen\src\licensedcode\data\rules\apache-2.0_or_mit_34.yml", "YAML", 0, 0, 0, 5, 0, 0, 1, 6
"d:\IDEWORK\lvmen\src\licensedcode\data\rules\apache-2.0_or_mit_4.yml", "YAML", 0, 0, 0, 6, 0, 0, 1, 7
"d:\IDEWORK\lvmen\src\licensedcode\data\rules\apache-2.0_or_mit_5.yml", "YAML", 0, 0, 0, 6, 0, 0, 1, 7
"d:\IDEWORK\lvmen\src\licensedcode\data\rules\apache-2.0_or_mit_6.yml", "YAML", 0, 0, 0, 9, 0, 0, 1, 10
"d:\IDEWORK\lvmen\src\licensedcode\data\rules\apache-2.0_or_mit_7.yml", "YAML", 0, 0, 0, 9, 0, 0, 1, 10
"d:\IDEWORK\lvmen\src\licensedcode\data\rules\apache-2.0_or_mit_8.yml", "YAML", 0, 0, 0, 3, 0, 0, 1, 4
"d:\IDEWORK\lvmen\src\licensedcode\data\rules\apache-2.0_or_mit_9.yml", "YAML", 0, 0, 0, 3, 0, 0, 1, 4
"d:\IDEWORK\lvmen\src\licensedcode\data\rules\apache-2.0_or_mit_and_generic-cla_1.yml", "YAML", 0, 0, 0, 6, 0, 0, 1, 7
"d:\IDEWORK\lvmen\src\licensedcode\data\rules\apache-2.0_or_mpl-1.1_1.yml", "YAML", 0, 0, 0, 2, 0, 0, 1, 3
"d:\IDEWORK\lvmen\src\licensedcode\data\rules\apache-2.0_or_mpl-1.1_2.yml", "YAML", 0, 0, 0, 6, 0, 0, 1, 7
"d:\IDEWORK\lvmen\src\licensedcode\data\rules\apache-2.0_or_mpl-1.1_3.yml", "YAML", 0, 0, 0, 6, 0, 0, 1, 7
"d:\IDEWORK\lvmen\src\licensedcode\data\rules\apache-2.0_or_mpl-1.1_4.yml", "YAML", 0, 0, 0, 7, 0, 0, 1, 8
"d:\IDEWORK\lvmen\src\licensedcode\data\rules\apache-2.0_or_mpl-1.1_5.yml", "YAML", 0, 0, 0, 7, 0, 0, 1, 8
"d:\IDEWORK\lvmen\src\licensedcode\data\rules\apache-2.0_or_mpl-1.1_6.yml", "YAML", 0, 0, 0, 7, 0, 0, 1, 8
"d:\IDEWORK\lvmen\src\licensedcode\data\rules\apache-2.0_or_mpl-1.1_7.yml", "YAML", 0, 0, 0, 7, 0, 0, 1, 8
"d:\IDEWORK\lvmen\src\licensedcode\data\rules\apache-2.0_or_ms-pl_1.yml", "YAML", 0, 0, 0, 5, 0, 0, 1, 6
"d:\IDEWORK\lvmen\src\licensedcode\data\rules\apache-2.0_or_ms-pl_2.yml", "YAML", 0, 0, 0, 3, 0, 0, 1, 4
"d:\IDEWORK\lvmen\src\licensedcode\data\rules\apache-2.0_or_ms-pl_3.yml", "YAML", 0, 0, 0, 3, 0, 0, 1, 4
"d:\IDEWORK\lvmen\src\licensedcode\data\rules\apache-2.0_or_ms-pl_and_apache-2.0_and_ms-pl_nuget_url_1.yml", "YAML", 0, 0, 0, 5, 0, 0, 1, 6
"d:\IDEWORK\lvmen\src\licensedcode\data\rules\apache-2.0_or_other-permissive_1.yml", "YAML", 0, 0, 0, 3, 0, 0, 1, 4
"d:\IDEWORK\lvmen\src\licensedcode\data\rules\apache-2.0_or_other-permissive_2.yml", "YAML", 0, 0, 0, 3, 0, 0, 1, 4
"d:\IDEWORK\lvmen\src\licensedcode\data\rules\apache-2.0_or_other-permissive_or_tsl-2020_1.yml", "YAML", 0, 0, 0, 5, 0, 0, 1, 6
"d:\IDEWORK\lvmen\src\licensedcode\data\rules\apache-2.0_or_wtfpl-2.0_1.yml", "YAML", 0, 0, 0, 3, 0, 0, 1, 4
"d:\IDEWORK\lvmen\src\licensedcode\data\rules\apache-2.0_or_zeusbench_1.yml", "YAML", 0, 0, 0, 3, 0, 0, 1, 4
"d:\IDEWORK\lvmen\src\licensedcode\data\rules\apache-2.0_osgi.yml", "YAML", 0, 0, 0, 5, 0, 0, 1, 6
"d:\IDEWORK\lvmen\src\licensedcode\data\rules\apache-2.0_product_includes_1.yml", "YAML", 0, 0, 0, 5, 0, 0, 1, 6
"d:\IDEWORK\lvmen\src\licensedcode\data\rules\apache-2.0_product_includes_2.yml", "YAML", 0, 0, 0, 5, 0, 0, 1, 6
"d:\IDEWORK\lvmen\src\licensedcode\data\rules\apache-2.0_public.yml", "YAML", 0, 0, 0, 5, 0, 0, 1, 6
"d:\IDEWORK\lvmen\src\licensedcode\data\rules\apache-2.0_public2.yml", "YAML", 0, 0, 0, 3, 0, 0, 1, 4
"d:\IDEWORK\lvmen\src\licensedcode\data\rules\apache-2.0_public3.yml", "YAML", 0, 0, 0, 5, 0, 0, 1, 6
"d:\IDEWORK\lvmen\src\licensedcode\data\rules\apache-2.0_scancode.yml", "YAML", 0, 0, 0, 5, 0, 0, 1, 6
"d:\IDEWORK\lvmen\src\licensedcode\data\rules\apache-2.0_see_1.yml", "YAML", 0, 0, 0, 4, 0, 0, 1, 5
"d:\IDEWORK\lvmen\src\licensedcode\data\rules\apache-2.0_short_mention.yml", "YAML", 0, 0, 0, 5, 0, 0, 1, 6
"d:\IDEWORK\lvmen\src\licensedcode\data\rules\apache-2.0_url_1.yml", "YAML", 0, 0, 0, 5, 0, 0, 1, 6
"d:\IDEWORK\lvmen\src\licensedcode\data\rules\apache-2.0_url_10.yml", "YAML", 0, 0, 0, 5, 0, 0, 1, 6
"d:\IDEWORK\lvmen\src\licensedcode\data\rules\apache-2.0_url_11.yml", "YAML", 0, 0, 0, 5, 0, 0, 1, 6
"d:\IDEWORK\lvmen\src\licensedcode\data\rules\apache-2.0_url_12.yml", "YAML", 0, 0, 0, 5, 0, 0, 1, 6
"d:\IDEWORK\lvmen\src\licensedcode\data\rules\apache-2.0_url_13.yml", "YAML", 0, 0, 0, 5, 0, 0, 1, 6
"d:\IDEWORK\lvmen\src\licensedcode\data\rules\apache-2.0_url_14.yml", "YAML", 0, 0, 0, 5, 0, 0, 1, 6
"d:\IDEWORK\lvmen\src\licensedcode\data\rules\apache-2.0_url_15.yml", "YAML", 0, 0, 0, 5, 0, 0, 1, 6
"d:\IDEWORK\lvmen\src\licensedcode\data\rules\apache-2.0_url_2.yml", "YAML", 0, 0, 0, 5, 0, 0, 1, 6
"d:\IDEWORK\lvmen\src\licensedcode\data\rules\apache-2.0_url_3.yml", "YAML", 0, 0, 0, 5, 0, 0, 1, 6
"d:\IDEWORK\lvmen\src\licensedcode\data\rules\apache-2.0_url_4.yml", "YAML", 0, 0, 0, 5, 0, 0, 1, 6
"d:\IDEWORK\lvmen\src\licensedcode\data\rules\apache-2.0_url_5.yml", "YAML", 0, 0, 0, 5, 0, 0, 1, 6
"d:\IDEWORK\lvmen\src\licensedcode\data\rules\apache-2.0_url_6.yml", "YAML", 0, 0, 0, 5, 0, 0, 1, 6
"d:\IDEWORK\lvmen\src\licensedcode\data\rules\apache-2.0_url_7.yml", "YAML", 0, 0, 0, 5, 0, 0, 1, 6
"d:\IDEWORK\lvmen\src\licensedcode\data\rules\apache-2.0_url_8.yml", "YAML", 0, 0, 0, 5, 0, 0, 1, 6
"d:\IDEWORK\lvmen\src\licensedcode\data\rules\apache-2.0_url_9.yml", "YAML", 0, 0, 0, 5, 0, 0, 1, 6
"d:\IDEWORK\lvmen\src\licensedcode\data\rules\apache-2.0_url_badge.yml", "YAML", 0, 0, 0, 5, 0, 0, 1, 6
"d:\IDEWORK\lvmen\src\licensedcode\data\rules\apache-2.0_url_glc_142.yml", "YAML", 0, 0, 0, 5, 0, 0, 1, 6
"d:\IDEWORK\lvmen\src\licensedcode\data\rules\apache-2.0_url_glc_143.yml", "YAML", 0, 0, 0, 5, 0, 0, 1, 6
"d:\IDEWORK\lvmen\src\licensedcode\data\rules\apache-2.0_with_apple-runtime-library-exception_1.yml", "YAML", 0, 0, 0, 4, 0, 0, 1, 5
"d:\IDEWORK\lvmen\src\licensedcode\data\rules\apache-2.0_with_apple-runtime-library-exception_2.yml", "YAML", 0, 0, 0, 4, 0, 0, 1, 5
"d:\IDEWORK\lvmen\src\licensedcode\data\rules\apache-2.0_with_commons-clause_1.yml", "YAML", 0, 0, 0, 5, 0, 0, 1, 6
"d:\IDEWORK\lvmen\src\licensedcode\data\rules\apache-2.0_with_commons-clause_10.yml", "YAML", 0, 0, 0, 3, 0, 0, 1, 4
"d:\IDEWORK\lvmen\src\licensedcode\data\rules\apache-2.0_with_commons-clause_11.yml", "YAML", 0, 0, 0, 3, 0, 0, 1, 4
"d:\IDEWORK\lvmen\src\licensedcode\data\rules\apache-2.0_with_commons-clause_12.yml", "YAML", 0, 0, 0, 3, 0, 0, 1, 4
"d:\IDEWORK\lvmen\src\licensedcode\data\rules\apache-2.0_with_commons-clause_13.yml", "YAML", 0, 0, 0, 3, 0, 0, 1, 4
"d:\IDEWORK\lvmen\src\licensedcode\data\rules\apache-2.0_with_commons-clause_14.yml", "YAML", 0, 0, 0, 5, 0, 0, 1, 6
"d:\IDEWORK\lvmen\src\licensedcode\data\rules\apache-2.0_with_commons-clause_15.yml", "YAML", 0, 0, 0, 5, 0, 0, 1, 6
"d:\IDEWORK\lvmen\src\licensedcode\data\rules\apache-2.0_with_commons-clause_16.yml", "YAML", 0, 0, 0, 5, 0, 0, 1, 6
"d:\IDEWORK\lvmen\src\licensedcode\data\rules\apache-2.0_with_commons-clause_17.yml", "YAML", 0, 0, 0, 5, 0, 0, 1, 6
"d:\IDEWORK\lvmen\src\licensedcode\data\rules\apache-2.0_with_commons-clause_18.yml", "YAML", 0, 0, 0, 5, 0, 0, 1, 6
"d:\IDEWORK\lvmen\src\licensedcode\data\rules\apache-2.0_with_commons-clause_19.yml", "YAML", 0, 0, 0, 5, 0, 0, 1, 6
"d:\IDEWORK\lvmen\src\licensedcode\data\rules\apache-2.0_with_commons-clause_2.yml", "YAML", 0, 0, 0, 3, 0, 0, 1, 4
"d:\IDEWORK\lvmen\src\licensedcode\data\rules\apache-2.0_with_commons-clause_20.yml", "YAML", 0, 0, 0, 5, 0, 0, 1, 6
"d:\IDEWORK\lvmen\src\licensedcode\data\rules\apache-2.0_with_commons-clause_21.yml", "YAML", 0, 0, 0, 5, 0, 0, 1, 6
"d:\IDEWORK\lvmen\src\licensedcode\data\rules\apache-2.0_with_commons-clause_22.yml", "YAML", 0, 0, 0, 5, 0, 0, 1, 6
"d:\IDEWORK\lvmen\src\licensedcode\data\rules\apache-2.0_with_commons-clause_23.yml", "YAML", 0, 0, 0, 5, 0, 0, 1, 6
"d:\IDEWORK\lvmen\src\licensedcode\data\rules\apache-2.0_with_commons-clause_24.yml", "YAML", 0, 0, 0, 5, 0, 0, 1, 6
"d:\IDEWORK\lvmen\src\licensedcode\data\rules\apache-2.0_with_commons-clause_3.yml", "YAML", 0, 0, 0, 3, 0, 0, 1, 4
"d:\IDEWORK\lvmen\src\licensedcode\data\rules\apache-2.0_with_commons-clause_4.yml", "YAML", 0, 0, 0, 3, 0, 0, 1, 4
"d:\IDEWORK\lvmen\src\licensedcode\data\rules\apache-2.0_with_commons-clause_5.yml", "YAML", 0, 0, 0, 3, 0, 0, 1, 4
"d:\IDEWORK\lvmen\src\licensedcode\data\rules\apache-2.0_with_commons-clause_6.yml", "YAML", 0, 0, 0, 5, 0, 0, 1, 6
"d:\IDEWORK\lvmen\src\licensedcode\data\rules\apache-2.0_with_commons-clause_7.yml", "YAML", 0, 0, 0, 5, 0, 0, 1, 6
"d:\IDEWORK\lvmen\src\licensedcode\data\rules\apache-2.0_with_commons-clause_8.yml", "YAML", 0, 0, 0, 3, 0, 0, 1, 4
"d:\IDEWORK\lvmen\src\licensedcode\data\rules\apache-2.0_with_commons-clause_9.yml", "YAML", 0, 0, 0, 3, 0, 0, 1, 4
"d:\IDEWORK\lvmen\src\licensedcode\data\rules\apache-2.0_with_generic-exception_1.yml", "YAML", 0, 0, 0, 4, 0, 0, 1, 5
"d:\IDEWORK\lvmen\src\licensedcode\data\rules\apache-2.0_with_generic-exception_2.yml", "YAML", 0, 0, 0, 3, 0, 0, 1, 4
"d:\IDEWORK\lvmen\src\licensedcode\data\rules\apache-2.0_with_generic-exception_3.yml", "YAML", 0, 0, 0, 4, 0, 0, 1, 5
"d:\IDEWORK\lvmen\src\licensedcode\data\rules\apache-2.0_with_generic-exception_4.yml", "YAML", 0, 0, 0, 6, 0, 0, 1, 7
"d:\IDEWORK\lvmen\src\licensedcode\data\rules\apache-2.0_with_generic-exception_5.yml", "YAML", 0, 0, 0, 2, 0, 0, 1, 3
"d:\IDEWORK\lvmen\src\licensedcode\data\rules\apache-2.0_with_generic-exception_6.yml", "YAML", 0, 0, 0, 5, 0, 0, 1, 6
"d:\IDEWORK\lvmen\src\licensedcode\data\rules\apache-2.0_with_generic-exception_7.yml", "YAML", 0, 0, 0, 5, 0, 0, 1, 6
"d:\IDEWORK\lvmen\src\licensedcode\data\rules\apache-2.0_with_generic-exception_8.yml", "YAML", 0, 0, 0, 5, 0, 0, 1, 6
"d:\IDEWORK\lvmen\src\licensedcode\data\rules\apache-2.0_with_generic-exception_9.yml", "YAML", 0, 0, 0, 2, 0, 0, 1, 3
"d:\IDEWORK\lvmen\src\licensedcode\data\rules\apache-2.0_with_llvm-exception_1.yml", "YAML", 0, 0, 0, 3, 0, 0, 1, 4
"d:\IDEWORK\lvmen\src\licensedcode\data\rules\apache-2.0_with_llvm-exception_2.yml", "YAML", 0, 0, 0, 3, 0, 0, 1, 4
"d:\IDEWORK\lvmen\src\licensedcode\data\rules\apache-2.0_with_llvm-exception_3.yml", "YAML", 0, 0, 0, 3, 0, 0, 1, 4
"d:\IDEWORK\lvmen\src\licensedcode\data\rules\apache-2.0_with_llvm-exception_4.yml", "YAML", 0, 0, 0, 5, 0, 0, 1, 6
"d:\IDEWORK\lvmen\src\licensedcode\data\rules\apache-2.0_with_llvm-exception_5.yml", "YAML", 0, 0, 0, 3, 0, 0, 1, 4
"d:\IDEWORK\lvmen\src\licensedcode\data\rules\apache-2.0_with_llvm-exception_6.yml", "YAML", 0, 0, 0, 3, 0, 0, 1, 4
"d:\IDEWORK\lvmen\src\licensedcode\data\rules\apache-2.0_with_llvm-exception_7.yml", "YAML", 0, 0, 0, 3, 0, 0, 1, 4
"d:\IDEWORK\lvmen\src\licensedcode\data\rules\apache-2.0_with_notice.yml", "YAML", 0, 0, 0, 6, 0, 0, 1, 7
"d:\IDEWORK\lvmen\src\licensedcode\data\rules\apache-exception-llvm.yml", "YAML", 0, 0, 0, 2, 0, 0, 1, 3
"d:\IDEWORK\lvmen\src\licensedcode\data\rules\apache_no-version_1.yml", "YAML", 0, 0, 0, 9, 0, 0, 1, 10
"d:\IDEWORK\lvmen\src\licensedcode\data\rules\apache_no-version_10.yml", "YAML", 0, 0, 0, 9, 0, 0, 1, 10
"d:\IDEWORK\lvmen\src\licensedcode\data\rules\apache_no-version_11.yml", "YAML", 0, 0, 0, 8, 0, 0, 2, 10
"d:\IDEWORK\lvmen\src\licensedcode\data\rules\apache_no-version_12.yml", "YAML", 0, 0, 0, 8, 0, 0, 2, 10
"d:\IDEWORK\lvmen\src\licensedcode\data\rules\apache_no-version_13.yml", "YAML", 0, 0, 0, 8, 0, 0, 2, 10
"d:\IDEWORK\lvmen\src\licensedcode\data\rules\apache_no-version_14.yml", "YAML", 0, 0, 0, 5, 0, 0, 2, 7
"d:\IDEWORK\lvmen\src\licensedcode\data\rules\apache_no-version_15.yml", "YAML", 0, 0, 0, 5, 0, 0, 2, 7
"d:\IDEWORK\lvmen\src\licensedcode\data\rules\apache_no-version_16.yml", "YAML", 0, 0, 0, 8, 0, 0, 2, 10
"d:\IDEWORK\lvmen\src\licensedcode\data\rules\apache_no-version_17.yml", "YAML", 0, 0, 0, 8, 0, 0, 2, 10
"d:\IDEWORK\lvmen\src\licensedcode\data\rules\apache_no-version_18.yml", "YAML", 0, 0, 0, 8, 0, 0, 2, 10
"d:\IDEWORK\lvmen\src\licensedcode\data\rules\apache_no-version_19.yml", "YAML", 0, 0, 0, 7, 0, 0, 2, 9
"d:\IDEWORK\lvmen\src\licensedcode\data\rules\apache_no-version_2.yml", "YAML", 0, 0, 0, 9, 0, 0, 1, 10
"d:\IDEWORK\lvmen\src\licensedcode\data\rules\apache_no-version_20.yml", "YAML", 0, 0, 0, 6, 0, 0, 1, 7
"d:\IDEWORK\lvmen\src\licensedcode\data\rules\apache_no-version_3.yml", "YAML", 0, 0, 0, 8, 0, 0, 2, 10
"d:\IDEWORK\lvmen\src\licensedcode\data\rules\apache_no-version_4.yml", "YAML", 0, 0, 0, 7, 0, 0, 1, 8
"d:\IDEWORK\lvmen\src\licensedcode\data\rules\apache_no-version_5.yml", "YAML", 0, 0, 0, 7, 0, 0, 1, 8
"d:\IDEWORK\lvmen\src\licensedcode\data\rules\apache_no-version_6.yml", "YAML", 0, 0, 0, 8, 0, 0, 2, 10
"d:\IDEWORK\lvmen\src\licensedcode\data\rules\apache_no-version_7.yml", "YAML", 0, 0, 0, 9, 0, 0, 1, 10
"d:\IDEWORK\lvmen\src\licensedcode\data\rules\apache_no-version_8.yml", "YAML", 0, 0, 0, 9, 0, 0, 1, 10
"d:\IDEWORK\lvmen\src\licensedcode\data\rules\apache_no-version_9.yml", "YAML", 0, 0, 0, 9, 0, 0, 1, 10
"d:\IDEWORK\lvmen\src\licensedcode\data\rules\apache_no-version_and_ijg_and_proprietary.yml", "YAML", 0, 0, 0, 16, 0, 0, 2, 18
"d:\IDEWORK\lvmen\src\licensedcode\data\rules\apafml_url_1.yml", "YAML", 0, 0, 0, 5, 0, 0, 1, 6
"d:\IDEWORK\lvmen\src\licensedcode\data\rules\apafml_url_2.yml", "YAML", 0, 0, 0, 5, 0, 0, 1, 6
"d:\IDEWORK\lvmen\src\licensedcode\data\rules\apple-attribution-1997_1.yml", "YAML", 0, 0, 0, 2, 0, 0, 1, 3
"d:\IDEWORK\lvmen\src\licensedcode\data\rules\apple-attribution.yml", "YAML", 0, 0, 0, 6, 0, 0, 1, 7
"d:\IDEWORK\lvmen\src\licensedcode\data\rules\apple-runtime-library-exception_url_1.yml", "YAML", 0, 0, 0, 5, 0, 0, 1, 6
"d:\IDEWORK\lvmen\src\licensedcode\data\rules\apple-runtime-library-exception_url_2.yml", "YAML", 0, 0, 0, 5, 0, 0, 1, 6
"d:\IDEWORK\lvmen\src\licensedcode\data\rules\apsl-1.0.yml", "YAML", 0, 0, 0, 5, 0, 0, 1, 6
"d:\IDEWORK\lvmen\src\licensedcode\data\rules\apsl-1.0_1.yml", "YAML", 0, 0, 0, 5, 0, 0, 1, 6
"d:\IDEWORK\lvmen\src\licensedcode\data\rules\apsl-1.0_2.yml", "YAML", 0, 0, 0, 5, 0, 0, 1, 6
"d:\IDEWORK\lvmen\src\licensedcode\data\rules\apsl-1.0_3.yml", "YAML", 0, 0, 0, 3, 0, 0, 1, 4
"d:\IDEWORK\lvmen\src\licensedcode\data\rules\apsl-1.0_url_1.yml", "YAML", 0, 0, 0, 5, 0, 0, 1, 6
"d:\IDEWORK\lvmen\src\licensedcode\data\rules\apsl-1.0_url_2.yml", "YAML", 0, 0, 0, 5, 0, 0, 1, 6
"d:\IDEWORK\lvmen\src\licensedcode\data\rules\apsl-1.1.yml", "YAML", 0, 0, 0, 5, 0, 0, 1, 6
"d:\IDEWORK\lvmen\src\licensedcode\data\rules\apsl-1.1_2.yml", "YAML", 0, 0, 0, 4, 0, 0, 1, 5
"d:\IDEWORK\lvmen\src\licensedcode\data\rules\apsl-1.1_3.yml", "YAML", 0, 0, 0, 4, 0, 0, 1, 5
"d:\IDEWORK\lvmen\src\licensedcode\data\rules\apsl-1.1_4.yml", "YAML", 0, 0, 0, 5, 0, 0, 1, 6
"d:\IDEWORK\lvmen\src\licensedcode\data\rules\apsl-1.1_5.yml", "YAML", 0, 0, 0, 3, 0, 0, 1, 4
"d:\IDEWORK\lvmen\src\licensedcode\data\rules\apsl-1.1_6.yml", "YAML", 0, 0, 0, 5, 0, 0, 1, 6
"d:\IDEWORK\lvmen\src\licensedcode\data\rules\apsl-1.1_7.yml", "YAML", 0, 0, 0, 3, 0, 0, 1, 4
"d:\IDEWORK\lvmen\src\licensedcode\data\rules\apsl-1.1_url_1.yml", "YAML", 0, 0, 0, 5, 0, 0, 1, 6
"d:\IDEWORK\lvmen\src\licensedcode\data\rules\apsl-1.1_url_2.yml", "YAML", 0, 0, 0, 5, 0, 0, 1, 6
"d:\IDEWORK\lvmen\src\licensedcode\data\rules\apsl-1.2.yml", "YAML", 0, 0, 0, 5, 0, 0, 1, 6
"d:\IDEWORK\lvmen\src\licensedcode\data\rules\apsl-1.2_1.yml", "YAML", 0, 0, 0, 4, 0, 0, 1, 5
"d:\IDEWORK\lvmen\src\licensedcode\data\rules\apsl-1.2_10.yml", "YAML", 0, 0, 0, 5, 0, 0, 1, 6
"d:\IDEWORK\lvmen\src\licensedcode\data\rules\apsl-1.2_2.yml", "YAML", 0, 0, 0, 5, 0, 0, 1, 6
"d:\IDEWORK\lvmen\src\licensedcode\data\rules\apsl-1.2_3.yml", "YAML", 0, 0, 0, 3, 0, 0, 1, 4
"d:\IDEWORK\lvmen\src\licensedcode\data\rules\apsl-1.2_4.yml", "YAML", 0, 0, 0, 5, 0, 0, 1, 6
"d:\IDEWORK\lvmen\src\licensedcode\data\rules\apsl-1.2_5.yml", "YAML", 0, 0, 0, 3, 0, 0, 1, 4
"d:\IDEWORK\lvmen\src\licensedcode\data\rules\apsl-1.2_6.yml", "YAML", 0, 0, 0, 3, 0, 0, 1, 4
"d:\IDEWORK\lvmen\src\licensedcode\data\rules\apsl-1.2_7.yml", "YAML", 0, 0, 0, 5, 0, 0, 1, 6
"d:\IDEWORK\lvmen\src\licensedcode\data\rules\apsl-1.2_8.yml", "YAML", 0, 0, 0, 5, 0, 0, 1, 6
"d:\IDEWORK\lvmen\src\licensedcode\data\rules\apsl-1.2_9.yml", "YAML", 0, 0, 0, 3, 0, 0, 1, 4
"d:\IDEWORK\lvmen\src\licensedcode\data\rules\apsl-1.2_url_1.yml", "YAML", 0, 0, 0, 5, 0, 0, 1, 6
"d:\IDEWORK\lvmen\src\licensedcode\data\rules\apsl-1.2_url_2.yml", "YAML", 0, 0, 0, 5, 0, 0, 1, 6
"d:\IDEWORK\lvmen\src\licensedcode\data\rules\apsl-2.0.SPDX.yml", "YAML", 0, 0, 0, 11, 0, 0, 1, 12
"d:\IDEWORK\lvmen\src\licensedcode\data\rules\apsl-2.0.yml", "YAML", 0, 0, 0, 5, 0, 0, 1, 6
"d:\IDEWORK\lvmen\src\licensedcode\data\rules\apsl-2.0_1.yml", "YAML", 0, 0, 0, 3, 0, 0, 1, 4
"d:\IDEWORK\lvmen\src\licensedcode\data\rules\apsl-2.0_10.yml", "YAML", 0, 0, 0, 5, 0, 0, 1, 6
"d:\IDEWORK\lvmen\src\licensedcode\data\rules\apsl-2.0_11.yml", "YAML", 0, 0, 0, 5, 0, 0, 1, 6
"d:\IDEWORK\lvmen\src\licensedcode\data\rules\apsl-2.0_12.yml", "YAML", 0, 0, 0, 5, 0, 0, 1, 6
"d:\IDEWORK\lvmen\src\licensedcode\data\rules\apsl-2.0_13.yml", "YAML", 0, 0, 0, 5, 0, 0, 1, 6
"d:\IDEWORK\lvmen\src\licensedcode\data\rules\apsl-2.0_14.yml", "YAML", 0, 0, 0, 7, 0, 0, 1, 8
"d:\IDEWORK\lvmen\src\licensedcode\data\rules\apsl-2.0_15.yml", "YAML", 0, 0, 0, 5, 0, 0, 1, 6
"d:\IDEWORK\lvmen\src\licensedcode\data\rules\apsl-2.0_2.yml", "YAML", 0, 0, 0, 5, 0, 0, 1, 6
"d:\IDEWORK\lvmen\src\licensedcode\data\rules\apsl-2.0_3.yml", "YAML", 0, 0, 0, 4, 0, 0, 1, 5
"d:\IDEWORK\lvmen\src\licensedcode\data\rules\apsl-2.0_4.yml", "YAML", 0, 0, 0, 5, 0, 0, 1, 6
"d:\IDEWORK\lvmen\src\licensedcode\data\rules\apsl-2.0_5.yml", "YAML", 0, 0, 0, 4, 0, 0, 1, 5
"d:\IDEWORK\lvmen\src\licensedcode\data\rules\apsl-2.0_6.yml", "YAML", 0, 0, 0, 4, 0, 0, 1, 5
"d:\IDEWORK\lvmen\src\licensedcode\data\rules\apsl-2.0_7.yml", "YAML", 0, 0, 0, 5, 0, 0, 1, 6
"d:\IDEWORK\lvmen\src\licensedcode\data\rules\apsl-2.0_8.yml", "YAML", 0, 0, 0, 4, 0, 0, 1, 5
"d:\IDEWORK\lvmen\src\licensedcode\data\rules\apsl-2.0_9.yml", "YAML", 0, 0, 0, 5, 0, 0, 1, 6
"d:\IDEWORK\lvmen\src\licensedcode\data\rules\apsl-2.0_url_1.yml", "YAML", 0, 0, 0, 5, 0, 0, 1, 6
"d:\IDEWORK\lvmen\src\licensedcode\data\rules\apsl-2.0_url_2.yml", "YAML", 0, 0, 0, 5, 0, 0, 1, 6
"d:\IDEWORK\lvmen\src\licensedcode\data\rules\aptana-1.0.yml", "YAML", 0, 0, 0, 5, 0, 0, 1, 6
"d:\IDEWORK\lvmen\src\licensedcode\data\rules\aptana-1.0_1.yml", "YAML", 0, 0, 0, 4, 0, 0, 1, 5
"d:\IDEWORK\lvmen\src\licensedcode\data\rules\arm-llvm-sga_1.yml", "YAML", 0, 0, 0, 5, 0, 0, 1, 6
"d:\IDEWORK\lvmen\src\licensedcode\data\rules\arphic-public.yml", "YAML", 0, 0, 0, 5, 0, 0, 1, 6
"d:\IDEWORK\lvmen\src\licensedcode\data\rules\artistic-1.0-cl8_1.yml", "YAML", 0, 0, 0, 4, 0, 0, 1, 5
"d:\IDEWORK\lvmen\src\licensedcode\data\rules\artistic-1.0-cl8_url_1.yml", "YAML", 0, 0, 0, 5, 0, 0, 1, 6
"d:\IDEWORK\lvmen\src\licensedcode\data\rules\artistic-1.0-cl8_url_2.yml", "YAML", 0, 0, 0, 5, 0, 0, 1, 6
"d:\IDEWORK\lvmen\src\licensedcode\data\rules\artistic-1.0.SPDX.yml", "YAML", 0, 0, 0, 6, 0, 0, 1, 7
"d:\IDEWORK\lvmen\src\licensedcode\data\rules\artistic-1.0.yml", "YAML", 0, 0, 0, 5, 0, 0, 1, 6
"d:\IDEWORK\lvmen\src\licensedcode\data\rules\artistic-1.0_1.yml", "YAML", 0, 0, 0, 3, 0, 0, 1, 4
"d:\IDEWORK\lvmen\src\licensedcode\data\rules\artistic-1.0_10.yml", "YAML", 0, 0, 0, 4, 0, 0, 1, 5
"d:\IDEWORK\lvmen\src\licensedcode\data\rules\artistic-1.0_11.yml", "YAML", 0, 0, 0, 3, 0, 0, 1, 4
"d:\IDEWORK\lvmen\src\licensedcode\data\rules\artistic-1.0_12.yml", "YAML", 0, 0, 0, 5, 0, 0, 1, 6
"d:\IDEWORK\lvmen\src\licensedcode\data\rules\artistic-1.0_13.yml", "YAML", 0, 0, 0, 3, 0, 0, 1, 4
"d:\IDEWORK\lvmen\src\licensedcode\data\rules\artistic-1.0_14.yml", "YAML", 0, 0, 0, 4, 0, 0, 1, 5
"d:\IDEWORK\lvmen\src\licensedcode\data\rules\artistic-1.0_15.yml", "YAML", 0, 0, 0, 3, 0, 0, 1, 4
"d:\IDEWORK\lvmen\src\licensedcode\data\rules\artistic-1.0_16.yml", "YAML", 0, 0, 0, 3, 0, 0, 1, 4
"d:\IDEWORK\lvmen\src\licensedcode\data\rules\artistic-1.0_2.yml", "YAML", 0, 0, 0, 3, 0, 0, 1, 4
"d:\IDEWORK\lvmen\src\licensedcode\data\rules\artistic-1.0_3.yml", "YAML", 0, 0, 0, 5, 0, 0, 1, 6
"d:\IDEWORK\lvmen\src\licensedcode\data\rules\artistic-1.0_4.yml", "YAML", 0, 0, 0, 5, 0, 0, 1, 6
"d:\IDEWORK\lvmen\src\licensedcode\data\rules\artistic-1.0_5.yml", "YAML", 0, 0, 0, 5, 0, 0, 1, 6
"d:\IDEWORK\lvmen\src\licensedcode\data\rules\artistic-1.0_6.yml", "YAML", 0, 0, 0, 4, 0, 0, 1, 5
"d:\IDEWORK\lvmen\src\licensedcode\data\rules\artistic-1.0_7.yml", "YAML", 0, 0, 0, 3, 0, 0, 1, 4
"d:\IDEWORK\lvmen\src\licensedcode\data\rules\artistic-1.0_8.yml", "YAML", 0, 0, 0, 3, 0, 0, 1, 4
"d:\IDEWORK\lvmen\src\licensedcode\data\rules\artistic-1.0_9.yml", "YAML", 0, 0, 0, 3, 0, 0, 1, 4
"d:\IDEWORK\lvmen\src\licensedcode\data\rules\artistic-1.0_mahon.yml", "YAML", 0, 0, 0, 8, 0, 0, 1, 9
"d:\IDEWORK\lvmen\src\licensedcode\data\rules\artistic-1.0_or_gpl-1.0-plus_1.yml", "YAML", 0, 0, 0, 6, 0, 0, 1, 7
"d:\IDEWORK\lvmen\src\licensedcode\data\rules\artistic-1.0_or_gpl-1.0-plus_2.yml", "YAML", 0, 0, 0, 4, 0, 0, 1, 5
"d:\IDEWORK\lvmen\src\licensedcode\data\rules\artistic-1.0_or_gpl-1.0-plus_3.yml", "YAML", 0, 0, 0, 5, 0, 0, 1, 6
"d:\IDEWORK\lvmen\src\licensedcode\data\rules\artistic-1.0_or_gpl-1.0-plus_and_artistic-1.0_or_gpl-1.0-plus_or_lgpl-2.0-plus_1.yml", "YAML", 0, 0, 0, 5, 0, 0, 1, 6
"d:\IDEWORK\lvmen\src\licensedcode\data\rules\artistic-1.0_or_gpl-1.0-plus_and_artistic-1.0_or_gpl-1.0-plus_or_lgpl-2.0-plus_2.yml", "YAML", 0, 0, 0, 5, 0, 0, 1, 6
"d:\IDEWORK\lvmen\src\licensedcode\data\rules\artistic-1.0_url_1.yml", "YAML", 0, 0, 0, 5, 0, 0, 1, 6
"d:\IDEWORK\lvmen\src\licensedcode\data\rules\artistic-1.0_url_2.yml", "YAML", 0, 0, 0, 5, 0, 0, 1, 6
"d:\IDEWORK\lvmen\src\licensedcode\data\rules\artistic-1.0_url_glc_66.yml", "YAML", 0, 0, 0, 5, 0, 0, 1, 6
"d:\IDEWORK\lvmen\src\licensedcode\data\rules\artistic-1.0_url_glc_67.yml", "YAML", 0, 0, 0, 5, 0, 0, 1, 6
"d:\IDEWORK\lvmen\src\licensedcode\data\rules\artistic-2.0.yml", "YAML", 0, 0, 0, 5, 0, 0, 1, 6
"d:\IDEWORK\lvmen\src\licensedcode\data\rules\artistic-2.0_1.yml", "YAML", 0, 0, 0, 5, 0, 0, 1, 6
"d:\IDEWORK\lvmen\src\licensedcode\data\rules\artistic-2.0_10.yml", "YAML", 0, 0, 0, 2, 0, 0, 1, 3
"d:\IDEWORK\lvmen\src\licensedcode\data\rules\artistic-2.0_11.yml", "YAML", 0, 0, 0, 5, 0, 0, 1, 6
"d:\IDEWORK\lvmen\src\licensedcode\data\rules\artistic-2.0_12.yml", "YAML", 0, 0, 0, 4, 0, 0, 1, 5
"d:\IDEWORK\lvmen\src\licensedcode\data\rules\artistic-2.0_13.yml", "YAML", 0, 0, 0, 2, 0, 0, 1, 3
"d:\IDEWORK\lvmen\src\licensedcode\data\rules\artistic-2.0_14.yml", "YAML", 0, 0, 0, 3, 0, 0, 1, 4
"d:\IDEWORK\lvmen\src\licensedcode\data\rules\artistic-2.0_15.yml", "YAML", 0, 0, 0, 3, 0, 0, 1, 4
"d:\IDEWORK\lvmen\src\licensedcode\data\rules\artistic-2.0_16.yml", "YAML", 0, 0, 0, 8, 0, 0, 1, 9
"d:\IDEWORK\lvmen\src\licensedcode\data\rules\artistic-2.0_17.yml", "YAML", 0, 0, 0, 5, 0, 0, 1, 6
"d:\IDEWORK\lvmen\src\licensedcode\data\rules\artistic-2.0_18.yml", "YAML", 0, 0, 0, 3, 0, 0, 1, 4
"d:\IDEWORK\lvmen\src\licensedcode\data\rules\artistic-2.0_19.yml", "YAML", 0, 0, 0, 3, 0, 0, 1, 4
"d:\IDEWORK\lvmen\src\licensedcode\data\rules\artistic-2.0_2.yml", "YAML", 0, 0, 0, 5, 0, 0, 1, 6
"d:\IDEWORK\lvmen\src\licensedcode\data\rules\artistic-2.0_20.yml", "YAML", 0, 0, 0, 5, 0, 0, 1, 6
"d:\IDEWORK\lvmen\src\licensedcode\data\rules\artistic-2.0_21.yml", "YAML", 0, 0, 0, 5, 0, 0, 1, 6
"d:\IDEWORK\lvmen\src\licensedcode\data\rules\artistic-2.0_22.yml", "YAML", 0, 0, 0, 5, 0, 0, 1, 6
"d:\IDEWORK\lvmen\src\licensedcode\data\rules\artistic-2.0_23.yml", "YAML", 0, 0, 0, 5, 0, 0, 1, 6
"d:\IDEWORK\lvmen\src\licensedcode\data\rules\artistic-2.0_24.yml", "YAML", 0, 0, 0, 3, 0, 0, 1, 4
"d:\IDEWORK\lvmen\src\licensedcode\data\rules\artistic-2.0_25.yml", "YAML", 0, 0, 0, 3, 0, 0, 1, 4
"d:\IDEWORK\lvmen\src\licensedcode\data\rules\artistic-2.0_26.yml", "YAML", 0, 0, 0, 5, 0, 0, 1, 6
"d:\IDEWORK\lvmen\src\licensedcode\data\rules\artistic-2.0_27.yml", "YAML", 0, 0, 0, 3, 0, 0, 1, 4
"d:\IDEWORK\lvmen\src\licensedcode\data\rules\artistic-2.0_28.yml", "YAML", 0, 0, 0, 4, 0, 0, 1, 5
"d:\IDEWORK\lvmen\src\licensedcode\data\rules\artistic-2.0_29.yml", "YAML", 0, 0, 0, 5, 0, 0, 1, 6
"d:\IDEWORK\lvmen\src\licensedcode\data\rules\artistic-2.0_3.yml", "YAML", 0, 0, 0, 4, 0, 0, 1, 5
"d:\IDEWORK\lvmen\src\licensedcode\data\rules\artistic-2.0_30.yml", "YAML", 0, 0, 0, 3, 0, 0, 1, 4
"d:\IDEWORK\lvmen\src\licensedcode\data\rules\artistic-2.0_31.yml", "YAML", 0, 0, 0, 3, 0, 0, 1, 4
"d:\IDEWORK\lvmen\src\licensedcode\data\rules\artistic-2.0_32.yml", "YAML", 0, 0, 0, 3, 0, 0, 1, 4
"d:\IDEWORK\lvmen\src\licensedcode\data\rules\artistic-2.0_33.yml", "YAML", 0, 0, 0, 3, 0, 0, 1, 4
"d:\IDEWORK\lvmen\src\licensedcode\data\rules\artistic-2.0_34.yml", "YAML", 0, 0, 0, 5, 0, 0, 1, 6
"d:\IDEWORK\lvmen\src\licensedcode\data\rules\artistic-2.0_35.yml", "YAML", 0, 0, 0, 3, 0, 0, 1, 4
"d:\IDEWORK\lvmen\src\licensedcode\data\rules\artistic-2.0_36.yml", "YAML", 0, 0, 0, 10, 0, 0, 1, 11
"d:\IDEWORK\lvmen\src\licensedcode\data\rules\artistic-2.0_37.yml", "YAML", 0, 0, 0, 4, 0, 0, 1, 5
"d:\IDEWORK\lvmen\src\licensedcode\data\rules\artistic-2.0_38.yml", "YAML", 0, 0, 0, 4, 0, 0, 1, 5
"d:\IDEWORK\lvmen\src\licensedcode\data\rules\artistic-2.0_39.yml", "YAML", 0, 0, 0, 2, 0, 0, 1, 3
"d:\IDEWORK\lvmen\src\licensedcode\data\rules\artistic-2.0_4.yml", "YAML", 0, 0, 0, 2, 0, 0, 1, 3
"d:\IDEWORK\lvmen\src\licensedcode\data\rules\artistic-2.0_40.yml", "YAML", 0, 0, 0, 5, 0, 0, 1, 6
"d:\IDEWORK\lvmen\src\licensedcode\data\rules\artistic-2.0_41.yml", "YAML", 0, 0, 0, 3, 0, 0, 1, 4
"d:\IDEWORK\lvmen\src\licensedcode\data\rules\artistic-2.0_42.yml", "YAML", 0, 0, 0, 3, 0, 0, 1, 4
"d:\IDEWORK\lvmen\src\licensedcode\data\rules\artistic-2.0_5.yml", "YAML", 0, 0, 0, 8, 0, 0, 1, 9
"d:\IDEWORK\lvmen\src\licensedcode\data\rules\artistic-2.0_6.yml", "YAML", 0, 0, 0, 5, 0, 0, 1, 6
"d:\IDEWORK\lvmen\src\licensedcode\data\rules\artistic-2.0_7.yml", "YAML", 0, 0, 0, 6, 0, 0, 1, 7
"d:\IDEWORK\lvmen\src\licensedcode\data\rules\artistic-2.0_8.yml", "YAML", 0, 0, 0, 5, 0, 0, 1, 6
"d:\IDEWORK\lvmen\src\licensedcode\data\rules\artistic-2.0_9.yml", "YAML", 0, 0, 0, 3, 0, 0, 1, 4
"d:\IDEWORK\lvmen\src\licensedcode\data\rules\artistic-2.0_and_public-domain-disclaimer_1.yml", "YAML", 0, 0, 0, 3, 0, 0, 1, 4
"d:\IDEWORK\lvmen\src\licensedcode\data\rules\artistic-2.0_and_public-domain_1.yml", "YAML", 0, 0, 0, 2, 0, 0, 1, 3
"d:\IDEWORK\lvmen\src\licensedcode\data\rules\artistic-2.0_notice.yml", "YAML", 0, 0, 0, 4, 0, 0, 1, 5
"d:\IDEWORK\lvmen\src\licensedcode\data\rules\artistic-2.0_or_bsd-new_or_lgpl-3.0_1.yml", "YAML", 0, 0, 0, 6, 0, 0, 1, 7
"d:\IDEWORK\lvmen\src\licensedcode\data\rules\artistic-2.0_or_bsd-new_or_lgpl-3.0_2.yml", "YAML", 0, 0, 0, 8, 0, 0, 1, 9
"d:\IDEWORK\lvmen\src\licensedcode\data\rules\artistic-2.0_or_bsd-new_or_lgpl-3.0_3.yml", "YAML", 0, 0, 0, 6, 0, 0, 1, 7
"d:\IDEWORK\lvmen\src\licensedcode\data\rules\artistic-2.0_or_commercial-license_1.yml", "YAML", 0, 0, 0, 5, 0, 0, 1, 6
"d:\IDEWORK\lvmen\src\licensedcode\data\rules\artistic-2.0_or_commercial-license_2.yml", "YAML", 0, 0, 0, 2, 0, 0, 1, 3
"d:\IDEWORK\lvmen\src\licensedcode\data\rules\artistic-2.0_or_commercial-license_3.yml", "YAML", 0, 0, 0, 3, 0, 0, 1, 4
"d:\IDEWORK\lvmen\src\licensedcode\data\rules\artistic-2.0_or_later_or_gpl-2.0.yml", "YAML", 0, 0, 0, 4, 0, 0, 1, 5
"d:\IDEWORK\lvmen\src\licensedcode\data\rules\artistic-2.0_url_1.yml", "YAML", 0, 0, 0, 5, 0, 0, 1, 6
"d:\IDEWORK\lvmen\src\licensedcode\data\rules\artistic-2.0_url_2.yml", "YAML", 0, 0, 0, 5, 0, 0, 1, 6
"d:\IDEWORK\lvmen\src\licensedcode\data\rules\artistic-2.0_url_badge.yml", "YAML", 0, 0, 0, 5, 0, 0, 1, 6
"d:\IDEWORK\lvmen\src\licensedcode\data\rules\artistic-2.0_url_badge_1.yml", "YAML", 0, 0, 0, 5, 0, 0, 1, 6
"d:\IDEWORK\lvmen\src\licensedcode\data\rules\artistic-2.0_url_glc_250.yml", "YAML", 0, 0, 0, 5, 0, 0, 1, 6
"d:\IDEWORK\lvmen\src\licensedcode\data\rules\artistic-2.0_url_glc_251.yml", "YAML", 0, 0, 0, 5, 0, 0, 1, 6
"d:\IDEWORK\lvmen\src\licensedcode\data\rules\artistic-clarified.yml", "YAML", 0, 0, 0, 5, 0, 0, 1, 6
"d:\IDEWORK\lvmen\src\licensedcode\data\rules\artistic-clarified_1.yml", "YAML", 0, 0, 0, 5, 0, 0, 1, 6
"d:\IDEWORK\lvmen\src\licensedcode\data\rules\artistic-clarified_2.yml", "YAML", 0, 0, 0, 4, 0, 0, 1, 5
"d:\IDEWORK\lvmen\src\licensedcode\data\rules\artistic-clarified_url_1.yml", "YAML", 0, 0, 0, 5, 0, 0, 1, 6
"d:\IDEWORK\lvmen\src\licensedcode\data\rules\artistic-clarified_url_2.yml", "YAML", 0, 0, 0, 5, 0, 0, 1, 6
"d:\IDEWORK\lvmen\src\licensedcode\data\rules\artistic-dist-1.0_1.yml", "YAML", 0, 0, 0, 3, 0, 0, 1, 4
"d:\IDEWORK\lvmen\src\licensedcode\data\rules\artistic-dist-1.0_2.yml", "YAML", 0, 0, 0, 5, 0, 0, 1, 6
"d:\IDEWORK\lvmen\src\licensedcode\data\rules\artistic-dist-1.0_3.yml", "YAML", 0, 0, 0, 2, 0, 0, 1, 3
"d:\IDEWORK\lvmen\src\licensedcode\data\rules\artistic-dist-1.0_or_gpl-1.0-plus_1.yml", "YAML", 0, 0, 0, 2, 0, 0, 1, 3
"d:\IDEWORK\lvmen\src\licensedcode\data\rules\artistic-perl-1.0.yml", "YAML", 0, 0, 0, 6, 0, 0, 1, 7
"d:\IDEWORK\lvmen\src\licensedcode\data\rules\artistic-perl-1.0_1.yml", "YAML", 0, 0, 0, 4, 0, 0, 1, 5
"d:\IDEWORK\lvmen\src\licensedcode\data\rules\artistic-perl-1.0_10.yml", "YAML", 0, 0, 0, 3, 0, 0, 1, 4
"d:\IDEWORK\lvmen\src\licensedcode\data\rules\artistic-perl-1.0_11.yml", "YAML", 0, 0, 0, 3, 0, 0, 1, 4
"d:\IDEWORK\lvmen\src\licensedcode\data\rules\artistic-perl-1.0_12.yml", "YAML", 0, 0, 0, 2, 0, 0, 1, 3
"d:\IDEWORK\lvmen\src\licensedcode\data\rules\artistic-perl-1.0_13.yml", "YAML", 0, 0, 0, 4, 0, 0, 1, 5
"d:\IDEWORK\lvmen\src\licensedcode\data\rules\artistic-perl-1.0_2.yml", "YAML", 0, 0, 0, 3, 0, 0, 1, 4
"d:\IDEWORK\lvmen\src\licensedcode\data\rules\artistic-perl-1.0_26.yml", "YAML", 0, 0, 0, 4, 0, 0, 1, 5
"d:\IDEWORK\lvmen\src\licensedcode\data\rules\artistic-perl-1.0_3.yml", "YAML", 0, 0, 0, 3, 0, 0, 1, 4
"d:\IDEWORK\lvmen\src\licensedcode\data\rules\artistic-perl-1.0_4.yml", "YAML", 0, 0, 0, 3, 0, 0, 1, 4
"d:\IDEWORK\lvmen\src\licensedcode\data\rules\artistic-perl-1.0_5.yml", "YAML", 0, 0, 0, 4, 0, 0, 1, 5
"d:\IDEWORK\lvmen\src\licensedcode\data\rules\artistic-perl-1.0_6.yml", "YAML", 0, 0, 0, 5, 0, 0, 1, 6
"d:\IDEWORK\lvmen\src\licensedcode\data\rules\artistic-perl-1.0_7.yml", "YAML", 0, 0, 0, 3, 0, 0, 1, 4
"d:\IDEWORK\lvmen\src\licensedcode\data\rules\artistic-perl-1.0_8.yml", "YAML", 0, 0, 0, 3, 0, 0, 1, 4
"d:\IDEWORK\lvmen\src\licensedcode\data\rules\artistic-perl-1.0_9.yml", "YAML", 0, 0, 0, 3, 0, 0, 1, 4
"d:\IDEWORK\lvmen\src\licensedcode\data\rules\artistic-perl-1.0_or_artistic-dist-1.0_or_gpl-1.0-plus_1.yml", "YAML", 0, 0, 0, 2, 0, 0, 1, 3
"d:\IDEWORK\lvmen\src\licensedcode\data\rules\artistic-perl-1.0_or_artistic-dist-1.0_or_gpl-1.0-plus_2.yml", "YAML", 0, 0, 0, 2, 0, 0, 1, 3
"d:\IDEWORK\lvmen\src\licensedcode\data\rules\artistic-perl-1.0_or_gpl-1.0-plus_1.yml", "YAML", 0, 0, 0, 2, 0, 0, 1, 3
"d:\IDEWORK\lvmen\src\licensedcode\data\rules\artistic-perl-1.0_or_gpl-1.0-plus_10.yml", "YAML", 0, 0, 0, 2, 0, 0, 1, 3
"d:\IDEWORK\lvmen\src\licensedcode\data\rules\artistic-perl-1.0_or_gpl-1.0-plus_11.yml", "YAML", 0, 0, 0, 3, 0, 0, 1, 4
"d:\IDEWORK\lvmen\src\licensedcode\data\rules\artistic-perl-1.0_or_gpl-1.0-plus_12.yml", "YAML", 0, 0, 0, 2, 0, 0, 1, 3
"d:\IDEWORK\lvmen\src\licensedcode\data\rules\artistic-perl-1.0_or_gpl-1.0-plus_13.yml", "YAML", 0, 0, 0, 2, 0, 0, 1, 3
"d:\IDEWORK\lvmen\src\licensedcode\data\rules\artistic-perl-1.0_or_gpl-1.0-plus_14.yml", "YAML", 0, 0, 0, 3, 0, 0, 1, 4
"d:\IDEWORK\lvmen\src\licensedcode\data\rules\artistic-perl-1.0_or_gpl-1.0-plus_15.yml", "YAML", 0, 0, 0, 2, 0, 0, 1, 3
"d:\IDEWORK\lvmen\src\licensedcode\data\rules\artistic-perl-1.0_or_gpl-1.0-plus_16.yml", "YAML", 0, 0, 0, 2, 0, 0, 1, 3
"d:\IDEWORK\lvmen\src\licensedcode\data\rules\artistic-perl-1.0_or_gpl-1.0-plus_17.yml", "YAML", 0, 0, 0, 2, 0, 0, 1, 3
"d:\IDEWORK\lvmen\src\licensedcode\data\rules\artistic-perl-1.0_or_gpl-1.0-plus_18.yml", "YAML", 0, 0, 0, 4, 0, 0, 1, 5
"d:\IDEWORK\lvmen\src\licensedcode\data\rules\artistic-perl-1.0_or_gpl-1.0-plus_19.yml", "YAML", 0, 0, 0, 2, 0, 0, 1, 3
"d:\IDEWORK\lvmen\src\licensedcode\data\rules\artistic-perl-1.0_or_gpl-1.0-plus_2.yml", "YAML", 0, 0, 0, 2, 0, 0, 1, 3
"d:\IDEWORK\lvmen\src\licensedcode\data\rules\artistic-perl-1.0_or_gpl-1.0-plus_20.yml", "YAML", 0, 0, 0, 4, 0, 0, 1, 5
"d:\IDEWORK\lvmen\src\licensedcode\data\rules\artistic-perl-1.0_or_gpl-1.0-plus_21.yml", "YAML", 0, 0, 0, 6, 0, 0, 1, 7
"d:\IDEWORK\lvmen\src\licensedcode\data\rules\artistic-perl-1.0_or_gpl-1.0-plus_22.yml", "YAML", 0, 0, 0, 3, 0, 0, 1, 4
"d:\IDEWORK\lvmen\src\licensedcode\data\rules\artistic-perl-1.0_or_gpl-1.0-plus_23.yml", "YAML", 0, 0, 0, 3, 0, 0, 1, 4
"d:\IDEWORK\lvmen\src\licensedcode\data\rules\artistic-perl-1.0_or_gpl-1.0-plus_24.yml", "YAML", 0, 0, 0, 3, 0, 0, 1, 4
"d:\IDEWORK\lvmen\src\licensedcode\data\rules\artistic-perl-1.0_or_gpl-1.0-plus_25.yml", "YAML", 0, 0, 0, 3, 0, 0, 1, 4
"d:\IDEWORK\lvmen\src\licensedcode\data\rules\artistic-perl-1.0_or_gpl-1.0-plus_26.yml", "YAML", 0, 0, 0, 4, 0, 0, 1, 5
"d:\IDEWORK\lvmen\src\licensedcode\data\rules\artistic-perl-1.0_or_gpl-1.0-plus_27.yml", "YAML", 0, 0, 0, 4, 0, 0, 1, 5
"d:\IDEWORK\lvmen\src\licensedcode\data\rules\artistic-perl-1.0_or_gpl-1.0-plus_28.yml", "YAML", 0, 0, 0, 3, 0, 0, 1, 4
"d:\IDEWORK\lvmen\src\licensedcode\data\rules\artistic-perl-1.0_or_gpl-1.0-plus_29.yml", "YAML", 0, 0, 0, 3, 0, 0, 1, 4
"d:\IDEWORK\lvmen\src\licensedcode\data\rules\artistic-perl-1.0_or_gpl-1.0-plus_3.yml", "YAML", 0, 0, 0, 3, 0, 0, 1, 4
"d:\IDEWORK\lvmen\src\licensedcode\data\rules\artistic-perl-1.0_or_gpl-1.0-plus_30.yml", "YAML", 0, 0, 0, 3, 0, 0, 1, 4
"d:\IDEWORK\lvmen\src\licensedcode\data\rules\artistic-perl-1.0_or_gpl-1.0-plus_31.yml", "YAML", 0, 0, 0, 3, 0, 0, 1, 4
"d:\IDEWORK\lvmen\src\licensedcode\data\rules\artistic-perl-1.0_or_gpl-1.0-plus_32.yml", "YAML", 0, 0, 0, 3, 0, 0, 1, 4
"d:\IDEWORK\lvmen\src\licensedcode\data\rules\artistic-perl-1.0_or_gpl-1.0-plus_33.yml", "YAML", 0, 0, 0, 3, 0, 0, 1, 4
"d:\IDEWORK\lvmen\src\licensedcode\data\rules\artistic-perl-1.0_or_gpl-1.0-plus_34.yml", "YAML", 0, 0, 0, 3, 0, 0, 1, 4
"d:\IDEWORK\lvmen\src\licensedcode\data\rules\artistic-perl-1.0_or_gpl-1.0-plus_35.yml", "YAML", 0, 0, 0, 6, 0, 0, 1, 7
"d:\IDEWORK\lvmen\src\licensedcode\data\rules\artistic-perl-1.0_or_gpl-1.0-plus_36.yml", "YAML", 0, 0, 0, 3, 0, 0, 1, 4
"d:\IDEWORK\lvmen\src\licensedcode\data\rules\artistic-perl-1.0_or_gpl-1.0-plus_37.yml", "YAML", 0, 0, 0, 3, 0, 0, 1, 4
"d:\IDEWORK\lvmen\src\licensedcode\data\rules\artistic-perl-1.0_or_gpl-1.0-plus_38.yml", "YAML", 0, 0, 0, 3, 0, 0, 1, 4
"d:\IDEWORK\lvmen\src\licensedcode\data\rules\artistic-perl-1.0_or_gpl-1.0-plus_39.yml", "YAML", 0, 0, 0, 3, 0, 0, 1, 4
"d:\IDEWORK\lvmen\src\licensedcode\data\rules\artistic-perl-1.0_or_gpl-1.0-plus_4.yml", "YAML", 0, 0, 0, 2, 0, 0, 1, 3
"d:\IDEWORK\lvmen\src\licensedcode\data\rules\artistic-perl-1.0_or_gpl-1.0-plus_40.yml", "YAML", 0, 0, 0, 3, 0, 0, 1, 4
"d:\IDEWORK\lvmen\src\licensedcode\data\rules\artistic-perl-1.0_or_gpl-1.0-plus_41.yml", "YAML", 0, 0, 0, 3, 0, 0, 1, 4
"d:\IDEWORK\lvmen\src\licensedcode\data\rules\artistic-perl-1.0_or_gpl-1.0-plus_42.yml", "YAML", 0, 0, 0, 3, 0, 0, 1, 4
"d:\IDEWORK\lvmen\src\licensedcode\data\rules\artistic-perl-1.0_or_gpl-1.0-plus_43.yml", "YAML", 0, 0, 0, 3, 0, 0, 1, 4
"d:\IDEWORK\lvmen\src\licensedcode\data\rules\artistic-perl-1.0_or_gpl-1.0-plus_44.yml", "YAML", 0, 0, 0, 2, 0, 0, 1, 3
"d:\IDEWORK\lvmen\src\licensedcode\data\rules\artistic-perl-1.0_or_gpl-1.0-plus_45.yml", "YAML", 0, 0, 0, 2, 0, 0, 1, 3
"d:\IDEWORK\lvmen\src\licensedcode\data\rules\artistic-perl-1.0_or_gpl-1.0-plus_46.yml", "YAML", 0, 0, 0, 2, 0, 0, 1, 3
"d:\IDEWORK\lvmen\src\licensedcode\data\rules\artistic-perl-1.0_or_gpl-1.0-plus_47.yml", "YAML", 0, 0, 0, 2, 0, 0, 1, 3
"d:\IDEWORK\lvmen\src\licensedcode\data\rules\artistic-perl-1.0_or_gpl-1.0-plus_48.yml", "YAML", 0, 0, 0, 3, 0, 0, 1, 4
"d:\IDEWORK\lvmen\src\licensedcode\data\rules\artistic-perl-1.0_or_gpl-1.0-plus_49.yml", "YAML", 0, 0, 0, 2, 0, 0, 1, 3
"d:\IDEWORK\lvmen\src\licensedcode\data\rules\artistic-perl-1.0_or_gpl-1.0-plus_5.yml", "YAML", 0, 0, 0, 2, 0, 0, 1, 3
"d:\IDEWORK\lvmen\src\licensedcode\data\rules\artistic-perl-1.0_or_gpl-1.0-plus_50.yml", "YAML", 0, 0, 0, 3, 0, 0, 1, 4
"d:\IDEWORK\lvmen\src\licensedcode\data\rules\artistic-perl-1.0_or_gpl-1.0-plus_51.yml", "YAML", 0, 0, 0, 6, 0, 0, 1, 7
"d:\IDEWORK\lvmen\src\licensedcode\data\rules\artistic-perl-1.0_or_gpl-1.0-plus_52.yml", "YAML", 0, 0, 0, 3, 0, 0, 1, 4
"d:\IDEWORK\lvmen\src\licensedcode\data\rules\artistic-perl-1.0_or_gpl-1.0-plus_6.yml", "YAML", 0, 0, 0, 2, 0, 0, 1, 3
"d:\IDEWORK\lvmen\src\licensedcode\data\rules\artistic-perl-1.0_or_gpl-1.0-plus_7.yml", "YAML", 0, 0, 0, 4, 0, 0, 1, 5
"d:\IDEWORK\lvmen\src\licensedcode\data\rules\artistic-perl-1.0_or_gpl-1.0-plus_8.yml", "YAML", 0, 0, 0, 3, 0, 0, 1, 4
"d:\IDEWORK\lvmen\src\licensedcode\data\rules\artistic-perl-1.0_or_gpl-1.0-plus_9.yml", "YAML", 0, 0, 0, 2, 0, 0, 1, 3
"d:\IDEWORK\lvmen\src\licensedcode\data\rules\artistic-perl-1.0_or_gpl-1.0-plus_and_bsd-new_1.yml", "YAML", 0, 0, 0, 3, 0, 0, 1, 4
"d:\IDEWORK\lvmen\src\licensedcode\data\rules\artistic-perl-1.0_or_gpl-1.0-plus_and_bsd-new_2.yml", "YAML", 0, 0, 0, 2, 0, 0, 1, 3
"d:\IDEWORK\lvmen\src\licensedcode\data\rules\artistic-perl-1.0_or_gpl-1.0_1.yml", "YAML", 0, 0, 0, 4, 0, 0, 1, 5
"d:\IDEWORK\lvmen\src\licensedcode\data\rules\artistic-perl-1.0_or_gpl-1.0_2.yml", "YAML", 0, 0, 0, 6, 0, 0, 1, 7
"d:\IDEWORK\lvmen\src\licensedcode\data\rules\artistic-perl-1.0_or_gpl-2.0-plus_1.yml", "YAML", 0, 0, 0, 5, 0, 0, 1, 6
"d:\IDEWORK\lvmen\src\licensedcode\data\rules\artistic-perl-1.0_or_gpl-2.0-plus_2.yml", "YAML", 0, 0, 0, 3, 0, 0, 1, 4
"d:\IDEWORK\lvmen\src\licensedcode\data\rules\artistic-perl-1.0_or_gpl-2.0-plus_3.yml", "YAML", 0, 0, 0, 3, 0, 0, 1, 4
"d:\IDEWORK\lvmen\src\licensedcode\data\rules\artistic-perl-1.0_perl5_1.yml", "YAML", 0, 0, 0, 4, 0, 0, 1, 5
"d:\IDEWORK\lvmen\src\licensedcode\data\rules\artistic-perl-1.0_perl5_2.yml", "YAML", 0, 0, 0, 4, 0, 0, 1, 5
"d:\IDEWORK\lvmen\src\licensedcode\data\rules\artistic-perl-1.0_perl5_3.yml", "YAML", 0, 0, 0, 4, 0, 0, 1, 5
"d:\IDEWORK\lvmen\src\licensedcode\data\rules\artistic-perl-1.0_perl5_4.yml", "YAML", 0, 0, 0, 4, 0, 0, 1, 5
"d:\IDEWORK\lvmen\src\licensedcode\data\rules\artistic-perl-1.0_url_1.yml", "YAML", 0, 0, 0, 5, 0, 0, 1, 6
"d:\IDEWORK\lvmen\src\licensedcode\data\rules\artistic-perl-1.0_url_2.yml", "YAML", 0, 0, 0, 5, 0, 0, 1, 6
"d:\IDEWORK\lvmen\src\licensedcode\data\rules\artistic_and_bsd-new.yml", "YAML", 0, 0, 0, 3, 0, 0, 1, 4
"d:\IDEWORK\lvmen\src\licensedcode\data\rules\artistic_and_bsd-new_and_gpl.yml", "YAML", 0, 0, 0, 2, 0, 0, 1, 3
"d:\IDEWORK\lvmen\src\licensedcode\data\rules\artistic_and_public-domain.yml", "YAML", 0, 0, 0, 2, 0, 0, 1, 3
"d:\IDEWORK\lvmen\src\licensedcode\data\rules\asmus.yml", "YAML", 0, 0, 0, 5, 0, 0, 1, 6
"d:\IDEWORK\lvmen\src\licensedcode\data\rules\ati-eula.yml", "YAML", 0, 0, 0, 5, 0, 0, 1, 6
"d:\IDEWORK\lvmen\src\licensedcode\data\rules\attribution.SPDX.yml", "YAML", 0, 0, 0, 4, 0, 0, 1, 5
"d:\IDEWORK\lvmen\src\licensedcode\data\rules\attribution.yml", "YAML", 0, 0, 0, 5, 0, 0, 1, 6
"d:\IDEWORK\lvmen\src\licensedcode\data\rules\attribution_1.yml", "YAML", 0, 0, 0, 5, 0, 0, 1, 6
"d:\IDEWORK\lvmen\src\licensedcode\data\rules\attribution_10.yml", "YAML", 0, 0, 0, 3, 0, 0, 1, 4
"d:\IDEWORK\lvmen\src\licensedcode\data\rules\attribution_11.yml", "YAML", 0, 0, 0, 3, 0, 0, 1, 4
"d:\IDEWORK\lvmen\src\licensedcode\data\rules\attribution_2.yml", "YAML", 0, 0, 0, 3, 0, 0, 1, 4
"d:\IDEWORK\lvmen\src\licensedcode\data\rules\attribution_3.yml", "YAML", 0, 0, 0, 5, 0, 0, 1, 6
"d:\IDEWORK\lvmen\src\licensedcode\data\rules\attribution_4.yml", "YAML", 0, 0, 0, 9, 0, 0, 1, 10
"d:\IDEWORK\lvmen\src\licensedcode\data\rules\attribution_5.yml", "YAML", 0, 0, 0, 3, 0, 0, 1, 4
"d:\IDEWORK\lvmen\src\licensedcode\data\rules\attribution_6.yml", "YAML", 0, 0, 0, 3, 0, 0, 1, 4
"d:\IDEWORK\lvmen\src\licensedcode\data\rules\attribution_7.yml", "YAML", 0, 0, 0, 3, 0, 0, 1, 4
"d:\IDEWORK\lvmen\src\licensedcode\data\rules\attribution_8.yml", "YAML", 0, 0, 0, 3, 0, 0, 1, 4
"d:\IDEWORK\lvmen\src\licensedcode\data\rules\attribution_9.yml", "YAML", 0, 0, 0, 5, 0, 0, 1, 6
"d:\IDEWORK\lvmen\src\licensedcode\data\rules\attribution_url_1.yml", "YAML", 0, 0, 0, 5, 0, 0, 1, 6
"d:\IDEWORK\lvmen\src\licensedcode\data\rules\attribution_url_2.yml", "YAML", 0, 0, 0, 5, 0, 0, 1, 6
"d:\IDEWORK\lvmen\src\licensedcode\data\rules\attribution_url_glc_252.yml", "YAML", 0, 0, 0, 5, 0, 0, 1, 6
"d:\IDEWORK\lvmen\src\licensedcode\data\rules\attribution_url_glc_253.yml", "YAML", 0, 0, 0, 5, 0, 0, 1, 6
"d:\IDEWORK\lvmen\src\licensedcode\data\rules\autoconf-exception-2.0_1.yml", "YAML", 0, 0, 0, 2, 0, 0, 1, 3
"d:\IDEWORK\lvmen\src\licensedcode\data\rules\autoconf-exception-2.0_url_1.yml", "YAML", 0, 0, 0, 5, 0, 0, 1, 6
"d:\IDEWORK\lvmen\src\licensedcode\data\rules\autoconf-exception-2.0_url_2.yml", "YAML", 0, 0, 0, 5, 0, 0, 1, 6
"d:\IDEWORK\lvmen\src\licensedcode\data\rules\autoconf-exception-3.0_1.yml", "YAML", 0, 0, 0, 5, 0, 0, 1, 6
"d:\IDEWORK\lvmen\src\licensedcode\data\rules\autoconf-exception-3.0_2.yml", "YAML", 0, 0, 0, 5, 0, 0, 1, 6
"d:\IDEWORK\lvmen\src\licensedcode\data\rules\autoconf-exception-3.0_3.yml", "YAML", 0, 0, 0, 4, 0, 0, 1, 5
"d:\IDEWORK\lvmen\src\licensedcode\data\rules\autoconf-exception-3.0_4.yml", "YAML", 0, 0, 0, 3, 0, 0, 1, 4
"d:\IDEWORK\lvmen\src\licensedcode\data\rules\autoconf-exception-3.0_5.yml", "YAML", 0, 0, 0, 3, 0, 0, 1, 4
"d:\IDEWORK\lvmen\src\licensedcode\data\rules\autoconf-exception-3.0_6.yml", "YAML", 0, 0, 0, 6, 0, 0, 1, 7
"d:\IDEWORK\lvmen\src\licensedcode\data\rules\autoconf-exception-3.0_7.yml", "YAML", 0, 0, 0, 3, 0, 0, 1, 4
"d:\IDEWORK\lvmen\src\licensedcode\data\rules\autoconf-exception-3.0_url_1.yml", "YAML", 0, 0, 0, 5, 0, 0, 1, 6
"d:\IDEWORK\lvmen\src\licensedcode\data\rules\autoconf-exception-3.0_url_2.yml", "YAML", 0, 0, 0, 5, 0, 0, 1, 6
"d:\IDEWORK\lvmen\src\licensedcode\data\rules\autoconf-macro-exception_1.yml", "YAML", 0, 0, 0, 2, 0, 0, 1, 3
"d:\IDEWORK\lvmen\src\licensedcode\data\rules\autoconf-macro-exception_2.yml", "YAML", 0, 0, 0, 2, 0, 0, 1, 3
"d:\IDEWORK\lvmen\src\licensedcode\data\rules\autoconf-simple-exception-2.0_1.yml", "YAML", 0, 0, 0, 3, 0, 0, 1, 4
"d:\IDEWORK\lvmen\src\licensedcode\data\rules\autoconf-simple-exception-2.0_2.yml", "YAML", 0, 0, 0, 3, 0, 0, 1, 4
"d:\IDEWORK\lvmen\src\licensedcode\data\rules\bahyph_url_1.yml", "YAML", 0, 0, 0, 5, 0, 0, 1, 6
"d:\IDEWORK\lvmen\src\licensedcode\data\rules\bahyph_url_2.yml", "YAML", 0, 0, 0, 5, 0, 0, 1, 6
"d:\IDEWORK\lvmen\src\licensedcode\data\rules\bakoma-fonts-1995_1.yml", "YAML", 0, 0, 0, 4, 0, 0, 1, 5
"d:\IDEWORK\lvmen\src\licensedcode\data\rules\bapl-1.0_1.yml", "YAML", 0, 0, 0, 4, 0, 0, 1, 5
"d:\IDEWORK\lvmen\src\licensedcode\data\rules\bapl-1.0_2.yml", "YAML", 0, 0, 0, 3, 0, 0, 1, 4
"d:\IDEWORK\lvmen\src\licensedcode\data\rules\bapl-1.0_3.yml", "YAML", 0, 0, 0, 5, 0, 0, 1, 6
"d:\IDEWORK\lvmen\src\licensedcode\data\rules\bapl-1.0_4.yml", "YAML", 0, 0, 0, 3, 0, 0, 1, 4
"d:\IDEWORK\lvmen\src\licensedcode\data\rules\barr-tex_url_1.yml", "YAML", 0, 0, 0, 5, 0, 0, 1, 6
"d:\IDEWORK\lvmen\src\licensedcode\data\rules\barr-tex_url_2.yml", "YAML", 0, 0, 0, 5, 0, 0, 1, 6
"d:\IDEWORK\lvmen\src\licensedcode\data\rules\base64_multichoice.yml", "YAML", 0, 0, 0, 13, 0, 0, 1, 14
"d:\IDEWORK\lvmen\src\licensedcode\data\rules\beautifulsoup4_mit.yml", "YAML", 0, 0, 0, 6, 0, 0, 1, 7
"d:\IDEWORK\lvmen\src\licensedcode\data\rules\beautifulsoup4_mit2.yml", "YAML", 0, 0, 0, 3, 0, 0, 1, 4
"d:\IDEWORK\lvmen\src\licensedcode\data\rules\beautifulsoup_bsd.yml", "YAML", 0, 0, 0, 4, 0, 0, 1, 5
"d:\IDEWORK\lvmen\src\licensedcode\data\rules\beerware.yml", "YAML", 0, 0, 0, 5, 0, 0, 1, 6
"d:\IDEWORK\lvmen\src\licensedcode\data\rules\beerware_1.yml", "YAML", 0, 0, 0, 4, 0, 0, 1, 5
"d:\IDEWORK\lvmen\src\licensedcode\data\rules\beerware_10.yml", "YAML", 0, 0, 0, 3, 0, 0, 1, 4
"d:\IDEWORK\lvmen\src\licensedcode\data\rules\beerware_11.yml", "YAML", 0, 0, 0, 3, 0, 0, 1, 4
"d:\IDEWORK\lvmen\src\licensedcode\data\rules\beerware_12.yml", "YAML", 0, 0, 0, 4, 0, 0, 1, 5
"d:\IDEWORK\lvmen\src\licensedcode\data\rules\beerware_2.yml", "YAML", 0, 0, 0, 2, 0, 0, 1, 3
"d:\IDEWORK\lvmen\src\licensedcode\data\rules\beerware_3.yml", "YAML", 0, 0, 0, 2, 0, 0, 1, 3
"d:\IDEWORK\lvmen\src\licensedcode\data\rules\beerware_4.yml", "YAML", 0, 0, 0, 4, 0, 0, 1, 5
"d:\IDEWORK\lvmen\src\licensedcode\data\rules\beerware_5.yml", "YAML", 0, 0, 0, 5, 0, 0, 1, 6
"d:\IDEWORK\lvmen\src\licensedcode\data\rules\beerware_6.yml", "YAML", 0, 0, 0, 3, 0, 0, 1, 4
"d:\IDEWORK\lvmen\src\licensedcode\data\rules\beerware_7.yml", "YAML", 0, 0, 0, 5, 0, 0, 1, 6
"d:\IDEWORK\lvmen\src\licensedcode\data\rules\beerware_8.yml", "YAML", 0, 0, 0, 3, 0, 0, 1, 4
"d:\IDEWORK\lvmen\src\licensedcode\data\rules\beerware_9.yml", "YAML", 0, 0, 0, 3, 0, 0, 1, 4
"d:\IDEWORK\lvmen\src\licensedcode\data\rules\beerware_url_1.yml", "YAML", 0, 0, 0, 5, 0, 0, 1, 6
"d:\IDEWORK\lvmen\src\licensedcode\data\rules\beerware_url_2.yml", "YAML", 0, 0, 0, 5, 0, 0, 1, 6
"d:\IDEWORK\lvmen\src\licensedcode\data\rules\bigdigits_1.yml", "YAML", 0, 0, 0, 5, 0, 0, 1, 6
"d:\IDEWORK\lvmen\src\licensedcode\data\rules\bigdigits_2.yml", "YAML", 0, 0, 0, 12, 0, 0, 1, 13
"d:\IDEWORK\lvmen\src\licensedcode\data\rules\bigdigits_3.yml", "YAML", 0, 0, 0, 10, 0, 0, 1, 11
"d:\IDEWORK\lvmen\src\licensedcode\data\rules\biopython.yml", "YAML", 0, 0, 0, 5, 0, 0, 1, 6
"d:\IDEWORK\lvmen\src\licensedcode\data\rules\biopython_1.yml", "YAML", 0, 0, 0, 3, 0, 0, 1, 4
"d:\IDEWORK\lvmen\src\licensedcode\data\rules\biopython_2.yml", "YAML", 0, 0, 0, 3, 0, 0, 1, 4
"d:\IDEWORK\lvmen\src\licensedcode\data\rules\biosl-4.0_1.yml", "YAML", 0, 0, 0, 11, 0, 0, 1, 12
"d:\IDEWORK\lvmen\src\licensedcode\data\rules\biosl-4.0_2.yml", "YAML", 0, 0, 0, 6, 0, 0, 1, 7
"d:\IDEWORK\lvmen\src\licensedcode\data\rules\biosl-4.0_3.yml", "YAML", 0, 0, 0, 6, 0, 0, 1, 7
"d:\IDEWORK\lvmen\src\licensedcode\data\rules\biosl-4.0_4.yml", "YAML", 0, 0, 0, 4, 0, 0, 1, 5
"d:\IDEWORK\lvmen\src\licensedcode\data\rules\biosl-4.0_5.yml", "YAML", 0, 0, 0, 4, 0, 0, 1, 5
"d:\IDEWORK\lvmen\src\licensedcode\data\rules\bison-exception-2.2_1.yml", "YAML", 0, 0, 0, 2, 0, 0, 1, 3
"d:\IDEWORK\lvmen\src\licensedcode\data\rules\bison-exception-2.2_2.yml", "YAML", 0, 0, 0, 2, 0, 0, 1, 3
"d:\IDEWORK\lvmen\src\licensedcode\data\rules\bison-exception-2.2_3.yml", "YAML", 0, 0, 0, 3, 0, 0, 1, 4
"d:\IDEWORK\lvmen\src\licensedcode\data\rules\bison-exception-2.2_4.yml", "YAML", 0, 0, 0, 3, 0, 0, 1, 4
"d:\IDEWORK\lvmen\src\licensedcode\data\rules\bison-exception-2.2_url_1.yml", "YAML", 0, 0, 0, 5, 0, 0, 1, 6
"d:\IDEWORK\lvmen\src\licensedcode\data\rules\bison-exception-2.2_url_2.yml", "YAML", 0, 0, 0, 5, 0, 0, 1, 6
"d:\IDEWORK\lvmen\src\licensedcode\data\rules\bitstream.yml", "YAML", 0, 0, 0, 5, 0, 0, 1, 6
"d:\IDEWORK\lvmen\src\licensedcode\data\rules\bitstream2.yml", "YAML", 0, 0, 0, 3, 0, 0, 1, 4
"d:\IDEWORK\lvmen\src\licensedcode\data\rules\bitstream_1.yml", "YAML", 0, 0, 0, 3, 0, 0, 1, 4
"d:\IDEWORK\lvmen\src\licensedcode\data\rules\bitstream_2.yml", "YAML", 0, 0, 0, 3, 0, 0, 1, 4
"d:\IDEWORK\lvmen\src\licensedcode\data\rules\bitstream_3.yml", "YAML", 0, 0, 0, 3, 0, 0, 1, 4
"d:\IDEWORK\lvmen\src\licensedcode\data\rules\bitstream_4.yml", "YAML", 0, 0, 0, 3, 0, 0, 1, 4
"d:\IDEWORK\lvmen\src\licensedcode\data\rules\bitstream_5.yml", "YAML", 0, 0, 0, 3, 0, 0, 1, 4
"d:\IDEWORK\lvmen\src\licensedcode\data\rules\bitstream_6.yml", "YAML", 0, 0, 0, 3, 0, 0, 1, 4
"d:\IDEWORK\lvmen\src\licensedcode\data\rules\bitstream_7.yml", "YAML", 0, 0, 0, 3, 0, 0, 1, 4
"d:\IDEWORK\lvmen\src\licensedcode\data\rules\bitstream_8.yml", "YAML", 0, 0, 0, 3, 0, 0, 1, 4
"d:\IDEWORK\lvmen\src\licensedcode\data\rules\bitstream_9.yml", "YAML", 0, 0, 0, 3, 0, 0, 1, 4
"d:\IDEWORK\lvmen\src\licensedcode\data\rules\bitstream_and_bitstream_and_public-domain_1.yml", "YAML", 0, 0, 0, 4, 0, 0, 1, 5
"d:\IDEWORK\lvmen\src\licensedcode\data\rules\bitstream_and_bitstream_and_public-domain_2.yml", "YAML", 0, 0, 0, 4, 0, 0, 1, 5
"d:\IDEWORK\lvmen\src\licensedcode\data\rules\bitstream_and_public-domain_1.yml", "YAML", 0, 0, 0, 4, 0, 0, 1, 5
"d:\IDEWORK\lvmen\src\licensedcode\data\rules\bitstream_and_public-domain_2.yml", "YAML", 0, 0, 0, 4, 0, 0, 1, 5
"d:\IDEWORK\lvmen\src\licensedcode\data\rules\bittorrent-1.0.yml", "YAML", 0, 0, 0, 5, 0, 0, 1, 6
"d:\IDEWORK\lvmen\src\licensedcode\data\rules\bittorrent-1.0_1.yml", "YAML", 0, 0, 0, 4, 0, 0, 1, 5
"d:\IDEWORK\lvmen\src\licensedcode\data\rules\bittorrent-1.0_2.yml", "YAML", 0, 0, 0, 4, 0, 0, 1, 5
"d:\IDEWORK\lvmen\src\licensedcode\data\rules\bittorrent-1.0_url_1.yml", "YAML", 0, 0, 0, 5, 0, 0, 1, 6
"d:\IDEWORK\lvmen\src\licensedcode\data\rules\bittorrent-1.0_url_2.yml", "YAML", 0, 0, 0, 5, 0, 0, 1, 6
"d:\IDEWORK\lvmen\src\licensedcode\data\rules\bittorrent-1.1.SPDX.yml", "YAML", 0, 0, 0, 6, 0, 0, 1, 7
"d:\IDEWORK\lvmen\src\licensedcode\data\rules\bittorrent-1.1_1.yml", "YAML", 0, 0, 0, 5, 0, 0, 1, 6
"d:\IDEWORK\lvmen\src\licensedcode\data\rules\bittorrent-1.1_2.yml", "YAML", 0, 0, 0, 4, 0, 0, 1, 5
"d:\IDEWORK\lvmen\src\licensedcode\data\rules\bittorrent-1.1_url_1.yml", "YAML", 0, 0, 0, 5, 0, 0, 1, 6
"d:\IDEWORK\lvmen\src\licensedcode\data\rules\bittorrent-1.1_url_2.yml", "YAML", 0, 0, 0, 5, 0, 0, 1, 6
"d:\IDEWORK\lvmen\src\licensedcode\data\rules\bitzi-pd.yml", "YAML", 0, 0, 0, 6, 0, 0, 1, 7
"d:\IDEWORK\lvmen\src\licensedcode\data\rules\bitzi-pd_1.yml", "YAML", 0, 0, 0, 8, 0, 0, 1, 9
"d:\IDEWORK\lvmen\src\licensedcode\data\rules\blessing_1.yml", "YAML", 0, 0, 0, 3, 0, 0, 1, 4
"d:\IDEWORK\lvmen\src\licensedcode\data\rules\blessing_url_1.yml", "YAML", 0, 0, 0, 5, 0, 0, 1, 6
"d:\IDEWORK\lvmen\src\licensedcode\data\rules\blessing_url_2.yml", "YAML", 0, 0, 0, 5, 0, 0, 1, 6
"d:\IDEWORK\lvmen\src\licensedcode\data\rules\blitz-artistic_or_gpl-2.0_1.yml", "YAML", 0, 0, 0, 6, 0, 0, 1, 7
"d:\IDEWORK\lvmen\src\licensedcode\data\rules\blitz-artistic_or_gpl-2.0_2.yml", "YAML", 0, 0, 0, 3, 0, 0, 1, 4
"d:\IDEWORK\lvmen\src\licensedcode\data\rules\blitz-artistic_or_gpl-2.0_3.yml", "YAML", 0, 0, 0, 5, 0, 0, 1, 6
"d:\IDEWORK\lvmen\src\licensedcode\data\rules\blueoak-1.0.0_url_1.yml", "YAML", 0, 0, 0, 5, 0, 0, 1, 6
"d:\IDEWORK\lvmen\src\licensedcode\data\rules\blueoak-1.0.0_url_2.yml", "YAML", 0, 0, 0, 5, 0, 0, 1, 6
"d:\IDEWORK\lvmen\src\licensedcode\data\rules\boost-1.0_1.yml", "YAML", 0, 0, 0, 7, 0, 0, 1, 8
"d:\IDEWORK\lvmen\src\licensedcode\data\rules\boost-1.0_10.yml", "YAML", 0, 0, 0, 5, 0, 0, 1, 6
"d:\IDEWORK\lvmen\src\licensedcode\data\rules\boost-1.0_11.yml", "YAML", 0, 0, 0, 3, 0, 0, 1, 4
"d:\IDEWORK\lvmen\src\licensedcode\data\rules\boost-1.0_12.yml", "YAML", 0, 0, 0, 8, 0, 0, 1, 9
"d:\IDEWORK\lvmen\src\licensedcode\data\rules\boost-1.0_13.yml", "YAML", 0, 0, 0, 5, 0, 0, 1, 6
"d:\IDEWORK\lvmen\src\licensedcode\data\rules\boost-1.0_14.yml", "YAML", 0, 0, 0, 5, 0, 0, 1, 6
"d:\IDEWORK\lvmen\src\licensedcode\data\rules\boost-1.0_15.yml", "YAML", 0, 0, 0, 5, 0, 0, 1, 6
"d:\IDEWORK\lvmen\src\licensedcode\data\rules\boost-1.0_16.yml", "YAML", 0, 0, 0, 3, 0, 0, 1, 4
"d:\IDEWORK\lvmen\src\licensedcode\data\rules\boost-1.0_17.yml", "YAML", 0, 0, 0, 3, 0, 0, 1, 4
"d:\IDEWORK\lvmen\src\licensedcode\data\rules\boost-1.0_18.yml", "YAML", 0, 0, 0, 5, 0, 0, 1, 6
"d:\IDEWORK\lvmen\src\licensedcode\data\rules\boost-1.0_19.yml", "YAML", 0, 0, 0, 5, 0, 0, 1, 6
"d:\IDEWORK\lvmen\src\licensedcode\data\rules\boost-1.0_1_markup.yml", "YAML", 0, 0, 0, 5, 0, 0, 1, 6
"d:\IDEWORK\lvmen\src\licensedcode\data\rules\boost-1.0_2.yml", "YAML", 0, 0, 0, 3, 0, 0, 1, 4
"d:\IDEWORK\lvmen\src\licensedcode\data\rules\boost-1.0_20.yml", "YAML", 0, 0, 0, 3, 0, 0, 1, 4
"d:\IDEWORK\lvmen\src\licensedcode\data\rules\boost-1.0_21.yml", "YAML", 0, 0, 0, 7, 0, 0, 1, 8
"d:\IDEWORK\lvmen\src\licensedcode\data\rules\boost-1.0_22.yml", "YAML", 0, 0, 0, 3, 0, 0, 1, 4
"d:\IDEWORK\lvmen\src\licensedcode\data\rules\boost-1.0_23.yml", "YAML", 0, 0, 0, 5, 0, 0, 1, 6
"d:\IDEWORK\lvmen\src\licensedcode\data\rules\boost-1.0_24.yml", "YAML", 0, 0, 0, 3, 0, 0, 1, 4
"d:\IDEWORK\lvmen\src\licensedcode\data\rules\boost-1.0_25.yml", "YAML", 0, 0, 0, 3, 0, 0, 1, 4
"d:\IDEWORK\lvmen\src\licensedcode\data\rules\boost-1.0_26.yml", "YAML", 0, 0, 0, 3, 0, 0, 1, 4
"d:\IDEWORK\lvmen\src\licensedcode\data\rules\boost-1.0_27.yml", "YAML", 0, 0, 0, 3, 0, 0, 1, 4
"d:\IDEWORK\lvmen\src\licensedcode\data\rules\boost-1.0_28.yml", "YAML", 0, 0, 0, 3, 0, 0, 1, 4
"d:\IDEWORK\lvmen\src\licensedcode\data\rules\boost-1.0_29.yml", "YAML", 0, 0, 0, 3, 0, 0, 1, 4
"d:\IDEWORK\lvmen\src\licensedcode\data\rules\boost-1.0_3.yml", "YAML", 0, 0, 0, 9, 0, 0, 1, 10
"d:\IDEWORK\lvmen\src\licensedcode\data\rules\boost-1.0_30.yml", "YAML", 0, 0, 0, 3, 0, 0, 1, 4
"d:\IDEWORK\lvmen\src\licensedcode\data\rules\boost-1.0_31.yml", "YAML", 0, 0, 0, 6, 0, 0, 1, 7
"d:\IDEWORK\lvmen\src\licensedcode\data\rules\boost-1.0_32.yml", "YAML", 0, 0, 0, 6, 0, 0, 1, 7
"d:\IDEWORK\lvmen\src\licensedcode\data\rules\boost-1.0_33.yml", "YAML", 0, 0, 0, 3, 0, 0, 1, 4
"d:\IDEWORK\lvmen\src\licensedcode\data\rules\boost-1.0_34.yml", "YAML", 0, 0, 0, 3, 0, 0, 1, 4
"d:\IDEWORK\lvmen\src\licensedcode\data\rules\boost-1.0_35.yml", "YAML", 0, 0, 0, 3, 0, 0, 1, 4
"d:\IDEWORK\lvmen\src\licensedcode\data\rules\boost-1.0_36.yml", "YAML", 0, 0, 0, 5, 0, 0, 1, 6
"d:\IDEWORK\lvmen\src\licensedcode\data\rules\boost-1.0_37.yml", "YAML", 0, 0, 0, 5, 0, 0, 1, 6
"d:\IDEWORK\lvmen\src\licensedcode\data\rules\boost-1.0_38.yml", "YAML", 0, 0, 0, 5, 0, 0, 1, 6
"d:\IDEWORK\lvmen\src\licensedcode\data\rules\boost-1.0_39.yml", "YAML", 0, 0, 0, 5, 0, 0, 1, 6
"d:\IDEWORK\lvmen\src\licensedcode\data\rules\boost-1.0_4.yml", "YAML", 0, 0, 0, 3, 0, 0, 1, 4
"d:\IDEWORK\lvmen\src\licensedcode\data\rules\boost-1.0_40.yml", "YAML", 0, 0, 0, 3, 0, 0, 1, 4
"d:\IDEWORK\lvmen\src\licensedcode\data\rules\boost-1.0_41.yml", "YAML", 0, 0, 0, 7, 0, 0, 1, 8
"d:\IDEWORK\lvmen\src\licensedcode\data\rules\boost-1.0_42.yml", "YAML", 0, 0, 0, 5, 0, 0, 1, 6
"d:\IDEWORK\lvmen\src\licensedcode\data\rules\boost-1.0_43.yml", "YAML", 0, 0, 0, 8, 0, 0, 1, 9
"d:\IDEWORK\lvmen\src\licensedcode\data\rules\boost-1.0_44.yml", "YAML", 0, 0, 0, 3, 0, 0, 1, 4
"d:\IDEWORK\lvmen\src\licensedcode\data\rules\boost-1.0_5.yml", "YAML", 0, 0, 0, 5, 0, 0, 1, 6
"d:\IDEWORK\lvmen\src\licensedcode\data\rules\boost-1.0_6.yml", "YAML", 0, 0, 0, 7, 0, 0, 1, 8
"d:\IDEWORK\lvmen\src\licensedcode\data\rules\boost-1.0_7.yml", "YAML", 0, 0, 0, 5, 0, 0, 1, 6
"d:\IDEWORK\lvmen\src\licensedcode\data\rules\boost-1.0_8.yml", "YAML", 0, 0, 0, 2, 0, 0, 1, 3
"d:\IDEWORK\lvmen\src\licensedcode\data\rules\boost-1.0_9.yml", "YAML", 0, 0, 0, 2, 0, 0, 1, 3
"d:\IDEWORK\lvmen\src\licensedcode\data\rules\boost-1.0_or_mit_1.yml", "YAML", 0, 0, 0, 5, 0, 0, 1, 6
"d:\IDEWORK\lvmen\src\licensedcode\data\rules\boost-1.0_or_mit_2.yml", "YAML", 0, 0, 0, 4, 0, 0, 1, 5
"d:\IDEWORK\lvmen\src\licensedcode\data\rules\boost-1.0_url_1.yml", "YAML", 0, 0, 0, 5, 0, 0, 1, 6
"d:\IDEWORK\lvmen\src\licensedcode\data\rules\boost-1.0_url_2.yml", "YAML", 0, 0, 0, 5, 0, 0, 1, 6
"d:\IDEWORK\lvmen\src\licensedcode\data\rules\boost-1.0_url_glc_148.yml", "YAML", 0, 0, 0, 5, 0, 0, 1, 6
"d:\IDEWORK\lvmen\src\licensedcode\data\rules\boost-1.0_url_glc_149.yml", "YAML", 0, 0, 0, 5, 0, 0, 1, 6
"d:\IDEWORK\lvmen\src\licensedcode\data\rules\boost-original.yml", "YAML", 0, 0, 0, 4, 0, 0, 1, 5
"d:\IDEWORK\lvmen\src\licensedcode\data\rules\boost-original_1.yml", "YAML", 0, 0, 0, 3, 0, 0, 1, 4
"d:\IDEWORK\lvmen\src\licensedcode\data\rules\boost-original_2.yml", "YAML", 0, 0, 0, 4, 0, 0, 1, 5
"d:\IDEWORK\lvmen\src\licensedcode\data\rules\bootloader-exception_url_1.yml", "YAML", 0, 0, 0, 5, 0, 0, 1, 6
"d:\IDEWORK\lvmen\src\licensedcode\data\rules\bootloader-exception_url_2.yml", "YAML", 0, 0, 0, 5, 0, 0, 1, 6
"d:\IDEWORK\lvmen\src\licensedcode\data\rules\borceux_url_1.yml", "YAML", 0, 0, 0, 5, 0, 0, 1, 6
"d:\IDEWORK\lvmen\src\licensedcode\data\rules\borceux_url_2.yml", "YAML", 0, 0, 0, 5, 0, 0, 1, 6
"d:\IDEWORK\lvmen\src\licensedcode\data\rules\bpel4ws-spec.yml", "YAML", 0, 0, 0, 2, 0, 0, 1, 3
"d:\IDEWORK\lvmen\src\licensedcode\data\rules\bpel4ws-spec2.yml", "YAML", 0, 0, 0, 2, 0, 0, 1, 3
"d:\IDEWORK\lvmen\src\licensedcode\data\rules\bpmn-io_1.yml", "YAML", 0, 0, 0, 5, 0, 0, 1, 6
"d:\IDEWORK\lvmen\src\licensedcode\data\rules\brian-clapper.yml", "YAML", 0, 0, 0, 6, 0, 0, 1, 7
"d:\IDEWORK\lvmen\src\licensedcode\data\rules\brian-gladman-3-clause.yml", "YAML", 0, 0, 0, 3, 0, 0, 1, 4
"d:\IDEWORK\lvmen\src\licensedcode\data\rules\brian-gladman-3-clause_1.yml", "YAML", 0, 0, 0, 5, 0, 0, 1, 6
"d:\IDEWORK\lvmen\src\licensedcode\data\rules\brian-gladman-3-clause_2.yml", "YAML", 0, 0, 0, 3, 0, 0, 1, 4
"d:\IDEWORK\lvmen\src\licensedcode\data\rules\brian-gladman-3-clause_3.yml", "YAML", 0, 0, 0, 3, 0, 0, 1, 4
"d:\IDEWORK\lvmen\src\licensedcode\data\rules\brian-gladman-3-clause_4.yml", "YAML", 0, 0, 0, 3, 0, 0, 1, 4
"d:\IDEWORK\lvmen\src\licensedcode\data\rules\brian-gladman-3-clause_5.yml", "YAML", 0, 0, 0, 3, 0, 0, 1, 4
"d:\IDEWORK\lvmen\src\licensedcode\data\rules\brian-gladman-3-clause_6.yml", "YAML", 0, 0, 0, 3, 0, 0, 1, 4
"d:\IDEWORK\lvmen\src\licensedcode\data\rules\brian-gladman-3-clause_7.yml", "YAML", 0, 0, 0, 3, 0, 0, 1, 4
"d:\IDEWORK\lvmen\src\licensedcode\data\rules\brian-gladman-3-clause_8.yml", "YAML", 0, 0, 0, 3, 0, 0, 1, 4
"d:\IDEWORK\lvmen\src\licensedcode\data\rules\brian-gladman-3-clause_9.yml", "YAML", 0, 0, 0, 3, 0, 0, 1, 4
"d:\IDEWORK\lvmen\src\licensedcode\data\rules\brian-gladman-3-clause_or_gpl-1.0-plus_1.yml", "YAML", 0, 0, 0, 2, 0, 0, 1, 3
"d:\IDEWORK\lvmen\src\licensedcode\data\rules\brian-gladman-3-clause_or_gpl-1.0-plus_2.yml", "YAML", 0, 0, 0, 2, 0, 0, 1, 3
"d:\IDEWORK\lvmen\src\licensedcode\data\rules\brian-gladman-3-clause_or_gpl-1.0-plus_3.yml", "YAML", 0, 0, 0, 3, 0, 0, 1, 4
"d:\IDEWORK\lvmen\src\licensedcode\data\rules\brian-gladman-3-clause_or_gpl-2.0-plus_1.yml", "YAML", 0, 0, 0, 4, 0, 0, 1, 5
"d:\IDEWORK\lvmen\src\licensedcode\data\rules\brian-gladman-3-clause_or_gpl-2.0-plus_2.yml", "YAML", 0, 0, 0, 4, 0, 0, 1, 5
"d:\IDEWORK\lvmen\src\licensedcode\data\rules\brian-gladman-3-clause_or_gpl-2.0-plus_3.yml", "YAML", 0, 0, 0, 5, 0, 0, 1, 6
"d:\IDEWORK\lvmen\src\licensedcode\data\rules\brian-gladman.yml", "YAML", 0, 0, 0, 5, 0, 0, 1, 6
"d:\IDEWORK\lvmen\src\licensedcode\data\rules\brian-gladman_1.yml", "YAML", 0, 0, 0, 5, 0, 0, 1, 6
"d:\IDEWORK\lvmen\src\licensedcode\data\rules\broadcom-cfe_1.yml", "YAML", 0, 0, 0, 2, 0, 0, 1, 3
"d:\IDEWORK\lvmen\src\licensedcode\data\rules\broadcom-confidential_1.yml", "YAML", 0, 0, 0, 2, 0, 0, 1, 3
"d:\IDEWORK\lvmen\src\licensedcode\data\rules\broadcom-confidential_2.yml", "YAML", 0, 0, 0, 2, 0, 0, 1, 3
"d:\IDEWORK\lvmen\src\licensedcode\data\rules\broadcom-proprietary.yml", "YAML", 0, 0, 0, 15, 0, 0, 1, 16
"d:\IDEWORK\lvmen\src\licensedcode\data\rules\broadcom-proprietary_1.yml", "YAML", 0, 0, 0, 2, 0, 0, 1, 3
"d:\IDEWORK\lvmen\src\licensedcode\data\rules\broadcom-standard-terms_1.yml", "YAML", 0, 0, 0, 2, 0, 0, 1, 3
"d:\IDEWORK\lvmen\src\licensedcode\data\rules\broadcom-standard-terms_2.yml", "YAML", 0, 0, 0, 2, 0, 0, 1, 3
"d:\IDEWORK\lvmen\src\licensedcode\data\rules\broadcom-standard-terms_3.yml", "YAML", 0, 0, 0, 2, 0, 0, 1, 3
"d:\IDEWORK\lvmen\src\licensedcode\data\rules\bsd-1-clause.yml", "YAML", 0, 0, 0, 3, 0, 0, 1, 4
"d:\IDEWORK\lvmen\src\licensedcode\data\rules\bsd-1-clause2.yml", "YAML", 0, 0, 0, 3, 0, 0, 1, 4
"d:\IDEWORK\lvmen\src\licensedcode\data\rules\bsd-1-clause3.yml", "YAML", 0, 0, 0, 3, 0, 0, 1, 4
"d:\IDEWORK\lvmen\src\licensedcode\data\rules\bsd-1-clause4.yml", "YAML", 0, 0, 0, 3, 0, 0, 1, 4
"d:\IDEWORK\lvmen\src\licensedcode\data\rules\bsd-1-clause_1.yml", "YAML", 0, 0, 0, 3, 0, 0, 1, 4
"d:\IDEWORK\lvmen\src\licensedcode\data\rules\bsd-1-clause_2.yml", "YAML", 0, 0, 0, 3, 0, 0, 1, 4
"d:\IDEWORK\lvmen\src\licensedcode\data\rules\bsd-1-clause_3.yml", "YAML", 0, 0, 0, 3, 0, 0, 1, 4
"d:\IDEWORK\lvmen\src\licensedcode\data\rules\bsd-1-clause_4.yml", "YAML", 0, 0, 0, 2, 0, 0, 1, 3
"d:\IDEWORK\lvmen\src\licensedcode\data\rules\bsd-1-clause_url_1.yml", "YAML", 0, 0, 0, 5, 0, 0, 1, 6
"d:\IDEWORK\lvmen\src\licensedcode\data\rules\bsd-1-clause_url_2.yml", "YAML", 0, 0, 0, 5, 0, 0, 1, 6
"d:\IDEWORK\lvmen\src\licensedcode\data\rules\bsd-2-clause-freebsd.SPDX.yml", "YAML", 0, 0, 0, 4, 0, 0, 1, 5
"d:\IDEWORK\lvmen\src\licensedcode\data\rules\bsd-2-clause-freebsd.yml", "YAML", 0, 0, 0, 5, 0, 0, 1, 6
"d:\IDEWORK\lvmen\src\licensedcode\data\rules\bsd-2-clause-freebsd_1.yml", "YAML", 0, 0, 0, 3, 0, 0, 1, 4
"d:\IDEWORK\lvmen\src\licensedcode\data\rules\bsd-2-clause-freebsd_10.yml", "YAML", 0, 0, 0, 3, 0, 0, 1, 4
"d:\IDEWORK\lvmen\src\licensedcode\data\rules\bsd-2-clause-freebsd_11.yml", "YAML", 0, 0, 0, 3, 0, 0, 1, 4
"d:\IDEWORK\lvmen\src\licensedcode\data\rules\bsd-2-clause-freebsd_12.yml", "YAML", 0, 0, 0, 5, 0, 0, 1, 6
"d:\IDEWORK\lvmen\src\licensedcode\data\rules\bsd-2-clause-freebsd_13.yml", "YAML", 0, 0, 0, 3, 0, 0, 1, 4
"d:\IDEWORK\lvmen\src\licensedcode\data\rules\bsd-2-clause-freebsd_2.yml", "YAML", 0, 0, 0, 2, 0, 0, 1, 3
"d:\IDEWORK\lvmen\src\licensedcode\data\rules\bsd-2-clause-freebsd_3.yml", "YAML", 0, 0, 0, 3, 0, 0, 1, 4
"d:\IDEWORK\lvmen\src\licensedcode\data\rules\bsd-2-clause-freebsd_4.yml", "YAML", 0, 0, 0, 5, 0, 0, 1, 6
"d:\IDEWORK\lvmen\src\licensedcode\data\rules\bsd-2-clause-freebsd_5.yml", "YAML", 0, 0, 0, 4, 0, 0, 1, 5
"d:\IDEWORK\lvmen\src\licensedcode\data\rules\bsd-2-clause-freebsd_6.yml", "YAML", 0, 0, 0, 3, 0, 0, 1, 4
"d:\IDEWORK\lvmen\src\licensedcode\data\rules\bsd-2-clause-freebsd_7.yml", "YAML", 0, 0, 0, 3, 0, 0, 1, 4
"d:\IDEWORK\lvmen\src\licensedcode\data\rules\bsd-2-clause-freebsd_8.yml", "YAML", 0, 0, 0, 2, 0, 0, 1, 3
"d:\IDEWORK\lvmen\src\licensedcode\data\rules\bsd-2-clause-freebsd_9.yml", "YAML", 0, 0, 0, 2, 0, 0, 1, 3
"d:\IDEWORK\lvmen\src\licensedcode\data\rules\bsd-2-clause-freebsd_nuget_url_1.yml", "YAML", 0, 0, 0, 5, 0, 0, 1, 6
"d:\IDEWORK\lvmen\src\licensedcode\data\rules\bsd-2-clause-freebsd_or_gpl-2.0.yml", "YAML", 0, 0, 0, 2, 0, 0, 1, 3
"d:\IDEWORK\lvmen\src\licensedcode\data\rules\bsd-2-clause-freebsd_url_1.yml", "YAML", 0, 0, 0, 5, 0, 0, 1, 6
"d:\IDEWORK\lvmen\src\licensedcode\data\rules\bsd-2-clause-freebsd_url_2.yml", "YAML", 0, 0, 0, 5, 0, 0, 1, 6
"d:\IDEWORK\lvmen\src\licensedcode\data\rules\bsd-2-clause-freebsd_url_badge.yml", "YAML", 0, 0, 0, 5, 0, 0, 1, 6
"d:\IDEWORK\lvmen\src\licensedcode\data\rules\bsd-2-clause-netbsd_url_1.yml", "YAML", 0, 0, 0, 5, 0, 0, 1, 6
"d:\IDEWORK\lvmen\src\licensedcode\data\rules\bsd-2-clause-netbsd_url_2.yml", "YAML", 0, 0, 0, 5, 0, 0, 1, 6
"d:\IDEWORK\lvmen\src\licensedcode\data\rules\bsd-2-clause-plus-advertizing_1.yml", "YAML", 0, 0, 0, 4, 0, 0, 1, 5
"d:\IDEWORK\lvmen\src\licensedcode\data\rules\bsd-2-clause-plus-advertizing_2.yml", "YAML", 0, 0, 0, 4, 0, 0, 1, 5
"d:\IDEWORK\lvmen\src\licensedcode\data\rules\bsd-2-clause-views_1.yml", "YAML", 0, 0, 0, 3, 0, 0, 1, 4
"d:\IDEWORK\lvmen\src\licensedcode\data\rules\bsd-2-clause-views_10.yml", "YAML", 0, 0, 0, 3, 0, 0, 1, 4
"d:\IDEWORK\lvmen\src\licensedcode\data\rules\bsd-2-clause-views_11.yml", "YAML", 0, 0, 0, 3, 0, 0, 1, 4
"d:\IDEWORK\lvmen\src\licensedcode\data\rules\bsd-2-clause-views_12.yml", "YAML", 0, 0, 0, 2, 0, 0, 1, 3
"d:\IDEWORK\lvmen\src\licensedcode\data\rules\bsd-2-clause-views_13.yml", "YAML", 0, 0, 0, 3, 0, 0, 1, 4
"d:\IDEWORK\lvmen\src\licensedcode\data\rules\bsd-2-clause-views_14.yml", "YAML", 0, 0, 0, 3, 0, 0, 1, 4
"d:\IDEWORK\lvmen\src\licensedcode\data\rules\bsd-2-clause-views_15.yml", "YAML", 0, 0, 0, 4, 0, 0, 1, 5
"d:\IDEWORK\lvmen\src\licensedcode\data\rules\bsd-2-clause-views_16.yml", "YAML", 0, 0, 0, 4, 0, 0, 1, 5
"d:\IDEWORK\lvmen\src\licensedcode\data\rules\bsd-2-clause-views_164.yml", "YAML", 0, 0, 0, 3, 0, 0, 1, 4
"d:\IDEWORK\lvmen\src\licensedcode\data\rules\bsd-2-clause-views_17.yml", "YAML", 0, 0, 0, 5, 0, 0, 1, 6
"d:\IDEWORK\lvmen\src\licensedcode\data\rules\bsd-2-clause-views_18.yml", "YAML", 0, 0, 0, 5, 0, 0, 1, 6
"d:\IDEWORK\lvmen\src\licensedcode\data\rules\bsd-2-clause-views_19.yml", "YAML", 0, 0, 0, 5, 0, 0, 1, 6
"d:\IDEWORK\lvmen\src\licensedcode\data\rules\bsd-2-clause-views_2.yml", "YAML", 0, 0, 0, 3, 0, 0, 1, 4
"d:\IDEWORK\lvmen\src\licensedcode\data\rules\bsd-2-clause-views_20.yml", "YAML", 0, 0, 0, 5, 0, 0, 1, 6
"d:\IDEWORK\lvmen\src\licensedcode\data\rules\bsd-2-clause-views_21.yml", "YAML", 0, 0, 0, 5, 0, 0, 1, 6
"d:\IDEWORK\lvmen\src\licensedcode\data\rules\bsd-2-clause-views_22.yml", "YAML", 0, 0, 0, 5, 0, 0, 1, 6
"d:\IDEWORK\lvmen\src\licensedcode\data\rules\bsd-2-clause-views_23.yml", "YAML", 0, 0, 0, 5, 0, 0, 1, 6
"d:\IDEWORK\lvmen\src\licensedcode\data\rules\bsd-2-clause-views_24.yml", "YAML", 0, 0, 0, 6, 0, 0, 1, 7
"d:\IDEWORK\lvmen\src\licensedcode\data\rules\bsd-2-clause-views_25.yml", "YAML", 0, 0, 0, 6, 0, 0, 1, 7
"d:\IDEWORK\lvmen\src\licensedcode\data\rules\bsd-2-clause-views_26.yml", "YAML", 0, 0, 0, 6, 0, 0, 1, 7
"d:\IDEWORK\lvmen\src\licensedcode\data\rules\bsd-2-clause-views_27.yml", "YAML", 0, 0, 0, 4, 0, 0, 1, 5
"d:\IDEWORK\lvmen\src\licensedcode\data\rules\bsd-2-clause-views_28.yml", "YAML", 0, 0, 0, 5, 0, 0, 1, 6
"d:\IDEWORK\lvmen\src\licensedcode\data\rules\bsd-2-clause-views_29.yml", "YAML", 0, 0, 0, 4, 0, 0, 1, 5
"d:\IDEWORK\lvmen\src\licensedcode\data\rules\bsd-2-clause-views_3.yml", "YAML", 0, 0, 0, 3, 0, 0, 1, 4
"d:\IDEWORK\lvmen\src\licensedcode\data\rules\bsd-2-clause-views_30.yml", "YAML", 0, 0, 0, 4, 0, 0, 1, 5
"d:\IDEWORK\lvmen\src\licensedcode\data\rules\bsd-2-clause-views_31.yml", "YAML", 0, 0, 0, 5, 0, 0, 1, 6
"d:\IDEWORK\lvmen\src\licensedcode\data\rules\bsd-2-clause-views_32.yml", "YAML", 0, 0, 0, 5, 0, 0, 1, 6
"d:\IDEWORK\lvmen\src\licensedcode\data\rules\bsd-2-clause-views_33.yml", "YAML", 0, 0, 0, 4, 0, 0, 1, 5
"d:\IDEWORK\lvmen\src\licensedcode\data\rules\bsd-2-clause-views_34.yml", "YAML", 0, 0, 0, 5, 0, 0, 1, 6
"d:\IDEWORK\lvmen\src\licensedcode\data\rules\bsd-2-clause-views_35.yml", "YAML", 0, 0, 0, 6, 0, 0, 1, 7
"d:\IDEWORK\lvmen\src\licensedcode\data\rules\bsd-2-clause-views_36.yml", "YAML", 0, 0, 0, 5, 0, 0, 1, 6
"d:\IDEWORK\lvmen\src\licensedcode\data\rules\bsd-2-clause-views_37.yml", "YAML", 0, 0, 0, 4, 0, 0, 1, 5
"d:\IDEWORK\lvmen\src\licensedcode\data\rules\bsd-2-clause-views_38.yml", "YAML", 0, 0, 0, 7, 0, 0, 1, 8
"d:\IDEWORK\lvmen\src\licensedcode\data\rules\bsd-2-clause-views_39.yml", "YAML", 0, 0, 0, 6, 0, 0, 1, 7
"d:\IDEWORK\lvmen\src\licensedcode\data\rules\bsd-2-clause-views_4.yml", "YAML", 0, 0, 0, 3, 0, 0, 1, 4
"d:\IDEWORK\lvmen\src\licensedcode\data\rules\bsd-2-clause-views_40.yml", "YAML", 0, 0, 0, 6, 0, 0, 1, 7
"d:\IDEWORK\lvmen\src\licensedcode\data\rules\bsd-2-clause-views_41.yml", "YAML", 0, 0, 0, 6, 0, 0, 1, 7
"d:\IDEWORK\lvmen\src\licensedcode\data\rules\bsd-2-clause-views_42.yml", "YAML", 0, 0, 0, 5, 0, 0, 1, 6
"d:\IDEWORK\lvmen\src\licensedcode\data\rules\bsd-2-clause-views_43.yml", "YAML", 0, 0, 0, 5, 0, 0, 1, 6
"d:\IDEWORK\lvmen\src\licensedcode\data\rules\bsd-2-clause-views_44.yml", "YAML", 0, 0, 0, 5, 0, 0, 1, 6
"d:\IDEWORK\lvmen\src\licensedcode\data\rules\bsd-2-clause-views_45.yml", "YAML", 0, 0, 0, 5, 0, 0, 1, 6
"d:\IDEWORK\lvmen\src\licensedcode\data\rules\bsd-2-clause-views_46.yml", "YAML", 0, 0, 0, 5, 0, 0, 1, 6
"d:\IDEWORK\lvmen\src\licensedcode\data\rules\bsd-2-clause-views_47.yml", "YAML", 0, 0, 0, 5, 0, 0, 1, 6
"d:\IDEWORK\lvmen\src\licensedcode\data\rules\bsd-2-clause-views_48.yml", "YAML", 0, 0, 0, 5, 0, 0, 1, 6
"d:\IDEWORK\lvmen\src\licensedcode\data\rules\bsd-2-clause-views_49.yml", "YAML", 0, 0, 0, 3, 0, 0, 1, 4
"d:\IDEWORK\lvmen\src\licensedcode\data\rules\bsd-2-clause-views_5.yml", "YAML", 0, 0, 0, 3, 0, 0, 1, 4
"d:\IDEWORK\lvmen\src\licensedcode\data\rules\bsd-2-clause-views_50.yml", "YAML", 0, 0, 0, 3, 0, 0, 1, 4
"d:\IDEWORK\lvmen\src\licensedcode\data\rules\bsd-2-clause-views_51.yml", "YAML", 0, 0, 0, 5, 0, 0, 1, 6
"d:\IDEWORK\lvmen\src\licensedcode\data\rules\bsd-2-clause-views_52.yml", "YAML", 0, 0, 0, 4, 0, 0, 1, 5
"d:\IDEWORK\lvmen\src\licensedcode\data\rules\bsd-2-clause-views_53.yml", "YAML", 0, 0, 0, 5, 0, 0, 1, 6
"d:\IDEWORK\lvmen\src\licensedcode\data\rules\bsd-2-clause-views_54.yml", "YAML", 0, 0, 0, 3, 0, 0, 1, 4
"d:\IDEWORK\lvmen\src\licensedcode\data\rules\bsd-2-clause-views_55.yml", "YAML", 0, 0, 0, 3, 0, 0, 1, 4
"d:\IDEWORK\lvmen\src\licensedcode\data\rules\bsd-2-clause-views_56.yml", "YAML", 0, 0, 0, 5, 0, 0, 1, 6
"d:\IDEWORK\lvmen\src\licensedcode\data\rules\bsd-2-clause-views_57.yml", "YAML", 0, 0, 0, 5, 0, 0, 1, 6
"d:\IDEWORK\lvmen\src\licensedcode\data\rules\bsd-2-clause-views_58.yml", "YAML", 0, 0, 0, 2, 0, 0, 1, 3
"d:\IDEWORK\lvmen\src\licensedcode\data\rules\bsd-2-clause-views_6.yml", "YAML", 0, 0, 0, 3, 0, 0, 1, 4
"d:\IDEWORK\lvmen\src\licensedcode\data\rules\bsd-2-clause-views_7.yml", "YAML", 0, 0, 0, 3, 0, 0, 1, 4
"d:\IDEWORK\lvmen\src\licensedcode\data\rules\bsd-2-clause-views_8.yml", "YAML", 0, 0, 0, 3, 0, 0, 1, 4
"d:\IDEWORK\lvmen\src\licensedcode\data\rules\bsd-2-clause-views_9.yml", "YAML", 0, 0, 0, 3, 0, 0, 1, 4
"d:\IDEWORK\lvmen\src\licensedcode\data\rules\bsd-2-clause-views_alac_1.yml", "YAML", 0, 0, 0, 3, 0, 0, 1, 4
"d:\IDEWORK\lvmen\src\licensedcode\data\rules\bsd-2-clause-views_and_bsd-simplified_1.yml", "YAML", 0, 0, 0, 5, 0, 0, 1, 6
"d:\IDEWORK\lvmen\src\licensedcode\data\rules\bsd-3-clause-jtag_1.yml", "YAML", 0, 0, 0, 5, 0, 0, 1, 6
"d:\IDEWORK\lvmen\src\licensedcode\data\rules\bsd-3-clause-jtag_2.yml", "YAML", 0, 0, 0, 4, 0, 0, 1, 5
"d:\IDEWORK\lvmen\src\licensedcode\data\rules\bsd-3-clause-no-nuclear-warranty_1.yml", "YAML", 0, 0, 0, 2, 0, 0, 1, 3
"d:\IDEWORK\lvmen\src\licensedcode\data\rules\bsd-3-clause-no-nuclear-warranty_2.yml", "YAML", 0, 0, 0, 3, 0, 0, 1, 4
"d:\IDEWORK\lvmen\src\licensedcode\data\rules\bsd-3-clause-no-nuclear-warranty_url_1.yml", "YAML", 0, 0, 0, 5, 0, 0, 1, 6
"d:\IDEWORK\lvmen\src\licensedcode\data\rules\bsd-3-clause-no-nuclear-warranty_url_2.yml", "YAML", 0, 0, 0, 5, 0, 0, 1, 6
"d:\IDEWORK\lvmen\src\licensedcode\data\rules\bsd-3-clause-open-mpi_url_1.yml", "YAML", 0, 0, 0, 5, 0, 0, 1, 6
"d:\IDEWORK\lvmen\src\licensedcode\data\rules\bsd-3-clause-open-mpi_url_2.yml", "YAML", 0, 0, 0, 5, 0, 0, 1, 6
"d:\IDEWORK\lvmen\src\licensedcode\data\rules\bsd-3-clause-sun_1.yml", "YAML", 0, 0, 0, 3, 0, 0, 1, 4
"d:\IDEWORK\lvmen\src\licensedcode\data\rules\bsd-3-clause-sun_2.yml", "YAML", 0, 0, 0, 3, 0, 0, 1, 4
"d:\IDEWORK\lvmen\src\licensedcode\data\rules\bsd-3-clause-sun_3.yml", "YAML", 0, 0, 0, 4, 0, 0, 1, 5
"d:\IDEWORK\lvmen\src\licensedcode\data\rules\bsd-4-clause-shortened_1.yml", "YAML", 0, 0, 0, 8, 0, 0, 2, 10
"d:\IDEWORK\lvmen\src\licensedcode\data\rules\bsd-4-clause-shortened_2.yml", "YAML", 0, 0, 0, 3, 0, 0, 1, 4
"d:\IDEWORK\lvmen\src\licensedcode\data\rules\bsd-ack_url_1.yml", "YAML", 0, 0, 0, 5, 0, 0, 1, 6
"d:\IDEWORK\lvmen\src\licensedcode\data\rules\bsd-ack_url_2.yml", "YAML", 0, 0, 0, 5, 0, 0, 1, 6
"d:\IDEWORK\lvmen\src\licensedcode\data\rules\bsd-artwork_1.yml", "YAML", 0, 0, 0, 3, 0, 0, 1, 4
"d:\IDEWORK\lvmen\src\licensedcode\data\rules\bsd-atmel_1.yml", "YAML", 0, 0, 0, 3, 0, 0, 1, 4
"d:\IDEWORK\lvmen\src\licensedcode\data\rules\bsd-axis-nomod_or_gpl-2.0-plus.yml", "YAML", 0, 0, 0, 2, 0, 0, 1, 3
"d:\IDEWORK\lvmen\src\licensedcode\data\rules\bsd-axis-nomod_or_gpl.yml", "YAML", 0, 0, 0, 3, 0, 0, 1, 4
"d:\IDEWORK\lvmen\src\licensedcode\data\rules\bsd-axis-nomod_or_gpl2.yml", "YAML", 0, 0, 0, 2, 0, 0, 1, 3
"d:\IDEWORK\lvmen\src\licensedcode\data\rules\bsd-axis-nomod_or_gpl3.yml", "YAML", 0, 0, 0, 2, 0, 0, 1, 3
"d:\IDEWORK\lvmen\src\licensedcode\data\rules\bsd-axis-nomod_or_gpl4.yml", "YAML", 0, 0, 0, 2, 0, 0, 1, 3
"d:\IDEWORK\lvmen\src\licensedcode\data\rules\bsd-axis_1.yml", "YAML", 0, 0, 0, 2, 0, 0, 1, 3
"d:\IDEWORK\lvmen\src\licensedcode\data\rules\bsd-axis_11.yml", "YAML", 0, 0, 0, 2, 0, 0, 1, 3
"d:\IDEWORK\lvmen\src\licensedcode\data\rules\bsd-axis_12.yml", "YAML", 0, 0, 0, 3, 0, 0, 1, 4
"d:\IDEWORK\lvmen\src\licensedcode\data\rules\bsd-axis_13.yml", "YAML", 0, 0, 0, 3, 0, 0, 1, 4
"d:\IDEWORK\lvmen\src\licensedcode\data\rules\bsd-axis_14.yml", "YAML", 0, 0, 0, 3, 0, 0, 1, 4
"d:\IDEWORK\lvmen\src\licensedcode\data\rules\bsd-axis_15.yml", "YAML", 0, 0, 0, 3, 0, 0, 1, 4
"d:\IDEWORK\lvmen\src\licensedcode\data\rules\bsd-axis_2.yml", "YAML", 0, 0, 0, 2, 0, 0, 1, 3
"d:\IDEWORK\lvmen\src\licensedcode\data\rules\bsd-axis_3.yml", "YAML", 0, 0, 0, 2, 0, 0, 1, 3
"d:\IDEWORK\lvmen\src\licensedcode\data\rules\bsd-axis_4.yml", "YAML", 0, 0, 0, 4, 0, 0, 1, 5
"d:\IDEWORK\lvmen\src\licensedcode\data\rules\bsd-axis_5.yml", "YAML", 0, 0, 0, 3, 0, 0, 1, 4
"d:\IDEWORK\lvmen\src\licensedcode\data\rules\bsd-axis_6.yml", "YAML", 0, 0, 0, 3, 0, 0, 1, 4
"d:\IDEWORK\lvmen\src\licensedcode\data\rules\bsd-axis_7.yml", "YAML", 0, 0, 0, 3, 0, 0, 1, 4
"d:\IDEWORK\lvmen\src\licensedcode\data\rules\bsd-axis_8.yml", "YAML", 0, 0, 0, 6, 0, 0, 1, 7
"d:\IDEWORK\lvmen\src\licensedcode\data\rules\bsd-axis_9.yml", "YAML", 0, 0, 0, 3, 0, 0, 1, 4
"d:\IDEWORK\lvmen\src\licensedcode\data\rules\bsd-dpt.yml", "YAML", 0, 0, 0, 3, 0, 0, 1, 4
"d:\IDEWORK\lvmen\src\licensedcode\data\rules\bsd-dpt_1.yml", "YAML", 0, 0, 0, 3, 0, 0, 1, 4
"d:\IDEWORK\lvmen\src\licensedcode\data\rules\bsd-export.yml", "YAML", 0, 0, 0, 2, 0, 0, 1, 3
"d:\IDEWORK\lvmen\src\licensedcode\data\rules\bsd-export_cavium.yml", "YAML", 0, 0, 0, 2, 0, 0, 1, 3
"d:\IDEWORK\lvmen\src\licensedcode\data\rules\bsd-export_cavium2.yml", "YAML", 0, 0, 0, 2, 0, 0, 1, 3
"d:\IDEWORK\lvmen\src\licensedcode\data\rules\bsd-innosys.yml", "YAML", 0, 0, 0, 4, 0, 0, 1, 5
"d:\IDEWORK\lvmen\src\licensedcode\data\rules\bsd-innosys2.yml", "YAML", 0, 0, 0, 3, 0, 0, 1, 4
"d:\IDEWORK\lvmen\src\licensedcode\data\rules\bsd-innosys3.yml", "YAML", 0, 0, 0, 3, 0, 0, 1, 4
"d:\IDEWORK\lvmen\src\licensedcode\data\rules\bsd-innosys4.yml", "YAML", 0, 0, 0, 3, 0, 0, 1, 4
"d:\IDEWORK\lvmen\src\licensedcode\data\rules\bsd-innosys5.yml", "YAML", 0, 0, 0, 3, 0, 0, 1, 4
"d:\IDEWORK\lvmen\src\licensedcode\data\rules\bsd-intel_1.yml", "YAML", 0, 0, 0, 2, 0, 0, 1, 3
"d:\IDEWORK\lvmen\src\licensedcode\data\rules\bsd-intel_2.yml", "YAML", 0, 0, 0, 2, 0, 0, 1, 3
"d:\IDEWORK\lvmen\src\licensedcode\data\rules\bsd-intel_3.yml", "YAML", 0, 0, 0, 2, 0, 0, 1, 3
"d:\IDEWORK\lvmen\src\licensedcode\data\rules\bsd-intel_4.yml", "YAML", 0, 0, 0, 2, 0, 0, 1, 3
"d:\IDEWORK\lvmen\src\licensedcode\data\rules\bsd-intel_5.yml", "YAML", 0, 0, 0, 2, 0, 0, 1, 3
"d:\IDEWORK\lvmen\src\licensedcode\data\rules\bsd-intel_6.yml", "YAML", 0, 0, 0, 2, 0, 0, 1, 3
"d:\IDEWORK\lvmen\src\licensedcode\data\rules\bsd-new-derivative_1.yml", "YAML", 0, 0, 0, 2, 0, 0, 1, 3
"d:\IDEWORK\lvmen\src\licensedcode\data\rules\bsd-new-link.yml", "YAML", 0, 0, 0, 4, 0, 0, 1, 5
"d:\IDEWORK\lvmen\src\licensedcode\data\rules\bsd-new-link2.yml", "YAML", 0, 0, 0, 4, 0, 0, 1, 5
"d:\IDEWORK\lvmen\src\licensedcode\data\rules\bsd-new-nomod_1.yml", "YAML", 0, 0, 0, 3, 0, 0, 1, 4
"d:\IDEWORK\lvmen\src\licensedcode\data\rules\bsd-new-nomod_or_gpl-2.0-plus_2.yml", "YAML", 0, 0, 0, 3, 0, 0, 1, 4
"d:\IDEWORK\lvmen\src\licensedcode\data\rules\bsd-new-nomod_or_gpl-2.0-plus_4.yml", "YAML", 0, 0, 0, 3, 0, 0, 1, 4
"d:\IDEWORK\lvmen\src\licensedcode\data\rules\bsd-new-nomod_or_gpl-2.0.yml", "YAML", 0, 0, 0, 5, 0, 0, 1, 6
"d:\IDEWORK\lvmen\src\licensedcode\data\rules\bsd-new-nomod_or_gpl-2.0_8.yml", "YAML", 0, 0, 0, 3, 0, 0, 1, 4
"d:\IDEWORK\lvmen\src\licensedcode\data\rules\bsd-new-oracle-glassfish.yml", "YAML", 0, 0, 0, 2, 0, 0, 1, 3
"d:\IDEWORK\lvmen\src\licensedcode\data\rules\bsd-new-sun-glassfish.yml", "YAML", 0, 0, 0, 2, 0, 0, 1, 3
"d:\IDEWORK\lvmen\src\licensedcode\data\rules\bsd-new-tcpdump_1.yml", "YAML", 0, 0, 0, 4, 0, 0, 1, 5
"d:\IDEWORK\lvmen\src\licensedcode\data\rules\bsd-new-tcpdump_2.yml", "YAML", 0, 0, 0, 4, 0, 0, 1, 5
"d:\IDEWORK\lvmen\src\licensedcode\data\rules\bsd-new-tcpdump_3.yml", "YAML", 0, 0, 0, 3, 0, 0, 1, 4
"d:\IDEWORK\lvmen\src\licensedcode\data\rules\bsd-new.yml", "YAML", 0, 0, 0, 5, 0, 0, 1, 6
"d:\IDEWORK\lvmen\src\licensedcode\data\rules\bsd-new_0.yml", "YAML", 0, 0, 0, 3, 0, 0, 1, 4
"d:\IDEWORK\lvmen\src\licensedcode\data\rules\bsd-new_1.yml", "YAML", 0, 0, 0, 5, 0, 0, 1, 6
"d:\IDEWORK\lvmen\src\licensedcode\data\rules\bsd-new_10.yml", "YAML", 0, 0, 0, 3, 0, 0, 1, 4
"d:\IDEWORK\lvmen\src\licensedcode\data\rules\bsd-new_100.yml", "YAML", 0, 0, 0, 3, 0, 0, 2, 5
"d:\IDEWORK\lvmen\src\licensedcode\data\rules\bsd-new_1000.yml", "YAML", 0, 0, 0, 5, 0, 0, 1, 6
"d:\IDEWORK\lvmen\src\licensedcode\data\rules\bsd-new_1001.yml", "YAML", 0, 0, 0, 3, 0, 0, 1, 4
"d:\IDEWORK\lvmen\src\licensedcode\data\rules\bsd-new_1002.yml", "YAML", 0, 0, 0, 5, 0, 0, 1, 6
"d:\IDEWORK\lvmen\src\licensedcode\data\rules\bsd-new_1003.yml", "YAML", 0, 0, 0, 5, 0, 0, 1, 6
"d:\IDEWORK\lvmen\src\licensedcode\data\rules\bsd-new_1004.yml", "YAML", 0, 0, 0, 5, 0, 0, 1, 6
"d:\IDEWORK\lvmen\src\licensedcode\data\rules\bsd-new_1005.yml", "YAML", 0, 0, 0, 5, 0, 0, 1, 6
"d:\IDEWORK\lvmen\src\licensedcode\data\rules\bsd-new_1006.yml", "YAML", 0, 0, 0, 2, 0, 0, 1, 3
"d:\IDEWORK\lvmen\src\licensedcode\data\rules\bsd-new_1007.yml", "YAML", 0, 0, 0, 2, 0, 0, 1, 3
"d:\IDEWORK\lvmen\src\licensedcode\data\rules\bsd-new_1008.yml", "YAML", 0, 0, 0, 3, 0, 0, 1, 4
"d:\IDEWORK\lvmen\src\licensedcode\data\rules\bsd-new_1009.yml", "YAML", 0, 0, 0, 3, 0, 0, 1, 4
"d:\IDEWORK\lvmen\src\licensedcode\data\rules\bsd-new_101.yml", "YAML", 0, 0, 0, 7, 0, 0, 1, 8
"d:\IDEWORK\lvmen\src\licensedcode\data\rules\bsd-new_1010.yml", "YAML", 0, 0, 0, 3, 0, 0, 1, 4
"d:\IDEWORK\lvmen\src\licensedcode\data\rules\bsd-new_1011.yml", "YAML", 0, 0, 0, 3, 0, 0, 1, 4
"d:\IDEWORK\lvmen\src\licensedcode\data\rules\bsd-new_1012.yml", "YAML", 0, 0, 0, 4, 0, 0, 1, 5
"d:\IDEWORK\lvmen\src\licensedcode\data\rules\bsd-new_1013.yml", "YAML", 0, 0, 0, 4, 0, 0, 1, 5
"d:\IDEWORK\lvmen\src\licensedcode\data\rules\bsd-new_1014.yml", "YAML", 0, 0, 0, 3, 0, 0, 1, 4
"d:\IDEWORK\lvmen\src\licensedcode\data\rules\bsd-new_1015.yml", "YAML", 0, 0, 0, 4, 0, 0, 1, 5
"d:\IDEWORK\lvmen\src\licensedcode\data\rules\bsd-new_1016.yml", "YAML", 0, 0, 0, 3, 0, 0, 1, 4
"d:\IDEWORK\lvmen\src\licensedcode\data\rules\bsd-new_1017.yml", "YAML", 0, 0, 0, 3, 0, 0, 1, 4
"d:\IDEWORK\lvmen\src\licensedcode\data\rules\bsd-new_1018.yml", "YAML", 0, 0, 0, 3, 0, 0, 1, 4
"d:\IDEWORK\lvmen\src\licensedcode\data\rules\bsd-new_1019.yml", "YAML", 0, 0, 0, 3, 0, 0, 1, 4
"d:\IDEWORK\lvmen\src\licensedcode\data\rules\bsd-new_102.yml", "YAML", 0, 0, 0, 2, 0, 0, 1, 3
"d:\IDEWORK\lvmen\src\licensedcode\data\rules\bsd-new_1020.yml", "YAML", 0, 0, 0, 5, 0, 0, 1, 6
"d:\IDEWORK\lvmen\src\licensedcode\data\rules\bsd-new_1021.yml", "YAML", 0, 0, 0, 3, 0, 0, 1, 4
"d:\IDEWORK\lvmen\src\licensedcode\data\rules\bsd-new_1022.yml", "YAML", 0, 0, 0, 3, 0, 0, 1, 4
"d:\IDEWORK\lvmen\src\licensedcode\data\rules\bsd-new_1023.yml", "YAML", 0, 0, 0, 3, 0, 0, 1, 4
"d:\IDEWORK\lvmen\src\licensedcode\data\rules\bsd-new_1024.yml", "YAML", 0, 0, 0, 3, 0, 0, 1, 4
"d:\IDEWORK\lvmen\src\licensedcode\data\rules\bsd-new_1025.yml", "YAML", 0, 0, 0, 3, 0, 0, 1, 4
"d:\IDEWORK\lvmen\src\licensedcode\data\rules\bsd-new_1026.yml", "YAML", 0, 0, 0, 5, 0, 0, 1, 6
"d:\IDEWORK\lvmen\src\licensedcode\data\rules\bsd-new_1027.yml", "YAML", 0, 0, 0, 3, 0, 0, 1, 4
"d:\IDEWORK\lvmen\src\licensedcode\data\rules\bsd-new_1028.yml", "YAML", 0, 0, 0, 3, 0, 0, 1, 4
"d:\IDEWORK\lvmen\src\licensedcode\data\rules\bsd-new_1029.yml", "YAML", 0, 0, 0, 5, 0, 0, 1, 6
"d:\IDEWORK\lvmen\src\licensedcode\data\rules\bsd-new_103.yml", "YAML", 0, 0, 0, 3, 0, 0, 1, 4
"d:\IDEWORK\lvmen\src\licensedcode\data\rules\bsd-new_1030.yml", "YAML", 0, 0, 0, 3, 0, 0, 1, 4
"d:\IDEWORK\lvmen\src\licensedcode\data\rules\bsd-new_1031.yml", "YAML", 0, 0, 0, 4, 0, 0, 1, 5
"d:\IDEWORK\lvmen\src\licensedcode\data\rules\bsd-new_1032.yml", "YAML", 0, 0, 0, 5, 0, 0, 1, 6
"d:\IDEWORK\lvmen\src\licensedcode\data\rules\bsd-new_1033.yml", "YAML", 0, 0, 0, 3, 0, 0, 1, 4
"d:\IDEWORK\lvmen\src\licensedcode\data\rules\bsd-new_1034.yml", "YAML", 0, 0, 0, 5, 0, 0, 1, 6
"d:\IDEWORK\lvmen\src\licensedcode\data\rules\bsd-new_1035.yml", "YAML", 0, 0, 0, 4, 0, 0, 1, 5
"d:\IDEWORK\lvmen\src\licensedcode\data\rules\bsd-new_1036.yml", "YAML", 0, 0, 0, 4, 0, 0, 1, 5
"d:\IDEWORK\lvmen\src\licensedcode\data\rules\bsd-new_1037.yml", "YAML", 0, 0, 0, 3, 0, 0, 1, 4
"d:\IDEWORK\lvmen\src\licensedcode\data\rules\bsd-new_1038.yml", "YAML", 0, 0, 0, 2, 0, 0, 1, 3
"d:\IDEWORK\lvmen\src\licensedcode\data\rules\bsd-new_1039.yml", "YAML", 0, 0, 0, 3, 0, 0, 1, 4
"d:\IDEWORK\lvmen\src\licensedcode\data\rules\bsd-new_104.yml", "YAML", 0, 0, 0, 2, 0, 0, 1, 3
"d:\IDEWORK\lvmen\src\licensedcode\data\rules\bsd-new_1040.yml", "YAML", 0, 0, 0, 2, 0, 0, 1, 3
"d:\IDEWORK\lvmen\src\licensedcode\data\rules\bsd-new_1041.yml", "YAML", 0, 0, 0, 2, 0, 0, 1, 3
"d:\IDEWORK\lvmen\src\licensedcode\data\rules\bsd-new_1042.yml", "YAML", 0, 0, 0, 2, 0, 0, 1, 3
"d:\IDEWORK\lvmen\src\licensedcode\data\rules\bsd-new_1043.yml", "YAML", 0, 0, 0, 4, 0, 0, 1, 5
"d:\IDEWORK\lvmen\src\licensedcode\data\rules\bsd-new_1044.yml", "YAML", 0, 0, 0, 3, 0, 0, 1, 4
"d:\IDEWORK\lvmen\src\licensedcode\data\rules\bsd-new_1045.yml", "YAML", 0, 0, 0, 5, 0, 0, 1, 6
"d:\IDEWORK\lvmen\src\licensedcode\data\rules\bsd-new_1046.yml", "YAML", 0, 0, 0, 2, 0, 0, 1, 3
"d:\IDEWORK\lvmen\src\licensedcode\data\rules\bsd-new_1047.yml", "YAML", 0, 0, 0, 2, 0, 0, 1, 3
"d:\IDEWORK\lvmen\src\licensedcode\data\rules\bsd-new_1048.yml", "YAML", 0, 0, 0, 2, 0, 0, 1, 3
"d:\IDEWORK\lvmen\src\licensedcode\data\rules\bsd-new_1049.yml", "YAML", 0, 0, 0, 2, 0, 0, 1, 3
"d:\IDEWORK\lvmen\src\licensedcode\data\rules\bsd-new_105.yml", "YAML", 0, 0, 0, 2, 0, 0, 1, 3
"d:\IDEWORK\lvmen\src\licensedcode\data\rules\bsd-new_1050.yml", "YAML", 0, 0, 0, 2, 0, 0, 1, 3
"d:\IDEWORK\lvmen\src\licensedcode\data\rules\bsd-new_1051.yml", "YAML", 0, 0, 0, 3, 0, 0, 1, 4
"d:\IDEWORK\lvmen\src\licensedcode\data\rules\bsd-new_1052.yml", "YAML", 0, 0, 0, 2, 0, 0, 1, 3
"d:\IDEWORK\lvmen\src\licensedcode\data\rules\bsd-new_1053.yml", "YAML", 0, 0, 0, 3, 0, 0, 1, 4
"d:\IDEWORK\lvmen\src\licensedcode\data\rules\bsd-new_1054.yml", "YAML", 0, 0, 0, 3, 0, 0, 1, 4
"d:\IDEWORK\lvmen\src\licensedcode\data\rules\bsd-new_1055.yml", "YAML", 0, 0, 0, 3, 0, 0, 1, 4
"d:\IDEWORK\lvmen\src\licensedcode\data\rules\bsd-new_1056.yml", "YAML", 0, 0, 0, 3, 0, 0, 1, 4
"d:\IDEWORK\lvmen\src\licensedcode\data\rules\bsd-new_1057.yml", "YAML", 0, 0, 0, 3, 0, 0, 1, 4
"d:\IDEWORK\lvmen\src\licensedcode\data\rules\bsd-new_1058.yml", "YAML", 0, 0, 0, 3, 0, 0, 1, 4
"d:\IDEWORK\lvmen\src\licensedcode\data\rules\bsd-new_1059.yml", "YAML", 0, 0, 0, 3, 0, 0, 1, 4
"d:\IDEWORK\lvmen\src\licensedcode\data\rules\bsd-new_106.yml", "YAML", 0, 0, 0, 4, 0, 0, 1, 5
"d:\IDEWORK\lvmen\src\licensedcode\data\rules\bsd-new_1060.yml", "YAML", 0, 0, 0, 4, 0, 0, 1, 5
"d:\IDEWORK\lvmen\src\licensedcode\data\rules\bsd-new_1061.yml", "YAML", 0, 0, 0, 3, 0, 0, 1, 4
"d:\IDEWORK\lvmen\src\licensedcode\data\rules\bsd-new_1062.yml", "YAML", 0, 0, 0, 3, 0, 0, 1, 4
"d:\IDEWORK\lvmen\src\licensedcode\data\rules\bsd-new_1063.yml", "YAML", 0, 0, 0, 2, 0, 0, 1, 3
"d:\IDEWORK\lvmen\src\licensedcode\data\rules\bsd-new_1064.yml", "YAML", 0, 0, 0, 2, 0, 0, 1, 3
"d:\IDEWORK\lvmen\src\licensedcode\data\rules\bsd-new_1065.yml", "YAML", 0, 0, 0, 3, 0, 0, 1, 4
"d:\IDEWORK\lvmen\src\licensedcode\data\rules\bsd-new_1066.yml", "YAML", 0, 0, 0, 2, 0, 0, 1, 3
"d:\IDEWORK\lvmen\src\licensedcode\data\rules\bsd-new_1067.yml", "YAML", 0, 0, 0, 2, 0, 0, 1, 3
"d:\IDEWORK\lvmen\src\licensedcode\data\rules\bsd-new_1068.yml", "YAML", 0, 0, 0, 2, 0, 0, 1, 3
"d:\IDEWORK\lvmen\src\licensedcode\data\rules\bsd-new_1069.yml", "YAML", 0, 0, 0, 2, 0, 0, 1, 3
"d:\IDEWORK\lvmen\src\licensedcode\data\rules\bsd-new_107.yml", "YAML", 0, 0, 0, 2, 0, 0, 1, 3
"d:\IDEWORK\lvmen\src\licensedcode\data\rules\bsd-new_1070.yml", "YAML", 0, 0, 0, 2, 0, 0, 1, 3
"d:\IDEWORK\lvmen\src\licensedcode\data\rules\bsd-new_1071.yml", "YAML", 0, 0, 0, 2, 0, 0, 1, 3
"d:\IDEWORK\lvmen\src\licensedcode\data\rules\bsd-new_1072.yml", "YAML", 0, 0, 0, 2, 0, 0, 1, 3
"d:\IDEWORK\lvmen\src\licensedcode\data\rules\bsd-new_1073.yml", "YAML", 0, 0, 0, 4, 0, 0, 1, 5
"d:\IDEWORK\lvmen\src\licensedcode\data\rules\bsd-new_1074.yml", "YAML", 0, 0, 0, 3, 0, 0, 1, 4
"d:\IDEWORK\lvmen\src\licensedcode\data\rules\bsd-new_108.yml", "YAML", 0, 0, 0, 5, 0, 0, 1, 6
"d:\IDEWORK\lvmen\src\licensedcode\data\rules\bsd-new_109.yml", "YAML", 0, 0, 0, 4, 0, 0, 1, 5
"d:\IDEWORK\lvmen\src\licensedcode\data\rules\bsd-new_11.yml", "YAML", 0, 0, 0, 3, 0, 0, 1, 4
"d:\IDEWORK\lvmen\src\licensedcode\data\rules\bsd-new_110.yml", "YAML", 0, 0, 0, 2, 0, 0, 1, 3
"d:\IDEWORK\lvmen\src\licensedcode\data\rules\bsd-new_111.yml", "YAML", 0, 0, 0, 4, 0, 0, 1, 5
"d:\IDEWORK\lvmen\src\licensedcode\data\rules\bsd-new_112.yml", "YAML", 0, 0, 0, 2, 0, 0, 1, 3
"d:\IDEWORK\lvmen\src\licensedcode\data\rules\bsd-new_113.yml", "YAML", 0, 0, 0, 2, 0, 0, 1, 3
"d:\IDEWORK\lvmen\src\licensedcode\data\rules\bsd-new_114.yml", "YAML", 0, 0, 0, 2, 0, 0, 1, 3
"d:\IDEWORK\lvmen\src\licensedcode\data\rules\bsd-new_114_2.yml", "YAML", 0, 0, 0, 2, 0, 0, 1, 3
"d:\IDEWORK\lvmen\src\licensedcode\data\rules\bsd-new_114_3.yml", "YAML", 0, 0, 0, 2, 0, 0, 1, 3
"d:\IDEWORK\lvmen\src\licensedcode\data\rules\bsd-new_114_4.yml", "YAML", 0, 0, 0, 2, 0, 0, 1, 3
"d:\IDEWORK\lvmen\src\licensedcode\data\rules\bsd-new_114_6.yml", "YAML", 0, 0, 0, 3, 0, 0, 2, 5
"d:\IDEWORK\lvmen\src\licensedcode\data\rules\bsd-new_115.yml", "YAML", 0, 0, 0, 2, 0, 0, 1, 3
"d:\IDEWORK\lvmen\src\licensedcode\data\rules\bsd-new_116.yml", "YAML", 0, 0, 0, 4, 0, 0, 1, 5
"d:\IDEWORK\lvmen\src\licensedcode\data\rules\bsd-new_117.yml", "YAML", 0, 0, 0, 2, 0, 0, 1, 3
"d:\IDEWORK\lvmen\src\licensedcode\data\rules\bsd-new_118.yml", "YAML", 0, 0, 0, 3, 0, 0, 1, 4
"d:\IDEWORK\lvmen\src\licensedcode\data\rules\bsd-new_119.yml", "YAML", 0, 0, 0, 4, 0, 0, 1, 5
"d:\IDEWORK\lvmen\src\licensedcode\data\rules\bsd-new_12.yml", "YAML", 0, 0, 0, 2, 0, 0, 1, 3
"d:\IDEWORK\lvmen\src\licensedcode\data\rules\bsd-new_120.yml", "YAML", 0, 0, 0, 2, 0, 0, 1, 3
"d:\IDEWORK\lvmen\src\licensedcode\data\rules\bsd-new_121.yml", "YAML", 0, 0, 0, 6, 0, 0, 1, 7
"d:\IDEWORK\lvmen\src\licensedcode\data\rules\bsd-new_122.yml", "YAML", 0, 0, 0, 2, 0, 0, 1, 3
"d:\IDEWORK\lvmen\src\licensedcode\data\rules\bsd-new_123.yml", "YAML", 0, 0, 0, 5, 0, 0, 1, 6
"d:\IDEWORK\lvmen\src\licensedcode\data\rules\bsd-new_124.yml", "YAML", 0, 0, 0, 3, 0, 0, 2, 5
"d:\IDEWORK\lvmen\src\licensedcode\data\rules\bsd-new_125.yml", "YAML", 0, 0, 0, 2, 0, 0, 1, 3
"d:\IDEWORK\lvmen\src\licensedcode\data\rules\bsd-new_126.yml", "YAML", 0, 0, 0, 3, 0, 0, 1, 4
"d:\IDEWORK\lvmen\src\licensedcode\data\rules\bsd-new_127.yml", "YAML", 0, 0, 0, 5, 0, 0, 1, 6
"d:\IDEWORK\lvmen\src\licensedcode\data\rules\bsd-new_128.yml", "YAML", 0, 0, 0, 6, 0, 0, 1, 7
"d:\IDEWORK\lvmen\src\licensedcode\data\rules\bsd-new_129.yml", "YAML", 0, 0, 0, 5, 0, 0, 1, 6
"d:\IDEWORK\lvmen\src\licensedcode\data\rules\bsd-new_13.yml", "YAML", 0, 0, 0, 3, 0, 0, 1, 4
"d:\IDEWORK\lvmen\src\licensedcode\data\rules\bsd-new_130.yml", "YAML", 0, 0, 0, 3, 0, 0, 1, 4
"d:\IDEWORK\lvmen\src\licensedcode\data\rules\bsd-new_131.yml", "YAML", 0, 0, 0, 3, 0, 0, 1, 4
"d:\IDEWORK\lvmen\src\licensedcode\data\rules\bsd-new_131_2.yml", "YAML", 0, 0, 0, 3, 0, 0, 1, 4
"d:\IDEWORK\lvmen\src\licensedcode\data\rules\bsd-new_131_3.yml", "YAML", 0, 0, 0, 3, 0, 0, 1, 4
"d:\IDEWORK\lvmen\src\licensedcode\data\rules\bsd-new_132.yml", "YAML", 0, 0, 0, 2, 0, 0, 1, 3
"d:\IDEWORK\lvmen\src\licensedcode\data\rules\bsd-new_133.yml", "YAML", 0, 0, 0, 2, 0, 0, 1, 3
"d:\IDEWORK\lvmen\src\licensedcode\data\rules\bsd-new_134.yml", "YAML", 0, 0, 0, 2, 0, 0, 1, 3
"d:\IDEWORK\lvmen\src\licensedcode\data\rules\bsd-new_135.yml", "YAML", 0, 0, 0, 2, 0, 0, 1, 3
"d:\IDEWORK\lvmen\src\licensedcode\data\rules\bsd-new_136.yml", "YAML", 0, 0, 0, 3, 0, 0, 1, 4
"d:\IDEWORK\lvmen\src\licensedcode\data\rules\bsd-new_137.yml", "YAML", 0, 0, 0, 3, 0, 0, 1, 4
"d:\IDEWORK\lvmen\src\licensedcode\data\rules\bsd-new_138.yml", "YAML", 0, 0, 0, 3, 0, 0, 1, 4
"d:\IDEWORK\lvmen\src\licensedcode\data\rules\bsd-new_139.yml", "YAML", 0, 0, 0, 3, 0, 0, 1, 4
"d:\IDEWORK\lvmen\src\licensedcode\data\rules\bsd-new_14.yml", "YAML", 0, 0, 0, 4, 0, 0, 1, 5
"d:\IDEWORK\lvmen\src\licensedcode\data\rules\bsd-new_140.yml", "YAML", 0, 0, 0, 4, 0, 0, 1, 5
"d:\IDEWORK\lvmen\src\licensedcode\data\rules\bsd-new_141.yml", "YAML", 0, 0, 0, 2, 0, 0, 1, 3
"d:\IDEWORK\lvmen\src\licensedcode\data\rules\bsd-new_142.yml", "YAML", 0, 0, 0, 4, 0, 0, 1, 5
"d:\IDEWORK\lvmen\src\licensedcode\data\rules\bsd-new_143.yml", "YAML", 0, 0, 0, 5, 0, 0, 1, 6
"d:\IDEWORK\lvmen\src\licensedcode\data\rules\bsd-new_144.yml", "YAML", 0, 0, 0, 3, 0, 0, 1, 4
"d:\IDEWORK\lvmen\src\licensedcode\data\rules\bsd-new_145.yml", "YAML", 0, 0, 0, 3, 0, 0, 1, 4
"d:\IDEWORK\lvmen\src\licensedcode\data\rules\bsd-new_146.yml", "YAML", 0, 0, 0, 2, 0, 0, 1, 3
"d:\IDEWORK\lvmen\src\licensedcode\data\rules\bsd-new_147.yml", "YAML", 0, 0, 0, 2, 0, 0, 1, 3
"d:\IDEWORK\lvmen\src\licensedcode\data\rules\bsd-new_148.yml", "YAML", 0, 0, 0, 2, 0, 0, 1, 3
"d:\IDEWORK\lvmen\src\licensedcode\data\rules\bsd-new_149.yml", "YAML", 0, 0, 0, 2, 0, 0, 1, 3
"d:\IDEWORK\lvmen\src\licensedcode\data\rules\bsd-new_15.yml", "YAML", 0, 0, 0, 3, 0, 0, 1, 4
"d:\IDEWORK\lvmen\src\licensedcode\data\rules\bsd-new_150.yml", "YAML", 0, 0, 0, 2, 0, 0, 1, 3
"d:\IDEWORK\lvmen\src\licensedcode\data\rules\bsd-new_151.yml", "YAML", 0, 0, 0, 2, 0, 0, 1, 3
"d:\IDEWORK\lvmen\src\licensedcode\data\rules\bsd-new_152.yml", "YAML", 0, 0, 0, 2, 0, 0, 1, 3
"d:\IDEWORK\lvmen\src\licensedcode\data\rules\bsd-new_153.yml", "YAML", 0, 0, 0, 2, 0, 0, 1, 3
"d:\IDEWORK\lvmen\src\licensedcode\data\rules\bsd-new_154.yml", "YAML", 0, 0, 0, 2, 0, 0, 1, 3
"d:\IDEWORK\lvmen\src\licensedcode\data\rules\bsd-new_155.yml", "YAML", 0, 0, 0, 2, 0, 0, 1, 3
"d:\IDEWORK\lvmen\src\licensedcode\data\rules\bsd-new_156.yml", "YAML", 0, 0, 0, 2, 0, 0, 1, 3
"d:\IDEWORK\lvmen\src\licensedcode\data\rules\bsd-new_157.yml", "YAML", 0, 0, 0, 2, 0, 0, 1, 3
"d:\IDEWORK\lvmen\src\licensedcode\data\rules\bsd-new_158.yml", "YAML", 0, 0, 0, 2, 0, 0, 1, 3
"d:\IDEWORK\lvmen\src\licensedcode\data\rules\bsd-new_159.yml", "YAML", 0, 0, 0, 2, 0, 0, 1, 3
"d:\IDEWORK\lvmen\src\licensedcode\data\rules\bsd-new_16.yml", "YAML", 0, 0, 0, 5, 0, 0, 1, 6
"d:\IDEWORK\lvmen\src\licensedcode\data\rules\bsd-new_160.yml", "YAML", 0, 0, 0, 2, 0, 0, 1, 3
"d:\IDEWORK\lvmen\src\licensedcode\data\rules\bsd-new_161.yml", "YAML", 0, 0, 0, 5, 0, 0, 1, 6
"d:\IDEWORK\lvmen\src\licensedcode\data\rules\bsd-new_162.yml", "YAML", 0, 0, 0, 2, 0, 0, 1, 3
"d:\IDEWORK\lvmen\src\licensedcode\data\rules\bsd-new_163.yml", "YAML", 0, 0, 0, 2, 0, 0, 1, 3
"d:\IDEWORK\lvmen\src\licensedcode\data\rules\bsd-new_164.yml", "YAML", 0, 0, 0, 3, 0, 0, 1, 4
"d:\IDEWORK\lvmen\src\licensedcode\data\rules\bsd-new_164_1.yml", "YAML", 0, 0, 0, 3, 0, 0, 1, 4
"d:\IDEWORK\lvmen\src\licensedcode\data\rules\bsd-new_164_2.yml", "YAML", 0, 0, 0, 3, 0, 0, 1, 4
"d:\IDEWORK\lvmen\src\licensedcode\data\rules\bsd-new_164_3.yml", "YAML", 0, 0, 0, 3, 0, 0, 1, 4
"d:\IDEWORK\lvmen\src\licensedcode\data\rules\bsd-new_165.yml", "YAML", 0, 0, 0, 2, 0, 0, 1, 3
"d:\IDEWORK\lvmen\src\licensedcode\data\rules\bsd-new_166.yml", "YAML", 0, 0, 0, 2, 0, 0, 1, 3
"d:\IDEWORK\lvmen\src\licensedcode\data\rules\bsd-new_167.yml", "YAML", 0, 0, 0, 4, 0, 0, 1, 5
"d:\IDEWORK\lvmen\src\licensedcode\data\rules\bsd-new_168.yml", "YAML", 0, 0, 0, 2, 0, 0, 1, 3
"d:\IDEWORK\lvmen\src\licensedcode\data\rules\bsd-new_169.yml", "YAML", 0, 0, 0, 3, 0, 0, 1, 4
"d:\IDEWORK\lvmen\src\licensedcode\data\rules\bsd-new_17.yml", "YAML", 0, 0, 0, 3, 0, 0, 1, 4
"d:\IDEWORK\lvmen\src\licensedcode\data\rules\bsd-new_170.yml", "YAML", 0, 0, 0, 4, 0, 0, 1, 5
"d:\IDEWORK\lvmen\src\licensedcode\data\rules\bsd-new_171.yml", "YAML", 0, 0, 0, 2, 0, 0, 1, 3
"d:\IDEWORK\lvmen\src\licensedcode\data\rules\bsd-new_172.yml", "YAML", 0, 0, 0, 3, 0, 0, 1, 4
"d:\IDEWORK\lvmen\src\licensedcode\data\rules\bsd-new_173.yml", "YAML", 0, 0, 0, 3, 0, 0, 1, 4
"d:\IDEWORK\lvmen\src\licensedcode\data\rules\bsd-new_174.yml", "YAML", 0, 0, 0, 2, 0, 0, 1, 3
"d:\IDEWORK\lvmen\src\licensedcode\data\rules\bsd-new_175.yml", "YAML", 0, 0, 0, 2, 0, 0, 1, 3
"d:\IDEWORK\lvmen\src\licensedcode\data\rules\bsd-new_176.yml", "YAML", 0, 0, 0, 2, 0, 0, 1, 3
"d:\IDEWORK\lvmen\src\licensedcode\data\rules\bsd-new_176_1.yml", "YAML", 0, 0, 0, 5, 0, 0, 1, 6
"d:\IDEWORK\lvmen\src\licensedcode\data\rules\bsd-new_177.yml", "YAML", 0, 0, 0, 2, 0, 0, 1, 3
"d:\IDEWORK\lvmen\src\licensedcode\data\rules\bsd-new_178.yml", "YAML", 0, 0, 0, 2, 0, 0, 1, 3
"d:\IDEWORK\lvmen\src\licensedcode\data\rules\bsd-new_179.yml", "YAML", 0, 0, 0, 8, 0, 0, 1, 9
"d:\IDEWORK\lvmen\src\licensedcode\data\rules\bsd-new_18.yml", "YAML", 0, 0, 0, 6, 0, 0, 1, 7
"d:\IDEWORK\lvmen\src\licensedcode\data\rules\bsd-new_180.yml", "YAML", 0, 0, 0, 5, 0, 0, 1, 6
"d:\IDEWORK\lvmen\src\licensedcode\data\rules\bsd-new_181.yml", "YAML", 0, 0, 0, 2, 0, 0, 1, 3
"d:\IDEWORK\lvmen\src\licensedcode\data\rules\bsd-new_182.yml", "YAML", 0, 0, 0, 2, 0, 0, 1, 3
"d:\IDEWORK\lvmen\src\licensedcode\data\rules\bsd-new_183.yml", "YAML", 0, 0, 0, 2, 0, 0, 1, 3
"d:\IDEWORK\lvmen\src\licensedcode\data\rules\bsd-new_184.yml", "YAML", 0, 0, 0, 6, 0, 0, 1, 7
"d:\IDEWORK\lvmen\src\licensedcode\data\rules\bsd-new_185.yml", "YAML", 0, 0, 0, 7, 0, 0, 1, 8
"d:\IDEWORK\lvmen\src\licensedcode\data\rules\bsd-new_186.yml", "YAML", 0, 0, 0, 2, 0, 0, 1, 3
"d:\IDEWORK\lvmen\src\licensedcode\data\rules\bsd-new_187.yml", "YAML", 0, 0, 0, 4, 0, 0, 1, 5
"d:\IDEWORK\lvmen\src\licensedcode\data\rules\bsd-new_188.yml", "YAML", 0, 0, 0, 2, 0, 0, 1, 3
"d:\IDEWORK\lvmen\src\licensedcode\data\rules\bsd-new_189.yml", "YAML", 0, 0, 0, 2, 0, 0, 1, 3
"d:\IDEWORK\lvmen\src\licensedcode\data\rules\bsd-new_19.yml", "YAML", 0, 0, 0, 2, 0, 0, 1, 3
"d:\IDEWORK\lvmen\src\licensedcode\data\rules\bsd-new_190.yml", "YAML", 0, 0, 0, 3, 0, 0, 1, 4
"d:\IDEWORK\lvmen\src\licensedcode\data\rules\bsd-new_191.yml", "YAML", 0, 0, 0, 3, 0, 0, 1, 4
"d:\IDEWORK\lvmen\src\licensedcode\data\rules\bsd-new_192.yml", "YAML", 0, 0, 0, 3, 0, 0, 1, 4
"d:\IDEWORK\lvmen\src\licensedcode\data\rules\bsd-new_193.yml", "YAML", 0, 0, 0, 2, 0, 0, 1, 3
"d:\IDEWORK\lvmen\src\licensedcode\data\rules\bsd-new_194.yml", "YAML", 0, 0, 0, 2, 0, 0, 1, 3
"d:\IDEWORK\lvmen\src\licensedcode\data\rules\bsd-new_195.yml", "YAML", 0, 0, 0, 3, 0, 0, 1, 4
"d:\IDEWORK\lvmen\src\licensedcode\data\rules\bsd-new_196.yml", "YAML", 0, 0, 0, 5, 0, 0, 1, 6
"d:\IDEWORK\lvmen\src\licensedcode\data\rules\bsd-new_197.yml", "YAML", 0, 0, 0, 2, 0, 0, 1, 3
"d:\IDEWORK\lvmen\src\licensedcode\data\rules\bsd-new_198.yml", "YAML", 0, 0, 0, 3, 0, 0, 1, 4
"d:\IDEWORK\lvmen\src\licensedcode\data\rules\bsd-new_199.yml", "YAML", 0, 0, 0, 3, 0, 0, 1, 4
"d:\IDEWORK\lvmen\src\licensedcode\data\rules\bsd-new_2.yml", "YAML", 0, 0, 0, 5, 0, 0, 1, 6
"d:\IDEWORK\lvmen\src\licensedcode\data\rules\bsd-new_20.yml", "YAML", 0, 0, 0, 3, 0, 0, 1, 4
"d:\IDEWORK\lvmen\src\licensedcode\data\rules\bsd-new_200.yml", "YAML", 0, 0, 0, 2, 0, 0, 1, 3
"d:\IDEWORK\lvmen\src\licensedcode\data\rules\bsd-new_201.yml", "YAML", 0, 0, 0, 3, 0, 0, 1, 4
"d:\IDEWORK\lvmen\src\licensedcode\data\rules\bsd-new_202.yml", "YAML", 0, 0, 0, 3, 0, 0, 1, 4
"d:\IDEWORK\lvmen\src\licensedcode\data\rules\bsd-new_202_1.yml", "YAML", 0, 0, 0, 3, 0, 0, 1, 4
"d:\IDEWORK\lvmen\src\licensedcode\data\rules\bsd-new_203.yml", "YAML", 0, 0, 0, 3, 0, 0, 1, 4
"d:\IDEWORK\lvmen\src\licensedcode\data\rules\bsd-new_204.yml", "YAML", 0, 0, 0, 2, 0, 0, 1, 3
"d:\IDEWORK\lvmen\src\licensedcode\data\rules\bsd-new_205.yml", "YAML", 0, 0, 0, 2, 0, 0, 1, 3
"d:\IDEWORK\lvmen\src\licensedcode\data\rules\bsd-new_206.yml", "YAML", 0, 0, 0, 2, 0, 0, 1, 3
"d:\IDEWORK\lvmen\src\licensedcode\data\rules\bsd-new_207.yml", "YAML", 0, 0, 0, 2, 0, 0, 1, 3
"d:\IDEWORK\lvmen\src\licensedcode\data\rules\bsd-new_208.yml", "YAML", 0, 0, 0, 2, 0, 0, 1, 3
"d:\IDEWORK\lvmen\src\licensedcode\data\rules\bsd-new_209.yml", "YAML", 0, 0, 0, 2, 0, 0, 1, 3
"d:\IDEWORK\lvmen\src\licensedcode\data\rules\bsd-new_21.yml", "YAML", 0, 0, 0, 3, 0, 0, 1, 4
"d:\IDEWORK\lvmen\src\licensedcode\data\rules\bsd-new_210.yml", "YAML", 0, 0, 0, 3, 0, 0, 1, 4
"d:\IDEWORK\lvmen\src\licensedcode\data\rules\bsd-new_211.yml", "YAML", 0, 0, 0, 2, 0, 0, 1, 3
"d:\IDEWORK\lvmen\src\licensedcode\data\rules\bsd-new_212.yml", "YAML", 0, 0, 0, 3, 0, 0, 1, 4
"d:\IDEWORK\lvmen\src\licensedcode\data\rules\bsd-new_213.yml", "YAML", 0, 0, 0, 2, 0, 0, 1, 3
"d:\IDEWORK\lvmen\src\licensedcode\data\rules\bsd-new_214.yml", "YAML", 0, 0, 0, 4, 0, 0, 1, 5
"d:\IDEWORK\lvmen\src\licensedcode\data\rules\bsd-new_215.yml", "YAML", 0, 0, 0, 3, 0, 0, 1, 4
"d:\IDEWORK\lvmen\src\licensedcode\data\rules\bsd-new_216.yml", "YAML", 0, 0, 0, 5, 0, 0, 1, 6
"d:\IDEWORK\lvmen\src\licensedcode\data\rules\bsd-new_217.yml", "YAML", 0, 0, 0, 3, 0, 0, 1, 4
"d:\IDEWORK\lvmen\src\licensedcode\data\rules\bsd-new_218.yml", "YAML", 0, 0, 0, 3, 0, 0, 1, 4
"d:\IDEWORK\lvmen\src\licensedcode\data\rules\bsd-new_219.yml", "YAML", 0, 0, 0, 5, 0, 0, 1, 6
"d:\IDEWORK\lvmen\src\licensedcode\data\rules\bsd-new_22.yml", "YAML", 0, 0, 0, 3, 0, 0, 1, 4
"d:\IDEWORK\lvmen\src\licensedcode\data\rules\bsd-new_220.yml", "YAML", 0, 0, 0, 3, 0, 0, 1, 4
"d:\IDEWORK\lvmen\src\licensedcode\data\rules\bsd-new_221.yml", "YAML", 0, 0, 0, 5, 0, 0, 1, 6
"d:\IDEWORK\lvmen\src\licensedcode\data\rules\bsd-new_222.yml", "YAML", 0, 0, 0, 2, 0, 0, 1, 3
"d:\IDEWORK\lvmen\src\licensedcode\data\rules\bsd-new_223.yml", "YAML", 0, 0, 0, 2, 0, 0, 1, 3
"d:\IDEWORK\lvmen\src\licensedcode\data\rules\bsd-new_224.yml", "YAML", 0, 0, 0, 5, 0, 0, 1, 6
"d:\IDEWORK\lvmen\src\licensedcode\data\rules\bsd-new_225.yml", "YAML", 0, 0, 0, 2, 0, 0, 1, 3
"d:\IDEWORK\lvmen\src\licensedcode\data\rules\bsd-new_226.yml", "YAML", 0, 0, 0, 5, 0, 0, 1, 6
"d:\IDEWORK\lvmen\src\licensedcode\data\rules\bsd-new_227.yml", "YAML", 0, 0, 0, 4, 0, 0, 1, 5
"d:\IDEWORK\lvmen\src\licensedcode\data\rules\bsd-new_228.yml", "YAML", 0, 0, 0, 3, 0, 0, 1, 4
"d:\IDEWORK\lvmen\src\licensedcode\data\rules\bsd-new_229.yml", "YAML", 0, 0, 0, 2, 0, 0, 1, 3
"d:\IDEWORK\lvmen\src\licensedcode\data\rules\bsd-new_23.yml", "YAML", 0, 0, 0, 3, 0, 0, 1, 4
"d:\IDEWORK\lvmen\src\licensedcode\data\rules\bsd-new_230.yml", "YAML", 0, 0, 0, 2, 0, 0, 1, 3
"d:\IDEWORK\lvmen\src\licensedcode\data\rules\bsd-new_231.yml", "YAML", 0, 0, 0, 3, 0, 0, 1, 4
"d:\IDEWORK\lvmen\src\licensedcode\data\rules\bsd-new_232.yml", "YAML", 0, 0, 0, 2, 0, 0, 1, 3
"d:\IDEWORK\lvmen\src\licensedcode\data\rules\bsd-new_233.yml", "YAML", 0, 0, 0, 2, 0, 0, 1, 3
"d:\IDEWORK\lvmen\src\licensedcode\data\rules\bsd-new_234.yml", "YAML", 0, 0, 0, 4, 0, 0, 1, 5
"d:\IDEWORK\lvmen\src\licensedcode\data\rules\bsd-new_235.yml", "YAML", 0, 0, 0, 2, 0, 0, 1, 3
"d:\IDEWORK\lvmen\src\licensedcode\data\rules\bsd-new_236.yml", "YAML", 0, 0, 0, 2, 0, 0, 1, 3
"d:\IDEWORK\lvmen\src\licensedcode\data\rules\bsd-new_237.yml", "YAML", 0, 0, 0, 2, 0, 0, 1, 3
"d:\IDEWORK\lvmen\src\licensedcode\data\rules\bsd-new_238.yml", "YAML", 0, 0, 0, 2, 0, 0, 1, 3
"d:\IDEWORK\lvmen\src\licensedcode\data\rules\bsd-new_239.yml", "YAML", 0, 0, 0, 2, 0, 0, 1, 3
"d:\IDEWORK\lvmen\src\licensedcode\data\rules\bsd-new_24.yml", "YAML", 0, 0, 0, 3, 0, 0, 1, 4
"d:\IDEWORK\lvmen\src\licensedcode\data\rules\bsd-new_240.yml", "YAML", 0, 0, 0, 5, 0, 0, 1, 6
"d:\IDEWORK\lvmen\src\licensedcode\data\rules\bsd-new_241.yml", "YAML", 0, 0, 0, 7, 0, 0, 1, 8
"d:\IDEWORK\lvmen\src\licensedcode\data\rules\bsd-new_241_1.yml", "YAML", 0, 0, 0, 5, 0, 0, 1, 6
"d:\IDEWORK\lvmen\src\licensedcode\data\rules\bsd-new_241_2.yml", "YAML", 0, 0, 0, 5, 0, 0, 1, 6
"d:\IDEWORK\lvmen\src\licensedcode\data\rules\bsd-new_241_3.yml", "YAML", 0, 0, 0, 5, 0, 0, 1, 6
"d:\IDEWORK\lvmen\src\licensedcode\data\rules\bsd-new_241_4.yml", "YAML", 0, 0, 0, 5, 0, 0, 1, 6
"d:\IDEWORK\lvmen\src\licensedcode\data\rules\bsd-new_242.yml", "YAML", 0, 0, 0, 3, 0, 0, 1, 4
"d:\IDEWORK\lvmen\src\licensedcode\data\rules\bsd-new_243.yml", "YAML", 0, 0, 0, 4, 0, 0, 1, 5
"d:\IDEWORK\lvmen\src\licensedcode\data\rules\bsd-new_244.yml", "YAML", 0, 0, 0, 3, 0, 0, 1, 4
"d:\IDEWORK\lvmen\src\licensedcode\data\rules\bsd-new_245.yml", "YAML", 0, 0, 0, 2, 0, 0, 1, 3
"d:\IDEWORK\lvmen\src\licensedcode\data\rules\bsd-new_246.yml", "YAML", 0, 0, 0, 2, 0, 0, 1, 3
"d:\IDEWORK\lvmen\src\licensedcode\data\rules\bsd-new_247.yml", "YAML", 0, 0, 0, 3, 0, 0, 1, 4
"d:\IDEWORK\lvmen\src\licensedcode\data\rules\bsd-new_248.yml", "YAML", 0, 0, 0, 3, 0, 0, 1, 4
"d:\IDEWORK\lvmen\src\licensedcode\data\rules\bsd-new_249.yml", "YAML", 0, 0, 0, 3, 0, 0, 1, 4
"d:\IDEWORK\lvmen\src\licensedcode\data\rules\bsd-new_25.yml", "YAML", 0, 0, 0, 6, 0, 0, 1, 7
"d:\IDEWORK\lvmen\src\licensedcode\data\rules\bsd-new_250.yml", "YAML", 0, 0, 0, 2, 0, 0, 1, 3
"d:\IDEWORK\lvmen\src\licensedcode\data\rules\bsd-new_251.yml", "YAML", 0, 0, 0, 2, 0, 0, 1, 3
"d:\IDEWORK\lvmen\src\licensedcode\data\rules\bsd-new_252.yml", "YAML", 0, 0, 0, 5, 0, 0, 1, 6
"d:\IDEWORK\lvmen\src\licensedcode\data\rules\bsd-new_253.yml", "YAML", 0, 0, 0, 5, 0, 0, 1, 6
"d:\IDEWORK\lvmen\src\licensedcode\data\rules\bsd-new_254.yml", "YAML", 0, 0, 0, 5, 0, 0, 1, 6
"d:\IDEWORK\lvmen\src\licensedcode\data\rules\bsd-new_255.yml", "YAML", 0, 0, 0, 3, 0, 0, 1, 4
"d:\IDEWORK\lvmen\src\licensedcode\data\rules\bsd-new_256.yml", "YAML", 0, 0, 0, 2, 0, 0, 1, 3
"d:\IDEWORK\lvmen\src\licensedcode\data\rules\bsd-new_257.yml", "YAML", 0, 0, 0, 2, 0, 0, 1, 3
"d:\IDEWORK\lvmen\src\licensedcode\data\rules\bsd-new_258.yml", "YAML", 0, 0, 0, 3, 0, 0, 1, 4
"d:\IDEWORK\lvmen\src\licensedcode\data\rules\bsd-new_259.yml", "YAML", 0, 0, 0, 4, 0, 0, 1, 5
"d:\IDEWORK\lvmen\src\licensedcode\data\rules\bsd-new_25_1.yml", "YAML", 0, 0, 0, 5, 0, 0, 1, 6
"d:\IDEWORK\lvmen\src\licensedcode\data\rules\bsd-new_25_2.yml", "YAML", 0, 0, 0, 4, 0, 0, 1, 5
"d:\IDEWORK\lvmen\src\licensedcode\data\rules\bsd-new_26.yml", "YAML", 0, 0, 0, 3, 0, 0, 1, 4
"d:\IDEWORK\lvmen\src\licensedcode\data\rules\bsd-new_260.yml", "YAML", 0, 0, 0, 3, 0, 0, 1, 4
"d:\IDEWORK\lvmen\src\licensedcode\data\rules\bsd-new_261.yml", "YAML", 0, 0, 0, 5, 0, 0, 1, 6
"d:\IDEWORK\lvmen\src\licensedcode\data\rules\bsd-new_262.yml", "YAML", 0, 0, 0, 5, 0, 0, 1, 6
"d:\IDEWORK\lvmen\src\licensedcode\data\rules\bsd-new_263.yml", "YAML", 0, 0, 0, 5, 0, 0, 1, 6
"d:\IDEWORK\lvmen\src\licensedcode\data\rules\bsd-new_264.yml", "YAML", 0, 0, 0, 4, 0, 0, 1, 5
"d:\IDEWORK\lvmen\src\licensedcode\data\rules\bsd-new_265.yml", "YAML", 0, 0, 0, 3, 0, 0, 1, 4
"d:\IDEWORK\lvmen\src\licensedcode\data\rules\bsd-new_266.yml", "YAML", 0, 0, 0, 5, 0, 0, 1, 6
"d:\IDEWORK\lvmen\src\licensedcode\data\rules\bsd-new_267.yml", "YAML", 0, 0, 0, 5, 0, 0, 1, 6
"d:\IDEWORK\lvmen\src\licensedcode\data\rules\bsd-new_268.yml", "YAML", 0, 0, 0, 5, 0, 0, 1, 6
"d:\IDEWORK\lvmen\src\licensedcode\data\rules\bsd-new_269.yml", "YAML", 0, 0, 0, 3, 0, 0, 1, 4
"d:\IDEWORK\lvmen\src\licensedcode\data\rules\bsd-new_27.yml", "YAML", 0, 0, 0, 4, 0, 0, 1, 5
"d:\IDEWORK\lvmen\src\licensedcode\data\rules\bsd-new_270.yml", "YAML", 0, 0, 0, 6, 0, 0, 1, 7
"d:\IDEWORK\lvmen\src\licensedcode\data\rules\bsd-new_271.yml", "YAML", 0, 0, 0, 2, 0, 0, 1, 3
"d:\IDEWORK\lvmen\src\licensedcode\data\rules\bsd-new_272.yml", "YAML", 0, 0, 0, 2, 0, 0, 1, 3
"d:\IDEWORK\lvmen\src\licensedcode\data\rules\bsd-new_273.yml", "YAML", 0, 0, 0, 2, 0, 0, 1, 3
"d:\IDEWORK\lvmen\src\licensedcode\data\rules\bsd-new_274.yml", "YAML", 0, 0, 0, 2, 0, 0, 1, 3
"d:\IDEWORK\lvmen\src\licensedcode\data\rules\bsd-new_275.yml", "YAML", 0, 0, 0, 2, 0, 0, 1, 3
"d:\IDEWORK\lvmen\src\licensedcode\data\rules\bsd-new_276.yml", "YAML", 0, 0, 0, 2, 0, 0, 1, 3
"d:\IDEWORK\lvmen\src\licensedcode\data\rules\bsd-new_277.yml", "YAML", 0, 0, 0, 4, 0, 0, 1, 5
"d:\IDEWORK\lvmen\src\licensedcode\data\rules\bsd-new_278.yml", "YAML", 0, 0, 0, 2, 0, 0, 1, 3
"d:\IDEWORK\lvmen\src\licensedcode\data\rules\bsd-new_279.yml", "YAML", 0, 0, 0, 2, 0, 0, 1, 3
"d:\IDEWORK\lvmen\src\licensedcode\data\rules\bsd-new_28.yml", "YAML", 0, 0, 0, 4, 0, 0, 1, 5
"d:\IDEWORK\lvmen\src\licensedcode\data\rules\bsd-new_280.yml", "YAML", 0, 0, 0, 2, 0, 0, 1, 3
"d:\IDEWORK\lvmen\src\licensedcode\data\rules\bsd-new_281.yml", "YAML", 0, 0, 0, 3, 0, 0, 1, 4
"d:\IDEWORK\lvmen\src\licensedcode\data\rules\bsd-new_282.yml", "YAML", 0, 0, 0, 3, 0, 0, 1, 4
"d:\IDEWORK\lvmen\src\licensedcode\data\rules\bsd-new_283.yml", "YAML", 0, 0, 0, 3, 0, 0, 1, 4
"d:\IDEWORK\lvmen\src\licensedcode\data\rules\bsd-new_284.yml", "YAML", 0, 0, 0, 5, 0, 0, 1, 6
"d:\IDEWORK\lvmen\src\licensedcode\data\rules\bsd-new_285.yml", "YAML", 0, 0, 0, 4, 0, 0, 1, 5
"d:\IDEWORK\lvmen\src\licensedcode\data\rules\bsd-new_286.yml", "YAML", 0, 0, 0, 3, 0, 0, 1, 4
"d:\IDEWORK\lvmen\src\licensedcode\data\rules\bsd-new_287.yml", "YAML", 0, 0, 0, 5, 0, 0, 1, 6
"d:\IDEWORK\lvmen\src\licensedcode\data\rules\bsd-new_288.yml", "YAML", 0, 0, 0, 3, 0, 0, 1, 4
"d:\IDEWORK\lvmen\src\licensedcode\data\rules\bsd-new_289.yml", "YAML", 0, 0, 0, 2, 0, 0, 1, 3
"d:\IDEWORK\lvmen\src\licensedcode\data\rules\bsd-new_29.yml", "YAML", 0, 0, 0, 2, 0, 0, 1, 3
"d:\IDEWORK\lvmen\src\licensedcode\data\rules\bsd-new_290.yml", "YAML", 0, 0, 0, 3, 0, 0, 1, 4
"d:\IDEWORK\lvmen\src\licensedcode\data\rules\bsd-new_291.yml", "YAML", 0, 0, 0, 3, 0, 0, 1, 4
"d:\IDEWORK\lvmen\src\licensedcode\data\rules\bsd-new_292.yml", "YAML", 0, 0, 0, 4, 0, 0, 1, 5
"d:\IDEWORK\lvmen\src\licensedcode\data\rules\bsd-new_293.yml", "YAML", 0, 0, 0, 4, 0, 0, 1, 5
"d:\IDEWORK\lvmen\src\licensedcode\data\rules\bsd-new_294.yml", "YAML", 0, 0, 0, 3, 0, 0, 1, 4
"d:\IDEWORK\lvmen\src\licensedcode\data\rules\bsd-new_295.yml", "YAML", 0, 0, 0, 2, 0, 0, 1, 3
"d:\IDEWORK\lvmen\src\licensedcode\data\rules\bsd-new_296.yml", "YAML", 0, 0, 0, 4, 0, 0, 1, 5
"d:\IDEWORK\lvmen\src\licensedcode\data\rules\bsd-new_297.yml", "YAML", 0, 0, 0, 3, 0, 0, 1, 4
"d:\IDEWORK\lvmen\src\licensedcode\data\rules\bsd-new_298.yml", "YAML", 0, 0, 0, 3, 0, 0, 1, 4
"d:\IDEWORK\lvmen\src\licensedcode\data\rules\bsd-new_299.yml", "YAML", 0, 0, 0, 3, 0, 0, 1, 4
"d:\IDEWORK\lvmen\src\licensedcode\data\rules\bsd-new_3.yml", "YAML", 0, 0, 0, 3, 0, 0, 1, 4
"d:\IDEWORK\lvmen\src\licensedcode\data\rules\bsd-new_30.yml", "YAML", 0, 0, 0, 5, 0, 0, 1, 6
"d:\IDEWORK\lvmen\src\licensedcode\data\rules\bsd-new_300.yml", "YAML", 0, 0, 0, 3, 0, 0, 1, 4
"d:\IDEWORK\lvmen\src\licensedcode\data\rules\bsd-new_301.yml", "YAML", 0, 0, 0, 2, 0, 0, 1, 3
"d:\IDEWORK\lvmen\src\licensedcode\data\rules\bsd-new_302.yml", "YAML", 0, 0, 0, 3, 0, 0, 1, 4
"d:\IDEWORK\lvmen\src\licensedcode\data\rules\bsd-new_303.yml", "YAML", 0, 0, 0, 3, 0, 0, 1, 4
"d:\IDEWORK\lvmen\src\licensedcode\data\rules\bsd-new_304.yml", "YAML", 0, 0, 0, 3, 0, 0, 1, 4
"d:\IDEWORK\lvmen\src\licensedcode\data\rules\bsd-new_305.yml", "YAML", 0, 0, 0, 2, 0, 0, 1, 3
"d:\IDEWORK\lvmen\src\licensedcode\data\rules\bsd-new_306.yml", "YAML", 0, 0, 0, 5, 0, 0, 1, 6
"d:\IDEWORK\lvmen\src\licensedcode\data\rules\bsd-new_307.yml", "YAML", 0, 0, 0, 3, 0, 0, 1, 4
"d:\IDEWORK\lvmen\src\licensedcode\data\rules\bsd-new_308.yml", "YAML", 0, 0, 0, 3, 0, 0, 1, 4
"d:\IDEWORK\lvmen\src\licensedcode\data\rules\bsd-new_309.yml", "YAML", 0, 0, 0, 5, 0, 0, 1, 6
"d:\IDEWORK\lvmen\src\licensedcode\data\rules\bsd-new_31.yml", "YAML", 0, 0, 0, 3, 0, 0, 1, 4
"d:\IDEWORK\lvmen\src\licensedcode\data\rules\bsd-new_310.yml", "YAML", 0, 0, 0, 3, 0, 0, 1, 4
"d:\IDEWORK\lvmen\src\licensedcode\data\rules\bsd-new_311.yml", "YAML", 0, 0, 0, 3, 0, 0, 1, 4
"d:\IDEWORK\lvmen\src\licensedcode\data\rules\bsd-new_312.yml", "YAML", 0, 0, 0, 2, 0, 0, 1, 3
"d:\IDEWORK\lvmen\src\licensedcode\data\rules\bsd-new_313.yml", "YAML", 0, 0, 0, 2, 0, 0, 1, 3
"d:\IDEWORK\lvmen\src\licensedcode\data\rules\bsd-new_314.yml", "YAML", 0, 0, 0, 2, 0, 0, 1, 3
"d:\IDEWORK\lvmen\src\licensedcode\data\rules\bsd-new_315.yml", "YAML", 0, 0, 0, 2, 0, 0, 1, 3
"d:\IDEWORK\lvmen\src\licensedcode\data\rules\bsd-new_316.yml", "YAML", 0, 0, 0, 2, 0, 0, 1, 3
"d:\IDEWORK\lvmen\src\licensedcode\data\rules\bsd-new_317.yml", "YAML", 0, 0, 0, 2, 0, 0, 1, 3
"d:\IDEWORK\lvmen\src\licensedcode\data\rules\bsd-new_318.yml", "YAML", 0, 0, 0, 2, 0, 0, 1, 3
"d:\IDEWORK\lvmen\src\licensedcode\data\rules\bsd-new_319.yml", "YAML", 0, 0, 0, 3, 0, 0, 1, 4
"d:\IDEWORK\lvmen\src\licensedcode\data\rules\bsd-new_32.yml", "YAML", 0, 0, 0, 3, 0, 0, 1, 4
"d:\IDEWORK\lvmen\src\licensedcode\data\rules\bsd-new_320.yml", "YAML", 0, 0, 0, 2, 0, 0, 1, 3
"d:\IDEWORK\lvmen\src\licensedcode\data\rules\bsd-new_321.yml", "YAML", 0, 0, 0, 2, 0, 0, 1, 3
"d:\IDEWORK\lvmen\src\licensedcode\data\rules\bsd-new_322.yml", "YAML", 0, 0, 0, 2, 0, 0, 1, 3
"d:\IDEWORK\lvmen\src\licensedcode\data\rules\bsd-new_323.yml", "YAML", 0, 0, 0, 2, 0, 0, 1, 3
"d:\IDEWORK\lvmen\src\licensedcode\data\rules\bsd-new_324.yml", "YAML", 0, 0, 0, 3, 0, 0, 1, 4
"d:\IDEWORK\lvmen\src\licensedcode\data\rules\bsd-new_325.yml", "YAML", 0, 0, 0, 2, 0, 0, 1, 3
"d:\IDEWORK\lvmen\src\licensedcode\data\rules\bsd-new_326.yml", "YAML", 0, 0, 0, 2, 0, 0, 1, 3
"d:\IDEWORK\lvmen\src\licensedcode\data\rules\bsd-new_327.yml", "YAML", 0, 0, 0, 2, 0, 0, 1, 3
"d:\IDEWORK\lvmen\src\licensedcode\data\rules\bsd-new_328.yml", "YAML", 0, 0, 0, 2, 0, 0, 1, 3
"d:\IDEWORK\lvmen\src\licensedcode\data\rules\bsd-new_329.yml", "YAML", 0, 0, 0, 3, 0, 0, 1, 4
"d:\IDEWORK\lvmen\src\licensedcode\data\rules\bsd-new_33.yml", "YAML", 0, 0, 0, 3, 0, 0, 1, 4
"d:\IDEWORK\lvmen\src\licensedcode\data\rules\bsd-new_330.yml", "YAML", 0, 0, 0, 2, 0, 0, 1, 3
"d:\IDEWORK\lvmen\src\licensedcode\data\rules\bsd-new_331.yml", "YAML", 0, 0, 0, 2, 0, 0, 1, 3
"d:\IDEWORK\lvmen\src\licensedcode\data\rules\bsd-new_332.yml", "YAML", 0, 0, 0, 2, 0, 0, 1, 3
"d:\IDEWORK\lvmen\src\licensedcode\data\rules\bsd-new_333.yml", "YAML", 0, 0, 0, 2, 0, 0, 1, 3
"d:\IDEWORK\lvmen\src\licensedcode\data\rules\bsd-new_334.yml", "YAML", 0, 0, 0, 3, 0, 0, 1, 4
"d:\IDEWORK\lvmen\src\licensedcode\data\rules\bsd-new_335.yml", "YAML", 0, 0, 0, 5, 0, 0, 1, 6
"d:\IDEWORK\lvmen\src\licensedcode\data\rules\bsd-new_336.yml", "YAML", 0, 0, 0, 5, 0, 0, 1, 6
"d:\IDEWORK\lvmen\src\licensedcode\data\rules\bsd-new_337.yml", "YAML", 0, 0, 0, 5, 0, 0, 1, 6
"d:\IDEWORK\lvmen\src\licensedcode\data\rules\bsd-new_338.yml", "YAML", 0, 0, 0, 3, 0, 0, 1, 4
"d:\IDEWORK\lvmen\src\licensedcode\data\rules\bsd-new_339.yml", "YAML", 0, 0, 0, 5, 0, 0, 1, 6
"d:\IDEWORK\lvmen\src\licensedcode\data\rules\bsd-new_34.yml", "YAML", 0, 0, 0, 3, 0, 0, 1, 4
"d:\IDEWORK\lvmen\src\licensedcode\data\rules\bsd-new_340.yml", "YAML", 0, 0, 0, 5, 0, 0, 1, 6
"d:\IDEWORK\lvmen\src\licensedcode\data\rules\bsd-new_341.yml", "YAML", 0, 0, 0, 5, 0, 0, 1, 6
"d:\IDEWORK\lvmen\src\licensedcode\data\rules\bsd-new_342.yml", "YAML", 0, 0, 0, 5, 0, 0, 1, 6
"d:\IDEWORK\lvmen\src\licensedcode\data\rules\bsd-new_343.yml", "YAML", 0, 0, 0, 5, 0, 0, 1, 6
"d:\IDEWORK\lvmen\src\licensedcode\data\rules\bsd-new_344.yml", "YAML", 0, 0, 0, 5, 0, 0, 1, 6
"d:\IDEWORK\lvmen\src\licensedcode\data\rules\bsd-new_345.yml", "YAML", 0, 0, 0, 5, 0, 0, 1, 6
"d:\IDEWORK\lvmen\src\licensedcode\data\rules\bsd-new_346.yml", "YAML", 0, 0, 0, 5, 0, 0, 1, 6
"d:\IDEWORK\lvmen\src\licensedcode\data\rules\bsd-new_347.yml", "YAML", 0, 0, 0, 6, 0, 0, 1, 7
"d:\IDEWORK\lvmen\src\licensedcode\data\rules\bsd-new_348.yml", "YAML", 0, 0, 0, 6, 0, 0, 1, 7
"d:\IDEWORK\lvmen\src\licensedcode\data\rules\bsd-new_349.yml", "YAML", 0, 0, 0, 5, 0, 0, 1, 6
"d:\IDEWORK\lvmen\src\licensedcode\data\rules\bsd-new_35.yml", "YAML", 0, 0, 0, 4, 0, 0, 1, 5
"d:\IDEWORK\lvmen\src\licensedcode\data\rules\bsd-new_350.yml", "YAML", 0, 0, 0, 5, 0, 0, 1, 6
"d:\IDEWORK\lvmen\src\licensedcode\data\rules\bsd-new_351.yml", "YAML", 0, 0, 0, 5, 0, 0, 1, 6
"d:\IDEWORK\lvmen\src\licensedcode\data\rules\bsd-new_352.yml", "YAML", 0, 0, 0, 5, 0, 0, 1, 6
"d:\IDEWORK\lvmen\src\licensedcode\data\rules\bsd-new_353.yml", "YAML", 0, 0, 0, 5, 0, 0, 1, 6
"d:\IDEWORK\lvmen\src\licensedcode\data\rules\bsd-new_354.yml", "YAML", 0, 0, 0, 5, 0, 0, 1, 6
"d:\IDEWORK\lvmen\src\licensedcode\data\rules\bsd-new_355.yml", "YAML", 0, 0, 0, 5, 0, 0, 1, 6
"d:\IDEWORK\lvmen\src\licensedcode\data\rules\bsd-new_356.yml", "YAML", 0, 0, 0, 5, 0, 0, 1, 6
"d:\IDEWORK\lvmen\src\licensedcode\data\rules\bsd-new_357.yml", "YAML", 0, 0, 0, 3, 0, 0, 1, 4
"d:\IDEWORK\lvmen\src\licensedcode\data\rules\bsd-new_358.yml", "YAML", 0, 0, 0, 5, 0, 0, 1, 6
"d:\IDEWORK\lvmen\src\licensedcode\data\rules\bsd-new_359.yml", "YAML", 0, 0, 0, 7, 0, 0, 1, 8
"d:\IDEWORK\lvmen\src\licensedcode\data\rules\bsd-new_36.yml", "YAML", 0, 0, 0, 5, 0, 0, 1, 6
"d:\IDEWORK\lvmen\src\licensedcode\data\rules\bsd-new_360.yml", "YAML", 0, 0, 0, 3, 0, 0, 1, 4
"d:\IDEWORK\lvmen\src\licensedcode\data\rules\bsd-new_361.yml", "YAML", 0, 0, 0, 3, 0, 0, 1, 4
"d:\IDEWORK\lvmen\src\licensedcode\data\rules\bsd-new_362.yml", "YAML", 0, 0, 0, 5, 0, 0, 1, 6
"d:\IDEWORK\lvmen\src\licensedcode\data\rules\bsd-new_363.yml", "YAML", 0, 0, 0, 3, 0, 0, 1, 4
"d:\IDEWORK\lvmen\src\licensedcode\data\rules\bsd-new_364.yml", "YAML", 0, 0, 0, 3, 0, 0, 1, 4
"d:\IDEWORK\lvmen\src\licensedcode\data\rules\bsd-new_365.yml", "YAML", 0, 0, 0, 3, 0, 0, 1, 4
"d:\IDEWORK\lvmen\src\licensedcode\data\rules\bsd-new_366.yml", "YAML", 0, 0, 0, 3, 0, 0, 1, 4
"d:\IDEWORK\lvmen\src\licensedcode\data\rules\bsd-new_367.yml", "YAML", 0, 0, 0, 3, 0, 0, 1, 4
"d:\IDEWORK\lvmen\src\licensedcode\data\rules\bsd-new_368.yml", "YAML", 0, 0, 0, 8, 0, 0, 1, 9
"d:\IDEWORK\lvmen\src\licensedcode\data\rules\bsd-new_369.yml", "YAML", 0, 0, 0, 3, 0, 0, 1, 4
"d:\IDEWORK\lvmen\src\licensedcode\data\rules\bsd-new_37.yml", "YAML", 0, 0, 0, 5, 0, 0, 1, 6
"d:\IDEWORK\lvmen\src\licensedcode\data\rules\bsd-new_370.yml", "YAML", 0, 0, 0, 3, 0, 0, 1, 4
"d:\IDEWORK\lvmen\src\licensedcode\data\rules\bsd-new_371.yml", "YAML", 0, 0, 0, 2, 0, 0, 1, 3
"d:\IDEWORK\lvmen\src\licensedcode\data\rules\bsd-new_372.yml", "YAML", 0, 0, 0, 2, 0, 0, 1, 3
"d:\IDEWORK\lvmen\src\licensedcode\data\rules\bsd-new_373.yml", "YAML", 0, 0, 0, 2, 0, 0, 1, 3
"d:\IDEWORK\lvmen\src\licensedcode\data\rules\bsd-new_374.yml", "YAML", 0, 0, 0, 2, 0, 0, 1, 3
"d:\IDEWORK\lvmen\src\licensedcode\data\rules\bsd-new_375.yml", "YAML", 0, 0, 0, 2, 0, 0, 1, 3
"d:\IDEWORK\lvmen\src\licensedcode\data\rules\bsd-new_376.yml", "YAML", 0, 0, 0, 6, 0, 0, 1, 7
"d:\IDEWORK\lvmen\src\licensedcode\data\rules\bsd-new_377.yml", "YAML", 0, 0, 0, 2, 0, 0, 1, 3
"d:\IDEWORK\lvmen\src\licensedcode\data\rules\bsd-new_378.yml", "YAML", 0, 0, 0, 2, 0, 0, 1, 3
"d:\IDEWORK\lvmen\src\licensedcode\data\rules\bsd-new_379.yml", "YAML", 0, 0, 0, 2, 0, 0, 1, 3
"d:\IDEWORK\lvmen\src\licensedcode\data\rules\bsd-new_38.yml", "YAML", 0, 0, 0, 3, 0, 0, 1, 4
"d:\IDEWORK\lvmen\src\licensedcode\data\rules\bsd-new_380.yml", "YAML", 0, 0, 0, 2, 0, 0, 1, 3
"d:\IDEWORK\lvmen\src\licensedcode\data\rules\bsd-new_381.yml", "YAML", 0, 0, 0, 3, 0, 0, 1, 4
"d:\IDEWORK\lvmen\src\licensedcode\data\rules\bsd-new_382.yml", "YAML", 0, 0, 0, 2, 0, 0, 1, 3
"d:\IDEWORK\lvmen\src\licensedcode\data\rules\bsd-new_383.yml", "YAML", 0, 0, 0, 2, 0, 0, 1, 3
"d:\IDEWORK\lvmen\src\licensedcode\data\rules\bsd-new_384.yml", "YAML", 0, 0, 0, 2, 0, 0, 1, 3
"d:\IDEWORK\lvmen\src\licensedcode\data\rules\bsd-new_385.yml", "YAML", 0, 0, 0, 2, 0, 0, 1, 3
"d:\IDEWORK\lvmen\src\licensedcode\data\rules\bsd-new_386.yml", "YAML", 0, 0, 0, 2, 0, 0, 1, 3
"d:\IDEWORK\lvmen\src\licensedcode\data\rules\bsd-new_387.yml", "YAML", 0, 0, 0, 3, 0, 0, 1, 4
"d:\IDEWORK\lvmen\src\licensedcode\data\rules\bsd-new_388.yml", "YAML", 0, 0, 0, 6, 0, 0, 1, 7
"d:\IDEWORK\lvmen\src\licensedcode\data\rules\bsd-new_389.yml", "YAML", 0, 0, 0, 5, 0, 0, 1, 6
"d:\IDEWORK\lvmen\src\licensedcode\data\rules\bsd-new_39.yml", "YAML", 0, 0, 0, 2, 0, 0, 1, 3
"d:\IDEWORK\lvmen\src\licensedcode\data\rules\bsd-new_390.yml", "YAML", 0, 0, 0, 3, 0, 0, 1, 4
"d:\IDEWORK\lvmen\src\licensedcode\data\rules\bsd-new_391.yml", "YAML", 0, 0, 0, 3, 0, 0, 1, 4
"d:\IDEWORK\lvmen\src\licensedcode\data\rules\bsd-new_392.yml", "YAML", 0, 0, 0, 3, 0, 0, 1, 4
"d:\IDEWORK\lvmen\src\licensedcode\data\rules\bsd-new_393.yml", "YAML", 0, 0, 0, 4, 0, 0, 1, 5
"d:\IDEWORK\lvmen\src\licensedcode\data\rules\bsd-new_394.yml", "YAML", 0, 0, 0, 4, 0, 0, 1, 5
"d:\IDEWORK\lvmen\src\licensedcode\data\rules\bsd-new_395.yml", "YAML", 0, 0, 0, 3, 0, 0, 1, 4
"d:\IDEWORK\lvmen\src\licensedcode\data\rules\bsd-new_396.yml", "YAML", 0, 0, 0, 3, 0, 0, 1, 4
"d:\IDEWORK\lvmen\src\licensedcode\data\rules\bsd-new_397.yml", "YAML", 0, 0, 0, 3, 0, 0, 1, 4
"d:\IDEWORK\lvmen\src\licensedcode\data\rules\bsd-new_398.yml", "YAML", 0, 0, 0, 3, 0, 0, 1, 4
"d:\IDEWORK\lvmen\src\licensedcode\data\rules\bsd-new_399.yml", "YAML", 0, 0, 0, 4, 0, 0, 1, 5
"d:\IDEWORK\lvmen\src\licensedcode\data\rules\bsd-new_4.yml", "YAML", 0, 0, 0, 2, 0, 0, 1, 3
"d:\IDEWORK\lvmen\src\licensedcode\data\rules\bsd-new_40.yml", "YAML", 0, 0, 0, 4, 0, 0, 1, 5
"d:\IDEWORK\lvmen\src\licensedcode\data\rules\bsd-new_400.yml", "YAML", 0, 0, 0, 3, 0, 0, 1, 4
"d:\IDEWORK\lvmen\src\licensedcode\data\rules\bsd-new_401.yml", "YAML", 0, 0, 0, 3, 0, 0, 1, 4
"d:\IDEWORK\lvmen\src\licensedcode\data\rules\bsd-new_402.yml", "YAML", 0, 0, 0, 2, 0, 0, 1, 3
"d:\IDEWORK\lvmen\src\licensedcode\data\rules\bsd-new_403.yml", "YAML", 0, 0, 0, 2, 0, 0, 1, 3
"d:\IDEWORK\lvmen\src\licensedcode\data\rules\bsd-new_404.yml", "YAML", 0, 0, 0, 2, 0, 0, 1, 3
"d:\IDEWORK\lvmen\src\licensedcode\data\rules\bsd-new_405.yml", "YAML", 0, 0, 0, 2, 0, 0, 1, 3
"d:\IDEWORK\lvmen\src\licensedcode\data\rules\bsd-new_406.yml", "YAML", 0, 0, 0, 3, 0, 0, 1, 4
"d:\IDEWORK\lvmen\src\licensedcode\data\rules\bsd-new_407.yml", "YAML", 0, 0, 0, 2, 0, 0, 1, 3
"d:\IDEWORK\lvmen\src\licensedcode\data\rules\bsd-new_408.yml", "YAML", 0, 0, 0, 2, 0, 0, 1, 3
"d:\IDEWORK\lvmen\src\licensedcode\data\rules\bsd-new_409.yml", "YAML", 0, 0, 0, 2, 0, 0, 1, 3
"d:\IDEWORK\lvmen\src\licensedcode\data\rules\bsd-new_40_1.yml", "YAML", 0, 0, 0, 3, 0, 0, 1, 4
"d:\IDEWORK\lvmen\src\licensedcode\data\rules\bsd-new_41.yml", "YAML", 0, 0, 0, 3, 0, 0, 1, 4
"d:\IDEWORK\lvmen\src\licensedcode\data\rules\bsd-new_410.yml", "YAML", 0, 0, 0, 2, 0, 0, 1, 3
"d:\IDEWORK\lvmen\src\licensedcode\data\rules\bsd-new_411.yml", "YAML", 0, 0, 0, 2, 0, 0, 1, 3
"d:\IDEWORK\lvmen\src\licensedcode\data\rules\bsd-new_412.yml", "YAML", 0, 0, 0, 2, 0, 0, 1, 3
"d:\IDEWORK\lvmen\src\licensedcode\data\rules\bsd-new_413.yml", "YAML", 0, 0, 0, 2, 0, 0, 1, 3
"d:\IDEWORK\lvmen\src\licensedcode\data\rules\bsd-new_414.yml", "YAML", 0, 0, 0, 2, 0, 0, 1, 3
"d:\IDEWORK\lvmen\src\licensedcode\data\rules\bsd-new_415.yml", "YAML", 0, 0, 0, 3, 0, 0, 1, 4
"d:\IDEWORK\lvmen\src\licensedcode\data\rules\bsd-new_416.yml", "YAML", 0, 0, 0, 4, 0, 0, 1, 5
"d:\IDEWORK\lvmen\src\licensedcode\data\rules\bsd-new_417.yml", "YAML", 0, 0, 0, 3, 0, 0, 1, 4
"d:\IDEWORK\lvmen\src\licensedcode\data\rules\bsd-new_418.yml", "YAML", 0, 0, 0, 3, 0, 0, 1, 4
"d:\IDEWORK\lvmen\src\licensedcode\data\rules\bsd-new_419.yml", "YAML", 0, 0, 0, 3, 0, 0, 1, 4
"d:\IDEWORK\lvmen\src\licensedcode\data\rules\bsd-new_42.yml", "YAML", 0, 0, 0, 3, 0, 0, 1, 4
"d:\IDEWORK\lvmen\src\licensedcode\data\rules\bsd-new_420.yml", "YAML", 0, 0, 0, 3, 0, 0, 1, 4
"d:\IDEWORK\lvmen\src\licensedcode\data\rules\bsd-new_421.yml", "YAML", 0, 0, 0, 3, 0, 0, 1, 4
"d:\IDEWORK\lvmen\src\licensedcode\data\rules\bsd-new_422.yml", "YAML", 0, 0, 0, 5, 0, 0, 1, 6
"d:\IDEWORK\lvmen\src\licensedcode\data\rules\bsd-new_423.yml", "YAML", 0, 0, 0, 3, 0, 0, 1, 4
"d:\IDEWORK\lvmen\src\licensedcode\data\rules\bsd-new_424.yml", "YAML", 0, 0, 0, 3, 0, 0, 1, 4
"d:\IDEWORK\lvmen\src\licensedcode\data\rules\bsd-new_425.yml", "YAML", 0, 0, 0, 2, 0, 0, 1, 3
"d:\IDEWORK\lvmen\src\licensedcode\data\rules\bsd-new_426.yml", "YAML", 0, 0, 0, 5, 0, 0, 1, 6
"d:\IDEWORK\lvmen\src\licensedcode\data\rules\bsd-new_427.yml", "YAML", 0, 0, 0, 3, 0, 0, 1, 4
"d:\IDEWORK\lvmen\src\licensedcode\data\rules\bsd-new_428.yml", "YAML", 0, 0, 0, 3, 0, 0, 1, 4
"d:\IDEWORK\lvmen\src\licensedcode\data\rules\bsd-new_429.yml", "YAML", 0, 0, 0, 3, 0, 0, 1, 4
"d:\IDEWORK\lvmen\src\licensedcode\data\rules\bsd-new_43.yml", "YAML", 0, 0, 0, 5, 0, 0, 1, 6
"d:\IDEWORK\lvmen\src\licensedcode\data\rules\bsd-new_430.yml", "YAML", 0, 0, 0, 5, 0, 0, 1, 6
"d:\IDEWORK\lvmen\src\licensedcode\data\rules\bsd-new_431.yml", "YAML", 0, 0, 0, 5, 0, 0, 1, 6
"d:\IDEWORK\lvmen\src\licensedcode\data\rules\bsd-new_432.yml", "YAML", 0, 0, 0, 5, 0, 0, 1, 6
"d:\IDEWORK\lvmen\src\licensedcode\data\rules\bsd-new_433.yml", "YAML", 0, 0, 0, 2, 0, 0, 1, 3
"d:\IDEWORK\lvmen\src\licensedcode\data\rules\bsd-new_434.yml", "YAML", 0, 0, 0, 3, 0, 0, 1, 4
"d:\IDEWORK\lvmen\src\licensedcode\data\rules\bsd-new_435.yml", "YAML", 0, 0, 0, 2, 0, 0, 1, 3
"d:\IDEWORK\lvmen\src\licensedcode\data\rules\bsd-new_436.yml", "YAML", 0, 0, 0, 5, 0, 0, 1, 6
"d:\IDEWORK\lvmen\src\licensedcode\data\rules\bsd-new_437.yml", "YAML", 0, 0, 0, 5, 0, 0, 1, 6
"d:\IDEWORK\lvmen\src\licensedcode\data\rules\bsd-new_438.yml", "YAML", 0, 0, 0, 5, 0, 0, 1, 6
"d:\IDEWORK\lvmen\src\licensedcode\data\rules\bsd-new_439.yml", "YAML", 0, 0, 0, 5, 0, 0, 1, 6
"d:\IDEWORK\lvmen\src\licensedcode\data\rules\bsd-new_44.yml", "YAML", 0, 0, 0, 3, 0, 0, 1, 4
"d:\IDEWORK\lvmen\src\licensedcode\data\rules\bsd-new_440.yml", "YAML", 0, 0, 0, 3, 0, 0, 1, 4
"d:\IDEWORK\lvmen\src\licensedcode\data\rules\bsd-new_441.yml", "YAML", 0, 0, 0, 2, 0, 0, 1, 3
"d:\IDEWORK\lvmen\src\licensedcode\data\rules\bsd-new_442.yml", "YAML", 0, 0, 0, 5, 0, 0, 1, 6
"d:\IDEWORK\lvmen\src\licensedcode\data\rules\bsd-new_443.yml", "YAML", 0, 0, 0, 2, 0, 0, 1, 3
"d:\IDEWORK\lvmen\src\licensedcode\data\rules\bsd-new_444.yml", "YAML", 0, 0, 0, 2, 0, 0, 1, 3
"d:\IDEWORK\lvmen\src\licensedcode\data\rules\bsd-new_445.yml", "YAML", 0, 0, 0, 2, 0, 0, 1, 3
"d:\IDEWORK\lvmen\src\licensedcode\data\rules\bsd-new_446.yml", "YAML", 0, 0, 0, 3, 0, 0, 1, 4
"d:\IDEWORK\lvmen\src\licensedcode\data\rules\bsd-new_447.yml", "YAML", 0, 0, 0, 3, 0, 0, 1, 4
"d:\IDEWORK\lvmen\src\licensedcode\data\rules\bsd-new_448.yml", "YAML", 0, 0, 0, 5, 0, 0, 1, 6
"d:\IDEWORK\lvmen\src\licensedcode\data\rules\bsd-new_449.yml", "YAML", 0, 0, 0, 3, 0, 0, 1, 4
"d:\IDEWORK\lvmen\src\licensedcode\data\rules\bsd-new_45.yml", "YAML", 0, 0, 0, 3, 0, 0, 1, 4
"d:\IDEWORK\lvmen\src\licensedcode\data\rules\bsd-new_450.yml", "YAML", 0, 0, 0, 3, 0, 0, 1, 4
"d:\IDEWORK\lvmen\src\licensedcode\data\rules\bsd-new_451.yml", "YAML", 0, 0, 0, 5, 0, 0, 1, 6
"d:\IDEWORK\lvmen\src\licensedcode\data\rules\bsd-new_452.yml", "YAML", 0, 0, 0, 7, 0, 0, 1, 8
"d:\IDEWORK\lvmen\src\licensedcode\data\rules\bsd-new_453.yml", "YAML", 0, 0, 0, 3, 0, 0, 1, 4
"d:\IDEWORK\lvmen\src\licensedcode\data\rules\bsd-new_454.yml", "YAML", 0, 0, 0, 5, 0, 0, 1, 6
"d:\IDEWORK\lvmen\src\licensedcode\data\rules\bsd-new_455.yml", "YAML", 0, 0, 0, 3, 0, 0, 1, 4
"d:\IDEWORK\lvmen\src\licensedcode\data\rules\bsd-new_456.yml", "YAML", 0, 0, 0, 3, 0, 0, 1, 4
"d:\IDEWORK\lvmen\src\licensedcode\data\rules\bsd-new_457.yml", "YAML", 0, 0, 0, 3, 0, 0, 1, 4
"d:\IDEWORK\lvmen\src\licensedcode\data\rules\bsd-new_458.yml", "YAML", 0, 0, 0, 3, 0, 0, 1, 4
"d:\IDEWORK\lvmen\src\licensedcode\data\rules\bsd-new_459.yml", "YAML", 0, 0, 0, 3, 0, 0, 1, 4
"d:\IDEWORK\lvmen\src\licensedcode\data\rules\bsd-new_46.yml", "YAML", 0, 0, 0, 3, 0, 0, 1, 4
"d:\IDEWORK\lvmen\src\licensedcode\data\rules\bsd-new_460.yml", "YAML", 0, 0, 0, 3, 0, 0, 1, 4
"d:\IDEWORK\lvmen\src\licensedcode\data\rules\bsd-new_461.yml", "YAML", 0, 0, 0, 3, 0, 0, 1, 4
"d:\IDEWORK\lvmen\src\licensedcode\data\rules\bsd-new_462.yml", "YAML", 0, 0, 0, 3, 0, 0, 1, 4
"d:\IDEWORK\lvmen\src\licensedcode\data\rules\bsd-new_463.yml", "YAML", 0, 0, 0, 3, 0, 0, 1, 4
"d:\IDEWORK\lvmen\src\licensedcode\data\rules\bsd-new_464.yml", "YAML", 0, 0, 0, 3, 0, 0, 1, 4
"d:\IDEWORK\lvmen\src\licensedcode\data\rules\bsd-new_465.yml", "YAML", 0, 0, 0, 3, 0, 0, 1, 4
"d:\IDEWORK\lvmen\src\licensedcode\data\rules\bsd-new_466.yml", "YAML", 0, 0, 0, 3, 0, 0, 1, 4
"d:\IDEWORK\lvmen\src\licensedcode\data\rules\bsd-new_467.yml", "YAML", 0, 0, 0, 5, 0, 0, 1, 6
"d:\IDEWORK\lvmen\src\licensedcode\data\rules\bsd-new_468.yml", "YAML", 0, 0, 0, 5, 0, 0, 1, 6
"d:\IDEWORK\lvmen\src\licensedcode\data\rules\bsd-new_469.yml", "YAML", 0, 0, 0, 5, 0, 0, 1, 6
"d:\IDEWORK\lvmen\src\licensedcode\data\rules\bsd-new_47.yml", "YAML", 0, 0, 0, 2, 0, 0, 1, 3
"d:\IDEWORK\lvmen\src\licensedcode\data\rules\bsd-new_470.yml", "YAML", 0, 0, 0, 3, 0, 0, 1, 4
"d:\IDEWORK\lvmen\src\licensedcode\data\rules\bsd-new_471.yml", "YAML", 0, 0, 0, 3, 0, 0, 1, 4
"d:\IDEWORK\lvmen\src\licensedcode\data\rules\bsd-new_472.yml", "YAML", 0, 0, 0, 3, 0, 0, 1, 4
"d:\IDEWORK\lvmen\src\licensedcode\data\rules\bsd-new_473.yml", "YAML", 0, 0, 0, 3, 0, 0, 1, 4
"d:\IDEWORK\lvmen\src\licensedcode\data\rules\bsd-new_474.yml", "YAML", 0, 0, 0, 5, 0, 0, 1, 6
"d:\IDEWORK\lvmen\src\licensedcode\data\rules\bsd-new_475.yml", "YAML", 0, 0, 0, 3, 0, 0, 1, 4
"d:\IDEWORK\lvmen\src\licensedcode\data\rules\bsd-new_476.yml", "YAML", 0, 0, 0, 3, 0, 0, 1, 4
"d:\IDEWORK\lvmen\src\licensedcode\data\rules\bsd-new_477.yml", "YAML", 0, 0, 0, 3, 0, 0, 1, 4
"d:\IDEWORK\lvmen\src\licensedcode\data\rules\bsd-new_478.yml", "YAML", 0, 0, 0, 3, 0, 0, 1, 4
"d:\IDEWORK\lvmen\src\licensedcode\data\rules\bsd-new_479.yml", "YAML", 0, 0, 0, 3, 0, 0, 1, 4
"d:\IDEWORK\lvmen\src\licensedcode\data\rules\bsd-new_48.yml", "YAML", 0, 0, 0, 2, 0, 0, 1, 3
"d:\IDEWORK\lvmen\src\licensedcode\data\rules\bsd-new_480.yml", "YAML", 0, 0, 0, 3, 0, 0, 1, 4
"d:\IDEWORK\lvmen\src\licensedcode\data\rules\bsd-new_481.yml", "YAML", 0, 0, 0, 3, 0, 0, 1, 4
"d:\IDEWORK\lvmen\src\licensedcode\data\rules\bsd-new_482.yml", "YAML", 0, 0, 0, 3, 0, 0, 1, 4
"d:\IDEWORK\lvmen\src\licensedcode\data\rules\bsd-new_483.yml", "YAML", 0, 0, 0, 3, 0, 0, 1, 4
"d:\IDEWORK\lvmen\src\licensedcode\data\rules\bsd-new_484.yml", "YAML", 0, 0, 0, 5, 0, 0, 1, 6
"d:\IDEWORK\lvmen\src\licensedcode\data\rules\bsd-new_485.yml", "YAML", 0, 0, 0, 5, 0, 0, 1, 6
"d:\IDEWORK\lvmen\src\licensedcode\data\rules\bsd-new_486.yml", "YAML", 0, 0, 0, 5, 0, 0, 1, 6
"d:\IDEWORK\lvmen\src\licensedcode\data\rules\bsd-new_487.yml", "YAML", 0, 0, 0, 5, 0, 0, 1, 6
"d:\IDEWORK\lvmen\src\licensedcode\data\rules\bsd-new_488.yml", "YAML", 0, 0, 0, 3, 0, 0, 1, 4
"d:\IDEWORK\lvmen\src\licensedcode\data\rules\bsd-new_489.yml", "YAML", 0, 0, 0, 3, 0, 0, 1, 4
"d:\IDEWORK\lvmen\src\licensedcode\data\rules\bsd-new_49.yml", "YAML", 0, 0, 0, 2, 0, 0, 1, 3
"d:\IDEWORK\lvmen\src\licensedcode\data\rules\bsd-new_490.yml", "YAML", 0, 0, 0, 3, 0, 0, 1, 4
"d:\IDEWORK\lvmen\src\licensedcode\data\rules\bsd-new_491.yml", "YAML", 0, 0, 0, 3, 0, 0, 1, 4
"d:\IDEWORK\lvmen\src\licensedcode\data\rules\bsd-new_492.yml", "YAML", 0, 0, 0, 3, 0, 0, 1, 4
"d:\IDEWORK\lvmen\src\licensedcode\data\rules\bsd-new_493.yml", "YAML", 0, 0, 0, 3, 0, 0, 1, 4
"d:\IDEWORK\lvmen\src\licensedcode\data\rules\bsd-new_494.yml", "YAML", 0, 0, 0, 3, 0, 0, 1, 4
"d:\IDEWORK\lvmen\src\licensedcode\data\rules\bsd-new_495.yml", "YAML", 0, 0, 0, 5, 0, 0, 1, 6
"d:\IDEWORK\lvmen\src\licensedcode\data\rules\bsd-new_496.yml", "YAML", 0, 0, 0, 3, 0, 0, 1, 4
"d:\IDEWORK\lvmen\src\licensedcode\data\rules\bsd-new_497.yml", "YAML", 0, 0, 0, 3, 0, 0, 1, 4
"d:\IDEWORK\lvmen\src\licensedcode\data\rules\bsd-new_498.yml", "YAML", 0, 0, 0, 3, 0, 0, 1, 4
"d:\IDEWORK\lvmen\src\licensedcode\data\rules\bsd-new_499.yml", "YAML", 0, 0, 0, 2, 0, 0, 1, 3
"d:\IDEWORK\lvmen\src\licensedcode\data\rules\bsd-new_5.yml", "YAML", 0, 0, 0, 2, 0, 0, 1, 3
"d:\IDEWORK\lvmen\src\licensedcode\data\rules\bsd-new_50.yml", "YAML", 0, 0, 0, 5, 0, 0, 1, 6
"d:\IDEWORK\lvmen\src\licensedcode\data\rules\bsd-new_500.yml", "YAML", 0, 0, 0, 3, 0, 0, 1, 4
"d:\IDEWORK\lvmen\src\licensedcode\data\rules\bsd-new_501.yml", "YAML", 0, 0, 0, 7, 0, 0, 1, 8
"d:\IDEWORK\lvmen\src\licensedcode\data\rules\bsd-new_502.yml", "YAML", 0, 0, 0, 4, 0, 0, 1, 5
"d:\IDEWORK\lvmen\src\licensedcode\data\rules\bsd-new_503.yml", "YAML", 0, 0, 0, 3, 0, 0, 1, 4
"d:\IDEWORK\lvmen\src\licensedcode\data\rules\bsd-new_504.yml", "YAML", 0, 0, 0, 3, 0, 0, 1, 4
"d:\IDEWORK\lvmen\src\licensedcode\data\rules\bsd-new_505.yml", "YAML", 0, 0, 0, 7, 0, 0, 1, 8
"d:\IDEWORK\lvmen\src\licensedcode\data\rules\bsd-new_506.yml", "YAML", 0, 0, 0, 3, 0, 0, 1, 4
"d:\IDEWORK\lvmen\src\licensedcode\data\rules\bsd-new_507.yml", "YAML", 0, 0, 0, 3, 0, 0, 1, 4
"d:\IDEWORK\lvmen\src\licensedcode\data\rules\bsd-new_508.yml", "YAML", 0, 0, 0, 3, 0, 0, 1, 4
"d:\IDEWORK\lvmen\src\licensedcode\data\rules\bsd-new_509.yml", "YAML", 0, 0, 0, 3, 0, 0, 1, 4
"d:\IDEWORK\lvmen\src\licensedcode\data\rules\bsd-new_51.yml", "YAML", 0, 0, 0, 5, 0, 0, 1, 6
"d:\IDEWORK\lvmen\src\licensedcode\data\rules\bsd-new_510.yml", "YAML", 0, 0, 0, 3, 0, 0, 1, 4
"d:\IDEWORK\lvmen\src\licensedcode\data\rules\bsd-new_511.yml", "YAML", 0, 0, 0, 3, 0, 0, 1, 4
"d:\IDEWORK\lvmen\src\licensedcode\data\rules\bsd-new_512.yml", "YAML", 0, 0, 0, 5, 0, 0, 1, 6
"d:\IDEWORK\lvmen\src\licensedcode\data\rules\bsd-new_513.yml", "YAML", 0, 0, 0, 5, 0, 0, 1, 6
"d:\IDEWORK\lvmen\src\licensedcode\data\rules\bsd-new_514.yml", "YAML", 0, 0, 0, 5, 0, 0, 1, 6
"d:\IDEWORK\lvmen\src\licensedcode\data\rules\bsd-new_515.yml", "YAML", 0, 0, 0, 3, 0, 0, 1, 4
"d:\IDEWORK\lvmen\src\licensedcode\data\rules\bsd-new_516.yml", "YAML", 0, 0, 0, 5, 0, 0, 1, 6
"d:\IDEWORK\lvmen\src\licensedcode\data\rules\bsd-new_517.yml", "YAML", 0, 0, 0, 3, 0, 0, 1, 4
"d:\IDEWORK\lvmen\src\licensedcode\data\rules\bsd-new_518.yml", "YAML", 0, 0, 0, 3, 0, 0, 1, 4
"d:\IDEWORK\lvmen\src\licensedcode\data\rules\bsd-new_519.yml", "YAML", 0, 0, 0, 3, 0, 0, 1, 4
"d:\IDEWORK\lvmen\src\licensedcode\data\rules\bsd-new_52.yml", "YAML", 0, 0, 0, 3, 0, 0, 1, 4
"d:\IDEWORK\lvmen\src\licensedcode\data\rules\bsd-new_520.yml", "YAML", 0, 0, 0, 3, 0, 0, 1, 4
"d:\IDEWORK\lvmen\src\licensedcode\data\rules\bsd-new_521.yml", "YAML", 0, 0, 0, 3, 0, 0, 1, 4
"d:\IDEWORK\lvmen\src\licensedcode\data\rules\bsd-new_522.yml", "YAML", 0, 0, 0, 7, 0, 0, 1, 8
"d:\IDEWORK\lvmen\src\licensedcode\data\rules\bsd-new_523.yml", "YAML", 0, 0, 0, 3, 0, 0, 1, 4
"d:\IDEWORK\lvmen\src\licensedcode\data\rules\bsd-new_524.yml", "YAML", 0, 0, 0, 4, 0, 0, 1, 5
"d:\IDEWORK\lvmen\src\licensedcode\data\rules\bsd-new_525.yml", "YAML", 0, 0, 0, 5, 0, 0, 1, 6
"d:\IDEWORK\lvmen\src\licensedcode\data\rules\bsd-new_526.yml", "YAML", 0, 0, 0, 3, 0, 0, 1, 4
"d:\IDEWORK\lvmen\src\licensedcode\data\rules\bsd-new_527.yml", "YAML", 0, 0, 0, 3, 0, 0, 1, 4
"d:\IDEWORK\lvmen\src\licensedcode\data\rules\bsd-new_528.yml", "YAML", 0, 0, 0, 3, 0, 0, 1, 4
"d:\IDEWORK\lvmen\src\licensedcode\data\rules\bsd-new_529.yml", "YAML", 0, 0, 0, 3, 0, 0, 1, 4
"d:\IDEWORK\lvmen\src\licensedcode\data\rules\bsd-new_53.yml", "YAML", 0, 0, 0, 4, 0, 0, 1, 5
"d:\IDEWORK\lvmen\src\licensedcode\data\rules\bsd-new_530.yml", "YAML", 0, 0, 0, 5, 0, 0, 1, 6
"d:\IDEWORK\lvmen\src\licensedcode\data\rules\bsd-new_531.yml", "YAML", 0, 0, 0, 5, 0, 0, 1, 6
"d:\IDEWORK\lvmen\src\licensedcode\data\rules\bsd-new_532.yml", "YAML", 0, 0, 0, 5, 0, 0, 1, 6
"d:\IDEWORK\lvmen\src\licensedcode\data\rules\bsd-new_533.yml", "YAML", 0, 0, 0, 3, 0, 0, 1, 4
"d:\IDEWORK\lvmen\src\licensedcode\data\rules\bsd-new_534.yml", "YAML", 0, 0, 0, 3, 0, 0, 1, 4
"d:\IDEWORK\lvmen\src\licensedcode\data\rules\bsd-new_535.yml", "YAML", 0, 0, 0, 3, 0, 0, 1, 4
"d:\IDEWORK\lvmen\src\licensedcode\data\rules\bsd-new_536.yml", "YAML", 0, 0, 0, 5, 0, 0, 1, 6
"d:\IDEWORK\lvmen\src\licensedcode\data\rules\bsd-new_537.yml", "YAML", 0, 0, 0, 5, 0, 0, 1, 6
"d:\IDEWORK\lvmen\src\licensedcode\data\rules\bsd-new_538.yml", "YAML", 0, 0, 0, 5, 0, 0, 1, 6
"d:\IDEWORK\lvmen\src\licensedcode\data\rules\bsd-new_539.yml", "YAML", 0, 0, 0, 3, 0, 0, 1, 4
"d:\IDEWORK\lvmen\src\licensedcode\data\rules\bsd-new_54.yml", "YAML", 0, 0, 0, 3, 0, 0, 1, 4
"d:\IDEWORK\lvmen\src\licensedcode\data\rules\bsd-new_540.yml", "YAML", 0, 0, 0, 5, 0, 0, 1, 6
"d:\IDEWORK\lvmen\src\licensedcode\data\rules\bsd-new_541.yml", "YAML", 0, 0, 0, 3, 0, 0, 1, 4
"d:\IDEWORK\lvmen\src\licensedcode\data\rules\bsd-new_542.yml", "YAML", 0, 0, 0, 3, 0, 0, 1, 4
"d:\IDEWORK\lvmen\src\licensedcode\data\rules\bsd-new_543.yml", "YAML", 0, 0, 0, 6, 0, 0, 1, 7
"d:\IDEWORK\lvmen\src\licensedcode\data\rules\bsd-new_544.yml", "YAML", 0, 0, 0, 3, 0, 0, 1, 4
"d:\IDEWORK\lvmen\src\licensedcode\data\rules\bsd-new_545.yml", "YAML", 0, 0, 0, 3, 0, 0, 1, 4
"d:\IDEWORK\lvmen\src\licensedcode\data\rules\bsd-new_546.yml", "YAML", 0, 0, 0, 3, 0, 0, 1, 4
"d:\IDEWORK\lvmen\src\licensedcode\data\rules\bsd-new_547.yml", "YAML", 0, 0, 0, 3, 0, 0, 1, 4
"d:\IDEWORK\lvmen\src\licensedcode\data\rules\bsd-new_548.yml", "YAML", 0, 0, 0, 5, 0, 0, 1, 6
"d:\IDEWORK\lvmen\src\licensedcode\data\rules\bsd-new_549.yml", "YAML", 0, 0, 0, 3, 0, 0, 1, 4
"d:\IDEWORK\lvmen\src\licensedcode\data\rules\bsd-new_55.yml", "YAML", 0, 0, 0, 3, 0, 0, 1, 4
"d:\IDEWORK\lvmen\src\licensedcode\data\rules\bsd-new_550.yml", "YAML", 0, 0, 0, 5, 0, 0, 1, 6
"d:\IDEWORK\lvmen\src\licensedcode\data\rules\bsd-new_551.yml", "YAML", 0, 0, 0, 5, 0, 0, 1, 6
"d:\IDEWORK\lvmen\src\licensedcode\data\rules\bsd-new_552.yml", "YAML", 0, 0, 0, 5, 0, 0, 1, 6
"d:\IDEWORK\lvmen\src\licensedcode\data\rules\bsd-new_553.yml", "YAML", 0, 0, 0, 5, 0, 0, 1, 6
"d:\IDEWORK\lvmen\src\licensedcode\data\rules\bsd-new_554.yml", "YAML", 0, 0, 0, 3, 0, 0, 1, 4
"d:\IDEWORK\lvmen\src\licensedcode\data\rules\bsd-new_555.yml", "YAML", 0, 0, 0, 3, 0, 0, 1, 4
"d:\IDEWORK\lvmen\src\licensedcode\data\rules\bsd-new_556.yml", "YAML", 0, 0, 0, 5, 0, 0, 1, 6
"d:\IDEWORK\lvmen\src\licensedcode\data\rules\bsd-new_557.yml", "YAML", 0, 0, 0, 5, 0, 0, 1, 6
"d:\IDEWORK\lvmen\src\licensedcode\data\rules\bsd-new_558.yml", "YAML", 0, 0, 0, 3, 0, 0, 1, 4
"d:\IDEWORK\lvmen\src\licensedcode\data\rules\bsd-new_559.yml", "YAML", 0, 0, 0, 5, 0, 0, 1, 6
"d:\IDEWORK\lvmen\src\licensedcode\data\rules\bsd-new_56.yml", "YAML", 0, 0, 0, 3, 0, 0, 1, 4
"d:\IDEWORK\lvmen\src\licensedcode\data\rules\bsd-new_560.yml", "YAML", 0, 0, 0, 5, 0, 0, 1, 6
"d:\IDEWORK\lvmen\src\licensedcode\data\rules\bsd-new_561.yml", "YAML", 0, 0, 0, 5, 0, 0, 1, 6
"d:\IDEWORK\lvmen\src\licensedcode\data\rules\bsd-new_562.yml", "YAML", 0, 0, 0, 5, 0, 0, 1, 6
"d:\IDEWORK\lvmen\src\licensedcode\data\rules\bsd-new_563.yml", "YAML", 0, 0, 0, 5, 0, 0, 1, 6
"d:\IDEWORK\lvmen\src\licensedcode\data\rules\bsd-new_564.yml", "YAML", 0, 0, 0, 5, 0, 0, 1, 6
"d:\IDEWORK\lvmen\src\licensedcode\data\rules\bsd-new_565.yml", "YAML", 0, 0, 0, 5, 0, 0, 1, 6
"d:\IDEWORK\lvmen\src\licensedcode\data\rules\bsd-new_566.yml", "YAML", 0, 0, 0, 5, 0, 0, 1, 6
"d:\IDEWORK\lvmen\src\licensedcode\data\rules\bsd-new_567.yml", "YAML", 0, 0, 0, 5, 0, 0, 1, 6
"d:\IDEWORK\lvmen\src\licensedcode\data\rules\bsd-new_568.yml", "YAML", 0, 0, 0, 5, 0, 0, 1, 6
"d:\IDEWORK\lvmen\src\licensedcode\data\rules\bsd-new_569.yml", "YAML", 0, 0, 0, 5, 0, 0, 1, 6
"d:\IDEWORK\lvmen\src\licensedcode\data\rules\bsd-new_57.yml", "YAML", 0, 0, 0, 2, 0, 0, 1, 3
"d:\IDEWORK\lvmen\src\licensedcode\data\rules\bsd-new_570.yml", "YAML", 0, 0, 0, 5, 0, 0, 1, 6
"d:\IDEWORK\lvmen\src\licensedcode\data\rules\bsd-new_571.yml", "YAML", 0, 0, 0, 3, 0, 0, 1, 4
"d:\IDEWORK\lvmen\src\licensedcode\data\rules\bsd-new_572.yml", "YAML", 0, 0, 0, 5, 0, 0, 1, 6
"d:\IDEWORK\lvmen\src\licensedcode\data\rules\bsd-new_573.yml", "YAML", 0, 0, 0, 3, 0, 0, 1, 4
"d:\IDEWORK\lvmen\src\licensedcode\data\rules\bsd-new_574.yml", "YAML", 0, 0, 0, 3, 0, 0, 1, 4
"d:\IDEWORK\lvmen\src\licensedcode\data\rules\bsd-new_575.yml", "YAML", 0, 0, 0, 5, 0, 0, 1, 6
"d:\IDEWORK\lvmen\src\licensedcode\data\rules\bsd-new_576.yml", "YAML", 0, 0, 0, 3, 0, 0, 1, 4
"d:\IDEWORK\lvmen\src\licensedcode\data\rules\bsd-new_577.yml", "YAML", 0, 0, 0, 3, 0, 0, 1, 4
"d:\IDEWORK\lvmen\src\licensedcode\data\rules\bsd-new_578.yml", "YAML", 0, 0, 0, 4, 0, 0, 1, 5
"d:\IDEWORK\lvmen\src\licensedcode\data\rules\bsd-new_579.yml", "YAML", 0, 0, 0, 3, 0, 0, 1, 4
"d:\IDEWORK\lvmen\src\licensedcode\data\rules\bsd-new_58.yml", "YAML", 0, 0, 0, 6, 0, 0, 1, 7
"d:\IDEWORK\lvmen\src\licensedcode\data\rules\bsd-new_580.yml", "YAML", 0, 0, 0, 3, 0, 0, 1, 4
"d:\IDEWORK\lvmen\src\licensedcode\data\rules\bsd-new_581.yml", "YAML", 0, 0, 0, 3, 0, 0, 1, 4
"d:\IDEWORK\lvmen\src\licensedcode\data\rules\bsd-new_582.yml", "YAML", 0, 0, 0, 3, 0, 0, 1, 4
"d:\IDEWORK\lvmen\src\licensedcode\data\rules\bsd-new_583.yml", "YAML", 0, 0, 0, 3, 0, 0, 1, 4
"d:\IDEWORK\lvmen\src\licensedcode\data\rules\bsd-new_584.yml", "YAML", 0, 0, 0, 3, 0, 0, 1, 4
"d:\IDEWORK\lvmen\src\licensedcode\data\rules\bsd-new_585.yml", "YAML", 0, 0, 0, 3, 0, 0, 1, 4
"d:\IDEWORK\lvmen\src\licensedcode\data\rules\bsd-new_586.yml", "YAML", 0, 0, 0, 3, 0, 0, 1, 4
"d:\IDEWORK\lvmen\src\licensedcode\data\rules\bsd-new_587.yml", "YAML", 0, 0, 0, 3, 0, 0, 1, 4
"d:\IDEWORK\lvmen\src\licensedcode\data\rules\bsd-new_588.yml", "YAML", 0, 0, 0, 3, 0, 0, 1, 4
"d:\IDEWORK\lvmen\src\licensedcode\data\rules\bsd-new_589.yml", "YAML", 0, 0, 0, 3, 0, 0, 1, 4
"d:\IDEWORK\lvmen\src\licensedcode\data\rules\bsd-new_59.yml", "YAML", 0, 0, 0, 2, 0, 0, 1, 3
"d:\IDEWORK\lvmen\src\licensedcode\data\rules\bsd-new_590.yml", "YAML", 0, 0, 0, 3, 0, 0, 1, 4
"d:\IDEWORK\lvmen\src\licensedcode\data\rules\bsd-new_591.yml", "YAML", 0, 0, 0, 3, 0, 0, 1, 4
"d:\IDEWORK\lvmen\src\licensedcode\data\rules\bsd-new_592.yml", "YAML", 0, 0, 0, 3, 0, 0, 1, 4
"d:\IDEWORK\lvmen\src\licensedcode\data\rules\bsd-new_593.yml", "YAML", 0, 0, 0, 4, 0, 0, 1, 5
"d:\IDEWORK\lvmen\src\licensedcode\data\rules\bsd-new_594.yml", "YAML", 0, 0, 0, 3, 0, 0, 1, 4
"d:\IDEWORK\lvmen\src\licensedcode\data\rules\bsd-new_595.yml", "YAML", 0, 0, 0, 3, 0, 0, 1, 4
"d:\IDEWORK\lvmen\src\licensedcode\data\rules\bsd-new_596.yml", "YAML", 0, 0, 0, 3, 0, 0, 1, 4
"d:\IDEWORK\lvmen\src\licensedcode\data\rules\bsd-new_597.yml", "YAML", 0, 0, 0, 5, 0, 0, 1, 6
"d:\IDEWORK\lvmen\src\licensedcode\data\rules\bsd-new_598.yml", "YAML", 0, 0, 0, 3, 0, 0, 1, 4
"d:\IDEWORK\lvmen\src\licensedcode\data\rules\bsd-new_599.yml", "YAML", 0, 0, 0, 3, 0, 0, 1, 4
"d:\IDEWORK\lvmen\src\licensedcode\data\rules\bsd-new_6.yml", "YAML", 0, 0, 0, 4, 0, 0, 1, 5
"d:\IDEWORK\lvmen\src\licensedcode\data\rules\bsd-new_60.yml", "YAML", 0, 0, 0, 2, 0, 0, 1, 3
"d:\IDEWORK\lvmen\src\licensedcode\data\rules\bsd-new_600.yml", "YAML", 0, 0, 0, 3, 0, 0, 1, 4
"d:\IDEWORK\lvmen\src\licensedcode\data\rules\bsd-new_601.yml", "YAML", 0, 0, 0, 3, 0, 0, 1, 4
"d:\IDEWORK\lvmen\src\licensedcode\data\rules\bsd-new_602.yml", "YAML", 0, 0, 0, 3, 0, 0, 1, 4
"d:\IDEWORK\lvmen\src\licensedcode\data\rules\bsd-new_603.yml", "YAML", 0, 0, 0, 5, 0, 0, 1, 6
"d:\IDEWORK\lvmen\src\licensedcode\data\rules\bsd-new_604.yml", "YAML", 0, 0, 0, 6, 0, 0, 1, 7
"d:\IDEWORK\lvmen\src\licensedcode\data\rules\bsd-new_605.yml", "YAML", 0, 0, 0, 3, 0, 0, 1, 4
"d:\IDEWORK\lvmen\src\licensedcode\data\rules\bsd-new_606.yml", "YAML", 0, 0, 0, 3, 0, 0, 1, 4
"d:\IDEWORK\lvmen\src\licensedcode\data\rules\bsd-new_607.yml", "YAML", 0, 0, 0, 5, 0, 0, 1, 6
"d:\IDEWORK\lvmen\src\licensedcode\data\rules\bsd-new_608.yml", "YAML", 0, 0, 0, 3, 0, 0, 1, 4
"d:\IDEWORK\lvmen\src\licensedcode\data\rules\bsd-new_609.yml", "YAML", 0, 0, 0, 5, 0, 0, 1, 6
"d:\IDEWORK\lvmen\src\licensedcode\data\rules\bsd-new_61.yml", "YAML", 0, 0, 0, 5, 0, 0, 1, 6
"d:\IDEWORK\lvmen\src\licensedcode\data\rules\bsd-new_610.yml", "YAML", 0, 0, 0, 3, 0, 0, 1, 4
"d:\IDEWORK\lvmen\src\licensedcode\data\rules\bsd-new_611.yml", "YAML", 0, 0, 0, 5, 0, 0, 1, 6
"d:\IDEWORK\lvmen\src\licensedcode\data\rules\bsd-new_612.yml", "YAML", 0, 0, 0, 3, 0, 0, 1, 4
"d:\IDEWORK\lvmen\src\licensedcode\data\rules\bsd-new_613.yml", "YAML", 0, 0, 0, 5, 0, 0, 1, 6
"d:\IDEWORK\lvmen\src\licensedcode\data\rules\bsd-new_614.yml", "YAML", 0, 0, 0, 5, 0, 0, 1, 6
"d:\IDEWORK\lvmen\src\licensedcode\data\rules\bsd-new_615.yml", "YAML", 0, 0, 0, 3, 0, 0, 1, 4
"d:\IDEWORK\lvmen\src\licensedcode\data\rules\bsd-new_616.yml", "YAML", 0, 0, 0, 5, 0, 0, 1, 6
"d:\IDEWORK\lvmen\src\licensedcode\data\rules\bsd-new_617.yml", "YAML", 0, 0, 0, 3, 0, 0, 1, 4
"d:\IDEWORK\lvmen\src\licensedcode\data\rules\bsd-new_618.yml", "YAML", 0, 0, 0, 3, 0, 0, 1, 4
"d:\IDEWORK\lvmen\src\licensedcode\data\rules\bsd-new_619.yml", "YAML", 0, 0, 0, 3, 0, 0, 1, 4
"d:\IDEWORK\lvmen\src\licensedcode\data\rules\bsd-new_62.yml", "YAML", 0, 0, 0, 6, 0, 0, 1, 7
"d:\IDEWORK\lvmen\src\licensedcode\data\rules\bsd-new_620.yml", "YAML", 0, 0, 0, 3, 0, 0, 1, 4
"d:\IDEWORK\lvmen\src\licensedcode\data\rules\bsd-new_621.yml", "YAML", 0, 0, 0, 3, 0, 0, 1, 4
"d:\IDEWORK\lvmen\src\licensedcode\data\rules\bsd-new_622.yml", "YAML", 0, 0, 0, 3, 0, 0, 1, 4
"d:\IDEWORK\lvmen\src\licensedcode\data\rules\bsd-new_623.yml", "YAML", 0, 0, 0, 3, 0, 0, 1, 4
"d:\IDEWORK\lvmen\src\licensedcode\data\rules\bsd-new_624.yml", "YAML", 0, 0, 0, 4, 0, 0, 1, 5
"d:\IDEWORK\lvmen\src\licensedcode\data\rules\bsd-new_625.yml", "YAML", 0, 0, 0, 3, 0, 0, 1, 4
"d:\IDEWORK\lvmen\src\licensedcode\data\rules\bsd-new_626.yml", "YAML", 0, 0, 0, 3, 0, 0, 1, 4
"d:\IDEWORK\lvmen\src\licensedcode\data\rules\bsd-new_627.yml", "YAML", 0, 0, 0, 5, 0, 0, 1, 6
"d:\IDEWORK\lvmen\src\licensedcode\data\rules\bsd-new_628.yml", "YAML", 0, 0, 0, 3, 0, 0, 1, 4
"d:\IDEWORK\lvmen\src\licensedcode\data\rules\bsd-new_629.yml", "YAML", 0, 0, 0, 3, 0, 0, 1, 4
"d:\IDEWORK\lvmen\src\licensedcode\data\rules\bsd-new_63.yml", "YAML", 0, 0, 0, 7, 0, 0, 1, 8
"d:\IDEWORK\lvmen\src\licensedcode\data\rules\bsd-new_630.yml", "YAML", 0, 0, 0, 7, 0, 0, 1, 8
"d:\IDEWORK\lvmen\src\licensedcode\data\rules\bsd-new_631.yml", "YAML", 0, 0, 0, 3, 0, 0, 1, 4
"d:\IDEWORK\lvmen\src\licensedcode\data\rules\bsd-new_632.yml", "YAML", 0, 0, 0, 4, 0, 0, 1, 5
"d:\IDEWORK\lvmen\src\licensedcode\data\rules\bsd-new_633.yml", "YAML", 0, 0, 0, 4, 0, 0, 1, 5
"d:\IDEWORK\lvmen\src\licensedcode\data\rules\bsd-new_634.yml", "YAML", 0, 0, 0, 3, 0, 0, 1, 4
"d:\IDEWORK\lvmen\src\licensedcode\data\rules\bsd-new_635.yml", "YAML", 0, 0, 0, 3, 0, 0, 1, 4
"d:\IDEWORK\lvmen\src\licensedcode\data\rules\bsd-new_636.yml", "YAML", 0, 0, 0, 3, 0, 0, 1, 4
"d:\IDEWORK\lvmen\src\licensedcode\data\rules\bsd-new_637.yml", "YAML", 0, 0, 0, 3, 0, 0, 1, 4
"d:\IDEWORK\lvmen\src\licensedcode\data\rules\bsd-new_638.yml", "YAML", 0, 0, 0, 5, 0, 0, 1, 6
"d:\IDEWORK\lvmen\src\licensedcode\data\rules\bsd-new_639.yml", "YAML", 0, 0, 0, 3, 0, 0, 1, 4
"d:\IDEWORK\lvmen\src\licensedcode\data\rules\bsd-new_64.yml", "YAML", 0, 0, 0, 2, 0, 0, 1, 3
"d:\IDEWORK\lvmen\src\licensedcode\data\rules\bsd-new_640.yml", "YAML", 0, 0, 0, 3, 0, 0, 1, 4
"d:\IDEWORK\lvmen\src\licensedcode\data\rules\bsd-new_641.yml", "YAML", 0, 0, 0, 3, 0, 0, 1, 4
"d:\IDEWORK\lvmen\src\licensedcode\data\rules\bsd-new_642.yml", "YAML", 0, 0, 0, 3, 0, 0, 1, 4
"d:\IDEWORK\lvmen\src\licensedcode\data\rules\bsd-new_643.yml", "YAML", 0, 0, 0, 3, 0, 0, 1, 4
"d:\IDEWORK\lvmen\src\licensedcode\data\rules\bsd-new_644.yml", "YAML", 0, 0, 0, 3, 0, 0, 1, 4
"d:\IDEWORK\lvmen\src\licensedcode\data\rules\bsd-new_645.yml", "YAML", 0, 0, 0, 3, 0, 0, 1, 4
"d:\IDEWORK\lvmen\src\licensedcode\data\rules\bsd-new_646.yml", "YAML", 0, 0, 0, 4, 0, 0, 1, 5
"d:\IDEWORK\lvmen\src\licensedcode\data\rules\bsd-new_647.yml", "YAML", 0, 0, 0, 3, 0, 0, 1, 4
"d:\IDEWORK\lvmen\src\licensedcode\data\rules\bsd-new_648.yml", "YAML", 0, 0, 0, 3, 0, 0, 1, 4
"d:\IDEWORK\lvmen\src\licensedcode\data\rules\bsd-new_649.yml", "YAML", 0, 0, 0, 3, 0, 0, 1, 4
"d:\IDEWORK\lvmen\src\licensedcode\data\rules\bsd-new_65.yml", "YAML", 0, 0, 0, 3, 0, 0, 1, 4
"d:\IDEWORK\lvmen\src\licensedcode\data\rules\bsd-new_650.yml", "YAML", 0, 0, 0, 3, 0, 0, 1, 4
"d:\IDEWORK\lvmen\src\licensedcode\data\rules\bsd-new_651.yml", "YAML", 0, 0, 0, 3, 0, 0, 1, 4
"d:\IDEWORK\lvmen\src\licensedcode\data\rules\bsd-new_652.yml", "YAML", 0, 0, 0, 3, 0, 0, 1, 4
"d:\IDEWORK\lvmen\src\licensedcode\data\rules\bsd-new_653.yml", "YAML", 0, 0, 0, 4, 0, 0, 1, 5
"d:\IDEWORK\lvmen\src\licensedcode\data\rules\bsd-new_654.yml", "YAML", 0, 0, 0, 3, 0, 0, 1, 4
"d:\IDEWORK\lvmen\src\licensedcode\data\rules\bsd-new_655.yml", "YAML", 0, 0, 0, 3, 0, 0, 1, 4
"d:\IDEWORK\lvmen\src\licensedcode\data\rules\bsd-new_656.yml", "YAML", 0, 0, 0, 6, 0, 0, 1, 7
"d:\IDEWORK\lvmen\src\licensedcode\data\rules\bsd-new_657.yml", "YAML", 0, 0, 0, 6, 0, 0, 1, 7
"d:\IDEWORK\lvmen\src\licensedcode\data\rules\bsd-new_658.yml", "YAML", 0, 0, 0, 6, 0, 0, 1, 7
"d:\IDEWORK\lvmen\src\licensedcode\data\rules\bsd-new_659.yml", "YAML", 0, 0, 0, 6, 0, 0, 1, 7
"d:\IDEWORK\lvmen\src\licensedcode\data\rules\bsd-new_66.yml", "YAML", 0, 0, 0, 2, 0, 0, 1, 3
"d:\IDEWORK\lvmen\src\licensedcode\data\rules\bsd-new_660.yml", "YAML", 0, 0, 0, 6, 0, 0, 1, 7
"d:\IDEWORK\lvmen\src\licensedcode\data\rules\bsd-new_661.yml", "YAML", 0, 0, 0, 3, 0, 0, 1, 4
"d:\IDEWORK\lvmen\src\licensedcode\data\rules\bsd-new_662.yml", "YAML", 0, 0, 0, 5, 0, 0, 1, 6
"d:\IDEWORK\lvmen\src\licensedcode\data\rules\bsd-new_663.yml", "YAML", 0, 0, 0, 5, 0, 0, 1, 6
"d:\IDEWORK\lvmen\src\licensedcode\data\rules\bsd-new_664.yml", "YAML", 0, 0, 0, 5, 0, 0, 1, 6
"d:\IDEWORK\lvmen\src\licensedcode\data\rules\bsd-new_665.yml", "YAML", 0, 0, 0, 3, 0, 0, 1, 4
"d:\IDEWORK\lvmen\src\licensedcode\data\rules\bsd-new_666.yml", "YAML", 0, 0, 0, 5, 0, 0, 1, 6
"d:\IDEWORK\lvmen\src\licensedcode\data\rules\bsd-new_667.yml", "YAML", 0, 0, 0, 3, 0, 0, 1, 4
"d:\IDEWORK\lvmen\src\licensedcode\data\rules\bsd-new_668.yml", "YAML", 0, 0, 0, 4, 0, 0, 1, 5
"d:\IDEWORK\lvmen\src\licensedcode\data\rules\bsd-new_669.yml", "YAML", 0, 0, 0, 4, 0, 0, 1, 5
"d:\IDEWORK\lvmen\src\licensedcode\data\rules\bsd-new_67.yml", "YAML", 0, 0, 0, 3, 0, 0, 1, 4
"d:\IDEWORK\lvmen\src\licensedcode\data\rules\bsd-new_670.yml", "YAML", 0, 0, 0, 4, 0, 0, 1, 5
"d:\IDEWORK\lvmen\src\licensedcode\data\rules\bsd-new_671.yml", "YAML", 0, 0, 0, 4, 0, 0, 1, 5
"d:\IDEWORK\lvmen\src\licensedcode\data\rules\bsd-new_672.yml", "YAML", 0, 0, 0, 5, 0, 0, 1, 6
"d:\IDEWORK\lvmen\src\licensedcode\data\rules\bsd-new_673.yml", "YAML", 0, 0, 0, 5, 0, 0, 1, 6
"d:\IDEWORK\lvmen\src\licensedcode\data\rules\bsd-new_674.yml", "YAML", 0, 0, 0, 4, 0, 0, 1, 5
"d:\IDEWORK\lvmen\src\licensedcode\data\rules\bsd-new_675.yml", "YAML", 0, 0, 0, 4, 0, 0, 1, 5
"d:\IDEWORK\lvmen\src\licensedcode\data\rules\bsd-new_676.yml", "YAML", 0, 0, 0, 3, 0, 0, 1, 4
"d:\IDEWORK\lvmen\src\licensedcode\data\rules\bsd-new_677.yml", "YAML", 0, 0, 0, 5, 0, 0, 1, 6
"d:\IDEWORK\lvmen\src\licensedcode\data\rules\bsd-new_678.yml", "YAML", 0, 0, 0, 5, 0, 0, 1, 6
"d:\IDEWORK\lvmen\src\licensedcode\data\rules\bsd-new_679.yml", "YAML", 0, 0, 0, 3, 0, 0, 1, 4
"d:\IDEWORK\lvmen\src\licensedcode\data\rules\bsd-new_68.yml", "YAML", 0, 0, 0, 2, 0, 0, 1, 3
"d:\IDEWORK\lvmen\src\licensedcode\data\rules\bsd-new_680.yml", "YAML", 0, 0, 0, 3, 0, 0, 1, 4
"d:\IDEWORK\lvmen\src\licensedcode\data\rules\bsd-new_681.yml", "YAML", 0, 0, 0, 3, 0, 0, 1, 4
"d:\IDEWORK\lvmen\src\licensedcode\data\rules\bsd-new_682.yml", "YAML", 0, 0, 0, 3, 0, 0, 1, 4
"d:\IDEWORK\lvmen\src\licensedcode\data\rules\bsd-new_683.yml", "YAML", 0, 0, 0, 3, 0, 0, 1, 4
"d:\IDEWORK\lvmen\src\licensedcode\data\rules\bsd-new_684.yml", "YAML", 0, 0, 0, 3, 0, 0, 1, 4
"d:\IDEWORK\lvmen\src\licensedcode\data\rules\bsd-new_685.yml", "YAML", 0, 0, 0, 4, 0, 0, 1, 5
"d:\IDEWORK\lvmen\src\licensedcode\data\rules\bsd-new_686.yml", "YAML", 0, 0, 0, 3, 0, 0, 1, 4
"d:\IDEWORK\lvmen\src\licensedcode\data\rules\bsd-new_687.yml", "YAML", 0, 0, 0, 3, 0, 0, 1, 4
"d:\IDEWORK\lvmen\src\licensedcode\data\rules\bsd-new_688.yml", "YAML", 0, 0, 0, 3, 0, 0, 1, 4
"d:\IDEWORK\lvmen\src\licensedcode\data\rules\bsd-new_689.yml", "YAML", 0, 0, 0, 3, 0, 0, 1, 4
"d:\IDEWORK\lvmen\src\licensedcode\data\rules\bsd-new_69.yml", "YAML", 0, 0, 0, 3, 0, 0, 1, 4
"d:\IDEWORK\lvmen\src\licensedcode\data\rules\bsd-new_690.yml", "YAML", 0, 0, 0, 3, 0, 0, 1, 4
"d:\IDEWORK\lvmen\src\licensedcode\data\rules\bsd-new_691.yml", "YAML", 0, 0, 0, 3, 0, 0, 1, 4
"d:\IDEWORK\lvmen\src\licensedcode\data\rules\bsd-new_692.yml", "YAML", 0, 0, 0, 3, 0, 0, 1, 4
"d:\IDEWORK\lvmen\src\licensedcode\data\rules\bsd-new_693.yml", "YAML", 0, 0, 0, 3, 0, 0, 1, 4
"d:\IDEWORK\lvmen\src\licensedcode\data\rules\bsd-new_694.yml", "YAML", 0, 0, 0, 3, 0, 0, 1, 4
"d:\IDEWORK\lvmen\src\licensedcode\data\rules\bsd-new_695.yml", "YAML", 0, 0, 0, 4, 0, 0, 1, 5
"d:\IDEWORK\lvmen\src\licensedcode\data\rules\bsd-new_696.yml", "YAML", 0, 0, 0, 6, 0, 0, 1, 7
"d:\IDEWORK\lvmen\src\licensedcode\data\rules\bsd-new_697.yml", "YAML", 0, 0, 0, 3, 0, 0, 1, 4
"d:\IDEWORK\lvmen\src\licensedcode\data\rules\bsd-new_698.yml", "YAML", 0, 0, 0, 4, 0, 0, 1, 5
"d:\IDEWORK\lvmen\src\licensedcode\data\rules\bsd-new_699.yml", "YAML", 0, 0, 0, 3, 0, 0, 1, 4
"d:\IDEWORK\lvmen\src\licensedcode\data\rules\bsd-new_7.yml", "YAML", 0, 0, 0, 2, 0, 0, 1, 3
"d:\IDEWORK\lvmen\src\licensedcode\data\rules\bsd-new_70.yml", "YAML", 0, 0, 0, 3, 0, 0, 1, 4
"d:\IDEWORK\lvmen\src\licensedcode\data\rules\bsd-new_700.yml", "YAML", 0, 0, 0, 3, 0, 0, 1, 4
"d:\IDEWORK\lvmen\src\licensedcode\data\rules\bsd-new_701.yml", "YAML", 0, 0, 0, 3, 0, 0, 1, 4
"d:\IDEWORK\lvmen\src\licensedcode\data\rules\bsd-new_702.yml", "YAML", 0, 0, 0, 3, 0, 0, 1, 4
"d:\IDEWORK\lvmen\src\licensedcode\data\rules\bsd-new_703.yml", "YAML", 0, 0, 0, 3, 0, 0, 1, 4
"d:\IDEWORK\lvmen\src\licensedcode\data\rules\bsd-new_704.yml", "YAML", 0, 0, 0, 6, 0, 0, 1, 7
"d:\IDEWORK\lvmen\src\licensedcode\data\rules\bsd-new_705.yml", "YAML", 0, 0, 0, 3, 0, 0, 1, 4
"d:\IDEWORK\lvmen\src\licensedcode\data\rules\bsd-new_706.yml", "YAML", 0, 0, 0, 3, 0, 0, 1, 4
"d:\IDEWORK\lvmen\src\licensedcode\data\rules\bsd-new_707.yml", "YAML", 0, 0, 0, 3, 0, 0, 1, 4
"d:\IDEWORK\lvmen\src\licensedcode\data\rules\bsd-new_708.yml", "YAML", 0, 0, 0, 3, 0, 0, 1, 4
"d:\IDEWORK\lvmen\src\licensedcode\data\rules\bsd-new_709.yml", "YAML", 0, 0, 0, 5, 0, 0, 1, 6
"d:\IDEWORK\lvmen\src\licensedcode\data\rules\bsd-new_71.yml", "YAML", 0, 0, 0, 6, 0, 0, 1, 7
"d:\IDEWORK\lvmen\src\licensedcode\data\rules\bsd-new_710.yml", "YAML", 0, 0, 0, 5, 0, 0, 1, 6
"d:\IDEWORK\lvmen\src\licensedcode\data\rules\bsd-new_711.yml", "YAML", 0, 0, 0, 5, 0, 0, 1, 6
"d:\IDEWORK\lvmen\src\licensedcode\data\rules\bsd-new_712.yml", "YAML", 0, 0, 0, 3, 0, 0, 1, 4
"d:\IDEWORK\lvmen\src\licensedcode\data\rules\bsd-new_713.yml", "YAML", 0, 0, 0, 5, 0, 0, 1, 6
"d:\IDEWORK\lvmen\src\licensedcode\data\rules\bsd-new_714.yml", "YAML", 0, 0, 0, 3, 0, 0, 1, 4
"d:\IDEWORK\lvmen\src\licensedcode\data\rules\bsd-new_715.yml", "YAML", 0, 0, 0, 3, 0, 0, 1, 4
"d:\IDEWORK\lvmen\src\licensedcode\data\rules\bsd-new_716.yml", "YAML", 0, 0, 0, 3, 0, 0, 1, 4
"d:\IDEWORK\lvmen\src\licensedcode\data\rules\bsd-new_717.yml", "YAML", 0, 0, 0, 3, 0, 0, 1, 4
"d:\IDEWORK\lvmen\src\licensedcode\data\rules\bsd-new_718.yml", "YAML", 0, 0, 0, 3, 0, 0, 1, 4
"d:\IDEWORK\lvmen\src\licensedcode\data\rules\bsd-new_719.yml", "YAML", 0, 0, 0, 3, 0, 0, 1, 4
"d:\IDEWORK\lvmen\src\licensedcode\data\rules\bsd-new_72.yml", "YAML", 0, 0, 0, 2, 0, 0, 1, 3
"d:\IDEWORK\lvmen\src\licensedcode\data\rules\bsd-new_720.yml", "YAML", 0, 0, 0, 3, 0, 0, 1, 4
"d:\IDEWORK\lvmen\src\licensedcode\data\rules\bsd-new_721.yml", "YAML", 0, 0, 0, 3, 0, 0, 1, 4
"d:\IDEWORK\lvmen\src\licensedcode\data\rules\bsd-new_722.yml", "YAML", 0, 0, 0, 7, 0, 0, 1, 8
"d:\IDEWORK\lvmen\src\licensedcode\data\rules\bsd-new_723.yml", "YAML", 0, 0, 0, 4, 0, 0, 1, 5
"d:\IDEWORK\lvmen\src\licensedcode\data\rules\bsd-new_724.yml", "YAML", 0, 0, 0, 5, 0, 0, 1, 6
"d:\IDEWORK\lvmen\src\licensedcode\data\rules\bsd-new_725.yml", "YAML", 0, 0, 0, 3, 0, 0, 1, 4
"d:\IDEWORK\lvmen\src\licensedcode\data\rules\bsd-new_726.yml", "YAML", 0, 0, 0, 5, 0, 0, 1, 6
"d:\IDEWORK\lvmen\src\licensedcode\data\rules\bsd-new_727.yml", "YAML", 0, 0, 0, 5, 0, 0, 1, 6
"d:\IDEWORK\lvmen\src\licensedcode\data\rules\bsd-new_728.yml", "YAML", 0, 0, 0, 5, 0, 0, 1, 6
"d:\IDEWORK\lvmen\src\licensedcode\data\rules\bsd-new_729.yml", "YAML", 0, 0, 0, 5, 0, 0, 1, 6
"d:\IDEWORK\lvmen\src\licensedcode\data\rules\bsd-new_73.yml", "YAML", 0, 0, 0, 2, 0, 0, 1, 3
"d:\IDEWORK\lvmen\src\licensedcode\data\rules\bsd-new_730.yml", "YAML", 0, 0, 0, 5, 0, 0, 1, 6
"d:\IDEWORK\lvmen\src\licensedcode\data\rules\bsd-new_731.yml", "YAML", 0, 0, 0, 3, 0, 0, 1, 4
"d:\IDEWORK\lvmen\src\licensedcode\data\rules\bsd-new_732.yml", "YAML", 0, 0, 0, 3, 0, 0, 1, 4
"d:\IDEWORK\lvmen\src\licensedcode\data\rules\bsd-new_733.yml", "YAML", 0, 0, 0, 3, 0, 0, 1, 4
"d:\IDEWORK\lvmen\src\licensedcode\data\rules\bsd-new_734.yml", "YAML", 0, 0, 0, 4, 0, 0, 1, 5
"d:\IDEWORK\lvmen\src\licensedcode\data\rules\bsd-new_735.yml", "YAML", 0, 0, 0, 5, 0, 0, 1, 6
"d:\IDEWORK\lvmen\src\licensedcode\data\rules\bsd-new_736.yml", "YAML", 0, 0, 0, 3, 0, 0, 1, 4
"d:\IDEWORK\lvmen\src\licensedcode\data\rules\bsd-new_737.yml", "YAML", 0, 0, 0, 3, 0, 0, 1, 4
"d:\IDEWORK\lvmen\src\licensedcode\data\rules\bsd-new_738.yml", "YAML", 0, 0, 0, 3, 0, 0, 1, 4
"d:\IDEWORK\lvmen\src\licensedcode\data\rules\bsd-new_739.yml", "YAML", 0, 0, 0, 5, 0, 0, 1, 6
"d:\IDEWORK\lvmen\src\licensedcode\data\rules\bsd-new_74.yml", "YAML", 0, 0, 0, 2, 0, 0, 1, 3
"d:\IDEWORK\lvmen\src\licensedcode\data\rules\bsd-new_740.yml", "YAML", 0, 0, 0, 5, 0, 0, 1, 6
"d:\IDEWORK\lvmen\src\licensedcode\data\rules\bsd-new_741.yml", "YAML", 0, 0, 0, 5, 0, 0, 1, 6
"d:\IDEWORK\lvmen\src\licensedcode\data\rules\bsd-new_742.yml", "YAML", 0, 0, 0, 5, 0, 0, 1, 6
"d:\IDEWORK\lvmen\src\licensedcode\data\rules\bsd-new_743.yml", "YAML", 0, 0, 0, 5, 0, 0, 1, 6
"d:\IDEWORK\lvmen\src\licensedcode\data\rules\bsd-new_744.yml", "YAML", 0, 0, 0, 5, 0, 0, 1, 6
"d:\IDEWORK\lvmen\src\licensedcode\data\rules\bsd-new_745.yml", "YAML", 0, 0, 0, 5, 0, 0, 1, 6
"d:\IDEWORK\lvmen\src\licensedcode\data\rules\bsd-new_746.yml", "YAML", 0, 0, 0, 3, 0, 0, 1, 4
"d:\IDEWORK\lvmen\src\licensedcode\data\rules\bsd-new_747.yml", "YAML", 0, 0, 0, 3, 0, 0, 1, 4
"d:\IDEWORK\lvmen\src\licensedcode\data\rules\bsd-new_748.yml", "YAML", 0, 0, 0, 3, 0, 0, 1, 4
"d:\IDEWORK\lvmen\src\licensedcode\data\rules\bsd-new_749.yml", "YAML", 0, 0, 0, 3, 0, 0, 1, 4
"d:\IDEWORK\lvmen\src\licensedcode\data\rules\bsd-new_75.yml", "YAML", 0, 0, 0, 2, 0, 0, 1, 3
"d:\IDEWORK\lvmen\src\licensedcode\data\rules\bsd-new_750.yml", "YAML", 0, 0, 0, 3, 0, 0, 1, 4
"d:\IDEWORK\lvmen\src\licensedcode\data\rules\bsd-new_751.yml", "YAML", 0, 0, 0, 3, 0, 0, 1, 4
"d:\IDEWORK\lvmen\src\licensedcode\data\rules\bsd-new_752.yml", "YAML", 0, 0, 0, 3, 0, 0, 1, 4
"d:\IDEWORK\lvmen\src\licensedcode\data\rules\bsd-new_753.yml", "YAML", 0, 0, 0, 7, 0, 0, 1, 8
"d:\IDEWORK\lvmen\src\licensedcode\data\rules\bsd-new_754.yml", "YAML", 0, 0, 0, 5, 0, 0, 1, 6
"d:\IDEWORK\lvmen\src\licensedcode\data\rules\bsd-new_755.yml", "YAML", 0, 0, 0, 5, 0, 0, 1, 6
"d:\IDEWORK\lvmen\src\licensedcode\data\rules\bsd-new_756.yml", "YAML", 0, 0, 0, 7, 0, 0, 1, 8
"d:\IDEWORK\lvmen\src\licensedcode\data\rules\bsd-new_757.yml", "YAML", 0, 0, 0, 3, 0, 0, 1, 4
"d:\IDEWORK\lvmen\src\licensedcode\data\rules\bsd-new_758.yml", "YAML", 0, 0, 0, 3, 0, 0, 1, 4
"d:\IDEWORK\lvmen\src\licensedcode\data\rules\bsd-new_759.yml", "YAML", 0, 0, 0, 5, 0, 0, 1, 6
"d:\IDEWORK\lvmen\src\licensedcode\data\rules\bsd-new_76.yml", "YAML", 0, 0, 0, 2, 0, 0, 1, 3
"d:\IDEWORK\lvmen\src\licensedcode\data\rules\bsd-new_760.yml", "YAML", 0, 0, 0, 5, 0, 0, 1, 6
"d:\IDEWORK\lvmen\src\licensedcode\data\rules\bsd-new_761.yml", "YAML", 0, 0, 0, 5, 0, 0, 1, 6
"d:\IDEWORK\lvmen\src\licensedcode\data\rules\bsd-new_762.yml", "YAML", 0, 0, 0, 3, 0, 0, 1, 4
"d:\IDEWORK\lvmen\src\licensedcode\data\rules\bsd-new_763.yml", "YAML", 0, 0, 0, 3, 0, 0, 1, 4
"d:\IDEWORK\lvmen\src\licensedcode\data\rules\bsd-new_764.yml", "YAML", 0, 0, 0, 3, 0, 0, 1, 4
"d:\IDEWORK\lvmen\src\licensedcode\data\rules\bsd-new_765.yml", "YAML", 0, 0, 0, 3, 0, 0, 1, 4
"d:\IDEWORK\lvmen\src\licensedcode\data\rules\bsd-new_766.yml", "YAML", 0, 0, 0, 3, 0, 0, 1, 4
"d:\IDEWORK\lvmen\src\licensedcode\data\rules\bsd-new_767.yml", "YAML", 0, 0, 0, 3, 0, 0, 1, 4
"d:\IDEWORK\lvmen\src\licensedcode\data\rules\bsd-new_768.yml", "YAML", 0, 0, 0, 5, 0, 0, 1, 6
"d:\IDEWORK\lvmen\src\licensedcode\data\rules\bsd-new_769.yml", "YAML", 0, 0, 0, 5, 0, 0, 1, 6
"d:\IDEWORK\lvmen\src\licensedcode\data\rules\bsd-new_77.yml", "YAML", 0, 0, 0, 2, 0, 0, 1, 3
"d:\IDEWORK\lvmen\src\licensedcode\data\rules\bsd-new_770.yml", "YAML", 0, 0, 0, 5, 0, 0, 1, 6
"d:\IDEWORK\lvmen\src\licensedcode\data\rules\bsd-new_771.yml", "YAML", 0, 0, 0, 5, 0, 0, 1, 6
"d:\IDEWORK\lvmen\src\licensedcode\data\rules\bsd-new_772.yml", "YAML", 0, 0, 0, 3, 0, 0, 1, 4
"d:\IDEWORK\lvmen\src\licensedcode\data\rules\bsd-new_773.yml", "YAML", 0, 0, 0, 3, 0, 0, 1, 4
"d:\IDEWORK\lvmen\src\licensedcode\data\rules\bsd-new_774.yml", "YAML", 0, 0, 0, 5, 0, 0, 1, 6
"d:\IDEWORK\lvmen\src\licensedcode\data\rules\bsd-new_775.yml", "YAML", 0, 0, 0, 7, 0, 0, 1, 8
"d:\IDEWORK\lvmen\src\licensedcode\data\rules\bsd-new_776.yml", "YAML", 0, 0, 0, 7, 0, 0, 1, 8
"d:\IDEWORK\lvmen\src\licensedcode\data\rules\bsd-new_777.yml", "YAML", 0, 0, 0, 5, 0, 0, 1, 6
"d:\IDEWORK\lvmen\src\licensedcode\data\rules\bsd-new_778.yml", "YAML", 0, 0, 0, 3, 0, 0, 1, 4
"d:\IDEWORK\lvmen\src\licensedcode\data\rules\bsd-new_779.yml", "YAML", 0, 0, 0, 6, 0, 0, 1, 7
"d:\IDEWORK\lvmen\src\licensedcode\data\rules\bsd-new_78.yml", "YAML", 0, 0, 0, 5, 0, 0, 1, 6
"d:\IDEWORK\lvmen\src\licensedcode\data\rules\bsd-new_780.yml", "YAML", 0, 0, 0, 6, 0, 0, 1, 7
"d:\IDEWORK\lvmen\src\licensedcode\data\rules\bsd-new_781.yml", "YAML", 0, 0, 0, 3, 0, 0, 1, 4
"d:\IDEWORK\lvmen\src\licensedcode\data\rules\bsd-new_782.yml", "YAML", 0, 0, 0, 3, 0, 0, 1, 4
"d:\IDEWORK\lvmen\src\licensedcode\data\rules\bsd-new_783.yml", "YAML", 0, 0, 0, 3, 0, 0, 1, 4
"d:\IDEWORK\lvmen\src\licensedcode\data\rules\bsd-new_784.yml", "YAML", 0, 0, 0, 3, 0, 0, 1, 4
"d:\IDEWORK\lvmen\src\licensedcode\data\rules\bsd-new_785.yml", "YAML", 0, 0, 0, 3, 0, 0, 1, 4
"d:\IDEWORK\lvmen\src\licensedcode\data\rules\bsd-new_786.yml", "YAML", 0, 0, 0, 3, 0, 0, 1, 4
"d:\IDEWORK\lvmen\src\licensedcode\data\rules\bsd-new_787.yml", "YAML", 0, 0, 0, 6, 0, 0, 1, 7
"d:\IDEWORK\lvmen\src\licensedcode\data\rules\bsd-new_788.yml", "YAML", 0, 0, 0, 3, 0, 0, 1, 4
"d:\IDEWORK\lvmen\src\licensedcode\data\rules\bsd-new_789.yml", "YAML", 0, 0, 0, 3, 0, 0, 1, 4
"d:\IDEWORK\lvmen\src\licensedcode\data\rules\bsd-new_79.yml", "YAML", 0, 0, 0, 3, 0, 0, 1, 4
"d:\IDEWORK\lvmen\src\licensedcode\data\rules\bsd-new_790.yml", "YAML", 0, 0, 0, 5, 0, 0, 1, 6
"d:\IDEWORK\lvmen\src\licensedcode\data\rules\bsd-new_791.yml", "YAML", 0, 0, 0, 5, 0, 0, 1, 6
"d:\IDEWORK\lvmen\src\licensedcode\data\rules\bsd-new_792.yml", "YAML", 0, 0, 0, 5, 0, 0, 1, 6
"d:\IDEWORK\lvmen\src\licensedcode\data\rules\bsd-new_793.yml", "YAML", 0, 0, 0, 3, 0, 0, 1, 4
"d:\IDEWORK\lvmen\src\licensedcode\data\rules\bsd-new_794.yml", "YAML", 0, 0, 0, 3, 0, 0, 1, 4
"d:\IDEWORK\lvmen\src\licensedcode\data\rules\bsd-new_795.yml", "YAML", 0, 0, 0, 3, 0, 0, 1, 4
"d:\IDEWORK\lvmen\src\licensedcode\data\rules\bsd-new_796.yml", "YAML", 0, 0, 0, 3, 0, 0, 1, 4
"d:\IDEWORK\lvmen\src\licensedcode\data\rules\bsd-new_797.yml", "YAML", 0, 0, 0, 3, 0, 0, 1, 4
"d:\IDEWORK\lvmen\src\licensedcode\data\rules\bsd-new_798.yml", "YAML", 0, 0, 0, 3, 0, 0, 1, 4
"d:\IDEWORK\lvmen\src\licensedcode\data\rules\bsd-new_799.yml", "YAML", 0, 0, 0, 6, 0, 0, 1, 7
"d:\IDEWORK\lvmen\src\licensedcode\data\rules\bsd-new_8.yml", "YAML", 0, 0, 0, 3, 0, 0, 1, 4
"d:\IDEWORK\lvmen\src\licensedcode\data\rules\bsd-new_80.yml", "YAML", 0, 0, 0, 3, 0, 0, 1, 4
"d:\IDEWORK\lvmen\src\licensedcode\data\rules\bsd-new_800.yml", "YAML", 0, 0, 0, 6, 0, 0, 1, 7
"d:\IDEWORK\lvmen\src\licensedcode\data\rules\bsd-new_801.yml", "YAML", 0, 0, 0, 3, 0, 0, 1, 4
"d:\IDEWORK\lvmen\src\licensedcode\data\rules\bsd-new_802.yml", "YAML", 0, 0, 0, 3, 0, 0, 1, 4
"d:\IDEWORK\lvmen\src\licensedcode\data\rules\bsd-new_803.yml", "YAML", 0, 0, 0, 3, 0, 0, 1, 4
"d:\IDEWORK\lvmen\src\licensedcode\data\rules\bsd-new_804.yml", "YAML", 0, 0, 0, 3, 0, 0, 1, 4
"d:\IDEWORK\lvmen\src\licensedcode\data\rules\bsd-new_805.yml", "YAML", 0, 0, 0, 3, 0, 0, 1, 4
"d:\IDEWORK\lvmen\src\licensedcode\data\rules\bsd-new_806.yml", "YAML", 0, 0, 0, 3, 0, 0, 1, 4
"d:\IDEWORK\lvmen\src\licensedcode\data\rules\bsd-new_807.yml", "YAML", 0, 0, 0, 3, 0, 0, 1, 4
"d:\IDEWORK\lvmen\src\licensedcode\data\rules\bsd-new_808.yml", "YAML", 0, 0, 0, 3, 0, 0, 1, 4
"d:\IDEWORK\lvmen\src\licensedcode\data\rules\bsd-new_809.yml", "YAML", 0, 0, 0, 3, 0, 0, 1, 4
"d:\IDEWORK\lvmen\src\licensedcode\data\rules\bsd-new_81.yml", "YAML", 0, 0, 0, 3, 0, 0, 1, 4
"d:\IDEWORK\lvmen\src\licensedcode\data\rules\bsd-new_810.yml", "YAML", 0, 0, 0, 5, 0, 0, 1, 6
"d:\IDEWORK\lvmen\src\licensedcode\data\rules\bsd-new_811.yml", "YAML", 0, 0, 0, 4, 0, 0, 2, 6
"d:\IDEWORK\lvmen\src\licensedcode\data\rules\bsd-new_812.yml", "YAML", 0, 0, 0, 3, 0, 0, 1, 4
"d:\IDEWORK\lvmen\src\licensedcode\data\rules\bsd-new_813.yml", "YAML", 0, 0, 0, 3, 0, 0, 1, 4
"d:\IDEWORK\lvmen\src\licensedcode\data\rules\bsd-new_814.yml", "YAML", 0, 0, 0, 6, 0, 0, 1, 7
"d:\IDEWORK\lvmen\src\licensedcode\data\rules\bsd-new_815.yml", "YAML", 0, 0, 0, 5, 0, 0, 1, 6
"d:\IDEWORK\lvmen\src\licensedcode\data\rules\bsd-new_816.yml", "YAML", 0, 0, 0, 4, 0, 0, 1, 5
"d:\IDEWORK\lvmen\src\licensedcode\data\rules\bsd-new_817.yml", "YAML", 0, 0, 0, 4, 0, 0, 1, 5
"d:\IDEWORK\lvmen\src\licensedcode\data\rules\bsd-new_818.yml", "YAML", 0, 0, 0, 5, 0, 0, 1, 6
"d:\IDEWORK\lvmen\src\licensedcode\data\rules\bsd-new_819.yml", "YAML", 0, 0, 0, 7, 0, 0, 1, 8
"d:\IDEWORK\lvmen\src\licensedcode\data\rules\bsd-new_82.yml", "YAML", 0, 0, 0, 5, 0, 0, 1, 6
"d:\IDEWORK\lvmen\src\licensedcode\data\rules\bsd-new_820.yml", "YAML", 0, 0, 0, 4, 0, 0, 1, 5
"d:\IDEWORK\lvmen\src\licensedcode\data\rules\bsd-new_821.yml", "YAML", 0, 0, 0, 3, 0, 0, 1, 4
"d:\IDEWORK\lvmen\src\licensedcode\data\rules\bsd-new_822.yml", "YAML", 0, 0, 0, 3, 0, 0, 1, 4
"d:\IDEWORK\lvmen\src\licensedcode\data\rules\bsd-new_823.yml", "YAML", 0, 0, 0, 5, 0, 0, 1, 6
"d:\IDEWORK\lvmen\src\licensedcode\data\rules\bsd-new_824.yml", "YAML", 0, 0, 0, 3, 0, 0, 1, 4
"d:\IDEWORK\lvmen\src\licensedcode\data\rules\bsd-new_825.yml", "YAML", 0, 0, 0, 5, 0, 0, 1, 6
"d:\IDEWORK\lvmen\src\licensedcode\data\rules\bsd-new_826.yml", "YAML", 0, 0, 0, 5, 0, 0, 1, 6
"d:\IDEWORK\lvmen\src\licensedcode\data\rules\bsd-new_827.yml", "YAML", 0, 0, 0, 5, 0, 0, 1, 6
"d:\IDEWORK\lvmen\src\licensedcode\data\rules\bsd-new_828.yml", "YAML", 0, 0, 0, 4, 0, 0, 1, 5
"d:\IDEWORK\lvmen\src\licensedcode\data\rules\bsd-new_829.yml", "YAML", 0, 0, 0, 3, 0, 0, 1, 4
"d:\IDEWORK\lvmen\src\licensedcode\data\rules\bsd-new_83.yml", "YAML", 0, 0, 0, 2, 0, 0, 1, 3
"d:\IDEWORK\lvmen\src\licensedcode\data\rules\bsd-new_830.yml", "YAML", 0, 0, 0, 5, 0, 0, 1, 6
"d:\IDEWORK\lvmen\src\licensedcode\data\rules\bsd-new_831.yml", "YAML", 0, 0, 0, 3, 0, 0, 1, 4
"d:\IDEWORK\lvmen\src\licensedcode\data\rules\bsd-new_832.yml", "YAML", 0, 0, 0, 7, 0, 0, 1, 8
"d:\IDEWORK\lvmen\src\licensedcode\data\rules\bsd-new_833.yml", "YAML", 0, 0, 0, 3, 0, 0, 1, 4
"d:\IDEWORK\lvmen\src\licensedcode\data\rules\bsd-new_834.yml", "YAML", 0, 0, 0, 3, 0, 0, 1, 4
"d:\IDEWORK\lvmen\src\licensedcode\data\rules\bsd-new_835.yml", "YAML", 0, 0, 0, 3, 0, 0, 1, 4
"d:\IDEWORK\lvmen\src\licensedcode\data\rules\bsd-new_836.yml", "YAML", 0, 0, 0, 3, 0, 0, 1, 4
"d:\IDEWORK\lvmen\src\licensedcode\data\rules\bsd-new_837.yml", "YAML", 0, 0, 0, 3, 0, 0, 1, 4
"d:\IDEWORK\lvmen\src\licensedcode\data\rules\bsd-new_838.yml", "YAML", 0, 0, 0, 3, 0, 0, 1, 4
"d:\IDEWORK\lvmen\src\licensedcode\data\rules\bsd-new_839.yml", "YAML", 0, 0, 0, 3, 0, 0, 1, 4
"d:\IDEWORK\lvmen\src\licensedcode\data\rules\bsd-new_84.yml", "YAML", 0, 0, 0, 5, 0, 0, 1, 6
"d:\IDEWORK\lvmen\src\licensedcode\data\rules\bsd-new_840.yml", "YAML", 0, 0, 0, 3, 0, 0, 1, 4
"d:\IDEWORK\lvmen\src\licensedcode\data\rules\bsd-new_841.yml", "YAML", 0, 0, 0, 3, 0, 0, 1, 4
"d:\IDEWORK\lvmen\src\licensedcode\data\rules\bsd-new_842.yml", "YAML", 0, 0, 0, 3, 0, 0, 1, 4
"d:\IDEWORK\lvmen\src\licensedcode\data\rules\bsd-new_843.yml", "YAML", 0, 0, 0, 3, 0, 0, 1, 4
"d:\IDEWORK\lvmen\src\licensedcode\data\rules\bsd-new_844.yml", "YAML", 0, 0, 0, 4, 0, 0, 1, 5
"d:\IDEWORK\lvmen\src\licensedcode\data\rules\bsd-new_845.yml", "YAML", 0, 0, 0, 3, 0, 0, 1, 4
"d:\IDEWORK\lvmen\src\licensedcode\data\rules\bsd-new_846.yml", "YAML", 0, 0, 0, 3, 0, 0, 1, 4
"d:\IDEWORK\lvmen\src\licensedcode\data\rules\bsd-new_847.yml", "YAML", 0, 0, 0, 3, 0, 0, 1, 4
"d:\IDEWORK\lvmen\src\licensedcode\data\rules\bsd-new_848.yml", "YAML", 0, 0, 0, 4, 0, 0, 1, 5
"d:\IDEWORK\lvmen\src\licensedcode\data\rules\bsd-new_849.yml", "YAML", 0, 0, 0, 3, 0, 0, 1, 4
"d:\IDEWORK\lvmen\src\licensedcode\data\rules\bsd-new_85.yml", "YAML", 0, 0, 0, 4, 0, 0, 1, 5
"d:\IDEWORK\lvmen\src\licensedcode\data\rules\bsd-new_850.yml", "YAML", 0, 0, 0, 3, 0, 0, 1, 4
"d:\IDEWORK\lvmen\src\licensedcode\data\rules\bsd-new_851.yml", "YAML", 0, 0, 0, 3, 0, 0, 1, 4
"d:\IDEWORK\lvmen\src\licensedcode\data\rules\bsd-new_852.yml", "YAML", 0, 0, 0, 3, 0, 0, 1, 4
"d:\IDEWORK\lvmen\src\licensedcode\data\rules\bsd-new_853.yml", "YAML", 0, 0, 0, 3, 0, 0, 1, 4
"d:\IDEWORK\lvmen\src\licensedcode\data\rules\bsd-new_854.yml", "YAML", 0, 0, 0, 7, 0, 0, 1, 8
"d:\IDEWORK\lvmen\src\licensedcode\data\rules\bsd-new_855.yml", "YAML", 0, 0, 0, 3, 0, 0, 1, 4
"d:\IDEWORK\lvmen\src\licensedcode\data\rules\bsd-new_856.yml", "YAML", 0, 0, 0, 8, 0, 0, 1, 9
"d:\IDEWORK\lvmen\src\licensedcode\data\rules\bsd-new_857.yml", "YAML", 0, 0, 0, 5, 0, 0, 1, 6
"d:\IDEWORK\lvmen\src\licensedcode\data\rules\bsd-new_858.yml", "YAML", 0, 0, 0, 3, 0, 0, 1, 4
"d:\IDEWORK\lvmen\src\licensedcode\data\rules\bsd-new_859.yml", "YAML", 0, 0, 0, 3, 0, 0, 1, 4
"d:\IDEWORK\lvmen\src\licensedcode\data\rules\bsd-new_86.yml", "YAML", 0, 0, 0, 2, 0, 0, 1, 3
"d:\IDEWORK\lvmen\src\licensedcode\data\rules\bsd-new_860.yml", "YAML", 0, 0, 0, 3, 0, 0, 1, 4
"d:\IDEWORK\lvmen\src\licensedcode\data\rules\bsd-new_861.yml", "YAML", 0, 0, 0, 3, 0, 0, 1, 4
"d:\IDEWORK\lvmen\src\licensedcode\data\rules\bsd-new_862.yml", "YAML", 0, 0, 0, 3, 0, 0, 1, 4
"d:\IDEWORK\lvmen\src\licensedcode\data\rules\bsd-new_863.yml", "YAML", 0, 0, 0, 5, 0, 0, 1, 6
"d:\IDEWORK\lvmen\src\licensedcode\data\rules\bsd-new_864.yml", "YAML", 0, 0, 0, 3, 0, 0, 1, 4
"d:\IDEWORK\lvmen\src\licensedcode\data\rules\bsd-new_865.yml", "YAML", 0, 0, 0, 3, 0, 0, 1, 4
"d:\IDEWORK\lvmen\src\licensedcode\data\rules\bsd-new_866.yml", "YAML", 0, 0, 0, 3, 0, 0, 1, 4
"d:\IDEWORK\lvmen\src\licensedcode\data\rules\bsd-new_867.yml", "YAML", 0, 0, 0, 3, 0, 0, 1, 4
"d:\IDEWORK\lvmen\src\licensedcode\data\rules\bsd-new_868.yml", "YAML", 0, 0, 0, 5, 0, 0, 1, 6
"d:\IDEWORK\lvmen\src\licensedcode\data\rules\bsd-new_869.yml", "YAML", 0, 0, 0, 5, 0, 0, 1, 6
"d:\IDEWORK\lvmen\src\licensedcode\data\rules\bsd-new_87.yml", "YAML", 0, 0, 0, 5, 0, 0, 1, 6
"d:\IDEWORK\lvmen\src\licensedcode\data\rules\bsd-new_870.yml", "YAML", 0, 0, 0, 5, 0, 0, 1, 6
"d:\IDEWORK\lvmen\src\licensedcode\data\rules\bsd-new_871.yml", "YAML", 0, 0, 0, 5, 0, 0, 1, 6
"d:\IDEWORK\lvmen\src\licensedcode\data\rules\bsd-new_872.yml", "YAML", 0, 0, 0, 5, 0, 0, 1, 6
"d:\IDEWORK\lvmen\src\licensedcode\data\rules\bsd-new_873.yml", "YAML", 0, 0, 0, 5, 0, 0, 1, 6
"d:\IDEWORK\lvmen\src\licensedcode\data\rules\bsd-new_874.yml", "YAML", 0, 0, 0, 3, 0, 0, 1, 4
"d:\IDEWORK\lvmen\src\licensedcode\data\rules\bsd-new_875.yml", "YAML", 0, 0, 0, 3, 0, 0, 1, 4
"d:\IDEWORK\lvmen\src\licensedcode\data\rules\bsd-new_876.yml", "YAML", 0, 0, 0, 3, 0, 0, 1, 4
"d:\IDEWORK\lvmen\src\licensedcode\data\rules\bsd-new_877.yml", "YAML", 0, 0, 0, 3, 0, 0, 1, 4
"d:\IDEWORK\lvmen\src\licensedcode\data\rules\bsd-new_878.yml", "YAML", 0, 0, 0, 3, 0, 0, 1, 4
"d:\IDEWORK\lvmen\src\licensedcode\data\rules\bsd-new_879.yml", "YAML", 0, 0, 0, 3, 0, 0, 1, 4
"d:\IDEWORK\lvmen\src\licensedcode\data\rules\bsd-new_88.yml", "YAML", 0, 0, 0, 3, 0, 0, 2, 5
"d:\IDEWORK\lvmen\src\licensedcode\data\rules\bsd-new_880.yml", "YAML", 0, 0, 0, 3, 0, 0, 1, 4
"d:\IDEWORK\lvmen\src\licensedcode\data\rules\bsd-new_881.yml", "YAML", 0, 0, 0, 3, 0, 0, 1, 4
"d:\IDEWORK\lvmen\src\licensedcode\data\rules\bsd-new_882.yml", "YAML", 0, 0, 0, 3, 0, 0, 1, 4
"d:\IDEWORK\lvmen\src\licensedcode\data\rules\bsd-new_883.yml", "YAML", 0, 0, 0, 4, 0, 0, 1, 5
"d:\IDEWORK\lvmen\src\licensedcode\data\rules\bsd-new_884.yml", "YAML", 0, 0, 0, 4, 0, 0, 1, 5
"d:\IDEWORK\lvmen\src\licensedcode\data\rules\bsd-new_885.yml", "YAML", 0, 0, 0, 3, 0, 0, 1, 4
"d:\IDEWORK\lvmen\src\licensedcode\data\rules\bsd-new_886.yml", "YAML", 0, 0, 0, 7, 0, 0, 1, 8
"d:\IDEWORK\lvmen\src\licensedcode\data\rules\bsd-new_887.yml", "YAML", 0, 0, 0, 7, 0, 0, 1, 8
"d:\IDEWORK\lvmen\src\licensedcode\data\rules\bsd-new_888.yml", "YAML", 0, 0, 0, 7, 0, 0, 1, 8
"d:\IDEWORK\lvmen\src\licensedcode\data\rules\bsd-new_889.yml", "YAML", 0, 0, 0, 7, 0, 0, 1, 8
"d:\IDEWORK\lvmen\src\licensedcode\data\rules\bsd-new_89.yml", "YAML", 0, 0, 0, 3, 0, 0, 1, 4
"d:\IDEWORK\lvmen\src\licensedcode\data\rules\bsd-new_890.yml", "YAML", 0, 0, 0, 3, 0, 0, 1, 4
"d:\IDEWORK\lvmen\src\licensedcode\data\rules\bsd-new_891.yml", "YAML", 0, 0, 0, 3, 0, 0, 1, 4
"d:\IDEWORK\lvmen\src\licensedcode\data\rules\bsd-new_892.yml", "YAML", 0, 0, 0, 3, 0, 0, 1, 4
"d:\IDEWORK\lvmen\src\licensedcode\data\rules\bsd-new_893.yml", "YAML", 0, 0, 0, 3, 0, 0, 1, 4
"d:\IDEWORK\lvmen\src\licensedcode\data\rules\bsd-new_894.yml", "YAML", 0, 0, 0, 3, 0, 0, 1, 4
"d:\IDEWORK\lvmen\src\licensedcode\data\rules\bsd-new_895.yml", "YAML", 0, 0, 0, 3, 0, 0, 1, 4
"d:\IDEWORK\lvmen\src\licensedcode\data\rules\bsd-new_896.yml", "YAML", 0, 0, 0, 6, 0, 0, 1, 7
"d:\IDEWORK\lvmen\src\licensedcode\data\rules\bsd-new_897.yml", "YAML", 0, 0, 0, 3, 0, 0, 1, 4
"d:\IDEWORK\lvmen\src\licensedcode\data\rules\bsd-new_898.yml", "YAML", 0, 0, 0, 3, 0, 0, 1, 4
"d:\IDEWORK\lvmen\src\licensedcode\data\rules\bsd-new_899.yml", "YAML", 0, 0, 0, 3, 0, 0, 1, 4
"d:\IDEWORK\lvmen\src\licensedcode\data\rules\bsd-new_9.yml", "YAML", 0, 0, 0, 3, 0, 0, 1, 4
"d:\IDEWORK\lvmen\src\licensedcode\data\rules\bsd-new_90.yml", "YAML", 0, 0, 0, 2, 0, 0, 1, 3
"d:\IDEWORK\lvmen\src\licensedcode\data\rules\bsd-new_900.yml", "YAML", 0, 0, 0, 3, 0, 0, 1, 4
"d:\IDEWORK\lvmen\src\licensedcode\data\rules\bsd-new_901.yml", "YAML", 0, 0, 0, 3, 0, 0, 1, 4
"d:\IDEWORK\lvmen\src\licensedcode\data\rules\bsd-new_902.yml", "YAML", 0, 0, 0, 3, 0, 0, 1, 4
"d:\IDEWORK\lvmen\src\licensedcode\data\rules\bsd-new_903.yml", "YAML", 0, 0, 0, 3, 0, 0, 1, 4
"d:\IDEWORK\lvmen\src\licensedcode\data\rules\bsd-new_904.yml", "YAML", 0, 0, 0, 3, 0, 0, 1, 4
"d:\IDEWORK\lvmen\src\licensedcode\data\rules\bsd-new_905.yml", "YAML", 0, 0, 0, 3, 0, 0, 1, 4
"d:\IDEWORK\lvmen\src\licensedcode\data\rules\bsd-new_906.yml", "YAML", 0, 0, 0, 3, 0, 0, 1, 4
"d:\IDEWORK\lvmen\src\licensedcode\data\rules\bsd-new_907.yml", "YAML", 0, 0, 0, 4, 0, 0, 1, 5
"d:\IDEWORK\lvmen\src\licensedcode\data\rules\bsd-new_908.yml", "YAML", 0, 0, 0, 5, 0, 0, 1, 6
"d:\IDEWORK\lvmen\src\licensedcode\data\rules\bsd-new_909.yml", "YAML", 0, 0, 0, 3, 0, 0, 1, 4
"d:\IDEWORK\lvmen\src\licensedcode\data\rules\bsd-new_91.yml", "YAML", 0, 0, 0, 2, 0, 0, 1, 3
"d:\IDEWORK\lvmen\src\licensedcode\data\rules\bsd-new_910.yml", "YAML", 0, 0, 0, 3, 0, 0, 1, 4
"d:\IDEWORK\lvmen\src\licensedcode\data\rules\bsd-new_911.yml", "YAML", 0, 0, 0, 3, 0, 0, 1, 4
"d:\IDEWORK\lvmen\src\licensedcode\data\rules\bsd-new_912.yml", "YAML", 0, 0, 0, 3, 0, 0, 1, 4
"d:\IDEWORK\lvmen\src\licensedcode\data\rules\bsd-new_913.yml", "YAML", 0, 0, 0, 3, 0, 0, 1, 4
"d:\IDEWORK\lvmen\src\licensedcode\data\rules\bsd-new_914.yml", "YAML", 0, 0, 0, 3, 0, 0, 1, 4
"d:\IDEWORK\lvmen\src\licensedcode\data\rules\bsd-new_915.yml", "YAML", 0, 0, 0, 3, 0, 0, 1, 4
"d:\IDEWORK\lvmen\src\licensedcode\data\rules\bsd-new_916.yml", "YAML", 0, 0, 0, 3, 0, 0, 1, 4
"d:\IDEWORK\lvmen\src\licensedcode\data\rules\bsd-new_917.yml", "YAML", 0, 0, 0, 5, 0, 0, 1, 6
"d:\IDEWORK\lvmen\src\licensedcode\data\rules\bsd-new_918.yml", "YAML", 0, 0, 0, 5, 0, 0, 1, 6
"d:\IDEWORK\lvmen\src\licensedcode\data\rules\bsd-new_919.yml", "YAML", 0, 0, 0, 4, 0, 0, 1, 5
"d:\IDEWORK\lvmen\src\licensedcode\data\rules\bsd-new_91_1.yml", "YAML", 0, 0, 0, 3, 0, 0, 1, 4
"d:\IDEWORK\lvmen\src\licensedcode\data\rules\bsd-new_92.yml", "YAML", 0, 0, 0, 2, 0, 0, 1, 3
"d:\IDEWORK\lvmen\src\licensedcode\data\rules\bsd-new_920.yml", "YAML", 0, 0, 0, 3, 0, 0, 1, 4
"d:\IDEWORK\lvmen\src\licensedcode\data\rules\bsd-new_921.yml", "YAML", 0, 0, 0, 5, 0, 0, 1, 6
"d:\IDEWORK\lvmen\src\licensedcode\data\rules\bsd-new_922.yml", "YAML", 0, 0, 0, 3, 0, 0, 1, 4
"d:\IDEWORK\lvmen\src\licensedcode\data\rules\bsd-new_923.yml", "YAML", 0, 0, 0, 5, 0, 0, 1, 6
"d:\IDEWORK\lvmen\src\licensedcode\data\rules\bsd-new_924.yml", "YAML", 0, 0, 0, 5, 0, 0, 1, 6
"d:\IDEWORK\lvmen\src\licensedcode\data\rules\bsd-new_925.yml", "YAML", 0, 0, 0, 3, 0, 0, 1, 4
"d:\IDEWORK\lvmen\src\licensedcode\data\rules\bsd-new_926.yml", "YAML", 0, 0, 0, 3, 0, 0, 1, 4
"d:\IDEWORK\lvmen\src\licensedcode\data\rules\bsd-new_927.yml", "YAML", 0, 0, 0, 5, 0, 0, 1, 6
"d:\IDEWORK\lvmen\src\licensedcode\data\rules\bsd-new_928.yml", "YAML", 0, 0, 0, 5, 0, 0, 1, 6
"d:\IDEWORK\lvmen\src\licensedcode\data\rules\bsd-new_929.yml", "YAML", 0, 0, 0, 3, 0, 0, 1, 4
"d:\IDEWORK\lvmen\src\licensedcode\data\rules\bsd-new_93.yml", "YAML", 0, 0, 0, 2, 0, 0, 1, 3
"d:\IDEWORK\lvmen\src\licensedcode\data\rules\bsd-new_930.yml", "YAML", 0, 0, 0, 3, 0, 0, 1, 4
"d:\IDEWORK\lvmen\src\licensedcode\data\rules\bsd-new_931.yml", "YAML", 0, 0, 0, 3, 0, 0, 1, 4
"d:\IDEWORK\lvmen\src\licensedcode\data\rules\bsd-new_932.yml", "YAML", 0, 0, 0, 3, 0, 0, 1, 4
"d:\IDEWORK\lvmen\src\licensedcode\data\rules\bsd-new_933.yml", "YAML", 0, 0, 0, 3, 0, 0, 1, 4
"d:\IDEWORK\lvmen\src\licensedcode\data\rules\bsd-new_934.yml", "YAML", 0, 0, 0, 3, 0, 0, 1, 4
"d:\IDEWORK\lvmen\src\licensedcode\data\rules\bsd-new_935.yml", "YAML", 0, 0, 0, 3, 0, 0, 1, 4
"d:\IDEWORK\lvmen\src\licensedcode\data\rules\bsd-new_936.yml", "YAML", 0, 0, 0, 3, 0, 0, 1, 4
"d:\IDEWORK\lvmen\src\licensedcode\data\rules\bsd-new_937.yml", "YAML", 0, 0, 0, 3, 0, 0, 1, 4
"d:\IDEWORK\lvmen\src\licensedcode\data\rules\bsd-new_938.yml", "YAML", 0, 0, 0, 3, 0, 0, 1, 4
"d:\IDEWORK\lvmen\src\licensedcode\data\rules\bsd-new_939.yml", "YAML", 0, 0, 0, 3, 0, 0, 1, 4
"d:\IDEWORK\lvmen\src\licensedcode\data\rules\bsd-new_94.yml", "YAML", 0, 0, 0, 2, 0, 0, 1, 3
"d:\IDEWORK\lvmen\src\licensedcode\data\rules\bsd-new_940.yml", "YAML", 0, 0, 0, 3, 0, 0, 1, 4
"d:\IDEWORK\lvmen\src\licensedcode\data\rules\bsd-new_941.yml", "YAML", 0, 0, 0, 3, 0, 0, 1, 4
"d:\IDEWORK\lvmen\src\licensedcode\data\rules\bsd-new_942.yml", "YAML", 0, 0, 0, 3, 0, 0, 1, 4
"d:\IDEWORK\lvmen\src\licensedcode\data\rules\bsd-new_943.yml", "YAML", 0, 0, 0, 3, 0, 0, 1, 4
"d:\IDEWORK\lvmen\src\licensedcode\data\rules\bsd-new_944.yml", "YAML", 0, 0, 0, 3, 0, 0, 1, 4
"d:\IDEWORK\lvmen\src\licensedcode\data\rules\bsd-new_945.yml", "YAML", 0, 0, 0, 3, 0, 0, 1, 4
"d:\IDEWORK\lvmen\src\licensedcode\data\rules\bsd-new_946.yml", "YAML", 0, 0, 0, 3, 0, 0, 1, 4
"d:\IDEWORK\lvmen\src\licensedcode\data\rules\bsd-new_947.yml", "YAML", 0, 0, 0, 3, 0, 0, 1, 4
"d:\IDEWORK\lvmen\src\licensedcode\data\rules\bsd-new_948.yml", "YAML", 0, 0, 0, 3, 0, 0, 1, 4
"d:\IDEWORK\lvmen\src\licensedcode\data\rules\bsd-new_949.yml", "YAML", 0, 0, 0, 3, 0, 0, 1, 4
"d:\IDEWORK\lvmen\src\licensedcode\data\rules\bsd-new_95.yml", "YAML", 0, 0, 0, 2, 0, 0, 1, 3
"d:\IDEWORK\lvmen\src\licensedcode\data\rules\bsd-new_950.yml", "YAML", 0, 0, 0, 3, 0, 0, 1, 4
"d:\IDEWORK\lvmen\src\licensedcode\data\rules\bsd-new_951.yml", "YAML", 0, 0, 0, 5, 0, 0, 1, 6
"d:\IDEWORK\lvmen\src\licensedcode\data\rules\bsd-new_952.yml", "YAML", 0, 0, 0, 5, 0, 0, 1, 6
"d:\IDEWORK\lvmen\src\licensedcode\data\rules\bsd-new_953.yml", "YAML", 0, 0, 0, 3, 0, 0, 1, 4
"d:\IDEWORK\lvmen\src\licensedcode\data\rules\bsd-new_954.yml", "YAML", 0, 0, 0, 5, 0, 0, 1, 6
"d:\IDEWORK\lvmen\src\licensedcode\data\rules\bsd-new_955.yml", "YAML", 0, 0, 0, 3, 0, 0, 1, 4
"d:\IDEWORK\lvmen\src\licensedcode\data\rules\bsd-new_956.yml", "YAML", 0, 0, 0, 3, 0, 0, 1, 4
"d:\IDEWORK\lvmen\src\licensedcode\data\rules\bsd-new_957.yml", "YAML", 0, 0, 0, 3, 0, 0, 1, 4
"d:\IDEWORK\lvmen\src\licensedcode\data\rules\bsd-new_958.yml", "YAML", 0, 0, 0, 3, 0, 0, 1, 4
"d:\IDEWORK\lvmen\src\licensedcode\data\rules\bsd-new_959.yml", "YAML", 0, 0, 0, 3, 0, 0, 1, 4
"d:\IDEWORK\lvmen\src\licensedcode\data\rules\bsd-new_96.yml", "YAML", 0, 0, 0, 2, 0, 0, 1, 3
"d:\IDEWORK\lvmen\src\licensedcode\data\rules\bsd-new_960.yml", "YAML", 0, 0, 0, 4, 0, 0, 1, 5
"d:\IDEWORK\lvmen\src\licensedcode\data\rules\bsd-new_961.yml", "YAML", 0, 0, 0, 3, 0, 0, 1, 4
"d:\IDEWORK\lvmen\src\licensedcode\data\rules\bsd-new_962.yml", "YAML", 0, 0, 0, 3, 0, 0, 1, 4
"d:\IDEWORK\lvmen\src\licensedcode\data\rules\bsd-new_963.yml", "YAML", 0, 0, 0, 3, 0, 0, 1, 4
"d:\IDEWORK\lvmen\src\licensedcode\data\rules\bsd-new_964.yml", "YAML", 0, 0, 0, 3, 0, 0, 1, 4
"d:\IDEWORK\lvmen\src\licensedcode\data\rules\bsd-new_965.yml", "YAML", 0, 0, 0, 3, 0, 0, 1, 4
"d:\IDEWORK\lvmen\src\licensedcode\data\rules\bsd-new_966.yml", "YAML", 0, 0, 0, 4, 0, 0, 1, 5
"d:\IDEWORK\lvmen\src\licensedcode\data\rules\bsd-new_967.yml", "YAML", 0, 0, 0, 4, 0, 0, 1, 5
"d:\IDEWORK\lvmen\src\licensedcode\data\rules\bsd-new_968.yml", "YAML", 0, 0, 0, 3, 0, 0, 1, 4
"d:\IDEWORK\lvmen\src\licensedcode\data\rules\bsd-new_969.yml", "YAML", 0, 0, 0, 3, 0, 0, 1, 4
"d:\IDEWORK\lvmen\src\licensedcode\data\rules\bsd-new_97.yml", "YAML", 0, 0, 0, 2, 0, 0, 1, 3
"d:\IDEWORK\lvmen\src\licensedcode\data\rules\bsd-new_970.yml", "YAML", 0, 0, 0, 4, 0, 0, 1, 5
"d:\IDEWORK\lvmen\src\licensedcode\data\rules\bsd-new_971.yml", "YAML", 0, 0, 0, 3, 0, 0, 1, 4
"d:\IDEWORK\lvmen\src\licensedcode\data\rules\bsd-new_972.yml", "YAML", 0, 0, 0, 3, 0, 0, 1, 4
"d:\IDEWORK\lvmen\src\licensedcode\data\rules\bsd-new_973.yml", "YAML", 0, 0, 0, 5, 0, 0, 1, 6
"d:\IDEWORK\lvmen\src\licensedcode\data\rules\bsd-new_974.yml", "YAML", 0, 0, 0, 3, 0, 0, 1, 4
"d:\IDEWORK\lvmen\src\licensedcode\data\rules\bsd-new_975.yml", "YAML", 0, 0, 0, 3, 0, 0, 1, 4
"d:\IDEWORK\lvmen\src\licensedcode\data\rules\bsd-new_976.yml", "YAML", 0, 0, 0, 3, 0, 0, 1, 4
"d:\IDEWORK\lvmen\src\licensedcode\data\rules\bsd-new_977.yml", "YAML", 0, 0, 0, 5, 0, 0, 1, 6
"d:\IDEWORK\lvmen\src\licensedcode\data\rules\bsd-new_978.yml", "YAML", 0, 0, 0, 3, 0, 0, 1, 4
"d:\IDEWORK\lvmen\src\licensedcode\data\rules\bsd-new_979.yml", "YAML", 0, 0, 0, 3, 0, 0, 1, 4
"d:\IDEWORK\lvmen\src\licensedcode\data\rules\bsd-new_98.yml", "YAML", 0, 0, 0, 2, 0, 0, 1, 3
"d:\IDEWORK\lvmen\src\licensedcode\data\rules\bsd-new_980.yml", "YAML", 0, 0, 0, 3, 0, 0, 1, 4
"d:\IDEWORK\lvmen\src\licensedcode\data\rules\bsd-new_981.yml", "YAML", 0, 0, 0, 3, 0, 0, 1, 4
"d:\IDEWORK\lvmen\src\licensedcode\data\rules\bsd-new_982.yml", "YAML", 0, 0, 0, 3, 0, 0, 1, 4
"d:\IDEWORK\lvmen\src\licensedcode\data\rules\bsd-new_983.yml", "YAML", 0, 0, 0, 3, 0, 0, 1, 4
"d:\IDEWORK\lvmen\src\licensedcode\data\rules\bsd-new_984.yml", "YAML", 0, 0, 0, 4, 0, 0, 1, 5
"d:\IDEWORK\lvmen\src\licensedcode\data\rules\bsd-new_985.yml", "YAML", 0, 0, 0, 3, 0, 0, 1, 4
"d:\IDEWORK\lvmen\src\licensedcode\data\rules\bsd-new_986.yml", "YAML", 0, 0, 0, 3, 0, 0, 1, 4
"d:\IDEWORK\lvmen\src\licensedcode\data\rules\bsd-new_987.yml", "YAML", 0, 0, 0, 3, 0, 0, 1, 4
"d:\IDEWORK\lvmen\src\licensedcode\data\rules\bsd-new_988.yml", "YAML", 0, 0, 0, 4, 0, 0, 1, 5
"d:\IDEWORK\lvmen\src\licensedcode\data\rules\bsd-new_989.yml", "YAML", 0, 0, 0, 5, 0, 0, 1, 6
"d:\IDEWORK\lvmen\src\licensedcode\data\rules\bsd-new_99.yml", "YAML", 0, 0, 0, 2, 0, 0, 1, 3
"d:\IDEWORK\lvmen\src\licensedcode\data\rules\bsd-new_990.yml", "YAML", 0, 0, 0, 6, 0, 0, 1, 7
"d:\IDEWORK\lvmen\src\licensedcode\data\rules\bsd-new_991.yml", "YAML", 0, 0, 0, 6, 0, 0, 1, 7
"d:\IDEWORK\lvmen\src\licensedcode\data\rules\bsd-new_992.yml", "YAML", 0, 0, 0, 6, 0, 0, 1, 7
"d:\IDEWORK\lvmen\src\licensedcode\data\rules\bsd-new_993.yml", "YAML", 0, 0, 0, 3, 0, 0, 1, 4
"d:\IDEWORK\lvmen\src\licensedcode\data\rules\bsd-new_994.yml", "YAML", 0, 0, 0, 3, 0, 0, 1, 4
"d:\IDEWORK\lvmen\src\licensedcode\data\rules\bsd-new_995.yml", "YAML", 0, 0, 0, 3, 0, 0, 1, 4
"d:\IDEWORK\lvmen\src\licensedcode\data\rules\bsd-new_996.yml", "YAML", 0, 0, 0, 3, 0, 0, 1, 4
"d:\IDEWORK\lvmen\src\licensedcode\data\rules\bsd-new_997.yml", "YAML", 0, 0, 0, 5, 0, 0, 1, 6
"d:\IDEWORK\lvmen\src\licensedcode\data\rules\bsd-new_998.yml", "YAML", 0, 0, 0, 3, 0, 0, 1, 4
"d:\IDEWORK\lvmen\src\licensedcode\data\rules\bsd-new_999.yml", "YAML", 0, 0, 0, 3, 0, 0, 1, 4
"d:\IDEWORK\lvmen\src\licensedcode\data\rules\bsd-new_99_1.yml", "YAML", 0, 0, 0, 2, 0, 0, 1, 3
"d:\IDEWORK\lvmen\src\licensedcode\data\rules\bsd-new_and_afpl-9.0_1.yml", "YAML", 0, 0, 0, 5, 0, 0, 1, 6
"d:\IDEWORK\lvmen\src\licensedcode\data\rules\bsd-new_and_apache2.yml", "YAML", 0, 0, 0, 2, 0, 0, 1, 3
"d:\IDEWORK\lvmen\src\licensedcode\data\rules\bsd-new_and_apache3.yml", "YAML", 0, 0, 0, 3, 0, 0, 1, 4
"d:\IDEWORK\lvmen\src\licensedcode\data\rules\bsd-new_and_bsd-simplified_1.yml", "YAML", 0, 0, 0, 2, 0, 0, 1, 3
"d:\IDEWORK\lvmen\src\licensedcode\data\rules\bsd-new_and_bsd-simplified_2.yml", "YAML", 0, 0, 0, 4, 0, 0, 1, 5
"d:\IDEWORK\lvmen\src\licensedcode\data\rules\bsd-new_and_bsd-simplified_3.yml", "YAML", 0, 0, 0, 5, 0, 0, 1, 6
"d:\IDEWORK\lvmen\src\licensedcode\data\rules\bsd-new_and_bsd-simplified_and_artistic-1.0_or_gpl-1.0-plus_or_lgpl-2.0-plus_1.yml", "YAML", 0, 0, 0, 6, 0, 0, 1, 7
"d:\IDEWORK\lvmen\src\licensedcode\data\rules\bsd-new_and_bsd-simplified_and_artistic-1.0_or_gpl-1.0-plus_or_lgpl-2.0-plus_2.yml", "YAML", 0, 0, 0, 4, 0, 0, 1, 5
"d:\IDEWORK\lvmen\src\licensedcode\data\rules\bsd-new_and_bsd-simplified_and_artistic-1.0_or_gpl-1.0-plus_or_lgpl-2.0-plus_3.yml", "YAML", 0, 0, 0, 9, 0, 0, 1, 10
"d:\IDEWORK\lvmen\src\licensedcode\data\rules\bsd-new_and_bsd-simplified_and_other-permissive_1.yml", "YAML", 0, 0, 0, 3, 0, 0, 1, 4
"d:\IDEWORK\lvmen\src\licensedcode\data\rules\bsd-new_and_cc-by-sa-3.0_1.yml", "YAML", 0, 0, 0, 3, 0, 0, 1, 4
"d:\IDEWORK\lvmen\src\licensedcode\data\rules\bsd-new_and_cc-pd.yml", "YAML", 0, 0, 0, 4, 0, 0, 1, 5
"d:\IDEWORK\lvmen\src\licensedcode\data\rules\bsd-new_and_cc-pd2.yml", "YAML", 0, 0, 0, 4, 0, 0, 1, 5
"d:\IDEWORK\lvmen\src\licensedcode\data\rules\bsd-new_and_dco-1.1_1.yml", "YAML", 0, 0, 0, 5, 0, 0, 1, 6
"d:\IDEWORK\lvmen\src\licensedcode\data\rules\bsd-new_and_ecma-no-patent_1.yml", "YAML", 0, 0, 0, 5, 0, 0, 1, 6
"d:\IDEWORK\lvmen\src\licensedcode\data\rules\bsd-new_and_facebook-patent-rights-2_1.yml", "YAML", 0, 0, 0, 7, 0, 0, 1, 8
"d:\IDEWORK\lvmen\src\licensedcode\data\rules\bsd-new_and_facebook-patent-rights-2_2.yml", "YAML", 0, 0, 0, 6, 0, 0, 1, 7
"d:\IDEWORK\lvmen\src\licensedcode\data\rules\bsd-new_and_facebook-patent-rights-2_3.yml", "YAML", 0, 0, 0, 6, 0, 0, 1, 7
"d:\IDEWORK\lvmen\src\licensedcode\data\rules\bsd-new_and_facebook-patent-rights-2_4.yml", "YAML", 0, 0, 0, 3, 0, 0, 1, 4
"d:\IDEWORK\lvmen\src\licensedcode\data\rules\bsd-new_and_facebook-patent-rights-2_5.yml", "YAML", 0, 0, 0, 3, 0, 0, 1, 4
"d:\IDEWORK\lvmen\src\licensedcode\data\rules\bsd-new_and_facebook-patent-rights-2_6.yml", "YAML", 0, 0, 0, 3, 0, 0, 1, 4
"d:\IDEWORK\lvmen\src\licensedcode\data\rules\bsd-new_and_facebook-patent-rights-2_and_other-permissive_and_cc-by-4.0.yml", "YAML", 0, 0, 0, 3, 0, 0, 1, 4
"d:\IDEWORK\lvmen\src\licensedcode\data\rules\bsd-new_and_facebook-patent-rights-2_and_proprietary-license_1.yml", "YAML", 0, 0, 0, 6, 0, 0, 1, 7
"d:\IDEWORK\lvmen\src\licensedcode\data\rules\bsd-new_and_facebook-patent-rights-2_and_proprietary-license_2.yml", "YAML", 0, 0, 0, 6, 0, 0, 1, 7
"d:\IDEWORK\lvmen\src\licensedcode\data\rules\bsd-new_and_generic-cla_1.yml", "YAML", 0, 0, 0, 5, 0, 0, 1, 6
"d:\IDEWORK\lvmen\src\licensedcode\data\rules\bsd-new_and_google-patent-license-golang_1.yml", "YAML", 0, 0, 0, 7, 0, 0, 1, 8
"d:\IDEWORK\lvmen\src\licensedcode\data\rules\bsd-new_and_google-patent-license-golang_2.yml", "YAML", 0, 0, 0, 7, 0, 0, 1, 8
"d:\IDEWORK\lvmen\src\licensedcode\data\rules\bsd-new_and_google-patent-license-golang_3.yml", "YAML", 0, 0, 0, 3, 0, 0, 1, 4
"d:\IDEWORK\lvmen\src\licensedcode\data\rules\bsd-new_and_google-patent-license-golang_4.yml", "YAML", 0, 0, 0, 3, 0, 0, 1, 4
"d:\IDEWORK\lvmen\src\licensedcode\data\rules\bsd-new_and_google-patent-license-golang_5.yml", "YAML", 0, 0, 0, 4, 0, 0, 1, 5
"d:\IDEWORK\lvmen\src\licensedcode\data\rules\bsd-new_and_google-patent-license-golang_6.yml", "YAML", 0, 0, 0, 4, 0, 0, 1, 5
"d:\IDEWORK\lvmen\src\licensedcode\data\rules\bsd-new_and_google-patent-license-webm_1.yml", "YAML", 0, 0, 0, 6, 0, 0, 1, 7
"d:\IDEWORK\lvmen\src\licensedcode\data\rules\bsd-new_and_google-patent-license-webm_2.yml", "YAML", 0, 0, 0, 7, 0, 0, 1, 8
"d:\IDEWORK\lvmen\src\licensedcode\data\rules\bsd-new_and_google-patent-license-webm_3.yml", "YAML", 0, 0, 0, 7, 0, 0, 1, 8
"d:\IDEWORK\lvmen\src\licensedcode\data\rules\bsd-new_and_google-patent-license-webm_4.yml", "YAML", 0, 0, 0, 7, 0, 0, 1, 8
"d:\IDEWORK\lvmen\src\licensedcode\data\rules\bsd-new_and_google-patent-license-webm_5.yml", "YAML", 0, 0, 0, 6, 0, 0, 1, 7
"d:\IDEWORK\lvmen\src\licensedcode\data\rules\bsd-new_and_gpl-2.0-plus_with_bison-exception-2.2_1.yml", "YAML", 0, 0, 0, 5, 0, 0, 1, 6
"d:\IDEWORK\lvmen\src\licensedcode\data\rules\bsd-new_and_gpl-2.0-plus_with_bison-exception-2.2_2.yml", "YAML", 0, 0, 0, 10, 0, 0, 1, 11
"d:\IDEWORK\lvmen\src\licensedcode\data\rules\bsd-new_and_gpl-2.0-plus_with_bison-exception-2.2_3.yml", "YAML", 0, 0, 0, 10, 0, 0, 1, 11
"d:\IDEWORK\lvmen\src\licensedcode\data\rules\bsd-new_and_gpl-2.0_and_gfdl-1.2_1.yml", "YAML", 0, 0, 0, 7, 0, 0, 1, 8
"d:\IDEWORK\lvmen\src\licensedcode\data\rules\bsd-new_and_gpl-2.0_and_mit.yml", "YAML", 0, 0, 0, 6, 0, 0, 1, 7
"d:\IDEWORK\lvmen\src\licensedcode\data\rules\bsd-new_and_ijg_and_libpng_1.yml", "YAML", 0, 0, 0, 5, 0, 0, 1, 6
"d:\IDEWORK\lvmen\src\licensedcode\data\rules\bsd-new_and_ijg_and_x11-tiff_and_bsd-new_1.yml", "YAML", 0, 0, 0, 5, 0, 0, 1, 6
"d:\IDEWORK\lvmen\src\licensedcode\data\rules\bsd-new_and_ijg_and_zlib_1.yml", "YAML", 0, 0, 0, 5, 0, 0, 1, 6
"d:\IDEWORK\lvmen\src\licensedcode\data\rules\bsd-new_and_ijg_and_zlib_2.yml", "YAML", 0, 0, 0, 3, 0, 0, 1, 4
"d:\IDEWORK\lvmen\src\licensedcode\data\rules\bsd-new_and_lgpl-2.0-plus_1.yml", "YAML", 0, 0, 0, 4, 0, 0, 1, 5
"d:\IDEWORK\lvmen\src\licensedcode\data\rules\bsd-new_and_lgpl-2.0_1.yml", "YAML", 0, 0, 0, 3, 0, 0, 1, 4
"d:\IDEWORK\lvmen\src\licensedcode\data\rules\bsd-new_and_lgpl-2.1_and_gpl-2.0_and_gfdl-1.2_1.yml", "YAML", 0, 0, 0, 8, 0, 0, 1, 9
"d:\IDEWORK\lvmen\src\licensedcode\data\rules\bsd-new_and_lgpl-2.1_and_gpl-2.0_and_gfdl-1.2_2.yml", "YAML", 0, 0, 0, 8, 0, 0, 1, 9
"d:\IDEWORK\lvmen\src\licensedcode\data\rules\bsd-new_and_mit-synopsys.yml", "YAML", 0, 0, 0, 3, 0, 0, 1, 4
"d:\IDEWORK\lvmen\src\licensedcode\data\rules\bsd-new_and_mit_1.yml", "YAML", 0, 0, 0, 3, 0, 0, 1, 4
"d:\IDEWORK\lvmen\src\licensedcode\data\rules\bsd-new_and_mit_2.yml", "YAML", 0, 0, 0, 6, 0, 0, 1, 7
"d:\IDEWORK\lvmen\src\licensedcode\data\rules\bsd-new_and_mit_3.yml", "YAML", 0, 0, 0, 3, 0, 0, 1, 4
"d:\IDEWORK\lvmen\src\licensedcode\data\rules\bsd-new_and_mit_4.yml", "YAML", 0, 0, 0, 3, 0, 0, 1, 4
"d:\IDEWORK\lvmen\src\licensedcode\data\rules\bsd-new_and_mit_and_lgpl-2.0-plus_1.yml", "YAML", 0, 0, 0, 3, 0, 0, 1, 4
"d:\IDEWORK\lvmen\src\licensedcode\data\rules\bsd-new_and_mit_and_public-domain_1.yml", "YAML", 0, 0, 0, 4, 0, 0, 1, 5
"d:\IDEWORK\lvmen\src\licensedcode\data\rules\bsd-new_and_nvidia-2002_1.yml", "YAML", 0, 0, 0, 3, 0, 0, 1, 4
"d:\IDEWORK\lvmen\src\licensedcode\data\rules\bsd-new_and_other-permissive_1.yml", "YAML", 0, 0, 0, 5, 0, 0, 1, 6
"d:\IDEWORK\lvmen\src\licensedcode\data\rules\bsd-new_and_other-permissive_2.yml", "YAML", 0, 0, 0, 4, 0, 0, 1, 5
"d:\IDEWORK\lvmen\src\licensedcode\data\rules\bsd-new_and_other-permissive_3.yml", "YAML", 0, 0, 0, 4, 0, 0, 1, 5
"d:\IDEWORK\lvmen\src\licensedcode\data\rules\bsd-new_and_other-permissive_4.yml", "YAML", 0, 0, 0, 3, 0, 0, 1, 4
"d:\IDEWORK\lvmen\src\licensedcode\data\rules\bsd-new_and_other-permissive_5.yml", "YAML", 0, 0, 0, 3, 0, 0, 1, 4
"d:\IDEWORK\lvmen\src\licensedcode\data\rules\bsd-new_and_other-permissive_6.yml", "YAML", 0, 0, 0, 8, 0, 0, 1, 9
"d:\IDEWORK\lvmen\src\licensedcode\data\rules\bsd-new_and_other-permissive_7.yml", "YAML", 0, 0, 0, 6, 0, 0, 1, 7
"d:\IDEWORK\lvmen\src\licensedcode\data\rules\bsd-new_and_other-permissive_8.yml", "YAML", 0, 0, 0, 2, 0, 0, 1, 3
"d:\IDEWORK\lvmen\src\licensedcode\data\rules\bsd-new_and_proprietary-license_1.yml", "YAML", 0, 0, 0, 4, 0, 0, 1, 5
"d:\IDEWORK\lvmen\src\licensedcode\data\rules\bsd-new_and_proprietary-license_2.yml", "YAML", 0, 0, 0, 4, 0, 0, 1, 5
"d:\IDEWORK\lvmen\src\licensedcode\data\rules\bsd-new_and_proprietary_1.yml", "YAML", 0, 0, 0, 2, 0, 0, 1, 3
"d:\IDEWORK\lvmen\src\licensedcode\data\rules\bsd-new_and_public-domain.yml", "YAML", 0, 0, 0, 2, 0, 0, 1, 3
"d:\IDEWORK\lvmen\src\licensedcode\data\rules\bsd-new_and_python_and_apache-2.0_1.yml", "YAML", 0, 0, 0, 3, 0, 0, 1, 4
"d:\IDEWORK\lvmen\src\licensedcode\data\rules\bsd-new_arm.yml", "YAML", 0, 0, 0, 2, 0, 0, 1, 3
"d:\IDEWORK\lvmen\src\licensedcode\data\rules\bsd-new_dispatch.yml", "YAML", 0, 0, 0, 2, 0, 0, 1, 3
"d:\IDEWORK\lvmen\src\licensedcode\data\rules\bsd-new_ecos.yml", "YAML", 0, 0, 0, 2, 0, 0, 1, 3
"d:\IDEWORK\lvmen\src\licensedcode\data\rules\bsd-new_g3d.yml", "YAML", 0, 0, 0, 3, 0, 0, 1, 4
"d:\IDEWORK\lvmen\src\licensedcode\data\rules\bsd-new_jcraft.yml", "YAML", 0, 0, 0, 6, 0, 0, 1, 7
"d:\IDEWORK\lvmen\src\licensedcode\data\rules\bsd-new_jcraft_2.yml", "YAML", 0, 0, 0, 2, 0, 0, 1, 3
"d:\IDEWORK\lvmen\src\licensedcode\data\rules\bsd-new_jcraft_3.yml", "YAML", 0, 0, 0, 5, 0, 0, 1, 6
"d:\IDEWORK\lvmen\src\licensedcode\data\rules\bsd-new_jcraft_4.yml", "YAML", 0, 0, 0, 5, 0, 0, 1, 6
"d:\IDEWORK\lvmen\src\licensedcode\data\rules\bsd-new_jcraft_5.yml", "YAML", 0, 0, 0, 6, 0, 0, 1, 7
"d:\IDEWORK\lvmen\src\licensedcode\data\rules\bsd-new_jython_1.yml", "YAML", 0, 0, 0, 2, 0, 0, 1, 3
"d:\IDEWORK\lvmen\src\licensedcode\data\rules\bsd-new_jython_2.yml", "YAML", 0, 0, 0, 3, 0, 0, 1, 4
"d:\IDEWORK\lvmen\src\licensedcode\data\rules\bsd-new_maven.yml", "YAML", 0, 0, 0, 5, 0, 0, 1, 6
"d:\IDEWORK\lvmen\src\licensedcode\data\rules\bsd-new_newlib.yml", "YAML", 0, 0, 0, 4, 0, 0, 1, 5
"d:\IDEWORK\lvmen\src\licensedcode\data\rules\bsd-new_newlib2.yml", "YAML", 0, 0, 0, 4, 0, 0, 1, 5
"d:\IDEWORK\lvmen\src\licensedcode\data\rules\bsd-new_newlib3.yml", "YAML", 0, 0, 0, 2, 0, 0, 1, 3
"d:\IDEWORK\lvmen\src\licensedcode\data\rules\bsd-new_newlib5.yml", "YAML", 0, 0, 0, 2, 0, 0, 1, 3
"d:\IDEWORK\lvmen\src\licensedcode\data\rules\bsd-new_npm.yml", "YAML", 0, 0, 0, 3, 0, 0, 1, 4
"d:\IDEWORK\lvmen\src\licensedcode\data\rules\bsd-new_nuget_url_1.yml", "YAML", 0, 0, 0, 5, 0, 0, 1, 6
"d:\IDEWORK\lvmen\src\licensedcode\data\rules\bsd-new_nuget_url_2.yml", "YAML", 0, 0, 0, 5, 0, 0, 1, 6
"d:\IDEWORK\lvmen\src\licensedcode\data\rules\bsd-new_nuget_url_3.yml", "YAML", 0, 0, 0, 5, 0, 0, 1, 6
"d:\IDEWORK\lvmen\src\licensedcode\data\rules\bsd-new_nuget_url_4.yml", "YAML", 0, 0, 0, 5, 0, 0, 1, 6
"d:\IDEWORK\lvmen\src\licensedcode\data\rules\bsd-new_or_afl-2.1_1.yml", "YAML", 0, 0, 0, 2, 0, 0, 1, 3
"d:\IDEWORK\lvmen\src\licensedcode\data\rules\bsd-new_or_afl-2.1_2.yml", "YAML", 0, 0, 0, 2, 0, 0, 1, 3
"d:\IDEWORK\lvmen\src\licensedcode\data\rules\bsd-new_or_apache-2.0.yml", "YAML", 0, 0, 0, 3, 0, 0, 1, 4
"d:\IDEWORK\lvmen\src\licensedcode\data\rules\bsd-new_or_apache-2.0_1.yml", "YAML", 0, 0, 0, 3, 0, 0, 1, 4
"d:\IDEWORK\lvmen\src\licensedcode\data\rules\bsd-new_or_apache-2.0_2.yml", "YAML", 0, 0, 0, 3, 0, 0, 1, 4
"d:\IDEWORK\lvmen\src\licensedcode\data\rules\bsd-new_or_apache-2.0_3.yml", "YAML", 0, 0, 0, 5, 0, 0, 1, 6
"d:\IDEWORK\lvmen\src\licensedcode\data\rules\bsd-new_or_apache-2.0_or_gpl-2.0-plus_or_lgpl-2.1-plus_1.yml", "YAML", 0, 0, 0, 7, 0, 0, 1, 8
"d:\IDEWORK\lvmen\src\licensedcode\data\rules\bsd-new_or_apache-2.0_or_gpl-2.0-plus_or_lgpl-2.1-plus_2.yml", "YAML", 0, 0, 0, 8, 0, 0, 1, 9
"d:\IDEWORK\lvmen\src\licensedcode\data\rules\bsd-new_or_epl-1.0_1.yml", "YAML", 0, 0, 0, 6, 0, 0, 1, 7
"d:\IDEWORK\lvmen\src\licensedcode\data\rules\bsd-new_or_epl-1.0_2.yml", "YAML", 0, 0, 0, 6, 0, 0, 1, 7
"d:\IDEWORK\lvmen\src\licensedcode\data\rules\bsd-new_or_epl-1.0_or_apache-2.0_or_mit_1.yml", "YAML", 0, 0, 0, 7, 0, 0, 1, 8
"d:\IDEWORK\lvmen\src\licensedcode\data\rules\bsd-new_or_epl-2.0_1.yml", "YAML", 0, 0, 0, 3, 0, 0, 1, 4
"d:\IDEWORK\lvmen\src\licensedcode\data\rules\bsd-new_or_epl-2.0_2.yml", "YAML", 0, 0, 0, 6, 0, 0, 1, 7
"d:\IDEWORK\lvmen\src\licensedcode\data\rules\bsd-new_or_epl-2.0_3.yml", "YAML", 0, 0, 0, 3, 0, 0, 1, 4
"d:\IDEWORK\lvmen\src\licensedcode\data\rules\bsd-new_or_epl-2.0_4.yml", "YAML", 0, 0, 0, 6, 0, 0, 1, 7
"d:\IDEWORK\lvmen\src\licensedcode\data\rules\bsd-new_or_epl-2.0_5.yml", "YAML", 0, 0, 0, 6, 0, 0, 1, 7
"d:\IDEWORK\lvmen\src\licensedcode\data\rules\bsd-new_or_epl-2.0_6.yml", "YAML", 0, 0, 0, 6, 0, 0, 1, 7
"d:\IDEWORK\lvmen\src\licensedcode\data\rules\bsd-new_or_epl-2.0_7.yml", "YAML", 0, 0, 0, 6, 0, 0, 1, 7
"d:\IDEWORK\lvmen\src\licensedcode\data\rules\bsd-new_or_epl-2.0_8.yml", "YAML", 0, 0, 0, 6, 0, 0, 1, 7
"d:\IDEWORK\lvmen\src\licensedcode\data\rules\bsd-new_or_gpl-1.0-plus_1.yml", "YAML", 0, 0, 0, 4, 0, 0, 1, 5
"d:\IDEWORK\lvmen\src\licensedcode\data\rules\bsd-new_or_gpl-1.0-plus_2.yml", "YAML", 0, 0, 0, 3, 0, 0, 1, 4
"d:\IDEWORK\lvmen\src\licensedcode\data\rules\bsd-new_or_gpl-1.0-plus_3.yml", "YAML", 0, 0, 0, 3, 0, 0, 1, 4
"d:\IDEWORK\lvmen\src\licensedcode\data\rules\bsd-new_or_gpl-1.0-plus_4.yml", "YAML", 0, 0, 0, 3, 0, 0, 1, 4
"d:\IDEWORK\lvmen\src\licensedcode\data\rules\bsd-new_or_gpl-1.0-plus_5.yml", "YAML", 0, 0, 0, 3, 0, 0, 1, 4
"d:\IDEWORK\lvmen\src\licensedcode\data\rules\bsd-new_or_gpl-1.0-plus_6.yml", "YAML", 0, 0, 0, 3, 0, 0, 1, 4
"d:\IDEWORK\lvmen\src\licensedcode\data\rules\bsd-new_or_gpl-1.0-plus_7.yml", "YAML", 0, 0, 0, 3, 0, 0, 1, 4
"d:\IDEWORK\lvmen\src\licensedcode\data\rules\bsd-new_or_gpl-1.0-plus_or_other-permissive_or_other-copyleft_1.yml", "YAML", 0, 0, 0, 5, 0, 0, 1, 6
"d:\IDEWORK\lvmen\src\licensedcode\data\rules\bsd-new_or_gpl-2.0-plus_1.yml", "YAML", 0, 0, 0, 3, 0, 0, 1, 4
"d:\IDEWORK\lvmen\src\licensedcode\data\rules\bsd-new_or_gpl-2.0-plus_2.yml", "YAML", 0, 0, 0, 3, 0, 0, 1, 4
"d:\IDEWORK\lvmen\src\licensedcode\data\rules\bsd-new_or_gpl-2.0-plus_3.yml", "YAML", 0, 0, 0, 3, 0, 0, 1, 4
"d:\IDEWORK\lvmen\src\licensedcode\data\rules\bsd-new_or_gpl-2.0-plus_4.yml", "YAML", 0, 0, 0, 3, 0, 0, 1, 4
"d:\IDEWORK\lvmen\src\licensedcode\data\rules\bsd-new_or_gpl-2.0-plus_5.yml", "YAML", 0, 0, 0, 3, 0, 0, 1, 4
"d:\IDEWORK\lvmen\src\licensedcode\data\rules\bsd-new_or_gpl-2.0-plus_6.yml", "YAML", 0, 0, 0, 2, 0, 0, 1, 3
"d:\IDEWORK\lvmen\src\licensedcode\data\rules\bsd-new_or_gpl-2.0-plus_7.yml", "YAML", 0, 0, 0, 2, 0, 0, 1, 3
"d:\IDEWORK\lvmen\src\licensedcode\data\rules\bsd-new_or_gpl-2.0-plus_libcap_1.yml", "YAML", 0, 0, 0, 4, 0, 0, 1, 5
"d:\IDEWORK\lvmen\src\licensedcode\data\rules\bsd-new_or_gpl-2.0-plus_libcap_2.yml", "YAML", 0, 0, 0, 5, 0, 0, 1, 6
"d:\IDEWORK\lvmen\src\licensedcode\data\rules\bsd-new_or_gpl-2.0-plus_libcap_3.yml", "YAML", 0, 0, 0, 5, 0, 0, 1, 6
"d:\IDEWORK\lvmen\src\licensedcode\data\rules\bsd-new_or_gpl-2.0-plus_libcap_4.yml", "YAML", 0, 0, 0, 4, 0, 0, 1, 5
"d:\IDEWORK\lvmen\src\licensedcode\data\rules\bsd-new_or_gpl-2.0_1.yml", "YAML", 0, 0, 0, 3, 0, 0, 1, 4
"d:\IDEWORK\lvmen\src\licensedcode\data\rules\bsd-new_or_gpl-2.0_10.yml", "YAML", 0, 0, 0, 3, 0, 0, 1, 4
"d:\IDEWORK\lvmen\src\licensedcode\data\rules\bsd-new_or_gpl-2.0_11.yml", "YAML", 0, 0, 0, 3, 0, 0, 1, 4
"d:\IDEWORK\lvmen\src\licensedcode\data\rules\bsd-new_or_gpl-2.0_12.yml", "YAML", 0, 0, 0, 3, 0, 0, 1, 4
"d:\IDEWORK\lvmen\src\licensedcode\data\rules\bsd-new_or_gpl-2.0_13.yml", "YAML", 0, 0, 0, 2, 0, 0, 1, 3
"d:\IDEWORK\lvmen\src\licensedcode\data\rules\bsd-new_or_gpl-2.0_14.yml", "YAML", 0, 0, 0, 2, 0, 0, 1, 3
"d:\IDEWORK\lvmen\src\licensedcode\data\rules\bsd-new_or_gpl-2.0_15.yml", "YAML", 0, 0, 0, 3, 0, 0, 1, 4
"d:\IDEWORK\lvmen\src\licensedcode\data\rules\bsd-new_or_gpl-2.0_16.yml", "YAML", 0, 0, 0, 6, 0, 0, 1, 7
"d:\IDEWORK\lvmen\src\licensedcode\data\rules\bsd-new_or_gpl-2.0_17.yml", "YAML", 0, 0, 0, 6, 0, 0, 1, 7
"d:\IDEWORK\lvmen\src\licensedcode\data\rules\bsd-new_or_gpl-2.0_18.yml", "YAML", 0, 0, 0, 3, 0, 0, 1, 4
"d:\IDEWORK\lvmen\src\licensedcode\data\rules\bsd-new_or_gpl-2.0_19.yml", "YAML", 0, 0, 0, 3, 0, 0, 1, 4
"d:\IDEWORK\lvmen\src\licensedcode\data\rules\bsd-new_or_gpl-2.0_2.yml", "YAML", 0, 0, 0, 4, 0, 0, 1, 5
"d:\IDEWORK\lvmen\src\licensedcode\data\rules\bsd-new_or_gpl-2.0_20.yml", "YAML", 0, 0, 0, 3, 0, 0, 1, 4
"d:\IDEWORK\lvmen\src\licensedcode\data\rules\bsd-new_or_gpl-2.0_21.yml", "YAML", 0, 0, 0, 3, 0, 0, 1, 4
"d:\IDEWORK\lvmen\src\licensedcode\data\rules\bsd-new_or_gpl-2.0_22.yml", "YAML", 0, 0, 0, 6, 0, 0, 1, 7
"d:\IDEWORK\lvmen\src\licensedcode\data\rules\bsd-new_or_gpl-2.0_23.yml", "YAML", 0, 0, 0, 6, 0, 0, 1, 7
"d:\IDEWORK\lvmen\src\licensedcode\data\rules\bsd-new_or_gpl-2.0_24.yml", "YAML", 0, 0, 0, 3, 0, 0, 1, 4
"d:\IDEWORK\lvmen\src\licensedcode\data\rules\bsd-new_or_gpl-2.0_25.yml", "YAML", 0, 0, 0, 3, 0, 0, 1, 4
"d:\IDEWORK\lvmen\src\licensedcode\data\rules\bsd-new_or_gpl-2.0_26.yml", "YAML", 0, 0, 0, 6, 0, 0, 1, 7
"d:\IDEWORK\lvmen\src\licensedcode\data\rules\bsd-new_or_gpl-2.0_27.yml", "YAML", 0, 0, 0, 3, 0, 0, 1, 4
"d:\IDEWORK\lvmen\src\licensedcode\data\rules\bsd-new_or_gpl-2.0_28.yml", "YAML", 0, 0, 0, 5, 0, 0, 1, 6
"d:\IDEWORK\lvmen\src\licensedcode\data\rules\bsd-new_or_gpl-2.0_29.yml", "YAML", 0, 0, 0, 3, 0, 0, 1, 4
"d:\IDEWORK\lvmen\src\licensedcode\data\rules\bsd-new_or_gpl-2.0_3.yml", "YAML", 0, 0, 0, 3, 0, 0, 1, 4
"d:\IDEWORK\lvmen\src\licensedcode\data\rules\bsd-new_or_gpl-2.0_30.yml", "YAML", 0, 0, 0, 9, 0, 0, 1, 10
"d:\IDEWORK\lvmen\src\licensedcode\data\rules\bsd-new_or_gpl-2.0_31.yml", "YAML", 0, 0, 0, 8, 0, 0, 1, 9
"d:\IDEWORK\lvmen\src\licensedcode\data\rules\bsd-new_or_gpl-2.0_32.yml", "YAML", 0, 0, 0, 6, 0, 0, 1, 7
"d:\IDEWORK\lvmen\src\licensedcode\data\rules\bsd-new_or_gpl-2.0_33.yml", "YAML", 0, 0, 0, 3, 0, 0, 1, 4
"d:\IDEWORK\lvmen\src\licensedcode\data\rules\bsd-new_or_gpl-2.0_34.yml", "YAML", 0, 0, 0, 3, 0, 0, 1, 4
"d:\IDEWORK\lvmen\src\licensedcode\data\rules\bsd-new_or_gpl-2.0_35.yml", "YAML", 0, 0, 0, 6, 0, 0, 1, 7
"d:\IDEWORK\lvmen\src\licensedcode\data\rules\bsd-new_or_gpl-2.0_36.yml", "YAML", 0, 0, 0, 3, 0, 0, 1, 4
"d:\IDEWORK\lvmen\src\licensedcode\data\rules\bsd-new_or_gpl-2.0_37.yml", "YAML", 0, 0, 0, 3, 0, 0, 1, 4
"d:\IDEWORK\lvmen\src\licensedcode\data\rules\bsd-new_or_gpl-2.0_38.yml", "YAML", 0, 0, 0, 7, 0, 0, 1, 8
"d:\IDEWORK\lvmen\src\licensedcode\data\rules\bsd-new_or_gpl-2.0_4.yml", "YAML", 0, 0, 0, 5, 0, 0, 1, 6
"d:\IDEWORK\lvmen\src\licensedcode\data\rules\bsd-new_or_gpl-2.0_5.yml", "YAML", 0, 0, 0, 3, 0, 0, 1, 4
"d:\IDEWORK\lvmen\src\licensedcode\data\rules\bsd-new_or_gpl-2.0_6.yml", "YAML", 0, 0, 0, 6, 0, 0, 1, 7
"d:\IDEWORK\lvmen\src\licensedcode\data\rules\bsd-new_or_gpl-2.0_7.yml", "YAML", 0, 0, 0, 3, 0, 0, 1, 4
"d:\IDEWORK\lvmen\src\licensedcode\data\rules\bsd-new_or_gpl-2.0_8.yml", "YAML", 0, 0, 0, 6, 0, 0, 1, 7
"d:\IDEWORK\lvmen\src\licensedcode\data\rules\bsd-new_or_gpl-2.0_9.yml", "YAML", 0, 0, 0, 2, 0, 0, 1, 3
"d:\IDEWORK\lvmen\src\licensedcode\data\rules\bsd-new_or_gpl-2.0_and_generic-cla_1.yml", "YAML", 0, 0, 0, 7, 0, 0, 1, 8
"d:\IDEWORK\lvmen\src\licensedcode\data\rules\bsd-new_or_gpl-2.0_kernel_module_license.yml", "YAML", 0, 0, 0, 6, 0, 0, 1, 7
"d:\IDEWORK\lvmen\src\licensedcode\data\rules\bsd-new_or_gpl-2.0_kernel_module_license_2.yml", "YAML", 0, 0, 0, 5, 0, 0, 1, 6
"d:\IDEWORK\lvmen\src\licensedcode\data\rules\bsd-new_or_gpl.yml", "YAML", 0, 0, 0, 3, 0, 0, 1, 4
"d:\IDEWORK\lvmen\src\licensedcode\data\rules\bsd-new_or_gpl_1.yml", "YAML", 0, 0, 0, 4, 0, 0, 1, 5
"d:\IDEWORK\lvmen\src\licensedcode\data\rules\bsd-new_or_gpl_2.yml", "YAML", 0, 0, 0, 4, 0, 0, 1, 5
"d:\IDEWORK\lvmen\src\licensedcode\data\rules\bsd-new_or_gpl_4.yml", "YAML", 0, 0, 0, 3, 0, 0, 1, 4
"d:\IDEWORK\lvmen\src\licensedcode\data\rules\bsd-new_or_gpl_5.yml", "YAML", 0, 0, 0, 3, 0, 0, 1, 4
"d:\IDEWORK\lvmen\src\licensedcode\data\rules\bsd-new_or_lgpl-2.0-plus_1.yml", "YAML", 0, 0, 0, 5, 0, 0, 1, 6
"d:\IDEWORK\lvmen\src\licensedcode\data\rules\bsd-new_or_lgpl-2.0-plus_2.yml", "YAML", 0, 0, 0, 3, 0, 0, 1, 4
"d:\IDEWORK\lvmen\src\licensedcode\data\rules\bsd-new_or_lgpl-2.0-plus_3.yml", "YAML", 0, 0, 0, 3, 0, 0, 1, 4
"d:\IDEWORK\lvmen\src\licensedcode\data\rules\bsd-new_or_lgpl-2.0-plus_4.yml", "YAML", 0, 0, 0, 2, 0, 0, 1, 3
"d:\IDEWORK\lvmen\src\licensedcode\data\rules\bsd-new_or_lgpl-2.1_1.yml", "YAML", 0, 0, 0, 2, 0, 0, 1, 3
"d:\IDEWORK\lvmen\src\licensedcode\data\rules\bsd-new_or_lgpl-2.1_2.yml", "YAML", 0, 0, 0, 2, 0, 0, 1, 3
"d:\IDEWORK\lvmen\src\licensedcode\data\rules\bsd-new_or_mit_1.yml", "YAML", 0, 0, 0, 3, 0, 0, 1, 4
"d:\IDEWORK\lvmen\src\licensedcode\data\rules\bsd-new_or_mit_2.yml", "YAML", 0, 0, 0, 3, 0, 0, 1, 4
"d:\IDEWORK\lvmen\src\licensedcode\data\rules\bsd-new_or_mit_3.yml", "YAML", 0, 0, 0, 2, 0, 0, 1, 3
"d:\IDEWORK\lvmen\src\licensedcode\data\rules\bsd-new_or_mit_4.yml", "YAML", 0, 0, 0, 3, 0, 0, 1, 4
"d:\IDEWORK\lvmen\src\licensedcode\data\rules\bsd-new_or_mit_5.yml", "YAML", 0, 0, 0, 5, 0, 0, 1, 6
"d:\IDEWORK\lvmen\src\licensedcode\data\rules\bsd-new_or_mit_6.yml", "YAML", 0, 0, 0, 3, 0, 0, 1, 4
"d:\IDEWORK\lvmen\src\licensedcode\data\rules\bsd-new_or_mit_7.yml", "YAML", 0, 0, 0, 5, 0, 0, 1, 6
"d:\IDEWORK\lvmen\src\licensedcode\data\rules\bsd-new_or_other-permissive_1.yml", "YAML", 0, 0, 0, 5, 0, 0, 1, 6
"d:\IDEWORK\lvmen\src\licensedcode\data\rules\bsd-new_or_simplified_10.yml", "YAML", 0, 0, 0, 3, 0, 0, 1, 4
"d:\IDEWORK\lvmen\src\licensedcode\data\rules\bsd-new_protojs_1.yml", "YAML", 0, 0, 0, 6, 0, 0, 1, 7
"d:\IDEWORK\lvmen\src\licensedcode\data\rules\bsd-new_provided_1.yml", "YAML", 0, 0, 0, 5, 0, 0, 1, 6
"d:\IDEWORK\lvmen\src\licensedcode\data\rules\bsd-new_provided_2.yml", "YAML", 0, 0, 0, 4, 0, 0, 1, 5
"d:\IDEWORK\lvmen\src\licensedcode\data\rules\bsd-new_qt.yml", "YAML", 0, 0, 0, 2, 0, 0, 1, 3
"d:\IDEWORK\lvmen\src\licensedcode\data\rules\bsd-new_readme1.yml", "YAML", 0, 0, 0, 3, 0, 0, 1, 4
"d:\IDEWORK\lvmen\src\licensedcode\data\rules\bsd-new_readme2.yml", "YAML", 0, 0, 0, 3, 0, 0, 1, 4
"d:\IDEWORK\lvmen\src\licensedcode\data\rules\bsd-new_readme3.yml", "YAML", 0, 0, 0, 2, 0, 0, 1, 3
"d:\IDEWORK\lvmen\src\licensedcode\data\rules\bsd-new_readme4.yml", "YAML", 0, 0, 0, 2, 0, 0, 1, 3
"d:\IDEWORK\lvmen\src\licensedcode\data\rules\bsd-new_readme5.yml", "YAML", 0, 0, 0, 3, 0, 0, 1, 4
"d:\IDEWORK\lvmen\src\licensedcode\data\rules\bsd-new_see_1.yml", "YAML", 0, 0, 0, 5, 0, 0, 1, 6
"d:\IDEWORK\lvmen\src\licensedcode\data\rules\bsd-new_see_license.yml", "YAML", 0, 0, 0, 5, 0, 0, 1, 6
"d:\IDEWORK\lvmen\src\licensedcode\data\rules\bsd-new_sla.yml", "YAML", 0, 0, 0, 3, 0, 0, 1, 4
"d:\IDEWORK\lvmen\src\licensedcode\data\rules\bsd-new_url_1.yml", "YAML", 0, 0, 0, 5, 0, 0, 1, 6
"d:\IDEWORK\lvmen\src\licensedcode\data\rules\bsd-new_url_2.yml", "YAML", 0, 0, 0, 5, 0, 0, 1, 6
"d:\IDEWORK\lvmen\src\licensedcode\data\rules\bsd-new_url_3.yml", "YAML", 0, 0, 0, 5, 0, 0, 1, 6
"d:\IDEWORK\lvmen\src\licensedcode\data\rules\bsd-new_url_4.yml", "YAML", 0, 0, 0, 5, 0, 0, 1, 6
"d:\IDEWORK\lvmen\src\licensedcode\data\rules\bsd-new_url_5.yml", "YAML", 0, 0, 0, 5, 0, 0, 1, 6
"d:\IDEWORK\lvmen\src\licensedcode\data\rules\bsd-new_url_6.yml", "YAML", 0, 0, 0, 5, 0, 0, 1, 6
"d:\IDEWORK\lvmen\src\licensedcode\data\rules\bsd-new_url_7.yml", "YAML", 0, 0, 0, 5, 0, 0, 1, 6
"d:\IDEWORK\lvmen\src\licensedcode\data\rules\bsd-new_url_8.yml", "YAML", 0, 0, 0, 5, 0, 0, 1, 6
"d:\IDEWORK\lvmen\src\licensedcode\data\rules\bsd-new_url_9.yml", "YAML", 0, 0, 0, 5, 0, 0, 1, 6
"d:\IDEWORK\lvmen\src\licensedcode\data\rules\bsd-new_url_badge.yml", "YAML", 0, 0, 0, 5, 0, 0, 1, 6
"d:\IDEWORK\lvmen\src\licensedcode\data\rules\bsd-new_w3c.yml", "YAML", 0, 0, 0, 5, 0, 0, 1, 6
"d:\IDEWORK\lvmen\src\licensedcode\data\rules\bsd-new_webm_1.yml", "YAML", 0, 0, 0, 5, 0, 0, 1, 6
"d:\IDEWORK\lvmen\src\licensedcode\data\rules\bsd-new_webm_2.yml", "YAML", 0, 0, 0, 4, 0, 0, 1, 5
"d:\IDEWORK\lvmen\src\licensedcode\data\rules\bsd-new_with_ecma-no-patent_1.yml", "YAML", 0, 0, 0, 5, 0, 0, 1, 6
"d:\IDEWORK\lvmen\src\licensedcode\data\rules\bsd-new_with_ecma-no-patent_2.yml", "YAML", 0, 0, 0, 4, 0, 0, 1, 5
"d:\IDEWORK\lvmen\src\licensedcode\data\rules\bsd-new_with_facebook-patent-rights-2_or_gpl-2.0_facebook_1.yml", "YAML", 0, 0, 0, 9, 0, 0, 1, 10
"d:\IDEWORK\lvmen\src\licensedcode\data\rules\bsd-new_with_far-manager-exception_1.yml", "YAML", 0, 0, 0, 4, 0, 0, 1, 5
"d:\IDEWORK\lvmen\src\licensedcode\data\rules\bsd-new_xstream_maven_1.yml", "YAML", 0, 0, 0, 5, 0, 0, 1, 6
"d:\IDEWORK\lvmen\src\licensedcode\data\rules\bsd-new_xstream_maven_2.yml", "YAML", 0, 0, 0, 5, 0, 0, 1, 6
"d:\IDEWORK\lvmen\src\licensedcode\data\rules\bsd-new_xstream_maven_3.yml", "YAML", 0, 0, 0, 5, 0, 0, 1, 6
"d:\IDEWORK\lvmen\src\licensedcode\data\rules\bsd-new_xstream_maven_4.yml", "YAML", 0, 0, 0, 5, 0, 0, 1, 6
"d:\IDEWORK\lvmen\src\licensedcode\data\rules\bsd-new_zlib.yml", "YAML", 0, 0, 0, 3, 0, 0, 1, 4
"d:\IDEWORK\lvmen\src\licensedcode\data\rules\bsd-new_zlib2.yml", "YAML", 0, 0, 0, 3, 0, 0, 1, 4
"d:\IDEWORK\lvmen\src\licensedcode\data\rules\bsd-no-disclaimer-unmodified_or_gpl-2.0-plus.yml", "YAML", 0, 0, 0, 3, 0, 0, 1, 4
"d:\IDEWORK\lvmen\src\licensedcode\data\rules\bsd-no-mod.yml", "YAML", 0, 0, 0, 5, 0, 0, 1, 6
"d:\IDEWORK\lvmen\src\licensedcode\data\rules\bsd-no-mod_1.yml", "YAML", 0, 0, 0, 4, 0, 0, 1, 5
"d:\IDEWORK\lvmen\src\licensedcode\data\rules\bsd-no-mod_2.yml", "YAML", 0, 0, 0, 5, 0, 0, 1, 6
"d:\IDEWORK\lvmen\src\licensedcode\data\rules\bsd-original-uc-1986_1.yml", "YAML", 0, 0, 0, 2, 0, 0, 1, 3
"d:\IDEWORK\lvmen\src\licensedcode\data\rules\bsd-original-uc-1986_2.yml", "YAML", 0, 0, 0, 3, 0, 0, 1, 4
"d:\IDEWORK\lvmen\src\licensedcode\data\rules\bsd-original-uc-1986_3.yml", "YAML", 0, 0, 0, 4, 0, 0, 1, 5
"d:\IDEWORK\lvmen\src\licensedcode\data\rules\bsd-original-uc.yml", "YAML", 0, 0, 0, 5, 0, 0, 1, 6
"d:\IDEWORK\lvmen\src\licensedcode\data\rules\bsd-original-uc_1.yml", "YAML", 0, 0, 0, 5, 0, 0, 1, 6
"d:\IDEWORK\lvmen\src\licensedcode\data\rules\bsd-original-uc_10.yml", "YAML", 0, 0, 0, 3, 0, 0, 2, 5
"d:\IDEWORK\lvmen\src\licensedcode\data\rules\bsd-original-uc_11.yml", "YAML", 0, 0, 0, 3, 0, 0, 1, 4
"d:\IDEWORK\lvmen\src\licensedcode\data\rules\bsd-original-uc_12.yml", "YAML", 0, 0, 0, 4, 0, 0, 2, 6
"d:\IDEWORK\lvmen\src\licensedcode\data\rules\bsd-original-uc_13.yml", "YAML", 0, 0, 0, 5, 0, 0, 1, 6
"d:\IDEWORK\lvmen\src\licensedcode\data\rules\bsd-original-uc_14.yml", "YAML", 0, 0, 0, 7, 0, 0, 1, 8
"d:\IDEWORK\lvmen\src\licensedcode\data\rules\bsd-original-uc_15.yml", "YAML", 0, 0, 0, 5, 0, 0, 1, 6
"d:\IDEWORK\lvmen\src\licensedcode\data\rules\bsd-original-uc_16.yml", "YAML", 0, 0, 0, 3, 0, 0, 1, 4
"d:\IDEWORK\lvmen\src\licensedcode\data\rules\bsd-original-uc_17.yml", "YAML", 0, 0, 0, 3, 0, 0, 1, 4
"d:\IDEWORK\lvmen\src\licensedcode\data\rules\bsd-original-uc_18.yml", "YAML", 0, 0, 0, 5, 0, 0, 1, 6
"d:\IDEWORK\lvmen\src\licensedcode\data\rules\bsd-original-uc_19.yml", "YAML", 0, 0, 0, 3, 0, 0, 1, 4
"d:\IDEWORK\lvmen\src\licensedcode\data\rules\bsd-original-uc_2.yml", "YAML", 0, 0, 0, 5, 0, 0, 1, 6
"d:\IDEWORK\lvmen\src\licensedcode\data\rules\bsd-original-uc_20.yml", "YAML", 0, 0, 0, 6, 0, 0, 1, 7
"d:\IDEWORK\lvmen\src\licensedcode\data\rules\bsd-original-uc_21.yml", "YAML", 0, 0, 0, 6, 0, 0, 1, 7
"d:\IDEWORK\lvmen\src\licensedcode\data\rules\bsd-original-uc_22.yml", "YAML", 0, 0, 0, 3, 0, 0, 1, 4
"d:\IDEWORK\lvmen\src\licensedcode\data\rules\bsd-original-uc_23.yml", "YAML", 0, 0, 0, 8, 0, 0, 2, 10
"d:\IDEWORK\lvmen\src\licensedcode\data\rules\bsd-original-uc_24.yml", "YAML", 0, 0, 0, 5, 0, 0, 1, 6
"d:\IDEWORK\lvmen\src\licensedcode\data\rules\bsd-original-uc_25.yml", "YAML", 0, 0, 0, 3, 0, 0, 1, 4
"d:\IDEWORK\lvmen\src\licensedcode\data\rules\bsd-original-uc_26.yml", "YAML", 0, 0, 0, 5, 0, 0, 1, 6
"d:\IDEWORK\lvmen\src\licensedcode\data\rules\bsd-original-uc_27.yml", "YAML", 0, 0, 0, 6, 0, 0, 1, 7
"d:\IDEWORK\lvmen\src\licensedcode\data\rules\bsd-original-uc_28.yml", "YAML", 0, 0, 0, 6, 0, 0, 1, 7
"d:\IDEWORK\lvmen\src\licensedcode\data\rules\bsd-original-uc_29.yml", "YAML", 0, 0, 0, 5, 0, 0, 1, 6
"d:\IDEWORK\lvmen\src\licensedcode\data\rules\bsd-original-uc_3.yml", "YAML", 0, 0, 0, 5, 0, 0, 1, 6
"d:\IDEWORK\lvmen\src\licensedcode\data\rules\bsd-original-uc_30.yml", "YAML", 0, 0, 0, 4, 0, 0, 1, 5
"d:\IDEWORK\lvmen\src\licensedcode\data\rules\bsd-original-uc_4.yml", "YAML", 0, 0, 0, 5, 0, 0, 1, 6
"d:\IDEWORK\lvmen\src\licensedcode\data\rules\bsd-original-uc_5.yml", "YAML", 0, 0, 0, 3, 0, 0, 1, 4
"d:\IDEWORK\lvmen\src\licensedcode\data\rules\bsd-original-uc_6.yml", "YAML", 0, 0, 0, 3, 0, 0, 1, 4
"d:\IDEWORK\lvmen\src\licensedcode\data\rules\bsd-original-uc_7.yml", "YAML", 0, 0, 0, 6, 0, 0, 2, 8
"d:\IDEWORK\lvmen\src\licensedcode\data\rules\bsd-original-uc_8.yml", "YAML", 0, 0, 0, 5, 0, 0, 1, 6
"d:\IDEWORK\lvmen\src\licensedcode\data\rules\bsd-original-uc_9.yml", "YAML", 0, 0, 0, 8, 0, 0, 1, 9
"d:\IDEWORK\lvmen\src\licensedcode\data\rules\bsd-original-uc_url_1.yml", "YAML", 0, 0, 0, 5, 0, 0, 1, 6
"d:\IDEWORK\lvmen\src\licensedcode\data\rules\bsd-original-uc_url_2.yml", "YAML", 0, 0, 0, 5, 0, 0, 1, 6
"d:\IDEWORK\lvmen\src\licensedcode\data\rules\bsd-original_1.yml", "YAML", 0, 0, 0, 5, 0, 0, 1, 6
"d:\IDEWORK\lvmen\src\licensedcode\data\rules\bsd-original_10.yml", "YAML", 0, 0, 0, 5, 0, 0, 1, 6
"d:\IDEWORK\lvmen\src\licensedcode\data\rules\bsd-original_11.yml", "YAML", 0, 0, 0, 5, 0, 0, 1, 6
"d:\IDEWORK\lvmen\src\licensedcode\data\rules\bsd-original_12.yml", "YAML", 0, 0, 0, 3, 0, 0, 1, 4
"d:\IDEWORK\lvmen\src\licensedcode\data\rules\bsd-original_13.yml", "YAML", 0, 0, 0, 3, 0, 0, 1, 4
"d:\IDEWORK\lvmen\src\licensedcode\data\rules\bsd-original_14.yml", "YAML", 0, 0, 0, 5, 0, 0, 1, 6
"d:\IDEWORK\lvmen\src\licensedcode\data\rules\bsd-original_15.yml", "YAML", 0, 0, 0, 5, 0, 0, 1, 6
"d:\IDEWORK\lvmen\src\licensedcode\data\rules\bsd-original_16.yml", "YAML", 0, 0, 0, 5, 0, 0, 1, 6
"d:\IDEWORK\lvmen\src\licensedcode\data\rules\bsd-original_17.yml", "YAML", 0, 0, 0, 3, 0, 0, 1, 4
"d:\IDEWORK\lvmen\src\licensedcode\data\rules\bsd-original_18.yml", "YAML", 0, 0, 0, 3, 0, 0, 1, 4
"d:\IDEWORK\lvmen\src\licensedcode\data\rules\bsd-original_19.yml", "YAML", 0, 0, 0, 3, 0, 0, 1, 4
"d:\IDEWORK\lvmen\src\licensedcode\data\rules\bsd-original_2.yml", "YAML", 0, 0, 0, 3, 0, 0, 1, 4
"d:\IDEWORK\lvmen\src\licensedcode\data\rules\bsd-original_20.yml", "YAML", 0, 0, 0, 3, 0, 0, 1, 4
"d:\IDEWORK\lvmen\src\licensedcode\data\rules\bsd-original_21.yml", "YAML", 0, 0, 0, 3, 0, 0, 1, 4
"d:\IDEWORK\lvmen\src\licensedcode\data\rules\bsd-original_22.yml", "YAML", 0, 0, 0, 5, 0, 0, 1, 6
"d:\IDEWORK\lvmen\src\licensedcode\data\rules\bsd-original_23.yml", "YAML", 0, 0, 0, 5, 0, 0, 1, 6
"d:\IDEWORK\lvmen\src\licensedcode\data\rules\bsd-original_24.yml", "YAML", 0, 0, 0, 3, 0, 0, 1, 4
"d:\IDEWORK\lvmen\src\licensedcode\data\rules\bsd-original_25.yml", "YAML", 0, 0, 0, 5, 0, 0, 2, 7
"d:\IDEWORK\lvmen\src\licensedcode\data\rules\bsd-original_26.yml", "YAML", 0, 0, 0, 5, 0, 0, 1, 6
"d:\IDEWORK\lvmen\src\licensedcode\data\rules\bsd-original_27.yml", "YAML", 0, 0, 0, 3, 0, 0, 1, 4
"d:\IDEWORK\lvmen\src\licensedcode\data\rules\bsd-original_28.yml", "YAML", 0, 0, 0, 5, 0, 0, 1, 6
"d:\IDEWORK\lvmen\src\licensedcode\data\rules\bsd-original_29.yml", "YAML", 0, 0, 0, 5, 0, 0, 1, 6
"d:\IDEWORK\lvmen\src\licensedcode\data\rules\bsd-original_3.yml", "YAML", 0, 0, 0, 6, 0, 0, 1, 7
"d:\IDEWORK\lvmen\src\licensedcode\data\rules\bsd-original_30.yml", "YAML", 0, 0, 0, 5, 0, 0, 1, 6
"d:\IDEWORK\lvmen\src\licensedcode\data\rules\bsd-original_31.yml", "YAML", 0, 0, 0, 4, 0, 0, 1, 5
"d:\IDEWORK\lvmen\src\licensedcode\data\rules\bsd-original_32.yml", "YAML", 0, 0, 0, 6, 0, 0, 1, 7
"d:\IDEWORK\lvmen\src\licensedcode\data\rules\bsd-original_33.yml", "YAML", 0, 0, 0, 5, 0, 0, 1, 6
"d:\IDEWORK\lvmen\src\licensedcode\data\rules\bsd-original_34.yml", "YAML", 0, 0, 0, 3, 0, 0, 1, 4
"d:\IDEWORK\lvmen\src\licensedcode\data\rules\bsd-original_35.yml", "YAML", 0, 0, 0, 3, 0, 0, 1, 4
"d:\IDEWORK\lvmen\src\licensedcode\data\rules\bsd-original_36.yml", "YAML", 0, 0, 0, 3, 0, 0, 1, 4
"d:\IDEWORK\lvmen\src\licensedcode\data\rules\bsd-original_37.yml", "YAML", 0, 0, 0, 3, 0, 0, 1, 4
"d:\IDEWORK\lvmen\src\licensedcode\data\rules\bsd-original_38.yml", "YAML", 0, 0, 0, 3, 0, 0, 1, 4
"d:\IDEWORK\lvmen\src\licensedcode\data\rules\bsd-original_39.yml", "YAML", 0, 0, 0, 3, 0, 0, 1, 4
"d:\IDEWORK\lvmen\src\licensedcode\data\rules\bsd-original_4.yml", "YAML", 0, 0, 0, 5, 0, 0, 1, 6
"d:\IDEWORK\lvmen\src\licensedcode\data\rules\bsd-original_40.yml", "YAML", 0, 0, 0, 3, 0, 0, 1, 4
"d:\IDEWORK\lvmen\src\licensedcode\data\rules\bsd-original_41.yml", "YAML", 0, 0, 0, 5, 0, 0, 1, 6
"d:\IDEWORK\lvmen\src\licensedcode\data\rules\bsd-original_42.yml", "YAML", 0, 0, 0, 3, 0, 0, 1, 4
"d:\IDEWORK\lvmen\src\licensedcode\data\rules\bsd-original_43.yml", "YAML", 0, 0, 0, 3, 0, 0, 1, 4
"d:\IDEWORK\lvmen\src\licensedcode\data\rules\bsd-original_44.yml", "YAML", 0, 0, 0, 5, 0, 0, 1, 6
"d:\IDEWORK\lvmen\src\licensedcode\data\rules\bsd-original_45.yml", "YAML", 0, 0, 0, 3, 0, 0, 1, 4
"d:\IDEWORK\lvmen\src\licensedcode\data\rules\bsd-original_46.yml", "YAML", 0, 0, 0, 4, 0, 0, 1, 5
"d:\IDEWORK\lvmen\src\licensedcode\data\rules\bsd-original_47.yml", "YAML", 0, 0, 0, 9, 0, 0, 1, 10
"d:\IDEWORK\lvmen\src\licensedcode\data\rules\bsd-original_48.yml", "YAML", 0, 0, 0, 4, 0, 0, 1, 5
"d:\IDEWORK\lvmen\src\licensedcode\data\rules\bsd-original_49.yml", "YAML", 0, 0, 0, 3, 0, 0, 1, 4
"d:\IDEWORK\lvmen\src\licensedcode\data\rules\bsd-original_5.yml", "YAML", 0, 0, 0, 3, 0, 0, 1, 4
"d:\IDEWORK\lvmen\src\licensedcode\data\rules\bsd-original_50.yml", "YAML", 0, 0, 0, 3, 0, 0, 1, 4
"d:\IDEWORK\lvmen\src\licensedcode\data\rules\bsd-original_51.yml", "YAML", 0, 0, 0, 3, 0, 0, 1, 4
"d:\IDEWORK\lvmen\src\licensedcode\data\rules\bsd-original_52.yml", "YAML", 0, 0, 0, 4, 0, 0, 1, 5
"d:\IDEWORK\lvmen\src\licensedcode\data\rules\bsd-original_53.yml", "YAML", 0, 0, 0, 3, 0, 0, 1, 4
"d:\IDEWORK\lvmen\src\licensedcode\data\rules\bsd-original_54.yml", "YAML", 0, 0, 0, 5, 0, 0, 1, 6
"d:\IDEWORK\lvmen\src\licensedcode\data\rules\bsd-original_55.yml", "YAML", 0, 0, 0, 3, 0, 0, 1, 4
"d:\IDEWORK\lvmen\src\licensedcode\data\rules\bsd-original_56.yml", "YAML", 0, 0, 0, 3, 0, 0, 1, 4
"d:\IDEWORK\lvmen\src\licensedcode\data\rules\bsd-original_57.yml", "YAML", 0, 0, 0, 4, 0, 0, 1, 5
"d:\IDEWORK\lvmen\src\licensedcode\data\rules\bsd-original_58.yml", "YAML", 0, 0, 0, 5, 0, 0, 1, 6
"d:\IDEWORK\lvmen\src\licensedcode\data\rules\bsd-original_59.yml", "YAML", 0, 0, 0, 3, 0, 0, 1, 4
"d:\IDEWORK\lvmen\src\licensedcode\data\rules\bsd-original_6.yml", "YAML", 0, 0, 0, 3, 0, 0, 1, 4
"d:\IDEWORK\lvmen\src\licensedcode\data\rules\bsd-original_60.yml", "YAML", 0, 0, 0, 3, 0, 0, 1, 4
"d:\IDEWORK\lvmen\src\licensedcode\data\rules\bsd-original_61.yml", "YAML", 0, 0, 0, 8, 0, 0, 1, 9
"d:\IDEWORK\lvmen\src\licensedcode\data\rules\bsd-original_62.yml", "YAML", 0, 0, 0, 5, 0, 0, 1, 6
"d:\IDEWORK\lvmen\src\licensedcode\data\rules\bsd-original_63.yml", "YAML", 0, 0, 0, 3, 0, 0, 1, 4
"d:\IDEWORK\lvmen\src\licensedcode\data\rules\bsd-original_64.yml", "YAML", 0, 0, 0, 3, 0, 0, 1, 4
"d:\IDEWORK\lvmen\src\licensedcode\data\rules\bsd-original_65.yml", "YAML", 0, 0, 0, 5, 0, 0, 1, 6
"d:\IDEWORK\lvmen\src\licensedcode\data\rules\bsd-original_66.yml", "YAML", 0, 0, 0, 3, 0, 0, 1, 4
"d:\IDEWORK\lvmen\src\licensedcode\data\rules\bsd-original_67.yml", "YAML", 0, 0, 0, 3, 0, 0, 1, 4
"d:\IDEWORK\lvmen\src\licensedcode\data\rules\bsd-original_68.yml", "YAML", 0, 0, 0, 6, 0, 0, 1, 7
"d:\IDEWORK\lvmen\src\licensedcode\data\rules\bsd-original_69.yml", "YAML", 0, 0, 0, 3, 0, 0, 1, 4
"d:\IDEWORK\lvmen\src\licensedcode\data\rules\bsd-original_7.yml", "YAML", 0, 0, 0, 5, 0, 0, 1, 6
"d:\IDEWORK\lvmen\src\licensedcode\data\rules\bsd-original_70.yml", "YAML", 0, 0, 0, 3, 0, 0, 1, 4
"d:\IDEWORK\lvmen\src\licensedcode\data\rules\bsd-original_71.yml", "YAML", 0, 0, 0, 4, 0, 0, 1, 5
"d:\IDEWORK\lvmen\src\licensedcode\data\rules\bsd-original_72.yml", "YAML", 0, 0, 0, 5, 0, 0, 1, 6
"d:\IDEWORK\lvmen\src\licensedcode\data\rules\bsd-original_73.yml", "YAML", 0, 0, 0, 5, 0, 0, 1, 6
"d:\IDEWORK\lvmen\src\licensedcode\data\rules\bsd-original_8.yml", "YAML", 0, 0, 0, 3, 0, 0, 1, 4
"d:\IDEWORK\lvmen\src\licensedcode\data\rules\bsd-original_9.yml", "YAML", 0, 0, 0, 3, 0, 0, 1, 4
"d:\IDEWORK\lvmen\src\licensedcode\data\rules\bsd-original_trimble.yml", "YAML", 0, 0, 0, 5, 0, 0, 1, 6
"d:\IDEWORK\lvmen\src\licensedcode\data\rules\bsd-original_url_1.yml", "YAML", 0, 0, 0, 5, 0, 0, 1, 6
"d:\IDEWORK\lvmen\src\licensedcode\data\rules\bsd-original_url_2.yml", "YAML", 0, 0, 0, 5, 0, 0, 1, 6
"d:\IDEWORK\lvmen\src\licensedcode\data\rules\bsd-plus-mod-notice_1.yml", "YAML", 0, 0, 0, 2, 0, 0, 1, 3
"d:\IDEWORK\lvmen\src\licensedcode\data\rules\bsd-plus-mod-notice_2.yml", "YAML", 0, 0, 0, 2, 0, 0, 1, 3
"d:\IDEWORK\lvmen\src\licensedcode\data\rules\bsd-plus-mod-notice_3.yml", "YAML", 0, 0, 0, 7, 0, 0, 1, 8
"d:\IDEWORK\lvmen\src\licensedcode\data\rules\bsd-plus-mod-notice_4.yml", "YAML", 0, 0, 0, 5, 0, 0, 1, 6
"d:\IDEWORK\lvmen\src\licensedcode\data\rules\bsd-plus-mod-notice_5.yml", "YAML", 0, 0, 0, 5, 0, 0, 1, 6
"d:\IDEWORK\lvmen\src\licensedcode\data\rules\bsd-plus-mod-notice_6.yml", "YAML", 0, 0, 0, 2, 0, 0, 1, 3
"d:\IDEWORK\lvmen\src\licensedcode\data\rules\bsd-plus-patent_1.yml", "YAML", 0, 0, 0, 3, 0, 0, 1, 4
"d:\IDEWORK\lvmen\src\licensedcode\data\rules\bsd-plus-patent_url_1.yml", "YAML", 0, 0, 0, 5, 0, 0, 1, 6
"d:\IDEWORK\lvmen\src\licensedcode\data\rules\bsd-plus-patent_url_2.yml", "YAML", 0, 0, 0, 5, 0, 0, 1, 6
"d:\IDEWORK\lvmen\src\licensedcode\data\rules\bsd-plus-patent_url_glc_68.yml", "YAML", 0, 0, 0, 5, 0, 0, 1, 6
"d:\IDEWORK\lvmen\src\licensedcode\data\rules\bsd-plus-patent_url_glc_69.yml", "YAML", 0, 0, 0, 5, 0, 0, 1, 6
"d:\IDEWORK\lvmen\src\licensedcode\data\rules\bsd-protection_1.yml", "YAML", 0, 0, 0, 6, 0, 0, 1, 7
"d:\IDEWORK\lvmen\src\licensedcode\data\rules\bsd-protection_2.yml", "YAML", 0, 0, 0, 4, 0, 0, 1, 5
"d:\IDEWORK\lvmen\src\licensedcode\data\rules\bsd-protection_url_1.yml", "YAML", 0, 0, 0, 5, 0, 0, 1, 6
"d:\IDEWORK\lvmen\src\licensedcode\data\rules\bsd-protection_url_2.yml", "YAML", 0, 0, 0, 5, 0, 0, 1, 6
"d:\IDEWORK\lvmen\src\licensedcode\data\rules\bsd-simplified-darwin_1.yml", "YAML", 0, 0, 0, 2, 0, 0, 1, 3
"d:\IDEWORK\lvmen\src\licensedcode\data\rules\bsd-simplified-darwin_2.yml", "YAML", 0, 0, 0, 6, 0, 0, 1, 7
"d:\IDEWORK\lvmen\src\licensedcode\data\rules\bsd-simplified-darwin_3.yml", "YAML", 0, 0, 0, 4, 0, 0, 1, 5
"d:\IDEWORK\lvmen\src\licensedcode\data\rules\bsd-simplified-intel_1.yml", "YAML", 0, 0, 0, 2, 0, 0, 1, 3
"d:\IDEWORK\lvmen\src\licensedcode\data\rules\bsd-simplified-source.yml", "YAML", 0, 0, 0, 2, 0, 0, 1, 3
"d:\IDEWORK\lvmen\src\licensedcode\data\rules\bsd-simplified_1.yml", "YAML", 0, 0, 0, 2, 0, 0, 1, 3
"d:\IDEWORK\lvmen\src\licensedcode\data\rules\bsd-simplified_10.yml", "YAML", 0, 0, 0, 3, 0, 0, 1, 4
"d:\IDEWORK\lvmen\src\licensedcode\data\rules\bsd-simplified_100.yml", "YAML", 0, 0, 0, 5, 0, 0, 1, 6
"d:\IDEWORK\lvmen\src\licensedcode\data\rules\bsd-simplified_101.yml", "YAML", 0, 0, 0, 5, 0, 0, 1, 6
"d:\IDEWORK\lvmen\src\licensedcode\data\rules\bsd-simplified_102.yml", "YAML", 0, 0, 0, 5, 0, 0, 1, 6
"d:\IDEWORK\lvmen\src\licensedcode\data\rules\bsd-simplified_103.yml", "YAML", 0, 0, 0, 5, 0, 0, 1, 6
"d:\IDEWORK\lvmen\src\licensedcode\data\rules\bsd-simplified_104.yml", "YAML", 0, 0, 0, 5, 0, 0, 1, 6
"d:\IDEWORK\lvmen\src\licensedcode\data\rules\bsd-simplified_105.yml", "YAML", 0, 0, 0, 5, 0, 0, 1, 6
"d:\IDEWORK\lvmen\src\licensedcode\data\rules\bsd-simplified_106.yml", "YAML", 0, 0, 0, 3, 0, 0, 1, 4
"d:\IDEWORK\lvmen\src\licensedcode\data\rules\bsd-simplified_107.yml", "YAML", 0, 0, 0, 4, 0, 0, 2, 6
"d:\IDEWORK\lvmen\src\licensedcode\data\rules\bsd-simplified_108.yml", "YAML", 0, 0, 0, 3, 0, 0, 1, 4
"d:\IDEWORK\lvmen\src\licensedcode\data\rules\bsd-simplified_109.yml", "YAML", 0, 0, 0, 3, 0, 0, 1, 4
"d:\IDEWORK\lvmen\src\licensedcode\data\rules\bsd-simplified_11.yml", "YAML", 0, 0, 0, 3, 0, 0, 1, 4
"d:\IDEWORK\lvmen\src\licensedcode\data\rules\bsd-simplified_110.yml", "YAML", 0, 0, 0, 3, 0, 0, 1, 4
"d:\IDEWORK\lvmen\src\licensedcode\data\rules\bsd-simplified_111.yml", "YAML", 0, 0, 0, 3, 0, 0, 1, 4
"d:\IDEWORK\lvmen\src\licensedcode\data\rules\bsd-simplified_112.yml", "YAML", 0, 0, 0, 3, 0, 0, 1, 4
"d:\IDEWORK\lvmen\src\licensedcode\data\rules\bsd-simplified_113.yml", "YAML", 0, 0, 0, 3, 0, 0, 1, 4
"d:\IDEWORK\lvmen\src\licensedcode\data\rules\bsd-simplified_114.yml", "YAML", 0, 0, 0, 3, 0, 0, 1, 4
"d:\IDEWORK\lvmen\src\licensedcode\data\rules\bsd-simplified_115.yml", "YAML", 0, 0, 0, 3, 0, 0, 1, 4
"d:\IDEWORK\lvmen\src\licensedcode\data\rules\bsd-simplified_116.yml", "YAML", 0, 0, 0, 5, 0, 0, 1, 6
"d:\IDEWORK\lvmen\src\licensedcode\data\rules\bsd-simplified_117.yml", "YAML", 0, 0, 0, 5, 0, 0, 1, 6
"d:\IDEWORK\lvmen\src\licensedcode\data\rules\bsd-simplified_118.yml", "YAML", 0, 0, 0, 3, 0, 0, 1, 4
"d:\IDEWORK\lvmen\src\licensedcode\data\rules\bsd-simplified_119.yml", "YAML", 0, 0, 0, 4, 0, 0, 2, 6
"d:\IDEWORK\lvmen\src\licensedcode\data\rules\bsd-simplified_12.yml", "YAML", 0, 0, 0, 5, 0, 0, 1, 6
"d:\IDEWORK\lvmen\src\licensedcode\data\rules\bsd-simplified_120.yml", "YAML", 0, 0, 0, 3, 0, 0, 1, 4
"d:\IDEWORK\lvmen\src\licensedcode\data\rules\bsd-simplified_121.yml", "YAML", 0, 0, 0, 5, 0, 0, 1, 6
"d:\IDEWORK\lvmen\src\licensedcode\data\rules\bsd-simplified_122.yml", "YAML", 0, 0, 0, 3, 0, 0, 1, 4
"d:\IDEWORK\lvmen\src\licensedcode\data\rules\bsd-simplified_123.yml", "YAML", 0, 0, 0, 6, 0, 0, 1, 7
"d:\IDEWORK\lvmen\src\licensedcode\data\rules\bsd-simplified_124.yml", "YAML", 0, 0, 0, 5, 0, 0, 1, 6
"d:\IDEWORK\lvmen\src\licensedcode\data\rules\bsd-simplified_125.yml", "YAML", 0, 0, 0, 5, 0, 0, 1, 6
"d:\IDEWORK\lvmen\src\licensedcode\data\rules\bsd-simplified_126.yml", "YAML", 0, 0, 0, 4, 0, 0, 2, 6
"d:\IDEWORK\lvmen\src\licensedcode\data\rules\bsd-simplified_127.yml", "YAML", 0, 0, 0, 3, 0, 0, 1, 4
"d:\IDEWORK\lvmen\src\licensedcode\data\rules\bsd-simplified_128.yml", "YAML", 0, 0, 0, 3, 0, 0, 1, 4
"d:\IDEWORK\lvmen\src\licensedcode\data\rules\bsd-simplified_129.yml", "YAML", 0, 0, 0, 3, 0, 0, 1, 4
"d:\IDEWORK\lvmen\src\licensedcode\data\rules\bsd-simplified_13.yml", "YAML", 0, 0, 0, 3, 0, 0, 1, 4
"d:\IDEWORK\lvmen\src\licensedcode\data\rules\bsd-simplified_130.yml", "YAML", 0, 0, 0, 3, 0, 0, 1, 4
"d:\IDEWORK\lvmen\src\licensedcode\data\rules\bsd-simplified_131.yml", "YAML", 0, 0, 0, 3, 0, 0, 1, 4
"d:\IDEWORK\lvmen\src\licensedcode\data\rules\bsd-simplified_132.yml", "YAML", 0, 0, 0, 3, 0, 0, 1, 4
"d:\IDEWORK\lvmen\src\licensedcode\data\rules\bsd-simplified_133.yml", "YAML", 0, 0, 0, 3, 0, 0, 1, 4
"d:\IDEWORK\lvmen\src\licensedcode\data\rules\bsd-simplified_134.yml", "YAML", 0, 0, 0, 5, 0, 0, 1, 6
"d:\IDEWORK\lvmen\src\licensedcode\data\rules\bsd-simplified_135.yml", "YAML", 0, 0, 0, 3, 0, 0, 1, 4
"d:\IDEWORK\lvmen\src\licensedcode\data\rules\bsd-simplified_136.yml", "YAML", 0, 0, 0, 3, 0, 0, 1, 4
"d:\IDEWORK\lvmen\src\licensedcode\data\rules\bsd-simplified_137.yml", "YAML", 0, 0, 0, 3, 0, 0, 1, 4
"d:\IDEWORK\lvmen\src\licensedcode\data\rules\bsd-simplified_138.yml", "YAML", 0, 0, 0, 5, 0, 0, 1, 6
"d:\IDEWORK\lvmen\src\licensedcode\data\rules\bsd-simplified_139.yml", "YAML", 0, 0, 0, 5, 0, 0, 1, 6
"d:\IDEWORK\lvmen\src\licensedcode\data\rules\bsd-simplified_14.yml", "YAML", 0, 0, 0, 2, 0, 0, 1, 3
"d:\IDEWORK\lvmen\src\licensedcode\data\rules\bsd-simplified_140.yml", "YAML", 0, 0, 0, 4, 0, 0, 2, 6
"d:\IDEWORK\lvmen\src\licensedcode\data\rules\bsd-simplified_141.yml", "YAML", 0, 0, 0, 6, 0, 0, 1, 7
"d:\IDEWORK\lvmen\src\licensedcode\data\rules\bsd-simplified_142.yml", "YAML", 0, 0, 0, 4, 0, 0, 2, 6
"d:\IDEWORK\lvmen\src\licensedcode\data\rules\bsd-simplified_143.yml", "YAML", 0, 0, 0, 6, 0, 0, 1, 7
"d:\IDEWORK\lvmen\src\licensedcode\data\rules\bsd-simplified_144.yml", "YAML", 0, 0, 0, 3, 0, 0, 1, 4
"d:\IDEWORK\lvmen\src\licensedcode\data\rules\bsd-simplified_145.yml", "YAML", 0, 0, 0, 3, 0, 0, 1, 4
"d:\IDEWORK\lvmen\src\licensedcode\data\rules\bsd-simplified_146.yml", "YAML", 0, 0, 0, 3, 0, 0, 1, 4
"d:\IDEWORK\lvmen\src\licensedcode\data\rules\bsd-simplified_147.yml", "YAML", 0, 0, 0, 3, 0, 0, 1, 4
"d:\IDEWORK\lvmen\src\licensedcode\data\rules\bsd-simplified_148.yml", "YAML", 0, 0, 0, 3, 0, 0, 1, 4
"d:\IDEWORK\lvmen\src\licensedcode\data\rules\bsd-simplified_149.yml", "YAML", 0, 0, 0, 3, 0, 0, 1, 4
"d:\IDEWORK\lvmen\src\licensedcode\data\rules\bsd-simplified_15.yml", "YAML", 0, 0, 0, 5, 0, 0, 1, 6
"d:\IDEWORK\lvmen\src\licensedcode\data\rules\bsd-simplified_150.yml", "YAML", 0, 0, 0, 3, 0, 0, 1, 4
"d:\IDEWORK\lvmen\src\licensedcode\data\rules\bsd-simplified_151.yml", "YAML", 0, 0, 0, 3, 0, 0, 1, 4
"d:\IDEWORK\lvmen\src\licensedcode\data\rules\bsd-simplified_152.yml", "YAML", 0, 0, 0, 3, 0, 0, 1, 4
"d:\IDEWORK\lvmen\src\licensedcode\data\rules\bsd-simplified_153.yml", "YAML", 0, 0, 0, 3, 0, 0, 1, 4
"d:\IDEWORK\lvmen\src\licensedcode\data\rules\bsd-simplified_154.yml", "YAML", 0, 0, 0, 3, 0, 0, 1, 4
"d:\IDEWORK\lvmen\src\licensedcode\data\rules\bsd-simplified_155.yml", "YAML", 0, 0, 0, 5, 0, 0, 1, 6
"d:\IDEWORK\lvmen\src\licensedcode\data\rules\bsd-simplified_156.yml", "YAML", 0, 0, 0, 3, 0, 0, 1, 4
"d:\IDEWORK\lvmen\src\licensedcode\data\rules\bsd-simplified_157.yml", "YAML", 0, 0, 0, 3, 0, 0, 1, 4
"d:\IDEWORK\lvmen\src\licensedcode\data\rules\bsd-simplified_158.yml", "YAML", 0, 0, 0, 3, 0, 0, 1, 4
"d:\IDEWORK\lvmen\src\licensedcode\data\rules\bsd-simplified_159.yml", "YAML", 0, 0, 0, 3, 0, 0, 1, 4
"d:\IDEWORK\lvmen\src\licensedcode\data\rules\bsd-simplified_16.yml", "YAML", 0, 0, 0, 2, 0, 0, 1, 3
"d:\IDEWORK\lvmen\src\licensedcode\data\rules\bsd-simplified_160.yml", "YAML", 0, 0, 0, 6, 0, 0, 1, 7
"d:\IDEWORK\lvmen\src\licensedcode\data\rules\bsd-simplified_161.yml", "YAML", 0, 0, 0, 3, 0, 0, 1, 4
"d:\IDEWORK\lvmen\src\licensedcode\data\rules\bsd-simplified_162.yml", "YAML", 0, 0, 0, 3, 0, 0, 1, 4
"d:\IDEWORK\lvmen\src\licensedcode\data\rules\bsd-simplified_163.yml", "YAML", 0, 0, 0, 3, 0, 0, 1, 4
"d:\IDEWORK\lvmen\src\licensedcode\data\rules\bsd-simplified_164.yml", "YAML", 0, 0, 0, 3, 0, 0, 1, 4
"d:\IDEWORK\lvmen\src\licensedcode\data\rules\bsd-simplified_165.yml", "YAML", 0, 0, 0, 3, 0, 0, 1, 4
"d:\IDEWORK\lvmen\src\licensedcode\data\rules\bsd-simplified_166.yml", "YAML", 0, 0, 0, 5, 0, 0, 1, 6
"d:\IDEWORK\lvmen\src\licensedcode\data\rules\bsd-simplified_167.yml", "YAML", 0, 0, 0, 5, 0, 0, 1, 6
"d:\IDEWORK\lvmen\src\licensedcode\data\rules\bsd-simplified_168.yml", "YAML", 0, 0, 0, 3, 0, 0, 1, 4
"d:\IDEWORK\lvmen\src\licensedcode\data\rules\bsd-simplified_169.yml", "YAML", 0, 0, 0, 3, 0, 0, 1, 4
"d:\IDEWORK\lvmen\src\licensedcode\data\rules\bsd-simplified_17.yml", "YAML", 0, 0, 0, 3, 0, 0, 1, 4
"d:\IDEWORK\lvmen\src\licensedcode\data\rules\bsd-simplified_170.yml", "YAML", 0, 0, 0, 3, 0, 0, 1, 4
"d:\IDEWORK\lvmen\src\licensedcode\data\rules\bsd-simplified_171.yml", "YAML", 0, 0, 0, 5, 0, 0, 1, 6
"d:\IDEWORK\lvmen\src\licensedcode\data\rules\bsd-simplified_172.yml", "YAML", 0, 0, 0, 6, 0, 0, 1, 7
"d:\IDEWORK\lvmen\src\licensedcode\data\rules\bsd-simplified_173.yml", "YAML", 0, 0, 0, 4, 0, 0, 1, 5
"d:\IDEWORK\lvmen\src\licensedcode\data\rules\bsd-simplified_174.yml", "YAML", 0, 0, 0, 4, 0, 0, 1, 5
"d:\IDEWORK\lvmen\src\licensedcode\data\rules\bsd-simplified_175.yml", "YAML", 0, 0, 0, 4, 0, 0, 1, 5
"d:\IDEWORK\lvmen\src\licensedcode\data\rules\bsd-simplified_176.yml", "YAML", 0, 0, 0, 3, 0, 0, 1, 4
"d:\IDEWORK\lvmen\src\licensedcode\data\rules\bsd-simplified_177.yml", "YAML", 0, 0, 0, 6, 0, 0, 1, 7
"d:\IDEWORK\lvmen\src\licensedcode\data\rules\bsd-simplified_178.yml", "YAML", 0, 0, 0, 6, 0, 0, 1, 7
"d:\IDEWORK\lvmen\src\licensedcode\data\rules\bsd-simplified_179.yml", "YAML", 0, 0, 0, 4, 0, 0, 1, 5
"d:\IDEWORK\lvmen\src\licensedcode\data\rules\bsd-simplified_18.yml", "YAML", 0, 0, 0, 2, 0, 0, 1, 3
"d:\IDEWORK\lvmen\src\licensedcode\data\rules\bsd-simplified_180.yml", "YAML", 0, 0, 0, 3, 0, 0, 1, 4
"d:\IDEWORK\lvmen\src\licensedcode\data\rules\bsd-simplified_181.yml", "YAML", 0, 0, 0, 3, 0, 0, 1, 4
"d:\IDEWORK\lvmen\src\licensedcode\data\rules\bsd-simplified_182.yml", "YAML", 0, 0, 0, 3, 0, 0, 1, 4
"d:\IDEWORK\lvmen\src\licensedcode\data\rules\bsd-simplified_183.yml", "YAML", 0, 0, 0, 3, 0, 0, 1, 4
"d:\IDEWORK\lvmen\src\licensedcode\data\rules\bsd-simplified_184.yml", "YAML", 0, 0, 0, 5, 0, 0, 1, 6
"d:\IDEWORK\lvmen\src\licensedcode\data\rules\bsd-simplified_185.yml", "YAML", 0, 0, 0, 3, 0, 0, 1, 4
"d:\IDEWORK\lvmen\src\licensedcode\data\rules\bsd-simplified_186.yml", "YAML", 0, 0, 0, 3, 0, 0, 1, 4
"d:\IDEWORK\lvmen\src\licensedcode\data\rules\bsd-simplified_187.yml", "YAML", 0, 0, 0, 3, 0, 0, 1, 4
"d:\IDEWORK\lvmen\src\licensedcode\data\rules\bsd-simplified_188.yml", "YAML", 0, 0, 0, 3, 0, 0, 1, 4
"d:\IDEWORK\lvmen\src\licensedcode\data\rules\bsd-simplified_189.yml", "YAML", 0, 0, 0, 3, 0, 0, 1, 4
"d:\IDEWORK\lvmen\src\licensedcode\data\rules\bsd-simplified_19.yml", "YAML", 0, 0, 0, 3, 0, 0, 1, 4
"d:\IDEWORK\lvmen\src\licensedcode\data\rules\bsd-simplified_190.yml", "YAML", 0, 0, 0, 3, 0, 0, 1, 4
"d:\IDEWORK\lvmen\src\licensedcode\data\rules\bsd-simplified_191.yml", "YAML", 0, 0, 0, 3, 0, 0, 1, 4
"d:\IDEWORK\lvmen\src\licensedcode\data\rules\bsd-simplified_192.yml", "YAML", 0, 0, 0, 3, 0, 0, 1, 4
"d:\IDEWORK\lvmen\src\licensedcode\data\rules\bsd-simplified_193.yml", "YAML", 0, 0, 0, 7, 0, 0, 1, 8
"d:\IDEWORK\lvmen\src\licensedcode\data\rules\bsd-simplified_194.yml", "YAML", 0, 0, 0, 5, 0, 0, 1, 6
"d:\IDEWORK\lvmen\src\licensedcode\data\rules\bsd-simplified_195.yml", "YAML", 0, 0, 0, 5, 0, 0, 1, 6
"d:\IDEWORK\lvmen\src\licensedcode\data\rules\bsd-simplified_196.yml", "YAML", 0, 0, 0, 5, 0, 0, 1, 6
"d:\IDEWORK\lvmen\src\licensedcode\data\rules\bsd-simplified_197.yml", "YAML", 0, 0, 0, 7, 0, 0, 1, 8
"d:\IDEWORK\lvmen\src\licensedcode\data\rules\bsd-simplified_198.yml", "YAML", 0, 0, 0, 7, 0, 0, 1, 8
"d:\IDEWORK\lvmen\src\licensedcode\data\rules\bsd-simplified_199.yml", "YAML", 0, 0, 0, 3, 0, 0, 1, 4
"d:\IDEWORK\lvmen\src\licensedcode\data\rules\bsd-simplified_2.yml", "YAML", 0, 0, 0, 2, 0, 0, 1, 3
"d:\IDEWORK\lvmen\src\licensedcode\data\rules\bsd-simplified_20.yml", "YAML", 0, 0, 0, 2, 0, 0, 1, 3
"d:\IDEWORK\lvmen\src\licensedcode\data\rules\bsd-simplified_200.yml", "YAML", 0, 0, 0, 3, 0, 0, 1, 4
"d:\IDEWORK\lvmen\src\licensedcode\data\rules\bsd-simplified_201.yml", "YAML", 0, 0, 0, 3, 0, 0, 1, 4
"d:\IDEWORK\lvmen\src\licensedcode\data\rules\bsd-simplified_202.yml", "YAML", 0, 0, 0, 3, 0, 0, 1, 4
"d:\IDEWORK\lvmen\src\licensedcode\data\rules\bsd-simplified_203.yml", "YAML", 0, 0, 0, 3, 0, 0, 1, 4
"d:\IDEWORK\lvmen\src\licensedcode\data\rules\bsd-simplified_204.yml", "YAML", 0, 0, 0, 3, 0, 0, 1, 4
"d:\IDEWORK\lvmen\src\licensedcode\data\rules\bsd-simplified_205.yml", "YAML", 0, 0, 0, 3, 0, 0, 1, 4
"d:\IDEWORK\lvmen\src\licensedcode\data\rules\bsd-simplified_206.yml", "YAML", 0, 0, 0, 3, 0, 0, 1, 4
"d:\IDEWORK\lvmen\src\licensedcode\data\rules\bsd-simplified_207.yml", "YAML", 0, 0, 0, 3, 0, 0, 1, 4
"d:\IDEWORK\lvmen\src\licensedcode\data\rules\bsd-simplified_208.yml", "YAML", 0, 0, 0, 3, 0, 0, 1, 4
"d:\IDEWORK\lvmen\src\licensedcode\data\rules\bsd-simplified_209.yml", "YAML", 0, 0, 0, 3, 0, 0, 1, 4
"d:\IDEWORK\lvmen\src\licensedcode\data\rules\bsd-simplified_21.yml", "YAML", 0, 0, 0, 3, 0, 0, 2, 5
"d:\IDEWORK\lvmen\src\licensedcode\data\rules\bsd-simplified_210.yml", "YAML", 0, 0, 0, 3, 0, 0, 1, 4
"d:\IDEWORK\lvmen\src\licensedcode\data\rules\bsd-simplified_211.yml", "YAML", 0, 0, 0, 3, 0, 0, 1, 4
"d:\IDEWORK\lvmen\src\licensedcode\data\rules\bsd-simplified_212.yml", "YAML", 0, 0, 0, 3, 0, 0, 1, 4
"d:\IDEWORK\lvmen\src\licensedcode\data\rules\bsd-simplified_213.yml", "YAML", 0, 0, 0, 5, 0, 0, 1, 6
"d:\IDEWORK\lvmen\src\licensedcode\data\rules\bsd-simplified_214.yml", "YAML", 0, 0, 0, 3, 0, 0, 1, 4
"d:\IDEWORK\lvmen\src\licensedcode\data\rules\bsd-simplified_215.yml", "YAML", 0, 0, 0, 6, 0, 0, 1, 7
"d:\IDEWORK\lvmen\src\licensedcode\data\rules\bsd-simplified_216.yml", "YAML", 0, 0, 0, 5, 0, 0, 1, 6
"d:\IDEWORK\lvmen\src\licensedcode\data\rules\bsd-simplified_217.yml", "YAML", 0, 0, 0, 3, 0, 0, 1, 4
"d:\IDEWORK\lvmen\src\licensedcode\data\rules\bsd-simplified_218.yml", "YAML", 0, 0, 0, 3, 0, 0, 1, 4
"d:\IDEWORK\lvmen\src\licensedcode\data\rules\bsd-simplified_219.yml", "YAML", 0, 0, 0, 4, 0, 0, 1, 5
"d:\IDEWORK\lvmen\src\licensedcode\data\rules\bsd-simplified_22.yml", "YAML", 0, 0, 0, 2, 0, 0, 1, 3
"d:\IDEWORK\lvmen\src\licensedcode\data\rules\bsd-simplified_220.yml", "YAML", 0, 0, 0, 4, 0, 0, 1, 5
"d:\IDEWORK\lvmen\src\licensedcode\data\rules\bsd-simplified_221.yml", "YAML", 0, 0, 0, 3, 0, 0, 1, 4
"d:\IDEWORK\lvmen\src\licensedcode\data\rules\bsd-simplified_222.yml", "YAML", 0, 0, 0, 5, 0, 0, 1, 6
"d:\IDEWORK\lvmen\src\licensedcode\data\rules\bsd-simplified_223.yml", "YAML", 0, 0, 0, 3, 0, 0, 1, 4
"d:\IDEWORK\lvmen\src\licensedcode\data\rules\bsd-simplified_224.yml", "YAML", 0, 0, 0, 3, 0, 0, 1, 4
"d:\IDEWORK\lvmen\src\licensedcode\data\rules\bsd-simplified_225.yml", "YAML", 0, 0, 0, 3, 0, 0, 1, 4
"d:\IDEWORK\lvmen\src\licensedcode\data\rules\bsd-simplified_226.yml", "YAML", 0, 0, 0, 3, 0, 0, 1, 4
"d:\IDEWORK\lvmen\src\licensedcode\data\rules\bsd-simplified_227.yml", "YAML", 0, 0, 0, 5, 0, 0, 1, 6
"d:\IDEWORK\lvmen\src\licensedcode\data\rules\bsd-simplified_228.yml", "YAML", 0, 0, 0, 5, 0, 0, 1, 6
"d:\IDEWORK\lvmen\src\licensedcode\data\rules\bsd-simplified_229.yml", "YAML", 0, 0, 0, 5, 0, 0, 1, 6
"d:\IDEWORK\lvmen\src\licensedcode\data\rules\bsd-simplified_23.yml", "YAML", 0, 0, 0, 2, 0, 0, 1, 3
"d:\IDEWORK\lvmen\src\licensedcode\data\rules\bsd-simplified_230.yml", "YAML", 0, 0, 0, 5, 0, 0, 1, 6
"d:\IDEWORK\lvmen\src\licensedcode\data\rules\bsd-simplified_231.yml", "YAML", 0, 0, 0, 5, 0, 0, 1, 6
"d:\IDEWORK\lvmen\src\licensedcode\data\rules\bsd-simplified_232.yml", "YAML", 0, 0, 0, 5, 0, 0, 1, 6
"d:\IDEWORK\lvmen\src\licensedcode\data\rules\bsd-simplified_233.yml", "YAML", 0, 0, 0, 3, 0, 0, 1, 4
"d:\IDEWORK\lvmen\src\licensedcode\data\rules\bsd-simplified_234.yml", "YAML", 0, 0, 0, 3, 0, 0, 1, 4
"d:\IDEWORK\lvmen\src\licensedcode\data\rules\bsd-simplified_235.yml", "YAML", 0, 0, 0, 3, 0, 0, 1, 4
"d:\IDEWORK\lvmen\src\licensedcode\data\rules\bsd-simplified_236.yml", "YAML", 0, 0, 0, 3, 0, 0, 1, 4
"d:\IDEWORK\lvmen\src\licensedcode\data\rules\bsd-simplified_237.yml", "YAML", 0, 0, 0, 4, 0, 0, 1, 5
"d:\IDEWORK\lvmen\src\licensedcode\data\rules\bsd-simplified_238.yml", "YAML", 0, 0, 0, 4, 0, 0, 1, 5
"d:\IDEWORK\lvmen\src\licensedcode\data\rules\bsd-simplified_239.yml", "YAML", 0, 0, 0, 6, 0, 0, 1, 7
"d:\IDEWORK\lvmen\src\licensedcode\data\rules\bsd-simplified_24.yml", "YAML", 0, 0, 0, 3, 0, 0, 1, 4
"d:\IDEWORK\lvmen\src\licensedcode\data\rules\bsd-simplified_240.yml", "YAML", 0, 0, 0, 6, 0, 0, 1, 7
"d:\IDEWORK\lvmen\src\licensedcode\data\rules\bsd-simplified_241.yml", "YAML", 0, 0, 0, 3, 0, 0, 1, 4
"d:\IDEWORK\lvmen\src\licensedcode\data\rules\bsd-simplified_242.yml", "YAML", 0, 0, 0, 3, 0, 0, 1, 4
"d:\IDEWORK\lvmen\src\licensedcode\data\rules\bsd-simplified_243.yml", "YAML", 0, 0, 0, 4, 0, 0, 1, 5
"d:\IDEWORK\lvmen\src\licensedcode\data\rules\bsd-simplified_244.yml", "YAML", 0, 0, 0, 4, 0, 0, 1, 5
"d:\IDEWORK\lvmen\src\licensedcode\data\rules\bsd-simplified_245.yml", "YAML", 0, 0, 0, 4, 0, 0, 1, 5
"d:\IDEWORK\lvmen\src\licensedcode\data\rules\bsd-simplified_246.yml", "YAML", 0, 0, 0, 4, 0, 0, 1, 5
"d:\IDEWORK\lvmen\src\licensedcode\data\rules\bsd-simplified_247.yml", "YAML", 0, 0, 0, 4, 0, 0, 1, 5
"d:\IDEWORK\lvmen\src\licensedcode\data\rules\bsd-simplified_248.yml", "YAML", 0, 0, 0, 6, 0, 0, 1, 7
"d:\IDEWORK\lvmen\src\licensedcode\data\rules\bsd-simplified_249.yml", "YAML", 0, 0, 0, 3, 0, 0, 1, 4
"d:\IDEWORK\lvmen\src\licensedcode\data\rules\bsd-simplified_25.yml", "YAML", 0, 0, 0, 3, 0, 0, 2, 5
"d:\IDEWORK\lvmen\src\licensedcode\data\rules\bsd-simplified_250.yml", "YAML", 0, 0, 0, 4, 0, 0, 1, 5
"d:\IDEWORK\lvmen\src\licensedcode\data\rules\bsd-simplified_251.yml", "YAML", 0, 0, 0, 4, 0, 0, 1, 5
"d:\IDEWORK\lvmen\src\licensedcode\data\rules\bsd-simplified_252.yml", "YAML", 0, 0, 0, 3, 0, 0, 1, 4
"d:\IDEWORK\lvmen\src\licensedcode\data\rules\bsd-simplified_253.yml", "YAML", 0, 0, 0, 6, 0, 0, 1, 7
"d:\IDEWORK\lvmen\src\licensedcode\data\rules\bsd-simplified_254.yml", "YAML", 0, 0, 0, 6, 0, 0, 1, 7
"d:\IDEWORK\lvmen\src\licensedcode\data\rules\bsd-simplified_255.yml", "YAML", 0, 0, 0, 5, 0, 0, 1, 6
"d:\IDEWORK\lvmen\src\licensedcode\data\rules\bsd-simplified_256.yml", "YAML", 0, 0, 0, 3, 0, 0, 1, 4
"d:\IDEWORK\lvmen\src\licensedcode\data\rules\bsd-simplified_257.yml", "YAML", 0, 0, 0, 3, 0, 0, 1, 4
"d:\IDEWORK\lvmen\src\licensedcode\data\rules\bsd-simplified_258.yml", "YAML", 0, 0, 0, 3, 0, 0, 1, 4
"d:\IDEWORK\lvmen\src\licensedcode\data\rules\bsd-simplified_259.yml", "YAML", 0, 0, 0, 3, 0, 0, 1, 4
"d:\IDEWORK\lvmen\src\licensedcode\data\rules\bsd-simplified_26.yml", "YAML", 0, 0, 0, 3, 0, 0, 2, 5
"d:\IDEWORK\lvmen\src\licensedcode\data\rules\bsd-simplified_260.yml", "YAML", 0, 0, 0, 3, 0, 0, 1, 4
"d:\IDEWORK\lvmen\src\licensedcode\data\rules\bsd-simplified_261.yml", "YAML", 0, 0, 0, 5, 0, 0, 1, 6
"d:\IDEWORK\lvmen\src\licensedcode\data\rules\bsd-simplified_262.yml", "YAML", 0, 0, 0, 6, 0, 0, 1, 7
"d:\IDEWORK\lvmen\src\licensedcode\data\rules\bsd-simplified_263.yml", "YAML", 0, 0, 0, 4, 0, 0, 1, 5
"d:\IDEWORK\lvmen\src\licensedcode\data\rules\bsd-simplified_264.yml", "YAML", 0, 0, 0, 4, 0, 0, 1, 5
"d:\IDEWORK\lvmen\src\licensedcode\data\rules\bsd-simplified_265.yml", "YAML", 0, 0, 0, 3, 0, 0, 1, 4
"d:\IDEWORK\lvmen\src\licensedcode\data\rules\bsd-simplified_266.yml", "YAML", 0, 0, 0, 4, 0, 0, 1, 5
"d:\IDEWORK\lvmen\src\licensedcode\data\rules\bsd-simplified_267.yml", "YAML", 0, 0, 0, 5, 0, 0, 1, 6
"d:\IDEWORK\lvmen\src\licensedcode\data\rules\bsd-simplified_268.yml", "YAML", 0, 0, 0, 3, 0, 0, 1, 4
"d:\IDEWORK\lvmen\src\licensedcode\data\rules\bsd-simplified_269.yml", "YAML", 0, 0, 0, 5, 0, 0, 1, 6
"d:\IDEWORK\lvmen\src\licensedcode\data\rules\bsd-simplified_27.yml", "YAML", 0, 0, 0, 2, 0, 0, 1, 3
"d:\IDEWORK\lvmen\src\licensedcode\data\rules\bsd-simplified_270.yml", "YAML", 0, 0, 0, 3, 0, 0, 1, 4
"d:\IDEWORK\lvmen\src\licensedcode\data\rules\bsd-simplified_271.yml", "YAML", 0, 0, 0, 5, 0, 0, 1, 6
"d:\IDEWORK\lvmen\src\licensedcode\data\rules\bsd-simplified_272.yml", "YAML", 0, 0, 0, 5, 0, 0, 1, 6
"d:\IDEWORK\lvmen\src\licensedcode\data\rules\bsd-simplified_273.yml", "YAML", 0, 0, 0, 3, 0, 0, 1, 4
"d:\IDEWORK\lvmen\src\licensedcode\data\rules\bsd-simplified_274.yml", "YAML", 0, 0, 0, 2, 0, 0, 1, 3
"d:\IDEWORK\lvmen\src\licensedcode\data\rules\bsd-simplified_275.yml", "YAML", 0, 0, 0, 2, 0, 0, 1, 3
"d:\IDEWORK\lvmen\src\licensedcode\data\rules\bsd-simplified_28.yml", "YAML", 0, 0, 0, 3, 0, 0, 1, 4
"d:\IDEWORK\lvmen\src\licensedcode\data\rules\bsd-simplified_29.yml", "YAML", 0, 0, 0, 2, 0, 0, 1, 3
"d:\IDEWORK\lvmen\src\licensedcode\data\rules\bsd-simplified_3.yml", "YAML", 0, 0, 0, 3, 0, 0, 1, 4
"d:\IDEWORK\lvmen\src\licensedcode\data\rules\bsd-simplified_30.yml", "YAML", 0, 0, 0, 2, 0, 0, 1, 3
"d:\IDEWORK\lvmen\src\licensedcode\data\rules\bsd-simplified_31.yml", "YAML", 0, 0, 0, 2, 0, 0, 1, 3
"d:\IDEWORK\lvmen\src\licensedcode\data\rules\bsd-simplified_32.yml", "YAML", 0, 0, 0, 2, 0, 0, 1, 3
"d:\IDEWORK\lvmen\src\licensedcode\data\rules\bsd-simplified_32_1.yml", "YAML", 0, 0, 0, 3, 0, 0, 2, 5
"d:\IDEWORK\lvmen\src\licensedcode\data\rules\bsd-simplified_32_3.yml", "YAML", 0, 0, 0, 3, 0, 0, 2, 5
"d:\IDEWORK\lvmen\src\licensedcode\data\rules\bsd-simplified_32_4.yml", "YAML", 0, 0, 0, 2, 0, 0, 1, 3
"d:\IDEWORK\lvmen\src\licensedcode\data\rules\bsd-simplified_33.yml", "YAML", 0, 0, 0, 2, 0, 0, 1, 3
"d:\IDEWORK\lvmen\src\licensedcode\data\rules\bsd-simplified_34.yml", "YAML", 0, 0, 0, 2, 0, 0, 1, 3
"d:\IDEWORK\lvmen\src\licensedcode\data\rules\bsd-simplified_35.yml", "YAML", 0, 0, 0, 2, 0, 0, 1, 3
"d:\IDEWORK\lvmen\src\licensedcode\data\rules\bsd-simplified_36.yml", "YAML", 0, 0, 0, 2, 0, 0, 1, 3
"d:\IDEWORK\lvmen\src\licensedcode\data\rules\bsd-simplified_37.yml", "YAML", 0, 0, 0, 2, 0, 0, 1, 3
"d:\IDEWORK\lvmen\src\licensedcode\data\rules\bsd-simplified_38.yml", "YAML", 0, 0, 0, 3, 0, 0, 1, 4
"d:\IDEWORK\lvmen\src\licensedcode\data\rules\bsd-simplified_39.yml", "YAML", 0, 0, 0, 3, 0, 0, 1, 4
"d:\IDEWORK\lvmen\src\licensedcode\data\rules\bsd-simplified_4.yml", "YAML", 0, 0, 0, 5, 0, 0, 1, 6
"d:\IDEWORK\lvmen\src\licensedcode\data\rules\bsd-simplified_40.yml", "YAML", 0, 0, 0, 2, 0, 0, 1, 3
"d:\IDEWORK\lvmen\src\licensedcode\data\rules\bsd-simplified_41.yml", "YAML", 0, 0, 0, 2, 0, 0, 1, 3
"d:\IDEWORK\lvmen\src\licensedcode\data\rules\bsd-simplified_42.yml", "YAML", 0, 0, 0, 3, 0, 0, 1, 4
"d:\IDEWORK\lvmen\src\licensedcode\data\rules\bsd-simplified_43.yml", "YAML", 0, 0, 0, 4, 0, 0, 2, 6
"d:\IDEWORK\lvmen\src\licensedcode\data\rules\bsd-simplified_44.yml", "YAML", 0, 0, 0, 4, 0, 0, 2, 6
"d:\IDEWORK\lvmen\src\licensedcode\data\rules\bsd-simplified_45.yml", "YAML", 0, 0, 0, 2, 0, 0, 1, 3
"d:\IDEWORK\lvmen\src\licensedcode\data\rules\bsd-simplified_46.yml", "YAML", 0, 0, 0, 3, 0, 0, 1, 4
"d:\IDEWORK\lvmen\src\licensedcode\data\rules\bsd-simplified_47.yml", "YAML", 0, 0, 0, 5, 0, 0, 1, 6
"d:\IDEWORK\lvmen\src\licensedcode\data\rules\bsd-simplified_48.yml", "YAML", 0, 0, 0, 5, 0, 0, 1, 6
"d:\IDEWORK\lvmen\src\licensedcode\data\rules\bsd-simplified_49.yml", "YAML", 0, 0, 0, 3, 0, 0, 1, 4
"d:\IDEWORK\lvmen\src\licensedcode\data\rules\bsd-simplified_5.yml", "YAML", 0, 0, 0, 2, 0, 0, 1, 3
"d:\IDEWORK\lvmen\src\licensedcode\data\rules\bsd-simplified_50.yml", "YAML", 0, 0, 0, 3, 0, 0, 1, 4
"d:\IDEWORK\lvmen\src\licensedcode\data\rules\bsd-simplified_51.yml", "YAML", 0, 0, 0, 3, 0, 0, 1, 4
"d:\IDEWORK\lvmen\src\licensedcode\data\rules\bsd-simplified_52.yml", "YAML", 0, 0, 0, 2, 0, 0, 1, 3
"d:\IDEWORK\lvmen\src\licensedcode\data\rules\bsd-simplified_53.yml", "YAML", 0, 0, 0, 3, 0, 0, 1, 4
"d:\IDEWORK\lvmen\src\licensedcode\data\rules\bsd-simplified_54.yml", "YAML", 0, 0, 0, 2, 0, 0, 1, 3
"d:\IDEWORK\lvmen\src\licensedcode\data\rules\bsd-simplified_55.yml", "YAML", 0, 0, 0, 2, 0, 0, 1, 3
"d:\IDEWORK\lvmen\src\licensedcode\data\rules\bsd-simplified_56.yml", "YAML", 0, 0, 0, 3, 0, 0, 1, 4
"d:\IDEWORK\lvmen\src\licensedcode\data\rules\bsd-simplified_57.yml", "YAML", 0, 0, 0, 3, 0, 0, 1, 4
"d:\IDEWORK\lvmen\src\licensedcode\data\rules\bsd-simplified_58.yml", "YAML", 0, 0, 0, 4, 0, 0, 1, 5
"d:\IDEWORK\lvmen\src\licensedcode\data\rules\bsd-simplified_59.yml", "YAML", 0, 0, 0, 5, 0, 0, 1, 6
"d:\IDEWORK\lvmen\src\licensedcode\data\rules\bsd-simplified_6.yml", "YAML", 0, 0, 0, 7, 0, 0, 1, 8
"d:\IDEWORK\lvmen\src\licensedcode\data\rules\bsd-simplified_60.yml", "YAML", 0, 0, 0, 5, 0, 0, 1, 6
"d:\IDEWORK\lvmen\src\licensedcode\data\rules\bsd-simplified_61.yml", "YAML", 0, 0, 0, 5, 0, 0, 1, 6
"d:\IDEWORK\lvmen\src\licensedcode\data\rules\bsd-simplified_62.yml", "YAML", 0, 0, 0, 3, 0, 0, 1, 4
"d:\IDEWORK\lvmen\src\licensedcode\data\rules\bsd-simplified_63.yml", "YAML", 0, 0, 0, 3, 0, 0, 1, 4
"d:\IDEWORK\lvmen\src\licensedcode\data\rules\bsd-simplified_64.yml", "YAML", 0, 0, 0, 3, 0, 0, 1, 4
"d:\IDEWORK\lvmen\src\licensedcode\data\rules\bsd-simplified_65.yml", "YAML", 0, 0, 0, 2, 0, 0, 1, 3
"d:\IDEWORK\lvmen\src\licensedcode\data\rules\bsd-simplified_66.yml", "YAML", 0, 0, 0, 3, 0, 0, 1, 4
"d:\IDEWORK\lvmen\src\licensedcode\data\rules\bsd-simplified_67.yml", "YAML", 0, 0, 0, 3, 0, 0, 1, 4
"d:\IDEWORK\lvmen\src\licensedcode\data\rules\bsd-simplified_68.yml", "YAML", 0, 0, 0, 2, 0, 0, 1, 3
"d:\IDEWORK\lvmen\src\licensedcode\data\rules\bsd-simplified_69.yml", "YAML", 0, 0, 0, 3, 0, 0, 1, 4
"d:\IDEWORK\lvmen\src\licensedcode\data\rules\bsd-simplified_7.yml", "YAML", 0, 0, 0, 5, 0, 0, 1, 6
"d:\IDEWORK\lvmen\src\licensedcode\data\rules\bsd-simplified_70.yml", "YAML", 0, 0, 0, 2, 0, 0, 1, 3
"d:\IDEWORK\lvmen\src\licensedcode\data\rules\bsd-simplified_71.yml", "YAML", 0, 0, 0, 2, 0, 0, 1, 3
"d:\IDEWORK\lvmen\src\licensedcode\data\rules\bsd-simplified_72.yml", "YAML", 0, 0, 0, 3, 0, 0, 1, 4
"d:\IDEWORK\lvmen\src\licensedcode\data\rules\bsd-simplified_73.yml", "YAML", 0, 0, 0, 5, 0, 0, 1, 6
"d:\IDEWORK\lvmen\src\licensedcode\data\rules\bsd-simplified_74.yml", "YAML", 0, 0, 0, 3, 0, 0, 1, 4
"d:\IDEWORK\lvmen\src\licensedcode\data\rules\bsd-simplified_75.yml", "YAML", 0, 0, 0, 3, 0, 0, 1, 4
"d:\IDEWORK\lvmen\src\licensedcode\data\rules\bsd-simplified_76.yml", "YAML", 0, 0, 0, 3, 0, 0, 1, 4
"d:\IDEWORK\lvmen\src\licensedcode\data\rules\bsd-simplified_77.yml", "YAML", 0, 0, 0, 3, 0, 0, 1, 4
"d:\IDEWORK\lvmen\src\licensedcode\data\rules\bsd-simplified_78.yml", "YAML", 0, 0, 0, 2, 0, 0, 1, 3
"d:\IDEWORK\lvmen\src\licensedcode\data\rules\bsd-simplified_79.yml", "YAML", 0, 0, 0, 5, 0, 0, 1, 6
"d:\IDEWORK\lvmen\src\licensedcode\data\rules\bsd-simplified_8.yml", "YAML", 0, 0, 0, 2, 0, 0, 1, 3
"d:\IDEWORK\lvmen\src\licensedcode\data\rules\bsd-simplified_80.yml", "YAML", 0, 0, 0, 5, 0, 0, 1, 6
"d:\IDEWORK\lvmen\src\licensedcode\data\rules\bsd-simplified_81.yml", "YAML", 0, 0, 0, 5, 0, 0, 1, 6
"d:\IDEWORK\lvmen\src\licensedcode\data\rules\bsd-simplified_82.yml", "YAML", 0, 0, 0, 5, 0, 0, 1, 6
"d:\IDEWORK\lvmen\src\licensedcode\data\rules\bsd-simplified_83.yml", "YAML", 0, 0, 0, 3, 0, 0, 1, 4
"d:\IDEWORK\lvmen\src\licensedcode\data\rules\bsd-simplified_84.yml", "YAML", 0, 0, 0, 3, 0, 0, 1, 4
"d:\IDEWORK\lvmen\src\licensedcode\data\rules\bsd-simplified_85.yml", "YAML", 0, 0, 0, 3, 0, 0, 1, 4
"d:\IDEWORK\lvmen\src\licensedcode\data\rules\bsd-simplified_86.yml", "YAML", 0, 0, 0, 3, 0, 0, 1, 4
"d:\IDEWORK\lvmen\src\licensedcode\data\rules\bsd-simplified_87.yml", "YAML", 0, 0, 0, 2, 0, 0, 1, 3
"d:\IDEWORK\lvmen\src\licensedcode\data\rules\bsd-simplified_88.yml", "YAML", 0, 0, 0, 3, 0, 0, 1, 4
"d:\IDEWORK\lvmen\src\licensedcode\data\rules\bsd-simplified_89.yml", "YAML", 0, 0, 0, 3, 0, 0, 1, 4
"d:\IDEWORK\lvmen\src\licensedcode\data\rules\bsd-simplified_9.yml", "YAML", 0, 0, 0, 3, 0, 0, 1, 4
"d:\IDEWORK\lvmen\src\licensedcode\data\rules\bsd-simplified_90.yml", "YAML", 0, 0, 0, 3, 0, 0, 1, 4
"d:\IDEWORK\lvmen\src\licensedcode\data\rules\bsd-simplified_91.yml", "YAML", 0, 0, 0, 5, 0, 0, 1, 6
"d:\IDEWORK\lvmen\src\licensedcode\data\rules\bsd-simplified_92.yml", "YAML", 0, 0, 0, 3, 0, 0, 1, 4
"d:\IDEWORK\lvmen\src\licensedcode\data\rules\bsd-simplified_93.yml", "YAML", 0, 0, 0, 3, 0, 0, 1, 4
"d:\IDEWORK\lvmen\src\licensedcode\data\rules\bsd-simplified_94.yml", "YAML", 0, 0, 0, 5, 0, 0, 1, 6
"d:\IDEWORK\lvmen\src\licensedcode\data\rules\bsd-simplified_95.yml", "YAML", 0, 0, 0, 3, 0, 0, 2, 5
"d:\IDEWORK\lvmen\src\licensedcode\data\rules\bsd-simplified_96.yml", "YAML", 0, 0, 0, 4, 0, 0, 1, 5
"d:\IDEWORK\lvmen\src\licensedcode\data\rules\bsd-simplified_97.yml", "YAML", 0, 0, 0, 5, 0, 0, 1, 6
"d:\IDEWORK\lvmen\src\licensedcode\data\rules\bsd-simplified_98.yml", "YAML", 0, 0, 0, 5, 0, 0, 1, 6
"d:\IDEWORK\lvmen\src\licensedcode\data\rules\bsd-simplified_99.yml", "YAML", 0, 0, 0, 3, 0, 0, 1, 4
"d:\IDEWORK\lvmen\src\licensedcode\data\rules\bsd-simplified_and_bsd-new_1.yml", "YAML", 0, 0, 0, 4, 0, 0, 2, 6
"d:\IDEWORK\lvmen\src\licensedcode\data\rules\bsd-simplified_and_bsd-new_2.yml", "YAML", 0, 0, 0, 4, 0, 0, 1, 5
"d:\IDEWORK\lvmen\src\licensedcode\data\rules\bsd-simplified_and_bsd-new_and_unknown-license-reference_nuget_url_1.yml", "YAML", 0, 0, 0, 5, 0, 0, 1, 6
"d:\IDEWORK\lvmen\src\licensedcode\data\rules\bsd-simplified_and_bsd-new_nuget_url_1.yml", "YAML", 0, 0, 0, 5, 0, 0, 1, 6
"d:\IDEWORK\lvmen\src\licensedcode\data\rules\bsd-simplified_and_gpl-2.0_1.yml", "YAML", 0, 0, 0, 5, 0, 0, 1, 6
"d:\IDEWORK\lvmen\src\licensedcode\data\rules\bsd-simplified_and_gpl-2.0_2.yml", "YAML", 0, 0, 0, 4, 0, 0, 1, 5
"d:\IDEWORK\lvmen\src\licensedcode\data\rules\bsd-simplified_and_gpl-2.0_3.yml", "YAML", 0, 0, 0, 4, 0, 0, 1, 5
"d:\IDEWORK\lvmen\src\licensedcode\data\rules\bsd-simplified_and_mpich_1.yml", "YAML", 0, 0, 0, 4, 0, 0, 1, 5
"d:\IDEWORK\lvmen\src\licensedcode\data\rules\bsd-simplified_and_proprietary-license_1.yml", "YAML", 0, 0, 0, 3, 0, 0, 1, 4
"d:\IDEWORK\lvmen\src\licensedcode\data\rules\bsd-simplified_and_unknown_1.yml", "YAML", 0, 0, 0, 4, 0, 0, 1, 5
"d:\IDEWORK\lvmen\src\licensedcode\data\rules\bsd-simplified_and_warranty-disclaimer_1.yml", "YAML", 0, 0, 0, 5, 0, 0, 1, 6
"d:\IDEWORK\lvmen\src\licensedcode\data\rules\bsd-simplified_botan.yml", "YAML", 0, 0, 0, 3, 0, 0, 1, 4
"d:\IDEWORK\lvmen\src\licensedcode\data\rules\bsd-simplified_cryptix_1.yml", "YAML", 0, 0, 0, 4, 0, 0, 1, 5
"d:\IDEWORK\lvmen\src\licensedcode\data\rules\bsd-simplified_cryptix_2.yml", "YAML", 0, 0, 0, 3, 0, 0, 1, 4
"d:\IDEWORK\lvmen\src\licensedcode\data\rules\bsd-simplified_cryptix_3.yml", "YAML", 0, 0, 0, 2, 0, 0, 1, 3
"d:\IDEWORK\lvmen\src\licensedcode\data\rules\bsd-simplified_cryptix_4.yml", "YAML", 0, 0, 0, 3, 0, 0, 2, 5
"d:\IDEWORK\lvmen\src\licensedcode\data\rules\bsd-simplified_docutils.yml", "YAML", 0, 0, 0, 4, 0, 0, 1, 5
"d:\IDEWORK\lvmen\src\licensedcode\data\rules\bsd-simplified_docutils2.yml", "YAML", 0, 0, 0, 3, 0, 0, 1, 4
"d:\IDEWORK\lvmen\src\licensedcode\data\rules\bsd-simplified_docutils3.yml", "YAML", 0, 0, 0, 2, 0, 0, 1, 3
"d:\IDEWORK\lvmen\src\licensedcode\data\rules\bsd-simplified_hyphenated.yml", "YAML", 0, 0, 0, 2, 0, 0, 1, 3
"d:\IDEWORK\lvmen\src\licensedcode\data\rules\bsd-simplified_hyphenated_or_gpl-2.0-plus.yml", "YAML", 0, 0, 0, 3, 0, 0, 1, 4
"d:\IDEWORK\lvmen\src\licensedcode\data\rules\bsd-simplified_invert.yml", "YAML", 0, 0, 0, 3, 0, 0, 1, 4
"d:\IDEWORK\lvmen\src\licensedcode\data\rules\bsd-simplified_newlib.yml", "YAML", 0, 0, 0, 4, 0, 0, 1, 5
"d:\IDEWORK\lvmen\src\licensedcode\data\rules\bsd-simplified_newlib2.yml", "YAML", 0, 0, 0, 2, 0, 0, 1, 3
"d:\IDEWORK\lvmen\src\licensedcode\data\rules\bsd-simplified_newlib3.yml", "YAML", 0, 0, 0, 2, 0, 0, 1, 3
"d:\IDEWORK\lvmen\src\licensedcode\data\rules\bsd-simplified_newlib4.yml", "YAML", 0, 0, 0, 2, 0, 0, 1, 3
"d:\IDEWORK\lvmen\src\licensedcode\data\rules\bsd-simplified_newlib5.yml", "YAML", 0, 0, 0, 2, 0, 0, 1, 3
"d:\IDEWORK\lvmen\src\licensedcode\data\rules\bsd-simplified_newlib6.yml", "YAML", 0, 0, 0, 2, 0, 0, 1, 3
"d:\IDEWORK\lvmen\src\licensedcode\data\rules\bsd-simplified_nuget_url_1.yml", "YAML", 0, 0, 0, 5, 0, 0, 1, 6
"d:\IDEWORK\lvmen\src\licensedcode\data\rules\bsd-simplified_nuget_url_2.yml", "YAML", 0, 0, 0, 5, 0, 0, 1, 6
"d:\IDEWORK\lvmen\src\licensedcode\data\rules\bsd-simplified_or_apache-2.0_1.yml", "YAML", 0, 0, 0, 3, 0, 0, 1, 4
"d:\IDEWORK\lvmen\src\licensedcode\data\rules\bsd-simplified_or_gpl-2.0-plus_1.yml", "YAML", 0, 0, 0, 3, 0, 0, 1, 4
"d:\IDEWORK\lvmen\src\licensedcode\data\rules\bsd-simplified_or_gpl-2.0-plus_2.yml", "YAML", 0, 0, 0, 4, 0, 0, 1, 5
"d:\IDEWORK\lvmen\src\licensedcode\data\rules\bsd-simplified_or_gpl-2.0-plus_3.yml", "YAML", 0, 0, 0, 4, 0, 0, 1, 5
"d:\IDEWORK\lvmen\src\licensedcode\data\rules\bsd-simplified_or_gpl-2.0-plus_4.yml", "YAML", 0, 0, 0, 4, 0, 0, 1, 5
"d:\IDEWORK\lvmen\src\licensedcode\data\rules\bsd-simplified_or_gpl-2.0-plus_5.yml", "YAML", 0, 0, 0, 3, 0, 0, 1, 4
"d:\IDEWORK\lvmen\src\licensedcode\data\rules\bsd-simplified_or_gpl-2.0-plus_6.yml", "YAML", 0, 0, 0, 4, 0, 0, 1, 5
"d:\IDEWORK\lvmen\src\licensedcode\data\rules\bsd-simplified_or_gpl-2.0-plus_7.yml", "YAML", 0, 0, 0, 5, 0, 0, 2, 7
"d:\IDEWORK\lvmen\src\licensedcode\data\rules\bsd-simplified_or_gpl-2.0-plus_8.yml", "YAML", 0, 0, 0, 6, 0, 0, 1, 7
"d:\IDEWORK\lvmen\src\licensedcode\data\rules\bsd-simplified_or_gpl-2.0-plus_9.yml", "YAML", 0, 0, 0, 6, 0, 0, 1, 7
"d:\IDEWORK\lvmen\src\licensedcode\data\rules\bsd-simplified_or_gpl-2.0.yml", "YAML", 0, 0, 0, 5, 0, 0, 1, 6
"d:\IDEWORK\lvmen\src\licensedcode\data\rules\bsd-simplified_or_gpl-2.0_1.yml", "YAML", 0, 0, 0, 5, 0, 0, 1, 6
"d:\IDEWORK\lvmen\src\licensedcode\data\rules\bsd-simplified_or_gpl-2.0_10.yml", "YAML", 0, 0, 0, 5, 0, 0, 1, 6
"d:\IDEWORK\lvmen\src\licensedcode\data\rules\bsd-simplified_or_gpl-2.0_11.yml", "YAML", 0, 0, 0, 9, 0, 0, 1, 10
"d:\IDEWORK\lvmen\src\licensedcode\data\rules\bsd-simplified_or_gpl-2.0_12.yml", "YAML", 0, 0, 0, 9, 0, 0, 1, 10
"d:\IDEWORK\lvmen\src\licensedcode\data\rules\bsd-simplified_or_gpl-2.0_13.yml", "YAML", 0, 0, 0, 10, 0, 0, 1, 11
"d:\IDEWORK\lvmen\src\licensedcode\data\rules\bsd-simplified_or_gpl-2.0_14.yml", "YAML", 0, 0, 0, 10, 0, 0, 1, 11
"d:\IDEWORK\lvmen\src\licensedcode\data\rules\bsd-simplified_or_gpl-2.0_2.yml", "YAML", 0, 0, 0, 5, 0, 0, 1, 6
"d:\IDEWORK\lvmen\src\licensedcode\data\rules\bsd-simplified_or_gpl-2.0_3.yml", "YAML", 0, 0, 0, 5, 0, 0, 1, 6
"d:\IDEWORK\lvmen\src\licensedcode\data\rules\bsd-simplified_or_gpl-2.0_5.yml", "YAML", 0, 0, 0, 4, 0, 0, 1, 5
"d:\IDEWORK\lvmen\src\licensedcode\data\rules\bsd-simplified_or_gpl-2.0_6.yml", "YAML", 0, 0, 0, 3, 0, 0, 1, 4
"d:\IDEWORK\lvmen\src\licensedcode\data\rules\bsd-simplified_or_gpl-2.0_7.yml", "YAML", 0, 0, 0, 3, 0, 0, 1, 4
"d:\IDEWORK\lvmen\src\licensedcode\data\rules\bsd-simplified_or_gpl-2.0_8.yml", "YAML", 0, 0, 0, 4, 0, 0, 1, 5
"d:\IDEWORK\lvmen\src\licensedcode\data\rules\bsd-simplified_or_gpl-2.0_9.yml", "YAML", 0, 0, 0, 4, 0, 0, 1, 5
"d:\IDEWORK\lvmen\src\licensedcode\data\rules\bsd-simplified_or_gpl-3.0-plus_1.yml", "YAML", 0, 0, 0, 4, 0, 0, 1, 5
"d:\IDEWORK\lvmen\src\licensedcode\data\rules\bsd-simplified_or_ruby_1.yml", "YAML", 0, 0, 0, 3, 0, 0, 1, 4
"d:\IDEWORK\lvmen\src\licensedcode\data\rules\bsd-simplified_or_ruby_2.yml", "YAML", 0, 0, 0, 3, 0, 0, 1, 4
"d:\IDEWORK\lvmen\src\licensedcode\data\rules\bsd-simplified_or_ruby_3.yml", "YAML", 0, 0, 0, 5, 0, 0, 1, 6
"d:\IDEWORK\lvmen\src\licensedcode\data\rules\bsd-simplified_or_ruby_4.yml", "YAML", 0, 0, 0, 5, 0, 0, 1, 6
"d:\IDEWORK\lvmen\src\licensedcode\data\rules\bsd-simplified_or_ruby_5.yml", "YAML", 0, 0, 0, 3, 0, 0, 1, 4
"d:\IDEWORK\lvmen\src\licensedcode\data\rules\bsd-simplified_or_ruby_6.yml", "YAML", 0, 0, 0, 3, 0, 0, 1, 4
"d:\IDEWORK\lvmen\src\licensedcode\data\rules\bsd-simplified_or_ruby_7.yml", "YAML", 0, 0, 0, 5, 0, 0, 1, 6
"d:\IDEWORK\lvmen\src\licensedcode\data\rules\bsd-simplified_or_ruby_8.yml", "YAML", 0, 0, 0, 5, 0, 0, 1, 6
"d:\IDEWORK\lvmen\src\licensedcode\data\rules\bsd-simplified_or_unknown-license-reference_and_odbl-1.0_1.yml", "YAML", 0, 0, 0, 7, 0, 0, 1, 8
"d:\IDEWORK\lvmen\src\licensedcode\data\rules\bsd-simplified_url_1.yml", "YAML", 0, 0, 0, 5, 0, 0, 1, 6
"d:\IDEWORK\lvmen\src\licensedcode\data\rules\bsd-simplified_url_2.yml", "YAML", 0, 0, 0, 5, 0, 0, 1, 6
"d:\IDEWORK\lvmen\src\licensedcode\data\rules\bsd-simplified_url_3.yml", "YAML", 0, 0, 0, 5, 0, 0, 1, 6
"d:\IDEWORK\lvmen\src\licensedcode\data\rules\bsd-simplified_url_4.yml", "YAML", 0, 0, 0, 5, 0, 0, 1, 6
"d:\IDEWORK\lvmen\src\licensedcode\data\rules\bsd-source-code_1.yml", "YAML", 0, 0, 0, 3, 0, 0, 1, 4
"d:\IDEWORK\lvmen\src\licensedcode\data\rules\bsd-source-code_10.yml", "YAML", 0, 0, 0, 2, 0, 0, 1, 3
"d:\IDEWORK\lvmen\src\licensedcode\data\rules\bsd-source-code_11.yml", "YAML", 0, 0, 0, 4, 0, 0, 1, 5
"d:\IDEWORK\lvmen\src\licensedcode\data\rules\bsd-source-code_2.yml", "YAML", 0, 0, 0, 3, 0, 0, 1, 4
"d:\IDEWORK\lvmen\src\licensedcode\data\rules\bsd-source-code_3.yml", "YAML", 0, 0, 0, 3, 0, 0, 1, 4
"d:\IDEWORK\lvmen\src\licensedcode\data\rules\bsd-source-code_4.yml", "YAML", 0, 0, 0, 4, 0, 0, 1, 5
"d:\IDEWORK\lvmen\src\licensedcode\data\rules\bsd-source-code_5.yml", "YAML", 0, 0, 0, 3, 0, 0, 1, 4
"d:\IDEWORK\lvmen\src\licensedcode\data\rules\bsd-source-code_6.yml", "YAML", 0, 0, 0, 3, 0, 0, 1, 4
"d:\IDEWORK\lvmen\src\licensedcode\data\rules\bsd-source-code_7.yml", "YAML", 0, 0, 0, 3, 0, 0, 1, 4
"d:\IDEWORK\lvmen\src\licensedcode\data\rules\bsd-source-code_8.yml", "YAML", 0, 0, 0, 2, 0, 0, 1, 3
"d:\IDEWORK\lvmen\src\licensedcode\data\rules\bsd-source-code_9.yml", "YAML", 0, 0, 0, 2, 0, 0, 1, 3
"d:\IDEWORK\lvmen\src\licensedcode\data\rules\bsd-source-code_url_1.yml", "YAML", 0, 0, 0, 5, 0, 0, 1, 6
"d:\IDEWORK\lvmen\src\licensedcode\data\rules\bsd-source-code_url_2.yml", "YAML", 0, 0, 0, 5, 0, 0, 1, 6
"d:\IDEWORK\lvmen\src\licensedcode\data\rules\bsd-top-gpl-addition_1.yml", "YAML", 0, 0, 0, 3, 0, 0, 1, 4
"d:\IDEWORK\lvmen\src\licensedcode\data\rules\bsd-top_2.yml", "YAML", 0, 0, 0, 4, 0, 0, 1, 5
"d:\IDEWORK\lvmen\src\licensedcode\data\rules\bsd-top_and_gpl-2.0-plus_1.yml", "YAML", 0, 0, 0, 8, 0, 0, 1, 9
"d:\IDEWORK\lvmen\src\licensedcode\data\rules\bsd-top_and_gpl-2.0-plus_and_free-unknown_1.yml", "YAML", 0, 0, 0, 8, 0, 0, 1, 9
"d:\IDEWORK\lvmen\src\licensedcode\data\rules\bsd-top_or_gpl-2.0-plus_1.yml", "YAML", 0, 0, 0, 5, 0, 0, 1, 6
"d:\IDEWORK\lvmen\src\licensedcode\data\rules\bsd-top_or_gpl-2.0-plus_2.yml", "YAML", 0, 0, 0, 6, 0, 0, 1, 7
"d:\IDEWORK\lvmen\src\licensedcode\data\rules\bsd-unchanged_1.yml", "YAML", 0, 0, 0, 2, 0, 0, 1, 3
"d:\IDEWORK\lvmen\src\licensedcode\data\rules\bsd-unchanged_2.yml", "YAML", 0, 0, 0, 3, 0, 0, 1, 4
"d:\IDEWORK\lvmen\src\licensedcode\data\rules\bsd-unchanged_3.yml", "YAML", 0, 0, 0, 3, 0, 0, 1, 4
"d:\IDEWORK\lvmen\src\licensedcode\data\rules\bsd-unchanged_4.yml", "YAML", 0, 0, 0, 2, 0, 0, 1, 3
"d:\IDEWORK\lvmen\src\licensedcode\data\rules\bsd-unmodified_1.yml", "YAML", 0, 0, 0, 2, 0, 0, 1, 3
"d:\IDEWORK\lvmen\src\licensedcode\data\rules\bsd-unmodified_2.yml", "YAML", 0, 0, 0, 3, 0, 0, 1, 4
"d:\IDEWORK\lvmen\src\licensedcode\data\rules\bsd-unmodified_3.yml", "YAML", 0, 0, 0, 2, 0, 0, 1, 3
"d:\IDEWORK\lvmen\src\licensedcode\data\rules\bsd-unmodified_4.yml", "YAML", 0, 0, 0, 2, 0, 0, 1, 3
"d:\IDEWORK\lvmen\src\licensedcode\data\rules\bsd-x11_1.yml", "YAML", 0, 0, 0, 2, 0, 0, 1, 3
"d:\IDEWORK\lvmen\src\licensedcode\data\rules\bsd-x11_10.yml", "YAML", 0, 0, 0, 3, 0, 0, 1, 4
"d:\IDEWORK\lvmen\src\licensedcode\data\rules\bsd-x11_11.yml", "YAML", 0, 0, 0, 3, 0, 0, 1, 4
"d:\IDEWORK\lvmen\src\licensedcode\data\rules\bsd-x11_2.yml", "YAML", 0, 0, 0, 6, 0, 0, 1, 7
"d:\IDEWORK\lvmen\src\licensedcode\data\rules\bsd-x11_3.yml", "YAML", 0, 0, 0, 4, 0, 0, 1, 5
"d:\IDEWORK\lvmen\src\licensedcode\data\rules\bsd-x11_4.yml", "YAML", 0, 0, 0, 2, 0, 0, 1, 3
"d:\IDEWORK\lvmen\src\licensedcode\data\rules\bsd-x11_5.yml", "YAML", 0, 0, 0, 3, 0, 0, 1, 4
"d:\IDEWORK\lvmen\src\licensedcode\data\rules\bsd-x11_6.yml", "YAML", 0, 0, 0, 4, 0, 0, 1, 5
"d:\IDEWORK\lvmen\src\licensedcode\data\rules\bsd-x11_7.yml", "YAML", 0, 0, 0, 4, 0, 0, 1, 5
"d:\IDEWORK\lvmen\src\licensedcode\data\rules\bsd-x11_8.yml", "YAML", 0, 0, 0, 2, 0, 0, 1, 3
"d:\IDEWORK\lvmen\src\licensedcode\data\rules\bsd-x11_9.yml", "YAML", 0, 0, 0, 4, 0, 0, 1, 5
"d:\IDEWORK\lvmen\src\licensedcode\data\rules\bsd-zero_1.yml", "YAML", 0, 0, 0, 3, 0, 0, 1, 4
"d:\IDEWORK\lvmen\src\licensedcode\data\rules\bsd-zero_2.yml", "YAML", 0, 0, 0, 5, 0, 0, 1, 6
"d:\IDEWORK\lvmen\src\licensedcode\data\rules\bsd-zero_3.yml", "YAML", 0, 0, 0, 5, 0, 0, 1, 6
"d:\IDEWORK\lvmen\src\licensedcode\data\rules\bsd-zero_4.yml", "YAML", 0, 0, 0, 3, 0, 0, 1, 4
"d:\IDEWORK\lvmen\src\licensedcode\data\rules\bsd-zero_5.yml", "YAML", 0, 0, 0, 3, 0, 0, 1, 4
"d:\IDEWORK\lvmen\src\licensedcode\data\rules\bsd-zero_6.yml", "YAML", 0, 0, 0, 4, 0, 0, 1, 5
"d:\IDEWORK\lvmen\src\licensedcode\data\rules\bsd-zero_url_1.yml", "YAML", 0, 0, 0, 5, 0, 0, 1, 6
"d:\IDEWORK\lvmen\src\licensedcode\data\rules\bsd_1.yml", "YAML", 0, 0, 0, 5, 0, 0, 1, 6
"d:\IDEWORK\lvmen\src\licensedcode\data\rules\bsl-1.0_and_cockroach_and_mit_and_bsd-new_1.yml", "YAML", 0, 0, 0, 3, 0, 0, 1, 4
"d:\IDEWORK\lvmen\src\licensedcode\data\rules\bsl-1.1_1.yml", "YAML", 0, 0, 0, 3, 0, 0, 1, 4
"d:\IDEWORK\lvmen\src\licensedcode\data\rules\bsl-1.1_2.yml", "YAML", 0, 0, 0, 3, 0, 0, 1, 4
"d:\IDEWORK\lvmen\src\licensedcode\data\rules\bsl-1.1_3.yml", "YAML", 0, 0, 0, 3, 0, 0, 1, 4
"d:\IDEWORK\lvmen\src\licensedcode\data\rules\bsl-1.1_4.yml", "YAML", 0, 0, 0, 5, 0, 0, 1, 6
"d:\IDEWORK\lvmen\src\licensedcode\data\rules\bsl-1.1_5.yml", "YAML", 0, 0, 0, 7, 0, 0, 1, 8
"d:\IDEWORK\lvmen\src\licensedcode\data\rules\bsla-no-advert_1.yml", "YAML", 0, 0, 0, 4, 0, 0, 1, 5
"d:\IDEWORK\lvmen\src\licensedcode\data\rules\bsla-no-advert_2.yml", "YAML", 0, 0, 0, 4, 0, 0, 1, 5
"d:\IDEWORK\lvmen\src\licensedcode\data\rules\bsla-no-advert_3.yml", "YAML", 0, 0, 0, 6, 0, 0, 1, 7
"d:\IDEWORK\lvmen\src\licensedcode\data\rules\bsla-no-advert_4.yml", "YAML", 0, 0, 0, 5, 0, 0, 1, 6
"d:\IDEWORK\lvmen\src\licensedcode\data\rules\bsla-no-advert_5.yml", "YAML", 0, 0, 0, 3, 0, 0, 1, 4
"d:\IDEWORK\lvmen\src\licensedcode\data\rules\bsla_1.yml", "YAML", 0, 0, 0, 4, 0, 0, 1, 5
"d:\IDEWORK\lvmen\src\licensedcode\data\rules\bsla_2.yml", "YAML", 0, 0, 0, 2, 0, 0, 1, 3
"d:\IDEWORK\lvmen\src\licensedcode\data\rules\bsla_3.yml", "YAML", 0, 0, 0, 4, 0, 0, 1, 5
"d:\IDEWORK\lvmen\src\licensedcode\data\rules\bsla_4.yml", "YAML", 0, 0, 0, 2, 0, 0, 1, 3
"d:\IDEWORK\lvmen\src\licensedcode\data\rules\bsla_5.yml", "YAML", 0, 0, 0, 3, 0, 0, 1, 4
"d:\IDEWORK\lvmen\src\licensedcode\data\rules\bsla_6.yml", "YAML", 0, 0, 0, 3, 0, 0, 1, 4
"d:\IDEWORK\lvmen\src\licensedcode\data\rules\bsla_7.yml", "YAML", 0, 0, 0, 4, 0, 0, 1, 5
"d:\IDEWORK\lvmen\src\licensedcode\data\rules\bytemark.yml", "YAML", 0, 0, 0, 3, 0, 0, 1, 4
"d:\IDEWORK\lvmen\src\licensedcode\data\rules\bytemark_1.yml", "YAML", 0, 0, 0, 2, 0, 0, 1, 3
"d:\IDEWORK\lvmen\src\licensedcode\data\rules\bzip2-libbzip-2010_1.yml", "YAML", 0, 0, 0, 3, 0, 0, 1, 4
"d:\IDEWORK\lvmen\src\licensedcode\data\rules\bzip2-libbzip-2010_10.yml", "YAML", 0, 0, 0, 5, 0, 0, 1, 6
"d:\IDEWORK\lvmen\src\licensedcode\data\rules\bzip2-libbzip-2010_11.yml", "YAML", 0, 0, 0, 5, 0, 0, 1, 6
"d:\IDEWORK\lvmen\src\licensedcode\data\rules\bzip2-libbzip-2010_12.yml", "YAML", 0, 0, 0, 5, 0, 0, 1, 6
"d:\IDEWORK\lvmen\src\licensedcode\data\rules\bzip2-libbzip-2010_13.yml", "YAML", 0, 0, 0, 6, 0, 0, 1, 7
"d:\IDEWORK\lvmen\src\licensedcode\data\rules\bzip2-libbzip-2010_14.yml", "YAML", 0, 0, 0, 5, 0, 0, 1, 6
"d:\IDEWORK\lvmen\src\licensedcode\data\rules\bzip2-libbzip-2010_15.yml", "YAML", 0, 0, 0, 10, 0, 0, 1, 11
"d:\IDEWORK\lvmen\src\licensedcode\data\rules\bzip2-libbzip-2010_16.yml", "YAML", 0, 0, 0, 5, 0, 0, 1, 6
"d:\IDEWORK\lvmen\src\licensedcode\data\rules\bzip2-libbzip-2010_17.yml", "YAML", 0, 0, 0, 9, 0, 0, 1, 10
"d:\IDEWORK\lvmen\src\licensedcode\data\rules\bzip2-libbzip-2010_18.yml", "YAML", 0, 0, 0, 5, 0, 0, 1, 6
"d:\IDEWORK\lvmen\src\licensedcode\data\rules\bzip2-libbzip-2010_19.yml", "YAML", 0, 0, 0, 11, 0, 0, 1, 12
"d:\IDEWORK\lvmen\src\licensedcode\data\rules\bzip2-libbzip-2010_2.yml", "YAML", 0, 0, 0, 2, 0, 0, 1, 3
"d:\IDEWORK\lvmen\src\licensedcode\data\rules\bzip2-libbzip-2010_20.yml", "YAML", 0, 0, 0, 11, 0, 0, 1, 12
"d:\IDEWORK\lvmen\src\licensedcode\data\rules\bzip2-libbzip-2010_21.yml", "YAML", 0, 0, 0, 5, 0, 0, 1, 6
"d:\IDEWORK\lvmen\src\licensedcode\data\rules\bzip2-libbzip-2010_22.yml", "YAML", 0, 0, 0, 11, 0, 0, 1, 12
"d:\IDEWORK\lvmen\src\licensedcode\data\rules\bzip2-libbzip-2010_23.yml", "YAML", 0, 0, 0, 11, 0, 0, 1, 12
"d:\IDEWORK\lvmen\src\licensedcode\data\rules\bzip2-libbzip-2010_24.yml", "YAML", 0, 0, 0, 5, 0, 0, 1, 6
"d:\IDEWORK\lvmen\src\licensedcode\data\rules\bzip2-libbzip-2010_25.yml", "YAML", 0, 0, 0, 11, 0, 0, 1, 12
"d:\IDEWORK\lvmen\src\licensedcode\data\rules\bzip2-libbzip-2010_26.yml", "YAML", 0, 0, 0, 5, 0, 0, 1, 6
"d:\IDEWORK\lvmen\src\licensedcode\data\rules\bzip2-libbzip-2010_27.yml", "YAML", 0, 0, 0, 11, 0, 0, 1, 12
"d:\IDEWORK\lvmen\src\licensedcode\data\rules\bzip2-libbzip-2010_28.yml", "YAML", 0, 0, 0, 7, 0, 0, 1, 8
"d:\IDEWORK\lvmen\src\licensedcode\data\rules\bzip2-libbzip-2010_29.yml", "YAML", 0, 0, 0, 11, 0, 0, 1, 12
"d:\IDEWORK\lvmen\src\licensedcode\data\rules\bzip2-libbzip-2010_3.yml", "YAML", 0, 0, 0, 3, 0, 0, 1, 4
"d:\IDEWORK\lvmen\src\licensedcode\data\rules\bzip2-libbzip-2010_4.yml", "YAML", 0, 0, 0, 2, 0, 0, 1, 3
"d:\IDEWORK\lvmen\src\licensedcode\data\rules\bzip2-libbzip-2010_5.yml", "YAML", 0, 0, 0, 6, 0, 0, 1, 7
"d:\IDEWORK\lvmen\src\licensedcode\data\rules\bzip2-libbzip-2010_6.yml", "YAML", 0, 0, 0, 5, 0, 0, 1, 6
"d:\IDEWORK\lvmen\src\licensedcode\data\rules\bzip2-libbzip-2010_7.yml", "YAML", 0, 0, 0, 4, 0, 0, 1, 5
"d:\IDEWORK\lvmen\src\licensedcode\data\rules\bzip2-libbzip-2010_8.yml", "YAML", 0, 0, 0, 5, 0, 0, 1, 6
"d:\IDEWORK\lvmen\src\licensedcode\data\rules\bzip2-libbzip-2010_9.yml", "YAML", 0, 0, 0, 9, 0, 0, 1, 10
"d:\IDEWORK\lvmen\src\licensedcode\data\rules\bzip2-libbzip-2010_nuget_url_1.yml", "YAML", 0, 0, 0, 5, 0, 0, 1, 6
"d:\IDEWORK\lvmen\src\licensedcode\data\rules\bzip2-libbzip-2010_url_1.yml", "YAML", 0, 0, 0, 5, 0, 0, 1, 6
"d:\IDEWORK\lvmen\src\licensedcode\data\rules\bzip2-libbzip-2010_url_2.yml", "YAML", 0, 0, 0, 5, 0, 0, 1, 6
"d:\IDEWORK\lvmen\src\licensedcode\data\rules\bzip2-libbzip-2010_valgrind_1.yml", "YAML", 0, 0, 0, 5, 0, 0, 1, 6
"d:\IDEWORK\lvmen\src\licensedcode\data\rules\c-fsl-1.1_1.yml", "YAML", 0, 0, 0, 4, 0, 0, 1, 5
"d:\IDEWORK\lvmen\src\licensedcode\data\rules\ca-tosl-1.1.SPDX.yml", "YAML", 0, 0, 0, 8, 0, 0, 1, 9
"d:\IDEWORK\lvmen\src\licensedcode\data\rules\ca-tosl-1.1.yml", "YAML", 0, 0, 0, 5, 0, 0, 1, 6
"d:\IDEWORK\lvmen\src\licensedcode\data\rules\ca-tosl-1.1_1.yml", "YAML", 0, 0, 0, 5, 0, 0, 1, 6
"d:\IDEWORK\lvmen\src\licensedcode\data\rules\ca-tosl-1.1_2.yml", "YAML", 0, 0, 0, 3, 0, 0, 1, 4
"d:\IDEWORK\lvmen\src\licensedcode\data\rules\ca-tosl-1.1_3.yml", "YAML", 0, 0, 0, 3, 0, 0, 1, 4
"d:\IDEWORK\lvmen\src\licensedcode\data\rules\ca-tosl-1.1_url_1.yml", "YAML", 0, 0, 0, 5, 0, 0, 1, 6
"d:\IDEWORK\lvmen\src\licensedcode\data\rules\ca-tosl-1.1_url_2.yml", "YAML", 0, 0, 0, 5, 0, 0, 1, 6
"d:\IDEWORK\lvmen\src\licensedcode\data\rules\ca-tosl-1.1_url_glc_70.yml", "YAML", 0, 0, 0, 5, 0, 0, 1, 6
"d:\IDEWORK\lvmen\src\licensedcode\data\rules\ca-tosl-1.1_url_glc_71.yml", "YAML", 0, 0, 0, 5, 0, 0, 1, 6
"d:\IDEWORK\lvmen\src\licensedcode\data\rules\cal-1.0_1.yml", "YAML", 0, 0, 0, 3, 0, 0, 1, 4
"d:\IDEWORK\lvmen\src\licensedcode\data\rules\cal-1.0_2.yml", "YAML", 0, 0, 0, 3, 0, 0, 1, 4
"d:\IDEWORK\lvmen\src\licensedcode\data\rules\cal-1.0_with_cal-1.0-combined-work-exception_1.yml", "YAML", 0, 0, 0, 3, 0, 0, 1, 4
"d:\IDEWORK\lvmen\src\licensedcode\data\rules\caldera_url_1.yml", "YAML", 0, 0, 0, 5, 0, 0, 1, 6
"d:\IDEWORK\lvmen\src\licensedcode\data\rules\caldera_url_2.yml", "YAML", 0, 0, 0, 5, 0, 0, 1, 6
"d:\IDEWORK\lvmen\src\licensedcode\data\rules\can-ogl-2.0-en_1.yml", "YAML", 0, 0, 0, 3, 0, 0, 1, 4
"d:\IDEWORK\lvmen\src\licensedcode\data\rules\can-ogl-2.0-en_2.yml", "YAML", 0, 0, 0, 3, 0, 0, 1, 4
"d:\IDEWORK\lvmen\src\licensedcode\data\rules\can-ogl-2.0-en_3.yml", "YAML", 0, 0, 0, 3, 0, 0, 1, 4
"d:\IDEWORK\lvmen\src\licensedcode\data\rules\can-ogl-2.0-en_4.yml", "YAML", 0, 0, 0, 3, 0, 0, 1, 4
"d:\IDEWORK\lvmen\src\licensedcode\data\rules\can-ogl-2.0-en_5.yml", "YAML", 0, 0, 0, 3, 0, 0, 1, 4
"d:\IDEWORK\lvmen\src\licensedcode\data\rules\carnegie-mellon-contributors.yml", "YAML", 0, 0, 0, 4, 0, 0, 1, 5
"d:\IDEWORK\lvmen\src\licensedcode\data\rules\carnegie-mellon-contributors_1.yml", "YAML", 0, 0, 0, 4, 0, 0, 1, 5
"d:\IDEWORK\lvmen\src\licensedcode\data\rules\carnegie-mellon-contributors_2.yml", "YAML", 0, 0, 0, 5, 0, 0, 1, 6
"d:\IDEWORK\lvmen\src\licensedcode\data\rules\carnegie-mellon-contributors_3.yml", "YAML", 0, 0, 0, 8, 0, 0, 1, 9
"d:\IDEWORK\lvmen\src\licensedcode\data\rules\cc-by-1.0.SPDX.yml", "YAML", 0, 0, 0, 6, 0, 0, 1, 7
"d:\IDEWORK\lvmen\src\licensedcode\data\rules\cc-by-1.0.yml", "YAML", 0, 0, 0, 5, 0, 0, 1, 6
"d:\IDEWORK\lvmen\src\licensedcode\data\rules\cc-by-1.0_1.yml", "YAML", 0, 0, 0, 5, 0, 0, 1, 6
"d:\IDEWORK\lvmen\src\licensedcode\data\rules\cc-by-1.0_2.yml", "YAML", 0, 0, 0, 5, 0, 0, 1, 6
"d:\IDEWORK\lvmen\src\licensedcode\data\rules\cc-by-1.0_3.yml", "YAML", 0, 0, 0, 5, 0, 0, 1, 6
"d:\IDEWORK\lvmen\src\licensedcode\data\rules\cc-by-1.0_4.yml", "YAML", 0, 0, 0, 3, 0, 0, 1, 4
"d:\IDEWORK\lvmen\src\licensedcode\data\rules\cc-by-1.0_5.yml", "YAML", 0, 0, 0, 5, 0, 0, 1, 6
"d:\IDEWORK\lvmen\src\licensedcode\data\rules\cc-by-1.0_6.yml", "YAML", 0, 0, 0, 3, 0, 0, 1, 4
"d:\IDEWORK\lvmen\src\licensedcode\data\rules\cc-by-1.0_7.yml", "YAML", 0, 0, 0, 5, 0, 0, 1, 6
"d:\IDEWORK\lvmen\src\licensedcode\data\rules\cc-by-1.0_8.yml", "YAML", 0, 0, 0, 4, 0, 0, 1, 5
"d:\IDEWORK\lvmen\src\licensedcode\data\rules\cc-by-1.0_licensebutton.yml", "YAML", 0, 0, 0, 5, 0, 0, 1, 6
"d:\IDEWORK\lvmen\src\licensedcode\data\rules\cc-by-1.0_url_1.yml", "YAML", 0, 0, 0, 5, 0, 0, 1, 6
"d:\IDEWORK\lvmen\src\licensedcode\data\rules\cc-by-1.0_url_2.yml", "YAML", 0, 0, 0, 5, 0, 0, 1, 6
"d:\IDEWORK\lvmen\src\licensedcode\data\rules\cc-by-1.0_url_glc_53.yml", "YAML", 0, 0, 0, 5, 0, 0, 1, 6
"d:\IDEWORK\lvmen\src\licensedcode\data\rules\cc-by-2.0-uk.yml", "YAML", 0, 0, 0, 5, 0, 0, 1, 6
"d:\IDEWORK\lvmen\src\licensedcode\data\rules\cc-by-2.0-uk_1.yml", "YAML", 0, 0, 0, 5, 0, 0, 1, 6
"d:\IDEWORK\lvmen\src\licensedcode\data\rules\cc-by-2.0.SPDX.yml", "YAML", 0, 0, 0, 6, 0, 0, 1, 7
"d:\IDEWORK\lvmen\src\licensedcode\data\rules\cc-by-2.0.yml", "YAML", 0, 0, 0, 5, 0, 0, 1, 6
"d:\IDEWORK\lvmen\src\licensedcode\data\rules\cc-by-2.0_1.yml", "YAML", 0, 0, 0, 5, 0, 0, 1, 6
"d:\IDEWORK\lvmen\src\licensedcode\data\rules\cc-by-2.0_10.yml", "YAML", 0, 0, 0, 5, 0, 0, 1, 6
"d:\IDEWORK\lvmen\src\licensedcode\data\rules\cc-by-2.0_11.yml", "YAML", 0, 0, 0, 5, 0, 0, 1, 6
"d:\IDEWORK\lvmen\src\licensedcode\data\rules\cc-by-2.0_12.yml", "YAML", 0, 0, 0, 5, 0, 0, 1, 6
"d:\IDEWORK\lvmen\src\licensedcode\data\rules\cc-by-2.0_13.yml", "YAML", 0, 0, 0, 5, 0, 0, 1, 6
"d:\IDEWORK\lvmen\src\licensedcode\data\rules\cc-by-2.0_14.yml", "YAML", 0, 0, 0, 5, 0, 0, 1, 6
"d:\IDEWORK\lvmen\src\licensedcode\data\rules\cc-by-2.0_15.yml", "YAML", 0, 0, 0, 5, 0, 0, 1, 6
"d:\IDEWORK\lvmen\src\licensedcode\data\rules\cc-by-2.0_16.yml", "YAML", 0, 0, 0, 4, 0, 0, 1, 5
"d:\IDEWORK\lvmen\src\licensedcode\data\rules\cc-by-2.0_2.yml", "YAML", 0, 0, 0, 5, 0, 0, 1, 6
"d:\IDEWORK\lvmen\src\licensedcode\data\rules\cc-by-2.0_3.yml", "YAML", 0, 0, 0, 3, 0, 0, 1, 4
"d:\IDEWORK\lvmen\src\licensedcode\data\rules\cc-by-2.0_4.yml", "YAML", 0, 0, 0, 5, 0, 0, 1, 6
"d:\IDEWORK\lvmen\src\licensedcode\data\rules\cc-by-2.0_5.yml", "YAML", 0, 0, 0, 5, 0, 0, 1, 6
"d:\IDEWORK\lvmen\src\licensedcode\data\rules\cc-by-2.0_6.yml", "YAML", 0, 0, 0, 3, 0, 0, 1, 4
"d:\IDEWORK\lvmen\src\licensedcode\data\rules\cc-by-2.0_7.yml", "YAML", 0, 0, 0, 3, 0, 0, 1, 4
"d:\IDEWORK\lvmen\src\licensedcode\data\rules\cc-by-2.0_8.yml", "YAML", 0, 0, 0, 3, 0, 0, 1, 4
"d:\IDEWORK\lvmen\src\licensedcode\data\rules\cc-by-2.0_9.yml", "YAML", 0, 0, 0, 5, 0, 0, 1, 6
"d:\IDEWORK\lvmen\src\licensedcode\data\rules\cc-by-2.0_licensebutton.yml", "YAML", 0, 0, 0, 5, 0, 0, 1, 6
"d:\IDEWORK\lvmen\src\licensedcode\data\rules\cc-by-2.0_url_1.yml", "YAML", 0, 0, 0, 5, 0, 0, 1, 6
"d:\IDEWORK\lvmen\src\licensedcode\data\rules\cc-by-2.0_url_2.yml", "YAML", 0, 0, 0, 5, 0, 0, 1, 6
"d:\IDEWORK\lvmen\src\licensedcode\data\rules\cc-by-2.0_url_glc_55.yml", "YAML", 0, 0, 0, 5, 0, 0, 1, 6
"d:\IDEWORK\lvmen\src\licensedcode\data\rules\cc-by-2.5.SPDX.yml", "YAML", 0, 0, 0, 6, 0, 0, 1, 7
"d:\IDEWORK\lvmen\src\licensedcode\data\rules\cc-by-2.5.yml", "YAML", 0, 0, 0, 5, 0, 0, 1, 6
"d:\IDEWORK\lvmen\src\licensedcode\data\rules\cc-by-2.5_1.yml", "YAML", 0, 0, 0, 5, 0, 0, 1, 6
"d:\IDEWORK\lvmen\src\licensedcode\data\rules\cc-by-2.5_10.yml", "YAML", 0, 0, 0, 5, 0, 0, 1, 6
"d:\IDEWORK\lvmen\src\licensedcode\data\rules\cc-by-2.5_11.yml", "YAML", 0, 0, 0, 3, 0, 0, 1, 4
"d:\IDEWORK\lvmen\src\licensedcode\data\rules\cc-by-2.5_12.yml", "YAML", 0, 0, 0, 3, 0, 0, 1, 4
"d:\IDEWORK\lvmen\src\licensedcode\data\rules\cc-by-2.5_13.yml", "YAML", 0, 0, 0, 3, 0, 0, 1, 4
"d:\IDEWORK\lvmen\src\licensedcode\data\rules\cc-by-2.5_14.yml", "YAML", 0, 0, 0, 5, 0, 0, 1, 6
"d:\IDEWORK\lvmen\src\licensedcode\data\rules\cc-by-2.5_15.yml", "YAML", 0, 0, 0, 4, 0, 0, 1, 5
"d:\IDEWORK\lvmen\src\licensedcode\data\rules\cc-by-2.5_2.yml", "YAML", 0, 0, 0, 6, 0, 0, 1, 7
"d:\IDEWORK\lvmen\src\licensedcode\data\rules\cc-by-2.5_3.yml", "YAML", 0, 0, 0, 3, 0, 0, 1, 4
"d:\IDEWORK\lvmen\src\licensedcode\data\rules\cc-by-2.5_4.yml", "YAML", 0, 0, 0, 5, 0, 0, 1, 6
"d:\IDEWORK\lvmen\src\licensedcode\data\rules\cc-by-2.5_5.yml", "YAML", 0, 0, 0, 4, 0, 0, 1, 5
"d:\IDEWORK\lvmen\src\licensedcode\data\rules\cc-by-2.5_6.yml", "YAML", 0, 0, 0, 4, 0, 0, 1, 5
"d:\IDEWORK\lvmen\src\licensedcode\data\rules\cc-by-2.5_7.yml", "YAML", 0, 0, 0, 3, 0, 0, 1, 4
"d:\IDEWORK\lvmen\src\licensedcode\data\rules\cc-by-2.5_8.yml", "YAML", 0, 0, 0, 5, 0, 0, 1, 6
"d:\IDEWORK\lvmen\src\licensedcode\data\rules\cc-by-2.5_9.yml", "YAML", 0, 0, 0, 5, 0, 0, 1, 6
"d:\IDEWORK\lvmen\src\licensedcode\data\rules\cc-by-2.5_licensebutton.yml", "YAML", 0, 0, 0, 5, 0, 0, 1, 6
"d:\IDEWORK\lvmen\src\licensedcode\data\rules\cc-by-2.5_or_cc-by-3.0_1.yml", "YAML", 0, 0, 0, 6, 0, 0, 1, 7
"d:\IDEWORK\lvmen\src\licensedcode\data\rules\cc-by-2.5_url_1.yml", "YAML", 0, 0, 0, 5, 0, 0, 1, 6
"d:\IDEWORK\lvmen\src\licensedcode\data\rules\cc-by-2.5_url_2.yml", "YAML", 0, 0, 0, 5, 0, 0, 1, 6
"d:\IDEWORK\lvmen\src\licensedcode\data\rules\cc-by-2.5_url_glc_57.yml", "YAML", 0, 0, 0, 5, 0, 0, 1, 6
"d:\IDEWORK\lvmen\src\licensedcode\data\rules\cc-by-3.0.SPDX.yml", "YAML", 0, 0, 0, 6, 0, 0, 1, 7
"d:\IDEWORK\lvmen\src\licensedcode\data\rules\cc-by-3.0.yml", "YAML", 0, 0, 0, 5, 0, 0, 1, 6
"d:\IDEWORK\lvmen\src\licensedcode\data\rules\cc-by-3.0_1.yml", "YAML", 0, 0, 0, 5, 0, 0, 1, 6
"d:\IDEWORK\lvmen\src\licensedcode\data\rules\cc-by-3.0_10.yml", "YAML", 0, 0, 0, 4, 0, 0, 1, 5
"d:\IDEWORK\lvmen\src\licensedcode\data\rules\cc-by-3.0_100.yml", "YAML", 0, 0, 0, 3, 0, 0, 1, 4
"d:\IDEWORK\lvmen\src\licensedcode\data\rules\cc-by-3.0_101.yml", "YAML", 0, 0, 0, 3, 0, 0, 1, 4
"d:\IDEWORK\lvmen\src\licensedcode\data\rules\cc-by-3.0_102.yml", "YAML", 0, 0, 0, 3, 0, 0, 1, 4
"d:\IDEWORK\lvmen\src\licensedcode\data\rules\cc-by-3.0_103.yml", "YAML", 0, 0, 0, 3, 0, 0, 1, 4
"d:\IDEWORK\lvmen\src\licensedcode\data\rules\cc-by-3.0_104.yml", "YAML", 0, 0, 0, 3, 0, 0, 1, 4
"d:\IDEWORK\lvmen\src\licensedcode\data\rules\cc-by-3.0_105.yml", "YAML", 0, 0, 0, 5, 0, 0, 1, 6
"d:\IDEWORK\lvmen\src\licensedcode\data\rules\cc-by-3.0_106.yml", "YAML", 0, 0, 0, 5, 0, 0, 1, 6
"d:\IDEWORK\lvmen\src\licensedcode\data\rules\cc-by-3.0_107.yml", "YAML", 0, 0, 0, 3, 0, 0, 1, 4
"d:\IDEWORK\lvmen\src\licensedcode\data\rules\cc-by-3.0_108.yml", "YAML", 0, 0, 0, 3, 0, 0, 1, 4
"d:\IDEWORK\lvmen\src\licensedcode\data\rules\cc-by-3.0_109.yml", "YAML", 0, 0, 0, 2, 0, 0, 1, 3
"d:\IDEWORK\lvmen\src\licensedcode\data\rules\cc-by-3.0_11.yml", "YAML", 0, 0, 0, 4, 0, 0, 1, 5
"d:\IDEWORK\lvmen\src\licensedcode\data\rules\cc-by-3.0_110.yml", "YAML", 0, 0, 0, 2, 0, 0, 1, 3
"d:\IDEWORK\lvmen\src\licensedcode\data\rules\cc-by-3.0_111.yml", "YAML", 0, 0, 0, 5, 0, 0, 1, 6
"d:\IDEWORK\lvmen\src\licensedcode\data\rules\cc-by-3.0_12.yml", "YAML", 0, 0, 0, 5, 0, 0, 1, 6
"d:\IDEWORK\lvmen\src\licensedcode\data\rules\cc-by-3.0_13.yml", "YAML", 0, 0, 0, 5, 0, 0, 1, 6
"d:\IDEWORK\lvmen\src\licensedcode\data\rules\cc-by-3.0_14.yml", "YAML", 0, 0, 0, 7, 0, 0, 1, 8
"d:\IDEWORK\lvmen\src\licensedcode\data\rules\cc-by-3.0_15.yml", "YAML", 0, 0, 0, 3, 0, 0, 1, 4
"d:\IDEWORK\lvmen\src\licensedcode\data\rules\cc-by-3.0_16.yml", "YAML", 0, 0, 0, 4, 0, 0, 1, 5
"d:\IDEWORK\lvmen\src\licensedcode\data\rules\cc-by-3.0_17.yml", "YAML", 0, 0, 0, 5, 0, 0, 1, 6
"d:\IDEWORK\lvmen\src\licensedcode\data\rules\cc-by-3.0_18.yml", "YAML", 0, 0, 0, 5, 0, 0, 1, 6
"d:\IDEWORK\lvmen\src\licensedcode\data\rules\cc-by-3.0_19.yml", "YAML", 0, 0, 0, 5, 0, 0, 1, 6
"d:\IDEWORK\lvmen\src\licensedcode\data\rules\cc-by-3.0_190.yml", "YAML", 0, 0, 0, 3, 0, 0, 1, 4
"d:\IDEWORK\lvmen\src\licensedcode\data\rules\cc-by-3.0_2.yml", "YAML", 0, 0, 0, 4, 0, 0, 1, 5
"d:\IDEWORK\lvmen\src\licensedcode\data\rules\cc-by-3.0_20.yml", "YAML", 0, 0, 0, 5, 0, 0, 1, 6
"d:\IDEWORK\lvmen\src\licensedcode\data\rules\cc-by-3.0_21.yml", "YAML", 0, 0, 0, 5, 0, 0, 1, 6
"d:\IDEWORK\lvmen\src\licensedcode\data\rules\cc-by-3.0_22.yml", "YAML", 0, 0, 0, 5, 0, 0, 1, 6
"d:\IDEWORK\lvmen\src\licensedcode\data\rules\cc-by-3.0_23.yml", "YAML", 0, 0, 0, 5, 0, 0, 1, 6
"d:\IDEWORK\lvmen\src\licensedcode\data\rules\cc-by-3.0_24.yml", "YAML", 0, 0, 0, 10, 0, 0, 1, 11
"d:\IDEWORK\lvmen\src\licensedcode\data\rules\cc-by-3.0_25.yml", "YAML", 0, 0, 0, 5, 0, 0, 1, 6
"d:\IDEWORK\lvmen\src\licensedcode\data\rules\cc-by-3.0_26.yml", "YAML", 0, 0, 0, 3, 0, 0, 1, 4
"d:\IDEWORK\lvmen\src\licensedcode\data\rules\cc-by-3.0_27.yml", "YAML", 0, 0, 0, 5, 0, 0, 1, 6
"d:\IDEWORK\lvmen\src\licensedcode\data\rules\cc-by-3.0_28.yml", "YAML", 0, 0, 0, 5, 0, 0, 1, 6
"d:\IDEWORK\lvmen\src\licensedcode\data\rules\cc-by-3.0_29.yml", "YAML", 0, 0, 0, 9, 0, 0, 1, 10
"d:\IDEWORK\lvmen\src\licensedcode\data\rules\cc-by-3.0_3.yml", "YAML", 0, 0, 0, 5, 0, 0, 1, 6
"d:\IDEWORK\lvmen\src\licensedcode\data\rules\cc-by-3.0_30.yml", "YAML", 0, 0, 0, 5, 0, 0, 1, 6
"d:\IDEWORK\lvmen\src\licensedcode\data\rules\cc-by-3.0_31.yml", "YAML", 0, 0, 0, 9, 0, 0, 1, 10
"d:\IDEWORK\lvmen\src\licensedcode\data\rules\cc-by-3.0_32.yml", "YAML", 0, 0, 0, 5, 0, 0, 1, 6
"d:\IDEWORK\lvmen\src\licensedcode\data\rules\cc-by-3.0_33.yml", "YAML", 0, 0, 0, 7, 0, 0, 1, 8
"d:\IDEWORK\lvmen\src\licensedcode\data\rules\cc-by-3.0_34.yml", "YAML", 0, 0, 0, 5, 0, 0, 1, 6
"d:\IDEWORK\lvmen\src\licensedcode\data\rules\cc-by-3.0_35.yml", "YAML", 0, 0, 0, 5, 0, 0, 1, 6
"d:\IDEWORK\lvmen\src\licensedcode\data\rules\cc-by-3.0_36.yml", "YAML", 0, 0, 0, 3, 0, 0, 1, 4
"d:\IDEWORK\lvmen\src\licensedcode\data\rules\cc-by-3.0_37.yml", "YAML", 0, 0, 0, 3, 0, 0, 1, 4
"d:\IDEWORK\lvmen\src\licensedcode\data\rules\cc-by-3.0_38.yml", "YAML", 0, 0, 0, 5, 0, 0, 1, 6
"d:\IDEWORK\lvmen\src\licensedcode\data\rules\cc-by-3.0_39.yml", "YAML", 0, 0, 0, 5, 0, 0, 1, 6
"d:\IDEWORK\lvmen\src\licensedcode\data\rules\cc-by-3.0_4.yml", "YAML", 0, 0, 0, 6, 0, 0, 1, 7
"d:\IDEWORK\lvmen\src\licensedcode\data\rules\cc-by-3.0_40.yml", "YAML", 0, 0, 0, 3, 0, 0, 1, 4
"d:\IDEWORK\lvmen\src\licensedcode\data\rules\cc-by-3.0_41.yml", "YAML", 0, 0, 0, 3, 0, 0, 1, 4
"d:\IDEWORK\lvmen\src\licensedcode\data\rules\cc-by-3.0_42.yml", "YAML", 0, 0, 0, 5, 0, 0, 1, 6
"d:\IDEWORK\lvmen\src\licensedcode\data\rules\cc-by-3.0_43.yml", "YAML", 0, 0, 0, 5, 0, 0, 1, 6
"d:\IDEWORK\lvmen\src\licensedcode\data\rules\cc-by-3.0_44.yml", "YAML", 0, 0, 0, 5, 0, 0, 1, 6
"d:\IDEWORK\lvmen\src\licensedcode\data\rules\cc-by-3.0_45.yml", "YAML", 0, 0, 0, 5, 0, 0, 1, 6
"d:\IDEWORK\lvmen\src\licensedcode\data\rules\cc-by-3.0_46.yml", "YAML", 0, 0, 0, 5, 0, 0, 1, 6
"d:\IDEWORK\lvmen\src\licensedcode\data\rules\cc-by-3.0_47.yml", "YAML", 0, 0, 0, 5, 0, 0, 1, 6
"d:\IDEWORK\lvmen\src\licensedcode\data\rules\cc-by-3.0_48.yml", "YAML", 0, 0, 0, 5, 0, 0, 1, 6
"d:\IDEWORK\lvmen\src\licensedcode\data\rules\cc-by-3.0_49.yml", "YAML", 0, 0, 0, 5, 0, 0, 1, 6
"d:\IDEWORK\lvmen\src\licensedcode\data\rules\cc-by-3.0_5.yml", "YAML", 0, 0, 0, 3, 0, 0, 1, 4
"d:\IDEWORK\lvmen\src\licensedcode\data\rules\cc-by-3.0_50.yml", "YAML", 0, 0, 0, 5, 0, 0, 1, 6
"d:\IDEWORK\lvmen\src\licensedcode\data\rules\cc-by-3.0_51.yml", "YAML", 0, 0, 0, 5, 0, 0, 1, 6
"d:\IDEWORK\lvmen\src\licensedcode\data\rules\cc-by-3.0_52.yml", "YAML", 0, 0, 0, 3, 0, 0, 1, 4
"d:\IDEWORK\lvmen\src\licensedcode\data\rules\cc-by-3.0_53.yml", "YAML", 0, 0, 0, 5, 0, 0, 1, 6
"d:\IDEWORK\lvmen\src\licensedcode\data\rules\cc-by-3.0_54.yml", "YAML", 0, 0, 0, 5, 0, 0, 1, 6
"d:\IDEWORK\lvmen\src\licensedcode\data\rules\cc-by-3.0_55.yml", "YAML", 0, 0, 0, 3, 0, 0, 1, 4
"d:\IDEWORK\lvmen\src\licensedcode\data\rules\cc-by-3.0_56.yml", "YAML", 0, 0, 0, 3, 0, 0, 1, 4
"d:\IDEWORK\lvmen\src\licensedcode\data\rules\cc-by-3.0_57.yml", "YAML", 0, 0, 0, 3, 0, 0, 1, 4
"d:\IDEWORK\lvmen\src\licensedcode\data\rules\cc-by-3.0_58.yml", "YAML", 0, 0, 0, 3, 0, 0, 1, 4
"d:\IDEWORK\lvmen\src\licensedcode\data\rules\cc-by-3.0_59.yml", "YAML", 0, 0, 0, 5, 0, 0, 1, 6
"d:\IDEWORK\lvmen\src\licensedcode\data\rules\cc-by-3.0_6.yml", "YAML", 0, 0, 0, 3, 0, 0, 1, 4
"d:\IDEWORK\lvmen\src\licensedcode\data\rules\cc-by-3.0_60.yml", "YAML", 0, 0, 0, 3, 0, 0, 1, 4
"d:\IDEWORK\lvmen\src\licensedcode\data\rules\cc-by-3.0_61.yml", "YAML", 0, 0, 0, 3, 0, 0, 1, 4
"d:\IDEWORK\lvmen\src\licensedcode\data\rules\cc-by-3.0_62.yml", "YAML", 0, 0, 0, 3, 0, 0, 1, 4
"d:\IDEWORK\lvmen\src\licensedcode\data\rules\cc-by-3.0_63.yml", "YAML", 0, 0, 0, 3, 0, 0, 1, 4
"d:\IDEWORK\lvmen\src\licensedcode\data\rules\cc-by-3.0_64.yml", "YAML", 0, 0, 0, 3, 0, 0, 1, 4
"d:\IDEWORK\lvmen\src\licensedcode\data\rules\cc-by-3.0_65.yml", "YAML", 0, 0, 0, 3, 0, 0, 1, 4
"d:\IDEWORK\lvmen\src\licensedcode\data\rules\cc-by-3.0_66.yml", "YAML", 0, 0, 0, 5, 0, 0, 1, 6
"d:\IDEWORK\lvmen\src\licensedcode\data\rules\cc-by-3.0_67.yml", "YAML", 0, 0, 0, 5, 0, 0, 1, 6
"d:\IDEWORK\lvmen\src\licensedcode\data\rules\cc-by-3.0_68.yml", "YAML", 0, 0, 0, 5, 0, 0, 1, 6
"d:\IDEWORK\lvmen\src\licensedcode\data\rules\cc-by-3.0_69.yml", "YAML", 0, 0, 0, 6, 0, 0, 1, 7
"d:\IDEWORK\lvmen\src\licensedcode\data\rules\cc-by-3.0_7.yml", "YAML", 0, 0, 0, 5, 0, 0, 1, 6
"d:\IDEWORK\lvmen\src\licensedcode\data\rules\cc-by-3.0_70.yml", "YAML", 0, 0, 0, 6, 0, 0, 1, 7
"d:\IDEWORK\lvmen\src\licensedcode\data\rules\cc-by-3.0_71.yml", "YAML", 0, 0, 0, 3, 0, 0, 1, 4
"d:\IDEWORK\lvmen\src\licensedcode\data\rules\cc-by-3.0_72.yml", "YAML", 0, 0, 0, 5, 0, 0, 1, 6
"d:\IDEWORK\lvmen\src\licensedcode\data\rules\cc-by-3.0_73.yml", "YAML", 0, 0, 0, 5, 0, 0, 1, 6
"d:\IDEWORK\lvmen\src\licensedcode\data\rules\cc-by-3.0_74.yml", "YAML", 0, 0, 0, 3, 0, 0, 1, 4
"d:\IDEWORK\lvmen\src\licensedcode\data\rules\cc-by-3.0_75.yml", "YAML", 0, 0, 0, 3, 0, 0, 1, 4
"d:\IDEWORK\lvmen\src\licensedcode\data\rules\cc-by-3.0_76.yml", "YAML", 0, 0, 0, 3, 0, 0, 1, 4
"d:\IDEWORK\lvmen\src\licensedcode\data\rules\cc-by-3.0_77.yml", "YAML", 0, 0, 0, 5, 0, 0, 1, 6
"d:\IDEWORK\lvmen\src\licensedcode\data\rules\cc-by-3.0_78.yml", "YAML", 0, 0, 0, 3, 0, 0, 1, 4
"d:\IDEWORK\lvmen\src\licensedcode\data\rules\cc-by-3.0_79.yml", "YAML", 0, 0, 0, 5, 0, 0, 1, 6
"d:\IDEWORK\lvmen\src\licensedcode\data\rules\cc-by-3.0_8.yml", "YAML", 0, 0, 0, 4, 0, 0, 1, 5
"d:\IDEWORK\lvmen\src\licensedcode\data\rules\cc-by-3.0_80.yml", "YAML", 0, 0, 0, 3, 0, 0, 1, 4
"d:\IDEWORK\lvmen\src\licensedcode\data\rules\cc-by-3.0_81.yml", "YAML", 0, 0, 0, 7, 0, 0, 1, 8
"d:\IDEWORK\lvmen\src\licensedcode\data\rules\cc-by-3.0_82.yml", "YAML", 0, 0, 0, 5, 0, 0, 1, 6
"d:\IDEWORK\lvmen\src\licensedcode\data\rules\cc-by-3.0_83.yml", "YAML", 0, 0, 0, 5, 0, 0, 1, 6
"d:\IDEWORK\lvmen\src\licensedcode\data\rules\cc-by-3.0_84.yml", "YAML", 0, 0, 0, 5, 0, 0, 1, 6
"d:\IDEWORK\lvmen\src\licensedcode\data\rules\cc-by-3.0_85.yml", "YAML", 0, 0, 0, 5, 0, 0, 1, 6
"d:\IDEWORK\lvmen\src\licensedcode\data\rules\cc-by-3.0_86.yml", "YAML", 0, 0, 0, 5, 0, 0, 1, 6
"d:\IDEWORK\lvmen\src\licensedcode\data\rules\cc-by-3.0_87.yml", "YAML", 0, 0, 0, 5, 0, 0, 1, 6
"d:\IDEWORK\lvmen\src\licensedcode\data\rules\cc-by-3.0_88.yml", "YAML", 0, 0, 0, 5, 0, 0, 1, 6
"d:\IDEWORK\lvmen\src\licensedcode\data\rules\cc-by-3.0_89.yml", "YAML", 0, 0, 0, 5, 0, 0, 1, 6
"d:\IDEWORK\lvmen\src\licensedcode\data\rules\cc-by-3.0_9.yml", "YAML", 0, 0, 0, 5, 0, 0, 1, 6
"d:\IDEWORK\lvmen\src\licensedcode\data\rules\cc-by-3.0_90.yml", "YAML", 0, 0, 0, 5, 0, 0, 1, 6
"d:\IDEWORK\lvmen\src\licensedcode\data\rules\cc-by-3.0_91.yml", "YAML", 0, 0, 0, 5, 0, 0, 1, 6
"d:\IDEWORK\lvmen\src\licensedcode\data\rules\cc-by-3.0_92.yml", "YAML", 0, 0, 0, 5, 0, 0, 1, 6
"d:\IDEWORK\lvmen\src\licensedcode\data\rules\cc-by-3.0_93.yml", "YAML", 0, 0, 0, 5, 0, 0, 1, 6
"d:\IDEWORK\lvmen\src\licensedcode\data\rules\cc-by-3.0_94.yml", "YAML", 0, 0, 0, 5, 0, 0, 1, 6
"d:\IDEWORK\lvmen\src\licensedcode\data\rules\cc-by-3.0_95.yml", "YAML", 0, 0, 0, 3, 0, 0, 1, 4
"d:\IDEWORK\lvmen\src\licensedcode\data\rules\cc-by-3.0_96.yml", "YAML", 0, 0, 0, 3, 0, 0, 1, 4
"d:\IDEWORK\lvmen\src\licensedcode\data\rules\cc-by-3.0_97.yml", "YAML", 0, 0, 0, 3, 0, 0, 1, 4
"d:\IDEWORK\lvmen\src\licensedcode\data\rules\cc-by-3.0_98.yml", "YAML", 0, 0, 0, 5, 0, 0, 1, 6
"d:\IDEWORK\lvmen\src\licensedcode\data\rules\cc-by-3.0_99.yml", "YAML", 0, 0, 0, 5, 0, 0, 1, 6
"d:\IDEWORK\lvmen\src\licensedcode\data\rules\cc-by-3.0_and_gpl-2.0_1.yml", "YAML", 0, 0, 0, 5, 0, 0, 1, 6
"d:\IDEWORK\lvmen\src\licensedcode\data\rules\cc-by-3.0_and_mit.yml", "YAML", 0, 0, 0, 3, 0, 0, 1, 4
"d:\IDEWORK\lvmen\src\licensedcode\data\rules\cc-by-3.0_and_mit2.yml", "YAML", 0, 0, 0, 9, 0, 0, 1, 10
"d:\IDEWORK\lvmen\src\licensedcode\data\rules\cc-by-3.0_and_mit3.yml", "YAML", 0, 0, 0, 4, 0, 0, 1, 5
"d:\IDEWORK\lvmen\src\licensedcode\data\rules\cc-by-3.0_and_mit_1.yml", "YAML", 0, 0, 0, 3, 0, 0, 1, 4
"d:\IDEWORK\lvmen\src\licensedcode\data\rules\cc-by-3.0_and_mit_10.yml", "YAML", 0, 0, 0, 6, 0, 0, 1, 7
"d:\IDEWORK\lvmen\src\licensedcode\data\rules\cc-by-3.0_and_mit_2.yml", "YAML", 0, 0, 0, 6, 0, 0, 1, 7
"d:\IDEWORK\lvmen\src\licensedcode\data\rules\cc-by-3.0_and_mit_3.yml", "YAML", 0, 0, 0, 6, 0, 0, 1, 7
"d:\IDEWORK\lvmen\src\licensedcode\data\rules\cc-by-3.0_and_mit_4.yml", "YAML", 0, 0, 0, 6, 0, 0, 1, 7
"d:\IDEWORK\lvmen\src\licensedcode\data\rules\cc-by-3.0_and_mit_5.yml", "YAML", 0, 0, 0, 6, 0, 0, 1, 7
"d:\IDEWORK\lvmen\src\licensedcode\data\rules\cc-by-3.0_and_mit_6.yml", "YAML", 0, 0, 0, 6, 0, 0, 1, 7
"d:\IDEWORK\lvmen\src\licensedcode\data\rules\cc-by-3.0_and_mit_7.yml", "YAML", 0, 0, 0, 7, 0, 0, 1, 8
"d:\IDEWORK\lvmen\src\licensedcode\data\rules\cc-by-3.0_and_mit_8.yml", "YAML", 0, 0, 0, 6, 0, 0, 1, 7
"d:\IDEWORK\lvmen\src\licensedcode\data\rules\cc-by-3.0_and_mit_9.yml", "YAML", 0, 0, 0, 6, 0, 0, 1, 7
"d:\IDEWORK\lvmen\src\licensedcode\data\rules\cc-by-3.0_licensebutton.yml", "YAML", 0, 0, 0, 5, 0, 0, 1, 6
"d:\IDEWORK\lvmen\src\licensedcode\data\rules\cc-by-3.0_or_gpl-2.0_1.yml", "YAML", 0, 0, 0, 3, 0, 0, 1, 4
"d:\IDEWORK\lvmen\src\licensedcode\data\rules\cc-by-3.0_url_1.yml", "YAML", 0, 0, 0, 5, 0, 0, 1, 6
"d:\IDEWORK\lvmen\src\licensedcode\data\rules\cc-by-3.0_url_2.yml", "YAML", 0, 0, 0, 5, 0, 0, 1, 6
"d:\IDEWORK\lvmen\src\licensedcode\data\rules\cc-by-4.0.SPDX.yml", "YAML", 0, 0, 0, 4, 0, 0, 1, 5
"d:\IDEWORK\lvmen\src\licensedcode\data\rules\cc-by-4.0.yml", "YAML", 0, 0, 0, 2, 0, 0, 1, 3
"d:\IDEWORK\lvmen\src\licensedcode\data\rules\cc-by-4.0_1.yml", "YAML", 0, 0, 0, 2, 0, 0, 1, 3
"d:\IDEWORK\lvmen\src\licensedcode\data\rules\cc-by-4.0_10.yml", "YAML", 0, 0, 0, 4, 0, 0, 1, 5
"d:\IDEWORK\lvmen\src\licensedcode\data\rules\cc-by-4.0_11.yml", "YAML", 0, 0, 0, 4, 0, 0, 1, 5
"d:\IDEWORK\lvmen\src\licensedcode\data\rules\cc-by-4.0_12.yml", "YAML", 0, 0, 0, 3, 0, 0, 1, 4
"d:\IDEWORK\lvmen\src\licensedcode\data\rules\cc-by-4.0_13.yml", "YAML", 0, 0, 0, 3, 0, 0, 1, 4
"d:\IDEWORK\lvmen\src\licensedcode\data\rules\cc-by-4.0_14.yml", "YAML", 0, 0, 0, 5, 0, 0, 1, 6
"d:\IDEWORK\lvmen\src\licensedcode\data\rules\cc-by-4.0_15.yml", "YAML", 0, 0, 0, 4, 0, 0, 1, 5
"d:\IDEWORK\lvmen\src\licensedcode\data\rules\cc-by-4.0_16.yml", "YAML", 0, 0, 0, 4, 0, 0, 1, 5
"d:\IDEWORK\lvmen\src\licensedcode\data\rules\cc-by-4.0_17.yml", "YAML", 0, 0, 0, 4, 0, 0, 1, 5
"d:\IDEWORK\lvmen\src\licensedcode\data\rules\cc-by-4.0_18.yml", "YAML", 0, 0, 0, 5, 0, 0, 1, 6
"d:\IDEWORK\lvmen\src\licensedcode\data\rules\cc-by-4.0_19.yml", "YAML", 0, 0, 0, 4, 0, 0, 1, 5
"d:\IDEWORK\lvmen\src\licensedcode\data\rules\cc-by-4.0_2.yml", "YAML", 0, 0, 0, 2, 0, 0, 1, 3
"d:\IDEWORK\lvmen\src\licensedcode\data\rules\cc-by-4.0_20.yml", "YAML", 0, 0, 0, 5, 0, 0, 1, 6
"d:\IDEWORK\lvmen\src\licensedcode\data\rules\cc-by-4.0_21.yml", "YAML", 0, 0, 0, 5, 0, 0, 1, 6
"d:\IDEWORK\lvmen\src\licensedcode\data\rules\cc-by-4.0_22.yml", "YAML", 0, 0, 0, 3, 0, 0, 1, 4
"d:\IDEWORK\lvmen\src\licensedcode\data\rules\cc-by-4.0_23.yml", "YAML", 0, 0, 0, 5, 0, 0, 1, 6
"d:\IDEWORK\lvmen\src\licensedcode\data\rules\cc-by-4.0_24.yml", "YAML", 0, 0, 0, 3, 0, 0, 1, 4
"d:\IDEWORK\lvmen\src\licensedcode\data\rules\cc-by-4.0_25.yml", "YAML", 0, 0, 0, 5, 0, 0, 1, 6
"d:\IDEWORK\lvmen\src\licensedcode\data\rules\cc-by-4.0_26.yml", "YAML", 0, 0, 0, 5, 0, 0, 1, 6
"d:\IDEWORK\lvmen\src\licensedcode\data\rules\cc-by-4.0_27.yml", "YAML", 0, 0, 0, 5, 0, 0, 1, 6
"d:\IDEWORK\lvmen\src\licensedcode\data\rules\cc-by-4.0_28.yml", "YAML", 0, 0, 0, 5, 0, 0, 1, 6
"d:\IDEWORK\lvmen\src\licensedcode\data\rules\cc-by-4.0_29.yml", "YAML", 0, 0, 0, 3, 0, 0, 1, 4
"d:\IDEWORK\lvmen\src\licensedcode\data\rules\cc-by-4.0_3.yml", "YAML", 0, 0, 0, 2, 0, 0, 1, 3
"d:\IDEWORK\lvmen\src\licensedcode\data\rules\cc-by-4.0_30.yml", "YAML", 0, 0, 0, 5, 0, 0, 1, 6
"d:\IDEWORK\lvmen\src\licensedcode\data\rules\cc-by-4.0_31.yml", "YAML", 0, 0, 0, 7, 0, 0, 1, 8
"d:\IDEWORK\lvmen\src\licensedcode\data\rules\cc-by-4.0_32.yml", "YAML", 0, 0, 0, 7, 0, 0, 1, 8
"d:\IDEWORK\lvmen\src\licensedcode\data\rules\cc-by-4.0_33.yml", "YAML", 0, 0, 0, 5, 0, 0, 1, 6
"d:\IDEWORK\lvmen\src\licensedcode\data\rules\cc-by-4.0_34.yml", "YAML", 0, 0, 0, 3, 0, 0, 1, 4
"d:\IDEWORK\lvmen\src\licensedcode\data\rules\cc-by-4.0_35.yml", "YAML", 0, 0, 0, 5, 0, 0, 1, 6
"d:\IDEWORK\lvmen\src\licensedcode\data\rules\cc-by-4.0_36.yml", "YAML", 0, 0, 0, 5, 0, 0, 1, 6
"d:\IDEWORK\lvmen\src\licensedcode\data\rules\cc-by-4.0_37.yml", "YAML", 0, 0, 0, 5, 0, 0, 1, 6
"d:\IDEWORK\lvmen\src\licensedcode\data\rules\cc-by-4.0_38.yml", "YAML", 0, 0, 0, 6, 0, 0, 1, 7
"d:\IDEWORK\lvmen\src\licensedcode\data\rules\cc-by-4.0_39.yml", "YAML", 0, 0, 0, 5, 0, 0, 1, 6
"d:\IDEWORK\lvmen\src\licensedcode\data\rules\cc-by-4.0_4.yml", "YAML", 0, 0, 0, 3, 0, 0, 1, 4
"d:\IDEWORK\lvmen\src\licensedcode\data\rules\cc-by-4.0_40.yml", "YAML", 0, 0, 0, 5, 0, 0, 1, 6
"d:\IDEWORK\lvmen\src\licensedcode\data\rules\cc-by-4.0_41.yml", "YAML", 0, 0, 0, 3, 0, 0, 1, 4
"d:\IDEWORK\lvmen\src\licensedcode\data\rules\cc-by-4.0_42.yml", "YAML", 0, 0, 0, 3, 0, 0, 1, 4
"d:\IDEWORK\lvmen\src\licensedcode\data\rules\cc-by-4.0_43.yml", "YAML", 0, 0, 0, 3, 0, 0, 1, 4
"d:\IDEWORK\lvmen\src\licensedcode\data\rules\cc-by-4.0_44.yml", "YAML", 0, 0, 0, 3, 0, 0, 1, 4
"d:\IDEWORK\lvmen\src\licensedcode\data\rules\cc-by-4.0_45.yml", "YAML", 0, 0, 0, 6, 0, 0, 1, 7
"d:\IDEWORK\lvmen\src\licensedcode\data\rules\cc-by-4.0_46.yml", "YAML", 0, 0, 0, 6, 0, 0, 1, 7
"d:\IDEWORK\lvmen\src\licensedcode\data\rules\cc-by-4.0_47.yml", "YAML", 0, 0, 0, 5, 0, 0, 1, 6
"d:\IDEWORK\lvmen\src\licensedcode\data\rules\cc-by-4.0_48.yml", "YAML", 0, 0, 0, 5, 0, 0, 1, 6
"d:\IDEWORK\lvmen\src\licensedcode\data\rules\cc-by-4.0_49.yml", "YAML", 0, 0, 0, 5, 0, 0, 1, 6
"d:\IDEWORK\lvmen\src\licensedcode\data\rules\cc-by-4.0_5.yml", "YAML", 0, 0, 0, 3, 0, 0, 1, 4
"d:\IDEWORK\lvmen\src\licensedcode\data\rules\cc-by-4.0_50.yml", "YAML", 0, 0, 0, 3, 0, 0, 1, 4
"d:\IDEWORK\lvmen\src\licensedcode\data\rules\cc-by-4.0_51.yml", "YAML", 0, 0, 0, 3, 0, 0, 1, 4
"d:\IDEWORK\lvmen\src\licensedcode\data\rules\cc-by-4.0_52.yml", "YAML", 0, 0, 0, 3, 0, 0, 1, 4
"d:\IDEWORK\lvmen\src\licensedcode\data\rules\cc-by-4.0_53.yml", "YAML", 0, 0, 0, 3, 0, 0, 1, 4
"d:\IDEWORK\lvmen\src\licensedcode\data\rules\cc-by-4.0_54.yml", "YAML", 0, 0, 0, 5, 0, 0, 1, 6
"d:\IDEWORK\lvmen\src\licensedcode\data\rules\cc-by-4.0_55.yml", "YAML", 0, 0, 0, 5, 0, 0, 1, 6
"d:\IDEWORK\lvmen\src\licensedcode\data\rules\cc-by-4.0_56.yml", "YAML", 0, 0, 0, 3, 0, 0, 1, 4
"d:\IDEWORK\lvmen\src\licensedcode\data\rules\cc-by-4.0_57.yml", "YAML", 0, 0, 0, 3, 0, 0, 1, 4
"d:\IDEWORK\lvmen\src\licensedcode\data\rules\cc-by-4.0_58.yml", "YAML", 0, 0, 0, 3, 0, 0, 1, 4
"d:\IDEWORK\lvmen\src\licensedcode\data\rules\cc-by-4.0_59.yml", "YAML", 0, 0, 0, 3, 0, 0, 1, 4
"d:\IDEWORK\lvmen\src\licensedcode\data\rules\cc-by-4.0_6.yml", "YAML", 0, 0, 0, 4, 0, 0, 1, 5
"d:\IDEWORK\lvmen\src\licensedcode\data\rules\cc-by-4.0_60.yml", "YAML", 0, 0, 0, 3, 0, 0, 1, 4
"d:\IDEWORK\lvmen\src\licensedcode\data\rules\cc-by-4.0_61.yml", "YAML", 0, 0, 0, 5, 0, 0, 1, 6
"d:\IDEWORK\lvmen\src\licensedcode\data\rules\cc-by-4.0_62.yml", "YAML", 0, 0, 0, 5, 0, 0, 1, 6
"d:\IDEWORK\lvmen\src\licensedcode\data\rules\cc-by-4.0_63.yml", "YAML", 0, 0, 0, 5, 0, 0, 1, 6
"d:\IDEWORK\lvmen\src\licensedcode\data\rules\cc-by-4.0_64.yml", "YAML", 0, 0, 0, 3, 0, 0, 1, 4
"d:\IDEWORK\lvmen\src\licensedcode\data\rules\cc-by-4.0_65.yml", "YAML", 0, 0, 0, 5, 0, 0, 1, 6
"d:\IDEWORK\lvmen\src\licensedcode\data\rules\cc-by-4.0_66.yml", "YAML", 0, 0, 0, 3, 0, 0, 1, 4
"d:\IDEWORK\lvmen\src\licensedcode\data\rules\cc-by-4.0_67.yml", "YAML", 0, 0, 0, 5, 0, 0, 1, 6
"d:\IDEWORK\lvmen\src\licensedcode\data\rules\cc-by-4.0_68.yml", "YAML", 0, 0, 0, 3, 0, 0, 1, 4
"d:\IDEWORK\lvmen\src\licensedcode\data\rules\cc-by-4.0_69.yml", "YAML", 0, 0, 0, 5, 0, 0, 1, 6
"d:\IDEWORK\lvmen\src\licensedcode\data\rules\cc-by-4.0_7.yml", "YAML", 0, 0, 0, 4, 0, 0, 1, 5
"d:\IDEWORK\lvmen\src\licensedcode\data\rules\cc-by-4.0_70.yml", "YAML", 0, 0, 0, 6, 0, 0, 1, 7
"d:\IDEWORK\lvmen\src\licensedcode\data\rules\cc-by-4.0_71.yml", "YAML", 0, 0, 0, 3, 0, 0, 1, 4
"d:\IDEWORK\lvmen\src\licensedcode\data\rules\cc-by-4.0_72.yml", "YAML", 0, 0, 0, 5, 0, 0, 1, 6
"d:\IDEWORK\lvmen\src\licensedcode\data\rules\cc-by-4.0_73.yml", "YAML", 0, 0, 0, 5, 0, 0, 1, 6
"d:\IDEWORK\lvmen\src\licensedcode\data\rules\cc-by-4.0_74.yml", "YAML", 0, 0, 0, 5, 0, 0, 1, 6
"d:\IDEWORK\lvmen\src\licensedcode\data\rules\cc-by-4.0_75.yml", "YAML", 0, 0, 0, 5, 0, 0, 1, 6
"d:\IDEWORK\lvmen\src\licensedcode\data\rules\cc-by-4.0_76.yml", "YAML", 0, 0, 0, 5, 0, 0, 1, 6
"d:\IDEWORK\lvmen\src\licensedcode\data\rules\cc-by-4.0_77.yml", "YAML", 0, 0, 0, 3, 0, 0, 1, 4
"d:\IDEWORK\lvmen\src\licensedcode\data\rules\cc-by-4.0_78.yml", "YAML", 0, 0, 0, 3, 0, 0, 1, 4
"d:\IDEWORK\lvmen\src\licensedcode\data\rules\cc-by-4.0_79.yml", "YAML", 0, 0, 0, 5, 0, 0, 1, 6
"d:\IDEWORK\lvmen\src\licensedcode\data\rules\cc-by-4.0_8.yml", "YAML", 0, 0, 0, 3, 0, 0, 1, 4
"d:\IDEWORK\lvmen\src\licensedcode\data\rules\cc-by-4.0_80.yml", "YAML", 0, 0, 0, 5, 0, 0, 1, 6
"d:\IDEWORK\lvmen\src\licensedcode\data\rules\cc-by-4.0_81.yml", "YAML", 0, 0, 0, 3, 0, 0, 1, 4
"d:\IDEWORK\lvmen\src\licensedcode\data\rules\cc-by-4.0_82.yml", "YAML", 0, 0, 0, 3, 0, 0, 1, 4
"d:\IDEWORK\lvmen\src\licensedcode\data\rules\cc-by-4.0_83.yml", "YAML", 0, 0, 0, 3, 0, 0, 1, 4
"d:\IDEWORK\lvmen\src\licensedcode\data\rules\cc-by-4.0_84.yml", "YAML", 0, 0, 0, 3, 0, 0, 1, 4
"d:\IDEWORK\lvmen\src\licensedcode\data\rules\cc-by-4.0_85.yml", "YAML", 0, 0, 0, 3, 0, 0, 1, 4
"d:\IDEWORK\lvmen\src\licensedcode\data\rules\cc-by-4.0_86.yml", "YAML", 0, 0, 0, 3, 0, 0, 1, 4
"d:\IDEWORK\lvmen\src\licensedcode\data\rules\cc-by-4.0_87.yml", "YAML", 0, 0, 0, 3, 0, 0, 1, 4
"d:\IDEWORK\lvmen\src\licensedcode\data\rules\cc-by-4.0_88.yml", "YAML", 0, 0, 0, 3, 0, 0, 1, 4
"d:\IDEWORK\lvmen\src\licensedcode\data\rules\cc-by-4.0_89.yml", "YAML", 0, 0, 0, 3, 0, 0, 1, 4
"d:\IDEWORK\lvmen\src\licensedcode\data\rules\cc-by-4.0_9.yml", "YAML", 0, 0, 0, 5, 0, 0, 1, 6
"d:\IDEWORK\lvmen\src\licensedcode\data\rules\cc-by-4.0_90.yml", "YAML", 0, 0, 0, 3, 0, 0, 1, 4
"d:\IDEWORK\lvmen\src\licensedcode\data\rules\cc-by-4.0_91.yml", "YAML", 0, 0, 0, 3, 0, 0, 1, 4
"d:\IDEWORK\lvmen\src\licensedcode\data\rules\cc-by-4.0_92.yml", "YAML", 0, 0, 0, 4, 0, 0, 1, 5
"d:\IDEWORK\lvmen\src\licensedcode\data\rules\cc-by-4.0_93.yml", "YAML", 0, 0, 0, 5, 0, 0, 1, 6
"d:\IDEWORK\lvmen\src\licensedcode\data\rules\cc-by-4.0_94.yml", "YAML", 0, 0, 0, 3, 0, 0, 1, 4
"d:\IDEWORK\lvmen\src\licensedcode\data\rules\cc-by-4.0_95.yml", "YAML", 0, 0, 0, 3, 0, 0, 1, 4
"d:\IDEWORK\lvmen\src\licensedcode\data\rules\cc-by-4.0_96.yml", "YAML", 0, 0, 0, 2, 0, 0, 1, 3
"d:\IDEWORK\lvmen\src\licensedcode\data\rules\cc-by-4.0_and_address.yml", "YAML", 0, 0, 0, 4, 0, 0, 1, 5
"d:\IDEWORK\lvmen\src\licensedcode\data\rules\cc-by-4.0_and_mit_1.yml", "YAML", 0, 0, 0, 3, 0, 0, 1, 4
"d:\IDEWORK\lvmen\src\licensedcode\data\rules\cc-by-4.0_and_mit_2.yml", "YAML", 0, 0, 0, 3, 0, 0, 1, 4
"d:\IDEWORK\lvmen\src\licensedcode\data\rules\cc-by-4.0_and_mit_3.yml", "YAML", 0, 0, 0, 3, 0, 0, 1, 4
"d:\IDEWORK\lvmen\src\licensedcode\data\rules\cc-by-4.0_and_ofl-1.1_and_mit_1.yml", "YAML", 0, 0, 0, 5, 0, 0, 1, 6
"d:\IDEWORK\lvmen\src\licensedcode\data\rules\cc-by-4.0_and_ofl-1.1_and_mit_2.yml", "YAML", 0, 0, 0, 3, 0, 0, 1, 4
"d:\IDEWORK\lvmen\src\licensedcode\data\rules\cc-by-4.0_and_ofl-1.1_and_mit_3.yml", "YAML", 0, 0, 0, 8, 0, 0, 1, 9
"d:\IDEWORK\lvmen\src\licensedcode\data\rules\cc-by-4.0_and_other-permissive_1.yml", "YAML", 0, 0, 0, 5, 0, 0, 1, 6
"d:\IDEWORK\lvmen\src\licensedcode\data\rules\cc-by-4.0_and_url1.yml", "YAML", 0, 0, 0, 4, 0, 0, 1, 5
"d:\IDEWORK\lvmen\src\licensedcode\data\rules\cc-by-4.0_and_url2.yml", "YAML", 0, 0, 0, 4, 0, 0, 1, 5
"d:\IDEWORK\lvmen\src\licensedcode\data\rules\cc-by-4.0_and_url3.yml", "YAML", 0, 0, 0, 5, 0, 0, 1, 6
"d:\IDEWORK\lvmen\src\licensedcode\data\rules\cc-by-4.0_and_url4.yml", "YAML", 0, 0, 0, 5, 0, 0, 1, 6
"d:\IDEWORK\lvmen\src\licensedcode\data\rules\cc-by-4.0_and_url5.yml", "YAML", 0, 0, 0, 5, 0, 0, 1, 6
"d:\IDEWORK\lvmen\src\licensedcode\data\rules\cc-by-4.0_and_url6.yml", "YAML", 0, 0, 0, 5, 0, 0, 1, 6
"d:\IDEWORK\lvmen\src\licensedcode\data\rules\cc-by-4.0_licensebutton.yml", "YAML", 0, 0, 0, 5, 0, 0, 1, 6
"d:\IDEWORK\lvmen\src\licensedcode\data\rules\cc-by-4.0_other_files.yml", "YAML", 0, 0, 0, 3, 0, 0, 1, 4
"d:\IDEWORK\lvmen\src\licensedcode\data\rules\cc-by-4.0_url_1.yml", "YAML", 0, 0, 0, 5, 0, 0, 1, 6
"d:\IDEWORK\lvmen\src\licensedcode\data\rules\cc-by-4.0_url_2.yml", "YAML", 0, 0, 0, 5, 0, 0, 1, 6
"d:\IDEWORK\lvmen\src\licensedcode\data\rules\cc-by-4.0_url_badge.yml", "YAML", 0, 0, 0, 4, 0, 0, 1, 5
"d:\IDEWORK\lvmen\src\licensedcode\data\rules\cc-by-4.0_url_badge_1.yml", "YAML", 0, 0, 0, 5, 0, 0, 1, 6
"d:\IDEWORK\lvmen\src\licensedcode\data\rules\cc-by-4.0_url_badge_2.yml", "YAML", 0, 0, 0, 4, 0, 0, 1, 5
"d:\IDEWORK\lvmen\src\licensedcode\data\rules\cc-by-4.0_url_badge_3.yml", "YAML", 0, 0, 0, 3, 0, 0, 1, 4
"d:\IDEWORK\lvmen\src\licensedcode\data\rules\cc-by-4.0_url_glc_60.yml", "YAML", 0, 0, 0, 5, 0, 0, 1, 6
"d:\IDEWORK\lvmen\src\licensedcode\data\rules\cc-by-4.0_url_glc_61.yml", "YAML", 0, 0, 0, 5, 0, 0, 1, 6
"d:\IDEWORK\lvmen\src\licensedcode\data\rules\cc-by-nc-1.0.SPDX.yml", "YAML", 0, 0, 0, 6, 0, 0, 1, 7
"d:\IDEWORK\lvmen\src\licensedcode\data\rules\cc-by-nc-1.0.yml", "YAML", 0, 0, 0, 5, 0, 0, 1, 6
"d:\IDEWORK\lvmen\src\licensedcode\data\rules\cc-by-nc-1.0_1.yml", "YAML", 0, 0, 0, 5, 0, 0, 1, 6
"d:\IDEWORK\lvmen\src\licensedcode\data\rules\cc-by-nc-1.0_2.yml", "YAML", 0, 0, 0, 4, 0, 0, 1, 5
"d:\IDEWORK\lvmen\src\licensedcode\data\rules\cc-by-nc-1.0_3.yml", "YAML", 0, 0, 0, 3, 0, 0, 1, 4
"d:\IDEWORK\lvmen\src\licensedcode\data\rules\cc-by-nc-1.0_4.yml", "YAML", 0, 0, 0, 3, 0, 0, 1, 4
"d:\IDEWORK\lvmen\src\licensedcode\data\rules\cc-by-nc-1.0_5.yml", "YAML", 0, 0, 0, 5, 0, 0, 1, 6
"d:\IDEWORK\lvmen\src\licensedcode\data\rules\cc-by-nc-1.0_6.yml", "YAML", 0, 0, 0, 5, 0, 0, 1, 6
"d:\IDEWORK\lvmen\src\licensedcode\data\rules\cc-by-nc-1.0_7.yml", "YAML", 0, 0, 0, 5, 0, 0, 1, 6
"d:\IDEWORK\lvmen\src\licensedcode\data\rules\cc-by-nc-1.0_8.yml", "YAML", 0, 0, 0, 5, 0, 0, 1, 6
"d:\IDEWORK\lvmen\src\licensedcode\data\rules\cc-by-nc-1.0_9.yml", "YAML", 0, 0, 0, 4, 0, 0, 1, 5
"d:\IDEWORK\lvmen\src\licensedcode\data\rules\cc-by-nc-1.0_licensebutton.yml", "YAML", 0, 0, 0, 5, 0, 0, 1, 6
"d:\IDEWORK\lvmen\src\licensedcode\data\rules\cc-by-nc-1.0_url_1.yml", "YAML", 0, 0, 0, 5, 0, 0, 1, 6
"d:\IDEWORK\lvmen\src\licensedcode\data\rules\cc-by-nc-1.0_url_2.yml", "YAML", 0, 0, 0, 5, 0, 0, 1, 6
"d:\IDEWORK\lvmen\src\licensedcode\data\rules\cc-by-nc-1.0_url_glc_21.yml", "YAML", 0, 0, 0, 5, 0, 0, 1, 6
"d:\IDEWORK\lvmen\src\licensedcode\data\rules\cc-by-nc-2.0.SPDX.yml", "YAML", 0, 0, 0, 6, 0, 0, 1, 7
"d:\IDEWORK\lvmen\src\licensedcode\data\rules\cc-by-nc-2.0.yml", "YAML", 0, 0, 0, 5, 0, 0, 1, 6
"d:\IDEWORK\lvmen\src\licensedcode\data\rules\cc-by-nc-2.0_1.yml", "YAML", 0, 0, 0, 5, 0, 0, 1, 6
"d:\IDEWORK\lvmen\src\licensedcode\data\rules\cc-by-nc-2.0_2.yml", "YAML", 0, 0, 0, 3, 0, 0, 1, 4
"d:\IDEWORK\lvmen\src\licensedcode\data\rules\cc-by-nc-2.0_3.yml", "YAML", 0, 0, 0, 3, 0, 0, 1, 4
"d:\IDEWORK\lvmen\src\licensedcode\data\rules\cc-by-nc-2.0_4.yml", "YAML", 0, 0, 0, 5, 0, 0, 1, 6
"d:\IDEWORK\lvmen\src\licensedcode\data\rules\cc-by-nc-2.0_5.yml", "YAML", 0, 0, 0, 5, 0, 0, 1, 6
"d:\IDEWORK\lvmen\src\licensedcode\data\rules\cc-by-nc-2.0_6.yml", "YAML", 0, 0, 0, 5, 0, 0, 1, 6
"d:\IDEWORK\lvmen\src\licensedcode\data\rules\cc-by-nc-2.0_7.yml", "YAML", 0, 0, 0, 4, 0, 0, 1, 5
"d:\IDEWORK\lvmen\src\licensedcode\data\rules\cc-by-nc-2.0_license_button.yml", "YAML", 0, 0, 0, 5, 0, 0, 1, 6
"d:\IDEWORK\lvmen\src\licensedcode\data\rules\cc-by-nc-2.0_url_1.yml", "YAML", 0, 0, 0, 5, 0, 0, 1, 6
"d:\IDEWORK\lvmen\src\licensedcode\data\rules\cc-by-nc-2.0_url_2.yml", "YAML", 0, 0, 0, 5, 0, 0, 1, 6
"d:\IDEWORK\lvmen\src\licensedcode\data\rules\cc-by-nc-2.0_url_glc_23.yml", "YAML", 0, 0, 0, 5, 0, 0, 1, 6
"d:\IDEWORK\lvmen\src\licensedcode\data\rules\cc-by-nc-2.5.SPDX.yml", "YAML", 0, 0, 0, 6, 0, 0, 1, 7
"d:\IDEWORK\lvmen\src\licensedcode\data\rules\cc-by-nc-2.5.yml", "YAML", 0, 0, 0, 5, 0, 0, 1, 6
"d:\IDEWORK\lvmen\src\licensedcode\data\rules\cc-by-nc-2.5_1.yml", "YAML", 0, 0, 0, 5, 0, 0, 1, 6
"d:\IDEWORK\lvmen\src\licensedcode\data\rules\cc-by-nc-2.5_2.yml", "YAML", 0, 0, 0, 5, 0, 0, 1, 6
"d:\IDEWORK\lvmen\src\licensedcode\data\rules\cc-by-nc-2.5_3.yml", "YAML", 0, 0, 0, 3, 0, 0, 1, 4
"d:\IDEWORK\lvmen\src\licensedcode\data\rules\cc-by-nc-2.5_4.yml", "YAML", 0, 0, 0, 3, 0, 0, 1, 4
"d:\IDEWORK\lvmen\src\licensedcode\data\rules\cc-by-nc-2.5_5.yml", "YAML", 0, 0, 0, 5, 0, 0, 1, 6
"d:\IDEWORK\lvmen\src\licensedcode\data\rules\cc-by-nc-2.5_6.yml", "YAML", 0, 0, 0, 4, 0, 0, 1, 5
"d:\IDEWORK\lvmen\src\licensedcode\data\rules\cc-by-nc-2.5_licensebutton.yml", "YAML", 0, 0, 0, 5, 0, 0, 1, 6
"d:\IDEWORK\lvmen\src\licensedcode\data\rules\cc-by-nc-2.5_url_1.yml", "YAML", 0, 0, 0, 5, 0, 0, 1, 6
"d:\IDEWORK\lvmen\src\licensedcode\data\rules\cc-by-nc-2.5_url_2.yml", "YAML", 0, 0, 0, 5, 0, 0, 1, 6
"d:\IDEWORK\lvmen\src\licensedcode\data\rules\cc-by-nc-2.5_url_glc_25.yml", "YAML", 0, 0, 0, 5, 0, 0, 1, 6
"d:\IDEWORK\lvmen\src\licensedcode\data\rules\cc-by-nc-3.0.SPDX.yml", "YAML", 0, 0, 0, 6, 0, 0, 1, 7
"d:\IDEWORK\lvmen\src\licensedcode\data\rules\cc-by-nc-3.0.yml", "YAML", 0, 0, 0, 5, 0, 0, 1, 6
"d:\IDEWORK\lvmen\src\licensedcode\data\rules\cc-by-nc-3.0_1.yml", "YAML", 0, 0, 0, 5, 0, 0, 1, 6
"d:\IDEWORK\lvmen\src\licensedcode\data\rules\cc-by-nc-3.0_10.yml", "YAML", 0, 0, 0, 3, 0, 0, 1, 4
"d:\IDEWORK\lvmen\src\licensedcode\data\rules\cc-by-nc-3.0_11.yml", "YAML", 0, 0, 0, 5, 0, 0, 1, 6
"d:\IDEWORK\lvmen\src\licensedcode\data\rules\cc-by-nc-3.0_12.yml", "YAML", 0, 0, 0, 5, 0, 0, 1, 6
"d:\IDEWORK\lvmen\src\licensedcode\data\rules\cc-by-nc-3.0_13.yml", "YAML", 0, 0, 0, 5, 0, 0, 1, 6
"d:\IDEWORK\lvmen\src\licensedcode\data\rules\cc-by-nc-3.0_14.yml", "YAML", 0, 0, 0, 4, 0, 0, 1, 5
"d:\IDEWORK\lvmen\src\licensedcode\data\rules\cc-by-nc-3.0_2.yml", "YAML", 0, 0, 0, 4, 0, 0, 1, 5
"d:\IDEWORK\lvmen\src\licensedcode\data\rules\cc-by-nc-3.0_3.yml", "YAML", 0, 0, 0, 5, 0, 0, 1, 6
"d:\IDEWORK\lvmen\src\licensedcode\data\rules\cc-by-nc-3.0_4.yml", "YAML", 0, 0, 0, 5, 0, 0, 1, 6
"d:\IDEWORK\lvmen\src\licensedcode\data\rules\cc-by-nc-3.0_5.yml", "YAML", 0, 0, 0, 4, 0, 0, 1, 5
"d:\IDEWORK\lvmen\src\licensedcode\data\rules\cc-by-nc-3.0_6.yml", "YAML", 0, 0, 0, 3, 0, 0, 1, 4
"d:\IDEWORK\lvmen\src\licensedcode\data\rules\cc-by-nc-3.0_7.yml", "YAML", 0, 0, 0, 3, 0, 0, 1, 4
"d:\IDEWORK\lvmen\src\licensedcode\data\rules\cc-by-nc-3.0_8.yml", "YAML", 0, 0, 0, 3, 0, 0, 1, 4
"d:\IDEWORK\lvmen\src\licensedcode\data\rules\cc-by-nc-3.0_9.yml", "YAML", 0, 0, 0, 3, 0, 0, 1, 4
"d:\IDEWORK\lvmen\src\licensedcode\data\rules\cc-by-nc-3.0_licensebutton.yml", "YAML", 0, 0, 0, 5, 0, 0, 1, 6
"d:\IDEWORK\lvmen\src\licensedcode\data\rules\cc-by-nc-3.0_url_1.yml", "YAML", 0, 0, 0, 5, 0, 0, 1, 6
"d:\IDEWORK\lvmen\src\licensedcode\data\rules\cc-by-nc-3.0_url_2.yml", "YAML", 0, 0, 0, 5, 0, 0, 1, 6
"d:\IDEWORK\lvmen\src\licensedcode\data\rules\cc-by-nc-3.0_url_glc_27.yml", "YAML", 0, 0, 0, 5, 0, 0, 1, 6
"d:\IDEWORK\lvmen\src\licensedcode\data\rules\cc-by-nc-4.0.SPDX.yml", "YAML", 0, 0, 0, 4, 0, 0, 1, 5
"d:\IDEWORK\lvmen\src\licensedcode\data\rules\cc-by-nc-4.0.yml", "YAML", 0, 0, 0, 2, 0, 0, 1, 3
"d:\IDEWORK\lvmen\src\licensedcode\data\rules\cc-by-nc-4.0_1.yml", "YAML", 0, 0, 0, 2, 0, 0, 1, 3
"d:\IDEWORK\lvmen\src\licensedcode\data\rules\cc-by-nc-4.0_10.yml", "YAML", 0, 0, 0, 3, 0, 0, 1, 4
"d:\IDEWORK\lvmen\src\licensedcode\data\rules\cc-by-nc-4.0_11.yml", "YAML", 0, 0, 0, 3, 0, 0, 1, 4
"d:\IDEWORK\lvmen\src\licensedcode\data\rules\cc-by-nc-4.0_12.yml", "YAML", 0, 0, 0, 3, 0, 0, 1, 4
"d:\IDEWORK\lvmen\src\licensedcode\data\rules\cc-by-nc-4.0_13.yml", "YAML", 0, 0, 0, 3, 0, 0, 1, 4
"d:\IDEWORK\lvmen\src\licensedcode\data\rules\cc-by-nc-4.0_14.yml", "YAML", 0, 0, 0, 3, 0, 0, 1, 4
"d:\IDEWORK\lvmen\src\licensedcode\data\rules\cc-by-nc-4.0_15.yml", "YAML", 0, 0, 0, 3, 0, 0, 1, 4
"d:\IDEWORK\lvmen\src\licensedcode\data\rules\cc-by-nc-4.0_16.yml", "YAML", 0, 0, 0, 3, 0, 0, 1, 4
"d:\IDEWORK\lvmen\src\licensedcode\data\rules\cc-by-nc-4.0_17.yml", "YAML", 0, 0, 0, 3, 0, 0, 1, 4
"d:\IDEWORK\lvmen\src\licensedcode\data\rules\cc-by-nc-4.0_18.yml", "YAML", 0, 0, 0, 5, 0, 0, 1, 6
"d:\IDEWORK\lvmen\src\licensedcode\data\rules\cc-by-nc-4.0_19.yml", "YAML", 0, 0, 0, 5, 0, 0, 1, 6
"d:\IDEWORK\lvmen\src\licensedcode\data\rules\cc-by-nc-4.0_2.yml", "YAML", 0, 0, 0, 5, 0, 0, 1, 6
"d:\IDEWORK\lvmen\src\licensedcode\data\rules\cc-by-nc-4.0_20.yml", "YAML", 0, 0, 0, 5, 0, 0, 1, 6
"d:\IDEWORK\lvmen\src\licensedcode\data\rules\cc-by-nc-4.0_21.yml", "YAML", 0, 0, 0, 5, 0, 0, 1, 6
"d:\IDEWORK\lvmen\src\licensedcode\data\rules\cc-by-nc-4.0_22.yml", "YAML", 0, 0, 0, 3, 0, 0, 1, 4
"d:\IDEWORK\lvmen\src\licensedcode\data\rules\cc-by-nc-4.0_23.yml", "YAML", 0, 0, 0, 2, 0, 0, 1, 3
"d:\IDEWORK\lvmen\src\licensedcode\data\rules\cc-by-nc-4.0_3.yml", "YAML", 0, 0, 0, 3, 0, 0, 1, 4
"d:\IDEWORK\lvmen\src\licensedcode\data\rules\cc-by-nc-4.0_4.yml", "YAML", 0, 0, 0, 5, 0, 0, 1, 6
"d:\IDEWORK\lvmen\src\licensedcode\data\rules\cc-by-nc-4.0_5.yml", "YAML", 0, 0, 0, 5, 0, 0, 1, 6
"d:\IDEWORK\lvmen\src\licensedcode\data\rules\cc-by-nc-4.0_6.yml", "YAML", 0, 0, 0, 5, 0, 0, 1, 6
"d:\IDEWORK\lvmen\src\licensedcode\data\rules\cc-by-nc-4.0_7.yml", "YAML", 0, 0, 0, 3, 0, 0, 1, 4
"d:\IDEWORK\lvmen\src\licensedcode\data\rules\cc-by-nc-4.0_8.yml", "YAML", 0, 0, 0, 3, 0, 0, 1, 4
"d:\IDEWORK\lvmen\src\licensedcode\data\rules\cc-by-nc-4.0_9.yml", "YAML", 0, 0, 0, 3, 0, 0, 1, 4
"d:\IDEWORK\lvmen\src\licensedcode\data\rules\cc-by-nc-4.0_licensebutton.yml", "YAML", 0, 0, 0, 5, 0, 0, 1, 6
"d:\IDEWORK\lvmen\src\licensedcode\data\rules\cc-by-nc-4.0_url_1.yml", "YAML", 0, 0, 0, 5, 0, 0, 1, 6
"d:\IDEWORK\lvmen\src\licensedcode\data\rules\cc-by-nc-4.0_url_2.yml", "YAML", 0, 0, 0, 5, 0, 0, 1, 6
"d:\IDEWORK\lvmen\src\licensedcode\data\rules\cc-by-nc-4.0_url_badge.yml", "YAML", 0, 0, 0, 4, 0, 0, 1, 5
"d:\IDEWORK\lvmen\src\licensedcode\data\rules\cc-by-nc-4.0_url_badge_1.yml", "YAML", 0, 0, 0, 5, 0, 0, 1, 6
"d:\IDEWORK\lvmen\src\licensedcode\data\rules\cc-by-nc-nd-1.0.yml", "YAML", 0, 0, 0, 5, 0, 0, 1, 6
"d:\IDEWORK\lvmen\src\licensedcode\data\rules\cc-by-nc-nd-1.0_1.yml", "YAML", 0, 0, 0, 5, 0, 0, 1, 6
"d:\IDEWORK\lvmen\src\licensedcode\data\rules\cc-by-nc-nd-1.0_10.yml", "YAML", 0, 0, 0, 3, 0, 0, 1, 4
"d:\IDEWORK\lvmen\src\licensedcode\data\rules\cc-by-nc-nd-1.0_11.yml", "YAML", 0, 0, 0, 3, 0, 0, 1, 4
"d:\IDEWORK\lvmen\src\licensedcode\data\rules\cc-by-nc-nd-1.0_12.yml", "YAML", 0, 0, 0, 3, 0, 0, 1, 4
"d:\IDEWORK\lvmen\src\licensedcode\data\rules\cc-by-nc-nd-1.0_13.yml", "YAML", 0, 0, 0, 3, 0, 0, 1, 4
"d:\IDEWORK\lvmen\src\licensedcode\data\rules\cc-by-nc-nd-1.0_14.yml", "YAML", 0, 0, 0, 3, 0, 0, 1, 4
"d:\IDEWORK\lvmen\src\licensedcode\data\rules\cc-by-nc-nd-1.0_15.yml", "YAML", 0, 0, 0, 3, 0, 0, 1, 4
"d:\IDEWORK\lvmen\src\licensedcode\data\rules\cc-by-nc-nd-1.0_16.yml", "YAML", 0, 0, 0, 3, 0, 0, 1, 4
"d:\IDEWORK\lvmen\src\licensedcode\data\rules\cc-by-nc-nd-1.0_17.yml", "YAML", 0, 0, 0, 3, 0, 0, 1, 4
"d:\IDEWORK\lvmen\src\licensedcode\data\rules\cc-by-nc-nd-1.0_18.yml", "YAML", 0, 0, 0, 3, 0, 0, 1, 4
"d:\IDEWORK\lvmen\src\licensedcode\data\rules\cc-by-nc-nd-1.0_19.yml", "YAML", 0, 0, 0, 3, 0, 0, 1, 4
"d:\IDEWORK\lvmen\src\licensedcode\data\rules\cc-by-nc-nd-1.0_2.yml", "YAML", 0, 0, 0, 3, 0, 0, 1, 4
"d:\IDEWORK\lvmen\src\licensedcode\data\rules\cc-by-nc-nd-1.0_20.yml", "YAML", 0, 0, 0, 3, 0, 0, 1, 4
"d:\IDEWORK\lvmen\src\licensedcode\data\rules\cc-by-nc-nd-1.0_21.yml", "YAML", 0, 0, 0, 3, 0, 0, 1, 4
"d:\IDEWORK\lvmen\src\licensedcode\data\rules\cc-by-nc-nd-1.0_22.yml", "YAML", 0, 0, 0, 3, 0, 0, 1, 4
"d:\IDEWORK\lvmen\src\licensedcode\data\rules\cc-by-nc-nd-1.0_23.yml", "YAML", 0, 0, 0, 3, 0, 0, 1, 4
"d:\IDEWORK\lvmen\src\licensedcode\data\rules\cc-by-nc-nd-1.0_24.yml", "YAML", 0, 0, 0, 3, 0, 0, 1, 4
"d:\IDEWORK\lvmen\src\licensedcode\data\rules\cc-by-nc-nd-1.0_25.yml", "YAML", 0, 0, 0, 3, 0, 0, 1, 4
"d:\IDEWORK\lvmen\src\licensedcode\data\rules\cc-by-nc-nd-1.0_26.yml", "YAML", 0, 0, 0, 3, 0, 0, 1, 4
"d:\IDEWORK\lvmen\src\licensedcode\data\rules\cc-by-nc-nd-1.0_27.yml", "YAML", 0, 0, 0, 3, 0, 0, 1, 4
"d:\IDEWORK\lvmen\src\licensedcode\data\rules\cc-by-nc-nd-1.0_28.yml", "YAML", 0, 0, 0, 3, 0, 0, 1, 4
"d:\IDEWORK\lvmen\src\licensedcode\data\rules\cc-by-nc-nd-1.0_29.yml", "YAML", 0, 0, 0, 3, 0, 0, 1, 4
"d:\IDEWORK\lvmen\src\licensedcode\data\rules\cc-by-nc-nd-1.0_3.yml", "YAML", 0, 0, 0, 3, 0, 0, 1, 4
"d:\IDEWORK\lvmen\src\licensedcode\data\rules\cc-by-nc-nd-1.0_30.yml", "YAML", 0, 0, 0, 3, 0, 0, 1, 4
"d:\IDEWORK\lvmen\src\licensedcode\data\rules\cc-by-nc-nd-1.0_31.yml", "YAML", 0, 0, 0, 3, 0, 0, 1, 4
"d:\IDEWORK\lvmen\src\licensedcode\data\rules\cc-by-nc-nd-1.0_32.yml", "YAML", 0, 0, 0, 3, 0, 0, 1, 4
"d:\IDEWORK\lvmen\src\licensedcode\data\rules\cc-by-nc-nd-1.0_33.yml", "YAML", 0, 0, 0, 3, 0, 0, 1, 4
"d:\IDEWORK\lvmen\src\licensedcode\data\rules\cc-by-nc-nd-1.0_34.yml", "YAML", 0, 0, 0, 3, 0, 0, 1, 4
"d:\IDEWORK\lvmen\src\licensedcode\data\rules\cc-by-nc-nd-1.0_35.yml", "YAML", 0, 0, 0, 3, 0, 0, 1, 4
"d:\IDEWORK\lvmen\src\licensedcode\data\rules\cc-by-nc-nd-1.0_36.yml", "YAML", 0, 0, 0, 3, 0, 0, 1, 4
"d:\IDEWORK\lvmen\src\licensedcode\data\rules\cc-by-nc-nd-1.0_37.yml", "YAML", 0, 0, 0, 3, 0, 0, 1, 4
"d:\IDEWORK\lvmen\src\licensedcode\data\rules\cc-by-nc-nd-1.0_38.yml", "YAML", 0, 0, 0, 3, 0, 0, 1, 4
"d:\IDEWORK\lvmen\src\licensedcode\data\rules\cc-by-nc-nd-1.0_39.yml", "YAML", 0, 0, 0, 3, 0, 0, 1, 4
"d:\IDEWORK\lvmen\src\licensedcode\data\rules\cc-by-nc-nd-1.0_4.yml", "YAML", 0, 0, 0, 3, 0, 0, 1, 4
"d:\IDEWORK\lvmen\src\licensedcode\data\rules\cc-by-nc-nd-1.0_40.yml", "YAML", 0, 0, 0, 3, 0, 0, 1, 4
"d:\IDEWORK\lvmen\src\licensedcode\data\rules\cc-by-nc-nd-1.0_41.yml", "YAML", 0, 0, 0, 3, 0, 0, 1, 4
"d:\IDEWORK\lvmen\src\licensedcode\data\rules\cc-by-nc-nd-1.0_42.yml", "YAML", 0, 0, 0, 3, 0, 0, 1, 4
"d:\IDEWORK\lvmen\src\licensedcode\data\rules\cc-by-nc-nd-1.0_43.yml", "YAML", 0, 0, 0, 3, 0, 0, 1, 4
"d:\IDEWORK\lvmen\src\licensedcode\data\rules\cc-by-nc-nd-1.0_44.yml", "YAML", 0, 0, 0, 3, 0, 0, 1, 4
"d:\IDEWORK\lvmen\src\licensedcode\data\rules\cc-by-nc-nd-1.0_45.yml", "YAML", 0, 0, 0, 3, 0, 0, 1, 4
"d:\IDEWORK\lvmen\src\licensedcode\data\rules\cc-by-nc-nd-1.0_46.yml", "YAML", 0, 0, 0, 3, 0, 0, 1, 4
"d:\IDEWORK\lvmen\src\licensedcode\data\rules\cc-by-nc-nd-1.0_47.yml", "YAML", 0, 0, 0, 3, 0, 0, 1, 4
"d:\IDEWORK\lvmen\src\licensedcode\data\rules\cc-by-nc-nd-1.0_48.yml", "YAML", 0, 0, 0, 3, 0, 0, 1, 4
"d:\IDEWORK\lvmen\src\licensedcode\data\rules\cc-by-nc-nd-1.0_49.yml", "YAML", 0, 0, 0, 3, 0, 0, 1, 4
"d:\IDEWORK\lvmen\src\licensedcode\data\rules\cc-by-nc-nd-1.0_5.yml", "YAML", 0, 0, 0, 3, 0, 0, 1, 4
"d:\IDEWORK\lvmen\src\licensedcode\data\rules\cc-by-nc-nd-1.0_50.yml", "YAML", 0, 0, 0, 3, 0, 0, 1, 4
"d:\IDEWORK\lvmen\src\licensedcode\data\rules\cc-by-nc-nd-1.0_51.yml", "YAML", 0, 0, 0, 5, 0, 0, 1, 6
"d:\IDEWORK\lvmen\src\licensedcode\data\rules\cc-by-nc-nd-1.0_52.yml", "YAML", 0, 0, 0, 5, 0, 0, 1, 6
"d:\IDEWORK\lvmen\src\licensedcode\data\rules\cc-by-nc-nd-1.0_53.yml", "YAML", 0, 0, 0, 5, 0, 0, 1, 6
"d:\IDEWORK\lvmen\src\licensedcode\data\rules\cc-by-nc-nd-1.0_54.yml", "YAML", 0, 0, 0, 5, 0, 0, 1, 6
"d:\IDEWORK\lvmen\src\licensedcode\data\rules\cc-by-nc-nd-1.0_55.yml", "YAML", 0, 0, 0, 5, 0, 0, 1, 6
"d:\IDEWORK\lvmen\src\licensedcode\data\rules\cc-by-nc-nd-1.0_56.yml", "YAML", 0, 0, 0, 5, 0, 0, 1, 6
"d:\IDEWORK\lvmen\src\licensedcode\data\rules\cc-by-nc-nd-1.0_57.yml", "YAML", 0, 0, 0, 4, 0, 0, 1, 5
"d:\IDEWORK\lvmen\src\licensedcode\data\rules\cc-by-nc-nd-1.0_6.yml", "YAML", 0, 0, 0, 3, 0, 0, 1, 4
"d:\IDEWORK\lvmen\src\licensedcode\data\rules\cc-by-nc-nd-1.0_7.yml", "YAML", 0, 0, 0, 3, 0, 0, 1, 4
"d:\IDEWORK\lvmen\src\licensedcode\data\rules\cc-by-nc-nd-1.0_8.yml", "YAML", 0, 0, 0, 3, 0, 0, 1, 4
"d:\IDEWORK\lvmen\src\licensedcode\data\rules\cc-by-nc-nd-1.0_9.yml", "YAML", 0, 0, 0, 3, 0, 0, 1, 4
"d:\IDEWORK\lvmen\src\licensedcode\data\rules\cc-by-nc-nd-1.0_license_button.yml", "YAML", 0, 0, 0, 5, 0, 0, 1, 6
"d:\IDEWORK\lvmen\src\licensedcode\data\rules\cc-by-nc-nd-1.0_license_button_1.yml", "YAML", 0, 0, 0, 5, 0, 0, 1, 6
"d:\IDEWORK\lvmen\src\licensedcode\data\rules\cc-by-nc-nd-1.0_url_1.yml", "YAML", 0, 0, 0, 5, 0, 0, 1, 6
"d:\IDEWORK\lvmen\src\licensedcode\data\rules\cc-by-nc-nd-1.0_url_2.yml", "YAML", 0, 0, 0, 5, 0, 0, 1, 6
"d:\IDEWORK\lvmen\src\licensedcode\data\rules\cc-by-nc-nd-1.0_url_glc_31.yml", "YAML", 0, 0, 0, 5, 0, 0, 1, 6
"d:\IDEWORK\lvmen\src\licensedcode\data\rules\cc-by-nc-nd-2.0-au.yml", "YAML", 0, 0, 0, 5, 0, 0, 1, 6
"d:\IDEWORK\lvmen\src\licensedcode\data\rules\cc-by-nc-nd-2.0.SPDX.yml", "YAML", 0, 0, 0, 6, 0, 0, 1, 7
"d:\IDEWORK\lvmen\src\licensedcode\data\rules\cc-by-nc-nd-2.0.yml", "YAML", 0, 0, 0, 5, 0, 0, 1, 6
"d:\IDEWORK\lvmen\src\licensedcode\data\rules\cc-by-nc-nd-2.0_1.yml", "YAML", 0, 0, 0, 5, 0, 0, 1, 6
"d:\IDEWORK\lvmen\src\licensedcode\data\rules\cc-by-nc-nd-2.0_10.yml", "YAML", 0, 0, 0, 3, 0, 0, 1, 4
"d:\IDEWORK\lvmen\src\licensedcode\data\rules\cc-by-nc-nd-2.0_11.yml", "YAML", 0, 0, 0, 3, 0, 0, 1, 4
"d:\IDEWORK\lvmen\src\licensedcode\data\rules\cc-by-nc-nd-2.0_12.yml", "YAML", 0, 0, 0, 3, 0, 0, 1, 4
"d:\IDEWORK\lvmen\src\licensedcode\data\rules\cc-by-nc-nd-2.0_13.yml", "YAML", 0, 0, 0, 3, 0, 0, 1, 4
"d:\IDEWORK\lvmen\src\licensedcode\data\rules\cc-by-nc-nd-2.0_14.yml", "YAML", 0, 0, 0, 3, 0, 0, 1, 4
"d:\IDEWORK\lvmen\src\licensedcode\data\rules\cc-by-nc-nd-2.0_15.yml", "YAML", 0, 0, 0, 3, 0, 0, 1, 4
"d:\IDEWORK\lvmen\src\licensedcode\data\rules\cc-by-nc-nd-2.0_16.yml", "YAML", 0, 0, 0, 5, 0, 0, 1, 6
"d:\IDEWORK\lvmen\src\licensedcode\data\rules\cc-by-nc-nd-2.0_17.yml", "YAML", 0, 0, 0, 5, 0, 0, 1, 6
"d:\IDEWORK\lvmen\src\licensedcode\data\rules\cc-by-nc-nd-2.0_18.yml", "YAML", 0, 0, 0, 5, 0, 0, 1, 6
"d:\IDEWORK\lvmen\src\licensedcode\data\rules\cc-by-nc-nd-2.0_19.yml", "YAML", 0, 0, 0, 5, 0, 0, 1, 6
"d:\IDEWORK\lvmen\src\licensedcode\data\rules\cc-by-nc-nd-2.0_2.yml", "YAML", 0, 0, 0, 4, 0, 0, 1, 5
"d:\IDEWORK\lvmen\src\licensedcode\data\rules\cc-by-nc-nd-2.0_20.yml", "YAML", 0, 0, 0, 5, 0, 0, 1, 6
"d:\IDEWORK\lvmen\src\licensedcode\data\rules\cc-by-nc-nd-2.0_21.yml", "YAML", 0, 0, 0, 5, 0, 0, 1, 6
"d:\IDEWORK\lvmen\src\licensedcode\data\rules\cc-by-nc-nd-2.0_22.yml", "YAML", 0, 0, 0, 4, 0, 0, 1, 5
"d:\IDEWORK\lvmen\src\licensedcode\data\rules\cc-by-nc-nd-2.0_3.yml", "YAML", 0, 0, 0, 3, 0, 0, 1, 4
"d:\IDEWORK\lvmen\src\licensedcode\data\rules\cc-by-nc-nd-2.0_4.yml", "YAML", 0, 0, 0, 3, 0, 0, 1, 4
"d:\IDEWORK\lvmen\src\licensedcode\data\rules\cc-by-nc-nd-2.0_5.yml", "YAML", 0, 0, 0, 3, 0, 0, 1, 4
"d:\IDEWORK\lvmen\src\licensedcode\data\rules\cc-by-nc-nd-2.0_6.yml", "YAML", 0, 0, 0, 3, 0, 0, 1, 4
"d:\IDEWORK\lvmen\src\licensedcode\data\rules\cc-by-nc-nd-2.0_7.yml", "YAML", 0, 0, 0, 3, 0, 0, 1, 4
"d:\IDEWORK\lvmen\src\licensedcode\data\rules\cc-by-nc-nd-2.0_8.yml", "YAML", 0, 0, 0, 3, 0, 0, 1, 4
"d:\IDEWORK\lvmen\src\licensedcode\data\rules\cc-by-nc-nd-2.0_9.yml", "YAML", 0, 0, 0, 3, 0, 0, 1, 4
"d:\IDEWORK\lvmen\src\licensedcode\data\rules\cc-by-nc-nd-2.0_license_button.yml", "YAML", 0, 0, 0, 5, 0, 0, 1, 6
"d:\IDEWORK\lvmen\src\licensedcode\data\rules\cc-by-nc-nd-2.0_license_button_1.yml", "YAML", 0, 0, 0, 5, 0, 0, 1, 6
"d:\IDEWORK\lvmen\src\licensedcode\data\rules\cc-by-nc-nd-2.0_license_button_2.yml", "YAML", 0, 0, 0, 5, 0, 0, 1, 6
"d:\IDEWORK\lvmen\src\licensedcode\data\rules\cc-by-nc-nd-2.0_licensebutton.yml", "YAML", 0, 0, 0, 5, 0, 0, 1, 6
"d:\IDEWORK\lvmen\src\licensedcode\data\rules\cc-by-nc-nd-2.0_url_1.yml", "YAML", 0, 0, 0, 5, 0, 0, 1, 6
"d:\IDEWORK\lvmen\src\licensedcode\data\rules\cc-by-nc-nd-2.0_url_2.yml", "YAML", 0, 0, 0, 5, 0, 0, 1, 6
"d:\IDEWORK\lvmen\src\licensedcode\data\rules\cc-by-nc-nd-2.0_url_glc_1.yml", "YAML", 0, 0, 0, 5, 0, 0, 1, 6
"d:\IDEWORK\lvmen\src\licensedcode\data\rules\cc-by-nc-nd-2.0_url_glc_2.yml", "YAML", 0, 0, 0, 5, 0, 0, 1, 6
"d:\IDEWORK\lvmen\src\licensedcode\data\rules\cc-by-nc-nd-2.0_url_glc_3.yml", "YAML", 0, 0, 0, 5, 0, 0, 1, 6
"d:\IDEWORK\lvmen\src\licensedcode\data\rules\cc-by-nc-nd-2.5.SPDX.yml", "YAML", 0, 0, 0, 6, 0, 0, 1, 7
"d:\IDEWORK\lvmen\src\licensedcode\data\rules\cc-by-nc-nd-2.5.yml", "YAML", 0, 0, 0, 5, 0, 0, 1, 6
"d:\IDEWORK\lvmen\src\licensedcode\data\rules\cc-by-nc-nd-2.5_1.yml", "YAML", 0, 0, 0, 5, 0, 0, 1, 6
"d:\IDEWORK\lvmen\src\licensedcode\data\rules\cc-by-nc-nd-2.5_10.yml", "YAML", 0, 0, 0, 3, 0, 0, 1, 4
"d:\IDEWORK\lvmen\src\licensedcode\data\rules\cc-by-nc-nd-2.5_11.yml", "YAML", 0, 0, 0, 3, 0, 0, 1, 4
"d:\IDEWORK\lvmen\src\licensedcode\data\rules\cc-by-nc-nd-2.5_12.yml", "YAML", 0, 0, 0, 3, 0, 0, 1, 4
"d:\IDEWORK\lvmen\src\licensedcode\data\rules\cc-by-nc-nd-2.5_13.yml", "YAML", 0, 0, 0, 3, 0, 0, 1, 4
"d:\IDEWORK\lvmen\src\licensedcode\data\rules\cc-by-nc-nd-2.5_14.yml", "YAML", 0, 0, 0, 3, 0, 0, 1, 4
"d:\IDEWORK\lvmen\src\licensedcode\data\rules\cc-by-nc-nd-2.5_15.yml", "YAML", 0, 0, 0, 5, 0, 0, 1, 6
"d:\IDEWORK\lvmen\src\licensedcode\data\rules\cc-by-nc-nd-2.5_16.yml", "YAML", 0, 0, 0, 4, 0, 0, 1, 5
"d:\IDEWORK\lvmen\src\licensedcode\data\rules\cc-by-nc-nd-2.5_2.yml", "YAML", 0, 0, 0, 3, 0, 0, 1, 4
"d:\IDEWORK\lvmen\src\licensedcode\data\rules\cc-by-nc-nd-2.5_3.yml", "YAML", 0, 0, 0, 3, 0, 0, 1, 4
"d:\IDEWORK\lvmen\src\licensedcode\data\rules\cc-by-nc-nd-2.5_4.yml", "YAML", 0, 0, 0, 3, 0, 0, 1, 4
"d:\IDEWORK\lvmen\src\licensedcode\data\rules\cc-by-nc-nd-2.5_5.yml", "YAML", 0, 0, 0, 3, 0, 0, 1, 4
"d:\IDEWORK\lvmen\src\licensedcode\data\rules\cc-by-nc-nd-2.5_6.yml", "YAML", 0, 0, 0, 3, 0, 0, 1, 4
"d:\IDEWORK\lvmen\src\licensedcode\data\rules\cc-by-nc-nd-2.5_7.yml", "YAML", 0, 0, 0, 3, 0, 0, 1, 4
"d:\IDEWORK\lvmen\src\licensedcode\data\rules\cc-by-nc-nd-2.5_8.yml", "YAML", 0, 0, 0, 3, 0, 0, 1, 4
"d:\IDEWORK\lvmen\src\licensedcode\data\rules\cc-by-nc-nd-2.5_9.yml", "YAML", 0, 0, 0, 3, 0, 0, 1, 4
"d:\IDEWORK\lvmen\src\licensedcode\data\rules\cc-by-nc-nd-2.5_licensebutton.yml", "YAML", 0, 0, 0, 5, 0, 0, 1, 6
"d:\IDEWORK\lvmen\src\licensedcode\data\rules\cc-by-nc-nd-2.5_url_1.yml", "YAML", 0, 0, 0, 5, 0, 0, 1, 6
"d:\IDEWORK\lvmen\src\licensedcode\data\rules\cc-by-nc-nd-2.5_url_2.yml", "YAML", 0, 0, 0, 5, 0, 0, 1, 6
"d:\IDEWORK\lvmen\src\licensedcode\data\rules\cc-by-nc-nd-2.5_url_glc_5.yml", "YAML", 0, 0, 0, 5, 0, 0, 1, 6
"d:\IDEWORK\lvmen\src\licensedcode\data\rules\cc-by-nc-nd-3.0-igo_1.yml", "YAML", 0, 0, 0, 3, 0, 0, 1, 4
"d:\IDEWORK\lvmen\src\licensedcode\data\rules\cc-by-nc-nd-3.0-igo_10.yml", "YAML", 0, 0, 0, 3, 0, 0, 1, 4
"d:\IDEWORK\lvmen\src\licensedcode\data\rules\cc-by-nc-nd-3.0-igo_11.yml", "YAML", 0, 0, 0, 3, 0, 0, 1, 4
"d:\IDEWORK\lvmen\src\licensedcode\data\rules\cc-by-nc-nd-3.0-igo_12.yml", "YAML", 0, 0, 0, 3, 0, 0, 1, 4
"d:\IDEWORK\lvmen\src\licensedcode\data\rules\cc-by-nc-nd-3.0-igo_13.yml", "YAML", 0, 0, 0, 3, 0, 0, 1, 4
"d:\IDEWORK\lvmen\src\licensedcode\data\rules\cc-by-nc-nd-3.0-igo_14.yml", "YAML", 0, 0, 0, 3, 0, 0, 1, 4
"d:\IDEWORK\lvmen\src\licensedcode\data\rules\cc-by-nc-nd-3.0-igo_15.yml", "YAML", 0, 0, 0, 3, 0, 0, 1, 4
"d:\IDEWORK\lvmen\src\licensedcode\data\rules\cc-by-nc-nd-3.0-igo_16.yml", "YAML", 0, 0, 0, 3, 0, 0, 1, 4
"d:\IDEWORK\lvmen\src\licensedcode\data\rules\cc-by-nc-nd-3.0-igo_17.yml", "YAML", 0, 0, 0, 5, 0, 0, 1, 6
"d:\IDEWORK\lvmen\src\licensedcode\data\rules\cc-by-nc-nd-3.0-igo_18.yml", "YAML", 0, 0, 0, 5, 0, 0, 1, 6
"d:\IDEWORK\lvmen\src\licensedcode\data\rules\cc-by-nc-nd-3.0-igo_19.yml", "YAML", 0, 0, 0, 5, 0, 0, 1, 6
"d:\IDEWORK\lvmen\src\licensedcode\data\rules\cc-by-nc-nd-3.0-igo_2.yml", "YAML", 0, 0, 0, 3, 0, 0, 1, 4
"d:\IDEWORK\lvmen\src\licensedcode\data\rules\cc-by-nc-nd-3.0-igo_20.yml", "YAML", 0, 0, 0, 5, 0, 0, 1, 6
"d:\IDEWORK\lvmen\src\licensedcode\data\rules\cc-by-nc-nd-3.0-igo_21.yml", "YAML", 0, 0, 0, 5, 0, 0, 1, 6
"d:\IDEWORK\lvmen\src\licensedcode\data\rules\cc-by-nc-nd-3.0-igo_3.yml", "YAML", 0, 0, 0, 3, 0, 0, 1, 4
"d:\IDEWORK\lvmen\src\licensedcode\data\rules\cc-by-nc-nd-3.0-igo_4.yml", "YAML", 0, 0, 0, 3, 0, 0, 1, 4
"d:\IDEWORK\lvmen\src\licensedcode\data\rules\cc-by-nc-nd-3.0-igo_5.yml", "YAML", 0, 0, 0, 3, 0, 0, 1, 4
"d:\IDEWORK\lvmen\src\licensedcode\data\rules\cc-by-nc-nd-3.0-igo_6.yml", "YAML", 0, 0, 0, 3, 0, 0, 1, 4
"d:\IDEWORK\lvmen\src\licensedcode\data\rules\cc-by-nc-nd-3.0-igo_7.yml", "YAML", 0, 0, 0, 3, 0, 0, 1, 4
"d:\IDEWORK\lvmen\src\licensedcode\data\rules\cc-by-nc-nd-3.0-igo_8.yml", "YAML", 0, 0, 0, 3, 0, 0, 1, 4
"d:\IDEWORK\lvmen\src\licensedcode\data\rules\cc-by-nc-nd-3.0-igo_9.yml", "YAML", 0, 0, 0, 3, 0, 0, 1, 4
"d:\IDEWORK\lvmen\src\licensedcode\data\rules\cc-by-nc-nd-3.0.SPDX.yml", "YAML", 0, 0, 0, 6, 0, 0, 1, 7
"d:\IDEWORK\lvmen\src\licensedcode\data\rules\cc-by-nc-nd-3.0.yml", "YAML", 0, 0, 0, 5, 0, 0, 1, 6
"d:\IDEWORK\lvmen\src\licensedcode\data\rules\cc-by-nc-nd-3.0_1.yml", "YAML", 0, 0, 0, 5, 0, 0, 1, 6
"d:\IDEWORK\lvmen\src\licensedcode\data\rules\cc-by-nc-nd-3.0_10.yml", "YAML", 0, 0, 0, 3, 0, 0, 1, 4
"d:\IDEWORK\lvmen\src\licensedcode\data\rules\cc-by-nc-nd-3.0_11.yml", "YAML", 0, 0, 0, 3, 0, 0, 1, 4
"d:\IDEWORK\lvmen\src\licensedcode\data\rules\cc-by-nc-nd-3.0_12.yml", "YAML", 0, 0, 0, 5, 0, 0, 1, 6
"d:\IDEWORK\lvmen\src\licensedcode\data\rules\cc-by-nc-nd-3.0_13.yml", "YAML", 0, 0, 0, 3, 0, 0, 1, 4
"d:\IDEWORK\lvmen\src\licensedcode\data\rules\cc-by-nc-nd-3.0_14.yml", "YAML", 0, 0, 0, 3, 0, 0, 1, 4
"d:\IDEWORK\lvmen\src\licensedcode\data\rules\cc-by-nc-nd-3.0_15.yml", "YAML", 0, 0, 0, 3, 0, 0, 1, 4
"d:\IDEWORK\lvmen\src\licensedcode\data\rules\cc-by-nc-nd-3.0_16.yml", "YAML", 0, 0, 0, 5, 0, 0, 1, 6
"d:\IDEWORK\lvmen\src\licensedcode\data\rules\cc-by-nc-nd-3.0_17.yml", "YAML", 0, 0, 0, 5, 0, 0, 1, 6
"d:\IDEWORK\lvmen\src\licensedcode\data\rules\cc-by-nc-nd-3.0_18.yml", "YAML", 0, 0, 0, 5, 0, 0, 1, 6
"d:\IDEWORK\lvmen\src\licensedcode\data\rules\cc-by-nc-nd-3.0_19.yml", "YAML", 0, 0, 0, 3, 0, 0, 1, 4
"d:\IDEWORK\lvmen\src\licensedcode\data\rules\cc-by-nc-nd-3.0_2.yml", "YAML", 0, 0, 0, 4, 0, 0, 1, 5
"d:\IDEWORK\lvmen\src\licensedcode\data\rules\cc-by-nc-nd-3.0_20.yml", "YAML", 0, 0, 0, 3, 0, 0, 1, 4
"d:\IDEWORK\lvmen\src\licensedcode\data\rules\cc-by-nc-nd-3.0_21.yml", "YAML", 0, 0, 0, 3, 0, 0, 1, 4
"d:\IDEWORK\lvmen\src\licensedcode\data\rules\cc-by-nc-nd-3.0_22.yml", "YAML", 0, 0, 0, 3, 0, 0, 1, 4
"d:\IDEWORK\lvmen\src\licensedcode\data\rules\cc-by-nc-nd-3.0_23.yml", "YAML", 0, 0, 0, 3, 0, 0, 1, 4
"d:\IDEWORK\lvmen\src\licensedcode\data\rules\cc-by-nc-nd-3.0_24.yml", "YAML", 0, 0, 0, 3, 0, 0, 1, 4
"d:\IDEWORK\lvmen\src\licensedcode\data\rules\cc-by-nc-nd-3.0_25.yml", "YAML", 0, 0, 0, 3, 0, 0, 1, 4
"d:\IDEWORK\lvmen\src\licensedcode\data\rules\cc-by-nc-nd-3.0_26.yml", "YAML", 0, 0, 0, 3, 0, 0, 1, 4
"d:\IDEWORK\lvmen\src\licensedcode\data\rules\cc-by-nc-nd-3.0_27.yml", "YAML", 0, 0, 0, 3, 0, 0, 1, 4
"d:\IDEWORK\lvmen\src\licensedcode\data\rules\cc-by-nc-nd-3.0_28.yml", "YAML", 0, 0, 0, 3, 0, 0, 1, 4
"d:\IDEWORK\lvmen\src\licensedcode\data\rules\cc-by-nc-nd-3.0_29.yml", "YAML", 0, 0, 0, 3, 0, 0, 1, 4
"d:\IDEWORK\lvmen\src\licensedcode\data\rules\cc-by-nc-nd-3.0_3.yml", "YAML", 0, 0, 0, 3, 0, 0, 1, 4
"d:\IDEWORK\lvmen\src\licensedcode\data\rules\cc-by-nc-nd-3.0_30.yml", "YAML", 0, 0, 0, 3, 0, 0, 1, 4
"d:\IDEWORK\lvmen\src\licensedcode\data\rules\cc-by-nc-nd-3.0_31.yml", "YAML", 0, 0, 0, 5, 0, 0, 1, 6
"d:\IDEWORK\lvmen\src\licensedcode\data\rules\cc-by-nc-nd-3.0_32.yml", "YAML", 0, 0, 0, 5, 0, 0, 1, 6
"d:\IDEWORK\lvmen\src\licensedcode\data\rules\cc-by-nc-nd-3.0_33.yml", "YAML", 0, 0, 0, 5, 0, 0, 1, 6
"d:\IDEWORK\lvmen\src\licensedcode\data\rules\cc-by-nc-nd-3.0_34.yml", "YAML", 0, 0, 0, 4, 0, 0, 1, 5
"d:\IDEWORK\lvmen\src\licensedcode\data\rules\cc-by-nc-nd-3.0_4.yml", "YAML", 0, 0, 0, 3, 0, 0, 1, 4
"d:\IDEWORK\lvmen\src\licensedcode\data\rules\cc-by-nc-nd-3.0_5.yml", "YAML", 0, 0, 0, 3, 0, 0, 1, 4
"d:\IDEWORK\lvmen\src\licensedcode\data\rules\cc-by-nc-nd-3.0_6.yml", "YAML", 0, 0, 0, 4, 0, 0, 1, 5
"d:\IDEWORK\lvmen\src\licensedcode\data\rules\cc-by-nc-nd-3.0_7.yml", "YAML", 0, 0, 0, 3, 0, 0, 1, 4
"d:\IDEWORK\lvmen\src\licensedcode\data\rules\cc-by-nc-nd-3.0_8.yml", "YAML", 0, 0, 0, 3, 0, 0, 1, 4
"d:\IDEWORK\lvmen\src\licensedcode\data\rules\cc-by-nc-nd-3.0_9.yml", "YAML", 0, 0, 0, 5, 0, 0, 1, 6
"d:\IDEWORK\lvmen\src\licensedcode\data\rules\cc-by-nc-nd-3.0_and_proprietary-license_1.yml", "YAML", 0, 0, 0, 3, 0, 0, 1, 4
"d:\IDEWORK\lvmen\src\licensedcode\data\rules\cc-by-nc-nd-3.0_and_proprietary-license_2.yml", "YAML", 0, 0, 0, 3, 0, 0, 1, 4
"d:\IDEWORK\lvmen\src\licensedcode\data\rules\cc-by-nc-nd-3.0_licensebutton.yml", "YAML", 0, 0, 0, 5, 0, 0, 1, 6
"d:\IDEWORK\lvmen\src\licensedcode\data\rules\cc-by-nc-nd-3.0_or_commercial-license.yml", "YAML", 0, 0, 0, 3, 0, 0, 1, 4
"d:\IDEWORK\lvmen\src\licensedcode\data\rules\cc-by-nc-nd-3.0_url_1.yml", "YAML", 0, 0, 0, 5, 0, 0, 1, 6
"d:\IDEWORK\lvmen\src\licensedcode\data\rules\cc-by-nc-nd-3.0_url_2.yml", "YAML", 0, 0, 0, 5, 0, 0, 1, 6
"d:\IDEWORK\lvmen\src\licensedcode\data\rules\cc-by-nc-nd-4.0.SPDX.yml", "YAML", 0, 0, 0, 4, 0, 0, 1, 5
"d:\IDEWORK\lvmen\src\licensedcode\data\rules\cc-by-nc-nd-4.0.yml", "YAML", 0, 0, 0, 2, 0, 0, 1, 3
"d:\IDEWORK\lvmen\src\licensedcode\data\rules\cc-by-nc-nd-4.0_1.yml", "YAML", 0, 0, 0, 3, 0, 0, 1, 4
"d:\IDEWORK\lvmen\src\licensedcode\data\rules\cc-by-nc-nd-4.0_10.yml", "YAML", 0, 0, 0, 2, 0, 0, 1, 3
"d:\IDEWORK\lvmen\src\licensedcode\data\rules\cc-by-nc-nd-4.0_11.yml", "YAML", 0, 0, 0, 5, 0, 0, 1, 6
"d:\IDEWORK\lvmen\src\licensedcode\data\rules\cc-by-nc-nd-4.0_12.yml", "YAML", 0, 0, 0, 5, 0, 0, 1, 6
"d:\IDEWORK\lvmen\src\licensedcode\data\rules\cc-by-nc-nd-4.0_13.yml", "YAML", 0, 0, 0, 3, 0, 0, 1, 4
"d:\IDEWORK\lvmen\src\licensedcode\data\rules\cc-by-nc-nd-4.0_14.yml", "YAML", 0, 0, 0, 3, 0, 0, 1, 4
"d:\IDEWORK\lvmen\src\licensedcode\data\rules\cc-by-nc-nd-4.0_15.yml", "YAML", 0, 0, 0, 3, 0, 0, 1, 4
"d:\IDEWORK\lvmen\src\licensedcode\data\rules\cc-by-nc-nd-4.0_16.yml", "YAML", 0, 0, 0, 3, 0, 0, 1, 4
"d:\IDEWORK\lvmen\src\licensedcode\data\rules\cc-by-nc-nd-4.0_17.yml", "YAML", 0, 0, 0, 5, 0, 0, 1, 6
"d:\IDEWORK\lvmen\src\licensedcode\data\rules\cc-by-nc-nd-4.0_18.yml", "YAML", 0, 0, 0, 5, 0, 0, 1, 6
"d:\IDEWORK\lvmen\src\licensedcode\data\rules\cc-by-nc-nd-4.0_19.yml", "YAML", 0, 0, 0, 5, 0, 0, 1, 6
"d:\IDEWORK\lvmen\src\licensedcode\data\rules\cc-by-nc-nd-4.0_2.yml", "YAML", 0, 0, 0, 3, 0, 0, 1, 4
"d:\IDEWORK\lvmen\src\licensedcode\data\rules\cc-by-nc-nd-4.0_20.yml", "YAML", 0, 0, 0, 5, 0, 0, 1, 6
"d:\IDEWORK\lvmen\src\licensedcode\data\rules\cc-by-nc-nd-4.0_21.yml", "YAML", 0, 0, 0, 5, 0, 0, 1, 6
"d:\IDEWORK\lvmen\src\licensedcode\data\rules\cc-by-nc-nd-4.0_22.yml", "YAML", 0, 0, 0, 3, 0, 0, 1, 4
"d:\IDEWORK\lvmen\src\licensedcode\data\rules\cc-by-nc-nd-4.0_23.yml", "YAML", 0, 0, 0, 3, 0, 0, 1, 4
"d:\IDEWORK\lvmen\src\licensedcode\data\rules\cc-by-nc-nd-4.0_24.yml", "YAML", 0, 0, 0, 3, 0, 0, 1, 4
"d:\IDEWORK\lvmen\src\licensedcode\data\rules\cc-by-nc-nd-4.0_25.yml", "YAML", 0, 0, 0, 5, 0, 0, 1, 6
"d:\IDEWORK\lvmen\src\licensedcode\data\rules\cc-by-nc-nd-4.0_26.yml", "YAML", 0, 0, 0, 5, 0, 0, 1, 6
"d:\IDEWORK\lvmen\src\licensedcode\data\rules\cc-by-nc-nd-4.0_27.yml", "YAML", 0, 0, 0, 3, 0, 0, 1, 4
"d:\IDEWORK\lvmen\src\licensedcode\data\rules\cc-by-nc-nd-4.0_28.yml", "YAML", 0, 0, 0, 5, 0, 0, 1, 6
"d:\IDEWORK\lvmen\src\licensedcode\data\rules\cc-by-nc-nd-4.0_29.yml", "YAML", 0, 0, 0, 3, 0, 0, 1, 4
"d:\IDEWORK\lvmen\src\licensedcode\data\rules\cc-by-nc-nd-4.0_3.yml", "YAML", 0, 0, 0, 3, 0, 0, 1, 4
"d:\IDEWORK\lvmen\src\licensedcode\data\rules\cc-by-nc-nd-4.0_30.yml", "YAML", 0, 0, 0, 3, 0, 0, 1, 4
"d:\IDEWORK\lvmen\src\licensedcode\data\rules\cc-by-nc-nd-4.0_31.yml", "YAML", 0, 0, 0, 3, 0, 0, 1, 4
"d:\IDEWORK\lvmen\src\licensedcode\data\rules\cc-by-nc-nd-4.0_32.yml", "YAML", 0, 0, 0, 3, 0, 0, 1, 4
"d:\IDEWORK\lvmen\src\licensedcode\data\rules\cc-by-nc-nd-4.0_33.yml", "YAML", 0, 0, 0, 3, 0, 0, 1, 4
"d:\IDEWORK\lvmen\src\licensedcode\data\rules\cc-by-nc-nd-4.0_34.yml", "YAML", 0, 0, 0, 3, 0, 0, 1, 4
"d:\IDEWORK\lvmen\src\licensedcode\data\rules\cc-by-nc-nd-4.0_35.yml", "YAML", 0, 0, 0, 3, 0, 0, 1, 4
"d:\IDEWORK\lvmen\src\licensedcode\data\rules\cc-by-nc-nd-4.0_36.yml", "YAML", 0, 0, 0, 3, 0, 0, 1, 4
"d:\IDEWORK\lvmen\src\licensedcode\data\rules\cc-by-nc-nd-4.0_37.yml", "YAML", 0, 0, 0, 3, 0, 0, 1, 4
"d:\IDEWORK\lvmen\src\licensedcode\data\rules\cc-by-nc-nd-4.0_38.yml", "YAML", 0, 0, 0, 3, 0, 0, 1, 4
"d:\IDEWORK\lvmen\src\licensedcode\data\rules\cc-by-nc-nd-4.0_39.yml", "YAML", 0, 0, 0, 3, 0, 0, 1, 4
"d:\IDEWORK\lvmen\src\licensedcode\data\rules\cc-by-nc-nd-4.0_4.yml", "YAML", 0, 0, 0, 3, 0, 0, 1, 4
"d:\IDEWORK\lvmen\src\licensedcode\data\rules\cc-by-nc-nd-4.0_40.yml", "YAML", 0, 0, 0, 3, 0, 0, 1, 4
"d:\IDEWORK\lvmen\src\licensedcode\data\rules\cc-by-nc-nd-4.0_41.yml", "YAML", 0, 0, 0, 3, 0, 0, 1, 4
"d:\IDEWORK\lvmen\src\licensedcode\data\rules\cc-by-nc-nd-4.0_42.yml", "YAML", 0, 0, 0, 3, 0, 0, 1, 4
"d:\IDEWORK\lvmen\src\licensedcode\data\rules\cc-by-nc-nd-4.0_43.yml", "YAML", 0, 0, 0, 3, 0, 0, 1, 4
"d:\IDEWORK\lvmen\src\licensedcode\data\rules\cc-by-nc-nd-4.0_44.yml", "YAML", 0, 0, 0, 3, 0, 0, 1, 4
"d:\IDEWORK\lvmen\src\licensedcode\data\rules\cc-by-nc-nd-4.0_45.yml", "YAML", 0, 0, 0, 3, 0, 0, 1, 4
"d:\IDEWORK\lvmen\src\licensedcode\data\rules\cc-by-nc-nd-4.0_46.yml", "YAML", 0, 0, 0, 3, 0, 0, 1, 4
"d:\IDEWORK\lvmen\src\licensedcode\data\rules\cc-by-nc-nd-4.0_47.yml", "YAML", 0, 0, 0, 3, 0, 0, 1, 4
"d:\IDEWORK\lvmen\src\licensedcode\data\rules\cc-by-nc-nd-4.0_48.yml", "YAML", 0, 0, 0, 3, 0, 0, 1, 4
"d:\IDEWORK\lvmen\src\licensedcode\data\rules\cc-by-nc-nd-4.0_49.yml", "YAML", 0, 0, 0, 5, 0, 0, 1, 6
"d:\IDEWORK\lvmen\src\licensedcode\data\rules\cc-by-nc-nd-4.0_5.yml", "YAML", 0, 0, 0, 3, 0, 0, 1, 4
"d:\IDEWORK\lvmen\src\licensedcode\data\rules\cc-by-nc-nd-4.0_50.yml", "YAML", 0, 0, 0, 5, 0, 0, 1, 6
"d:\IDEWORK\lvmen\src\licensedcode\data\rules\cc-by-nc-nd-4.0_51.yml", "YAML", 0, 0, 0, 5, 0, 0, 1, 6
"d:\IDEWORK\lvmen\src\licensedcode\data\rules\cc-by-nc-nd-4.0_52.yml", "YAML", 0, 0, 0, 5, 0, 0, 1, 6
"d:\IDEWORK\lvmen\src\licensedcode\data\rules\cc-by-nc-nd-4.0_53.yml", "YAML", 0, 0, 0, 2, 0, 0, 1, 3
"d:\IDEWORK\lvmen\src\licensedcode\data\rules\cc-by-nc-nd-4.0_6.yml", "YAML", 0, 0, 0, 3, 0, 0, 1, 4
"d:\IDEWORK\lvmen\src\licensedcode\data\rules\cc-by-nc-nd-4.0_7.yml", "YAML", 0, 0, 0, 3, 0, 0, 1, 4
"d:\IDEWORK\lvmen\src\licensedcode\data\rules\cc-by-nc-nd-4.0_8.yml", "YAML", 0, 0, 0, 3, 0, 0, 1, 4
"d:\IDEWORK\lvmen\src\licensedcode\data\rules\cc-by-nc-nd-4.0_9.yml", "YAML", 0, 0, 0, 5, 0, 0, 1, 6
"d:\IDEWORK\lvmen\src\licensedcode\data\rules\cc-by-nc-nd-4.0_licensebutton.yml", "YAML", 0, 0, 0, 5, 0, 0, 1, 6
"d:\IDEWORK\lvmen\src\licensedcode\data\rules\cc-by-nc-nd-4.0_url_1.yml", "YAML", 0, 0, 0, 5, 0, 0, 1, 6
"d:\IDEWORK\lvmen\src\licensedcode\data\rules\cc-by-nc-nd-4.0_url_2.yml", "YAML", 0, 0, 0, 5, 0, 0, 1, 6
"d:\IDEWORK\lvmen\src\licensedcode\data\rules\cc-by-nc-nd-4.0_url_badge.yml", "YAML", 0, 0, 0, 4, 0, 0, 1, 5
"d:\IDEWORK\lvmen\src\licensedcode\data\rules\cc-by-nc-nd-4.0_url_badge_1.yml", "YAML", 0, 0, 0, 5, 0, 0, 1, 6
"d:\IDEWORK\lvmen\src\licensedcode\data\rules\cc-by-nc-sa-1.0.SPDX.yml", "YAML", 0, 0, 0, 6, 0, 0, 1, 7
"d:\IDEWORK\lvmen\src\licensedcode\data\rules\cc-by-nc-sa-1.0.yml", "YAML", 0, 0, 0, 5, 0, 0, 1, 6
"d:\IDEWORK\lvmen\src\licensedcode\data\rules\cc-by-nc-sa-1.0_1.yml", "YAML", 0, 0, 0, 5, 0, 0, 1, 6
"d:\IDEWORK\lvmen\src\licensedcode\data\rules\cc-by-nc-sa-1.0_10.yml", "YAML", 0, 0, 0, 3, 0, 0, 1, 4
"d:\IDEWORK\lvmen\src\licensedcode\data\rules\cc-by-nc-sa-1.0_11.yml", "YAML", 0, 0, 0, 5, 0, 0, 1, 6
"d:\IDEWORK\lvmen\src\licensedcode\data\rules\cc-by-nc-sa-1.0_12.yml", "YAML", 0, 0, 0, 5, 0, 0, 1, 6
"d:\IDEWORK\lvmen\src\licensedcode\data\rules\cc-by-nc-sa-1.0_13.yml", "YAML", 0, 0, 0, 5, 0, 0, 1, 6
"d:\IDEWORK\lvmen\src\licensedcode\data\rules\cc-by-nc-sa-1.0_14.yml", "YAML", 0, 0, 0, 5, 0, 0, 1, 6
"d:\IDEWORK\lvmen\src\licensedcode\data\rules\cc-by-nc-sa-1.0_15.yml", "YAML", 0, 0, 0, 4, 0, 0, 1, 5
"d:\IDEWORK\lvmen\src\licensedcode\data\rules\cc-by-nc-sa-1.0_2.yml", "YAML", 0, 0, 0, 3, 0, 0, 1, 4
"d:\IDEWORK\lvmen\src\licensedcode\data\rules\cc-by-nc-sa-1.0_3.yml", "YAML", 0, 0, 0, 3, 0, 0, 1, 4
"d:\IDEWORK\lvmen\src\licensedcode\data\rules\cc-by-nc-sa-1.0_4.yml", "YAML", 0, 0, 0, 3, 0, 0, 1, 4
"d:\IDEWORK\lvmen\src\licensedcode\data\rules\cc-by-nc-sa-1.0_5.yml", "YAML", 0, 0, 0, 3, 0, 0, 1, 4
"d:\IDEWORK\lvmen\src\licensedcode\data\rules\cc-by-nc-sa-1.0_6.yml", "YAML", 0, 0, 0, 3, 0, 0, 1, 4
"d:\IDEWORK\lvmen\src\licensedcode\data\rules\cc-by-nc-sa-1.0_7.yml", "YAML", 0, 0, 0, 3, 0, 0, 1, 4
"d:\IDEWORK\lvmen\src\licensedcode\data\rules\cc-by-nc-sa-1.0_8.yml", "YAML", 0, 0, 0, 3, 0, 0, 1, 4
"d:\IDEWORK\lvmen\src\licensedcode\data\rules\cc-by-nc-sa-1.0_9.yml", "YAML", 0, 0, 0, 3, 0, 0, 1, 4
"d:\IDEWORK\lvmen\src\licensedcode\data\rules\cc-by-nc-sa-1.0_license_button.yml", "YAML", 0, 0, 0, 5, 0, 0, 1, 6
"d:\IDEWORK\lvmen\src\licensedcode\data\rules\cc-by-nc-sa-1.0_licensebutton.yml", "YAML", 0, 0, 0, 5, 0, 0, 1, 6
"d:\IDEWORK\lvmen\src\licensedcode\data\rules\cc-by-nc-sa-1.0_url_1.yml", "YAML", 0, 0, 0, 5, 0, 0, 1, 6
"d:\IDEWORK\lvmen\src\licensedcode\data\rules\cc-by-nc-sa-1.0_url_2.yml", "YAML", 0, 0, 0, 5, 0, 0, 1, 6
"d:\IDEWORK\lvmen\src\licensedcode\data\rules\cc-by-nc-sa-1.0_url_glc_11.yml", "YAML", 0, 0, 0, 5, 0, 0, 1, 6
"d:\IDEWORK\lvmen\src\licensedcode\data\rules\cc-by-nc-sa-2.0.SPDX.yml", "YAML", 0, 0, 0, 6, 0, 0, 1, 7
"d:\IDEWORK\lvmen\src\licensedcode\data\rules\cc-by-nc-sa-2.0.yml", "YAML", 0, 0, 0, 5, 0, 0, 1, 6
"d:\IDEWORK\lvmen\src\licensedcode\data\rules\cc-by-nc-sa-2.0_1.yml", "YAML", 0, 0, 0, 5, 0, 0, 1, 6
"d:\IDEWORK\lvmen\src\licensedcode\data\rules\cc-by-nc-sa-2.0_10.yml", "YAML", 0, 0, 0, 3, 0, 0, 1, 4
"d:\IDEWORK\lvmen\src\licensedcode\data\rules\cc-by-nc-sa-2.0_11.yml", "YAML", 0, 0, 0, 3, 0, 0, 1, 4
"d:\IDEWORK\lvmen\src\licensedcode\data\rules\cc-by-nc-sa-2.0_12.yml", "YAML", 0, 0, 0, 3, 0, 0, 1, 4
"d:\IDEWORK\lvmen\src\licensedcode\data\rules\cc-by-nc-sa-2.0_13.yml", "YAML", 0, 0, 0, 3, 0, 0, 1, 4
"d:\IDEWORK\lvmen\src\licensedcode\data\rules\cc-by-nc-sa-2.0_14.yml", "YAML", 0, 0, 0, 3, 0, 0, 1, 4
"d:\IDEWORK\lvmen\src\licensedcode\data\rules\cc-by-nc-sa-2.0_15.yml", "YAML", 0, 0, 0, 3, 0, 0, 1, 4
"d:\IDEWORK\lvmen\src\licensedcode\data\rules\cc-by-nc-sa-2.0_16.yml", "YAML", 0, 0, 0, 3, 0, 0, 1, 4
"d:\IDEWORK\lvmen\src\licensedcode\data\rules\cc-by-nc-sa-2.0_17.yml", "YAML", 0, 0, 0, 6, 0, 0, 1, 7
"d:\IDEWORK\lvmen\src\licensedcode\data\rules\cc-by-nc-sa-2.0_18.yml", "YAML", 0, 0, 0, 6, 0, 0, 1, 7
"d:\IDEWORK\lvmen\src\licensedcode\data\rules\cc-by-nc-sa-2.0_19.yml", "YAML", 0, 0, 0, 4, 0, 0, 1, 5
"d:\IDEWORK\lvmen\src\licensedcode\data\rules\cc-by-nc-sa-2.0_2.yml", "YAML", 0, 0, 0, 4, 0, 0, 1, 5
"d:\IDEWORK\lvmen\src\licensedcode\data\rules\cc-by-nc-sa-2.0_20.yml", "YAML", 0, 0, 0, 5, 0, 0, 1, 6
"d:\IDEWORK\lvmen\src\licensedcode\data\rules\cc-by-nc-sa-2.0_21.yml", "YAML", 0, 0, 0, 5, 0, 0, 1, 6
"d:\IDEWORK\lvmen\src\licensedcode\data\rules\cc-by-nc-sa-2.0_22.yml", "YAML", 0, 0, 0, 5, 0, 0, 1, 6
"d:\IDEWORK\lvmen\src\licensedcode\data\rules\cc-by-nc-sa-2.0_23.yml", "YAML", 0, 0, 0, 4, 0, 0, 1, 5
"d:\IDEWORK\lvmen\src\licensedcode\data\rules\cc-by-nc-sa-2.0_3.yml", "YAML", 0, 0, 0, 4, 0, 0, 1, 5
"d:\IDEWORK\lvmen\src\licensedcode\data\rules\cc-by-nc-sa-2.0_4.yml", "YAML", 0, 0, 0, 3, 0, 0, 1, 4
"d:\IDEWORK\lvmen\src\licensedcode\data\rules\cc-by-nc-sa-2.0_5.yml", "YAML", 0, 0, 0, 4, 0, 0, 1, 5
"d:\IDEWORK\lvmen\src\licensedcode\data\rules\cc-by-nc-sa-2.0_6.yml", "YAML", 0, 0, 0, 4, 0, 0, 1, 5
"d:\IDEWORK\lvmen\src\licensedcode\data\rules\cc-by-nc-sa-2.0_7.yml", "YAML", 0, 0, 0, 3, 0, 0, 1, 4
"d:\IDEWORK\lvmen\src\licensedcode\data\rules\cc-by-nc-sa-2.0_8.yml", "YAML", 0, 0, 0, 3, 0, 0, 1, 4
"d:\IDEWORK\lvmen\src\licensedcode\data\rules\cc-by-nc-sa-2.0_9.yml", "YAML", 0, 0, 0, 3, 0, 0, 1, 4
"d:\IDEWORK\lvmen\src\licensedcode\data\rules\cc-by-nc-sa-2.0_license_button.yml", "YAML", 0, 0, 0, 5, 0, 0, 1, 6
"d:\IDEWORK\lvmen\src\licensedcode\data\rules\cc-by-nc-sa-2.0_license_button_1.yml", "YAML", 0, 0, 0, 5, 0, 0, 1, 6
"d:\IDEWORK\lvmen\src\licensedcode\data\rules\cc-by-nc-sa-2.0_licensebutton.yml", "YAML", 0, 0, 0, 5, 0, 0, 1, 6
"d:\IDEWORK\lvmen\src\licensedcode\data\rules\cc-by-nc-sa-2.0_url_1.yml", "YAML", 0, 0, 0, 5, 0, 0, 1, 6
"d:\IDEWORK\lvmen\src\licensedcode\data\rules\cc-by-nc-sa-2.0_url_2.yml", "YAML", 0, 0, 0, 5, 0, 0, 1, 6
"d:\IDEWORK\lvmen\src\licensedcode\data\rules\cc-by-nc-sa-2.0_url_glc_13.yml", "YAML", 0, 0, 0, 5, 0, 0, 1, 6
"d:\IDEWORK\lvmen\src\licensedcode\data\rules\cc-by-nc-sa-2.5.SPDX.yml", "YAML", 0, 0, 0, 6, 0, 0, 1, 7
"d:\IDEWORK\lvmen\src\licensedcode\data\rules\cc-by-nc-sa-2.5.yml", "YAML", 0, 0, 0, 5, 0, 0, 1, 6
"d:\IDEWORK\lvmen\src\licensedcode\data\rules\cc-by-nc-sa-2.5_1.yml", "YAML", 0, 0, 0, 5, 0, 0, 1, 6
"d:\IDEWORK\lvmen\src\licensedcode\data\rules\cc-by-nc-sa-2.5_10.yml", "YAML", 0, 0, 0, 3, 0, 0, 1, 4
"d:\IDEWORK\lvmen\src\licensedcode\data\rules\cc-by-nc-sa-2.5_11.yml", "YAML", 0, 0, 0, 3, 0, 0, 1, 4
"d:\IDEWORK\lvmen\src\licensedcode\data\rules\cc-by-nc-sa-2.5_12.yml", "YAML", 0, 0, 0, 3, 0, 0, 1, 4
"d:\IDEWORK\lvmen\src\licensedcode\data\rules\cc-by-nc-sa-2.5_13.yml", "YAML", 0, 0, 0, 3, 0, 0, 1, 4
"d:\IDEWORK\lvmen\src\licensedcode\data\rules\cc-by-nc-sa-2.5_14.yml", "YAML", 0, 0, 0, 3, 0, 0, 1, 4
"d:\IDEWORK\lvmen\src\licensedcode\data\rules\cc-by-nc-sa-2.5_15.yml", "YAML", 0, 0, 0, 3, 0, 0, 1, 4
"d:\IDEWORK\lvmen\src\licensedcode\data\rules\cc-by-nc-sa-2.5_16.yml", "YAML", 0, 0, 0, 5, 0, 0, 1, 6
"d:\IDEWORK\lvmen\src\licensedcode\data\rules\cc-by-nc-sa-2.5_17.yml", "YAML", 0, 0, 0, 4, 0, 0, 1, 5
"d:\IDEWORK\lvmen\src\licensedcode\data\rules\cc-by-nc-sa-2.5_2.yml", "YAML", 0, 0, 0, 3, 0, 0, 1, 4
"d:\IDEWORK\lvmen\src\licensedcode\data\rules\cc-by-nc-sa-2.5_3.yml", "YAML", 0, 0, 0, 5, 0, 0, 1, 6
"d:\IDEWORK\lvmen\src\licensedcode\data\rules\cc-by-nc-sa-2.5_4.yml", "YAML", 0, 0, 0, 5, 0, 0, 1, 6
"d:\IDEWORK\lvmen\src\licensedcode\data\rules\cc-by-nc-sa-2.5_5.yml", "YAML", 0, 0, 0, 3, 0, 0, 1, 4
"d:\IDEWORK\lvmen\src\licensedcode\data\rules\cc-by-nc-sa-2.5_6.yml", "YAML", 0, 0, 0, 5, 0, 0, 1, 6
"d:\IDEWORK\lvmen\src\licensedcode\data\rules\cc-by-nc-sa-2.5_7.yml", "YAML", 0, 0, 0, 5, 0, 0, 1, 6
"d:\IDEWORK\lvmen\src\licensedcode\data\rules\cc-by-nc-sa-2.5_8.yml", "YAML", 0, 0, 0, 3, 0, 0, 1, 4
"d:\IDEWORK\lvmen\src\licensedcode\data\rules\cc-by-nc-sa-2.5_9.yml", "YAML", 0, 0, 0, 3, 0, 0, 1, 4
"d:\IDEWORK\lvmen\src\licensedcode\data\rules\cc-by-nc-sa-2.5_licensebutton.yml", "YAML", 0, 0, 0, 5, 0, 0, 1, 6
"d:\IDEWORK\lvmen\src\licensedcode\data\rules\cc-by-nc-sa-2.5_url_1.yml", "YAML", 0, 0, 0, 5, 0, 0, 1, 6
"d:\IDEWORK\lvmen\src\licensedcode\data\rules\cc-by-nc-sa-2.5_url_2.yml", "YAML", 0, 0, 0, 5, 0, 0, 1, 6
"d:\IDEWORK\lvmen\src\licensedcode\data\rules\cc-by-nc-sa-3.0-us_1.yml", "YAML", 0, 0, 0, 3, 0, 0, 1, 4
"d:\IDEWORK\lvmen\src\licensedcode\data\rules\cc-by-nc-sa-3.0-us_10.yml", "YAML", 0, 0, 0, 3, 0, 0, 1, 4
"d:\IDEWORK\lvmen\src\licensedcode\data\rules\cc-by-nc-sa-3.0-us_11.yml", "YAML", 0, 0, 0, 3, 0, 0, 1, 4
"d:\IDEWORK\lvmen\src\licensedcode\data\rules\cc-by-nc-sa-3.0-us_12.yml", "YAML", 0, 0, 0, 3, 0, 0, 1, 4
"d:\IDEWORK\lvmen\src\licensedcode\data\rules\cc-by-nc-sa-3.0-us_13.yml", "YAML", 0, 0, 0, 3, 0, 0, 1, 4
"d:\IDEWORK\lvmen\src\licensedcode\data\rules\cc-by-nc-sa-3.0-us_14.yml", "YAML", 0, 0, 0, 3, 0, 0, 1, 4
"d:\IDEWORK\lvmen\src\licensedcode\data\rules\cc-by-nc-sa-3.0-us_15.yml", "YAML", 0, 0, 0, 3, 0, 0, 1, 4
"d:\IDEWORK\lvmen\src\licensedcode\data\rules\cc-by-nc-sa-3.0-us_16.yml", "YAML", 0, 0, 0, 3, 0, 0, 1, 4
"d:\IDEWORK\lvmen\src\licensedcode\data\rules\cc-by-nc-sa-3.0-us_2.yml", "YAML", 0, 0, 0, 3, 0, 0, 1, 4
"d:\IDEWORK\lvmen\src\licensedcode\data\rules\cc-by-nc-sa-3.0-us_3.yml", "YAML", 0, 0, 0, 3, 0, 0, 1, 4
"d:\IDEWORK\lvmen\src\licensedcode\data\rules\cc-by-nc-sa-3.0-us_4.yml", "YAML", 0, 0, 0, 3, 0, 0, 1, 4
"d:\IDEWORK\lvmen\src\licensedcode\data\rules\cc-by-nc-sa-3.0-us_5.yml", "YAML", 0, 0, 0, 3, 0, 0, 1, 4
"d:\IDEWORK\lvmen\src\licensedcode\data\rules\cc-by-nc-sa-3.0-us_6.yml", "YAML", 0, 0, 0, 3, 0, 0, 1, 4
"d:\IDEWORK\lvmen\src\licensedcode\data\rules\cc-by-nc-sa-3.0-us_7.yml", "YAML", 0, 0, 0, 3, 0, 0, 1, 4
"d:\IDEWORK\lvmen\src\licensedcode\data\rules\cc-by-nc-sa-3.0-us_8.yml", "YAML", 0, 0, 0, 3, 0, 0, 1, 4
"d:\IDEWORK\lvmen\src\licensedcode\data\rules\cc-by-nc-sa-3.0-us_9.yml", "YAML", 0, 0, 0, 3, 0, 0, 1, 4
"d:\IDEWORK\lvmen\src\licensedcode\data\rules\cc-by-nc-sa-3.0.SPDX.yml", "YAML", 0, 0, 0, 6, 0, 0, 1, 7
"d:\IDEWORK\lvmen\src\licensedcode\data\rules\cc-by-nc-sa-3.0.yml", "YAML", 0, 0, 0, 5, 0, 0, 1, 6
"d:\IDEWORK\lvmen\src\licensedcode\data\rules\cc-by-nc-sa-3.0_1.yml", "YAML", 0, 0, 0, 5, 0, 0, 1, 6
"d:\IDEWORK\lvmen\src\licensedcode\data\rules\cc-by-nc-sa-3.0_10.yml", "YAML", 0, 0, 0, 4, 0, 0, 1, 5
"d:\IDEWORK\lvmen\src\licensedcode\data\rules\cc-by-nc-sa-3.0_11.yml", "YAML", 0, 0, 0, 3, 0, 0, 1, 4
"d:\IDEWORK\lvmen\src\licensedcode\data\rules\cc-by-nc-sa-3.0_12.yml", "YAML", 0, 0, 0, 3, 0, 0, 1, 4
"d:\IDEWORK\lvmen\src\licensedcode\data\rules\cc-by-nc-sa-3.0_13.yml", "YAML", 0, 0, 0, 5, 0, 0, 1, 6
"d:\IDEWORK\lvmen\src\licensedcode\data\rules\cc-by-nc-sa-3.0_14.yml", "YAML", 0, 0, 0, 3, 0, 0, 1, 4
"d:\IDEWORK\lvmen\src\licensedcode\data\rules\cc-by-nc-sa-3.0_15.yml", "YAML", 0, 0, 0, 5, 0, 0, 1, 6
"d:\IDEWORK\lvmen\src\licensedcode\data\rules\cc-by-nc-sa-3.0_16.yml", "YAML", 0, 0, 0, 3, 0, 0, 1, 4
"d:\IDEWORK\lvmen\src\licensedcode\data\rules\cc-by-nc-sa-3.0_17.yml", "YAML", 0, 0, 0, 5, 0, 0, 1, 6
"d:\IDEWORK\lvmen\src\licensedcode\data\rules\cc-by-nc-sa-3.0_18.yml", "YAML", 0, 0, 0, 3, 0, 0, 1, 4
"d:\IDEWORK\lvmen\src\licensedcode\data\rules\cc-by-nc-sa-3.0_19.yml", "YAML", 0, 0, 0, 3, 0, 0, 1, 4
"d:\IDEWORK\lvmen\src\licensedcode\data\rules\cc-by-nc-sa-3.0_2.yml", "YAML", 0, 0, 0, 4, 0, 0, 1, 5
"d:\IDEWORK\lvmen\src\licensedcode\data\rules\cc-by-nc-sa-3.0_20.yml", "YAML", 0, 0, 0, 3, 0, 0, 1, 4
"d:\IDEWORK\lvmen\src\licensedcode\data\rules\cc-by-nc-sa-3.0_21.yml", "YAML", 0, 0, 0, 3, 0, 0, 1, 4
"d:\IDEWORK\lvmen\src\licensedcode\data\rules\cc-by-nc-sa-3.0_22.yml", "YAML", 0, 0, 0, 5, 0, 0, 1, 6
"d:\IDEWORK\lvmen\src\licensedcode\data\rules\cc-by-nc-sa-3.0_23.yml", "YAML", 0, 0, 0, 5, 0, 0, 1, 6
"d:\IDEWORK\lvmen\src\licensedcode\data\rules\cc-by-nc-sa-3.0_24.yml", "YAML", 0, 0, 0, 3, 0, 0, 1, 4
"d:\IDEWORK\lvmen\src\licensedcode\data\rules\cc-by-nc-sa-3.0_25.yml", "YAML", 0, 0, 0, 3, 0, 0, 1, 4
"d:\IDEWORK\lvmen\src\licensedcode\data\rules\cc-by-nc-sa-3.0_26.yml", "YAML", 0, 0, 0, 3, 0, 0, 1, 4
"d:\IDEWORK\lvmen\src\licensedcode\data\rules\cc-by-nc-sa-3.0_27.yml", "YAML", 0, 0, 0, 3, 0, 0, 1, 4
"d:\IDEWORK\lvmen\src\licensedcode\data\rules\cc-by-nc-sa-3.0_28.yml", "YAML", 0, 0, 0, 3, 0, 0, 1, 4
"d:\IDEWORK\lvmen\src\licensedcode\data\rules\cc-by-nc-sa-3.0_29.yml", "YAML", 0, 0, 0, 3, 0, 0, 1, 4
"d:\IDEWORK\lvmen\src\licensedcode\data\rules\cc-by-nc-sa-3.0_3.yml", "YAML", 0, 0, 0, 5, 0, 0, 1, 6
"d:\IDEWORK\lvmen\src\licensedcode\data\rules\cc-by-nc-sa-3.0_30.yml", "YAML", 0, 0, 0, 3, 0, 0, 1, 4
"d:\IDEWORK\lvmen\src\licensedcode\data\rules\cc-by-nc-sa-3.0_31.yml", "YAML", 0, 0, 0, 3, 0, 0, 1, 4
"d:\IDEWORK\lvmen\src\licensedcode\data\rules\cc-by-nc-sa-3.0_32.yml", "YAML", 0, 0, 0, 3, 0, 0, 1, 4
"d:\IDEWORK\lvmen\src\licensedcode\data\rules\cc-by-nc-sa-3.0_33.yml", "YAML", 0, 0, 0, 3, 0, 0, 1, 4
"d:\IDEWORK\lvmen\src\licensedcode\data\rules\cc-by-nc-sa-3.0_34.yml", "YAML", 0, 0, 0, 3, 0, 0, 1, 4
"d:\IDEWORK\lvmen\src\licensedcode\data\rules\cc-by-nc-sa-3.0_35.yml", "YAML", 0, 0, 0, 3, 0, 0, 1, 4
"d:\IDEWORK\lvmen\src\licensedcode\data\rules\cc-by-nc-sa-3.0_36.yml", "YAML", 0, 0, 0, 3, 0, 0, 1, 4
"d:\IDEWORK\lvmen\src\licensedcode\data\rules\cc-by-nc-sa-3.0_37.yml", "YAML", 0, 0, 0, 3, 0, 0, 1, 4
"d:\IDEWORK\lvmen\src\licensedcode\data\rules\cc-by-nc-sa-3.0_38.yml", "YAML", 0, 0, 0, 3, 0, 0, 1, 4
"d:\IDEWORK\lvmen\src\licensedcode\data\rules\cc-by-nc-sa-3.0_39.yml", "YAML", 0, 0, 0, 5, 0, 0, 1, 6
"d:\IDEWORK\lvmen\src\licensedcode\data\rules\cc-by-nc-sa-3.0_4.yml", "YAML", 0, 0, 0, 4, 0, 0, 1, 5
"d:\IDEWORK\lvmen\src\licensedcode\data\rules\cc-by-nc-sa-3.0_40.yml", "YAML", 0, 0, 0, 5, 0, 0, 1, 6
"d:\IDEWORK\lvmen\src\licensedcode\data\rules\cc-by-nc-sa-3.0_41.yml", "YAML", 0, 0, 0, 5, 0, 0, 1, 6
"d:\IDEWORK\lvmen\src\licensedcode\data\rules\cc-by-nc-sa-3.0_42.yml", "YAML", 0, 0, 0, 5, 0, 0, 1, 6
"d:\IDEWORK\lvmen\src\licensedcode\data\rules\cc-by-nc-sa-3.0_43.yml", "YAML", 0, 0, 0, 5, 0, 0, 1, 6
"d:\IDEWORK\lvmen\src\licensedcode\data\rules\cc-by-nc-sa-3.0_44.yml", "YAML", 0, 0, 0, 5, 0, 0, 1, 6
"d:\IDEWORK\lvmen\src\licensedcode\data\rules\cc-by-nc-sa-3.0_45.yml", "YAML", 0, 0, 0, 5, 0, 0, 1, 6
"d:\IDEWORK\lvmen\src\licensedcode\data\rules\cc-by-nc-sa-3.0_46.yml", "YAML", 0, 0, 0, 3, 0, 0, 1, 4
"d:\IDEWORK\lvmen\src\licensedcode\data\rules\cc-by-nc-sa-3.0_47.yml", "YAML", 0, 0, 0, 4, 0, 0, 1, 5
"d:\IDEWORK\lvmen\src\licensedcode\data\rules\cc-by-nc-sa-3.0_5.yml", "YAML", 0, 0, 0, 4, 0, 0, 1, 5
"d:\IDEWORK\lvmen\src\licensedcode\data\rules\cc-by-nc-sa-3.0_6.yml", "YAML", 0, 0, 0, 5, 0, 0, 1, 6
"d:\IDEWORK\lvmen\src\licensedcode\data\rules\cc-by-nc-sa-3.0_7.yml", "YAML", 0, 0, 0, 4, 0, 0, 1, 5
"d:\IDEWORK\lvmen\src\licensedcode\data\rules\cc-by-nc-sa-3.0_8.yml", "YAML", 0, 0, 0, 4, 0, 0, 1, 5
"d:\IDEWORK\lvmen\src\licensedcode\data\rules\cc-by-nc-sa-3.0_9.yml", "YAML", 0, 0, 0, 6, 0, 0, 1, 7
"d:\IDEWORK\lvmen\src\licensedcode\data\rules\cc-by-nc-sa-3.0_and_proprietary-license_1.yml", "YAML", 0, 0, 0, 4, 0, 0, 1, 5
"d:\IDEWORK\lvmen\src\licensedcode\data\rules\cc-by-nc-sa-3.0_licensebutton.yml", "YAML", 0, 0, 0, 5, 0, 0, 1, 6
"d:\IDEWORK\lvmen\src\licensedcode\data\rules\cc-by-nc-sa-3.0_url_1.yml", "YAML", 0, 0, 0, 5, 0, 0, 1, 6
"d:\IDEWORK\lvmen\src\licensedcode\data\rules\cc-by-nc-sa-3.0_url_2.yml", "YAML", 0, 0, 0, 5, 0, 0, 1, 6
"d:\IDEWORK\lvmen\src\licensedcode\data\rules\cc-by-nc-sa-3.0_url_glc_17.yml", "YAML", 0, 0, 0, 5, 0, 0, 1, 6
"d:\IDEWORK\lvmen\src\licensedcode\data\rules\cc-by-nc-sa-4.0.SPDX.yml", "YAML", 0, 0, 0, 4, 0, 0, 1, 5
"d:\IDEWORK\lvmen\src\licensedcode\data\rules\cc-by-nc-sa-4.0.yml", "YAML", 0, 0, 0, 2, 0, 0, 1, 3
"d:\IDEWORK\lvmen\src\licensedcode\data\rules\cc-by-nc-sa-4.0_1.yml", "YAML", 0, 0, 0, 5, 0, 0, 1, 6
"d:\IDEWORK\lvmen\src\licensedcode\data\rules\cc-by-nc-sa-4.0_10.yml", "YAML", 0, 0, 0, 3, 0, 0, 1, 4
"d:\IDEWORK\lvmen\src\licensedcode\data\rules\cc-by-nc-sa-4.0_11.yml", "YAML", 0, 0, 0, 3, 0, 0, 1, 4
"d:\IDEWORK\lvmen\src\licensedcode\data\rules\cc-by-nc-sa-4.0_12.yml", "YAML", 0, 0, 0, 3, 0, 0, 1, 4
"d:\IDEWORK\lvmen\src\licensedcode\data\rules\cc-by-nc-sa-4.0_13.yml", "YAML", 0, 0, 0, 3, 0, 0, 1, 4
"d:\IDEWORK\lvmen\src\licensedcode\data\rules\cc-by-nc-sa-4.0_14.yml", "YAML", 0, 0, 0, 3, 0, 0, 1, 4
"d:\IDEWORK\lvmen\src\licensedcode\data\rules\cc-by-nc-sa-4.0_15.yml", "YAML", 0, 0, 0, 3, 0, 0, 1, 4
"d:\IDEWORK\lvmen\src\licensedcode\data\rules\cc-by-nc-sa-4.0_16.yml", "YAML", 0, 0, 0, 3, 0, 0, 1, 4
"d:\IDEWORK\lvmen\src\licensedcode\data\rules\cc-by-nc-sa-4.0_17.yml", "YAML", 0, 0, 0, 3, 0, 0, 1, 4
"d:\IDEWORK\lvmen\src\licensedcode\data\rules\cc-by-nc-sa-4.0_18.yml", "YAML", 0, 0, 0, 3, 0, 0, 1, 4
"d:\IDEWORK\lvmen\src\licensedcode\data\rules\cc-by-nc-sa-4.0_19.yml", "YAML", 0, 0, 0, 5, 0, 0, 1, 6
"d:\IDEWORK\lvmen\src\licensedcode\data\rules\cc-by-nc-sa-4.0_2.yml", "YAML", 0, 0, 0, 5, 0, 0, 1, 6
"d:\IDEWORK\lvmen\src\licensedcode\data\rules\cc-by-nc-sa-4.0_20.yml", "YAML", 0, 0, 0, 5, 0, 0, 1, 6
"d:\IDEWORK\lvmen\src\licensedcode\data\rules\cc-by-nc-sa-4.0_21.yml", "YAML", 0, 0, 0, 5, 0, 0, 1, 6
"d:\IDEWORK\lvmen\src\licensedcode\data\rules\cc-by-nc-sa-4.0_22.yml", "YAML", 0, 0, 0, 5, 0, 0, 1, 6
"d:\IDEWORK\lvmen\src\licensedcode\data\rules\cc-by-nc-sa-4.0_23.yml", "YAML", 0, 0, 0, 2, 0, 0, 1, 3
"d:\IDEWORK\lvmen\src\licensedcode\data\rules\cc-by-nc-sa-4.0_3.yml", "YAML", 0, 0, 0, 2, 0, 0, 1, 3
"d:\IDEWORK\lvmen\src\licensedcode\data\rules\cc-by-nc-sa-4.0_4.yml", "YAML", 0, 0, 0, 5, 0, 0, 1, 6
"d:\IDEWORK\lvmen\src\licensedcode\data\rules\cc-by-nc-sa-4.0_5.yml", "YAML", 0, 0, 0, 5, 0, 0, 1, 6
"d:\IDEWORK\lvmen\src\licensedcode\data\rules\cc-by-nc-sa-4.0_6.yml", "YAML", 0, 0, 0, 3, 0, 0, 1, 4
"d:\IDEWORK\lvmen\src\licensedcode\data\rules\cc-by-nc-sa-4.0_7.yml", "YAML", 0, 0, 0, 3, 0, 0, 1, 4
"d:\IDEWORK\lvmen\src\licensedcode\data\rules\cc-by-nc-sa-4.0_8.yml", "YAML", 0, 0, 0, 3, 0, 0, 1, 4
"d:\IDEWORK\lvmen\src\licensedcode\data\rules\cc-by-nc-sa-4.0_9.yml", "YAML", 0, 0, 0, 3, 0, 0, 1, 4
"d:\IDEWORK\lvmen\src\licensedcode\data\rules\cc-by-nc-sa-4.0_licensebutton.yml", "YAML", 0, 0, 0, 5, 0, 0, 1, 6
"d:\IDEWORK\lvmen\src\licensedcode\data\rules\cc-by-nc-sa-4.0_url_1.yml", "YAML", 0, 0, 0, 5, 0, 0, 1, 6
"d:\IDEWORK\lvmen\src\licensedcode\data\rules\cc-by-nc-sa-4.0_url_2.yml", "YAML", 0, 0, 0, 5, 0, 0, 1, 6
"d:\IDEWORK\lvmen\src\licensedcode\data\rules\cc-by-nc-sa-4.0_url_badge.yml", "YAML", 0, 0, 0, 4, 0, 0, 1, 5
"d:\IDEWORK\lvmen\src\licensedcode\data\rules\cc-by-nc-sa-4.0_url_badge_1.yml", "YAML", 0, 0, 0, 5, 0, 0, 1, 6
"d:\IDEWORK\lvmen\src\licensedcode\data\rules\cc-by-nd-1.0.SPDX.yml", "YAML", 0, 0, 0, 6, 0, 0, 1, 7
"d:\IDEWORK\lvmen\src\licensedcode\data\rules\cc-by-nd-1.0.yml", "YAML", 0, 0, 0, 5, 0, 0, 1, 6
"d:\IDEWORK\lvmen\src\licensedcode\data\rules\cc-by-nd-1.0_1.yml", "YAML", 0, 0, 0, 5, 0, 0, 1, 6
"d:\IDEWORK\lvmen\src\licensedcode\data\rules\cc-by-nd-1.0_10.yml", "YAML", 0, 0, 0, 3, 0, 0, 1, 4
"d:\IDEWORK\lvmen\src\licensedcode\data\rules\cc-by-nd-1.0_11.yml", "YAML", 0, 0, 0, 3, 0, 0, 1, 4
"d:\IDEWORK\lvmen\src\licensedcode\data\rules\cc-by-nd-1.0_12.yml", "YAML", 0, 0, 0, 3, 0, 0, 1, 4
"d:\IDEWORK\lvmen\src\licensedcode\data\rules\cc-by-nd-1.0_13.yml", "YAML", 0, 0, 0, 3, 0, 0, 1, 4
"d:\IDEWORK\lvmen\src\licensedcode\data\rules\cc-by-nd-1.0_14.yml", "YAML", 0, 0, 0, 3, 0, 0, 1, 4
"d:\IDEWORK\lvmen\src\licensedcode\data\rules\cc-by-nd-1.0_15.yml", "YAML", 0, 0, 0, 3, 0, 0, 1, 4
"d:\IDEWORK\lvmen\src\licensedcode\data\rules\cc-by-nd-1.0_16.yml", "YAML", 0, 0, 0, 3, 0, 0, 1, 4
"d:\IDEWORK\lvmen\src\licensedcode\data\rules\cc-by-nd-1.0_17.yml", "YAML", 0, 0, 0, 5, 0, 0, 1, 6
"d:\IDEWORK\lvmen\src\licensedcode\data\rules\cc-by-nd-1.0_18.yml", "YAML", 0, 0, 0, 5, 0, 0, 1, 6
"d:\IDEWORK\lvmen\src\licensedcode\data\rules\cc-by-nd-1.0_19.yml", "YAML", 0, 0, 0, 5, 0, 0, 1, 6
"d:\IDEWORK\lvmen\src\licensedcode\data\rules\cc-by-nd-1.0_2.yml", "YAML", 0, 0, 0, 3, 0, 0, 1, 4
"d:\IDEWORK\lvmen\src\licensedcode\data\rules\cc-by-nd-1.0_20.yml", "YAML", 0, 0, 0, 5, 0, 0, 1, 6
"d:\IDEWORK\lvmen\src\licensedcode\data\rules\cc-by-nd-1.0_21.yml", "YAML", 0, 0, 0, 5, 0, 0, 1, 6
"d:\IDEWORK\lvmen\src\licensedcode\data\rules\cc-by-nd-1.0_22.yml", "YAML", 0, 0, 0, 4, 0, 0, 1, 5
"d:\IDEWORK\lvmen\src\licensedcode\data\rules\cc-by-nd-1.0_3.yml", "YAML", 0, 0, 0, 3, 0, 0, 1, 4
"d:\IDEWORK\lvmen\src\licensedcode\data\rules\cc-by-nd-1.0_4.yml", "YAML", 0, 0, 0, 3, 0, 0, 1, 4
"d:\IDEWORK\lvmen\src\licensedcode\data\rules\cc-by-nd-1.0_5.yml", "YAML", 0, 0, 0, 3, 0, 0, 1, 4
"d:\IDEWORK\lvmen\src\licensedcode\data\rules\cc-by-nd-1.0_6.yml", "YAML", 0, 0, 0, 3, 0, 0, 1, 4
"d:\IDEWORK\lvmen\src\licensedcode\data\rules\cc-by-nd-1.0_7.yml", "YAML", 0, 0, 0, 3, 0, 0, 1, 4
"d:\IDEWORK\lvmen\src\licensedcode\data\rules\cc-by-nd-1.0_8.yml", "YAML", 0, 0, 0, 3, 0, 0, 1, 4
"d:\IDEWORK\lvmen\src\licensedcode\data\rules\cc-by-nd-1.0_9.yml", "YAML", 0, 0, 0, 3, 0, 0, 1, 4
"d:\IDEWORK\lvmen\src\licensedcode\data\rules\cc-by-nd-1.0_license_button.yml", "YAML", 0, 0, 0, 5, 0, 0, 1, 6
"d:\IDEWORK\lvmen\src\licensedcode\data\rules\cc-by-nd-1.0_licensebutton.yml", "YAML", 0, 0, 0, 5, 0, 0, 1, 6
"d:\IDEWORK\lvmen\src\licensedcode\data\rules\cc-by-nd-1.0_url_1.yml", "YAML", 0, 0, 0, 5, 0, 0, 1, 6
"d:\IDEWORK\lvmen\src\licensedcode\data\rules\cc-by-nd-1.0_url_2.yml", "YAML", 0, 0, 0, 5, 0, 0, 1, 6
"d:\IDEWORK\lvmen\src\licensedcode\data\rules\cc-by-nd-1.0_url_glc_33.yml", "YAML", 0, 0, 0, 5, 0, 0, 1, 6
"d:\IDEWORK\lvmen\src\licensedcode\data\rules\cc-by-nd-2.0.SPDX.yml", "YAML", 0, 0, 0, 6, 0, 0, 1, 7
"d:\IDEWORK\lvmen\src\licensedcode\data\rules\cc-by-nd-2.0.yml", "YAML", 0, 0, 0, 5, 0, 0, 1, 6
"d:\IDEWORK\lvmen\src\licensedcode\data\rules\cc-by-nd-2.0_1.yml", "YAML", 0, 0, 0, 5, 0, 0, 1, 6
"d:\IDEWORK\lvmen\src\licensedcode\data\rules\cc-by-nd-2.0_10.yml", "YAML", 0, 0, 0, 3, 0, 0, 1, 4
"d:\IDEWORK\lvmen\src\licensedcode\data\rules\cc-by-nd-2.0_11.yml", "YAML", 0, 0, 0, 3, 0, 0, 1, 4
"d:\IDEWORK\lvmen\src\licensedcode\data\rules\cc-by-nd-2.0_12.yml", "YAML", 0, 0, 0, 3, 0, 0, 1, 4
"d:\IDEWORK\lvmen\src\licensedcode\data\rules\cc-by-nd-2.0_13.yml", "YAML", 0, 0, 0, 3, 0, 0, 1, 4
"d:\IDEWORK\lvmen\src\licensedcode\data\rules\cc-by-nd-2.0_14.yml", "YAML", 0, 0, 0, 3, 0, 0, 1, 4
"d:\IDEWORK\lvmen\src\licensedcode\data\rules\cc-by-nd-2.0_15.yml", "YAML", 0, 0, 0, 3, 0, 0, 1, 4
"d:\IDEWORK\lvmen\src\licensedcode\data\rules\cc-by-nd-2.0_16.yml", "YAML", 0, 0, 0, 3, 0, 0, 1, 4
"d:\IDEWORK\lvmen\src\licensedcode\data\rules\cc-by-nd-2.0_17.yml", "YAML", 0, 0, 0, 5, 0, 0, 1, 6
"d:\IDEWORK\lvmen\src\licensedcode\data\rules\cc-by-nd-2.0_18.yml", "YAML", 0, 0, 0, 5, 0, 0, 1, 6
"d:\IDEWORK\lvmen\src\licensedcode\data\rules\cc-by-nd-2.0_19.yml", "YAML", 0, 0, 0, 5, 0, 0, 1, 6
"d:\IDEWORK\lvmen\src\licensedcode\data\rules\cc-by-nd-2.0_2.yml", "YAML", 0, 0, 0, 3, 0, 0, 1, 4
"d:\IDEWORK\lvmen\src\licensedcode\data\rules\cc-by-nd-2.0_20.yml", "YAML", 0, 0, 0, 5, 0, 0, 1, 6
"d:\IDEWORK\lvmen\src\licensedcode\data\rules\cc-by-nd-2.0_21.yml", "YAML", 0, 0, 0, 4, 0, 0, 1, 5
"d:\IDEWORK\lvmen\src\licensedcode\data\rules\cc-by-nd-2.0_3.yml", "YAML", 0, 0, 0, 3, 0, 0, 1, 4
"d:\IDEWORK\lvmen\src\licensedcode\data\rules\cc-by-nd-2.0_4.yml", "YAML", 0, 0, 0, 3, 0, 0, 1, 4
"d:\IDEWORK\lvmen\src\licensedcode\data\rules\cc-by-nd-2.0_5.yml", "YAML", 0, 0, 0, 3, 0, 0, 1, 4
"d:\IDEWORK\lvmen\src\licensedcode\data\rules\cc-by-nd-2.0_6.yml", "YAML", 0, 0, 0, 3, 0, 0, 1, 4
"d:\IDEWORK\lvmen\src\licensedcode\data\rules\cc-by-nd-2.0_7.yml", "YAML", 0, 0, 0, 3, 0, 0, 1, 4
"d:\IDEWORK\lvmen\src\licensedcode\data\rules\cc-by-nd-2.0_8.yml", "YAML", 0, 0, 0, 3, 0, 0, 1, 4
"d:\IDEWORK\lvmen\src\licensedcode\data\rules\cc-by-nd-2.0_9.yml", "YAML", 0, 0, 0, 3, 0, 0, 1, 4
"d:\IDEWORK\lvmen\src\licensedcode\data\rules\cc-by-nd-2.0_license_button.yml", "YAML", 0, 0, 0, 5, 0, 0, 1, 6
"d:\IDEWORK\lvmen\src\licensedcode\data\rules\cc-by-nd-2.0_license_button_1.yml", "YAML", 0, 0, 0, 5, 0, 0, 1, 6
"d:\IDEWORK\lvmen\src\licensedcode\data\rules\cc-by-nd-2.0_licensebutton.yml", "YAML", 0, 0, 0, 5, 0, 0, 1, 6
"d:\IDEWORK\lvmen\src\licensedcode\data\rules\cc-by-nd-2.0_url_1.yml", "YAML", 0, 0, 0, 5, 0, 0, 1, 6
"d:\IDEWORK\lvmen\src\licensedcode\data\rules\cc-by-nd-2.0_url_2.yml", "YAML", 0, 0, 0, 5, 0, 0, 1, 6
"d:\IDEWORK\lvmen\src\licensedcode\data\rules\cc-by-nd-2.0_url_glc_35.yml", "YAML", 0, 0, 0, 5, 0, 0, 1, 6
"d:\IDEWORK\lvmen\src\licensedcode\data\rules\cc-by-nd-2.5.SPDX.yml", "YAML", 0, 0, 0, 6, 0, 0, 1, 7
"d:\IDEWORK\lvmen\src\licensedcode\data\rules\cc-by-nd-2.5.yml", "YAML", 0, 0, 0, 5, 0, 0, 1, 6
"d:\IDEWORK\lvmen\src\licensedcode\data\rules\cc-by-nd-2.5_1.yml", "YAML", 0, 0, 0, 5, 0, 0, 1, 6
"d:\IDEWORK\lvmen\src\licensedcode\data\rules\cc-by-nd-2.5_10.yml", "YAML", 0, 0, 0, 3, 0, 0, 1, 4
"d:\IDEWORK\lvmen\src\licensedcode\data\rules\cc-by-nd-2.5_11.yml", "YAML", 0, 0, 0, 3, 0, 0, 1, 4
"d:\IDEWORK\lvmen\src\licensedcode\data\rules\cc-by-nd-2.5_12.yml", "YAML", 0, 0, 0, 3, 0, 0, 1, 4
"d:\IDEWORK\lvmen\src\licensedcode\data\rules\cc-by-nd-2.5_13.yml", "YAML", 0, 0, 0, 3, 0, 0, 1, 4
"d:\IDEWORK\lvmen\src\licensedcode\data\rules\cc-by-nd-2.5_14.yml", "YAML", 0, 0, 0, 3, 0, 0, 1, 4
"d:\IDEWORK\lvmen\src\licensedcode\data\rules\cc-by-nd-2.5_15.yml", "YAML", 0, 0, 0, 3, 0, 0, 1, 4
"d:\IDEWORK\lvmen\src\licensedcode\data\rules\cc-by-nd-2.5_16.yml", "YAML", 0, 0, 0, 3, 0, 0, 1, 4
"d:\IDEWORK\lvmen\src\licensedcode\data\rules\cc-by-nd-2.5_17.yml", "YAML", 0, 0, 0, 5, 0, 0, 1, 6
"d:\IDEWORK\lvmen\src\licensedcode\data\rules\cc-by-nd-2.5_18.yml", "YAML", 0, 0, 0, 4, 0, 0, 1, 5
"d:\IDEWORK\lvmen\src\licensedcode\data\rules\cc-by-nd-2.5_2.yml", "YAML", 0, 0, 0, 3, 0, 0, 1, 4
"d:\IDEWORK\lvmen\src\licensedcode\data\rules\cc-by-nd-2.5_3.yml", "YAML", 0, 0, 0, 3, 0, 0, 1, 4
"d:\IDEWORK\lvmen\src\licensedcode\data\rules\cc-by-nd-2.5_4.yml", "YAML", 0, 0, 0, 3, 0, 0, 1, 4
"d:\IDEWORK\lvmen\src\licensedcode\data\rules\cc-by-nd-2.5_5.yml", "YAML", 0, 0, 0, 3, 0, 0, 1, 4
"d:\IDEWORK\lvmen\src\licensedcode\data\rules\cc-by-nd-2.5_6.yml", "YAML", 0, 0, 0, 3, 0, 0, 1, 4
"d:\IDEWORK\lvmen\src\licensedcode\data\rules\cc-by-nd-2.5_7.yml", "YAML", 0, 0, 0, 3, 0, 0, 1, 4
"d:\IDEWORK\lvmen\src\licensedcode\data\rules\cc-by-nd-2.5_8.yml", "YAML", 0, 0, 0, 3, 0, 0, 1, 4
"d:\IDEWORK\lvmen\src\licensedcode\data\rules\cc-by-nd-2.5_9.yml", "YAML", 0, 0, 0, 3, 0, 0, 1, 4
"d:\IDEWORK\lvmen\src\licensedcode\data\rules\cc-by-nd-2.5_licensebutton.yml", "YAML", 0, 0, 0, 5, 0, 0, 1, 6
"d:\IDEWORK\lvmen\src\licensedcode\data\rules\cc-by-nd-2.5_url_1.yml", "YAML", 0, 0, 0, 5, 0, 0, 1, 6
"d:\IDEWORK\lvmen\src\licensedcode\data\rules\cc-by-nd-2.5_url_2.yml", "YAML", 0, 0, 0, 5, 0, 0, 1, 6
"d:\IDEWORK\lvmen\src\licensedcode\data\rules\cc-by-nd-2.5_url_glc_37.yml", "YAML", 0, 0, 0, 5, 0, 0, 1, 6
"d:\IDEWORK\lvmen\src\licensedcode\data\rules\cc-by-nd-3.0.SPDX.yml", "YAML", 0, 0, 0, 6, 0, 0, 1, 7
"d:\IDEWORK\lvmen\src\licensedcode\data\rules\cc-by-nd-3.0.yml", "YAML", 0, 0, 0, 5, 0, 0, 1, 6
"d:\IDEWORK\lvmen\src\licensedcode\data\rules\cc-by-nd-3.0_1.yml", "YAML", 0, 0, 0, 5, 0, 0, 1, 6
"d:\IDEWORK\lvmen\src\licensedcode\data\rules\cc-by-nd-3.0_10.yml", "YAML", 0, 0, 0, 3, 0, 0, 1, 4
"d:\IDEWORK\lvmen\src\licensedcode\data\rules\cc-by-nd-3.0_11.yml", "YAML", 0, 0, 0, 3, 0, 0, 1, 4
"d:\IDEWORK\lvmen\src\licensedcode\data\rules\cc-by-nd-3.0_12.yml", "YAML", 0, 0, 0, 3, 0, 0, 1, 4
"d:\IDEWORK\lvmen\src\licensedcode\data\rules\cc-by-nd-3.0_13.yml", "YAML", 0, 0, 0, 3, 0, 0, 1, 4
"d:\IDEWORK\lvmen\src\licensedcode\data\rules\cc-by-nd-3.0_14.yml", "YAML", 0, 0, 0, 3, 0, 0, 1, 4
"d:\IDEWORK\lvmen\src\licensedcode\data\rules\cc-by-nd-3.0_15.yml", "YAML", 0, 0, 0, 3, 0, 0, 1, 4
"d:\IDEWORK\lvmen\src\licensedcode\data\rules\cc-by-nd-3.0_16.yml", "YAML", 0, 0, 0, 3, 0, 0, 1, 4
"d:\IDEWORK\lvmen\src\licensedcode\data\rules\cc-by-nd-3.0_17.yml", "YAML", 0, 0, 0, 3, 0, 0, 1, 4
"d:\IDEWORK\lvmen\src\licensedcode\data\rules\cc-by-nd-3.0_18.yml", "YAML", 0, 0, 0, 3, 0, 0, 1, 4
"d:\IDEWORK\lvmen\src\licensedcode\data\rules\cc-by-nd-3.0_19.yml", "YAML", 0, 0, 0, 3, 0, 0, 1, 4
"d:\IDEWORK\lvmen\src\licensedcode\data\rules\cc-by-nd-3.0_2.yml", "YAML", 0, 0, 0, 4, 0, 0, 1, 5
"d:\IDEWORK\lvmen\src\licensedcode\data\rules\cc-by-nd-3.0_20.yml", "YAML", 0, 0, 0, 3, 0, 0, 1, 4
"d:\IDEWORK\lvmen\src\licensedcode\data\rules\cc-by-nd-3.0_21.yml", "YAML", 0, 0, 0, 3, 0, 0, 1, 4
"d:\IDEWORK\lvmen\src\licensedcode\data\rules\cc-by-nd-3.0_22.yml", "YAML", 0, 0, 0, 5, 0, 0, 1, 6
"d:\IDEWORK\lvmen\src\licensedcode\data\rules\cc-by-nd-3.0_23.yml", "YAML", 0, 0, 0, 5, 0, 0, 1, 6
"d:\IDEWORK\lvmen\src\licensedcode\data\rules\cc-by-nd-3.0_24.yml", "YAML", 0, 0, 0, 5, 0, 0, 1, 6
"d:\IDEWORK\lvmen\src\licensedcode\data\rules\cc-by-nd-3.0_25.yml", "YAML", 0, 0, 0, 5, 0, 0, 1, 6
"d:\IDEWORK\lvmen\src\licensedcode\data\rules\cc-by-nd-3.0_26.yml", "YAML", 0, 0, 0, 5, 0, 0, 1, 6
"d:\IDEWORK\lvmen\src\licensedcode\data\rules\cc-by-nd-3.0_27.yml", "YAML", 0, 0, 0, 5, 0, 0, 1, 6
"d:\IDEWORK\lvmen\src\licensedcode\data\rules\cc-by-nd-3.0_28.yml", "YAML", 0, 0, 0, 5, 0, 0, 1, 6
"d:\IDEWORK\lvmen\src\licensedcode\data\rules\cc-by-nd-3.0_29.yml", "YAML", 0, 0, 0, 4, 0, 0, 1, 5
"d:\IDEWORK\lvmen\src\licensedcode\data\rules\cc-by-nd-3.0_3.yml", "YAML", 0, 0, 0, 4, 0, 0, 1, 5
"d:\IDEWORK\lvmen\src\licensedcode\data\rules\cc-by-nd-3.0_4.yml", "YAML", 0, 0, 0, 4, 0, 0, 1, 5
"d:\IDEWORK\lvmen\src\licensedcode\data\rules\cc-by-nd-3.0_5.yml", "YAML", 0, 0, 0, 3, 0, 0, 1, 4
"d:\IDEWORK\lvmen\src\licensedcode\data\rules\cc-by-nd-3.0_6.yml", "YAML", 0, 0, 0, 5, 0, 0, 1, 6
"d:\IDEWORK\lvmen\src\licensedcode\data\rules\cc-by-nd-3.0_7.yml", "YAML", 0, 0, 0, 3, 0, 0, 1, 4
"d:\IDEWORK\lvmen\src\licensedcode\data\rules\cc-by-nd-3.0_8.yml", "YAML", 0, 0, 0, 3, 0, 0, 1, 4
"d:\IDEWORK\lvmen\src\licensedcode\data\rules\cc-by-nd-3.0_9.yml", "YAML", 0, 0, 0, 3, 0, 0, 1, 4
"d:\IDEWORK\lvmen\src\licensedcode\data\rules\cc-by-nd-3.0_licensebutton.yml", "YAML", 0, 0, 0, 5, 0, 0, 1, 6
"d:\IDEWORK\lvmen\src\licensedcode\data\rules\cc-by-nd-3.0_url_1.yml", "YAML", 0, 0, 0, 5, 0, 0, 1, 6
"d:\IDEWORK\lvmen\src\licensedcode\data\rules\cc-by-nd-3.0_url_2.yml", "YAML", 0, 0, 0, 5, 0, 0, 1, 6
"d:\IDEWORK\lvmen\src\licensedcode\data\rules\cc-by-nd-3.0_url_glc_39.yml", "YAML", 0, 0, 0, 5, 0, 0, 1, 6
"d:\IDEWORK\lvmen\src\licensedcode\data\rules\cc-by-nd-4.0.SPDX.yml", "YAML", 0, 0, 0, 4, 0, 0, 1, 5
"d:\IDEWORK\lvmen\src\licensedcode\data\rules\cc-by-nd-4.0.yml", "YAML", 0, 0, 0, 2, 0, 0, 1, 3
"d:\IDEWORK\lvmen\src\licensedcode\data\rules\cc-by-nd-4.0_1.yml", "YAML", 0, 0, 0, 2, 0, 0, 1, 3
"d:\IDEWORK\lvmen\src\licensedcode\data\rules\cc-by-nd-4.0_10.yml", "YAML", 0, 0, 0, 3, 0, 0, 1, 4
"d:\IDEWORK\lvmen\src\licensedcode\data\rules\cc-by-nd-4.0_11.yml", "YAML", 0, 0, 0, 3, 0, 0, 1, 4
"d:\IDEWORK\lvmen\src\licensedcode\data\rules\cc-by-nd-4.0_12.yml", "YAML", 0, 0, 0, 3, 0, 0, 1, 4
"d:\IDEWORK\lvmen\src\licensedcode\data\rules\cc-by-nd-4.0_13.yml", "YAML", 0, 0, 0, 3, 0, 0, 1, 4
"d:\IDEWORK\lvmen\src\licensedcode\data\rules\cc-by-nd-4.0_14.yml", "YAML", 0, 0, 0, 3, 0, 0, 1, 4
"d:\IDEWORK\lvmen\src\licensedcode\data\rules\cc-by-nd-4.0_15.yml", "YAML", 0, 0, 0, 3, 0, 0, 1, 4
"d:\IDEWORK\lvmen\src\licensedcode\data\rules\cc-by-nd-4.0_16.yml", "YAML", 0, 0, 0, 3, 0, 0, 1, 4
"d:\IDEWORK\lvmen\src\licensedcode\data\rules\cc-by-nd-4.0_17.yml", "YAML", 0, 0, 0, 3, 0, 0, 1, 4
"d:\IDEWORK\lvmen\src\licensedcode\data\rules\cc-by-nd-4.0_18.yml", "YAML", 0, 0, 0, 5, 0, 0, 1, 6
"d:\IDEWORK\lvmen\src\licensedcode\data\rules\cc-by-nd-4.0_19.yml", "YAML", 0, 0, 0, 3, 0, 0, 1, 4
"d:\IDEWORK\lvmen\src\licensedcode\data\rules\cc-by-nd-4.0_2.yml", "YAML", 0, 0, 0, 5, 0, 0, 1, 6
"d:\IDEWORK\lvmen\src\licensedcode\data\rules\cc-by-nd-4.0_20.yml", "YAML", 0, 0, 0, 3, 0, 0, 1, 4
"d:\IDEWORK\lvmen\src\licensedcode\data\rules\cc-by-nd-4.0_21.yml", "YAML", 0, 0, 0, 5, 0, 0, 1, 6
"d:\IDEWORK\lvmen\src\licensedcode\data\rules\cc-by-nd-4.0_22.yml", "YAML", 0, 0, 0, 5, 0, 0, 1, 6
"d:\IDEWORK\lvmen\src\licensedcode\data\rules\cc-by-nd-4.0_23.yml", "YAML", 0, 0, 0, 5, 0, 0, 1, 6
"d:\IDEWORK\lvmen\src\licensedcode\data\rules\cc-by-nd-4.0_24.yml", "YAML", 0, 0, 0, 2, 0, 0, 1, 3
"d:\IDEWORK\lvmen\src\licensedcode\data\rules\cc-by-nd-4.0_3.yml", "YAML", 0, 0, 0, 3, 0, 0, 1, 4
"d:\IDEWORK\lvmen\src\licensedcode\data\rules\cc-by-nd-4.0_4.yml", "YAML", 0, 0, 0, 3, 0, 0, 1, 4
"d:\IDEWORK\lvmen\src\licensedcode\data\rules\cc-by-nd-4.0_5.yml", "YAML", 0, 0, 0, 3, 0, 0, 1, 4
"d:\IDEWORK\lvmen\src\licensedcode\data\rules\cc-by-nd-4.0_6.yml", "YAML", 0, 0, 0, 3, 0, 0, 1, 4
"d:\IDEWORK\lvmen\src\licensedcode\data\rules\cc-by-nd-4.0_7.yml", "YAML", 0, 0, 0, 3, 0, 0, 1, 4
"d:\IDEWORK\lvmen\src\licensedcode\data\rules\cc-by-nd-4.0_8.yml", "YAML", 0, 0, 0, 3, 0, 0, 1, 4
"d:\IDEWORK\lvmen\src\licensedcode\data\rules\cc-by-nd-4.0_9.yml", "YAML", 0, 0, 0, 3, 0, 0, 1, 4
"d:\IDEWORK\lvmen\src\licensedcode\data\rules\cc-by-nd-4.0_licensebutton.yml", "YAML", 0, 0, 0, 5, 0, 0, 1, 6
"d:\IDEWORK\lvmen\src\licensedcode\data\rules\cc-by-nd-4.0_url_1.yml", "YAML", 0, 0, 0, 5, 0, 0, 1, 6
"d:\IDEWORK\lvmen\src\licensedcode\data\rules\cc-by-nd-4.0_url_2.yml", "YAML", 0, 0, 0, 5, 0, 0, 1, 6
"d:\IDEWORK\lvmen\src\licensedcode\data\rules\cc-by-nd-4.0_url_badge.yml", "YAML", 0, 0, 0, 4, 0, 0, 1, 5
"d:\IDEWORK\lvmen\src\licensedcode\data\rules\cc-by-nd-4.0_url_badge_1.yml", "YAML", 0, 0, 0, 5, 0, 0, 1, 6
"d:\IDEWORK\lvmen\src\licensedcode\data\rules\cc-by-nd-4.0_url_glc_40.yml", "YAML", 0, 0, 0, 5, 0, 0, 1, 6
"d:\IDEWORK\lvmen\src\licensedcode\data\rules\cc-by-nd-4.0_url_glc_41.yml", "YAML", 0, 0, 0, 5, 0, 0, 1, 6
"d:\IDEWORK\lvmen\src\licensedcode\data\rules\cc-by-sa-1.0.SPDX.yml", "YAML", 0, 0, 0, 6, 0, 0, 1, 7
"d:\IDEWORK\lvmen\src\licensedcode\data\rules\cc-by-sa-1.0.yml", "YAML", 0, 0, 0, 5, 0, 0, 1, 6
"d:\IDEWORK\lvmen\src\licensedcode\data\rules\cc-by-sa-1.0_1.yml", "YAML", 0, 0, 0, 5, 0, 0, 1, 6
"d:\IDEWORK\lvmen\src\licensedcode\data\rules\cc-by-sa-1.0_10.yml", "YAML", 0, 0, 0, 3, 0, 0, 1, 4
"d:\IDEWORK\lvmen\src\licensedcode\data\rules\cc-by-sa-1.0_11.yml", "YAML", 0, 0, 0, 5, 0, 0, 1, 6
"d:\IDEWORK\lvmen\src\licensedcode\data\rules\cc-by-sa-1.0_12.yml", "YAML", 0, 0, 0, 5, 0, 0, 1, 6
"d:\IDEWORK\lvmen\src\licensedcode\data\rules\cc-by-sa-1.0_13.yml", "YAML", 0, 0, 0, 5, 0, 0, 1, 6
"d:\IDEWORK\lvmen\src\licensedcode\data\rules\cc-by-sa-1.0_14.yml", "YAML", 0, 0, 0, 5, 0, 0, 1, 6
"d:\IDEWORK\lvmen\src\licensedcode\data\rules\cc-by-sa-1.0_15.yml", "YAML", 0, 0, 0, 5, 0, 0, 1, 6
"d:\IDEWORK\lvmen\src\licensedcode\data\rules\cc-by-sa-1.0_16.yml", "YAML", 0, 0, 0, 4, 0, 0, 1, 5
"d:\IDEWORK\lvmen\src\licensedcode\data\rules\cc-by-sa-1.0_2.yml", "YAML", 0, 0, 0, 5, 0, 0, 1, 6
"d:\IDEWORK\lvmen\src\licensedcode\data\rules\cc-by-sa-1.0_3.yml", "YAML", 0, 0, 0, 3, 0, 0, 1, 4
"d:\IDEWORK\lvmen\src\licensedcode\data\rules\cc-by-sa-1.0_4.yml", "YAML", 0, 0, 0, 3, 0, 0, 1, 4
"d:\IDEWORK\lvmen\src\licensedcode\data\rules\cc-by-sa-1.0_5.yml", "YAML", 0, 0, 0, 3, 0, 0, 1, 4
"d:\IDEWORK\lvmen\src\licensedcode\data\rules\cc-by-sa-1.0_6.yml", "YAML", 0, 0, 0, 3, 0, 0, 1, 4
"d:\IDEWORK\lvmen\src\licensedcode\data\rules\cc-by-sa-1.0_7.yml", "YAML", 0, 0, 0, 3, 0, 0, 1, 4
"d:\IDEWORK\lvmen\src\licensedcode\data\rules\cc-by-sa-1.0_8.yml", "YAML", 0, 0, 0, 3, 0, 0, 1, 4
"d:\IDEWORK\lvmen\src\licensedcode\data\rules\cc-by-sa-1.0_9.yml", "YAML", 0, 0, 0, 3, 0, 0, 1, 4
"d:\IDEWORK\lvmen\src\licensedcode\data\rules\cc-by-sa-1.0_license_button.yml", "YAML", 0, 0, 0, 5, 0, 0, 1, 6
"d:\IDEWORK\lvmen\src\licensedcode\data\rules\cc-by-sa-1.0_licensebutton.yml", "YAML", 0, 0, 0, 5, 0, 0, 1, 6
"d:\IDEWORK\lvmen\src\licensedcode\data\rules\cc-by-sa-1.0_url_1.yml", "YAML", 0, 0, 0, 5, 0, 0, 1, 6
"d:\IDEWORK\lvmen\src\licensedcode\data\rules\cc-by-sa-1.0_url_2.yml", "YAML", 0, 0, 0, 5, 0, 0, 1, 6
"d:\IDEWORK\lvmen\src\licensedcode\data\rules\cc-by-sa-1.0_url_glc_43.yml", "YAML", 0, 0, 0, 5, 0, 0, 1, 6
"d:\IDEWORK\lvmen\src\licensedcode\data\rules\cc-by-sa-2.0.SPDX.yml", "YAML", 0, 0, 0, 6, 0, 0, 1, 7
"d:\IDEWORK\lvmen\src\licensedcode\data\rules\cc-by-sa-2.0.yml", "YAML", 0, 0, 0, 5, 0, 0, 1, 6
"d:\IDEWORK\lvmen\src\licensedcode\data\rules\cc-by-sa-2.0_1.yml", "YAML", 0, 0, 0, 5, 0, 0, 1, 6
"d:\IDEWORK\lvmen\src\licensedcode\data\rules\cc-by-sa-2.0_10.yml", "YAML", 0, 0, 0, 5, 0, 0, 1, 6
"d:\IDEWORK\lvmen\src\licensedcode\data\rules\cc-by-sa-2.0_11.yml", "YAML", 0, 0, 0, 5, 0, 0, 1, 6
"d:\IDEWORK\lvmen\src\licensedcode\data\rules\cc-by-sa-2.0_12.yml", "YAML", 0, 0, 0, 5, 0, 0, 1, 6
"d:\IDEWORK\lvmen\src\licensedcode\data\rules\cc-by-sa-2.0_13.yml", "YAML", 0, 0, 0, 3, 0, 0, 1, 4
"d:\IDEWORK\lvmen\src\licensedcode\data\rules\cc-by-sa-2.0_14.yml", "YAML", 0, 0, 0, 3, 0, 0, 1, 4
"d:\IDEWORK\lvmen\src\licensedcode\data\rules\cc-by-sa-2.0_15.yml", "YAML", 0, 0, 0, 3, 0, 0, 1, 4
"d:\IDEWORK\lvmen\src\licensedcode\data\rules\cc-by-sa-2.0_16.yml", "YAML", 0, 0, 0, 3, 0, 0, 1, 4
"d:\IDEWORK\lvmen\src\licensedcode\data\rules\cc-by-sa-2.0_17.yml", "YAML", 0, 0, 0, 3, 0, 0, 1, 4
"d:\IDEWORK\lvmen\src\licensedcode\data\rules\cc-by-sa-2.0_18.yml", "YAML", 0, 0, 0, 3, 0, 0, 1, 4
"d:\IDEWORK\lvmen\src\licensedcode\data\rules\cc-by-sa-2.0_19.yml", "YAML", 0, 0, 0, 3, 0, 0, 1, 4
"d:\IDEWORK\lvmen\src\licensedcode\data\rules\cc-by-sa-2.0_2.yml", "YAML", 0, 0, 0, 5, 0, 0, 1, 6
"d:\IDEWORK\lvmen\src\licensedcode\data\rules\cc-by-sa-2.0_20.yml", "YAML", 0, 0, 0, 3, 0, 0, 1, 4
"d:\IDEWORK\lvmen\src\licensedcode\data\rules\cc-by-sa-2.0_21.yml", "YAML", 0, 0, 0, 5, 0, 0, 1, 6
"d:\IDEWORK\lvmen\src\licensedcode\data\rules\cc-by-sa-2.0_22.yml", "YAML", 0, 0, 0, 5, 0, 0, 1, 6
"d:\IDEWORK\lvmen\src\licensedcode\data\rules\cc-by-sa-2.0_23.yml", "YAML", 0, 0, 0, 5, 0, 0, 1, 6
"d:\IDEWORK\lvmen\src\licensedcode\data\rules\cc-by-sa-2.0_24.yml", "YAML", 0, 0, 0, 5, 0, 0, 1, 6
"d:\IDEWORK\lvmen\src\licensedcode\data\rules\cc-by-sa-2.0_25.yml", "YAML", 0, 0, 0, 5, 0, 0, 1, 6
"d:\IDEWORK\lvmen\src\licensedcode\data\rules\cc-by-sa-2.0_26.yml", "YAML", 0, 0, 0, 5, 0, 0, 1, 6
"d:\IDEWORK\lvmen\src\licensedcode\data\rules\cc-by-sa-2.0_27.yml", "YAML", 0, 0, 0, 5, 0, 0, 1, 6
"d:\IDEWORK\lvmen\src\licensedcode\data\rules\cc-by-sa-2.0_28.yml", "YAML", 0, 0, 0, 5, 0, 0, 1, 6
"d:\IDEWORK\lvmen\src\licensedcode\data\rules\cc-by-sa-2.0_29.yml", "YAML", 0, 0, 0, 3, 0, 0, 1, 4
"d:\IDEWORK\lvmen\src\licensedcode\data\rules\cc-by-sa-2.0_3.yml", "YAML", 0, 0, 0, 3, 0, 0, 1, 4
"d:\IDEWORK\lvmen\src\licensedcode\data\rules\cc-by-sa-2.0_30.yml", "YAML", 0, 0, 0, 3, 0, 0, 1, 4
"d:\IDEWORK\lvmen\src\licensedcode\data\rules\cc-by-sa-2.0_31.yml", "YAML", 0, 0, 0, 3, 0, 0, 1, 4
"d:\IDEWORK\lvmen\src\licensedcode\data\rules\cc-by-sa-2.0_32.yml", "YAML", 0, 0, 0, 3, 0, 0, 1, 4
"d:\IDEWORK\lvmen\src\licensedcode\data\rules\cc-by-sa-2.0_33.yml", "YAML", 0, 0, 0, 3, 0, 0, 1, 4
"d:\IDEWORK\lvmen\src\licensedcode\data\rules\cc-by-sa-2.0_34.yml", "YAML", 0, 0, 0, 3, 0, 0, 1, 4
"d:\IDEWORK\lvmen\src\licensedcode\data\rules\cc-by-sa-2.0_35.yml", "YAML", 0, 0, 0, 3, 0, 0, 1, 4
"d:\IDEWORK\lvmen\src\licensedcode\data\rules\cc-by-sa-2.0_36.yml", "YAML", 0, 0, 0, 3, 0, 0, 1, 4
"d:\IDEWORK\lvmen\src\licensedcode\data\rules\cc-by-sa-2.0_37.yml", "YAML", 0, 0, 0, 5, 0, 0, 1, 6
"d:\IDEWORK\lvmen\src\licensedcode\data\rules\cc-by-sa-2.0_38.yml", "YAML", 0, 0, 0, 3, 0, 0, 1, 4
"d:\IDEWORK\lvmen\src\licensedcode\data\rules\cc-by-sa-2.0_4.yml", "YAML", 0, 0, 0, 5, 0, 0, 1, 6
"d:\IDEWORK\lvmen\src\licensedcode\data\rules\cc-by-sa-2.0_5.yml", "YAML", 0, 0, 0, 5, 0, 0, 1, 6
"d:\IDEWORK\lvmen\src\licensedcode\data\rules\cc-by-sa-2.0_6.yml", "YAML", 0, 0, 0, 5, 0, 0, 1, 6
"d:\IDEWORK\lvmen\src\licensedcode\data\rules\cc-by-sa-2.0_7.yml", "YAML", 0, 0, 0, 5, 0, 0, 1, 6
"d:\IDEWORK\lvmen\src\licensedcode\data\rules\cc-by-sa-2.0_8.yml", "YAML", 0, 0, 0, 5, 0, 0, 1, 6
"d:\IDEWORK\lvmen\src\licensedcode\data\rules\cc-by-sa-2.0_9.yml", "YAML", 0, 0, 0, 5, 0, 0, 1, 6
"d:\IDEWORK\lvmen\src\licensedcode\data\rules\cc-by-sa-2.0_license_button.yml", "YAML", 0, 0, 0, 5, 0, 0, 1, 6
"d:\IDEWORK\lvmen\src\licensedcode\data\rules\cc-by-sa-2.0_license_button_1.yml", "YAML", 0, 0, 0, 5, 0, 0, 1, 6
"d:\IDEWORK\lvmen\src\licensedcode\data\rules\cc-by-sa-2.0_licensebutton.yml", "YAML", 0, 0, 0, 5, 0, 0, 1, 6
"d:\IDEWORK\lvmen\src\licensedcode\data\rules\cc-by-sa-2.0_or_gpl-3.0-plus_1.yml", "YAML", 0, 0, 0, 3, 0, 0, 1, 4
"d:\IDEWORK\lvmen\src\licensedcode\data\rules\cc-by-sa-2.0_or_odbl-1.0_1.yml", "YAML", 0, 0, 0, 6, 0, 0, 1, 7
"d:\IDEWORK\lvmen\src\licensedcode\data\rules\cc-by-sa-2.0_or_odbl-1.0_2.yml", "YAML", 0, 0, 0, 6, 0, 0, 1, 7
"d:\IDEWORK\lvmen\src\licensedcode\data\rules\cc-by-sa-2.0_url_1.yml", "YAML", 0, 0, 0, 5, 0, 0, 1, 6
"d:\IDEWORK\lvmen\src\licensedcode\data\rules\cc-by-sa-2.0_url_2.yml", "YAML", 0, 0, 0, 5, 0, 0, 1, 6
"d:\IDEWORK\lvmen\src\licensedcode\data\rules\cc-by-sa-2.0_url_glc_45.yml", "YAML", 0, 0, 0, 5, 0, 0, 1, 6
"d:\IDEWORK\lvmen\src\licensedcode\data\rules\cc-by-sa-2.5.SPDX.yml", "YAML", 0, 0, 0, 6, 0, 0, 1, 7
"d:\IDEWORK\lvmen\src\licensedcode\data\rules\cc-by-sa-2.5.yml", "YAML", 0, 0, 0, 5, 0, 0, 1, 6
"d:\IDEWORK\lvmen\src\licensedcode\data\rules\cc-by-sa-2.5_1.yml", "YAML", 0, 0, 0, 5, 0, 0, 1, 6
"d:\IDEWORK\lvmen\src\licensedcode\data\rules\cc-by-sa-2.5_10.yml", "YAML", 0, 0, 0, 3, 0, 0, 1, 4
"d:\IDEWORK\lvmen\src\licensedcode\data\rules\cc-by-sa-2.5_11.yml", "YAML", 0, 0, 0, 3, 0, 0, 1, 4
"d:\IDEWORK\lvmen\src\licensedcode\data\rules\cc-by-sa-2.5_12.yml", "YAML", 0, 0, 0, 3, 0, 0, 1, 4
"d:\IDEWORK\lvmen\src\licensedcode\data\rules\cc-by-sa-2.5_13.yml", "YAML", 0, 0, 0, 3, 0, 0, 1, 4
"d:\IDEWORK\lvmen\src\licensedcode\data\rules\cc-by-sa-2.5_14.yml", "YAML", 0, 0, 0, 3, 0, 0, 1, 4
"d:\IDEWORK\lvmen\src\licensedcode\data\rules\cc-by-sa-2.5_15.yml", "YAML", 0, 0, 0, 3, 0, 0, 1, 4
"d:\IDEWORK\lvmen\src\licensedcode\data\rules\cc-by-sa-2.5_16.yml", "YAML", 0, 0, 0, 3, 0, 0, 1, 4
"d:\IDEWORK\lvmen\src\licensedcode\data\rules\cc-by-sa-2.5_17.yml", "YAML", 0, 0, 0, 3, 0, 0, 1, 4
"d:\IDEWORK\lvmen\src\licensedcode\data\rules\cc-by-sa-2.5_18.yml", "YAML", 0, 0, 0, 3, 0, 0, 1, 4
"d:\IDEWORK\lvmen\src\licensedcode\data\rules\cc-by-sa-2.5_19.yml", "YAML", 0, 0, 0, 5, 0, 0, 1, 6
"d:\IDEWORK\lvmen\src\licensedcode\data\rules\cc-by-sa-2.5_2.yml", "YAML", 0, 0, 0, 3, 0, 0, 1, 4
"d:\IDEWORK\lvmen\src\licensedcode\data\rules\cc-by-sa-2.5_20.yml", "YAML", 0, 0, 0, 4, 0, 0, 1, 5
"d:\IDEWORK\lvmen\src\licensedcode\data\rules\cc-by-sa-2.5_3.yml", "YAML", 0, 0, 0, 5, 0, 0, 1, 6
"d:\IDEWORK\lvmen\src\licensedcode\data\rules\cc-by-sa-2.5_4.yml", "YAML", 0, 0, 0, 4, 0, 0, 1, 5
"d:\IDEWORK\lvmen\src\licensedcode\data\rules\cc-by-sa-2.5_5.yml", "YAML", 0, 0, 0, 5, 0, 0, 1, 6
"d:\IDEWORK\lvmen\src\licensedcode\data\rules\cc-by-sa-2.5_6.yml", "YAML", 0, 0, 0, 3, 0, 0, 1, 4
"d:\IDEWORK\lvmen\src\licensedcode\data\rules\cc-by-sa-2.5_7.yml", "YAML", 0, 0, 0, 4, 0, 0, 1, 5
"d:\IDEWORK\lvmen\src\licensedcode\data\rules\cc-by-sa-2.5_8.yml", "YAML", 0, 0, 0, 6, 0, 0, 1, 7
"d:\IDEWORK\lvmen\src\licensedcode\data\rules\cc-by-sa-2.5_9.yml", "YAML", 0, 0, 0, 5, 0, 0, 1, 6
"d:\IDEWORK\lvmen\src\licensedcode\data\rules\cc-by-sa-2.5_licensebutton.yml", "YAML", 0, 0, 0, 5, 0, 0, 1, 6
"d:\IDEWORK\lvmen\src\licensedcode\data\rules\cc-by-sa-2.5_url_1.yml", "YAML", 0, 0, 0, 5, 0, 0, 1, 6
"d:\IDEWORK\lvmen\src\licensedcode\data\rules\cc-by-sa-2.5_url_2.yml", "YAML", 0, 0, 0, 5, 0, 0, 1, 6
"d:\IDEWORK\lvmen\src\licensedcode\data\rules\cc-by-sa-2.5_url_glc_47.yml", "YAML", 0, 0, 0, 5, 0, 0, 1, 6
"d:\IDEWORK\lvmen\src\licensedcode\data\rules\cc-by-sa-3.0-stack_overflow.yml", "YAML", 0, 0, 0, 5, 0, 0, 1, 6
"d:\IDEWORK\lvmen\src\licensedcode\data\rules\cc-by-sa-3.0.SPDX.yml", "YAML", 0, 0, 0, 7, 0, 0, 1, 8
"d:\IDEWORK\lvmen\src\licensedcode\data\rules\cc-by-sa-3.0_1.yml", "YAML", 0, 0, 0, 5, 0, 0, 1, 6
"d:\IDEWORK\lvmen\src\licensedcode\data\rules\cc-by-sa-3.0_10.yml", "YAML", 0, 0, 0, 5, 0, 0, 1, 6
"d:\IDEWORK\lvmen\src\licensedcode\data\rules\cc-by-sa-3.0_11.yml", "YAML", 0, 0, 0, 5, 0, 0, 1, 6
"d:\IDEWORK\lvmen\src\licensedcode\data\rules\cc-by-sa-3.0_12.yml", "YAML", 0, 0, 0, 3, 0, 0, 1, 4
"d:\IDEWORK\lvmen\src\licensedcode\data\rules\cc-by-sa-3.0_13.yml", "YAML", 0, 0, 0, 3, 0, 0, 1, 4
"d:\IDEWORK\lvmen\src\licensedcode\data\rules\cc-by-sa-3.0_14.yml", "YAML", 0, 0, 0, 3, 0, 0, 1, 4
"d:\IDEWORK\lvmen\src\licensedcode\data\rules\cc-by-sa-3.0_15.yml", "YAML", 0, 0, 0, 3, 0, 0, 1, 4
"d:\IDEWORK\lvmen\src\licensedcode\data\rules\cc-by-sa-3.0_16.yml", "YAML", 0, 0, 0, 3, 0, 0, 1, 4
"d:\IDEWORK\lvmen\src\licensedcode\data\rules\cc-by-sa-3.0_17.yml", "YAML", 0, 0, 0, 5, 0, 0, 1, 6
"d:\IDEWORK\lvmen\src\licensedcode\data\rules\cc-by-sa-3.0_18.yml", "YAML", 0, 0, 0, 5, 0, 0, 1, 6
"d:\IDEWORK\lvmen\src\licensedcode\data\rules\cc-by-sa-3.0_19.yml", "YAML", 0, 0, 0, 6, 0, 0, 1, 7
"d:\IDEWORK\lvmen\src\licensedcode\data\rules\cc-by-sa-3.0_2.yml", "YAML", 0, 0, 0, 5, 0, 0, 1, 6
"d:\IDEWORK\lvmen\src\licensedcode\data\rules\cc-by-sa-3.0_20.yml", "YAML", 0, 0, 0, 5, 0, 0, 1, 6
"d:\IDEWORK\lvmen\src\licensedcode\data\rules\cc-by-sa-3.0_21.yml", "YAML", 0, 0, 0, 3, 0, 0, 1, 4
"d:\IDEWORK\lvmen\src\licensedcode\data\rules\cc-by-sa-3.0_22.yml", "YAML", 0, 0, 0, 5, 0, 0, 1, 6
"d:\IDEWORK\lvmen\src\licensedcode\data\rules\cc-by-sa-3.0_23.yml", "YAML", 0, 0, 0, 5, 0, 0, 1, 6
"d:\IDEWORK\lvmen\src\licensedcode\data\rules\cc-by-sa-3.0_24.yml", "YAML", 0, 0, 0, 3, 0, 0, 1, 4
"d:\IDEWORK\lvmen\src\licensedcode\data\rules\cc-by-sa-3.0_25.yml", "YAML", 0, 0, 0, 5, 0, 0, 1, 6
"d:\IDEWORK\lvmen\src\licensedcode\data\rules\cc-by-sa-3.0_26.yml", "YAML", 0, 0, 0, 5, 0, 0, 1, 6
"d:\IDEWORK\lvmen\src\licensedcode\data\rules\cc-by-sa-3.0_27.yml", "YAML", 0, 0, 0, 3, 0, 0, 1, 4
"d:\IDEWORK\lvmen\src\licensedcode\data\rules\cc-by-sa-3.0_28.yml", "YAML", 0, 0, 0, 3, 0, 0, 1, 4
"d:\IDEWORK\lvmen\src\licensedcode\data\rules\cc-by-sa-3.0_29.yml", "YAML", 0, 0, 0, 3, 0, 0, 1, 4
"d:\IDEWORK\lvmen\src\licensedcode\data\rules\cc-by-sa-3.0_3.yml", "YAML", 0, 0, 0, 5, 0, 0, 1, 6
"d:\IDEWORK\lvmen\src\licensedcode\data\rules\cc-by-sa-3.0_30.yml", "YAML", 0, 0, 0, 3, 0, 0, 1, 4
"d:\IDEWORK\lvmen\src\licensedcode\data\rules\cc-by-sa-3.0_31.yml", "YAML", 0, 0, 0, 5, 0, 0, 1, 6
"d:\IDEWORK\lvmen\src\licensedcode\data\rules\cc-by-sa-3.0_32.yml", "YAML", 0, 0, 0, 5, 0, 0, 1, 6
"d:\IDEWORK\lvmen\src\licensedcode\data\rules\cc-by-sa-3.0_33.yml", "YAML", 0, 0, 0, 3, 0, 0, 1, 4
"d:\IDEWORK\lvmen\src\licensedcode\data\rules\cc-by-sa-3.0_34.yml", "YAML", 0, 0, 0, 5, 0, 0, 1, 6
"d:\IDEWORK\lvmen\src\licensedcode\data\rules\cc-by-sa-3.0_35.yml", "YAML", 0, 0, 0, 6, 0, 0, 1, 7
"d:\IDEWORK\lvmen\src\licensedcode\data\rules\cc-by-sa-3.0_36.yml", "YAML", 0, 0, 0, 4, 0, 0, 1, 5
"d:\IDEWORK\lvmen\src\licensedcode\data\rules\cc-by-sa-3.0_37.yml", "YAML", 0, 0, 0, 5, 0, 0, 1, 6
"d:\IDEWORK\lvmen\src\licensedcode\data\rules\cc-by-sa-3.0_38.yml", "YAML", 0, 0, 0, 5, 0, 0, 1, 6
"d:\IDEWORK\lvmen\src\licensedcode\data\rules\cc-by-sa-3.0_39.yml", "YAML", 0, 0, 0, 3, 0, 0, 1, 4
"d:\IDEWORK\lvmen\src\licensedcode\data\rules\cc-by-sa-3.0_4.yml", "YAML", 0, 0, 0, 4, 0, 0, 1, 5
"d:\IDEWORK\lvmen\src\licensedcode\data\rules\cc-by-sa-3.0_40.yml", "YAML", 0, 0, 0, 3, 0, 0, 1, 4
"d:\IDEWORK\lvmen\src\licensedcode\data\rules\cc-by-sa-3.0_41.yml", "YAML", 0, 0, 0, 6, 0, 0, 1, 7
"d:\IDEWORK\lvmen\src\licensedcode\data\rules\cc-by-sa-3.0_42.yml", "YAML", 0, 0, 0, 3, 0, 0, 1, 4
"d:\IDEWORK\lvmen\src\licensedcode\data\rules\cc-by-sa-3.0_43.yml", "YAML", 0, 0, 0, 3, 0, 0, 1, 4
"d:\IDEWORK\lvmen\src\licensedcode\data\rules\cc-by-sa-3.0_44.yml", "YAML", 0, 0, 0, 5, 0, 0, 1, 6
"d:\IDEWORK\lvmen\src\licensedcode\data\rules\cc-by-sa-3.0_45.yml", "YAML", 0, 0, 0, 5, 0, 0, 1, 6
"d:\IDEWORK\lvmen\src\licensedcode\data\rules\cc-by-sa-3.0_46.yml", "YAML", 0, 0, 0, 5, 0, 0, 1, 6
"d:\IDEWORK\lvmen\src\licensedcode\data\rules\cc-by-sa-3.0_47.yml", "YAML", 0, 0, 0, 3, 0, 0, 1, 4
"d:\IDEWORK\lvmen\src\licensedcode\data\rules\cc-by-sa-3.0_48.yml", "YAML", 0, 0, 0, 6, 0, 0, 1, 7
"d:\IDEWORK\lvmen\src\licensedcode\data\rules\cc-by-sa-3.0_49.yml", "YAML", 0, 0, 0, 5, 0, 0, 1, 6
"d:\IDEWORK\lvmen\src\licensedcode\data\rules\cc-by-sa-3.0_5.yml", "YAML", 0, 0, 0, 4, 0, 0, 1, 5
"d:\IDEWORK\lvmen\src\licensedcode\data\rules\cc-by-sa-3.0_50.yml", "YAML", 0, 0, 0, 3, 0, 0, 1, 4
"d:\IDEWORK\lvmen\src\licensedcode\data\rules\cc-by-sa-3.0_51.yml", "YAML", 0, 0, 0, 3, 0, 0, 1, 4
"d:\IDEWORK\lvmen\src\licensedcode\data\rules\cc-by-sa-3.0_52.yml", "YAML", 0, 0, 0, 3, 0, 0, 1, 4
"d:\IDEWORK\lvmen\src\licensedcode\data\rules\cc-by-sa-3.0_53.yml", "YAML", 0, 0, 0, 3, 0, 0, 1, 4
"d:\IDEWORK\lvmen\src\licensedcode\data\rules\cc-by-sa-3.0_54.yml", "YAML", 0, 0, 0, 3, 0, 0, 1, 4
"d:\IDEWORK\lvmen\src\licensedcode\data\rules\cc-by-sa-3.0_55.yml", "YAML", 0, 0, 0, 3, 0, 0, 1, 4
"d:\IDEWORK\lvmen\src\licensedcode\data\rules\cc-by-sa-3.0_56.yml", "YAML", 0, 0, 0, 3, 0, 0, 1, 4
"d:\IDEWORK\lvmen\src\licensedcode\data\rules\cc-by-sa-3.0_57.yml", "YAML", 0, 0, 0, 3, 0, 0, 1, 4
"d:\IDEWORK\lvmen\src\licensedcode\data\rules\cc-by-sa-3.0_58.yml", "YAML", 0, 0, 0, 3, 0, 0, 1, 4
"d:\IDEWORK\lvmen\src\licensedcode\data\rules\cc-by-sa-3.0_59.yml", "YAML", 0, 0, 0, 3, 0, 0, 1, 4
"d:\IDEWORK\lvmen\src\licensedcode\data\rules\cc-by-sa-3.0_6.yml", "YAML", 0, 0, 0, 4, 0, 0, 1, 5
"d:\IDEWORK\lvmen\src\licensedcode\data\rules\cc-by-sa-3.0_60.yml", "YAML", 0, 0, 0, 3, 0, 0, 1, 4
"d:\IDEWORK\lvmen\src\licensedcode\data\rules\cc-by-sa-3.0_61.yml", "YAML", 0, 0, 0, 7, 0, 0, 1, 8
"d:\IDEWORK\lvmen\src\licensedcode\data\rules\cc-by-sa-3.0_62.yml", "YAML", 0, 0, 0, 5, 0, 0, 1, 6
"d:\IDEWORK\lvmen\src\licensedcode\data\rules\cc-by-sa-3.0_63.yml", "YAML", 0, 0, 0, 5, 0, 0, 1, 6
"d:\IDEWORK\lvmen\src\licensedcode\data\rules\cc-by-sa-3.0_64.yml", "YAML", 0, 0, 0, 3, 0, 0, 1, 4
"d:\IDEWORK\lvmen\src\licensedcode\data\rules\cc-by-sa-3.0_65.yml", "YAML", 0, 0, 0, 5, 0, 0, 1, 6
"d:\IDEWORK\lvmen\src\licensedcode\data\rules\cc-by-sa-3.0_66.yml", "YAML", 0, 0, 0, 5, 0, 0, 1, 6
"d:\IDEWORK\lvmen\src\licensedcode\data\rules\cc-by-sa-3.0_67.yml", "YAML", 0, 0, 0, 5, 0, 0, 1, 6
"d:\IDEWORK\lvmen\src\licensedcode\data\rules\cc-by-sa-3.0_68.yml", "YAML", 0, 0, 0, 5, 0, 0, 1, 6
"d:\IDEWORK\lvmen\src\licensedcode\data\rules\cc-by-sa-3.0_69.yml", "YAML", 0, 0, 0, 5, 0, 0, 1, 6
"d:\IDEWORK\lvmen\src\licensedcode\data\rules\cc-by-sa-3.0_7.yml", "YAML", 0, 0, 0, 5, 0, 0, 1, 6
"d:\IDEWORK\lvmen\src\licensedcode\data\rules\cc-by-sa-3.0_70.yml", "YAML", 0, 0, 0, 5, 0, 0, 1, 6
"d:\IDEWORK\lvmen\src\licensedcode\data\rules\cc-by-sa-3.0_71.yml", "YAML", 0, 0, 0, 5, 0, 0, 1, 6
"d:\IDEWORK\lvmen\src\licensedcode\data\rules\cc-by-sa-3.0_72.yml", "YAML", 0, 0, 0, 3, 0, 0, 1, 4
"d:\IDEWORK\lvmen\src\licensedcode\data\rules\cc-by-sa-3.0_73.yml", "YAML", 0, 0, 0, 3, 0, 0, 1, 4
"d:\IDEWORK\lvmen\src\licensedcode\data\rules\cc-by-sa-3.0_74.yml", "YAML", 0, 0, 0, 3, 0, 0, 1, 4
"d:\IDEWORK\lvmen\src\licensedcode\data\rules\cc-by-sa-3.0_75.yml", "YAML", 0, 0, 0, 3, 0, 0, 1, 4
"d:\IDEWORK\lvmen\src\licensedcode\data\rules\cc-by-sa-3.0_76.yml", "YAML", 0, 0, 0, 3, 0, 0, 1, 4
"d:\IDEWORK\lvmen\src\licensedcode\data\rules\cc-by-sa-3.0_77.yml", "YAML", 0, 0, 0, 3, 0, 0, 1, 4
"d:\IDEWORK\lvmen\src\licensedcode\data\rules\cc-by-sa-3.0_78.yml", "YAML", 0, 0, 0, 3, 0, 0, 1, 4
"d:\IDEWORK\lvmen\src\licensedcode\data\rules\cc-by-sa-3.0_79.yml", "YAML", 0, 0, 0, 3, 0, 0, 1, 4
"d:\IDEWORK\lvmen\src\licensedcode\data\rules\cc-by-sa-3.0_8.yml", "YAML", 0, 0, 0, 3, 0, 0, 1, 4
"d:\IDEWORK\lvmen\src\licensedcode\data\rules\cc-by-sa-3.0_80.yml", "YAML", 0, 0, 0, 5, 0, 0, 1, 6
"d:\IDEWORK\lvmen\src\licensedcode\data\rules\cc-by-sa-3.0_81.yml", "YAML", 0, 0, 0, 4, 0, 0, 1, 5
"d:\IDEWORK\lvmen\src\licensedcode\data\rules\cc-by-sa-3.0_82.yml", "YAML", 0, 0, 0, 5, 0, 0, 1, 6
"d:\IDEWORK\lvmen\src\licensedcode\data\rules\cc-by-sa-3.0_83.yml", "YAML", 0, 0, 0, 3, 0, 0, 1, 4
"d:\IDEWORK\lvmen\src\licensedcode\data\rules\cc-by-sa-3.0_84.yml", "YAML", 0, 0, 0, 3, 0, 0, 1, 4
"d:\IDEWORK\lvmen\src\licensedcode\data\rules\cc-by-sa-3.0_85.yml", "YAML", 0, 0, 0, 4, 0, 0, 1, 5
"d:\IDEWORK\lvmen\src\licensedcode\data\rules\cc-by-sa-3.0_86.yml", "YAML", 0, 0, 0, 5, 0, 0, 1, 6
"d:\IDEWORK\lvmen\src\licensedcode\data\rules\cc-by-sa-3.0_87.yml", "YAML", 0, 0, 0, 3, 0, 0, 1, 4
"d:\IDEWORK\lvmen\src\licensedcode\data\rules\cc-by-sa-3.0_88.yml", "YAML", 0, 0, 0, 3, 0, 0, 1, 4
"d:\IDEWORK\lvmen\src\licensedcode\data\rules\cc-by-sa-3.0_89.yml", "YAML", 0, 0, 0, 4, 0, 0, 1, 5
"d:\IDEWORK\lvmen\src\licensedcode\data\rules\cc-by-sa-3.0_9.yml", "YAML", 0, 0, 0, 5, 0, 0, 1, 6
"d:\IDEWORK\lvmen\src\licensedcode\data\rules\cc-by-sa-3.0_licensebutton.yml", "YAML", 0, 0, 0, 5, 0, 0, 1, 6
"d:\IDEWORK\lvmen\src\licensedcode\data\rules\cc-by-sa-3.0_or_gfdl-1.2-plus_or_gpl-3.0-plus_1.yml", "YAML", 0, 0, 0, 4, 0, 0, 1, 5
"d:\IDEWORK\lvmen\src\licensedcode\data\rules\cc-by-sa-3.0_or_lgpl-2.0-plus_1.yml", "YAML", 0, 0, 0, 3, 0, 0, 1, 4
"d:\IDEWORK\lvmen\src\licensedcode\data\rules\cc-by-sa-3.0_or_lgpl-2.0-plus_2.yml", "YAML", 0, 0, 0, 3, 0, 0, 1, 4
"d:\IDEWORK\lvmen\src\licensedcode\data\rules\cc-by-sa-3.0_url_1.yml", "YAML", 0, 0, 0, 5, 0, 0, 1, 6
"d:\IDEWORK\lvmen\src\licensedcode\data\rules\cc-by-sa-3.0_url_2.yml", "YAML", 0, 0, 0, 5, 0, 0, 1, 6
"d:\IDEWORK\lvmen\src\licensedcode\data\rules\cc-by-sa-3.0_url_glc_49.yml", "YAML", 0, 0, 0, 5, 0, 0, 1, 6
"d:\IDEWORK\lvmen\src\licensedcode\data\rules\cc-by-sa-4.0.SPDX.yml", "YAML", 0, 0, 0, 4, 0, 0, 1, 5
"d:\IDEWORK\lvmen\src\licensedcode\data\rules\cc-by-sa-4.0.yml", "YAML", 0, 0, 0, 2, 0, 0, 1, 3
"d:\IDEWORK\lvmen\src\licensedcode\data\rules\cc-by-sa-4.0_1.yml", "YAML", 0, 0, 0, 6, 0, 0, 1, 7
"d:\IDEWORK\lvmen\src\licensedcode\data\rules\cc-by-sa-4.0_10.yml", "YAML", 0, 0, 0, 4, 0, 0, 1, 5
"d:\IDEWORK\lvmen\src\licensedcode\data\rules\cc-by-sa-4.0_11.yml", "YAML", 0, 0, 0, 2, 0, 0, 1, 3
"d:\IDEWORK\lvmen\src\licensedcode\data\rules\cc-by-sa-4.0_12.yml", "YAML", 0, 0, 0, 5, 0, 0, 1, 6
"d:\IDEWORK\lvmen\src\licensedcode\data\rules\cc-by-sa-4.0_13.yml", "YAML", 0, 0, 0, 5, 0, 0, 1, 6
"d:\IDEWORK\lvmen\src\licensedcode\data\rules\cc-by-sa-4.0_14.yml", "YAML", 0, 0, 0, 3, 0, 0, 1, 4
"d:\IDEWORK\lvmen\src\licensedcode\data\rules\cc-by-sa-4.0_15.yml", "YAML", 0, 0, 0, 5, 0, 0, 1, 6
"d:\IDEWORK\lvmen\src\licensedcode\data\rules\cc-by-sa-4.0_16.yml", "YAML", 0, 0, 0, 5, 0, 0, 1, 6
"d:\IDEWORK\lvmen\src\licensedcode\data\rules\cc-by-sa-4.0_17.yml", "YAML", 0, 0, 0, 5, 0, 0, 1, 6
"d:\IDEWORK\lvmen\src\licensedcode\data\rules\cc-by-sa-4.0_18.yml", "YAML", 0, 0, 0, 5, 0, 0, 1, 6
"d:\IDEWORK\lvmen\src\licensedcode\data\rules\cc-by-sa-4.0_19.yml", "YAML", 0, 0, 0, 3, 0, 0, 1, 4
"d:\IDEWORK\lvmen\src\licensedcode\data\rules\cc-by-sa-4.0_2.yml", "YAML", 0, 0, 0, 3, 0, 0, 1, 4
"d:\IDEWORK\lvmen\src\licensedcode\data\rules\cc-by-sa-4.0_20.yml", "YAML", 0, 0, 0, 5, 0, 0, 1, 6
"d:\IDEWORK\lvmen\src\licensedcode\data\rules\cc-by-sa-4.0_21.yml", "YAML", 0, 0, 0, 5, 0, 0, 1, 6
"d:\IDEWORK\lvmen\src\licensedcode\data\rules\cc-by-sa-4.0_22.yml", "YAML", 0, 0, 0, 3, 0, 0, 1, 4
"d:\IDEWORK\lvmen\src\licensedcode\data\rules\cc-by-sa-4.0_23.yml", "YAML", 0, 0, 0, 3, 0, 0, 1, 4
"d:\IDEWORK\lvmen\src\licensedcode\data\rules\cc-by-sa-4.0_24.yml", "YAML", 0, 0, 0, 5, 0, 0, 1, 6
"d:\IDEWORK\lvmen\src\licensedcode\data\rules\cc-by-sa-4.0_25.yml", "YAML", 0, 0, 0, 3, 0, 0, 1, 4
"d:\IDEWORK\lvmen\src\licensedcode\data\rules\cc-by-sa-4.0_26.yml", "YAML", 0, 0, 0, 5, 0, 0, 1, 6
"d:\IDEWORK\lvmen\src\licensedcode\data\rules\cc-by-sa-4.0_27.yml", "YAML", 0, 0, 0, 5, 0, 0, 1, 6
"d:\IDEWORK\lvmen\src\licensedcode\data\rules\cc-by-sa-4.0_28.yml", "YAML", 0, 0, 0, 5, 0, 0, 1, 6
"d:\IDEWORK\lvmen\src\licensedcode\data\rules\cc-by-sa-4.0_29.yml", "YAML", 0, 0, 0, 3, 0, 0, 1, 4
"d:\IDEWORK\lvmen\src\licensedcode\data\rules\cc-by-sa-4.0_3.yml", "YAML", 0, 0, 0, 3, 0, 0, 1, 4
"d:\IDEWORK\lvmen\src\licensedcode\data\rules\cc-by-sa-4.0_30.yml", "YAML", 0, 0, 0, 3, 0, 0, 1, 4
"d:\IDEWORK\lvmen\src\licensedcode\data\rules\cc-by-sa-4.0_31.yml", "YAML", 0, 0, 0, 3, 0, 0, 1, 4
"d:\IDEWORK\lvmen\src\licensedcode\data\rules\cc-by-sa-4.0_32.yml", "YAML", 0, 0, 0, 3, 0, 0, 1, 4
"d:\IDEWORK\lvmen\src\licensedcode\data\rules\cc-by-sa-4.0_33.yml", "YAML", 0, 0, 0, 5, 0, 0, 1, 6
"d:\IDEWORK\lvmen\src\licensedcode\data\rules\cc-by-sa-4.0_34.yml", "YAML", 0, 0, 0, 5, 0, 0, 1, 6
"d:\IDEWORK\lvmen\src\licensedcode\data\rules\cc-by-sa-4.0_35.yml", "YAML", 0, 0, 0, 5, 0, 0, 1, 6
"d:\IDEWORK\lvmen\src\licensedcode\data\rules\cc-by-sa-4.0_36.yml", "YAML", 0, 0, 0, 5, 0, 0, 1, 6
"d:\IDEWORK\lvmen\src\licensedcode\data\rules\cc-by-sa-4.0_37.yml", "YAML", 0, 0, 0, 3, 0, 0, 1, 4
"d:\IDEWORK\lvmen\src\licensedcode\data\rules\cc-by-sa-4.0_38.yml", "YAML", 0, 0, 0, 5, 0, 0, 1, 6
"d:\IDEWORK\lvmen\src\licensedcode\data\rules\cc-by-sa-4.0_39.yml", "YAML", 0, 0, 0, 5, 0, 0, 1, 6
"d:\IDEWORK\lvmen\src\licensedcode\data\rules\cc-by-sa-4.0_4.yml", "YAML", 0, 0, 0, 3, 0, 0, 1, 4
"d:\IDEWORK\lvmen\src\licensedcode\data\rules\cc-by-sa-4.0_40.yml", "YAML", 0, 0, 0, 3, 0, 0, 1, 4
"d:\IDEWORK\lvmen\src\licensedcode\data\rules\cc-by-sa-4.0_41.yml", "YAML", 0, 0, 0, 5, 0, 0, 1, 6
"d:\IDEWORK\lvmen\src\licensedcode\data\rules\cc-by-sa-4.0_42.yml", "YAML", 0, 0, 0, 5, 0, 0, 1, 6
"d:\IDEWORK\lvmen\src\licensedcode\data\rules\cc-by-sa-4.0_43.yml", "YAML", 0, 0, 0, 5, 0, 0, 1, 6
"d:\IDEWORK\lvmen\src\licensedcode\data\rules\cc-by-sa-4.0_44.yml", "YAML", 0, 0, 0, 5, 0, 0, 1, 6
"d:\IDEWORK\lvmen\src\licensedcode\data\rules\cc-by-sa-4.0_45.yml", "YAML", 0, 0, 0, 3, 0, 0, 1, 4
"d:\IDEWORK\lvmen\src\licensedcode\data\rules\cc-by-sa-4.0_46.yml", "YAML", 0, 0, 0, 5, 0, 0, 1, 6
"d:\IDEWORK\lvmen\src\licensedcode\data\rules\cc-by-sa-4.0_47.yml", "YAML", 0, 0, 0, 5, 0, 0, 1, 6
"d:\IDEWORK\lvmen\src\licensedcode\data\rules\cc-by-sa-4.0_48.yml", "YAML", 0, 0, 0, 5, 0, 0, 1, 6
"d:\IDEWORK\lvmen\src\licensedcode\data\rules\cc-by-sa-4.0_49.yml", "YAML", 0, 0, 0, 5, 0, 0, 1, 6
"d:\IDEWORK\lvmen\src\licensedcode\data\rules\cc-by-sa-4.0_5.yml", "YAML", 0, 0, 0, 3, 0, 0, 1, 4
"d:\IDEWORK\lvmen\src\licensedcode\data\rules\cc-by-sa-4.0_50.yml", "YAML", 0, 0, 0, 5, 0, 0, 1, 6
"d:\IDEWORK\lvmen\src\licensedcode\data\rules\cc-by-sa-4.0_51.yml", "YAML", 0, 0, 0, 5, 0, 0, 1, 6
"d:\IDEWORK\lvmen\src\licensedcode\data\rules\cc-by-sa-4.0_52.yml", "YAML", 0, 0, 0, 5, 0, 0, 1, 6
"d:\IDEWORK\lvmen\src\licensedcode\data\rules\cc-by-sa-4.0_53.yml", "YAML", 0, 0, 0, 5, 0, 0, 1, 6
"d:\IDEWORK\lvmen\src\licensedcode\data\rules\cc-by-sa-4.0_54.yml", "YAML", 0, 0, 0, 3, 0, 0, 1, 4
"d:\IDEWORK\lvmen\src\licensedcode\data\rules\cc-by-sa-4.0_540.yml", "YAML", 0, 0, 0, 5, 0, 0, 1, 6
"d:\IDEWORK\lvmen\src\licensedcode\data\rules\cc-by-sa-4.0_55.yml", "YAML", 0, 0, 0, 5, 0, 0, 1, 6
"d:\IDEWORK\lvmen\src\licensedcode\data\rules\cc-by-sa-4.0_56.yml", "YAML", 0, 0, 0, 5, 0, 0, 1, 6
"d:\IDEWORK\lvmen\src\licensedcode\data\rules\cc-by-sa-4.0_57.yml", "YAML", 0, 0, 0, 3, 0, 0, 1, 4
"d:\IDEWORK\lvmen\src\licensedcode\data\rules\cc-by-sa-4.0_58.yml", "YAML", 0, 0, 0, 5, 0, 0, 1, 6
"d:\IDEWORK\lvmen\src\licensedcode\data\rules\cc-by-sa-4.0_59.yml", "YAML", 0, 0, 0, 5, 0, 0, 1, 6
"d:\IDEWORK\lvmen\src\licensedcode\data\rules\cc-by-sa-4.0_6.yml", "YAML", 0, 0, 0, 3, 0, 0, 1, 4
"d:\IDEWORK\lvmen\src\licensedcode\data\rules\cc-by-sa-4.0_60.yml", "YAML", 0, 0, 0, 6, 0, 0, 1, 7
"d:\IDEWORK\lvmen\src\licensedcode\data\rules\cc-by-sa-4.0_61.yml", "YAML", 0, 0, 0, 3, 0, 0, 1, 4
"d:\IDEWORK\lvmen\src\licensedcode\data\rules\cc-by-sa-4.0_62.yml", "YAML", 0, 0, 0, 3, 0, 0, 1, 4
"d:\IDEWORK\lvmen\src\licensedcode\data\rules\cc-by-sa-4.0_63.yml", "YAML", 0, 0, 0, 3, 0, 0, 1, 4
"d:\IDEWORK\lvmen\src\licensedcode\data\rules\cc-by-sa-4.0_64.yml", "YAML", 0, 0, 0, 3, 0, 0, 1, 4
"d:\IDEWORK\lvmen\src\licensedcode\data\rules\cc-by-sa-4.0_65.yml", "YAML", 0, 0, 0, 3, 0, 0, 1, 4
"d:\IDEWORK\lvmen\src\licensedcode\data\rules\cc-by-sa-4.0_66.yml", "YAML", 0, 0, 0, 3, 0, 0, 1, 4
"d:\IDEWORK\lvmen\src\licensedcode\data\rules\cc-by-sa-4.0_67.yml", "YAML", 0, 0, 0, 3, 0, 0, 1, 4
"d:\IDEWORK\lvmen\src\licensedcode\data\rules\cc-by-sa-4.0_68.yml", "YAML", 0, 0, 0, 3, 0, 0, 1, 4
"d:\IDEWORK\lvmen\src\licensedcode\data\rules\cc-by-sa-4.0_69.yml", "YAML", 0, 0, 0, 5, 0, 0, 1, 6
"d:\IDEWORK\lvmen\src\licensedcode\data\rules\cc-by-sa-4.0_7.yml", "YAML", 0, 0, 0, 3, 0, 0, 1, 4
"d:\IDEWORK\lvmen\src\licensedcode\data\rules\cc-by-sa-4.0_70.yml", "YAML", 0, 0, 0, 5, 0, 0, 1, 6
"d:\IDEWORK\lvmen\src\licensedcode\data\rules\cc-by-sa-4.0_71.yml", "YAML", 0, 0, 0, 5, 0, 0, 1, 6
"d:\IDEWORK\lvmen\src\licensedcode\data\rules\cc-by-sa-4.0_72.yml", "YAML", 0, 0, 0, 5, 0, 0, 1, 6
"d:\IDEWORK\lvmen\src\licensedcode\data\rules\cc-by-sa-4.0_73.yml", "YAML", 0, 0, 0, 3, 0, 0, 1, 4
"d:\IDEWORK\lvmen\src\licensedcode\data\rules\cc-by-sa-4.0_74.yml", "YAML", 0, 0, 0, 3, 0, 0, 1, 4
"d:\IDEWORK\lvmen\src\licensedcode\data\rules\cc-by-sa-4.0_75.yml", "YAML", 0, 0, 0, 3, 0, 0, 1, 4
"d:\IDEWORK\lvmen\src\licensedcode\data\rules\cc-by-sa-4.0_76.yml", "YAML", 0, 0, 0, 3, 0, 0, 1, 4
"d:\IDEWORK\lvmen\src\licensedcode\data\rules\cc-by-sa-4.0_77.yml", "YAML", 0, 0, 0, 3, 0, 0, 1, 4
"d:\IDEWORK\lvmen\src\licensedcode\data\rules\cc-by-sa-4.0_78.yml", "YAML", 0, 0, 0, 3, 0, 0, 1, 4
"d:\IDEWORK\lvmen\src\licensedcode\data\rules\cc-by-sa-4.0_79.yml", "YAML", 0, 0, 0, 3, 0, 0, 1, 4
"d:\IDEWORK\lvmen\src\licensedcode\data\rules\cc-by-sa-4.0_8.yml", "YAML", 0, 0, 0, 3, 0, 0, 1, 4
"d:\IDEWORK\lvmen\src\licensedcode\data\rules\cc-by-sa-4.0_80.yml", "YAML", 0, 0, 0, 3, 0, 0, 1, 4
"d:\IDEWORK\lvmen\src\licensedcode\data\rules\cc-by-sa-4.0_81.yml", "YAML", 0, 0, 0, 3, 0, 0, 1, 4
"d:\IDEWORK\lvmen\src\licensedcode\data\rules\cc-by-sa-4.0_82.yml", "YAML", 0, 0, 0, 3, 0, 0, 1, 4
"d:\IDEWORK\lvmen\src\licensedcode\data\rules\cc-by-sa-4.0_83.yml", "YAML", 0, 0, 0, 3, 0, 0, 1, 4
"d:\IDEWORK\lvmen\src\licensedcode\data\rules\cc-by-sa-4.0_84.yml", "YAML", 0, 0, 0, 3, 0, 0, 1, 4
"d:\IDEWORK\lvmen\src\licensedcode\data\rules\cc-by-sa-4.0_85.yml", "YAML", 0, 0, 0, 4, 0, 0, 1, 5
"d:\IDEWORK\lvmen\src\licensedcode\data\rules\cc-by-sa-4.0_86.yml", "YAML", 0, 0, 0, 3, 0, 0, 1, 4
"d:\IDEWORK\lvmen\src\licensedcode\data\rules\cc-by-sa-4.0_9.yml", "YAML", 0, 0, 0, 3, 0, 0, 1, 4
"d:\IDEWORK\lvmen\src\licensedcode\data\rules\cc-by-sa-4.0_and_cc-by-3.0_1.yml", "YAML", 0, 0, 0, 5, 0, 0, 1, 6
"d:\IDEWORK\lvmen\src\licensedcode\data\rules\cc-by-sa-4.0_and_gpl-1.0-plus_1.yml", "YAML", 0, 0, 0, 3, 0, 0, 1, 4
"d:\IDEWORK\lvmen\src\licensedcode\data\rules\cc-by-sa-4.0_and_url.yml", "YAML", 0, 0, 0, 5, 0, 0, 1, 6
"d:\IDEWORK\lvmen\src\licensedcode\data\rules\cc-by-sa-4.0_licensebutton.yml", "YAML", 0, 0, 0, 5, 0, 0, 1, 6
"d:\IDEWORK\lvmen\src\licensedcode\data\rules\cc-by-sa-4.0_or_cc-by-nc-sa-4.0_or_cc-by-4.0_1.yml", "YAML", 0, 0, 0, 4, 0, 0, 1, 5
"d:\IDEWORK\lvmen\src\licensedcode\data\rules\cc-by-sa-4.0_url_1.yml", "YAML", 0, 0, 0, 5, 0, 0, 1, 6
"d:\IDEWORK\lvmen\src\licensedcode\data\rules\cc-by-sa-4.0_url_2.yml", "YAML", 0, 0, 0, 5, 0, 0, 1, 6
"d:\IDEWORK\lvmen\src\licensedcode\data\rules\cc-by-sa-4.0_url_badge.yml", "YAML", 0, 0, 0, 5, 0, 0, 1, 6
"d:\IDEWORK\lvmen\src\licensedcode\data\rules\cc-by-sa-4.0_url_badge_1.yml", "YAML", 0, 0, 0, 4, 0, 0, 1, 5
"d:\IDEWORK\lvmen\src\licensedcode\data\rules\cc-by-uk-2.0-webtoolkit.yml", "YAML", 0, 0, 0, 5, 0, 0, 1, 6
"d:\IDEWORK\lvmen\src\licensedcode\data\rules\cc-by-uk-2.0-webtoolkit_1.yml", "YAML", 0, 0, 0, 6, 0, 0, 1, 7
"d:\IDEWORK\lvmen\src\licensedcode\data\rules\cc-by-uk-2.0-webtoolkit_2.yml", "YAML", 0, 0, 0, 5, 0, 0, 1, 6
"d:\IDEWORK\lvmen\src\licensedcode\data\rules\cc-devnations-2.0_1.yml", "YAML", 0, 0, 0, 5, 0, 0, 1, 6
"d:\IDEWORK\lvmen\src\licensedcode\data\rules\cc-devnations-2.0_2.yml", "YAML", 0, 0, 0, 5, 0, 0, 1, 6
"d:\IDEWORK\lvmen\src\licensedcode\data\rules\cc-devnations-2.0_3.yml", "YAML", 0, 0, 0, 5, 0, 0, 1, 6
"d:\IDEWORK\lvmen\src\licensedcode\data\rules\cc-devnations-2.0_4.yml", "YAML", 0, 0, 0, 5, 0, 0, 1, 6
"d:\IDEWORK\lvmen\src\licensedcode\data\rules\cc-pd_1.yml", "YAML", 0, 0, 0, 5, 0, 0, 1, 6
"d:\IDEWORK\lvmen\src\licensedcode\data\rules\cc-pd_10.yml", "YAML", 0, 0, 0, 2, 0, 0, 1, 3
"d:\IDEWORK\lvmen\src\licensedcode\data\rules\cc-pd_11.yml", "YAML", 0, 0, 0, 5, 0, 0, 1, 6
"d:\IDEWORK\lvmen\src\licensedcode\data\rules\cc-pd_12.yml", "YAML", 0, 0, 0, 5, 0, 0, 1, 6
"d:\IDEWORK\lvmen\src\licensedcode\data\rules\cc-pd_13.yml", "YAML", 0, 0, 0, 5, 0, 0, 1, 6
"d:\IDEWORK\lvmen\src\licensedcode\data\rules\cc-pd_14.yml", "YAML", 0, 0, 0, 8, 0, 0, 1, 9
"d:\IDEWORK\lvmen\src\licensedcode\data\rules\cc-pd_15.yml", "YAML", 0, 0, 0, 3, 0, 0, 1, 4
"d:\IDEWORK\lvmen\src\licensedcode\data\rules\cc-pd_16.yml", "YAML", 0, 0, 0, 4, 0, 0, 1, 5
"d:\IDEWORK\lvmen\src\licensedcode\data\rules\cc-pd_2.yml", "YAML", 0, 0, 0, 5, 0, 0, 1, 6
"d:\IDEWORK\lvmen\src\licensedcode\data\rules\cc-pd_2002_1.yml", "YAML", 0, 0, 0, 4, 0, 0, 1, 5
"d:\IDEWORK\lvmen\src\licensedcode\data\rules\cc-pd_2004_1.yml", "YAML", 0, 0, 0, 2, 0, 0, 1, 3
"d:\IDEWORK\lvmen\src\licensedcode\data\rules\cc-pd_3.yml", "YAML", 0, 0, 0, 4, 0, 0, 1, 5
"d:\IDEWORK\lvmen\src\licensedcode\data\rules\cc-pd_4.yml", "YAML", 0, 0, 0, 5, 0, 0, 1, 6
"d:\IDEWORK\lvmen\src\licensedcode\data\rules\cc-pd_5.yml", "YAML", 0, 0, 0, 4, 0, 0, 1, 5
"d:\IDEWORK\lvmen\src\licensedcode\data\rules\cc-pd_6.yml", "YAML", 0, 0, 0, 4, 0, 0, 1, 5
"d:\IDEWORK\lvmen\src\licensedcode\data\rules\cc-pd_7.yml", "YAML", 0, 0, 0, 5, 0, 0, 1, 6
"d:\IDEWORK\lvmen\src\licensedcode\data\rules\cc-pd_8.yml", "YAML", 0, 0, 0, 5, 0, 0, 1, 6
"d:\IDEWORK\lvmen\src\licensedcode\data\rules\cc-pd_9.yml", "YAML", 0, 0, 0, 8, 0, 0, 1, 9
"d:\IDEWORK\lvmen\src\licensedcode\data\rules\cc-pd_pom.yml", "YAML", 0, 0, 0, 5, 0, 0, 1, 6
"d:\IDEWORK\lvmen\src\licensedcode\data\rules\cc-pd_pom2.yml", "YAML", 0, 0, 0, 5, 0, 0, 1, 6
"d:\IDEWORK\lvmen\src\licensedcode\data\rules\cc-pd_url_1.yml", "YAML", 0, 0, 0, 5, 0, 0, 1, 6
"d:\IDEWORK\lvmen\src\licensedcode\data\rules\cc-pd_url_2.yml", "YAML", 0, 0, 0, 5, 0, 0, 1, 6
"d:\IDEWORK\lvmen\src\licensedcode\data\rules\cc-pdm-1.0_1.yml", "YAML", 0, 0, 0, 4, 0, 0, 1, 5
"d:\IDEWORK\lvmen\src\licensedcode\data\rules\cc-pdm-1.0_2.yml", "YAML", 0, 0, 0, 4, 0, 0, 1, 5
"d:\IDEWORK\lvmen\src\licensedcode\data\rules\cc-sampling-1.0_1.yml", "YAML", 0, 0, 0, 5, 0, 0, 1, 6
"d:\IDEWORK\lvmen\src\licensedcode\data\rules\cc-sampling-plus-1.0_1.yml", "YAML", 0, 0, 0, 5, 0, 0, 1, 6
"d:\IDEWORK\lvmen\src\licensedcode\data\rules\cc-sampling-plus-1.0_2.yml", "YAML", 0, 0, 0, 5, 0, 0, 1, 6
"d:\IDEWORK\lvmen\src\licensedcode\data\rules\cc-sampling-plus-1.0_3.yml", "YAML", 0, 0, 0, 3, 0, 0, 1, 4
"d:\IDEWORK\lvmen\src\licensedcode\data\rules\cc-sampling-plus-1.0_4.yml", "YAML", 0, 0, 0, 5, 0, 0, 1, 6
"d:\IDEWORK\lvmen\src\licensedcode\data\rules\cc-sampling-plus-1.0_5.yml", "YAML", 0, 0, 0, 3, 0, 0, 1, 4
"d:\IDEWORK\lvmen\src\licensedcode\data\rules\cc-sampling-plus-1.0_6.yml", "YAML", 0, 0, 0, 3, 0, 0, 1, 4
"d:\IDEWORK\lvmen\src\licensedcode\data\rules\cc0-1.0.SPDX.yml", "YAML", 0, 0, 0, 4, 0, 0, 1, 5
"d:\IDEWORK\lvmen\src\licensedcode\data\rules\cc0-1.0.yml", "YAML", 0, 0, 0, 5, 0, 0, 1, 6
"d:\IDEWORK\lvmen\src\licensedcode\data\rules\cc0-1.0_1.yml", "YAML", 0, 0, 0, 5, 0, 0, 1, 6
"d:\IDEWORK\lvmen\src\licensedcode\data\rules\cc0-1.0_10.yml", "YAML", 0, 0, 0, 5, 0, 0, 1, 6
"d:\IDEWORK\lvmen\src\licensedcode\data\rules\cc0-1.0_100.yml", "YAML", 0, 0, 0, 5, 0, 0, 1, 6
"d:\IDEWORK\lvmen\src\licensedcode\data\rules\cc0-1.0_101.yml", "YAML", 0, 0, 0, 5, 0, 0, 1, 6
"d:\IDEWORK\lvmen\src\licensedcode\data\rules\cc0-1.0_102.yml", "YAML", 0, 0, 0, 3, 0, 0, 1, 4
"d:\IDEWORK\lvmen\src\licensedcode\data\rules\cc0-1.0_103.yml", "YAML", 0, 0, 0, 5, 0, 0, 1, 6
"d:\IDEWORK\lvmen\src\licensedcode\data\rules\cc0-1.0_104.yml", "YAML", 0, 0, 0, 4, 0, 0, 1, 5
"d:\IDEWORK\lvmen\src\licensedcode\data\rules\cc0-1.0_105.yml", "YAML", 0, 0, 0, 5, 0, 0, 1, 6
"d:\IDEWORK\lvmen\src\licensedcode\data\rules\cc0-1.0_106.yml", "YAML", 0, 0, 0, 3, 0, 0, 1, 4
"d:\IDEWORK\lvmen\src\licensedcode\data\rules\cc0-1.0_107.yml", "YAML", 0, 0, 0, 3, 0, 0, 1, 4
"d:\IDEWORK\lvmen\src\licensedcode\data\rules\cc0-1.0_108.yml", "YAML", 0, 0, 0, 5, 0, 0, 1, 6
"d:\IDEWORK\lvmen\src\licensedcode\data\rules\cc0-1.0_109.yml", "YAML", 0, 0, 0, 5, 0, 0, 1, 6
"d:\IDEWORK\lvmen\src\licensedcode\data\rules\cc0-1.0_11.yml", "YAML", 0, 0, 0, 2, 0, 0, 1, 3
"d:\IDEWORK\lvmen\src\licensedcode\data\rules\cc0-1.0_110.yml", "YAML", 0, 0, 0, 5, 0, 0, 1, 6
"d:\IDEWORK\lvmen\src\licensedcode\data\rules\cc0-1.0_111.yml", "YAML", 0, 0, 0, 3, 0, 0, 1, 4
"d:\IDEWORK\lvmen\src\licensedcode\data\rules\cc0-1.0_112.yml", "YAML", 0, 0, 0, 4, 0, 0, 1, 5
"d:\IDEWORK\lvmen\src\licensedcode\data\rules\cc0-1.0_113.yml", "YAML", 0, 0, 0, 5, 0, 0, 1, 6
"d:\IDEWORK\lvmen\src\licensedcode\data\rules\cc0-1.0_114.yml", "YAML", 0, 0, 0, 3, 0, 0, 1, 4
"d:\IDEWORK\lvmen\src\licensedcode\data\rules\cc0-1.0_115.yml", "YAML", 0, 0, 0, 3, 0, 0, 1, 4
"d:\IDEWORK\lvmen\src\licensedcode\data\rules\cc0-1.0_116.yml", "YAML", 0, 0, 0, 4, 0, 0, 1, 5
"d:\IDEWORK\lvmen\src\licensedcode\data\rules\cc0-1.0_117.yml", "YAML", 0, 0, 0, 3, 0, 0, 1, 4
"d:\IDEWORK\lvmen\src\licensedcode\data\rules\cc0-1.0_118.yml", "YAML", 0, 0, 0, 5, 0, 0, 1, 6
"d:\IDEWORK\lvmen\src\licensedcode\data\rules\cc0-1.0_119.yml", "YAML", 0, 0, 0, 5, 0, 0, 1, 6
"d:\IDEWORK\lvmen\src\licensedcode\data\rules\cc0-1.0_12.yml", "YAML", 0, 0, 0, 3, 0, 0, 1, 4
"d:\IDEWORK\lvmen\src\licensedcode\data\rules\cc0-1.0_120.yml", "YAML", 0, 0, 0, 5, 0, 0, 1, 6
"d:\IDEWORK\lvmen\src\licensedcode\data\rules\cc0-1.0_121.yml", "YAML", 0, 0, 0, 5, 0, 0, 1, 6
"d:\IDEWORK\lvmen\src\licensedcode\data\rules\cc0-1.0_122.yml", "YAML", 0, 0, 0, 5, 0, 0, 1, 6
"d:\IDEWORK\lvmen\src\licensedcode\data\rules\cc0-1.0_123.yml", "YAML", 0, 0, 0, 5, 0, 0, 1, 6
"d:\IDEWORK\lvmen\src\licensedcode\data\rules\cc0-1.0_124.yml", "YAML", 0, 0, 0, 5, 0, 0, 1, 6
"d:\IDEWORK\lvmen\src\licensedcode\data\rules\cc0-1.0_125.yml", "YAML", 0, 0, 0, 5, 0, 0, 1, 6
"d:\IDEWORK\lvmen\src\licensedcode\data\rules\cc0-1.0_126.yml", "YAML", 0, 0, 0, 5, 0, 0, 1, 6
"d:\IDEWORK\lvmen\src\licensedcode\data\rules\cc0-1.0_127.yml", "YAML", 0, 0, 0, 5, 0, 0, 1, 6
"d:\IDEWORK\lvmen\src\licensedcode\data\rules\cc0-1.0_128.yml", "YAML", 0, 0, 0, 4, 0, 0, 1, 5
"d:\IDEWORK\lvmen\src\licensedcode\data\rules\cc0-1.0_129.yml", "YAML", 0, 0, 0, 5, 0, 0, 1, 6
"d:\IDEWORK\lvmen\src\licensedcode\data\rules\cc0-1.0_13.yml", "YAML", 0, 0, 0, 5, 0, 0, 1, 6
"d:\IDEWORK\lvmen\src\licensedcode\data\rules\cc0-1.0_130.yml", "YAML", 0, 0, 0, 3, 0, 0, 1, 4
"d:\IDEWORK\lvmen\src\licensedcode\data\rules\cc0-1.0_131.yml", "YAML", 0, 0, 0, 5, 0, 0, 1, 6
"d:\IDEWORK\lvmen\src\licensedcode\data\rules\cc0-1.0_132.yml", "YAML", 0, 0, 0, 5, 0, 0, 1, 6
"d:\IDEWORK\lvmen\src\licensedcode\data\rules\cc0-1.0_133.yml", "YAML", 0, 0, 0, 3, 0, 0, 1, 4
"d:\IDEWORK\lvmen\src\licensedcode\data\rules\cc0-1.0_134.yml", "YAML", 0, 0, 0, 3, 0, 0, 1, 4
"d:\IDEWORK\lvmen\src\licensedcode\data\rules\cc0-1.0_135.yml", "YAML", 0, 0, 0, 3, 0, 0, 1, 4
"d:\IDEWORK\lvmen\src\licensedcode\data\rules\cc0-1.0_136.yml", "YAML", 0, 0, 0, 3, 0, 0, 1, 4
"d:\IDEWORK\lvmen\src\licensedcode\data\rules\cc0-1.0_137.yml", "YAML", 0, 0, 0, 7, 0, 0, 1, 8
"d:\IDEWORK\lvmen\src\licensedcode\data\rules\cc0-1.0_138.yml", "YAML", 0, 0, 0, 4, 0, 0, 1, 5
"d:\IDEWORK\lvmen\src\licensedcode\data\rules\cc0-1.0_139.yml", "YAML", 0, 0, 0, 3, 0, 0, 1, 4
"d:\IDEWORK\lvmen\src\licensedcode\data\rules\cc0-1.0_14.yml", "YAML", 0, 0, 0, 3, 0, 0, 1, 4
"d:\IDEWORK\lvmen\src\licensedcode\data\rules\cc0-1.0_140.yml", "YAML", 0, 0, 0, 3, 0, 0, 1, 4
"d:\IDEWORK\lvmen\src\licensedcode\data\rules\cc0-1.0_141.yml", "YAML", 0, 0, 0, 4, 0, 0, 1, 5
"d:\IDEWORK\lvmen\src\licensedcode\data\rules\cc0-1.0_142.yml", "YAML", 0, 0, 0, 5, 0, 0, 1, 6
"d:\IDEWORK\lvmen\src\licensedcode\data\rules\cc0-1.0_143.yml", "YAML", 0, 0, 0, 5, 0, 0, 1, 6
"d:\IDEWORK\lvmen\src\licensedcode\data\rules\cc0-1.0_144.yml", "YAML", 0, 0, 0, 3, 0, 0, 1, 4
"d:\IDEWORK\lvmen\src\licensedcode\data\rules\cc0-1.0_145.yml", "YAML", 0, 0, 0, 4, 0, 0, 1, 5
"d:\IDEWORK\lvmen\src\licensedcode\data\rules\cc0-1.0_146.yml", "YAML", 0, 0, 0, 7, 0, 0, 1, 8
"d:\IDEWORK\lvmen\src\licensedcode\data\rules\cc0-1.0_147.yml", "YAML", 0, 0, 0, 2, 0, 0, 1, 3
"d:\IDEWORK\lvmen\src\licensedcode\data\rules\cc0-1.0_148.yml", "YAML", 0, 0, 0, 6, 0, 0, 1, 7
"d:\IDEWORK\lvmen\src\licensedcode\data\rules\cc0-1.0_149.yml", "YAML", 0, 0, 0, 5, 0, 0, 1, 6
"d:\IDEWORK\lvmen\src\licensedcode\data\rules\cc0-1.0_15.yml", "YAML", 0, 0, 0, 4, 0, 0, 1, 5
"d:\IDEWORK\lvmen\src\licensedcode\data\rules\cc0-1.0_150.yml", "YAML", 0, 0, 0, 6, 0, 0, 1, 7
"d:\IDEWORK\lvmen\src\licensedcode\data\rules\cc0-1.0_151.yml", "YAML", 0, 0, 0, 5, 0, 0, 1, 6
"d:\IDEWORK\lvmen\src\licensedcode\data\rules\cc0-1.0_152.yml", "YAML", 0, 0, 0, 7, 0, 0, 1, 8
"d:\IDEWORK\lvmen\src\licensedcode\data\rules\cc0-1.0_153.yml", "YAML", 0, 0, 0, 6, 0, 0, 1, 7
"d:\IDEWORK\lvmen\src\licensedcode\data\rules\cc0-1.0_154.yml", "YAML", 0, 0, 0, 4, 0, 0, 1, 5
"d:\IDEWORK\lvmen\src\licensedcode\data\rules\cc0-1.0_155.yml", "YAML", 0, 0, 0, 2, 0, 0, 1, 3
"d:\IDEWORK\lvmen\src\licensedcode\data\rules\cc0-1.0_156.yml", "YAML", 0, 0, 0, 6, 0, 0, 1, 7
"d:\IDEWORK\lvmen\src\licensedcode\data\rules\cc0-1.0_157.yml", "YAML", 0, 0, 0, 5, 0, 0, 1, 6
"d:\IDEWORK\lvmen\src\licensedcode\data\rules\cc0-1.0_158.yml", "YAML", 0, 0, 0, 6, 0, 0, 1, 7
"d:\IDEWORK\lvmen\src\licensedcode\data\rules\cc0-1.0_159.yml", "YAML", 0, 0, 0, 5, 0, 0, 1, 6
"d:\IDEWORK\lvmen\src\licensedcode\data\rules\cc0-1.0_16.yml", "YAML", 0, 0, 0, 5, 0, 0, 1, 6
"d:\IDEWORK\lvmen\src\licensedcode\data\rules\cc0-1.0_160.yml", "YAML", 0, 0, 0, 7, 0, 0, 1, 8
"d:\IDEWORK\lvmen\src\licensedcode\data\rules\cc0-1.0_161.yml", "YAML", 0, 0, 0, 7, 0, 0, 1, 8
"d:\IDEWORK\lvmen\src\licensedcode\data\rules\cc0-1.0_162.yml", "YAML", 0, 0, 0, 2, 0, 0, 1, 3
"d:\IDEWORK\lvmen\src\licensedcode\data\rules\cc0-1.0_163.yml", "YAML", 0, 0, 0, 5, 0, 0, 1, 6
"d:\IDEWORK\lvmen\src\licensedcode\data\rules\cc0-1.0_17.yml", "YAML", 0, 0, 0, 5, 0, 0, 1, 6
"d:\IDEWORK\lvmen\src\licensedcode\data\rules\cc0-1.0_18.yml", "YAML", 0, 0, 0, 2, 0, 0, 1, 3
"d:\IDEWORK\lvmen\src\licensedcode\data\rules\cc0-1.0_19.yml", "YAML", 0, 0, 0, 5, 0, 0, 1, 6
"d:\IDEWORK\lvmen\src\licensedcode\data\rules\cc0-1.0_2.yml", "YAML", 0, 0, 0, 3, 0, 0, 1, 4
"d:\IDEWORK\lvmen\src\licensedcode\data\rules\cc0-1.0_20.yml", "YAML", 0, 0, 0, 4, 0, 0, 1, 5
"d:\IDEWORK\lvmen\src\licensedcode\data\rules\cc0-1.0_21.yml", "YAML", 0, 0, 0, 3, 0, 0, 1, 4
"d:\IDEWORK\lvmen\src\licensedcode\data\rules\cc0-1.0_22.yml", "YAML", 0, 0, 0, 3, 0, 0, 1, 4
"d:\IDEWORK\lvmen\src\licensedcode\data\rules\cc0-1.0_23.yml", "YAML", 0, 0, 0, 4, 0, 0, 1, 5
"d:\IDEWORK\lvmen\src\licensedcode\data\rules\cc0-1.0_24.yml", "YAML", 0, 0, 0, 5, 0, 0, 1, 6
"d:\IDEWORK\lvmen\src\licensedcode\data\rules\cc0-1.0_25.yml", "YAML", 0, 0, 0, 5, 0, 0, 1, 6
"d:\IDEWORK\lvmen\src\licensedcode\data\rules\cc0-1.0_26.yml", "YAML", 0, 0, 0, 4, 0, 0, 1, 5
"d:\IDEWORK\lvmen\src\licensedcode\data\rules\cc0-1.0_27.yml", "YAML", 0, 0, 0, 4, 0, 0, 1, 5
"d:\IDEWORK\lvmen\src\licensedcode\data\rules\cc0-1.0_28.yml", "YAML", 0, 0, 0, 4, 0, 0, 1, 5
"d:\IDEWORK\lvmen\src\licensedcode\data\rules\cc0-1.0_29.yml", "YAML", 0, 0, 0, 4, 0, 0, 1, 5
"d:\IDEWORK\lvmen\src\licensedcode\data\rules\cc0-1.0_3.yml", "YAML", 0, 0, 0, 5, 0, 0, 1, 6
"d:\IDEWORK\lvmen\src\licensedcode\data\rules\cc0-1.0_30.yml", "YAML", 0, 0, 0, 3, 0, 0, 1, 4
"d:\IDEWORK\lvmen\src\licensedcode\data\rules\cc0-1.0_31.yml", "YAML", 0, 0, 0, 5, 0, 0, 1, 6
"d:\IDEWORK\lvmen\src\licensedcode\data\rules\cc0-1.0_32.yml", "YAML", 0, 0, 0, 5, 0, 0, 1, 6
"d:\IDEWORK\lvmen\src\licensedcode\data\rules\cc0-1.0_33.yml", "YAML", 0, 0, 0, 3, 0, 0, 1, 4
"d:\IDEWORK\lvmen\src\licensedcode\data\rules\cc0-1.0_34.yml", "YAML", 0, 0, 0, 3, 0, 0, 1, 4
"d:\IDEWORK\lvmen\src\licensedcode\data\rules\cc0-1.0_35.yml", "YAML", 0, 0, 0, 3, 0, 0, 1, 4
"d:\IDEWORK\lvmen\src\licensedcode\data\rules\cc0-1.0_36.yml", "YAML", 0, 0, 0, 3, 0, 0, 1, 4
"d:\IDEWORK\lvmen\src\licensedcode\data\rules\cc0-1.0_37.yml", "YAML", 0, 0, 0, 2, 0, 0, 1, 3
"d:\IDEWORK\lvmen\src\licensedcode\data\rules\cc0-1.0_38.yml", "YAML", 0, 0, 0, 5, 0, 0, 1, 6
"d:\IDEWORK\lvmen\src\licensedcode\data\rules\cc0-1.0_39.yml", "YAML", 0, 0, 0, 5, 0, 0, 1, 6
"d:\IDEWORK\lvmen\src\licensedcode\data\rules\cc0-1.0_4.yml", "YAML", 0, 0, 0, 2, 0, 0, 1, 3
"d:\IDEWORK\lvmen\src\licensedcode\data\rules\cc0-1.0_40.yml", "YAML", 0, 0, 0, 5, 0, 0, 1, 6
"d:\IDEWORK\lvmen\src\licensedcode\data\rules\cc0-1.0_41.yml", "YAML", 0, 0, 0, 5, 0, 0, 1, 6
"d:\IDEWORK\lvmen\src\licensedcode\data\rules\cc0-1.0_42.yml", "YAML", 0, 0, 0, 5, 0, 0, 1, 6
"d:\IDEWORK\lvmen\src\licensedcode\data\rules\cc0-1.0_43.yml", "YAML", 0, 0, 0, 5, 0, 0, 1, 6
"d:\IDEWORK\lvmen\src\licensedcode\data\rules\cc0-1.0_44.yml", "YAML", 0, 0, 0, 5, 0, 0, 1, 6
"d:\IDEWORK\lvmen\src\licensedcode\data\rules\cc0-1.0_45.yml", "YAML", 0, 0, 0, 5, 0, 0, 1, 6
"d:\IDEWORK\lvmen\src\licensedcode\data\rules\cc0-1.0_46.yml", "YAML", 0, 0, 0, 5, 0, 0, 1, 6
"d:\IDEWORK\lvmen\src\licensedcode\data\rules\cc0-1.0_47.yml", "YAML", 0, 0, 0, 5, 0, 0, 1, 6
"d:\IDEWORK\lvmen\src\licensedcode\data\rules\cc0-1.0_48.yml", "YAML", 0, 0, 0, 5, 0, 0, 1, 6
"d:\IDEWORK\lvmen\src\licensedcode\data\rules\cc0-1.0_49.yml", "YAML", 0, 0, 0, 5, 0, 0, 1, 6
"d:\IDEWORK\lvmen\src\licensedcode\data\rules\cc0-1.0_5.yml", "YAML", 0, 0, 0, 4, 0, 0, 1, 5
"d:\IDEWORK\lvmen\src\licensedcode\data\rules\cc0-1.0_50.yml", "YAML", 0, 0, 0, 5, 0, 0, 1, 6
"d:\IDEWORK\lvmen\src\licensedcode\data\rules\cc0-1.0_51.yml", "YAML", 0, 0, 0, 5, 0, 0, 1, 6
"d:\IDEWORK\lvmen\src\licensedcode\data\rules\cc0-1.0_52.yml", "YAML", 0, 0, 0, 5, 0, 0, 1, 6
"d:\IDEWORK\lvmen\src\licensedcode\data\rules\cc0-1.0_53.yml", "YAML", 0, 0, 0, 5, 0, 0, 1, 6
"d:\IDEWORK\lvmen\src\licensedcode\data\rules\cc0-1.0_54.yml", "YAML", 0, 0, 0, 5, 0, 0, 1, 6
"d:\IDEWORK\lvmen\src\licensedcode\data\rules\cc0-1.0_55.yml", "YAML", 0, 0, 0, 3, 0, 0, 1, 4
"d:\IDEWORK\lvmen\src\licensedcode\data\rules\cc0-1.0_56.yml", "YAML", 0, 0, 0, 5, 0, 0, 1, 6
"d:\IDEWORK\lvmen\src\licensedcode\data\rules\cc0-1.0_57.yml", "YAML", 0, 0, 0, 3, 0, 0, 1, 4
"d:\IDEWORK\lvmen\src\licensedcode\data\rules\cc0-1.0_58.yml", "YAML", 0, 0, 0, 3, 0, 0, 1, 4
"d:\IDEWORK\lvmen\src\licensedcode\data\rules\cc0-1.0_59.yml", "YAML", 0, 0, 0, 3, 0, 0, 1, 4
"d:\IDEWORK\lvmen\src\licensedcode\data\rules\cc0-1.0_6.yml", "YAML", 0, 0, 0, 4, 0, 0, 1, 5
"d:\IDEWORK\lvmen\src\licensedcode\data\rules\cc0-1.0_60.yml", "YAML", 0, 0, 0, 3, 0, 0, 1, 4
"d:\IDEWORK\lvmen\src\licensedcode\data\rules\cc0-1.0_61.yml", "YAML", 0, 0, 0, 3, 0, 0, 1, 4
"d:\IDEWORK\lvmen\src\licensedcode\data\rules\cc0-1.0_62.yml", "YAML", 0, 0, 0, 5, 0, 0, 1, 6
"d:\IDEWORK\lvmen\src\licensedcode\data\rules\cc0-1.0_63.yml", "YAML", 0, 0, 0, 3, 0, 0, 1, 4
"d:\IDEWORK\lvmen\src\licensedcode\data\rules\cc0-1.0_64.yml", "YAML", 0, 0, 0, 5, 0, 0, 1, 6
"d:\IDEWORK\lvmen\src\licensedcode\data\rules\cc0-1.0_65.yml", "YAML", 0, 0, 0, 5, 0, 0, 1, 6
"d:\IDEWORK\lvmen\src\licensedcode\data\rules\cc0-1.0_66.yml", "YAML", 0, 0, 0, 3, 0, 0, 1, 4
"d:\IDEWORK\lvmen\src\licensedcode\data\rules\cc0-1.0_67.yml", "YAML", 0, 0, 0, 3, 0, 0, 1, 4
"d:\IDEWORK\lvmen\src\licensedcode\data\rules\cc0-1.0_68.yml", "YAML", 0, 0, 0, 5, 0, 0, 1, 6
"d:\IDEWORK\lvmen\src\licensedcode\data\rules\cc0-1.0_69.yml", "YAML", 0, 0, 0, 3, 0, 0, 1, 4
"d:\IDEWORK\lvmen\src\licensedcode\data\rules\cc0-1.0_7.yml", "YAML", 0, 0, 0, 2, 0, 0, 1, 3
"d:\IDEWORK\lvmen\src\licensedcode\data\rules\cc0-1.0_70.yml", "YAML", 0, 0, 0, 3, 0, 0, 1, 4
"d:\IDEWORK\lvmen\src\licensedcode\data\rules\cc0-1.0_71.yml", "YAML", 0, 0, 0, 6, 0, 0, 1, 7
"d:\IDEWORK\lvmen\src\licensedcode\data\rules\cc0-1.0_72.yml", "YAML", 0, 0, 0, 3, 0, 0, 1, 4
"d:\IDEWORK\lvmen\src\licensedcode\data\rules\cc0-1.0_73.yml", "YAML", 0, 0, 0, 3, 0, 0, 1, 4
"d:\IDEWORK\lvmen\src\licensedcode\data\rules\cc0-1.0_74.yml", "YAML", 0, 0, 0, 5, 0, 0, 1, 6
"d:\IDEWORK\lvmen\src\licensedcode\data\rules\cc0-1.0_75.yml", "YAML", 0, 0, 0, 5, 0, 0, 1, 6
"d:\IDEWORK\lvmen\src\licensedcode\data\rules\cc0-1.0_76.yml", "YAML", 0, 0, 0, 7, 0, 0, 1, 8
"d:\IDEWORK\lvmen\src\licensedcode\data\rules\cc0-1.0_77.yml", "YAML", 0, 0, 0, 8, 0, 0, 1, 9
"d:\IDEWORK\lvmen\src\licensedcode\data\rules\cc0-1.0_78.yml", "YAML", 0, 0, 0, 4, 0, 0, 1, 5
"d:\IDEWORK\lvmen\src\licensedcode\data\rules\cc0-1.0_79.yml", "YAML", 0, 0, 0, 4, 0, 0, 1, 5
"d:\IDEWORK\lvmen\src\licensedcode\data\rules\cc0-1.0_8.yml", "YAML", 0, 0, 0, 5, 0, 0, 1, 6
"d:\IDEWORK\lvmen\src\licensedcode\data\rules\cc0-1.0_80.yml", "YAML", 0, 0, 0, 5, 0, 0, 1, 6
"d:\IDEWORK\lvmen\src\licensedcode\data\rules\cc0-1.0_81.yml", "YAML", 0, 0, 0, 6, 0, 0, 1, 7
"d:\IDEWORK\lvmen\src\licensedcode\data\rules\cc0-1.0_82.yml", "YAML", 0, 0, 0, 5, 0, 0, 1, 6
"d:\IDEWORK\lvmen\src\licensedcode\data\rules\cc0-1.0_83.yml", "YAML", 0, 0, 0, 5, 0, 0, 1, 6
"d:\IDEWORK\lvmen\src\licensedcode\data\rules\cc0-1.0_84.yml", "YAML", 0, 0, 0, 5, 0, 0, 1, 6
"d:\IDEWORK\lvmen\src\licensedcode\data\rules\cc0-1.0_85.yml", "YAML", 0, 0, 0, 5, 0, 0, 1, 6
"d:\IDEWORK\lvmen\src\licensedcode\data\rules\cc0-1.0_86.yml", "YAML", 0, 0, 0, 3, 0, 0, 1, 4
"d:\IDEWORK\lvmen\src\licensedcode\data\rules\cc0-1.0_87.yml", "YAML", 0, 0, 0, 3, 0, 0, 1, 4
"d:\IDEWORK\lvmen\src\licensedcode\data\rules\cc0-1.0_88.yml", "YAML", 0, 0, 0, 3, 0, 0, 1, 4
"d:\IDEWORK\lvmen\src\licensedcode\data\rules\cc0-1.0_89.yml", "YAML", 0, 0, 0, 3, 0, 0, 1, 4
"d:\IDEWORK\lvmen\src\licensedcode\data\rules\cc0-1.0_9.yml", "YAML", 0, 0, 0, 5, 0, 0, 1, 6
"d:\IDEWORK\lvmen\src\licensedcode\data\rules\cc0-1.0_90.yml", "YAML", 0, 0, 0, 3, 0, 0, 1, 4
"d:\IDEWORK\lvmen\src\licensedcode\data\rules\cc0-1.0_91.yml", "YAML", 0, 0, 0, 5, 0, 0, 1, 6
"d:\IDEWORK\lvmen\src\licensedcode\data\rules\cc0-1.0_92.yml", "YAML", 0, 0, 0, 3, 0, 0, 1, 4
"d:\IDEWORK\lvmen\src\licensedcode\data\rules\cc0-1.0_93.yml", "YAML", 0, 0, 0, 5, 0, 0, 1, 6
"d:\IDEWORK\lvmen\src\licensedcode\data\rules\cc0-1.0_94.yml", "YAML", 0, 0, 0, 3, 0, 0, 1, 4
"d:\IDEWORK\lvmen\src\licensedcode\data\rules\cc0-1.0_95.yml", "YAML", 0, 0, 0, 8, 0, 0, 1, 9
"d:\IDEWORK\lvmen\src\licensedcode\data\rules\cc0-1.0_96.yml", "YAML", 0, 0, 0, 3, 0, 0, 1, 4
"d:\IDEWORK\lvmen\src\licensedcode\data\rules\cc0-1.0_97.yml", "YAML", 0, 0, 0, 3, 0, 0, 1, 4
"d:\IDEWORK\lvmen\src\licensedcode\data\rules\cc0-1.0_98.yml", "YAML", 0, 0, 0, 3, 0, 0, 1, 4
"d:\IDEWORK\lvmen\src\licensedcode\data\rules\cc0-1.0_99.yml", "YAML", 0, 0, 0, 7, 0, 0, 1, 8
"d:\IDEWORK\lvmen\src\licensedcode\data\rules\cc0-1.0_and_lgpl-2.1_1.yml", "YAML", 0, 0, 0, 4, 0, 0, 1, 5
"d:\IDEWORK\lvmen\src\licensedcode\data\rules\cc0-1.0_and_proprietary-license_1.yml", "YAML", 0, 0, 0, 8, 0, 0, 1, 9
"d:\IDEWORK\lvmen\src\licensedcode\data\rules\cc0-1.0_and_proprietary-license_2.yml", "YAML", 0, 0, 0, 8, 0, 0, 1, 9
"d:\IDEWORK\lvmen\src\licensedcode\data\rules\cc0-1.0_and_proprietary-license_3.yml", "YAML", 0, 0, 0, 8, 0, 0, 1, 9
"d:\IDEWORK\lvmen\src\licensedcode\data\rules\cc0-1.0_and_proprietary-license_4.yml", "YAML", 0, 0, 0, 6, 0, 0, 1, 7
"d:\IDEWORK\lvmen\src\licensedcode\data\rules\cc0-1.0_and_proprietary-license_5.yml", "YAML", 0, 0, 0, 6, 0, 0, 1, 7
"d:\IDEWORK\lvmen\src\licensedcode\data\rules\cc0-1.0_data.yml", "YAML", 0, 0, 0, 4, 0, 0, 1, 5
"d:\IDEWORK\lvmen\src\licensedcode\data\rules\cc0-1.0_data2.yml", "YAML", 0, 0, 0, 4, 0, 0, 1, 5
"d:\IDEWORK\lvmen\src\licensedcode\data\rules\cc0-1.0_license_button.yml", "YAML", 0, 0, 0, 5, 0, 0, 1, 6
"d:\IDEWORK\lvmen\src\licensedcode\data\rules\cc0-1.0_license_button_1.yml", "YAML", 0, 0, 0, 5, 0, 0, 1, 6
"d:\IDEWORK\lvmen\src\licensedcode\data\rules\cc0-1.0_link.yml", "YAML", 0, 0, 0, 4, 0, 0, 1, 5
"d:\IDEWORK\lvmen\src\licensedcode\data\rules\cc0-1.0_link3.yml", "YAML", 0, 0, 0, 5, 0, 0, 1, 6
"d:\IDEWORK\lvmen\src\licensedcode\data\rules\cc0-1.0_mirror.yml", "YAML", 0, 0, 0, 5, 0, 0, 1, 6
"d:\IDEWORK\lvmen\src\licensedcode\data\rules\cc0-1.0_mirror3.yml", "YAML", 0, 0, 0, 5, 0, 0, 1, 6
"d:\IDEWORK\lvmen\src\licensedcode\data\rules\cc0-1.0_mirror4.yml", "YAML", 0, 0, 0, 4, 0, 0, 1, 5
"d:\IDEWORK\lvmen\src\licensedcode\data\rules\cc0-1.0_or_apache-2.0_1.yml", "YAML", 0, 0, 0, 3, 0, 0, 1, 4
"d:\IDEWORK\lvmen\src\licensedcode\data\rules\cc0-1.0_or_apache-2.0_2.yml", "YAML", 0, 0, 0, 3, 0, 0, 1, 4
"d:\IDEWORK\lvmen\src\licensedcode\data\rules\cc0-1.0_or_apache-2.0_3.yml", "YAML", 0, 0, 0, 2, 0, 0, 1, 3
"d:\IDEWORK\lvmen\src\licensedcode\data\rules\cc0-1.0_or_apache-2.0_4.yml", "YAML", 0, 0, 0, 2, 0, 0, 1, 3
"d:\IDEWORK\lvmen\src\licensedcode\data\rules\cc0-1.0_or_apache-2.0_5.yml", "YAML", 0, 0, 0, 5, 0, 0, 1, 6
"d:\IDEWORK\lvmen\src\licensedcode\data\rules\cc0-1.0_or_bsd-simplified_1.yml", "YAML", 0, 0, 0, 5, 0, 0, 1, 6
"d:\IDEWORK\lvmen\src\licensedcode\data\rules\cc0-1.0_or_mit_1.yml", "YAML", 0, 0, 0, 5, 0, 0, 1, 6
"d:\IDEWORK\lvmen\src\licensedcode\data\rules\cc0-1.0_or_openssl-ssleay_or_apache-2.0_1.yml", "YAML", 0, 0, 0, 6, 0, 0, 1, 7
"d:\IDEWORK\lvmen\src\licensedcode\data\rules\cc0-1.0_or_openssl-ssleay_or_apache-2.0_2.yml", "YAML", 0, 0, 0, 7, 0, 0, 1, 8
"d:\IDEWORK\lvmen\src\licensedcode\data\rules\cc0-1.0_or_openssl-ssleay_or_apache-2.0_3.yml", "YAML", 0, 0, 0, 3, 0, 0, 1, 4
"d:\IDEWORK\lvmen\src\licensedcode\data\rules\cc0-1.0_or_openssl-ssleay_or_apache-2.0_4.yml", "YAML", 0, 0, 0, 3, 0, 0, 1, 4
"d:\IDEWORK\lvmen\src\licensedcode\data\rules\cc0-1.0_or_openssl-ssleay_or_apache-2.0_5.yml", "YAML", 0, 0, 0, 6, 0, 0, 1, 7
"d:\IDEWORK\lvmen\src\licensedcode\data\rules\cc0-1.0_or_openssl-ssleay_or_apache-2.0_6.yml", "YAML", 0, 0, 0, 7, 0, 0, 1, 8
"d:\IDEWORK\lvmen\src\licensedcode\data\rules\cc0-1.0_or_public-domain_1.yml", "YAML", 0, 0, 0, 5, 0, 0, 1, 6
"d:\IDEWORK\lvmen\src\licensedcode\data\rules\cc0-1.0_or_public-domain_2.yml", "YAML", 0, 0, 0, 5, 0, 0, 1, 6
"d:\IDEWORK\lvmen\src\licensedcode\data\rules\cc0-1.0_or_public-domain_3.yml", "YAML", 0, 0, 0, 5, 0, 0, 1, 6
"d:\IDEWORK\lvmen\src\licensedcode\data\rules\cc0-1.0_prefix.yml", "YAML", 0, 0, 0, 2, 0, 0, 1, 3
"d:\IDEWORK\lvmen\src\licensedcode\data\rules\cc0-1.0_public-domain_142.yml", "YAML", 0, 0, 0, 5, 0, 0, 1, 6
"d:\IDEWORK\lvmen\src\licensedcode\data\rules\cc0-1.0_public-domain_143.yml", "YAML", 0, 0, 0, 5, 0, 0, 1, 6
"d:\IDEWORK\lvmen\src\licensedcode\data\rules\cc0-1.0_url_1.yml", "YAML", 0, 0, 0, 5, 0, 0, 1, 6
"d:\IDEWORK\lvmen\src\licensedcode\data\rules\cc0-1.0_url_2.yml", "YAML", 0, 0, 0, 5, 0, 0, 1, 6
"d:\IDEWORK\lvmen\src\licensedcode\data\rules\cc0-1.0_url_badge.yml", "YAML", 0, 0, 0, 4, 0, 0, 1, 5
"d:\IDEWORK\lvmen\src\licensedcode\data\rules\cc0-1.0_url_badge_1.yml", "YAML", 0, 0, 0, 5, 0, 0, 1, 6
"d:\IDEWORK\lvmen\src\licensedcode\data\rules\cc0-1.0_us_gov.yml", "YAML", 0, 0, 0, 2, 0, 0, 1, 3
"d:\IDEWORK\lvmen\src\licensedcode\data\rules\cc0-1.0_us_govt.yml", "YAML", 0, 0, 0, 5, 0, 0, 1, 6
"d:\IDEWORK\lvmen\src\licensedcode\data\rules\cddl-1.0-glassfish_1.yml", "YAML", 0, 0, 0, 4, 0, 0, 1, 5
"d:\IDEWORK\lvmen\src\licensedcode\data\rules\cddl-1.0-glassfish_2.yml", "YAML", 0, 0, 0, 4, 0, 0, 1, 5
"d:\IDEWORK\lvmen\src\licensedcode\data\rules\cddl-1.0.SPDX.yml", "YAML", 0, 0, 0, 4, 0, 0, 1, 5
"d:\IDEWORK\lvmen\src\licensedcode\data\rules\cddl-1.0.yml", "YAML", 0, 0, 0, 3, 0, 0, 1, 4
"d:\IDEWORK\lvmen\src\licensedcode\data\rules\cddl-1.0_1.yml", "YAML", 0, 0, 0, 2, 0, 0, 1, 3
"d:\IDEWORK\lvmen\src\licensedcode\data\rules\cddl-1.0_10.yml", "YAML", 0, 0, 0, 5, 0, 0, 1, 6
"d:\IDEWORK\lvmen\src\licensedcode\data\rules\cddl-1.0_11.yml", "YAML", 0, 0, 0, 3, 0, 0, 1, 4
"d:\IDEWORK\lvmen\src\licensedcode\data\rules\cddl-1.0_12.yml", "YAML", 0, 0, 0, 4, 0, 0, 1, 5
"d:\IDEWORK\lvmen\src\licensedcode\data\rules\cddl-1.0_13.yml", "YAML", 0, 0, 0, 4, 0, 0, 1, 5
"d:\IDEWORK\lvmen\src\licensedcode\data\rules\cddl-1.0_14.yml", "YAML", 0, 0, 0, 5, 0, 0, 1, 6
"d:\IDEWORK\lvmen\src\licensedcode\data\rules\cddl-1.0_15.yml", "YAML", 0, 0, 0, 2, 0, 0, 1, 3
"d:\IDEWORK\lvmen\src\licensedcode\data\rules\cddl-1.0_16.yml", "YAML", 0, 0, 0, 3, 0, 0, 1, 4
"d:\IDEWORK\lvmen\src\licensedcode\data\rules\cddl-1.0_17.yml", "YAML", 0, 0, 0, 4, 0, 0, 1, 5
"d:\IDEWORK\lvmen\src\licensedcode\data\rules\cddl-1.0_18.yml", "YAML", 0, 0, 0, 5, 0, 0, 1, 6
"d:\IDEWORK\lvmen\src\licensedcode\data\rules\cddl-1.0_19.yml", "YAML", 0, 0, 0, 5, 0, 0, 1, 6
"d:\IDEWORK\lvmen\src\licensedcode\data\rules\cddl-1.0_2.yml", "YAML", 0, 0, 0, 3, 0, 0, 1, 4
"d:\IDEWORK\lvmen\src\licensedcode\data\rules\cddl-1.0_20.yml", "YAML", 0, 0, 0, 4, 0, 0, 1, 5
"d:\IDEWORK\lvmen\src\licensedcode\data\rules\cddl-1.0_21.yml", "YAML", 0, 0, 0, 5, 0, 0, 1, 6
"d:\IDEWORK\lvmen\src\licensedcode\data\rules\cddl-1.0_22.yml", "YAML", 0, 0, 0, 3, 0, 0, 1, 4
"d:\IDEWORK\lvmen\src\licensedcode\data\rules\cddl-1.0_23.yml", "YAML", 0, 0, 0, 4, 0, 0, 1, 5
"d:\IDEWORK\lvmen\src\licensedcode\data\rules\cddl-1.0_24.yml", "YAML", 0, 0, 0, 4, 0, 0, 1, 5
"d:\IDEWORK\lvmen\src\licensedcode\data\rules\cddl-1.0_25.yml", "YAML", 0, 0, 0, 2, 0, 0, 1, 3
"d:\IDEWORK\lvmen\src\licensedcode\data\rules\cddl-1.0_26.yml", "YAML", 0, 0, 0, 4, 0, 0, 1, 5
"d:\IDEWORK\lvmen\src\licensedcode\data\rules\cddl-1.0_27.yml", "YAML", 0, 0, 0, 5, 0, 0, 1, 6
"d:\IDEWORK\lvmen\src\licensedcode\data\rules\cddl-1.0_28.yml", "YAML", 0, 0, 0, 5, 0, 0, 1, 6
"d:\IDEWORK\lvmen\src\licensedcode\data\rules\cddl-1.0_29.yml", "YAML", 0, 0, 0, 5, 0, 0, 1, 6
"d:\IDEWORK\lvmen\src\licensedcode\data\rules\cddl-1.0_3.yml", "YAML", 0, 0, 0, 5, 0, 0, 1, 6
"d:\IDEWORK\lvmen\src\licensedcode\data\rules\cddl-1.0_30.yml", "YAML", 0, 0, 0, 5, 0, 0, 1, 6
"d:\IDEWORK\lvmen\src\licensedcode\data\rules\cddl-1.0_31.yml", "YAML", 0, 0, 0, 5, 0, 0, 1, 6
"d:\IDEWORK\lvmen\src\licensedcode\data\rules\cddl-1.0_32.yml", "YAML", 0, 0, 0, 5, 0, 0, 1, 6
"d:\IDEWORK\lvmen\src\licensedcode\data\rules\cddl-1.0_33.yml", "YAML", 0, 0, 0, 3, 0, 0, 1, 4
"d:\IDEWORK\lvmen\src\licensedcode\data\rules\cddl-1.0_34.yml", "YAML", 0, 0, 0, 5, 0, 0, 1, 6
"d:\IDEWORK\lvmen\src\licensedcode\data\rules\cddl-1.0_35.yml", "YAML", 0, 0, 0, 3, 0, 0, 1, 4
"d:\IDEWORK\lvmen\src\licensedcode\data\rules\cddl-1.0_36.yml", "YAML", 0, 0, 0, 5, 0, 0, 1, 6
"d:\IDEWORK\lvmen\src\licensedcode\data\rules\cddl-1.0_37.yml", "YAML", 0, 0, 0, 3, 0, 0, 1, 4
"d:\IDEWORK\lvmen\src\licensedcode\data\rules\cddl-1.0_38.yml", "YAML", 0, 0, 0, 3, 0, 0, 1, 4
"d:\IDEWORK\lvmen\src\licensedcode\data\rules\cddl-1.0_39.yml", "YAML", 0, 0, 0, 5, 0, 0, 1, 6
"d:\IDEWORK\lvmen\src\licensedcode\data\rules\cddl-1.0_4.yml", "YAML", 0, 0, 0, 5, 0, 0, 1, 6
"d:\IDEWORK\lvmen\src\licensedcode\data\rules\cddl-1.0_40.yml", "YAML", 0, 0, 0, 5, 0, 0, 1, 6
"d:\IDEWORK\lvmen\src\licensedcode\data\rules\cddl-1.0_41.yml", "YAML", 0, 0, 0, 5, 0, 0, 1, 6
"d:\IDEWORK\lvmen\src\licensedcode\data\rules\cddl-1.0_42.yml", "YAML", 0, 0, 0, 5, 0, 0, 1, 6
"d:\IDEWORK\lvmen\src\licensedcode\data\rules\cddl-1.0_43.yml", "YAML", 0, 0, 0, 3, 0, 0, 1, 4
"d:\IDEWORK\lvmen\src\licensedcode\data\rules\cddl-1.0_44.yml", "YAML", 0, 0, 0, 5, 0, 0, 1, 6
"d:\IDEWORK\lvmen\src\licensedcode\data\rules\cddl-1.0_45.yml", "YAML", 0, 0, 0, 7, 0, 0, 1, 8
"d:\IDEWORK\lvmen\src\licensedcode\data\rules\cddl-1.0_46.yml", "YAML", 0, 0, 0, 3, 0, 0, 1, 4
"d:\IDEWORK\lvmen\src\licensedcode\data\rules\cddl-1.0_47.yml", "YAML", 0, 0, 0, 3, 0, 0, 1, 4
"d:\IDEWORK\lvmen\src\licensedcode\data\rules\cddl-1.0_48.yml", "YAML", 0, 0, 0, 6, 0, 0, 1, 7
"d:\IDEWORK\lvmen\src\licensedcode\data\rules\cddl-1.0_49.yml", "YAML", 0, 0, 0, 5, 0, 0, 1, 6
"d:\IDEWORK\lvmen\src\licensedcode\data\rules\cddl-1.0_5.yml", "YAML", 0, 0, 0, 5, 0, 0, 1, 6
"d:\IDEWORK\lvmen\src\licensedcode\data\rules\cddl-1.0_50.yml", "YAML", 0, 0, 0, 5, 0, 0, 1, 6
"d:\IDEWORK\lvmen\src\licensedcode\data\rules\cddl-1.0_51.yml", "YAML", 0, 0, 0, 3, 0, 0, 1, 4
"d:\IDEWORK\lvmen\src\licensedcode\data\rules\cddl-1.0_52.yml", "YAML", 0, 0, 0, 5, 0, 0, 1, 6
"d:\IDEWORK\lvmen\src\licensedcode\data\rules\cddl-1.0_53.yml", "YAML", 0, 0, 0, 3, 0, 0, 1, 4
"d:\IDEWORK\lvmen\src\licensedcode\data\rules\cddl-1.0_54.yml", "YAML", 0, 0, 0, 3, 0, 0, 1, 4
"d:\IDEWORK\lvmen\src\licensedcode\data\rules\cddl-1.0_55.yml", "YAML", 0, 0, 0, 3, 0, 0, 1, 4
"d:\IDEWORK\lvmen\src\licensedcode\data\rules\cddl-1.0_56.yml", "YAML", 0, 0, 0, 3, 0, 0, 1, 4
"d:\IDEWORK\lvmen\src\licensedcode\data\rules\cddl-1.0_57.yml", "YAML", 0, 0, 0, 3, 0, 0, 1, 4
"d:\IDEWORK\lvmen\src\licensedcode\data\rules\cddl-1.0_58.yml", "YAML", 0, 0, 0, 5, 0, 0, 1, 6
"d:\IDEWORK\lvmen\src\licensedcode\data\rules\cddl-1.0_59.yml", "YAML", 0, 0, 0, 5, 0, 0, 1, 6
"d:\IDEWORK\lvmen\src\licensedcode\data\rules\cddl-1.0_6.yml", "YAML", 0, 0, 0, 5, 0, 0, 1, 6
"d:\IDEWORK\lvmen\src\licensedcode\data\rules\cddl-1.0_60.yml", "YAML", 0, 0, 0, 5, 0, 0, 1, 6
"d:\IDEWORK\lvmen\src\licensedcode\data\rules\cddl-1.0_61.yml", "YAML", 0, 0, 0, 7, 0, 0, 1, 8
"d:\IDEWORK\lvmen\src\licensedcode\data\rules\cddl-1.0_62.yml", "YAML", 0, 0, 0, 3, 0, 0, 1, 4
"d:\IDEWORK\lvmen\src\licensedcode\data\rules\cddl-1.0_63.yml", "YAML", 0, 0, 0, 6, 0, 0, 1, 7
"d:\IDEWORK\lvmen\src\licensedcode\data\rules\cddl-1.0_64.yml", "YAML", 0, 0, 0, 3, 0, 0, 1, 4
"d:\IDEWORK\lvmen\src\licensedcode\data\rules\cddl-1.0_65.yml", "YAML", 0, 0, 0, 3, 0, 0, 1, 4
"d:\IDEWORK\lvmen\src\licensedcode\data\rules\cddl-1.0_66.yml", "YAML", 0, 0, 0, 4, 0, 0, 1, 5
"d:\IDEWORK\lvmen\src\licensedcode\data\rules\cddl-1.0_7.yml", "YAML", 0, 0, 0, 5, 0, 0, 1, 6
"d:\IDEWORK\lvmen\src\licensedcode\data\rules\cddl-1.0_8.yml", "YAML", 0, 0, 0, 5, 0, 0, 1, 6
"d:\IDEWORK\lvmen\src\licensedcode\data\rules\cddl-1.0_9.yml", "YAML", 0, 0, 0, 3, 0, 0, 1, 4
"d:\IDEWORK\lvmen\src\licensedcode\data\rules\cddl-1.0_or_gpl-2.0-classpath_and_apache-2.0-glassfish_1.yml", "YAML", 0, 0, 0, 5, 0, 0, 1, 6
"d:\IDEWORK\lvmen\src\licensedcode\data\rules\cddl-1.0_or_gpl-2.0-classpath_and_apache-2.0-glassfish_2.yml", "YAML", 0, 0, 0, 5, 0, 0, 1, 6
"d:\IDEWORK\lvmen\src\licensedcode\data\rules\cddl-1.0_or_gpl-2.0-glassfish.yml", "YAML", 0, 0, 0, 4, 0, 0, 1, 5
"d:\IDEWORK\lvmen\src\licensedcode\data\rules\cddl-1.0_or_gpl-2.0-plus_with_classpath-exception-2.0.yml", "YAML", 0, 0, 0, 11, 0, 0, 1, 12
"d:\IDEWORK\lvmen\src\licensedcode\data\rules\cddl-1.0_or_gpl-2.0-plus_with_classpath-exception-2.0_2.yml", "YAML", 0, 0, 0, 5, 0, 0, 1, 6
"d:\IDEWORK\lvmen\src\licensedcode\data\rules\cddl-1.0_or_gpl-2.0-plus_with_classpath-exception-2.0_3.yml", "YAML", 0, 0, 0, 5, 0, 0, 1, 6
"d:\IDEWORK\lvmen\src\licensedcode\data\rules\cddl-1.0_or_gpl-2.0.yml", "YAML", 0, 0, 0, 5, 0, 0, 1, 6
"d:\IDEWORK\lvmen\src\licensedcode\data\rules\cddl-1.0_or_gpl-2.0_1.yml", "YAML", 0, 0, 0, 4, 0, 0, 1, 5
"d:\IDEWORK\lvmen\src\licensedcode\data\rules\cddl-1.0_or_gpl-2.0_2.yml", "YAML", 0, 0, 0, 2, 0, 0, 1, 3
"d:\IDEWORK\lvmen\src\licensedcode\data\rules\cddl-1.0_or_gpl-2.0_3.yml", "YAML", 0, 0, 0, 3, 0, 0, 1, 4
"d:\IDEWORK\lvmen\src\licensedcode\data\rules\cddl-1.0_or_gpl-2.0_4.yml", "YAML", 0, 0, 0, 3, 0, 0, 1, 4
"d:\IDEWORK\lvmen\src\licensedcode\data\rules\cddl-1.0_or_gpl-2.0_with_classpath-exception-2.0_1.yml", "YAML", 0, 0, 0, 5, 0, 0, 1, 6
"d:\IDEWORK\lvmen\src\licensedcode\data\rules\cddl-1.0_or_gpl-2.0_with_classpath-exception-2.0_2.yml", "YAML", 0, 0, 0, 5, 0, 0, 1, 6
"d:\IDEWORK\lvmen\src\licensedcode\data\rules\cddl-1.0_or_gpl-2.0_with_classpath-exception-2.0_3.yml", "YAML", 0, 0, 0, 3, 0, 0, 1, 4
"d:\IDEWORK\lvmen\src\licensedcode\data\rules\cddl-1.0_or_gpl-2.0_with_classpath-exception-2.0_4.yml", "YAML", 0, 0, 0, 3, 0, 0, 1, 4
"d:\IDEWORK\lvmen\src\licensedcode\data\rules\cddl-1.0_or_gpl-2.0_with_classpath-exception-2.0_5.yml", "YAML", 0, 0, 0, 3, 0, 0, 1, 4
"d:\IDEWORK\lvmen\src\licensedcode\data\rules\cddl-1.0_or_gpl-2.0_with_classpath-exception-2.0_6.yml", "YAML", 0, 0, 0, 5, 0, 0, 1, 6
"d:\IDEWORK\lvmen\src\licensedcode\data\rules\cddl-1.0_or_gpl-2.0_with_classpath-exception-2.0_7.yml", "YAML", 0, 0, 0, 5, 0, 0, 1, 6
"d:\IDEWORK\lvmen\src\licensedcode\data\rules\cddl-1.0_or_gpl-2.0_with_classpath-exception-2.0_and_apache-2.0_1.yml", "YAML", 0, 0, 0, 5, 0, 0, 1, 6
"d:\IDEWORK\lvmen\src\licensedcode\data\rules\cddl-1.0_or_gpl-2.0_with_classpath-exception-2.0_and_apache-2.0_2.yml", "YAML", 0, 0, 0, 5, 0, 0, 1, 6
"d:\IDEWORK\lvmen\src\licensedcode\data\rules\cddl-1.0_or_lgpl-2.1-plus_1.yml", "YAML", 0, 0, 0, 3, 0, 0, 1, 4
"d:\IDEWORK\lvmen\src\licensedcode\data\rules\cddl-1.0_or_lgpl-2.1-plus_2.yml", "YAML", 0, 0, 0, 3, 0, 0, 1, 4
"d:\IDEWORK\lvmen\src\licensedcode\data\rules\cddl-1.0_or_lgpl-2.1-plus_3.yml", "YAML", 0, 0, 0, 3, 0, 0, 1, 4
"d:\IDEWORK\lvmen\src\licensedcode\data\rules\cddl-1.0_or_lgpl-2.1-plus_4.yml", "YAML", 0, 0, 0, 6, 0, 0, 1, 7
"d:\IDEWORK\lvmen\src\licensedcode\data\rules\cddl-1.0_url_1.yml", "YAML", 0, 0, 0, 5, 0, 0, 1, 6
"d:\IDEWORK\lvmen\src\licensedcode\data\rules\cddl-1.0_url_2.yml", "YAML", 0, 0, 0, 5, 0, 0, 1, 6
"d:\IDEWORK\lvmen\src\licensedcode\data\rules\cddl-1.0_url_glc_254.yml", "YAML", 0, 0, 0, 5, 0, 0, 1, 6
"d:\IDEWORK\lvmen\src\licensedcode\data\rules\cddl-1.0_url_glc_255.yml", "YAML", 0, 0, 0, 5, 0, 0, 1, 6
"d:\IDEWORK\lvmen\src\licensedcode\data\rules\cddl-1.1.yml", "YAML", 0, 0, 0, 5, 0, 0, 1, 6
"d:\IDEWORK\lvmen\src\licensedcode\data\rules\cddl-1.1_1.yml", "YAML", 0, 0, 0, 5, 0, 0, 1, 6
"d:\IDEWORK\lvmen\src\licensedcode\data\rules\cddl-1.1_10.yml", "YAML", 0, 0, 0, 5, 0, 0, 1, 6
"d:\IDEWORK\lvmen\src\licensedcode\data\rules\cddl-1.1_2.yml", "YAML", 0, 0, 0, 5, 0, 0, 1, 6
"d:\IDEWORK\lvmen\src\licensedcode\data\rules\cddl-1.1_3.yml", "YAML", 0, 0, 0, 5, 0, 0, 1, 6
"d:\IDEWORK\lvmen\src\licensedcode\data\rules\cddl-1.1_4.yml", "YAML", 0, 0, 0, 3, 0, 0, 1, 4
"d:\IDEWORK\lvmen\src\licensedcode\data\rules\cddl-1.1_5.yml", "YAML", 0, 0, 0, 3, 0, 0, 1, 4
"d:\IDEWORK\lvmen\src\licensedcode\data\rules\cddl-1.1_6.yml", "YAML", 0, 0, 0, 7, 0, 0, 1, 8
"d:\IDEWORK\lvmen\src\licensedcode\data\rules\cddl-1.1_7.yml", "YAML", 0, 0, 0, 3, 0, 0, 1, 4
"d:\IDEWORK\lvmen\src\licensedcode\data\rules\cddl-1.1_8.yml", "YAML", 0, 0, 0, 3, 0, 0, 1, 4
"d:\IDEWORK\lvmen\src\licensedcode\data\rules\cddl-1.1_9.yml", "YAML", 0, 0, 0, 3, 0, 0, 1, 4
"d:\IDEWORK\lvmen\src\licensedcode\data\rules\cddl-1.1_or_gpl-2.0-classpath-glassfish.yml", "YAML", 0, 0, 0, 4, 0, 0, 1, 5
"d:\IDEWORK\lvmen\src\licensedcode\data\rules\cddl-1.1_or_gpl-2.0-classpath_and_apache-2.0-glassfish_1.yml", "YAML", 0, 0, 0, 5, 0, 0, 1, 6
"d:\IDEWORK\lvmen\src\licensedcode\data\rules\cddl-1.1_or_gpl-2.0-classpath_and_apache-2.0-glassfish_2.yml", "YAML", 0, 0, 0, 5, 0, 0, 1, 6
"d:\IDEWORK\lvmen\src\licensedcode\data\rules\cddl-1.1_or_gpl-2.0-classpath_and_mit-glassfish.yml", "YAML", 0, 0, 0, 5, 0, 0, 1, 6
"d:\IDEWORK\lvmen\src\licensedcode\data\rules\cddl-1.1_or_gpl-2.0-classpath_and_w3c-glassfish.yml", "YAML", 0, 0, 0, 5, 0, 0, 1, 6
"d:\IDEWORK\lvmen\src\licensedcode\data\rules\cddl-1.1_or_gpl-2.0-plus_with_classpath-exception-2.0_1.yml", "YAML", 0, 0, 0, 11, 0, 0, 1, 12
"d:\IDEWORK\lvmen\src\licensedcode\data\rules\cddl-1.1_or_gpl-2.0_with_classpath-exception-2.0_1.yml", "YAML", 0, 0, 0, 4, 0, 0, 1, 5
"d:\IDEWORK\lvmen\src\licensedcode\data\rules\cddl-1.1_or_gpl-2.0_with_classpath-exception-2.0_2.yml", "YAML", 0, 0, 0, 5, 0, 0, 1, 6
"d:\IDEWORK\lvmen\src\licensedcode\data\rules\cddl-1.1_or_gpl-2.0_with_classpath-exception-2.0_3.yml", "YAML", 0, 0, 0, 5, 0, 0, 1, 6
"d:\IDEWORK\lvmen\src\licensedcode\data\rules\cddl-1.1_or_gpl-2.0_with_classpath-exception-2.0_4.yml", "YAML", 0, 0, 0, 5, 0, 0, 1, 6
"d:\IDEWORK\lvmen\src\licensedcode\data\rules\cddl-1.1_or_gpl-2.0_with_classpath-exception-2.0_5.yml", "YAML", 0, 0, 0, 5, 0, 0, 1, 6
"d:\IDEWORK\lvmen\src\licensedcode\data\rules\cddl-1.1_or_gpl-2.0_with_classpath-exception-2.0_6.yml", "YAML", 0, 0, 0, 5, 0, 0, 1, 6
"d:\IDEWORK\lvmen\src\licensedcode\data\rules\cddl-1.1_or_gpl-2.0_with_classpath-exception-2.0_7.yml", "YAML", 0, 0, 0, 5, 0, 0, 1, 6
"d:\IDEWORK\lvmen\src\licensedcode\data\rules\cddl-1.1_or_gpl-2.0_with_classpath-exception-2.0_8.yml", "YAML", 0, 0, 0, 7, 0, 0, 1, 8
"d:\IDEWORK\lvmen\src\licensedcode\data\rules\cddl-1.1_or_gpl-2.0_with_classpath-exception-2.0_and_apache-2.0_1.yml", "YAML", 0, 0, 0, 5, 0, 0, 1, 6
"d:\IDEWORK\lvmen\src\licensedcode\data\rules\cddl-1.1_or_gpl-2.0_with_classpath-exception-2.0_and_apache-2.0_2.yml", "YAML", 0, 0, 0, 5, 0, 0, 1, 6
"d:\IDEWORK\lvmen\src\licensedcode\data\rules\cddl-1.1_url_1.yml", "YAML", 0, 0, 0, 5, 0, 0, 1, 6
"d:\IDEWORK\lvmen\src\licensedcode\data\rules\cddl-1.1_url_2.yml", "YAML", 0, 0, 0, 5, 0, 0, 1, 6
"d:\IDEWORK\lvmen\src\licensedcode\data\rules\cdla-permissive-1.0_1.yml", "YAML", 0, 0, 0, 3, 0, 0, 1, 4
"d:\IDEWORK\lvmen\src\licensedcode\data\rules\cdla-permissive-1.0_2.yml", "YAML", 0, 0, 0, 3, 0, 0, 1, 4
"d:\IDEWORK\lvmen\src\licensedcode\data\rules\cdla-permissive-1.0_3.yml", "YAML", 0, 0, 0, 3, 0, 0, 1, 4
"d:\IDEWORK\lvmen\src\licensedcode\data\rules\cdla-permissive-1.0_url_1.yml", "YAML", 0, 0, 0, 5, 0, 0, 1, 6
"d:\IDEWORK\lvmen\src\licensedcode\data\rules\cdla-permissive-1.0_url_2.yml", "YAML", 0, 0, 0, 5, 0, 0, 1, 6
"d:\IDEWORK\lvmen\src\licensedcode\data\rules\cdla-sharing-1.0_url_1.yml", "YAML", 0, 0, 0, 5, 0, 0, 1, 6
"d:\IDEWORK\lvmen\src\licensedcode\data\rules\cdla-sharing-1.0_url_2.yml", "YAML", 0, 0, 0, 5, 0, 0, 1, 6
"d:\IDEWORK\lvmen\src\licensedcode\data\rules\cecill-1.0.yml", "YAML", 0, 0, 0, 5, 0, 0, 1, 6
"d:\IDEWORK\lvmen\src\licensedcode\data\rules\cecill-1.0_en.yml", "YAML", 0, 0, 0, 2, 0, 0, 1, 3
"d:\IDEWORK\lvmen\src\licensedcode\data\rules\cecill-1.0_en2.yml", "YAML", 0, 0, 0, 3, 0, 0, 1, 4
"d:\IDEWORK\lvmen\src\licensedcode\data\rules\cecill-1.0_en3.yml", "YAML", 0, 0, 0, 3, 0, 0, 1, 4
"d:\IDEWORK\lvmen\src\licensedcode\data\rules\cecill-1.0_url_1.yml", "YAML", 0, 0, 0, 5, 0, 0, 1, 6
"d:\IDEWORK\lvmen\src\licensedcode\data\rules\cecill-1.0_url_2.yml", "YAML", 0, 0, 0, 5, 0, 0, 1, 6
"d:\IDEWORK\lvmen\src\licensedcode\data\rules\cecill-1.1.SPDX.yml", "YAML", 0, 0, 0, 4, 0, 0, 1, 5
"d:\IDEWORK\lvmen\src\licensedcode\data\rules\cecill-1.1_1.yml", "YAML", 0, 0, 0, 3, 0, 0, 1, 4
"d:\IDEWORK\lvmen\src\licensedcode\data\rules\cecill-1.1_2.yml", "YAML", 0, 0, 0, 3, 0, 0, 1, 4
"d:\IDEWORK\lvmen\src\licensedcode\data\rules\cecill-1.1_3.yml", "YAML", 0, 0, 0, 5, 0, 0, 1, 6
"d:\IDEWORK\lvmen\src\licensedcode\data\rules\cecill-1.1_4.yml", "YAML", 0, 0, 0, 5, 0, 0, 1, 6
"d:\IDEWORK\lvmen\src\licensedcode\data\rules\cecill-1.1_url_1.yml", "YAML", 0, 0, 0, 5, 0, 0, 1, 6
"d:\IDEWORK\lvmen\src\licensedcode\data\rules\cecill-1.1_url_2.yml", "YAML", 0, 0, 0, 5, 0, 0, 1, 6
"d:\IDEWORK\lvmen\src\licensedcode\data\rules\cecill-2.0-fr_2.yml", "YAML", 0, 0, 0, 4, 0, 0, 1, 5
"d:\IDEWORK\lvmen\src\licensedcode\data\rules\cecill-2.0-fr_5.yml", "YAML", 0, 0, 0, 6, 0, 0, 1, 7
"d:\IDEWORK\lvmen\src\licensedcode\data\rules\cecill-2.0-fr_SPDX.yml", "YAML", 0, 0, 0, 4, 0, 0, 1, 5
"d:\IDEWORK\lvmen\src\licensedcode\data\rules\cecill-2.0.yml", "YAML", 0, 0, 0, 5, 0, 0, 1, 6
"d:\IDEWORK\lvmen\src\licensedcode\data\rules\cecill-2.0_1.yml", "YAML", 0, 0, 0, 5, 0, 0, 1, 6
"d:\IDEWORK\lvmen\src\licensedcode\data\rules\cecill-2.0_3.yml", "YAML", 0, 0, 0, 3, 0, 0, 1, 4
"d:\IDEWORK\lvmen\src\licensedcode\data\rules\cecill-2.0_4.yml", "YAML", 0, 0, 0, 5, 0, 0, 1, 6
"d:\IDEWORK\lvmen\src\licensedcode\data\rules\cecill-2.0_5.yml", "YAML", 0, 0, 0, 4, 0, 0, 1, 5
"d:\IDEWORK\lvmen\src\licensedcode\data\rules\cecill-2.0_6.yml", "YAML", 0, 0, 0, 3, 0, 0, 1, 4
"d:\IDEWORK\lvmen\src\licensedcode\data\rules\cecill-2.0_7.yml", "YAML", 0, 0, 0, 5, 0, 0, 1, 6
"d:\IDEWORK\lvmen\src\licensedcode\data\rules\cecill-2.0_8.yml", "YAML", 0, 0, 0, 7, 0, 0, 1, 8
"d:\IDEWORK\lvmen\src\licensedcode\data\rules\cecill-2.0_9.yml", "YAML", 0, 0, 0, 5, 0, 0, 1, 6
"d:\IDEWORK\lvmen\src\licensedcode\data\rules\cecill-2.0_or_cecill-c_1.yml", "YAML", 0, 0, 0, 6, 0, 0, 1, 7
"d:\IDEWORK\lvmen\src\licensedcode\data\rules\cecill-2.0_url_1.yml", "YAML", 0, 0, 0, 5, 0, 0, 1, 6
"d:\IDEWORK\lvmen\src\licensedcode\data\rules\cecill-2.0_url_2.yml", "YAML", 0, 0, 0, 5, 0, 0, 1, 6
"d:\IDEWORK\lvmen\src\licensedcode\data\rules\cecill-2.1_en.yml", "YAML", 0, 0, 0, 4, 0, 0, 1, 5
"d:\IDEWORK\lvmen\src\licensedcode\data\rules\cecill-2.1_fr_2.yml", "YAML", 0, 0, 0, 5, 0, 0, 1, 6
"d:\IDEWORK\lvmen\src\licensedcode\data\rules\cecill-2.1_url_1.yml", "YAML", 0, 0, 0, 5, 0, 0, 1, 6
"d:\IDEWORK\lvmen\src\licensedcode\data\rules\cecill-2.1_url_2.yml", "YAML", 0, 0, 0, 5, 0, 0, 1, 6
"d:\IDEWORK\lvmen\src\licensedcode\data\rules\cecill-b-fr.yml", "YAML", 0, 0, 0, 6, 0, 0, 1, 7
"d:\IDEWORK\lvmen\src\licensedcode\data\rules\cecill-b_1.yml", "YAML", 0, 0, 0, 3, 0, 0, 1, 4
"d:\IDEWORK\lvmen\src\licensedcode\data\rules\cecill-b_2.yml", "YAML", 0, 0, 0, 5, 0, 0, 1, 6
"d:\IDEWORK\lvmen\src\licensedcode\data\rules\cecill-b_3.yml", "YAML", 0, 0, 0, 5, 0, 0, 1, 6
"d:\IDEWORK\lvmen\src\licensedcode\data\rules\cecill-b_4.yml", "YAML", 0, 0, 0, 2, 0, 0, 1, 3
"d:\IDEWORK\lvmen\src\licensedcode\data\rules\cecill-b_5.yml", "YAML", 0, 0, 0, 3, 0, 0, 1, 4
"d:\IDEWORK\lvmen\src\licensedcode\data\rules\cecill-b_6.yml", "YAML", 0, 0, 0, 5, 0, 0, 1, 6
"d:\IDEWORK\lvmen\src\licensedcode\data\rules\cecill-b_url_1.yml", "YAML", 0, 0, 0, 5, 0, 0, 1, 6
"d:\IDEWORK\lvmen\src\licensedcode\data\rules\cecill-b_url_2.yml", "YAML", 0, 0, 0, 5, 0, 0, 1, 6
"d:\IDEWORK\lvmen\src\licensedcode\data\rules\cecill-c-fr.yml", "YAML", 0, 0, 0, 6, 0, 0, 1, 7
"d:\IDEWORK\lvmen\src\licensedcode\data\rules\cecill-c_1.yml", "YAML", 0, 0, 0, 2, 0, 0, 1, 3
"d:\IDEWORK\lvmen\src\licensedcode\data\rules\cecill-c_url_1.yml", "YAML", 0, 0, 0, 5, 0, 0, 1, 6
"d:\IDEWORK\lvmen\src\licensedcode\data\rules\cecill-c_url_2.yml", "YAML", 0, 0, 0, 5, 0, 0, 1, 6
"d:\IDEWORK\lvmen\src\licensedcode\data\rules\cern-ohl-1.1_1.yml", "YAML", 0, 0, 0, 6, 0, 0, 1, 7
"d:\IDEWORK\lvmen\src\licensedcode\data\rules\cern-ohl-1.1_2.yml", "YAML", 0, 0, 0, 9, 0, 0, 1, 10
"d:\IDEWORK\lvmen\src\licensedcode\data\rules\cern-ohl-1.1_url_1.yml", "YAML", 0, 0, 0, 5, 0, 0, 1, 6
"d:\IDEWORK\lvmen\src\licensedcode\data\rules\cern-ohl-1.1_url_2.yml", "YAML", 0, 0, 0, 5, 0, 0, 1, 6
"d:\IDEWORK\lvmen\src\licensedcode\data\rules\cern-ohl-1.2_1.yml", "YAML", 0, 0, 0, 5, 0, 0, 1, 6
"d:\IDEWORK\lvmen\src\licensedcode\data\rules\cern-ohl-1.2_url_1.yml", "YAML", 0, 0, 0, 5, 0, 0, 1, 6
"d:\IDEWORK\lvmen\src\licensedcode\data\rules\cern-ohl-1.2_url_2.yml", "YAML", 0, 0, 0, 5, 0, 0, 1, 6
"d:\IDEWORK\lvmen\src\licensedcode\data\rules\cern-ohl-p-2.0_1.yml", "YAML", 0, 0, 0, 7, 0, 0, 1, 8
"d:\IDEWORK\lvmen\src\licensedcode\data\rules\cern-ohl-s-2.0_1.yml", "YAML", 0, 0, 0, 7, 0, 0, 1, 8
"d:\IDEWORK\lvmen\src\licensedcode\data\rules\cern-ohl-w-2.0_1.yml", "YAML", 0, 0, 0, 7, 0, 0, 1, 8
"d:\IDEWORK\lvmen\src\licensedcode\data\rules\chicken-dl-0.2_1.yml", "YAML", 0, 0, 0, 3, 0, 0, 1, 4
"d:\IDEWORK\lvmen\src\licensedcode\data\rules\chicken-dl-0.2_2.yml", "YAML", 0, 0, 0, 3, 0, 0, 1, 4
"d:\IDEWORK\lvmen\src\licensedcode\data\rules\chris-maunder.yml", "YAML", 0, 0, 0, 5, 0, 0, 1, 6
"d:\IDEWORK\lvmen\src\licensedcode\data\rules\classpath-exception-2.0.yml", "YAML", 0, 0, 0, 3, 0, 0, 1, 4
"d:\IDEWORK\lvmen\src\licensedcode\data\rules\classpath-exception-2.0_1.yml", "YAML", 0, 0, 0, 5, 0, 0, 1, 6
"d:\IDEWORK\lvmen\src\licensedcode\data\rules\classpath-exception-2.0_2.yml", "YAML", 0, 0, 0, 5, 0, 0, 1, 6
"d:\IDEWORK\lvmen\src\licensedcode\data\rules\classpath-exception-2.0_3.yml", "YAML", 0, 0, 0, 5, 0, 0, 1, 6
"d:\IDEWORK\lvmen\src\licensedcode\data\rules\classpath-exception-2.0_4.yml", "YAML", 0, 0, 0, 3, 0, 0, 1, 4
"d:\IDEWORK\lvmen\src\licensedcode\data\rules\classpath-exception-2.0_5.yml", "YAML", 0, 0, 0, 3, 0, 0, 1, 4
"d:\IDEWORK\lvmen\src\licensedcode\data\rules\classpath-exception-2.0_6.yml", "YAML", 0, 0, 0, 3, 0, 0, 1, 4
"d:\IDEWORK\lvmen\src\licensedcode\data\rules\classpath-exception-2.0_7.yml", "YAML", 0, 0, 0, 3, 0, 0, 1, 4
"d:\IDEWORK\lvmen\src\licensedcode\data\rules\classpath-exception-2.0_8.yml", "YAML", 0, 0, 0, 5, 0, 0, 1, 6
"d:\IDEWORK\lvmen\src\licensedcode\data\rules\classpath-exception-2.0_9.yml", "YAML", 0, 0, 0, 5, 0, 0, 1, 6
"d:\IDEWORK\lvmen\src\licensedcode\data\rules\classpath-exception-2.0_url_1.yml", "YAML", 0, 0, 0, 5, 0, 0, 1, 6
"d:\IDEWORK\lvmen\src\licensedcode\data\rules\classpath-exception-2.0_url_2.yml", "YAML", 0, 0, 0, 5, 0, 0, 1, 6
"d:\IDEWORK\lvmen\src\licensedcode\data\rules\clear-bsd.SPDX.yml", "YAML", 0, 0, 0, 4, 0, 0, 1, 5
"d:\IDEWORK\lvmen\src\licensedcode\data\rules\clear-bsd_1.yml", "YAML", 0, 0, 0, 5, 0, 0, 1, 6
"d:\IDEWORK\lvmen\src\licensedcode\data\rules\clear-bsd_10.yml", "YAML", 0, 0, 0, 3, 0, 0, 1, 4
"d:\IDEWORK\lvmen\src\licensedcode\data\rules\clear-bsd_11.yml", "YAML", 0, 0, 0, 3, 0, 0, 1, 4
"d:\IDEWORK\lvmen\src\licensedcode\data\rules\clear-bsd_12.yml", "YAML", 0, 0, 0, 3, 0, 0, 1, 4
"d:\IDEWORK\lvmen\src\licensedcode\data\rules\clear-bsd_2.yml", "YAML", 0, 0, 0, 3, 0, 0, 1, 4
"d:\IDEWORK\lvmen\src\licensedcode\data\rules\clear-bsd_3.yml", "YAML", 0, 0, 0, 2, 0, 0, 1, 3
"d:\IDEWORK\lvmen\src\licensedcode\data\rules\clear-bsd_4.yml", "YAML", 0, 0, 0, 3, 0, 0, 1, 4
"d:\IDEWORK\lvmen\src\licensedcode\data\rules\clear-bsd_5.yml", "YAML", 0, 0, 0, 3, 0, 0, 2, 5
"d:\IDEWORK\lvmen\src\licensedcode\data\rules\clear-bsd_6.yml", "YAML", 0, 0, 0, 5, 0, 0, 1, 6
"d:\IDEWORK\lvmen\src\licensedcode\data\rules\clear-bsd_7.yml", "YAML", 0, 0, 0, 5, 0, 0, 1, 6
"d:\IDEWORK\lvmen\src\licensedcode\data\rules\clear-bsd_8.yml", "YAML", 0, 0, 0, 3, 0, 0, 1, 4
"d:\IDEWORK\lvmen\src\licensedcode\data\rules\clear-bsd_9.yml", "YAML", 0, 0, 0, 3, 0, 0, 1, 4
"d:\IDEWORK\lvmen\src\licensedcode\data\rules\clear-bsd_or_gpl-2.0-plus.yml", "YAML", 0, 0, 0, 3, 0, 0, 1, 4
"d:\IDEWORK\lvmen\src\licensedcode\data\rules\clear-bsd_or_gpl-2.0-plus2.yml", "YAML", 0, 0, 0, 3, 0, 0, 1, 4
"d:\IDEWORK\lvmen\src\licensedcode\data\rules\clear-bsd_url_1.yml", "YAML", 0, 0, 0, 5, 0, 0, 1, 6
"d:\IDEWORK\lvmen\src\licensedcode\data\rules\clear-bsd_url_2.yml", "YAML", 0, 0, 0, 5, 0, 0, 1, 6
"d:\IDEWORK\lvmen\src\licensedcode\data\rules\clisp-exception-2.0_url_1.yml", "YAML", 0, 0, 0, 5, 0, 0, 1, 6
"d:\IDEWORK\lvmen\src\licensedcode\data\rules\clisp-exception-2.0_url_2.yml", "YAML", 0, 0, 0, 5, 0, 0, 1, 6
"d:\IDEWORK\lvmen\src\licensedcode\data\rules\cmigemo.yml", "YAML", 0, 0, 0, 5, 0, 0, 1, 6
"d:\IDEWORK\lvmen\src\licensedcode\data\rules\cmu-computing-services_1.yml", "YAML", 0, 0, 0, 9, 0, 0, 1, 10
"d:\IDEWORK\lvmen\src\licensedcode\data\rules\cmu-simple_or_gpl-2.0-plus.yml", "YAML", 0, 0, 0, 4, 0, 0, 1, 5
"d:\IDEWORK\lvmen\src\licensedcode\data\rules\cmu-simple_or_gpl-2.0-plus_1.yml", "YAML", 0, 0, 0, 5, 0, 0, 1, 6
"d:\IDEWORK\lvmen\src\licensedcode\data\rules\cmu-template_1.yml", "YAML", 0, 0, 0, 2, 0, 0, 1, 3
"d:\IDEWORK\lvmen\src\licensedcode\data\rules\cmu-template_2.yml", "YAML", 0, 0, 0, 2, 0, 0, 1, 3
"d:\IDEWORK\lvmen\src\licensedcode\data\rules\cmu-template_3.yml", "YAML", 0, 0, 0, 4, 0, 0, 1, 5
"d:\IDEWORK\lvmen\src\licensedcode\data\rules\cmu-uc_1.yml", "YAML", 0, 0, 0, 4, 0, 0, 1, 5
"d:\IDEWORK\lvmen\src\licensedcode\data\rules\cmu-uc_10.yml", "YAML", 0, 0, 0, 4, 0, 0, 1, 5
"d:\IDEWORK\lvmen\src\licensedcode\data\rules\cmu-uc_11.yml", "YAML", 0, 0, 0, 6, 0, 0, 1, 7
"d:\IDEWORK\lvmen\src\licensedcode\data\rules\cmu-uc_12.yml", "YAML", 0, 0, 0, 3, 0, 0, 1, 4
"d:\IDEWORK\lvmen\src\licensedcode\data\rules\cmu-uc_13.yml", "YAML", 0, 0, 0, 3, 0, 0, 1, 4
"d:\IDEWORK\lvmen\src\licensedcode\data\rules\cmu-uc_14.yml", "YAML", 0, 0, 0, 3, 0, 0, 1, 4
"d:\IDEWORK\lvmen\src\licensedcode\data\rules\cmu-uc_15.yml", "YAML", 0, 0, 0, 4, 0, 0, 1, 5
"d:\IDEWORK\lvmen\src\licensedcode\data\rules\cmu-uc_2.yml", "YAML", 0, 0, 0, 5, 0, 0, 1, 6
"d:\IDEWORK\lvmen\src\licensedcode\data\rules\cmu-uc_3.yml", "YAML", 0, 0, 0, 3, 0, 0, 1, 4
"d:\IDEWORK\lvmen\src\licensedcode\data\rules\cmu-uc_4.yml", "YAML", 0, 0, 0, 3, 0, 0, 1, 4
"d:\IDEWORK\lvmen\src\licensedcode\data\rules\cmu-uc_5.yml", "YAML", 0, 0, 0, 3, 0, 0, 1, 4
"d:\IDEWORK\lvmen\src\licensedcode\data\rules\cmu-uc_6.yml", "YAML", 0, 0, 0, 4, 0, 0, 1, 5
"d:\IDEWORK\lvmen\src\licensedcode\data\rules\cmu-uc_60.yml", "YAML", 0, 0, 0, 3, 0, 0, 1, 4
"d:\IDEWORK\lvmen\src\licensedcode\data\rules\cmu-uc_7.yml", "YAML", 0, 0, 0, 4, 0, 0, 1, 5
"d:\IDEWORK\lvmen\src\licensedcode\data\rules\cmu-uc_70.yml", "YAML", 0, 0, 0, 3, 0, 0, 1, 4
"d:\IDEWORK\lvmen\src\licensedcode\data\rules\cmu-uc_8.yml", "YAML", 0, 0, 0, 4, 0, 0, 1, 5
"d:\IDEWORK\lvmen\src\licensedcode\data\rules\cmu-uc_89.yml", "YAML", 0, 0, 0, 3, 0, 0, 1, 4
"d:\IDEWORK\lvmen\src\licensedcode\data\rules\cmu-uc_9.yml", "YAML", 0, 0, 0, 4, 0, 0, 1, 5
"d:\IDEWORK\lvmen\src\licensedcode\data\rules\cmu-uc_historical_with_documentation.yml", "YAML", 0, 0, 0, 2, 0, 0, 1, 3
"d:\IDEWORK\lvmen\src\licensedcode\data\rules\cmu-uc_historical_with_documentation2.yml", "YAML", 0, 0, 0, 2, 0, 0, 1, 3
"d:\IDEWORK\lvmen\src\licensedcode\data\rules\cmu-uc_historical_with_documentation3.yml", "YAML", 0, 0, 0, 2, 0, 0, 1, 3
"d:\IDEWORK\lvmen\src\licensedcode\data\rules\cmu-uc_historical_with_documentation4.yml", "YAML", 0, 0, 0, 2, 0, 0, 1, 3
"d:\IDEWORK\lvmen\src\licensedcode\data\rules\cmu-uc_url_1.yml", "YAML", 0, 0, 0, 5, 0, 0, 1, 6
"d:\IDEWORK\lvmen\src\licensedcode\data\rules\cmu-uc_url_2.yml", "YAML", 0, 0, 0, 5, 0, 0, 1, 6
"d:\IDEWORK\lvmen\src\licensedcode\data\rules\cnri-jython_url_1.yml", "YAML", 0, 0, 0, 5, 0, 0, 1, 6
"d:\IDEWORK\lvmen\src\licensedcode\data\rules\cnri-jython_url_2.yml", "YAML", 0, 0, 0, 5, 0, 0, 1, 6
"d:\IDEWORK\lvmen\src\licensedcode\data\rules\cnri-python-1.6.1.yml", "YAML", 0, 0, 0, 9, 0, 0, 1, 10
"d:\IDEWORK\lvmen\src\licensedcode\data\rules\cnri-python-1.6.1_url_1.yml", "YAML", 0, 0, 0, 5, 0, 0, 1, 6
"d:\IDEWORK\lvmen\src\licensedcode\data\rules\cnri-python-1.6.1_url_2.yml", "YAML", 0, 0, 0, 5, 0, 0, 1, 6
"d:\IDEWORK\lvmen\src\licensedcode\data\rules\cnri-python-1.6.SPDX.yml", "YAML", 0, 0, 0, 7, 0, 0, 1, 8
"d:\IDEWORK\lvmen\src\licensedcode\data\rules\cnri-python-1.6.yml", "YAML", 0, 0, 0, 5, 0, 0, 1, 6
"d:\IDEWORK\lvmen\src\licensedcode\data\rules\cnri-python-1.6_1.yml", "YAML", 0, 0, 0, 9, 0, 0, 1, 10
"d:\IDEWORK\lvmen\src\licensedcode\data\rules\cnri-python-1.6_2.yml", "YAML", 0, 0, 0, 5, 0, 0, 1, 6
"d:\IDEWORK\lvmen\src\licensedcode\data\rules\cnri-python-1.6_3.yml", "YAML", 0, 0, 0, 5, 0, 0, 1, 6
"d:\IDEWORK\lvmen\src\licensedcode\data\rules\cnri-python-1.6_4.yml", "YAML", 0, 0, 0, 3, 0, 0, 1, 4
"d:\IDEWORK\lvmen\src\licensedcode\data\rules\cnri-python-1.6_5.yml", "YAML", 0, 0, 0, 3, 0, 0, 1, 4
"d:\IDEWORK\lvmen\src\licensedcode\data\rules\cnri-python-1.6_6.yml", "YAML", 0, 0, 0, 3, 0, 0, 1, 4
"d:\IDEWORK\lvmen\src\licensedcode\data\rules\cnri-python-1.6_7.yml", "YAML", 0, 0, 0, 3, 0, 0, 1, 4
"d:\IDEWORK\lvmen\src\licensedcode\data\rules\cnri-python-1.6_url_1.yml", "YAML", 0, 0, 0, 5, 0, 0, 1, 6
"d:\IDEWORK\lvmen\src\licensedcode\data\rules\cnri-python-1.6_url_2.yml", "YAML", 0, 0, 0, 5, 0, 0, 1, 6
"d:\IDEWORK\lvmen\src\licensedcode\data\rules\cnri-python-1.6_url_glc_151.yml", "YAML", 0, 0, 0, 5, 0, 0, 1, 6
"d:\IDEWORK\lvmen\src\licensedcode\data\rules\cockroach_1.yml", "YAML", 0, 0, 0, 12, 0, 0, 1, 13
"d:\IDEWORK\lvmen\src\licensedcode\data\rules\cockroach_2.yml", "YAML", 0, 0, 0, 12, 0, 0, 1, 13
"d:\IDEWORK\lvmen\src\licensedcode\data\rules\cockroach_3.yml", "YAML", 0, 0, 0, 12, 0, 0, 1, 13
"d:\IDEWORK\lvmen\src\licensedcode\data\rules\cockroach_4.yml", "YAML", 0, 0, 0, 12, 0, 0, 1, 13
"d:\IDEWORK\lvmen\src\licensedcode\data\rules\colt.yml", "YAML", 0, 0, 0, 5, 0, 0, 1, 6
"d:\IDEWORK\lvmen\src\licensedcode\data\rules\com-oreilly-servlet.yml", "YAML", 0, 0, 0, 5, 0, 0, 1, 6
"d:\IDEWORK\lvmen\src\licensedcode\data\rules\com-oreilly-servlet_1.yml", "YAML", 0, 0, 0, 5, 0, 0, 1, 6
"d:\IDEWORK\lvmen\src\licensedcode\data\rules\com-oreilly-servlet_2.yml", "YAML", 0, 0, 0, 7, 0, 0, 1, 8
"d:\IDEWORK\lvmen\src\licensedcode\data\rules\commercial-license_1.yml", "YAML", 0, 0, 0, 2, 0, 0, 1, 3
"d:\IDEWORK\lvmen\src\licensedcode\data\rules\commercial-license_10.yml", "YAML", 0, 0, 0, 5, 0, 0, 1, 6
"d:\IDEWORK\lvmen\src\licensedcode\data\rules\commercial-license_11.yml", "YAML", 0, 0, 0, 3, 0, 0, 1, 4
"d:\IDEWORK\lvmen\src\licensedcode\data\rules\commercial-license_12.yml", "YAML", 0, 0, 0, 5, 0, 0, 1, 6
"d:\IDEWORK\lvmen\src\licensedcode\data\rules\commercial-license_13.yml", "YAML", 0, 0, 0, 2, 0, 0, 1, 3
"d:\IDEWORK\lvmen\src\licensedcode\data\rules\commercial-license_14.yml", "YAML", 0, 0, 0, 2, 0, 0, 1, 3
"d:\IDEWORK\lvmen\src\licensedcode\data\rules\commercial-license_15.yml", "YAML", 0, 0, 0, 2, 0, 0, 1, 3
"d:\IDEWORK\lvmen\src\licensedcode\data\rules\commercial-license_16.yml", "YAML", 0, 0, 0, 2, 0, 0, 1, 3
"d:\IDEWORK\lvmen\src\licensedcode\data\rules\commercial-license_17.yml", "YAML", 0, 0, 0, 2, 0, 0, 1, 3
"d:\IDEWORK\lvmen\src\licensedcode\data\rules\commercial-license_18.yml", "YAML", 0, 0, 0, 2, 0, 0, 1, 3
"d:\IDEWORK\lvmen\src\licensedcode\data\rules\commercial-license_19.yml", "YAML", 0, 0, 0, 5, 0, 0, 1, 6
"d:\IDEWORK\lvmen\src\licensedcode\data\rules\commercial-license_2.yml", "YAML", 0, 0, 0, 3, 0, 0, 1, 4
"d:\IDEWORK\lvmen\src\licensedcode\data\rules\commercial-license_20.yml", "YAML", 0, 0, 0, 3, 0, 0, 1, 4
"d:\IDEWORK\lvmen\src\licensedcode\data\rules\commercial-license_21.yml", "YAML", 0, 0, 0, 3, 0, 0, 1, 4
"d:\IDEWORK\lvmen\src\licensedcode\data\rules\commercial-license_22.yml", "YAML", 0, 0, 0, 5, 0, 0, 1, 6
"d:\IDEWORK\lvmen\src\licensedcode\data\rules\commercial-license_23.yml", "YAML", 0, 0, 0, 5, 0, 0, 1, 6
"d:\IDEWORK\lvmen\src\licensedcode\data\rules\commercial-license_24.yml", "YAML", 0, 0, 0, 5, 0, 0, 1, 6
"d:\IDEWORK\lvmen\src\licensedcode\data\rules\commercial-license_25.yml", "YAML", 0, 0, 0, 3, 0, 0, 1, 4
"d:\IDEWORK\lvmen\src\licensedcode\data\rules\commercial-license_26.yml", "YAML", 0, 0, 0, 3, 0, 0, 1, 4
"d:\IDEWORK\lvmen\src\licensedcode\data\rules\commercial-license_27.yml", "YAML", 0, 0, 0, 4, 0, 0, 1, 5
"d:\IDEWORK\lvmen\src\licensedcode\data\rules\commercial-license_28.yml", "YAML", 0, 0, 0, 3, 0, 0, 1, 4
"d:\IDEWORK\lvmen\src\licensedcode\data\rules\commercial-license_29.yml", "YAML", 0, 0, 0, 2, 0, 0, 1, 3
"d:\IDEWORK\lvmen\src\licensedcode\data\rules\commercial-license_3.yml", "YAML", 0, 0, 0, 2, 0, 0, 1, 3
"d:\IDEWORK\lvmen\src\licensedcode\data\rules\commercial-license_30.yml", "YAML", 0, 0, 0, 2, 0, 0, 1, 3
"d:\IDEWORK\lvmen\src\licensedcode\data\rules\commercial-license_31.yml", "YAML", 0, 0, 0, 2, 0, 0, 1, 3
"d:\IDEWORK\lvmen\src\licensedcode\data\rules\commercial-license_32.yml", "YAML", 0, 0, 0, 3, 0, 0, 1, 4
"d:\IDEWORK\lvmen\src\licensedcode\data\rules\commercial-license_33.yml", "YAML", 0, 0, 0, 2, 0, 0, 1, 3
"d:\IDEWORK\lvmen\src\licensedcode\data\rules\commercial-license_34.yml", "YAML", 0, 0, 0, 2, 0, 0, 1, 3
"d:\IDEWORK\lvmen\src\licensedcode\data\rules\commercial-license_35.yml", "YAML", 0, 0, 0, 4, 0, 0, 1, 5
"d:\IDEWORK\lvmen\src\licensedcode\data\rules\commercial-license_36.yml", "YAML", 0, 0, 0, 5, 0, 0, 1, 6
"d:\IDEWORK\lvmen\src\licensedcode\data\rules\commercial-license_37.yml", "YAML", 0, 0, 0, 5, 0, 0, 1, 6
"d:\IDEWORK\lvmen\src\licensedcode\data\rules\commercial-license_38.yml", "YAML", 0, 0, 0, 5, 0, 0, 1, 6
"d:\IDEWORK\lvmen\src\licensedcode\data\rules\commercial-license_39.yml", "YAML", 0, 0, 0, 3, 0, 0, 1, 4
"d:\IDEWORK\lvmen\src\licensedcode\data\rules\commercial-license_4.yml", "YAML", 0, 0, 0, 2, 0, 0, 1, 3
"d:\IDEWORK\lvmen\src\licensedcode\data\rules\commercial-license_40.yml", "YAML", 0, 0, 0, 3, 0, 0, 1, 4
"d:\IDEWORK\lvmen\src\licensedcode\data\rules\commercial-license_41.yml", "YAML", 0, 0, 0, 4, 0, 0, 1, 5
"d:\IDEWORK\lvmen\src\licensedcode\data\rules\commercial-license_42.yml", "YAML", 0, 0, 0, 4, 0, 0, 1, 5
"d:\IDEWORK\lvmen\src\licensedcode\data\rules\commercial-license_43.yml", "YAML", 0, 0, 0, 3, 0, 0, 1, 4
"d:\IDEWORK\lvmen\src\licensedcode\data\rules\commercial-license_44.yml", "YAML", 0, 0, 0, 7, 0, 0, 1, 8
"d:\IDEWORK\lvmen\src\licensedcode\data\rules\commercial-license_45.yml", "YAML", 0, 0, 0, 3, 0, 0, 1, 4
"d:\IDEWORK\lvmen\src\licensedcode\data\rules\commercial-license_46.yml", "YAML", 0, 0, 0, 3, 0, 0, 1, 4
"d:\IDEWORK\lvmen\src\licensedcode\data\rules\commercial-license_47.yml", "YAML", 0, 0, 0, 5, 0, 0, 1, 6
"d:\IDEWORK\lvmen\src\licensedcode\data\rules\commercial-license_48.yml", "YAML", 0, 0, 0, 3, 0, 0, 1, 4
"d:\IDEWORK\lvmen\src\licensedcode\data\rules\commercial-license_49.yml", "YAML", 0, 0, 0, 5, 0, 0, 1, 6
"d:\IDEWORK\lvmen\src\licensedcode\data\rules\commercial-license_5.yml", "YAML", 0, 0, 0, 2, 0, 0, 1, 3
"d:\IDEWORK\lvmen\src\licensedcode\data\rules\commercial-license_50.yml", "YAML", 0, 0, 0, 5, 0, 0, 1, 6
"d:\IDEWORK\lvmen\src\licensedcode\data\rules\commercial-license_51.yml", "YAML", 0, 0, 0, 3, 0, 0, 1, 4
"d:\IDEWORK\lvmen\src\licensedcode\data\rules\commercial-license_52.yml", "YAML", 0, 0, 0, 3, 0, 0, 1, 4
"d:\IDEWORK\lvmen\src\licensedcode\data\rules\commercial-license_53.yml", "YAML", 0, 0, 0, 4, 0, 0, 1, 5
"d:\IDEWORK\lvmen\src\licensedcode\data\rules\commercial-license_54.yml", "YAML", 0, 0, 0, 10, 0, 0, 1, 11
"d:\IDEWORK\lvmen\src\licensedcode\data\rules\commercial-license_55.yml", "YAML", 0, 0, 0, 3, 0, 0, 1, 4
"d:\IDEWORK\lvmen\src\licensedcode\data\rules\commercial-license_56.yml", "YAML", 0, 0, 0, 2, 0, 0, 1, 3
"d:\IDEWORK\lvmen\src\licensedcode\data\rules\commercial-license_57.yml", "YAML", 0, 0, 0, 5, 0, 0, 1, 6
"d:\IDEWORK\lvmen\src\licensedcode\data\rules\commercial-license_58.yml", "YAML", 0, 0, 0, 3, 0, 0, 1, 4
"d:\IDEWORK\lvmen\src\licensedcode\data\rules\commercial-license_59.yml", "YAML", 0, 0, 0, 5, 0, 0, 1, 6
"d:\IDEWORK\lvmen\src\licensedcode\data\rules\commercial-license_6.yml", "YAML", 0, 0, 0, 4, 0, 0, 1, 5
"d:\IDEWORK\lvmen\src\licensedcode\data\rules\commercial-license_60.yml", "YAML", 0, 0, 0, 3, 0, 0, 1, 4
"d:\IDEWORK\lvmen\src\licensedcode\data\rules\commercial-license_61.yml", "YAML", 0, 0, 0, 3, 0, 0, 1, 4
"d:\IDEWORK\lvmen\src\licensedcode\data\rules\commercial-license_62.yml", "YAML", 0, 0, 0, 3, 0, 0, 1, 4
"d:\IDEWORK\lvmen\src\licensedcode\data\rules\commercial-license_63.yml", "YAML", 0, 0, 0, 3, 0, 0, 1, 4
"d:\IDEWORK\lvmen\src\licensedcode\data\rules\commercial-license_64.yml", "YAML", 0, 0, 0, 3, 0, 0, 1, 4
"d:\IDEWORK\lvmen\src\licensedcode\data\rules\commercial-license_65.yml", "YAML", 0, 0, 0, 3, 0, 0, 1, 4
"d:\IDEWORK\lvmen\src\licensedcode\data\rules\commercial-license_66.yml", "YAML", 0, 0, 0, 5, 0, 0, 1, 6
"d:\IDEWORK\lvmen\src\licensedcode\data\rules\commercial-license_67.yml", "YAML", 0, 0, 0, 3, 0, 0, 1, 4
"d:\IDEWORK\lvmen\src\licensedcode\data\rules\commercial-license_68.yml", "YAML", 0, 0, 0, 3, 0, 0, 1, 4
"d:\IDEWORK\lvmen\src\licensedcode\data\rules\commercial-license_69.yml", "YAML", 0, 0, 0, 3, 0, 0, 1, 4
"d:\IDEWORK\lvmen\src\licensedcode\data\rules\commercial-license_7.yml", "YAML", 0, 0, 0, 3, 0, 0, 1, 4
"d:\IDEWORK\lvmen\src\licensedcode\data\rules\commercial-license_70.yml", "YAML", 0, 0, 0, 3, 0, 0, 1, 4
"d:\IDEWORK\lvmen\src\licensedcode\data\rules\commercial-license_71.yml", "YAML", 0, 0, 0, 3, 0, 0, 1, 4
"d:\IDEWORK\lvmen\src\licensedcode\data\rules\commercial-license_72.yml", "YAML", 0, 0, 0, 3, 0, 0, 1, 4
"d:\IDEWORK\lvmen\src\licensedcode\data\rules\commercial-license_73.yml", "YAML", 0, 0, 0, 3, 0, 0, 1, 4
"d:\IDEWORK\lvmen\src\licensedcode\data\rules\commercial-license_74.yml", "YAML", 0, 0, 0, 3, 0, 0, 1, 4
"d:\IDEWORK\lvmen\src\licensedcode\data\rules\commercial-license_75.yml", "YAML", 0, 0, 0, 3, 0, 0, 1, 4
"d:\IDEWORK\lvmen\src\licensedcode\data\rules\commercial-license_8.yml", "YAML", 0, 0, 0, 5, 0, 0, 1, 6
"d:\IDEWORK\lvmen\src\licensedcode\data\rules\commercial-license_9.yml", "YAML", 0, 0, 0, 5, 0, 0, 1, 6
"d:\IDEWORK\lvmen\src\licensedcode\data\rules\commercial-license_and_other-permissive_and_mit_1.yml", "YAML", 0, 0, 0, 3, 0, 0, 1, 4
"d:\IDEWORK\lvmen\src\licensedcode\data\rules\commercial-license_bcm.yml", "YAML", 0, 0, 0, 2, 0, 0, 1, 3
"d:\IDEWORK\lvmen\src\licensedcode\data\rules\commercial-license_bcm1.yml", "YAML", 0, 0, 0, 2, 0, 0, 1, 3
"d:\IDEWORK\lvmen\src\licensedcode\data\rules\commercial-license_bitstream.yml", "YAML", 0, 0, 0, 2, 0, 0, 1, 3
"d:\IDEWORK\lvmen\src\licensedcode\data\rules\commercial-license_fontspring-application-1.7.2.yml", "YAML", 0, 0, 0, 4, 0, 0, 1, 5
"d:\IDEWORK\lvmen\src\licensedcode\data\rules\commercial-license_fontspring-demo-1.7.yml", "YAML", 0, 0, 0, 4, 0, 0, 1, 5
"d:\IDEWORK\lvmen\src\licensedcode\data\rules\commercial-license_fontspring-desktop-1.7.yml", "YAML", 0, 0, 0, 4, 0, 0, 1, 5
"d:\IDEWORK\lvmen\src\licensedcode\data\rules\commercial-license_fontspring-ebook-1.7.yml", "YAML", 0, 0, 0, 4, 0, 0, 1, 5
"d:\IDEWORK\lvmen\src\licensedcode\data\rules\commercial-license_fontspring-webfont-1.7.yml", "YAML", 0, 0, 0, 4, 0, 0, 1, 5
"d:\IDEWORK\lvmen\src\licensedcode\data\rules\commercial-license_india.yml", "YAML", 0, 0, 0, 2, 0, 0, 1, 3
"d:\IDEWORK\lvmen\src\licensedcode\data\rules\commercial-license_khronos_1.yml", "YAML", 0, 0, 0, 2, 0, 0, 1, 3
"d:\IDEWORK\lvmen\src\licensedcode\data\rules\commercial-license_khronos_2.yml", "YAML", 0, 0, 0, 2, 0, 0, 1, 3
"d:\IDEWORK\lvmen\src\licensedcode\data\rules\commercial-license_nc1.yml", "YAML", 0, 0, 0, 3, 0, 0, 1, 4
"d:\IDEWORK\lvmen\src\licensedcode\data\rules\commercial-license_nc2.yml", "YAML", 0, 0, 0, 3, 0, 0, 1, 4
"d:\IDEWORK\lvmen\src\licensedcode\data\rules\commercial-license_nc3.yml", "YAML", 0, 0, 0, 3, 0, 0, 1, 4
"d:\IDEWORK\lvmen\src\licensedcode\data\rules\commercial-license_non_com.yml", "YAML", 0, 0, 0, 3, 0, 0, 1, 4
"d:\IDEWORK\lvmen\src\licensedcode\data\rules\commercial-license_or_agpl-3.0_with_agpl-generic-additional-terms_1.yml", "YAML", 0, 0, 0, 3, 0, 0, 1, 4
"d:\IDEWORK\lvmen\src\licensedcode\data\rules\commercial-license_or_bsd-new_1.yml", "YAML", 0, 0, 0, 6, 0, 0, 1, 7
"d:\IDEWORK\lvmen\src\licensedcode\data\rules\commercial-license_or_bsd-simplified_1.yml", "YAML", 0, 0, 0, 5, 0, 0, 1, 6
"d:\IDEWORK\lvmen\src\licensedcode\data\rules\commercial-license_or_gpl-1.0-plus_1.yml", "YAML", 0, 0, 0, 3, 0, 0, 1, 4
"d:\IDEWORK\lvmen\src\licensedcode\data\rules\commercial-license_or_gpl-1.0-plus_2.yml", "YAML", 0, 0, 0, 5, 0, 0, 1, 6
"d:\IDEWORK\lvmen\src\licensedcode\data\rules\commercial-license_or_gpl-2.0_1.yml", "YAML", 0, 0, 0, 5, 0, 0, 1, 6
"d:\IDEWORK\lvmen\src\licensedcode\data\rules\commercial-license_or_gpl-2.0_2.yml", "YAML", 0, 0, 0, 5, 0, 0, 1, 6
"d:\IDEWORK\lvmen\src\licensedcode\data\rules\commercial-license_or_gpl-2.0_3.yml", "YAML", 0, 0, 0, 5, 0, 0, 1, 6
"d:\IDEWORK\lvmen\src\licensedcode\data\rules\commercial-license_or_gpl-2.0_or_bsd-simplified_1.yml", "YAML", 0, 0, 0, 5, 0, 0, 1, 6
"d:\IDEWORK\lvmen\src\licensedcode\data\rules\commercial-license_or_gpl-2.0_or_bsd-simplified_2.yml", "YAML", 0, 0, 0, 5, 0, 0, 1, 6
"d:\IDEWORK\lvmen\src\licensedcode\data\rules\commercial-license_or_gpl-2.0_or_gpl-3.0_1.yml", "YAML", 0, 0, 0, 5, 0, 0, 1, 6
"d:\IDEWORK\lvmen\src\licensedcode\data\rules\commercial-license_or_gpl-2.0_or_gpl-3.0_2.yml", "YAML", 0, 0, 0, 5, 0, 0, 1, 6
"d:\IDEWORK\lvmen\src\licensedcode\data\rules\commercial-license_or_gpl-2.0_or_gpl-3.0_or_bsd-simplified_1.yml", "YAML", 0, 0, 0, 5, 0, 0, 1, 6
"d:\IDEWORK\lvmen\src\licensedcode\data\rules\commercial-license_or_gpl-2.0_or_gpl-3.0_or_bsd-simplified_2.yml", "YAML", 0, 0, 0, 5, 0, 0, 1, 6
"d:\IDEWORK\lvmen\src\licensedcode\data\rules\commercial-license_or_gpl-3.0_1.yml", "YAML", 0, 0, 0, 5, 0, 0, 1, 6
"d:\IDEWORK\lvmen\src\licensedcode\data\rules\commercial-license_or_gpl-3.0_2.yml", "YAML", 0, 0, 0, 5, 0, 0, 1, 6
"d:\IDEWORK\lvmen\src\licensedcode\data\rules\commercial-license_or_gpl-3.0_3.yml", "YAML", 0, 0, 0, 5, 0, 0, 1, 6
"d:\IDEWORK\lvmen\src\licensedcode\data\rules\commercial-license_or_gpl-3.0_4.yml", "YAML", 0, 0, 0, 5, 0, 0, 1, 6
"d:\IDEWORK\lvmen\src\licensedcode\data\rules\commercial-license_or_gpl-3.0_5.yml", "YAML", 0, 0, 0, 5, 0, 0, 1, 6
"d:\IDEWORK\lvmen\src\licensedcode\data\rules\commercial-license_or_gpl-3.0_6.yml", "YAML", 0, 0, 0, 3, 0, 0, 1, 4
"d:\IDEWORK\lvmen\src\licensedcode\data\rules\commercial-license_or_gpl-3.0_7.yml", "YAML", 0, 0, 0, 3, 0, 0, 1, 4
"d:\IDEWORK\lvmen\src\licensedcode\data\rules\commercial-license_or_lgpl-2.1_with_qt-lgpl-exception-1.1_or_gpl-3.0_1.yml", "YAML", 0, 0, 0, 11, 0, 0, 1, 12
"d:\IDEWORK\lvmen\src\licensedcode\data\rules\commercial-license_or_lgpl-2.1_with_qt-lgpl-exception-1.1_or_gpl-3.0_2.yml", "YAML", 0, 0, 0, 11, 0, 0, 1, 12
"d:\IDEWORK\lvmen\src\licensedcode\data\rules\commercial-license_or_lgpl-2.1_with_qt-lgpl-exception-1.1_or_gpl-3.0_3.yml", "YAML", 0, 0, 0, 12, 0, 0, 1, 13
"d:\IDEWORK\lvmen\src\licensedcode\data\rules\commercial-license_or_lgpl-2.1_with_qt-lgpl-exception-1.1_or_gpl-3.0_4.yml", "YAML", 0, 0, 0, 11, 0, 0, 1, 12
"d:\IDEWORK\lvmen\src\licensedcode\data\rules\commercial-license_or_lgpl-2.1_with_qt-lgpl-exception-1.1_or_gpl-3.0_5.yml", "YAML", 0, 0, 0, 11, 0, 0, 1, 12
"d:\IDEWORK\lvmen\src\licensedcode\data\rules\commercial-license_or_lgpl-2.1_with_qt-lgpl-exception-1.1_or_gpl-3.0_6.yml", "YAML", 0, 0, 0, 11, 0, 0, 1, 12
"d:\IDEWORK\lvmen\src\licensedcode\data\rules\commercial-license_proprietary_108.yml", "YAML", 0, 0, 0, 2, 0, 0, 1, 3
"d:\IDEWORK\lvmen\src\licensedcode\data\rules\commercial-license_proprietary_109.yml", "YAML", 0, 0, 0, 2, 0, 0, 1, 3
"d:\IDEWORK\lvmen\src\licensedcode\data\rules\commercial-license_proprietary_11.yml", "YAML", 0, 0, 0, 3, 0, 0, 1, 4
"d:\IDEWORK\lvmen\src\licensedcode\data\rules\commercial-option.yml", "YAML", 0, 0, 0, 3, 0, 0, 1, 4
"d:\IDEWORK\lvmen\src\licensedcode\data\rules\commercial-option_1.yml", "YAML", 0, 0, 0, 3, 0, 0, 1, 4
"d:\IDEWORK\lvmen\src\licensedcode\data\rules\commercial-option_33.yml", "YAML", 0, 0, 0, 3, 0, 0, 1, 4
"d:\IDEWORK\lvmen\src\licensedcode\data\rules\commercial-option_or_gpl-1.0-plus_1.yml", "YAML", 0, 0, 0, 4, 0, 0, 1, 5
"d:\IDEWORK\lvmen\src\licensedcode\data\rules\commercial-option_or_gpl-2.0_1.yml", "YAML", 0, 0, 0, 4, 0, 0, 1, 5
"d:\IDEWORK\lvmen\src\licensedcode\data\rules\commonj-timer.yml", "YAML", 0, 0, 0, 7, 0, 0, 1, 8
"d:\IDEWORK\lvmen\src\licensedcode\data\rules\commonj-timer_1.yml", "YAML", 0, 0, 0, 5, 0, 0, 1, 6
"d:\IDEWORK\lvmen\src\licensedcode\data\rules\commons-clause_1.yml", "YAML", 0, 0, 0, 2, 0, 0, 1, 3
"d:\IDEWORK\lvmen\src\licensedcode\data\rules\commons-clause_2.yml", "YAML", 0, 0, 0, 2, 0, 0, 1, 3
"d:\IDEWORK\lvmen\src\licensedcode\data\rules\commons-clause_3.yml", "YAML", 0, 0, 0, 2, 0, 0, 1, 3
"d:\IDEWORK\lvmen\src\licensedcode\data\rules\commons-clause_4.yml", "YAML", 0, 0, 0, 2, 0, 0, 1, 3
"d:\IDEWORK\lvmen\src\licensedcode\data\rules\commons-clause_5.yml", "YAML", 0, 0, 0, 3, 0, 0, 1, 4
"d:\IDEWORK\lvmen\src\licensedcode\data\rules\commons-clause_6.yml", "YAML", 0, 0, 0, 3, 0, 0, 1, 4
"d:\IDEWORK\lvmen\src\licensedcode\data\rules\commons-clause_7.yml", "YAML", 0, 0, 0, 3, 0, 0, 1, 4
"d:\IDEWORK\lvmen\src\licensedcode\data\rules\condor-1.1.SPDX.yml", "YAML", 0, 0, 0, 17, 0, 0, 1, 18
"d:\IDEWORK\lvmen\src\licensedcode\data\rules\condor-1.1.yml", "YAML", 0, 0, 0, 5, 0, 0, 1, 6
"d:\IDEWORK\lvmen\src\licensedcode\data\rules\condor-1.1_url_1.yml", "YAML", 0, 0, 0, 5, 0, 0, 1, 6
"d:\IDEWORK\lvmen\src\licensedcode\data\rules\condor-1.1_url_2.yml", "YAML", 0, 0, 0, 5, 0, 0, 1, 6
"d:\IDEWORK\lvmen\src\licensedcode\data\rules\copyheart_1.yml", "YAML", 0, 0, 0, 3, 0, 0, 1, 4
"d:\IDEWORK\lvmen\src\licensedcode\data\rules\copyheart_2.yml", "YAML", 0, 0, 0, 3, 0, 0, 1, 4
"d:\IDEWORK\lvmen\src\licensedcode\data\rules\copyheart_5.yml", "YAML", 0, 0, 0, 3, 0, 0, 1, 4
"d:\IDEWORK\lvmen\src\licensedcode\data\rules\copyleft-next-0.3.0_1.yml", "YAML", 0, 0, 0, 4, 0, 0, 1, 5
"d:\IDEWORK\lvmen\src\licensedcode\data\rules\copyleft-next-0.3.0_2.yml", "YAML", 0, 0, 0, 3, 0, 0, 1, 4
"d:\IDEWORK\lvmen\src\licensedcode\data\rules\copyleft-next-0.3.0_3.yml", "YAML", 0, 0, 0, 3, 0, 0, 1, 4
"d:\IDEWORK\lvmen\src\licensedcode\data\rules\copyleft-next-0.3.0_url_1.yml", "YAML", 0, 0, 0, 5, 0, 0, 1, 6
"d:\IDEWORK\lvmen\src\licensedcode\data\rules\copyleft-next-0.3.0_url_2.yml", "YAML", 0, 0, 0, 5, 0, 0, 1, 6
"d:\IDEWORK\lvmen\src\licensedcode\data\rules\copyleft-next-0.3.1_url_1.yml", "YAML", 0, 0, 0, 5, 0, 0, 1, 6
"d:\IDEWORK\lvmen\src\licensedcode\data\rules\copyleft-next-0.3.1_url_2.yml", "YAML", 0, 0, 0, 5, 0, 0, 1, 6
"d:\IDEWORK\lvmen\src\licensedcode\data\rules\cpal-1.0.SPDX.yml", "YAML", 0, 0, 0, 4, 0, 0, 1, 5
"d:\IDEWORK\lvmen\src\licensedcode\data\rules\cpal-1.0.yml", "YAML", 0, 0, 0, 3, 0, 0, 1, 4
"d:\IDEWORK\lvmen\src\licensedcode\data\rules\cpal-1.0_1.yml", "YAML", 0, 0, 0, 3, 0, 0, 1, 4
"d:\IDEWORK\lvmen\src\licensedcode\data\rules\cpal-1.0_10.yml", "YAML", 0, 0, 0, 9, 0, 0, 1, 10
"d:\IDEWORK\lvmen\src\licensedcode\data\rules\cpal-1.0_11.yml", "YAML", 0, 0, 0, 5, 0, 0, 1, 6
"d:\IDEWORK\lvmen\src\licensedcode\data\rules\cpal-1.0_12.yml", "YAML", 0, 0, 0, 5, 0, 0, 1, 6
"d:\IDEWORK\lvmen\src\licensedcode\data\rules\cpal-1.0_13.yml", "YAML", 0, 0, 0, 3, 0, 0, 1, 4
"d:\IDEWORK\lvmen\src\licensedcode\data\rules\cpal-1.0_14.yml", "YAML", 0, 0, 0, 5, 0, 0, 1, 6
"d:\IDEWORK\lvmen\src\licensedcode\data\rules\cpal-1.0_15.yml", "YAML", 0, 0, 0, 5, 0, 0, 1, 6
"d:\IDEWORK\lvmen\src\licensedcode\data\rules\cpal-1.0_16.yml", "YAML", 0, 0, 0, 4, 0, 0, 1, 5
"d:\IDEWORK\lvmen\src\licensedcode\data\rules\cpal-1.0_17.yml", "YAML", 0, 0, 0, 5, 0, 0, 1, 6
"d:\IDEWORK\lvmen\src\licensedcode\data\rules\cpal-1.0_18.yml", "YAML", 0, 0, 0, 5, 0, 0, 1, 6
"d:\IDEWORK\lvmen\src\licensedcode\data\rules\cpal-1.0_19.yml", "YAML", 0, 0, 0, 3, 0, 0, 1, 4
"d:\IDEWORK\lvmen\src\licensedcode\data\rules\cpal-1.0_2.yml", "YAML", 0, 0, 0, 5, 0, 0, 1, 6
"d:\IDEWORK\lvmen\src\licensedcode\data\rules\cpal-1.0_20.yml", "YAML", 0, 0, 0, 5, 0, 0, 1, 6
"d:\IDEWORK\lvmen\src\licensedcode\data\rules\cpal-1.0_21.yml", "YAML", 0, 0, 0, 4, 0, 0, 1, 5
"d:\IDEWORK\lvmen\src\licensedcode\data\rules\cpal-1.0_22.yml", "YAML", 0, 0, 0, 4, 0, 0, 1, 5
"d:\IDEWORK\lvmen\src\licensedcode\data\rules\cpal-1.0_23.yml", "YAML", 0, 0, 0, 5, 0, 0, 1, 6
"d:\IDEWORK\lvmen\src\licensedcode\data\rules\cpal-1.0_24.yml", "YAML", 0, 0, 0, 10, 0, 0, 1, 11
"d:\IDEWORK\lvmen\src\licensedcode\data\rules\cpal-1.0_25.yml", "YAML", 0, 0, 0, 5, 0, 0, 1, 6
"d:\IDEWORK\lvmen\src\licensedcode\data\rules\cpal-1.0_26.yml", "YAML", 0, 0, 0, 3, 0, 0, 1, 4
"d:\IDEWORK\lvmen\src\licensedcode\data\rules\cpal-1.0_27.yml", "YAML", 0, 0, 0, 3, 0, 0, 1, 4
"d:\IDEWORK\lvmen\src\licensedcode\data\rules\cpal-1.0_3.yml", "YAML", 0, 0, 0, 4, 0, 0, 1, 5
"d:\IDEWORK\lvmen\src\licensedcode\data\rules\cpal-1.0_4.yml", "YAML", 0, 0, 0, 2, 0, 0, 1, 3
"d:\IDEWORK\lvmen\src\licensedcode\data\rules\cpal-1.0_5.yml", "YAML", 0, 0, 0, 5, 0, 0, 1, 6
"d:\IDEWORK\lvmen\src\licensedcode\data\rules\cpal-1.0_6.yml", "YAML", 0, 0, 0, 3, 0, 0, 1, 4
"d:\IDEWORK\lvmen\src\licensedcode\data\rules\cpal-1.0_7.yml", "YAML", 0, 0, 0, 3, 0, 0, 1, 4
"d:\IDEWORK\lvmen\src\licensedcode\data\rules\cpal-1.0_8.yml", "YAML", 0, 0, 0, 3, 0, 0, 1, 4
"d:\IDEWORK\lvmen\src\licensedcode\data\rules\cpal-1.0_9.yml", "YAML", 0, 0, 0, 5, 0, 0, 1, 6
"d:\IDEWORK\lvmen\src\licensedcode\data\rules\cpal-1.0_or_agpl-3.0_1.yml", "YAML", 0, 0, 0, 2, 0, 0, 1, 3
"d:\IDEWORK\lvmen\src\licensedcode\data\rules\cpal-1.0_or_commercial-license_1.yml", "YAML", 0, 0, 0, 7, 0, 0, 1, 8
"d:\IDEWORK\lvmen\src\licensedcode\data\rules\cpal-1.0_url_1.yml", "YAML", 0, 0, 0, 5, 0, 0, 1, 6
"d:\IDEWORK\lvmen\src\licensedcode\data\rules\cpal-1.0_url_2.yml", "YAML", 0, 0, 0, 5, 0, 0, 1, 6
"d:\IDEWORK\lvmen\src\licensedcode\data\rules\cpal-1.0_url_glc_153.yml", "YAML", 0, 0, 0, 5, 0, 0, 1, 6
"d:\IDEWORK\lvmen\src\licensedcode\data\rules\cpl-0.5.yml", "YAML", 0, 0, 0, 5, 0, 0, 1, 6
"d:\IDEWORK\lvmen\src\licensedcode\data\rules\cpl-1.0.SPDX.yml", "YAML", 0, 0, 0, 4, 0, 0, 1, 5
"d:\IDEWORK\lvmen\src\licensedcode\data\rules\cpl-1.0.yml", "YAML", 0, 0, 0, 5, 0, 0, 1, 6
"d:\IDEWORK\lvmen\src\licensedcode\data\rules\cpl-1.02_1.yml", "YAML", 0, 0, 0, 5, 0, 0, 1, 6
"d:\IDEWORK\lvmen\src\licensedcode\data\rules\cpl-1.0_1.yml", "YAML", 0, 0, 0, 5, 0, 0, 1, 6
"d:\IDEWORK\lvmen\src\licensedcode\data\rules\cpl-1.0_10.yml", "YAML", 0, 0, 0, 5, 0, 0, 1, 6
"d:\IDEWORK\lvmen\src\licensedcode\data\rules\cpl-1.0_11.yml", "YAML", 0, 0, 0, 4, 0, 0, 1, 5
"d:\IDEWORK\lvmen\src\licensedcode\data\rules\cpl-1.0_12.yml", "YAML", 0, 0, 0, 5, 0, 0, 1, 6
"d:\IDEWORK\lvmen\src\licensedcode\data\rules\cpl-1.0_13.yml", "YAML", 0, 0, 0, 5, 0, 0, 1, 6
"d:\IDEWORK\lvmen\src\licensedcode\data\rules\cpl-1.0_14.yml", "YAML", 0, 0, 0, 4, 0, 0, 1, 5
"d:\IDEWORK\lvmen\src\licensedcode\data\rules\cpl-1.0_15.yml", "YAML", 0, 0, 0, 3, 0, 0, 1, 4
"d:\IDEWORK\lvmen\src\licensedcode\data\rules\cpl-1.0_16.yml", "YAML", 0, 0, 0, 3, 0, 0, 1, 4
"d:\IDEWORK\lvmen\src\licensedcode\data\rules\cpl-1.0_17.yml", "YAML", 0, 0, 0, 5, 0, 0, 1, 6
"d:\IDEWORK\lvmen\src\licensedcode\data\rules\cpl-1.0_18.yml", "YAML", 0, 0, 0, 5, 0, 0, 1, 6
"d:\IDEWORK\lvmen\src\licensedcode\data\rules\cpl-1.0_19.yml", "YAML", 0, 0, 0, 7, 0, 0, 1, 8
"d:\IDEWORK\lvmen\src\licensedcode\data\rules\cpl-1.0_2.yml", "YAML", 0, 0, 0, 5, 0, 0, 1, 6
"d:\IDEWORK\lvmen\src\licensedcode\data\rules\cpl-1.0_20.yml", "YAML", 0, 0, 0, 3, 0, 0, 1, 4
"d:\IDEWORK\lvmen\src\licensedcode\data\rules\cpl-1.0_21.yml", "YAML", 0, 0, 0, 3, 0, 0, 1, 4
"d:\IDEWORK\lvmen\src\licensedcode\data\rules\cpl-1.0_22.yml", "YAML", 0, 0, 0, 5, 0, 0, 1, 6
"d:\IDEWORK\lvmen\src\licensedcode\data\rules\cpl-1.0_23.yml", "YAML", 0, 0, 0, 5, 0, 0, 1, 6
"d:\IDEWORK\lvmen\src\licensedcode\data\rules\cpl-1.0_24.yml", "YAML", 0, 0, 0, 5, 0, 0, 1, 6
"d:\IDEWORK\lvmen\src\licensedcode\data\rules\cpl-1.0_25.yml", "YAML", 0, 0, 0, 3, 0, 0, 1, 4
"d:\IDEWORK\lvmen\src\licensedcode\data\rules\cpl-1.0_3.yml", "YAML", 0, 0, 0, 2, 0, 0, 1, 3
"d:\IDEWORK\lvmen\src\licensedcode\data\rules\cpl-1.0_4.yml", "YAML", 0, 0, 0, 5, 0, 0, 1, 6
"d:\IDEWORK\lvmen\src\licensedcode\data\rules\cpl-1.0_5.yml", "YAML", 0, 0, 0, 3, 0, 0, 1, 4
"d:\IDEWORK\lvmen\src\licensedcode\data\rules\cpl-1.0_6.yml", "YAML", 0, 0, 0, 6, 0, 0, 1, 7
"d:\IDEWORK\lvmen\src\licensedcode\data\rules\cpl-1.0_7.yml", "YAML", 0, 0, 0, 2, 0, 0, 1, 3
"d:\IDEWORK\lvmen\src\licensedcode\data\rules\cpl-1.0_8.yml", "YAML", 0, 0, 0, 3, 0, 0, 1, 4
"d:\IDEWORK\lvmen\src\licensedcode\data\rules\cpl-1.0_9.yml", "YAML", 0, 0, 0, 2, 0, 0, 1, 3
"d:\IDEWORK\lvmen\src\licensedcode\data\rules\cpl-1.0_and_bsd-new_1.yml", "YAML", 0, 0, 0, 6, 0, 0, 1, 7
"d:\IDEWORK\lvmen\src\licensedcode\data\rules\cpl-1.0_and_gpl_and_lgpl.yml", "YAML", 0, 0, 0, 9, 0, 0, 1, 10
"d:\IDEWORK\lvmen\src\licensedcode\data\rules\cpl-1.0_and_gpl_and_lgpl_ruby.yml", "YAML", 0, 0, 0, 4, 0, 0, 1, 5
"d:\IDEWORK\lvmen\src\licensedcode\data\rules\cpl-1.0_and_other-permissive_1.yml", "YAML", 0, 0, 0, 5, 0, 0, 1, 6
"d:\IDEWORK\lvmen\src\licensedcode\data\rules\cpl-1.0_or_bsd-new_or_gpl-2.0_and_free-unknown_1.yml", "YAML", 0, 0, 0, 8, 0, 0, 1, 9
"d:\IDEWORK\lvmen\src\licensedcode\data\rules\cpl-1.0_or_bsd-new_or_gpl-2.0_and_free-unknown_2.yml", "YAML", 0, 0, 0, 8, 0, 0, 1, 9
"d:\IDEWORK\lvmen\src\licensedcode\data\rules\cpl-1.0_or_gpl-2.0-plus_or_lgpl-2.1-plus_1.yml", "YAML", 0, 0, 0, 7, 0, 0, 1, 8
"d:\IDEWORK\lvmen\src\licensedcode\data\rules\cpl-1.0_or_gpl-2.0-plus_or_lgpl-2.1-plus_2.yml", "YAML", 0, 0, 0, 7, 0, 0, 1, 8
"d:\IDEWORK\lvmen\src\licensedcode\data\rules\cpl-1.0_or_gpl-2.0_or_lgpl-2.1_1.yml", "YAML", 0, 0, 0, 5, 0, 0, 1, 6
"d:\IDEWORK\lvmen\src\licensedcode\data\rules\cpl-1.0_or_gpl-2.0_or_lgpl-2.1_2.yml", "YAML", 0, 0, 0, 8, 0, 0, 1, 9
"d:\IDEWORK\lvmen\src\licensedcode\data\rules\cpl-1.0_or_gpl-2.0_or_lgpl-2.1_3.yml", "YAML", 0, 0, 0, 8, 0, 0, 1, 9
"d:\IDEWORK\lvmen\src\licensedcode\data\rules\cpl-1.0_url_1.yml", "YAML", 0, 0, 0, 5, 0, 0, 1, 6
"d:\IDEWORK\lvmen\src\licensedcode\data\rules\cpl-1.0_url_2.yml", "YAML", 0, 0, 0, 5, 0, 0, 1, 6
"d:\IDEWORK\lvmen\src\licensedcode\data\rules\cpl-1.0_url_glc_72.yml", "YAML", 0, 0, 0, 5, 0, 0, 1, 6
"d:\IDEWORK\lvmen\src\licensedcode\data\rules\cpl-1.0_url_glc_73.yml", "YAML", 0, 0, 0, 5, 0, 0, 1, 6
"d:\IDEWORK\lvmen\src\licensedcode\data\rules\cpl_or_lgpl_lzma_sdk.yml", "YAML", 0, 0, 0, 2, 0, 0, 1, 3
"d:\IDEWORK\lvmen\src\licensedcode\data\rules\cpl_or_lgpl_with_lzma-sdk-2006-exception.yml", "YAML", 0, 0, 0, 2, 0, 0, 1, 3
"d:\IDEWORK\lvmen\src\licensedcode\data\rules\cpol-1.02.SPDX.yml", "YAML", 0, 0, 0, 4, 0, 0, 1, 5
"d:\IDEWORK\lvmen\src\licensedcode\data\rules\cpol-1.02.yml", "YAML", 0, 0, 0, 5, 0, 0, 1, 6
"d:\IDEWORK\lvmen\src\licensedcode\data\rules\cpol-1.02_1.yml", "YAML", 0, 0, 0, 3, 0, 0, 1, 4
"d:\IDEWORK\lvmen\src\licensedcode\data\rules\cpol-1.02_2.yml", "YAML", 0, 0, 0, 4, 0, 0, 1, 5
"d:\IDEWORK\lvmen\src\licensedcode\data\rules\cpol-1.02_3.yml", "YAML", 0, 0, 0, 6, 0, 0, 1, 7
"d:\IDEWORK\lvmen\src\licensedcode\data\rules\cpol-1.02_4.yml", "YAML", 0, 0, 0, 3, 0, 0, 1, 4
"d:\IDEWORK\lvmen\src\licensedcode\data\rules\cpol-1.02_5.yml", "YAML", 0, 0, 0, 5, 0, 0, 1, 6
"d:\IDEWORK\lvmen\src\licensedcode\data\rules\cpol-1.02_6.yml", "YAML", 0, 0, 0, 4, 0, 0, 1, 5
"d:\IDEWORK\lvmen\src\licensedcode\data\rules\cpol-1.02_url_1.yml", "YAML", 0, 0, 0, 5, 0, 0, 1, 6
"d:\IDEWORK\lvmen\src\licensedcode\data\rules\cpol-1.02_url_2.yml", "YAML", 0, 0, 0, 5, 0, 0, 1, 6
"d:\IDEWORK\lvmen\src\licensedcode\data\rules\crapl-0.1.yml", "YAML", 0, 0, 0, 3, 0, 0, 1, 4
"d:\IDEWORK\lvmen\src\licensedcode\data\rules\crapl-0.1_1.yml", "YAML", 0, 0, 0, 2, 0, 0, 1, 3
"d:\IDEWORK\lvmen\src\licensedcode\data\rules\crapl-0.1_2.yml", "YAML", 0, 0, 0, 2, 0, 0, 1, 3
"d:\IDEWORK\lvmen\src\licensedcode\data\rules\crapl-0.1_3.yml", "YAML", 0, 0, 0, 4, 0, 0, 1, 5
"d:\IDEWORK\lvmen\src\licensedcode\data\rules\crcalc_1.yml", "YAML", 0, 0, 0, 4, 0, 0, 1, 5
"d:\IDEWORK\lvmen\src\licensedcode\data\rules\crcalc_2.yml", "YAML", 0, 0, 0, 3, 0, 0, 1, 4
"d:\IDEWORK\lvmen\src\licensedcode\data\rules\crossword_url_1.yml", "YAML", 0, 0, 0, 5, 0, 0, 1, 6
"d:\IDEWORK\lvmen\src\licensedcode\data\rules\crossword_url_2.yml", "YAML", 0, 0, 0, 5, 0, 0, 1, 6
"d:\IDEWORK\lvmen\src\licensedcode\data\rules\crypto-keys-redistribution.yml", "YAML", 0, 0, 0, 2, 0, 0, 1, 3
"d:\IDEWORK\lvmen\src\licensedcode\data\rules\crystal-stacker_url_1.yml", "YAML", 0, 0, 0, 5, 0, 0, 1, 6
"d:\IDEWORK\lvmen\src\licensedcode\data\rules\crystal-stacker_url_2.yml", "YAML", 0, 0, 0, 5, 0, 0, 1, 6
"d:\IDEWORK\lvmen\src\licensedcode\data\rules\csprng_1.yml", "YAML", 0, 0, 0, 6, 0, 0, 1, 7
"d:\IDEWORK\lvmen\src\licensedcode\data\rules\csprng_or_lgpl-2.1-plus_1.yml", "YAML", 0, 0, 0, 4, 0, 0, 1, 5
"d:\IDEWORK\lvmen\src\licensedcode\data\rules\csprng_or_lgpl-2.1-plus_2.yml", "YAML", 0, 0, 0, 4, 0, 0, 1, 5
"d:\IDEWORK\lvmen\src\licensedcode\data\rules\csprng_or_lgpl-2.1-plus_3.yml", "YAML", 0, 0, 0, 7, 0, 0, 1, 8
"d:\IDEWORK\lvmen\src\licensedcode\data\rules\cua-opl-1.0.SPDX.yml", "YAML", 0, 0, 0, 6, 0, 0, 1, 7
"d:\IDEWORK\lvmen\src\licensedcode\data\rules\cua-opl-1.0.yml", "YAML", 0, 0, 0, 5, 0, 0, 1, 6
"d:\IDEWORK\lvmen\src\licensedcode\data\rules\cua-opl-1.0_1.yml", "YAML", 0, 0, 0, 5, 0, 0, 1, 6
"d:\IDEWORK\lvmen\src\licensedcode\data\rules\cua-opl-1.0_2.yml", "YAML", 0, 0, 0, 3, 0, 0, 1, 4
"d:\IDEWORK\lvmen\src\licensedcode\data\rules\cua-opl-1.0_3.yml", "YAML", 0, 0, 0, 5, 0, 0, 1, 6
"d:\IDEWORK\lvmen\src\licensedcode\data\rules\cua-opl-1.0_4.yml", "YAML", 0, 0, 0, 3, 0, 0, 1, 4
"d:\IDEWORK\lvmen\src\licensedcode\data\rules\cua-opl-1.0_url_1.yml", "YAML", 0, 0, 0, 5, 0, 0, 1, 6
"d:\IDEWORK\lvmen\src\licensedcode\data\rules\cua-opl-1.0_url_2.yml", "YAML", 0, 0, 0, 5, 0, 0, 1, 6
"d:\IDEWORK\lvmen\src\licensedcode\data\rules\cua-opl-1.0_url_glc_74.yml", "YAML", 0, 0, 0, 5, 0, 0, 1, 6
"d:\IDEWORK\lvmen\src\licensedcode\data\rules\cua-opl-1.0_url_glc_75.yml", "YAML", 0, 0, 0, 5, 0, 0, 1, 6
"d:\IDEWORK\lvmen\src\licensedcode\data\rules\cube_url_1.yml", "YAML", 0, 0, 0, 5, 0, 0, 1, 6
"d:\IDEWORK\lvmen\src\licensedcode\data\rules\cube_url_2.yml", "YAML", 0, 0, 0, 5, 0, 0, 1, 6
"d:\IDEWORK\lvmen\src\licensedcode\data\rules\cups_1.yml", "YAML", 0, 0, 0, 9, 0, 0, 1, 10
"d:\IDEWORK\lvmen\src\licensedcode\data\rules\cups_2.yml", "YAML", 0, 0, 0, 9, 0, 0, 1, 10
"d:\IDEWORK\lvmen\src\licensedcode\data\rules\cups_3.yml", "YAML", 0, 0, 0, 9, 0, 0, 1, 10
"d:\IDEWORK\lvmen\src\licensedcode\data\rules\cups_4.yml", "YAML", 0, 0, 0, 5, 0, 0, 1, 6
"d:\IDEWORK\lvmen\src\licensedcode\data\rules\cups_5.yml", "YAML", 0, 0, 0, 12, 0, 0, 1, 13
"d:\IDEWORK\lvmen\src\licensedcode\data\rules\cups_6.yml", "YAML", 0, 0, 0, 5, 0, 0, 1, 6
"d:\IDEWORK\lvmen\src\licensedcode\data\rules\curl.yml", "YAML", 0, 0, 0, 4, 0, 0, 1, 5
"d:\IDEWORK\lvmen\src\licensedcode\data\rules\curl_1.yml", "YAML", 0, 0, 0, 4, 0, 0, 1, 5
"d:\IDEWORK\lvmen\src\licensedcode\data\rules\curl_2.yml", "YAML", 0, 0, 0, 6, 0, 0, 1, 7
"d:\IDEWORK\lvmen\src\licensedcode\data\rules\curl_3.yml", "YAML", 0, 0, 0, 5, 0, 0, 1, 6
"d:\IDEWORK\lvmen\src\licensedcode\data\rules\curl_4.yml", "YAML", 0, 0, 0, 6, 0, 0, 1, 7
"d:\IDEWORK\lvmen\src\licensedcode\data\rules\curl_5.yml", "YAML", 0, 0, 0, 5, 0, 0, 1, 6
"d:\IDEWORK\lvmen\src\licensedcode\data\rules\curl_6.yml", "YAML", 0, 0, 0, 4, 0, 0, 1, 5
"d:\IDEWORK\lvmen\src\licensedcode\data\rules\curl_7.yml", "YAML", 0, 0, 0, 3, 0, 0, 1, 4
"d:\IDEWORK\lvmen\src\licensedcode\data\rules\curl_8.yml", "YAML", 0, 0, 0, 3, 0, 0, 1, 4
"d:\IDEWORK\lvmen\src\licensedcode\data\rules\curl_url_1.yml", "YAML", 0, 0, 0, 5, 0, 0, 1, 6
"d:\IDEWORK\lvmen\src\licensedcode\data\rules\curl_url_2.yml", "YAML", 0, 0, 0, 5, 0, 0, 1, 6
"d:\IDEWORK\lvmen\src\licensedcode\data\rules\cve-tou_1.yml", "YAML", 0, 0, 0, 4, 0, 0, 1, 5
"d:\IDEWORK\lvmen\src\licensedcode\data\rules\cve-tou_2.yml", "YAML", 0, 0, 0, 4, 0, 0, 1, 5
"d:\IDEWORK\lvmen\src\licensedcode\data\rules\cve-tou_3.yml", "YAML", 0, 0, 0, 4, 0, 0, 1, 5
"d:\IDEWORK\lvmen\src\licensedcode\data\rules\cvwl_1.yml", "YAML", 0, 0, 0, 10, 0, 0, 1, 11
"d:\IDEWORK\lvmen\src\licensedcode\data\rules\cygwin-exception-2.0_1.yml", "YAML", 0, 0, 0, 4, 0, 0, 1, 5
"d:\IDEWORK\lvmen\src\licensedcode\data\rules\cygwin-exception-2.0_2.yml", "YAML", 0, 0, 0, 6, 0, 0, 1, 7
"d:\IDEWORK\lvmen\src\licensedcode\data\rules\cygwin-exception-2.0_3.yml", "YAML", 0, 0, 0, 5, 0, 0, 1, 6
"d:\IDEWORK\lvmen\src\licensedcode\data\rules\cygwin-exception-lgpl-3.0-plus_1.yml", "YAML", 0, 0, 0, 2, 0, 0, 1, 3
"d:\IDEWORK\lvmen\src\licensedcode\data\rules\d-zlib.yml", "YAML", 0, 0, 0, 3, 0, 0, 2, 5
"d:\IDEWORK\lvmen\src\licensedcode\data\rules\damail.yml", "YAML", 0, 0, 0, 3, 0, 0, 1, 4
"d:\IDEWORK\lvmen\src\licensedcode\data\rules\day-spec.yml", "YAML", 0, 0, 0, 3, 0, 0, 1, 4
"d:\IDEWORK\lvmen\src\licensedcode\data\rules\dbcl-1.0_1.yml", "YAML", 0, 0, 0, 5, 0, 0, 1, 6
"d:\IDEWORK\lvmen\src\licensedcode\data\rules\dbcl-1.0_2.yml", "YAML", 0, 0, 0, 3, 0, 0, 1, 4
"d:\IDEWORK\lvmen\src\licensedcode\data\rules\dbcl-1.0_3.yml", "YAML", 0, 0, 0, 5, 0, 0, 1, 6
"d:\IDEWORK\lvmen\src\licensedcode\data\rules\dbcl-1.0_4.yml", "YAML", 0, 0, 0, 5, 0, 0, 1, 6
"d:\IDEWORK\lvmen\src\licensedcode\data\rules\dbcl-1.0_5.yml", "YAML", 0, 0, 0, 5, 0, 0, 1, 6
"d:\IDEWORK\lvmen\src\licensedcode\data\rules\dbcl-1.0_6.yml", "YAML", 0, 0, 0, 5, 0, 0, 1, 6
"d:\IDEWORK\lvmen\src\licensedcode\data\rules\dco-1.1_1.yml", "YAML", 0, 0, 0, 3, 0, 0, 1, 4
"d:\IDEWORK\lvmen\src\licensedcode\data\rules\dco-1.1_10.yml", "YAML", 0, 0, 0, 3, 0, 0, 1, 4
"d:\IDEWORK\lvmen\src\licensedcode\data\rules\dco-1.1_11.yml", "YAML", 0, 0, 0, 7, 0, 0, 1, 8
"d:\IDEWORK\lvmen\src\licensedcode\data\rules\dco-1.1_12.yml", "YAML", 0, 0, 0, 3, 0, 0, 1, 4
"d:\IDEWORK\lvmen\src\licensedcode\data\rules\dco-1.1_2.yml", "YAML", 0, 0, 0, 3, 0, 0, 1, 4
"d:\IDEWORK\lvmen\src\licensedcode\data\rules\dco-1.1_3.yml", "YAML", 0, 0, 0, 2, 0, 0, 1, 3
"d:\IDEWORK\lvmen\src\licensedcode\data\rules\dco-1.1_4.yml", "YAML", 0, 0, 0, 4, 0, 0, 1, 5
"d:\IDEWORK\lvmen\src\licensedcode\data\rules\dco-1.1_5.yml", "YAML", 0, 0, 0, 9, 0, 0, 1, 10
"d:\IDEWORK\lvmen\src\licensedcode\data\rules\dco-1.1_6.yml", "YAML", 0, 0, 0, 5, 0, 0, 1, 6
"d:\IDEWORK\lvmen\src\licensedcode\data\rules\dco-1.1_7.yml", "YAML", 0, 0, 0, 3, 0, 0, 1, 4
"d:\IDEWORK\lvmen\src\licensedcode\data\rules\dco-1.1_8.yml", "YAML", 0, 0, 0, 5, 0, 0, 1, 6
"d:\IDEWORK\lvmen\src\licensedcode\data\rules\dco-1.1_9.yml", "YAML", 0, 0, 0, 5, 0, 0, 1, 6
"d:\IDEWORK\lvmen\src\licensedcode\data\rules\dco-1.1_and_bsd-new_1.yml", "YAML", 0, 0, 0, 3, 0, 0, 1, 4
"d:\IDEWORK\lvmen\src\licensedcode\data\rules\debian_common_apache-2.0-plus.yml", "YAML", 0, 0, 0, 3, 0, 0, 1, 4
"d:\IDEWORK\lvmen\src\licensedcode\data\rules\debian_common_gfdl-1.2-plus.yml", "YAML", 0, 0, 0, 3, 0, 0, 1, 4
"d:\IDEWORK\lvmen\src\licensedcode\data\rules\debian_common_gfdl-1.2.yml", "YAML", 0, 0, 0, 3, 0, 0, 1, 4
"d:\IDEWORK\lvmen\src\licensedcode\data\rules\debian_common_gfdl-1.3-plus.yml", "YAML", 0, 0, 0, 3, 0, 0, 1, 4
"d:\IDEWORK\lvmen\src\licensedcode\data\rules\debian_common_gfdl-plus.yml", "YAML", 0, 0, 0, 3, 0, 0, 1, 4
"d:\IDEWORK\lvmen\src\licensedcode\data\rules\debian_common_gpl-plus.yml", "YAML", 0, 0, 0, 3, 0, 0, 1, 4
"d:\IDEWORK\lvmen\src\licensedcode\data\rules\debian_common_lgpl-plus.yml", "YAML", 0, 0, 0, 3, 0, 0, 1, 4
"d:\IDEWORK\lvmen\src\licensedcode\data\rules\debian_common_mpl-1.1-plus.yml", "YAML", 0, 0, 0, 3, 0, 0, 1, 4
"d:\IDEWORK\lvmen\src\licensedcode\data\rules\debian_common_mpl-2.0-plus.yml", "YAML", 0, 0, 0, 3, 0, 0, 1, 4
"d:\IDEWORK\lvmen\src\licensedcode\data\rules\debian_gpl_footer.yml", "YAML", 0, 0, 0, 2, 0, 0, 1, 3
"d:\IDEWORK\lvmen\src\licensedcode\data\rules\devblocks-1.0_1.yml", "YAML", 0, 0, 0, 5, 0, 0, 1, 6
"d:\IDEWORK\lvmen\src\licensedcode\data\rules\diffmark_url_1.yml", "YAML", 0, 0, 0, 5, 0, 0, 1, 6
"d:\IDEWORK\lvmen\src\licensedcode\data\rules\diffmark_url_2.yml", "YAML", 0, 0, 0, 5, 0, 0, 1, 6
"d:\IDEWORK\lvmen\src\licensedcode\data\rules\digia-qt-commercial_or_gfdl-1.3_1.yml", "YAML", 0, 0, 0, 7, 0, 0, 1, 8
"d:\IDEWORK\lvmen\src\licensedcode\data\rules\digia-qt-commercial_or_gfdl-1.3_qt.yml", "YAML", 0, 0, 0, 6, 0, 0, 1, 7
"d:\IDEWORK\lvmen\src\licensedcode\data\rules\digia-qt-commercial_or_lgpl-2.1_with_qt-company-exception-lgpl-2.1_or_lgpl-3.0_with_qt-company-exception-lgpl-2.1_or_gpl-3.0_1.yml", "YAML", 0, 0, 0, 11, 0, 0, 1, 12
"d:\IDEWORK\lvmen\src\licensedcode\data\rules\digia-qt-commercial_or_lgpl-2.1_with_qt-lgpl-exception-1.1_or_gpl-3.0_1.yml", "YAML", 0, 0, 0, 9, 0, 0, 1, 10
"d:\IDEWORK\lvmen\src\licensedcode\data\rules\digia-qt-commercial_or_lgpl-2.1_with_qt-lgpl-exception-1.1_or_gpl-3.0_2.yml", "YAML", 0, 0, 0, 9, 0, 0, 1, 10
"d:\IDEWORK\lvmen\src\licensedcode\data\rules\digia-qt-commercial_or_lgpl-2.1_with_qt-lgpl-exception-1.1_or_gpl-3.0_3.yml", "YAML", 0, 0, 0, 9, 0, 0, 1, 10
"d:\IDEWORK\lvmen\src\licensedcode\data\rules\digia-qt-commercial_or_lgpl-2.1_with_qt-lgpl-exception-1.1_or_lgpl-3.0_1.yml", "YAML", 0, 0, 0, 9, 0, 0, 1, 10
"d:\IDEWORK\lvmen\src\licensedcode\data\rules\digia-qt-commercial_or_lgpl-3.0_or_gpl-2.0_1.yml", "YAML", 0, 0, 0, 9, 0, 0, 1, 10
"d:\IDEWORK\lvmen\src\licensedcode\data\rules\digia-qt-commercial_or_lgpl-3.0_qt.yml", "YAML", 0, 0, 0, 6, 0, 0, 1, 7
"d:\IDEWORK\lvmen\src\licensedcode\data\rules\digirule-foss-exception_1.yml", "YAML", 0, 0, 0, 4, 0, 0, 1, 5
"d:\IDEWORK\lvmen\src\licensedcode\data\rules\digirule-foss-exception_url_1.yml", "YAML", 0, 0, 0, 5, 0, 0, 1, 6
"d:\IDEWORK\lvmen\src\licensedcode\data\rules\digirule-foss-exception_url_2.yml", "YAML", 0, 0, 0, 5, 0, 0, 1, 6
"d:\IDEWORK\lvmen\src\licensedcode\data\rules\docbook.yml", "YAML", 0, 0, 0, 3, 0, 0, 1, 4
"d:\IDEWORK\lvmen\src\licensedcode\data\rules\dom4j_1.yml", "YAML", 0, 0, 0, 5, 0, 0, 1, 6
"d:\IDEWORK\lvmen\src\licensedcode\data\rules\dom4j_2.yml", "YAML", 0, 0, 0, 5, 0, 0, 1, 6
"d:\IDEWORK\lvmen\src\licensedcode\data\rules\dom4j_3.yml", "YAML", 0, 0, 0, 6, 0, 0, 1, 7
"d:\IDEWORK\lvmen\src\licensedcode\data\rules\dom4j_4.yml", "YAML", 0, 0, 0, 3, 0, 0, 1, 4
"d:\IDEWORK\lvmen\src\licensedcode\data\rules\dom4j_5.yml", "YAML", 0, 0, 0, 4, 0, 0, 1, 5
"d:\IDEWORK\lvmen\src\licensedcode\data\rules\dom4j_6.yml", "YAML", 0, 0, 0, 4, 0, 0, 1, 5
"d:\IDEWORK\lvmen\src\licensedcode\data\rules\dom4j_apache-due-credit_1.yml", "YAML", 0, 0, 0, 8, 0, 0, 1, 9
"d:\IDEWORK\lvmen\src\licensedcode\data\rules\dom4j_apache-due-credit_2.yml", "YAML", 0, 0, 0, 6, 0, 0, 1, 7
"d:\IDEWORK\lvmen\src\licensedcode\data\rules\dom4j_apache-due-credit_3.yml", "YAML", 0, 0, 0, 2, 0, 0, 1, 3
"d:\IDEWORK\lvmen\src\licensedcode\data\rules\dom4j_apache-due-credit_4.yml", "YAML", 0, 0, 0, 2, 0, 0, 1, 3
"d:\IDEWORK\lvmen\src\licensedcode\data\rules\dom4j_classworlds.SPDX.yml", "YAML", 0, 0, 0, 12, 0, 0, 1, 13
"d:\IDEWORK\lvmen\src\licensedcode\data\rules\dom4j_classworlds.yml", "YAML", 0, 0, 0, 5, 0, 0, 1, 6
"d:\IDEWORK\lvmen\src\licensedcode\data\rules\dom4j_url_1.yml", "YAML", 0, 0, 0, 5, 0, 0, 1, 6
"d:\IDEWORK\lvmen\src\licensedcode\data\rules\dom4j_url_2.yml", "YAML", 0, 0, 0, 5, 0, 0, 1, 6
"d:\IDEWORK\lvmen\src\licensedcode\data\rules\dotseqn_url_1.yml", "YAML", 0, 0, 0, 5, 0, 0, 1, 6
"d:\IDEWORK\lvmen\src\licensedcode\data\rules\dotseqn_url_2.yml", "YAML", 0, 0, 0, 5, 0, 0, 1, 6
"d:\IDEWORK\lvmen\src\licensedcode\data\rules\drl-1.0_1.yml", "YAML", 0, 0, 0, 5, 0, 0, 1, 6
"d:\IDEWORK\lvmen\src\licensedcode\data\rules\dsdp_url_1.yml", "YAML", 0, 0, 0, 5, 0, 0, 1, 6
"d:\IDEWORK\lvmen\src\licensedcode\data\rules\dsdp_url_2.yml", "YAML", 0, 0, 0, 5, 0, 0, 1, 6
"d:\IDEWORK\lvmen\src\licensedcode\data\rules\dshell_mit_or_public.yml", "YAML", 0, 0, 0, 4, 0, 0, 1, 5
"d:\IDEWORK\lvmen\src\licensedcode\data\rules\dshell_public.yml", "YAML", 0, 0, 0, 2, 0, 0, 1, 3
"d:\IDEWORK\lvmen\src\licensedcode\data\rules\dtree.yml", "YAML", 0, 0, 0, 5, 0, 0, 1, 6
"d:\IDEWORK\lvmen\src\licensedcode\data\rules\dvipdfm_url_1.yml", "YAML", 0, 0, 0, 5, 0, 0, 1, 6
"d:\IDEWORK\lvmen\src\licensedcode\data\rules\dvipdfm_url_2.yml", "YAML", 0, 0, 0, 5, 0, 0, 1, 6
"d:\IDEWORK\lvmen\src\licensedcode\data\rules\dwtfnmfpl-3.0_1.yml", "YAML", 0, 0, 0, 5, 0, 0, 1, 6
"d:\IDEWORK\lvmen\src\licensedcode\data\rules\ecl-1.0.SPDX.yml", "YAML", 0, 0, 0, 4, 0, 0, 1, 5
"d:\IDEWORK\lvmen\src\licensedcode\data\rules\ecl-1.0.yml", "YAML", 0, 0, 0, 5, 0, 0, 1, 6
"d:\IDEWORK\lvmen\src\licensedcode\data\rules\ecl-1.0_1.yml", "YAML", 0, 0, 0, 5, 0, 0, 1, 6
"d:\IDEWORK\lvmen\src\licensedcode\data\rules\ecl-1.0_2.yml", "YAML", 0, 0, 0, 3, 0, 0, 1, 4
"d:\IDEWORK\lvmen\src\licensedcode\data\rules\ecl-1.0_3.yml", "YAML", 0, 0, 0, 4, 0, 0, 1, 5
"d:\IDEWORK\lvmen\src\licensedcode\data\rules\ecl-1.0_4.yml", "YAML", 0, 0, 0, 3, 0, 0, 1, 4
"d:\IDEWORK\lvmen\src\licensedcode\data\rules\ecl-1.0_5.yml", "YAML", 0, 0, 0, 3, 0, 0, 1, 4
"d:\IDEWORK\lvmen\src\licensedcode\data\rules\ecl-1.0_url_1.yml", "YAML", 0, 0, 0, 5, 0, 0, 1, 6
"d:\IDEWORK\lvmen\src\licensedcode\data\rules\ecl-1.0_url_2.yml", "YAML", 0, 0, 0, 5, 0, 0, 1, 6
"d:\IDEWORK\lvmen\src\licensedcode\data\rules\ecl-1.0_url_glc_76.yml", "YAML", 0, 0, 0, 5, 0, 0, 1, 6
"d:\IDEWORK\lvmen\src\licensedcode\data\rules\ecl-1.0_url_glc_77.yml", "YAML", 0, 0, 0, 5, 0, 0, 1, 6
"d:\IDEWORK\lvmen\src\licensedcode\data\rules\ecl-2.0.SPDX.yml", "YAML", 0, 0, 0, 8, 0, 0, 1, 9
"d:\IDEWORK\lvmen\src\licensedcode\data\rules\ecl-2.0.yml", "YAML", 0, 0, 0, 5, 0, 0, 1, 6
"d:\IDEWORK\lvmen\src\licensedcode\data\rules\ecl-2.0_1.yml", "YAML", 0, 0, 0, 5, 0, 0, 1, 6
"d:\IDEWORK\lvmen\src\licensedcode\data\rules\ecl-2.0_10.yml", "YAML", 0, 0, 0, 8, 0, 0, 1, 9
"d:\IDEWORK\lvmen\src\licensedcode\data\rules\ecl-2.0_11.yml", "YAML", 0, 0, 0, 6, 0, 0, 1, 7
"d:\IDEWORK\lvmen\src\licensedcode\data\rules\ecl-2.0_12.yml", "YAML", 0, 0, 0, 5, 0, 0, 1, 6
"d:\IDEWORK\lvmen\src\licensedcode\data\rules\ecl-2.0_2.yml", "YAML", 0, 0, 0, 3, 0, 0, 1, 4
"d:\IDEWORK\lvmen\src\licensedcode\data\rules\ecl-2.0_3.yml", "YAML", 0, 0, 0, 5, 0, 0, 1, 6
"d:\IDEWORK\lvmen\src\licensedcode\data\rules\ecl-2.0_4.yml", "YAML", 0, 0, 0, 6, 0, 0, 1, 7
"d:\IDEWORK\lvmen\src\licensedcode\data\rules\ecl-2.0_5.yml", "YAML", 0, 0, 0, 5, 0, 0, 1, 6
"d:\IDEWORK\lvmen\src\licensedcode\data\rules\ecl-2.0_6.yml", "YAML", 0, 0, 0, 3, 0, 0, 1, 4
"d:\IDEWORK\lvmen\src\licensedcode\data\rules\ecl-2.0_7.yml", "YAML", 0, 0, 0, 5, 0, 0, 1, 6
"d:\IDEWORK\lvmen\src\licensedcode\data\rules\ecl-2.0_8.yml", "YAML", 0, 0, 0, 5, 0, 0, 1, 6
"d:\IDEWORK\lvmen\src\licensedcode\data\rules\ecl-2.0_9.yml", "YAML", 0, 0, 0, 5, 0, 0, 1, 6
"d:\IDEWORK\lvmen\src\licensedcode\data\rules\ecl-2.0_url_1.yml", "YAML", 0, 0, 0, 5, 0, 0, 1, 6
"d:\IDEWORK\lvmen\src\licensedcode\data\rules\ecl-2.0_url_2.yml", "YAML", 0, 0, 0, 5, 0, 0, 1, 6
"d:\IDEWORK\lvmen\src\licensedcode\data\rules\ecl-2.0_url_glc_78.yml", "YAML", 0, 0, 0, 5, 0, 0, 1, 6
"d:\IDEWORK\lvmen\src\licensedcode\data\rules\ecl-2.0_url_glc_79.yml", "YAML", 0, 0, 0, 5, 0, 0, 1, 6
"d:\IDEWORK\lvmen\src\licensedcode\data\rules\eclipse-sua-2017_1.yml", "YAML", 0, 0, 0, 13, 0, 0, 1, 14
"d:\IDEWORK\lvmen\src\licensedcode\data\rules\eclipse-sua-2017_2.yml", "YAML", 0, 0, 0, 13, 0, 0, 1, 14
"d:\IDEWORK\lvmen\src\licensedcode\data\rules\ecma-documentation_and_bsd-new_with_ecma-no-patent_1.yml", "YAML", 0, 0, 0, 5, 0, 0, 1, 6
"d:\IDEWORK\lvmen\src\licensedcode\data\rules\ecos-exception-2.0_1.yml", "YAML", 0, 0, 0, 2, 0, 0, 1, 3
"d:\IDEWORK\lvmen\src\licensedcode\data\rules\ecos-exception-2.0_url_1.yml", "YAML", 0, 0, 0, 5, 0, 0, 1, 6
"d:\IDEWORK\lvmen\src\licensedcode\data\rules\ecos-exception-2.0_url_2.yml", "YAML", 0, 0, 0, 5, 0, 0, 1, 6
"d:\IDEWORK\lvmen\src\licensedcode\data\rules\ecosrh-1.0_1.yml", "YAML", 0, 0, 0, 5, 0, 0, 1, 6
"d:\IDEWORK\lvmen\src\licensedcode\data\rules\ecosrh-1.0_2.yml", "YAML", 0, 0, 0, 4, 0, 0, 1, 5
"d:\IDEWORK\lvmen\src\licensedcode\data\rules\ecosrh-1.0_3.yml", "YAML", 0, 0, 0, 9, 0, 0, 1, 10
"d:\IDEWORK\lvmen\src\licensedcode\data\rules\ecosrh-1.1_2.yml", "YAML", 0, 0, 0, 3, 0, 0, 1, 4
"d:\IDEWORK\lvmen\src\licensedcode\data\rules\ecosrh-1.1_3.yml", "YAML", 0, 0, 0, 4, 0, 0, 1, 5
"d:\IDEWORK\lvmen\src\licensedcode\data\rules\ecosrh-1.1_4.yml", "YAML", 0, 0, 0, 3, 0, 0, 1, 4
"d:\IDEWORK\lvmen\src\licensedcode\data\rules\ecosrh-1.1_5.yml", "YAML", 0, 0, 0, 5, 0, 0, 1, 6
"d:\IDEWORK\lvmen\src\licensedcode\data\rules\ecosrh-1.1_6.yml", "YAML", 0, 0, 0, 14, 0, 0, 1, 15
"d:\IDEWORK\lvmen\src\licensedcode\data\rules\ecosrh-1.1_or_gpl-2.0.yml", "YAML", 0, 0, 0, 4, 0, 0, 1, 5
"d:\IDEWORK\lvmen\src\licensedcode\data\rules\ecosrh-1.1_url_1.yml", "YAML", 0, 0, 0, 5, 0, 0, 1, 6
"d:\IDEWORK\lvmen\src\licensedcode\data\rules\ecosrh-1.1_url_2.yml", "YAML", 0, 0, 0, 5, 0, 0, 1, 6
"d:\IDEWORK\lvmen\src\licensedcode\data\rules\edl-1.0.yml", "YAML", 0, 0, 0, 5, 0, 0, 1, 6
"d:\IDEWORK\lvmen\src\licensedcode\data\rules\edl-1.0_1.yml", "YAML", 0, 0, 0, 3, 0, 0, 1, 4
"d:\IDEWORK\lvmen\src\licensedcode\data\rules\edl-1.0_2.yml", "YAML", 0, 0, 0, 2, 0, 0, 1, 3
"d:\IDEWORK\lvmen\src\licensedcode\data\rules\edl-1.0_3.yml", "YAML", 0, 0, 0, 5, 0, 0, 1, 6
"d:\IDEWORK\lvmen\src\licensedcode\data\rules\edl-1.0_or_epl-1.0.yml", "YAML", 0, 0, 0, 5, 0, 0, 1, 6
"d:\IDEWORK\lvmen\src\licensedcode\data\rules\efl-1.0.yml", "YAML", 0, 0, 0, 6, 0, 0, 1, 7
"d:\IDEWORK\lvmen\src\licensedcode\data\rules\efl-1.0_1.yml", "YAML", 0, 0, 0, 5, 0, 0, 1, 6
"d:\IDEWORK\lvmen\src\licensedcode\data\rules\efl-1.0_3.yml", "YAML", 0, 0, 0, 5, 0, 0, 1, 6
"d:\IDEWORK\lvmen\src\licensedcode\data\rules\efl-1.0_5.yml", "YAML", 0, 0, 0, 3, 0, 0, 1, 4
"d:\IDEWORK\lvmen\src\licensedcode\data\rules\efl-1.0_url_1.yml", "YAML", 0, 0, 0, 5, 0, 0, 1, 6
"d:\IDEWORK\lvmen\src\licensedcode\data\rules\efl-1.0_url_2.yml", "YAML", 0, 0, 0, 5, 0, 0, 1, 6
"d:\IDEWORK\lvmen\src\licensedcode\data\rules\efl-1.0_url_glc_80.yml", "YAML", 0, 0, 0, 5, 0, 0, 1, 6
"d:\IDEWORK\lvmen\src\licensedcode\data\rules\efl-1.0_url_glc_81.yml", "YAML", 0, 0, 0, 5, 0, 0, 1, 6
"d:\IDEWORK\lvmen\src\licensedcode\data\rules\efl-2.0.SPDX.yml", "YAML", 0, 0, 0, 4, 0, 0, 1, 5
"d:\IDEWORK\lvmen\src\licensedcode\data\rules\efl-2.0.yml", "YAML", 0, 0, 0, 5, 0, 0, 1, 6
"d:\IDEWORK\lvmen\src\licensedcode\data\rules\efl-2.0_1.yml", "YAML", 0, 0, 0, 5, 0, 0, 1, 6
"d:\IDEWORK\lvmen\src\licensedcode\data\rules\efl-2.0_10.yml", "YAML", 0, 0, 0, 5, 0, 0, 1, 6
"d:\IDEWORK\lvmen\src\licensedcode\data\rules\efl-2.0_11.yml", "YAML", 0, 0, 0, 5, 0, 0, 1, 6
"d:\IDEWORK\lvmen\src\licensedcode\data\rules\efl-2.0_12.yml", "YAML", 0, 0, 0, 5, 0, 0, 1, 6
"d:\IDEWORK\lvmen\src\licensedcode\data\rules\efl-2.0_2.yml", "YAML", 0, 0, 0, 6, 0, 0, 1, 7
"d:\IDEWORK\lvmen\src\licensedcode\data\rules\efl-2.0_3.yml", "YAML", 0, 0, 0, 3, 0, 0, 1, 4
"d:\IDEWORK\lvmen\src\licensedcode\data\rules\efl-2.0_4.yml", "YAML", 0, 0, 0, 5, 0, 0, 1, 6
"d:\IDEWORK\lvmen\src\licensedcode\data\rules\efl-2.0_5.yml", "YAML", 0, 0, 0, 5, 0, 0, 1, 6
"d:\IDEWORK\lvmen\src\licensedcode\data\rules\efl-2.0_6.yml", "YAML", 0, 0, 0, 5, 0, 0, 1, 6
"d:\IDEWORK\lvmen\src\licensedcode\data\rules\efl-2.0_7.yml", "YAML", 0, 0, 0, 6, 0, 0, 1, 7
"d:\IDEWORK\lvmen\src\licensedcode\data\rules\efl-2.0_8.yml", "YAML", 0, 0, 0, 5, 0, 0, 1, 6
"d:\IDEWORK\lvmen\src\licensedcode\data\rules\efl-2.0_9.yml", "YAML", 0, 0, 0, 3, 0, 0, 1, 4
"d:\IDEWORK\lvmen\src\licensedcode\data\rules\efl-2.0_url_1.yml", "YAML", 0, 0, 0, 5, 0, 0, 1, 6
"d:\IDEWORK\lvmen\src\licensedcode\data\rules\efl-2.0_url_2.yml", "YAML", 0, 0, 0, 5, 0, 0, 1, 6
"d:\IDEWORK\lvmen\src\licensedcode\data\rules\efl-2.0_url_glc_82.yml", "YAML", 0, 0, 0, 5, 0, 0, 1, 6
"d:\IDEWORK\lvmen\src\licensedcode\data\rules\efl-2.0_url_glc_83.yml", "YAML", 0, 0, 0, 5, 0, 0, 1, 6
"d:\IDEWORK\lvmen\src\licensedcode\data\rules\egenix-1.1.0.yml", "YAML", 0, 0, 0, 4, 0, 0, 1, 5
"d:\IDEWORK\lvmen\src\licensedcode\data\rules\egenix-1.1.0_1.yml", "YAML", 0, 0, 0, 7, 0, 0, 1, 8
"d:\IDEWORK\lvmen\src\licensedcode\data\rules\egenix-1.1.0_2.yml", "YAML", 0, 0, 0, 8, 0, 0, 1, 9
"d:\IDEWORK\lvmen\src\licensedcode\data\rules\egenix-1.1.0_url_1.yml", "YAML", 0, 0, 0, 5, 0, 0, 1, 6
"d:\IDEWORK\lvmen\src\licensedcode\data\rules\egenix-1.1.0_url_2.yml", "YAML", 0, 0, 0, 5, 0, 0, 1, 6
"d:\IDEWORK\lvmen\src\licensedcode\data\rules\ej-technologies-eula.yml", "YAML", 0, 0, 0, 5, 0, 0, 1, 6
"d:\IDEWORK\lvmen\src\licensedcode\data\rules\ekioh_1.yml", "YAML", 0, 0, 0, 6, 0, 0, 1, 7
"d:\IDEWORK\lvmen\src\licensedcode\data\rules\ekioh_2.yml", "YAML", 0, 0, 0, 4, 0, 0, 1, 5
"d:\IDEWORK\lvmen\src\licensedcode\data\rules\ekioh_3.yml", "YAML", 0, 0, 0, 4, 0, 0, 1, 5
"d:\IDEWORK\lvmen\src\licensedcode\data\rules\ekioh_4.yml", "YAML", 0, 0, 0, 4, 0, 0, 1, 5
"d:\IDEWORK\lvmen\src\licensedcode\data\rules\ekioh_mit_like2.yml", "YAML", 0, 0, 0, 5, 0, 0, 1, 6
"d:\IDEWORK\lvmen\src\licensedcode\data\rules\elastic-license-2018_1.yml", "YAML", 0, 0, 0, 4, 0, 0, 1, 5
"d:\IDEWORK\lvmen\src\licensedcode\data\rules\elastic-license-2018_10.yml", "YAML", 0, 0, 0, 4, 0, 0, 2, 6
"d:\IDEWORK\lvmen\src\licensedcode\data\rules\elastic-license-2018_2.yml", "YAML", 0, 0, 0, 4, 0, 0, 1, 5
"d:\IDEWORK\lvmen\src\licensedcode\data\rules\elastic-license-2018_3.yml", "YAML", 0, 0, 0, 4, 0, 0, 1, 5
"d:\IDEWORK\lvmen\src\licensedcode\data\rules\elastic-license-2018_4.yml", "YAML", 0, 0, 0, 6, 0, 0, 1, 7
"d:\IDEWORK\lvmen\src\licensedcode\data\rules\elastic-license-2018_5.yml", "YAML", 0, 0, 0, 4, 0, 0, 1, 5
"d:\IDEWORK\lvmen\src\licensedcode\data\rules\elastic-license-2018_6.yml", "YAML", 0, 0, 0, 6, 0, 0, 1, 7
"d:\IDEWORK\lvmen\src\licensedcode\data\rules\elastic-license-2018_7.yml", "YAML", 0, 0, 0, 4, 0, 0, 2, 6
"d:\IDEWORK\lvmen\src\licensedcode\data\rules\elastic-license-2018_8.yml", "YAML", 0, 0, 0, 4, 0, 0, 2, 6
"d:\IDEWORK\lvmen\src\licensedcode\data\rules\elastic-license-2018_9.yml", "YAML", 0, 0, 0, 4, 0, 0, 2, 6
"d:\IDEWORK\lvmen\src\licensedcode\data\rules\elastic-license-v2_1.yml", "YAML", 0, 0, 0, 5, 0, 0, 1, 6
"d:\IDEWORK\lvmen\src\licensedcode\data\rules\elastic-license-v2_2.yml", "YAML", 0, 0, 0, 5, 0, 0, 1, 6
"d:\IDEWORK\lvmen\src\licensedcode\data\rules\elastic-license-v2_3.yml", "YAML", 0, 0, 0, 3, 0, 0, 1, 4
"d:\IDEWORK\lvmen\src\licensedcode\data\rules\elastic-license-v2_4.yml", "YAML", 0, 0, 0, 3, 0, 0, 1, 4
"d:\IDEWORK\lvmen\src\licensedcode\data\rules\elastic-license-v2_5.yml", "YAML", 0, 0, 0, 5, 0, 0, 1, 6
"d:\IDEWORK\lvmen\src\licensedcode\data\rules\elastic-license-v2_or_mongodb-sspl-1.0_1.yml", "YAML", 0, 0, 0, 8, 0, 0, 1, 9
"d:\IDEWORK\lvmen\src\licensedcode\data\rules\elastic-license-v2_or_mongodb-sspl-1.0_2.yml", "YAML", 0, 0, 0, 6, 0, 0, 2, 8
"d:\IDEWORK\lvmen\src\licensedcode\data\rules\elastic-license-v2_or_mongodb-sspl-1.0_3.yml", "YAML", 0, 0, 0, 6, 0, 0, 1, 7
"d:\IDEWORK\lvmen\src\licensedcode\data\rules\elastic-license-v2_or_mongodb-sspl-1.0_4.yml", "YAML", 0, 0, 0, 6, 0, 0, 1, 7
"d:\IDEWORK\lvmen\src\licensedcode\data\rules\elastic_1.yml", "YAML", 0, 0, 0, 3, 0, 0, 1, 4
"d:\IDEWORK\lvmen\src\licensedcode\data\rules\elastic_2.yml", "YAML", 0, 0, 0, 3, 0, 0, 1, 4
"d:\IDEWORK\lvmen\src\licensedcode\data\rules\elib-gpl.yml", "YAML", 0, 0, 0, 3, 0, 0, 1, 4
"d:\IDEWORK\lvmen\src\licensedcode\data\rules\elib-gpl_1.yml", "YAML", 0, 0, 0, 5, 0, 0, 1, 6
"d:\IDEWORK\lvmen\src\licensedcode\data\rules\elib-gpl_2.yml", "YAML", 0, 0, 0, 3, 0, 0, 1, 4
"d:\IDEWORK\lvmen\src\licensedcode\data\rules\elib-gpl_3.yml", "YAML", 0, 0, 0, 5, 0, 0, 1, 6
"d:\IDEWORK\lvmen\src\licensedcode\data\rules\elib-gpl_4.yml", "YAML", 0, 0, 0, 5, 0, 0, 1, 6
"d:\IDEWORK\lvmen\src\licensedcode\data\rules\emit_0.yml", "YAML", 0, 0, 0, 6, 0, 0, 1, 7
"d:\IDEWORK\lvmen\src\licensedcode\data\rules\emit_1.yml", "YAML", 0, 0, 0, 2, 0, 0, 1, 3
"d:\IDEWORK\lvmen\src\licensedcode\data\rules\emit_2.yml", "YAML", 0, 0, 0, 4, 0, 0, 1, 5
"d:\IDEWORK\lvmen\src\licensedcode\data\rules\emx-library.yml", "YAML", 0, 0, 0, 5, 0, 0, 1, 6
"d:\IDEWORK\lvmen\src\licensedcode\data\rules\enhydra-1.1.yml", "YAML", 0, 0, 0, 5, 0, 0, 1, 6
"d:\IDEWORK\lvmen\src\licensedcode\data\rules\enlightenment_url_1.yml", "YAML", 0, 0, 0, 5, 0, 0, 1, 6
"d:\IDEWORK\lvmen\src\licensedcode\data\rules\enlightenment_url_2.yml", "YAML", 0, 0, 0, 5, 0, 0, 1, 6
"d:\IDEWORK\lvmen\src\licensedcode\data\rules\enna_url_1.yml", "YAML", 0, 0, 0, 5, 0, 0, 1, 6
"d:\IDEWORK\lvmen\src\licensedcode\data\rules\enna_url_2.yml", "YAML", 0, 0, 0, 5, 0, 0, 1, 6
"d:\IDEWORK\lvmen\src\licensedcode\data\rules\entessa-1.0.SPDX.yml", "YAML", 0, 0, 0, 15, 0, 0, 1, 16
"d:\IDEWORK\lvmen\src\licensedcode\data\rules\entessa-1.0.yml", "YAML", 0, 0, 0, 5, 0, 0, 1, 6
"d:\IDEWORK\lvmen\src\licensedcode\data\rules\entessa-1.0_1.yml", "YAML", 0, 0, 0, 5, 0, 0, 1, 6
"d:\IDEWORK\lvmen\src\licensedcode\data\rules\entessa-1.0_2.yml", "YAML", 0, 0, 0, 5, 0, 0, 1, 6
"d:\IDEWORK\lvmen\src\licensedcode\data\rules\entessa-1.0_3.yml", "YAML", 0, 0, 0, 5, 0, 0, 1, 6
"d:\IDEWORK\lvmen\src\licensedcode\data\rules\entessa-1.0_4.yml", "YAML", 0, 0, 0, 3, 0, 0, 1, 4
"d:\IDEWORK\lvmen\src\licensedcode\data\rules\entessa-1.0_url_1.yml", "YAML", 0, 0, 0, 5, 0, 0, 1, 6
"d:\IDEWORK\lvmen\src\licensedcode\data\rules\entessa-1.0_url_2.yml", "YAML", 0, 0, 0, 5, 0, 0, 1, 6
"d:\IDEWORK\lvmen\src\licensedcode\data\rules\entessa-1.0_url_glc_84.yml", "YAML", 0, 0, 0, 5, 0, 0, 1, 6
"d:\IDEWORK\lvmen\src\licensedcode\data\rules\entessa-1.0_url_glc_85.yml", "YAML", 0, 0, 0, 5, 0, 0, 1, 6
"d:\IDEWORK\lvmen\src\licensedcode\data\rules\epics.yml", "YAML", 0, 0, 0, 5, 0, 0, 1, 6
"d:\IDEWORK\lvmen\src\licensedcode\data\rules\epics_1.yml", "YAML", 0, 0, 0, 2, 0, 0, 1, 3
"d:\IDEWORK\lvmen\src\licensedcode\data\rules\epics_2.yml", "YAML", 0, 0, 0, 3, 0, 0, 1, 4
"d:\IDEWORK\lvmen\src\licensedcode\data\rules\epics_3.yml", "YAML", 0, 0, 0, 2, 0, 0, 1, 3
"d:\IDEWORK\lvmen\src\licensedcode\data\rules\epics_and_proprietary-license_1.yml", "YAML", 0, 0, 0, 4, 0, 0, 1, 5
"d:\IDEWORK\lvmen\src\licensedcode\data\rules\epl-1.0.yml", "YAML", 0, 0, 0, 5, 0, 0, 1, 6
"d:\IDEWORK\lvmen\src\licensedcode\data\rules\epl-1.0_1.yml", "YAML", 0, 0, 0, 3, 0, 0, 1, 4
"d:\IDEWORK\lvmen\src\licensedcode\data\rules\epl-1.0_10.yml", "YAML", 0, 0, 0, 5, 0, 0, 1, 6
"d:\IDEWORK\lvmen\src\licensedcode\data\rules\epl-1.0_11.yml", "YAML", 0, 0, 0, 5, 0, 0, 1, 6
"d:\IDEWORK\lvmen\src\licensedcode\data\rules\epl-1.0_12.yml", "YAML", 0, 0, 0, 2, 0, 0, 1, 3
"d:\IDEWORK\lvmen\src\licensedcode\data\rules\epl-1.0_13.yml", "YAML", 0, 0, 0, 6, 0, 0, 1, 7
"d:\IDEWORK\lvmen\src\licensedcode\data\rules\epl-1.0_14.yml", "YAML", 0, 0, 0, 5, 0, 0, 1, 6
"d:\IDEWORK\lvmen\src\licensedcode\data\rules\epl-1.0_15.yml", "YAML", 0, 0, 0, 5, 0, 0, 1, 6
"d:\IDEWORK\lvmen\src\licensedcode\data\rules\epl-1.0_16.yml", "YAML", 0, 0, 0, 4, 0, 0, 1, 5
"d:\IDEWORK\lvmen\src\licensedcode\data\rules\epl-1.0_17.yml", "YAML", 0, 0, 0, 2, 0, 0, 1, 3
"d:\IDEWORK\lvmen\src\licensedcode\data\rules\epl-1.0_18.yml", "YAML", 0, 0, 0, 3, 0, 0, 1, 4
"d:\IDEWORK\lvmen\src\licensedcode\data\rules\epl-1.0_19.yml", "YAML", 0, 0, 0, 5, 0, 0, 1, 6
"d:\IDEWORK\lvmen\src\licensedcode\data\rules\epl-1.0_2.yml", "YAML", 0, 0, 0, 4, 0, 0, 1, 5
"d:\IDEWORK\lvmen\src\licensedcode\data\rules\epl-1.0_20.yml", "YAML", 0, 0, 0, 5, 0, 0, 1, 6
"d:\IDEWORK\lvmen\src\licensedcode\data\rules\epl-1.0_21.yml", "YAML", 0, 0, 0, 5, 0, 0, 1, 6
"d:\IDEWORK\lvmen\src\licensedcode\data\rules\epl-1.0_22.yml", "YAML", 0, 0, 0, 5, 0, 0, 1, 6
"d:\IDEWORK\lvmen\src\licensedcode\data\rules\epl-1.0_23.yml", "YAML", 0, 0, 0, 3, 0, 0, 1, 4
"d:\IDEWORK\lvmen\src\licensedcode\data\rules\epl-1.0_24.yml", "YAML", 0, 0, 0, 5, 0, 0, 1, 6
"d:\IDEWORK\lvmen\src\licensedcode\data\rules\epl-1.0_25.yml", "YAML", 0, 0, 0, 4, 0, 0, 1, 5
"d:\IDEWORK\lvmen\src\licensedcode\data\rules\epl-1.0_26.yml", "YAML", 0, 0, 0, 3, 0, 0, 1, 4
"d:\IDEWORK\lvmen\src\licensedcode\data\rules\epl-1.0_27.yml", "YAML", 0, 0, 0, 5, 0, 0, 1, 6
"d:\IDEWORK\lvmen\src\licensedcode\data\rules\epl-1.0_28.yml", "YAML", 0, 0, 0, 5, 0, 0, 1, 6
"d:\IDEWORK\lvmen\src\licensedcode\data\rules\epl-1.0_29.yml", "YAML", 0, 0, 0, 3, 0, 0, 1, 4
"d:\IDEWORK\lvmen\src\licensedcode\data\rules\epl-1.0_3.yml", "YAML", 0, 0, 0, 5, 0, 0, 1, 6
"d:\IDEWORK\lvmen\src\licensedcode\data\rules\epl-1.0_30.yml", "YAML", 0, 0, 0, 5, 0, 0, 1, 6
"d:\IDEWORK\lvmen\src\licensedcode\data\rules\epl-1.0_31.yml", "YAML", 0, 0, 0, 6, 0, 0, 1, 7
"d:\IDEWORK\lvmen\src\licensedcode\data\rules\epl-1.0_32.yml", "YAML", 0, 0, 0, 6, 0, 0, 1, 7
"d:\IDEWORK\lvmen\src\licensedcode\data\rules\epl-1.0_33.yml", "YAML", 0, 0, 0, 5, 0, 0, 1, 6
"d:\IDEWORK\lvmen\src\licensedcode\data\rules\epl-1.0_34.yml", "YAML", 0, 0, 0, 5, 0, 0, 1, 6
"d:\IDEWORK\lvmen\src\licensedcode\data\rules\epl-1.0_35.yml", "YAML", 0, 0, 0, 5, 0, 0, 1, 6
"d:\IDEWORK\lvmen\src\licensedcode\data\rules\epl-1.0_36.yml", "YAML", 0, 0, 0, 5, 0, 0, 1, 6
"d:\IDEWORK\lvmen\src\licensedcode\data\rules\epl-1.0_37.yml", "YAML", 0, 0, 0, 3, 0, 0, 1, 4
"d:\IDEWORK\lvmen\src\licensedcode\data\rules\epl-1.0_38.yml", "YAML", 0, 0, 0, 5, 0, 0, 1, 6
"d:\IDEWORK\lvmen\src\licensedcode\data\rules\epl-1.0_39.yml", "YAML", 0, 0, 0, 3, 0, 0, 1, 4
"d:\IDEWORK\lvmen\src\licensedcode\data\rules\epl-1.0_4.yml", "YAML", 0, 0, 0, 3, 0, 0, 1, 4
"d:\IDEWORK\lvmen\src\licensedcode\data\rules\epl-1.0_40.yml", "YAML", 0, 0, 0, 3, 0, 0, 1, 4
"d:\IDEWORK\lvmen\src\licensedcode\data\rules\epl-1.0_41.yml", "YAML", 0, 0, 0, 3, 0, 0, 1, 4
"d:\IDEWORK\lvmen\src\licensedcode\data\rules\epl-1.0_42.yml", "YAML", 0, 0, 0, 3, 0, 0, 1, 4
"d:\IDEWORK\lvmen\src\licensedcode\data\rules\epl-1.0_43.yml", "YAML", 0, 0, 0, 3, 0, 0, 1, 4
"d:\IDEWORK\lvmen\src\licensedcode\data\rules\epl-1.0_44.yml", "YAML", 0, 0, 0, 3, 0, 0, 1, 4
"d:\IDEWORK\lvmen\src\licensedcode\data\rules\epl-1.0_45.yml", "YAML", 0, 0, 0, 7, 0, 0, 1, 8
"d:\IDEWORK\lvmen\src\licensedcode\data\rules\epl-1.0_46.yml", "YAML", 0, 0, 0, 3, 0, 0, 1, 4
"d:\IDEWORK\lvmen\src\licensedcode\data\rules\epl-1.0_47.yml", "YAML", 0, 0, 0, 3, 0, 0, 1, 4
"d:\IDEWORK\lvmen\src\licensedcode\data\rules\epl-1.0_48.yml", "YAML", 0, 0, 0, 3, 0, 0, 1, 4
"d:\IDEWORK\lvmen\src\licensedcode\data\rules\epl-1.0_49.yml", "YAML", 0, 0, 0, 3, 0, 0, 1, 4
"d:\IDEWORK\lvmen\src\licensedcode\data\rules\epl-1.0_5.yml", "YAML", 0, 0, 0, 5, 0, 0, 1, 6
"d:\IDEWORK\lvmen\src\licensedcode\data\rules\epl-1.0_50.yml", "YAML", 0, 0, 0, 3, 0, 0, 1, 4
"d:\IDEWORK\lvmen\src\licensedcode\data\rules\epl-1.0_51.yml", "YAML", 0, 0, 0, 5, 0, 0, 1, 6
"d:\IDEWORK\lvmen\src\licensedcode\data\rules\epl-1.0_52.yml", "YAML", 0, 0, 0, 5, 0, 0, 1, 6
"d:\IDEWORK\lvmen\src\licensedcode\data\rules\epl-1.0_53.yml", "YAML", 0, 0, 0, 3, 0, 0, 1, 4
"d:\IDEWORK\lvmen\src\licensedcode\data\rules\epl-1.0_54.yml", "YAML", 0, 0, 0, 5, 0, 0, 1, 6
"d:\IDEWORK\lvmen\src\licensedcode\data\rules\epl-1.0_55.yml", "YAML", 0, 0, 0, 3, 0, 0, 1, 4
"d:\IDEWORK\lvmen\src\licensedcode\data\rules\epl-1.0_56.yml", "YAML", 0, 0, 0, 3, 0, 0, 1, 4
"d:\IDEWORK\lvmen\src\licensedcode\data\rules\epl-1.0_57.yml", "YAML", 0, 0, 0, 3, 0, 0, 1, 4
"d:\IDEWORK\lvmen\src\licensedcode\data\rules\epl-1.0_58.yml", "YAML", 0, 0, 0, 3, 0, 0, 1, 4
"d:\IDEWORK\lvmen\src\licensedcode\data\rules\epl-1.0_59.yml", "YAML", 0, 0, 0, 3, 0, 0, 1, 4
"d:\IDEWORK\lvmen\src\licensedcode\data\rules\epl-1.0_6.yml", "YAML", 0, 0, 0, 3, 0, 0, 1, 4
"d:\IDEWORK\lvmen\src\licensedcode\data\rules\epl-1.0_60.yml", "YAML", 0, 0, 0, 3, 0, 0, 1, 4
"d:\IDEWORK\lvmen\src\licensedcode\data\rules\epl-1.0_61.yml", "YAML", 0, 0, 0, 10, 0, 0, 1, 11
"d:\IDEWORK\lvmen\src\licensedcode\data\rules\epl-1.0_62.yml", "YAML", 0, 0, 0, 10, 0, 0, 1, 11
"d:\IDEWORK\lvmen\src\licensedcode\data\rules\epl-1.0_63.yml", "YAML", 0, 0, 0, 5, 0, 0, 1, 6
"d:\IDEWORK\lvmen\src\licensedcode\data\rules\epl-1.0_64.yml", "YAML", 0, 0, 0, 3, 0, 0, 1, 4
"d:\IDEWORK\lvmen\src\licensedcode\data\rules\epl-1.0_65.yml", "YAML", 0, 0, 0, 3, 0, 0, 1, 4
"d:\IDEWORK\lvmen\src\licensedcode\data\rules\epl-1.0_66.yml", "YAML", 0, 0, 0, 4, 0, 0, 1, 5
"d:\IDEWORK\lvmen\src\licensedcode\data\rules\epl-1.0_67.yml", "YAML", 0, 0, 0, 5, 0, 0, 1, 6
"d:\IDEWORK\lvmen\src\licensedcode\data\rules\epl-1.0_68.yml", "YAML", 0, 0, 0, 5, 0, 0, 1, 6
"d:\IDEWORK\lvmen\src\licensedcode\data\rules\epl-1.0_69.yml", "YAML", 0, 0, 0, 6, 0, 0, 1, 7
"d:\IDEWORK\lvmen\src\licensedcode\data\rules\epl-1.0_7.yml", "YAML", 0, 0, 0, 5, 0, 0, 1, 6
"d:\IDEWORK\lvmen\src\licensedcode\data\rules\epl-1.0_70.yml", "YAML", 0, 0, 0, 4, 0, 0, 1, 5
"d:\IDEWORK\lvmen\src\licensedcode\data\rules\epl-1.0_71.yml", "YAML", 0, 0, 0, 3, 0, 0, 1, 4
"d:\IDEWORK\lvmen\src\licensedcode\data\rules\epl-1.0_72.yml", "YAML", 0, 0, 0, 3, 0, 0, 1, 4
"d:\IDEWORK\lvmen\src\licensedcode\data\rules\epl-1.0_73.yml", "YAML", 0, 0, 0, 5, 0, 0, 1, 6
"d:\IDEWORK\lvmen\src\licensedcode\data\rules\epl-1.0_8.yml", "YAML", 0, 0, 0, 5, 0, 0, 1, 6
"d:\IDEWORK\lvmen\src\licensedcode\data\rules\epl-1.0_9.yml", "YAML", 0, 0, 0, 5, 0, 0, 1, 6
"d:\IDEWORK\lvmen\src\licensedcode\data\rules\epl-1.0_and_bsd-new_1.yml", "YAML", 0, 0, 0, 6, 0, 0, 1, 7
"d:\IDEWORK\lvmen\src\licensedcode\data\rules\epl-1.0_and_bsd-new_2.yml", "YAML", 0, 0, 0, 2, 0, 0, 1, 3
"d:\IDEWORK\lvmen\src\licensedcode\data\rules\epl-1.0_and_bsd-new_3.yml", "YAML", 0, 0, 0, 5, 0, 0, 1, 6
"d:\IDEWORK\lvmen\src\licensedcode\data\rules\epl-1.0_and_bsd-new_4.yml", "YAML", 0, 0, 0, 7, 0, 0, 1, 8
"d:\IDEWORK\lvmen\src\licensedcode\data\rules\epl-1.0_and_epl-2.0_1.yml", "YAML", 0, 0, 0, 7, 0, 0, 1, 8
"d:\IDEWORK\lvmen\src\licensedcode\data\rules\epl-1.0_and_other-copyleft_1.yml", "YAML", 0, 0, 0, 3, 0, 0, 1, 4
"d:\IDEWORK\lvmen\src\licensedcode\data\rules\epl-1.0_markdown.yml", "YAML", 0, 0, 0, 2, 0, 0, 1, 3
"d:\IDEWORK\lvmen\src\licensedcode\data\rules\epl-1.0_or_apache-2.0.yml", "YAML", 0, 0, 0, 6, 0, 0, 1, 7
"d:\IDEWORK\lvmen\src\licensedcode\data\rules\epl-1.0_or_apache-2.0_1.yml", "YAML", 0, 0, 0, 7, 0, 0, 1, 8
"d:\IDEWORK\lvmen\src\licensedcode\data\rules\epl-1.0_or_apache-2.0_2.yml", "YAML", 0, 0, 0, 7, 0, 0, 1, 8
"d:\IDEWORK\lvmen\src\licensedcode\data\rules\epl-1.0_or_apache-2.0_and_bsd-new_and_mit_and_others_1.yml", "YAML", 0, 0, 0, 7, 0, 0, 1, 8
"d:\IDEWORK\lvmen\src\licensedcode\data\rules\epl-1.0_or_apache-2.0_and_others.yml", "YAML", 0, 0, 0, 3, 0, 0, 1, 4
"d:\IDEWORK\lvmen\src\licensedcode\data\rules\epl-1.0_or_apache-2.0_and_others2.yml", "YAML", 0, 0, 0, 7, 0, 0, 1, 8
"d:\IDEWORK\lvmen\src\licensedcode\data\rules\epl-1.0_or_bsd-new_1.yml", "YAML", 0, 0, 0, 6, 0, 0, 1, 7
"d:\IDEWORK\lvmen\src\licensedcode\data\rules\epl-1.0_or_bsd-new_2.yml", "YAML", 0, 0, 0, 8, 0, 0, 1, 9
"d:\IDEWORK\lvmen\src\licensedcode\data\rules\epl-1.0_or_bsd-new_3.yml", "YAML", 0, 0, 0, 5, 0, 0, 1, 6
"d:\IDEWORK\lvmen\src\licensedcode\data\rules\epl-1.0_or_bsd-new_4.yml", "YAML", 0, 0, 0, 2, 0, 0, 1, 3
"d:\IDEWORK\lvmen\src\licensedcode\data\rules\epl-1.0_or_bsd-new_5.yml", "YAML", 0, 0, 0, 5, 0, 0, 1, 6
"d:\IDEWORK\lvmen\src\licensedcode\data\rules\epl-1.0_or_gpl-2.0-plus_1.yml", "YAML", 0, 0, 0, 3, 0, 0, 1, 4
"d:\IDEWORK\lvmen\src\licensedcode\data\rules\epl-1.0_or_gpl-2.0-plus_or_lgpl-2.1-plus_1.yml", "YAML", 0, 0, 0, 5, 0, 0, 1, 6
"d:\IDEWORK\lvmen\src\licensedcode\data\rules\epl-1.0_or_gpl-2.0_or_lgpl-2.1_1.yml", "YAML", 0, 0, 0, 2, 0, 0, 1, 3
"d:\IDEWORK\lvmen\src\licensedcode\data\rules\epl-1.0_or_gpl-2.0_or_lgpl-2.1_2.yml", "YAML", 0, 0, 0, 5, 0, 0, 1, 6
"d:\IDEWORK\lvmen\src\licensedcode\data\rules\epl-1.0_or_lgpl-2.1-plus_1.yml", "YAML", 0, 0, 0, 5, 0, 0, 1, 6
"d:\IDEWORK\lvmen\src\licensedcode\data\rules\epl-1.0_or_lgpl-2.1-plus_2.yml", "YAML", 0, 0, 0, 3, 0, 0, 1, 4
"d:\IDEWORK\lvmen\src\licensedcode\data\rules\epl-1.0_or_lgpl-2.1-plus_3.yml", "YAML", 0, 0, 0, 6, 0, 0, 1, 7
"d:\IDEWORK\lvmen\src\licensedcode\data\rules\epl-1.0_or_lgpl-2.1-plus_4.yml", "YAML", 0, 0, 0, 7, 0, 0, 1, 8
"d:\IDEWORK\lvmen\src\licensedcode\data\rules\epl-1.0_or_lgpl-2.1-plus_5.yml", "YAML", 0, 0, 0, 7, 0, 0, 1, 8
"d:\IDEWORK\lvmen\src\licensedcode\data\rules\epl-1.0_or_lgpl-2.1-plus_or_gpl-2.0-plus_or_agpl-3.0-plus_or_apache-2.0_or_and_others_1.yml", "YAML", 0, 0, 0, 13, 0, 0, 1, 14
"d:\IDEWORK\lvmen\src\licensedcode\data\rules\epl-1.0_or_lgpl-2.1-plus_or_gpl-2.0-plus_or_agpl-3.0-plus_or_apache-2.0_or_bsd-new_or_mit_1.yml", "YAML", 0, 0, 0, 14, 0, 0, 1, 15
"d:\IDEWORK\lvmen\src\licensedcode\data\rules\epl-1.0_or_lgpl-2.1-plus_or_gpl-2.0-plus_or_agpl-3.0-plus_or_apache-2.0_or_bsd-new_or_mit_2.yml", "YAML", 0, 0, 0, 14, 0, 0, 1, 15
"d:\IDEWORK\lvmen\src\licensedcode\data\rules\epl-1.0_or_lgpl-2.1-plus_or_gpl-2.0-plus_or_apache-2.0_or_bsd-new_1.yml", "YAML", 0, 0, 0, 10, 0, 0, 1, 11
"d:\IDEWORK\lvmen\src\licensedcode\data\rules\epl-1.0_or_lgpl-2.1-plus_or_gpl-2.0-plus_or_apache-2.0_or_bsd-new_2.yml", "YAML", 0, 0, 0, 4, 0, 0, 1, 5
"d:\IDEWORK\lvmen\src\licensedcode\data\rules\epl-1.0_or_lgpl-2.1-plus_or_gpl-2.0-plus_or_apache-2.0_or_bsd-new_3.yml", "YAML", 0, 0, 0, 10, 0, 0, 1, 11
"d:\IDEWORK\lvmen\src\licensedcode\data\rules\epl-1.0_or_lgpl-2.1-plus_or_gpl-2.0-plus_or_apache-2.0_or_bsd-new_4.yml", "YAML", 0, 0, 0, 10, 0, 0, 1, 11
"d:\IDEWORK\lvmen\src\licensedcode\data\rules\epl-1.0_or_lgpl-2.1-plus_or_gpl-2.0-plus_or_apache-2.0_or_bsd-new_5.yml", "YAML", 0, 0, 0, 10, 0, 0, 1, 11
"d:\IDEWORK\lvmen\src\licensedcode\data\rules\epl-1.0_or_lgpl-2.1.yml", "YAML", 0, 0, 0, 2, 0, 0, 1, 3
"d:\IDEWORK\lvmen\src\licensedcode\data\rules\epl-1.0_or_lgpl-2.1_1.yml", "YAML", 0, 0, 0, 6, 0, 0, 1, 7
"d:\IDEWORK\lvmen\src\licensedcode\data\rules\epl-1.0_or_lgpl-2.1_2.yml", "YAML", 0, 0, 0, 7, 0, 0, 1, 8
"d:\IDEWORK\lvmen\src\licensedcode\data\rules\epl-1.0_url_1.yml", "YAML", 0, 0, 0, 5, 0, 0, 1, 6
"d:\IDEWORK\lvmen\src\licensedcode\data\rules\epl-1.0_url_2.yml", "YAML", 0, 0, 0, 5, 0, 0, 1, 6
"d:\IDEWORK\lvmen\src\licensedcode\data\rules\epl-1.0_url_badge.yml", "YAML", 0, 0, 0, 5, 0, 0, 1, 6
"d:\IDEWORK\lvmen\src\licensedcode\data\rules\epl-1.0_url_glc_154.yml", "YAML", 0, 0, 0, 5, 0, 0, 1, 6
"d:\IDEWORK\lvmen\src\licensedcode\data\rules\epl-1.0_url_glc_155.yml", "YAML", 0, 0, 0, 5, 0, 0, 1, 6
"d:\IDEWORK\lvmen\src\licensedcode\data\rules\epl-2.0_1.yml", "YAML", 0, 0, 0, 7, 0, 0, 1, 8
"d:\IDEWORK\lvmen\src\licensedcode\data\rules\epl-2.0_10.yml", "YAML", 0, 0, 0, 2, 0, 0, 1, 3
"d:\IDEWORK\lvmen\src\licensedcode\data\rules\epl-2.0_11.yml", "YAML", 0, 0, 0, 2, 0, 0, 1, 3
"d:\IDEWORK\lvmen\src\licensedcode\data\rules\epl-2.0_12.yml", "YAML", 0, 0, 0, 3, 0, 0, 1, 4
"d:\IDEWORK\lvmen\src\licensedcode\data\rules\epl-2.0_13.yml", "YAML", 0, 0, 0, 3, 0, 0, 1, 4
"d:\IDEWORK\lvmen\src\licensedcode\data\rules\epl-2.0_14.yml", "YAML", 0, 0, 0, 4, 0, 0, 1, 5
"d:\IDEWORK\lvmen\src\licensedcode\data\rules\epl-2.0_15.yml", "YAML", 0, 0, 0, 4, 0, 0, 1, 5
"d:\IDEWORK\lvmen\src\licensedcode\data\rules\epl-2.0_16.yml", "YAML", 0, 0, 0, 5, 0, 0, 1, 6
"d:\IDEWORK\lvmen\src\licensedcode\data\rules\epl-2.0_17.yml", "YAML", 0, 0, 0, 3, 0, 0, 1, 4
"d:\IDEWORK\lvmen\src\licensedcode\data\rules\epl-2.0_18.yml", "YAML", 0, 0, 0, 5, 0, 0, 1, 6
"d:\IDEWORK\lvmen\src\licensedcode\data\rules\epl-2.0_19.yml", "YAML", 0, 0, 0, 5, 0, 0, 1, 6
"d:\IDEWORK\lvmen\src\licensedcode\data\rules\epl-2.0_2.yml", "YAML", 0, 0, 0, 5, 0, 0, 1, 6
"d:\IDEWORK\lvmen\src\licensedcode\data\rules\epl-2.0_20.yml", "YAML", 0, 0, 0, 5, 0, 0, 1, 6
"d:\IDEWORK\lvmen\src\licensedcode\data\rules\epl-2.0_21.yml", "YAML", 0, 0, 0, 5, 0, 0, 1, 6
"d:\IDEWORK\lvmen\src\licensedcode\data\rules\epl-2.0_22.yml", "YAML", 0, 0, 0, 5, 0, 0, 1, 6
"d:\IDEWORK\lvmen\src\licensedcode\data\rules\epl-2.0_23.yml", "YAML", 0, 0, 0, 5, 0, 0, 1, 6
"d:\IDEWORK\lvmen\src\licensedcode\data\rules\epl-2.0_24.yml", "YAML", 0, 0, 0, 5, 0, 0, 1, 6
"d:\IDEWORK\lvmen\src\licensedcode\data\rules\epl-2.0_25.yml", "YAML", 0, 0, 0, 5, 0, 0, 1, 6
"d:\IDEWORK\lvmen\src\licensedcode\data\rules\epl-2.0_26.yml", "YAML", 0, 0, 0, 5, 0, 0, 1, 6
"d:\IDEWORK\lvmen\src\licensedcode\data\rules\epl-2.0_27.yml", "YAML", 0, 0, 0, 3, 0, 0, 1, 4
"d:\IDEWORK\lvmen\src\licensedcode\data\rules\epl-2.0_28.yml", "YAML", 0, 0, 0, 3, 0, 0, 1, 4
"d:\IDEWORK\lvmen\src\licensedcode\data\rules\epl-2.0_29.yml", "YAML", 0, 0, 0, 5, 0, 0, 1, 6
"d:\IDEWORK\lvmen\src\licensedcode\data\rules\epl-2.0_3.yml", "YAML", 0, 0, 0, 4, 0, 0, 1, 5
"d:\IDEWORK\lvmen\src\licensedcode\data\rules\epl-2.0_30.yml", "YAML", 0, 0, 0, 3, 0, 0, 1, 4
"d:\IDEWORK\lvmen\src\licensedcode\data\rules\epl-2.0_31.yml", "YAML", 0, 0, 0, 5, 0, 0, 1, 6
"d:\IDEWORK\lvmen\src\licensedcode\data\rules\epl-2.0_32.yml", "YAML", 0, 0, 0, 5, 0, 0, 1, 6
"d:\IDEWORK\lvmen\src\licensedcode\data\rules\epl-2.0_33.yml", "YAML", 0, 0, 0, 3, 0, 0, 1, 4
"d:\IDEWORK\lvmen\src\licensedcode\data\rules\epl-2.0_34.yml", "YAML", 0, 0, 0, 3, 0, 0, 1, 4
"d:\IDEWORK\lvmen\src\licensedcode\data\rules\epl-2.0_35.yml", "YAML", 0, 0, 0, 3, 0, 0, 1, 4
"d:\IDEWORK\lvmen\src\licensedcode\data\rules\epl-2.0_36.yml", "YAML", 0, 0, 0, 3, 0, 0, 1, 4
"d:\IDEWORK\lvmen\src\licensedcode\data\rules\epl-2.0_37.yml", "YAML", 0, 0, 0, 3, 0, 0, 1, 4
"d:\IDEWORK\lvmen\src\licensedcode\data\rules\epl-2.0_38.yml", "YAML", 0, 0, 0, 3, 0, 0, 1, 4
"d:\IDEWORK\lvmen\src\licensedcode\data\rules\epl-2.0_39.yml", "YAML", 0, 0, 0, 3, 0, 0, 1, 4
"d:\IDEWORK\lvmen\src\licensedcode\data\rules\epl-2.0_4.yml", "YAML", 0, 0, 0, 4, 0, 0, 1, 5
"d:\IDEWORK\lvmen\src\licensedcode\data\rules\epl-2.0_40.yml", "YAML", 0, 0, 0, 3, 0, 0, 1, 4
"d:\IDEWORK\lvmen\src\licensedcode\data\rules\epl-2.0_41.yml", "YAML", 0, 0, 0, 3, 0, 0, 1, 4
"d:\IDEWORK\lvmen\src\licensedcode\data\rules\epl-2.0_42.yml", "YAML", 0, 0, 0, 3, 0, 0, 1, 4
"d:\IDEWORK\lvmen\src\licensedcode\data\rules\epl-2.0_43.yml", "YAML", 0, 0, 0, 3, 0, 0, 1, 4
"d:\IDEWORK\lvmen\src\licensedcode\data\rules\epl-2.0_44.yml", "YAML", 0, 0, 0, 5, 0, 0, 1, 6
"d:\IDEWORK\lvmen\src\licensedcode\data\rules\epl-2.0_45.yml", "YAML", 0, 0, 0, 3, 0, 0, 1, 4
"d:\IDEWORK\lvmen\src\licensedcode\data\rules\epl-2.0_6.yml", "YAML", 0, 0, 0, 3, 0, 0, 1, 4
"d:\IDEWORK\lvmen\src\licensedcode\data\rules\epl-2.0_7.yml", "YAML", 0, 0, 0, 3, 0, 0, 1, 4
"d:\IDEWORK\lvmen\src\licensedcode\data\rules\epl-2.0_8.yml", "YAML", 0, 0, 0, 2, 0, 0, 1, 3
"d:\IDEWORK\lvmen\src\licensedcode\data\rules\epl-2.0_9.yml", "YAML", 0, 0, 0, 2, 0, 0, 1, 3
"d:\IDEWORK\lvmen\src\licensedcode\data\rules\epl-2.0_or_apache-2.0.yml", "YAML", 0, 0, 0, 5, 0, 0, 1, 6
"d:\IDEWORK\lvmen\src\licensedcode\data\rules\epl-2.0_or_apache-2.0_1.yml", "YAML", 0, 0, 0, 5, 0, 0, 1, 6
"d:\IDEWORK\lvmen\src\licensedcode\data\rules\epl-2.0_or_apache-2.0_2.yml", "YAML", 0, 0, 0, 5, 0, 0, 1, 6
"d:\IDEWORK\lvmen\src\licensedcode\data\rules\epl-2.0_or_apache-2.0_3.yml", "YAML", 0, 0, 0, 2, 0, 0, 1, 3
"d:\IDEWORK\lvmen\src\licensedcode\data\rules\epl-2.0_or_apache-2.0_4.yml", "YAML", 0, 0, 0, 5, 0, 0, 1, 6
"d:\IDEWORK\lvmen\src\licensedcode\data\rules\epl-2.0_or_apache-2.0_5.yml", "YAML", 0, 0, 0, 4, 0, 0, 1, 5
"d:\IDEWORK\lvmen\src\licensedcode\data\rules\epl-2.0_or_apache-2.0_6.yml", "YAML", 0, 0, 0, 5, 0, 0, 1, 6
"d:\IDEWORK\lvmen\src\licensedcode\data\rules\epl-2.0_or_apache-2.0_or_gpl-2.0_with_classpath-exception-2.0_and_gpl-2.0_and_others_1.yml", "YAML", 0, 0, 0, 10, 0, 0, 1, 11
"d:\IDEWORK\lvmen\src\licensedcode\data\rules\epl-2.0_or_apache-2.0_or_gpl-2.0_with_classpath-exception-20_and_others_1.yml", "YAML", 0, 0, 0, 10, 0, 0, 1, 11
"d:\IDEWORK\lvmen\src\licensedcode\data\rules\epl-2.0_or_apache-2.0_or_gpl-2.0_with_openjdk-exception.yml", "YAML", 0, 0, 0, 8, 0, 0, 1, 9
"d:\IDEWORK\lvmen\src\licensedcode\data\rules\epl-2.0_or_apache-2.0_or_gpl-2.0_with_openjdk-exception2.yml", "YAML", 0, 0, 0, 8, 0, 0, 1, 9
"d:\IDEWORK\lvmen\src\licensedcode\data\rules\epl-2.0_or_apache-2.0_or_gpl-2.0_with_openjdk-exception3.yml", "YAML", 0, 0, 0, 8, 0, 0, 1, 9
"d:\IDEWORK\lvmen\src\licensedcode\data\rules\epl-2.0_or_apache-2.0_or_gpl-2.0_with_openjdk-exception4.yml", "YAML", 0, 0, 0, 9, 0, 0, 1, 10
"d:\IDEWORK\lvmen\src\licensedcode\data\rules\epl-2.0_or_apache-2.0_or_gpl-2.0_with_openjdk-exception5.yml", "YAML", 0, 0, 0, 8, 0, 0, 1, 9
"d:\IDEWORK\lvmen\src\licensedcode\data\rules\epl-2.0_or_apache-2.0_or_gpl-2.0_with_openjdk-exception6.yml", "YAML", 0, 0, 0, 9, 0, 0, 1, 10
"d:\IDEWORK\lvmen\src\licensedcode\data\rules\epl-2.0_or_apache-2.0_or_gpl-2.0_with_openjdk-exception7.yml", "YAML", 0, 0, 0, 8, 0, 0, 1, 9
"d:\IDEWORK\lvmen\src\licensedcode\data\rules\epl-2.0_or_apache-2.0_or_gpl-2.0_with_openjdk-exception_and_others.yml", "YAML", 0, 0, 0, 8, 0, 0, 1, 9
"d:\IDEWORK\lvmen\src\licensedcode\data\rules\epl-2.0_or_apache-2.0_or_gpl-2.0_with_openjdk-exception_and_others2.yml", "YAML", 0, 0, 0, 10, 0, 0, 1, 11
"d:\IDEWORK\lvmen\src\licensedcode\data\rules\epl-2.0_or_apache-2.0_or_gpl-2.0_with_openjdk-exception_and_others3.yml", "YAML", 0, 0, 0, 8, 0, 0, 1, 9
"d:\IDEWORK\lvmen\src\licensedcode\data\rules\epl-2.0_or_apache-2.0_or_gpl-2.0_with_openjdk-exception_and_others4.yml", "YAML", 0, 0, 0, 8, 0, 0, 1, 9
"d:\IDEWORK\lvmen\src\licensedcode\data\rules\epl-2.0_or_gpl-2.0-plus_or_lgpl-2.1-plus_1.yml", "YAML", 0, 0, 0, 5, 0, 0, 1, 6
"d:\IDEWORK\lvmen\src\licensedcode\data\rules\epl-2.0_or_gpl-2.0-plus_or_lgpl-2.1-plus_10.yml", "YAML", 0, 0, 0, 7, 0, 0, 1, 8
"d:\IDEWORK\lvmen\src\licensedcode\data\rules\epl-2.0_or_gpl-2.0-plus_or_lgpl-2.1-plus_11.yml", "YAML", 0, 0, 0, 5, 0, 0, 1, 6
"d:\IDEWORK\lvmen\src\licensedcode\data\rules\epl-2.0_or_gpl-2.0-plus_or_lgpl-2.1-plus_12.yml", "YAML", 0, 0, 0, 5, 0, 0, 1, 6
"d:\IDEWORK\lvmen\src\licensedcode\data\rules\epl-2.0_or_gpl-2.0-plus_or_lgpl-2.1-plus_13.yml", "YAML", 0, 0, 0, 3, 0, 0, 1, 4
"d:\IDEWORK\lvmen\src\licensedcode\data\rules\epl-2.0_or_gpl-2.0-plus_or_lgpl-2.1-plus_14.yml", "YAML", 0, 0, 0, 6, 0, 0, 1, 7
"d:\IDEWORK\lvmen\src\licensedcode\data\rules\epl-2.0_or_gpl-2.0-plus_or_lgpl-2.1-plus_15.yml", "YAML", 0, 0, 0, 3, 0, 0, 1, 4
"d:\IDEWORK\lvmen\src\licensedcode\data\rules\epl-2.0_or_gpl-2.0-plus_or_lgpl-2.1-plus_16.yml", "YAML", 0, 0, 0, 6, 0, 0, 1, 7
"d:\IDEWORK\lvmen\src\licensedcode\data\rules\epl-2.0_or_gpl-2.0-plus_or_lgpl-2.1-plus_17.yml", "YAML", 0, 0, 0, 12, 0, 0, 1, 13
"d:\IDEWORK\lvmen\src\licensedcode\data\rules\epl-2.0_or_gpl-2.0-plus_or_lgpl-2.1-plus_18.yml", "YAML", 0, 0, 0, 9, 0, 0, 1, 10
"d:\IDEWORK\lvmen\src\licensedcode\data\rules\epl-2.0_or_gpl-2.0-plus_or_lgpl-2.1-plus_19.yml", "YAML", 0, 0, 0, 7, 0, 0, 1, 8
"d:\IDEWORK\lvmen\src\licensedcode\data\rules\epl-2.0_or_gpl-2.0-plus_or_lgpl-2.1-plus_2.yml", "YAML", 0, 0, 0, 4, 0, 0, 1, 5
"d:\IDEWORK\lvmen\src\licensedcode\data\rules\epl-2.0_or_gpl-2.0-plus_or_lgpl-2.1-plus_3.yml", "YAML", 0, 0, 0, 3, 0, 0, 1, 4
"d:\IDEWORK\lvmen\src\licensedcode\data\rules\epl-2.0_or_gpl-2.0-plus_or_lgpl-2.1-plus_4.yml", "YAML", 0, 0, 0, 3, 0, 0, 1, 4
"d:\IDEWORK\lvmen\src\licensedcode\data\rules\epl-2.0_or_gpl-2.0-plus_or_lgpl-2.1-plus_5.yml", "YAML", 0, 0, 0, 3, 0, 0, 1, 4
"d:\IDEWORK\lvmen\src\licensedcode\data\rules\epl-2.0_or_gpl-2.0-plus_or_lgpl-2.1-plus_6.yml", "YAML", 0, 0, 0, 3, 0, 0, 1, 4
"d:\IDEWORK\lvmen\src\licensedcode\data\rules\epl-2.0_or_gpl-2.0-plus_or_lgpl-2.1-plus_7.yml", "YAML", 0, 0, 0, 3, 0, 0, 1, 4
"d:\IDEWORK\lvmen\src\licensedcode\data\rules\epl-2.0_or_gpl-2.0-plus_or_lgpl-2.1-plus_7_NOT.yml", "YAML", 0, 0, 0, 4, 0, 0, 1, 5
"d:\IDEWORK\lvmen\src\licensedcode\data\rules\epl-2.0_or_gpl-2.0-plus_or_lgpl-2.1-plus_8.yml", "YAML", 0, 0, 0, 3, 0, 0, 1, 4
"d:\IDEWORK\lvmen\src\licensedcode\data\rules\epl-2.0_or_gpl-2.0-plus_or_lgpl-2.1-plus_9.yml", "YAML", 0, 0, 0, 9, 0, 0, 1, 10
"d:\IDEWORK\lvmen\src\licensedcode\data\rules\epl-2.0_or_gpl-2.0_or_lgpl-2.1_1.yml", "YAML", 0, 0, 0, 8, 0, 0, 1, 9
"d:\IDEWORK\lvmen\src\licensedcode\data\rules\epl-2.0_or_gpl-2.0_or_lgpl-2.1_2.yml", "YAML", 0, 0, 0, 5, 0, 0, 1, 6
"d:\IDEWORK\lvmen\src\licensedcode\data\rules\epl-2.0_or_gpl-2.0_or_lgpl-2.1_3.yml", "YAML", 0, 0, 0, 4, 0, 0, 1, 5
"d:\IDEWORK\lvmen\src\licensedcode\data\rules\epl-2.0_or_gpl-2.0_or_lgpl-2.1_4.yml", "YAML", 0, 0, 0, 8, 0, 0, 1, 9
"d:\IDEWORK\lvmen\src\licensedcode\data\rules\epl-2.0_or_gpl-2.0_with_classpath-exception-2.0.yml", "YAML", 0, 0, 0, 6, 0, 0, 1, 7
"d:\IDEWORK\lvmen\src\licensedcode\data\rules\epl-2.0_or_gpl-2.0_with_classpath-exception-2.0_1.yml", "YAML", 0, 0, 0, 5, 0, 0, 1, 6
"d:\IDEWORK\lvmen\src\licensedcode\data\rules\epl-2.0_or_gpl-2.0_with_classpath-exception-2.0_2.yml", "YAML", 0, 0, 0, 5, 0, 0, 1, 6
"d:\IDEWORK\lvmen\src\licensedcode\data\rules\epl-2.0_or_gpl-2.0_with_classpath-exception-2.0_3.yml", "YAML", 0, 0, 0, 6, 0, 0, 1, 7
"d:\IDEWORK\lvmen\src\licensedcode\data\rules\epl-2.0_or_ibmpl-1.0_1.yml", "YAML", 0, 0, 0, 3, 0, 0, 1, 4
"d:\IDEWORK\lvmen\src\licensedcode\data\rules\epl-2.0_url_1.yml", "YAML", 0, 0, 0, 5, 0, 0, 1, 6
"d:\IDEWORK\lvmen\src\licensedcode\data\rules\epl-2.0_url_2.yml", "YAML", 0, 0, 0, 5, 0, 0, 1, 6
"d:\IDEWORK\lvmen\src\licensedcode\data\rules\epl-2.0_url_glc_156.yml", "YAML", 0, 0, 0, 5, 0, 0, 1, 6
"d:\IDEWORK\lvmen\src\licensedcode\data\rules\epl-2.0_url_glc_157.yml", "YAML", 0, 0, 0, 5, 0, 0, 1, 6
"d:\IDEWORK\lvmen\src\licensedcode\data\rules\epl_no-version.yml", "YAML", 0, 0, 0, 3, 0, 0, 1, 4
"d:\IDEWORK\lvmen\src\licensedcode\data\rules\epo-osl-2005.1.yml", "YAML", 0, 0, 0, 5, 0, 0, 1, 6
"d:\IDEWORK\lvmen\src\licensedcode\data\rules\erlangpl-1.1.yml", "YAML", 0, 0, 0, 5, 0, 0, 1, 6
"d:\IDEWORK\lvmen\src\licensedcode\data\rules\erlangpl-1.1_1.yml", "YAML", 0, 0, 0, 3, 0, 0, 1, 4
"d:\IDEWORK\lvmen\src\licensedcode\data\rules\erlangpl-1.1_2.yml", "YAML", 0, 0, 0, 8, 0, 0, 1, 9
"d:\IDEWORK\lvmen\src\licensedcode\data\rules\erlangpl-1.1_3.yml", "YAML", 0, 0, 0, 4, 0, 0, 1, 5
"d:\IDEWORK\lvmen\src\licensedcode\data\rules\erlangpl-1.1_url_1.yml", "YAML", 0, 0, 0, 5, 0, 0, 1, 6
"d:\IDEWORK\lvmen\src\licensedcode\data\rules\erlangpl-1.1_url_2.yml", "YAML", 0, 0, 0, 5, 0, 0, 1, 6
"d:\IDEWORK\lvmen\src\licensedcode\data\rules\etalab-2.0_1.yml", "YAML", 0, 0, 0, 5, 0, 0, 1, 6
"d:\IDEWORK\lvmen\src\licensedcode\data\rules\etalab-2.0_2.yml", "YAML", 0, 0, 0, 6, 0, 0, 1, 7
"d:\IDEWORK\lvmen\src\licensedcode\data\rules\etalab-2.0_3.yml", "YAML", 0, 0, 0, 4, 0, 0, 1, 5
"d:\IDEWORK\lvmen\src\licensedcode\data\rules\etalab-2.0_4.yml", "YAML", 0, 0, 0, 4, 0, 0, 1, 5
"d:\IDEWORK\lvmen\src\licensedcode\data\rules\eu-datagrid.SPDX.yml", "YAML", 0, 0, 0, 15, 0, 0, 1, 16
"d:\IDEWORK\lvmen\src\licensedcode\data\rules\eu-datagrid.yml", "YAML", 0, 0, 0, 5, 0, 0, 1, 6
"d:\IDEWORK\lvmen\src\licensedcode\data\rules\eu-datagrid_1.yml", "YAML", 0, 0, 0, 5, 0, 0, 1, 6
"d:\IDEWORK\lvmen\src\licensedcode\data\rules\eu-datagrid_2.yml", "YAML", 0, 0, 0, 3, 0, 0, 1, 4
"d:\IDEWORK\lvmen\src\licensedcode\data\rules\eu-datagrid_3.yml", "YAML", 0, 0, 0, 5, 0, 0, 1, 6
"d:\IDEWORK\lvmen\src\licensedcode\data\rules\eu-datagrid_4.yml", "YAML", 0, 0, 0, 5, 0, 0, 1, 6
"d:\IDEWORK\lvmen\src\licensedcode\data\rules\eu-datagrid_5.yml", "YAML", 0, 0, 0, 5, 0, 0, 1, 6
"d:\IDEWORK\lvmen\src\licensedcode\data\rules\eu-datagrid_url_1.yml", "YAML", 0, 0, 0, 5, 0, 0, 1, 6
"d:\IDEWORK\lvmen\src\licensedcode\data\rules\eu-datagrid_url_2.yml", "YAML", 0, 0, 0, 5, 0, 0, 1, 6
"d:\IDEWORK\lvmen\src\licensedcode\data\rules\eu-datagrid_url_glc_158.yml", "YAML", 0, 0, 0, 5, 0, 0, 1, 6
"d:\IDEWORK\lvmen\src\licensedcode\data\rules\eu-datagrid_url_glc_159.yml", "YAML", 0, 0, 0, 5, 0, 0, 1, 6
"d:\IDEWORK\lvmen\src\licensedcode\data\rules\eupl-1.0.SPDX.yml", "YAML", 0, 0, 0, 8, 0, 0, 1, 9
"d:\IDEWORK\lvmen\src\licensedcode\data\rules\eupl-1.0.yml", "YAML", 0, 0, 0, 5, 0, 0, 1, 6
"d:\IDEWORK\lvmen\src\licensedcode\data\rules\eupl-1.0_1.yml", "YAML", 0, 0, 0, 3, 0, 0, 1, 4
"d:\IDEWORK\lvmen\src\licensedcode\data\rules\eupl-1.0_2.yml", "YAML", 0, 0, 0, 6, 0, 0, 1, 7
"d:\IDEWORK\lvmen\src\licensedcode\data\rules\eupl-1.0_url_1.yml", "YAML", 0, 0, 0, 5, 0, 0, 1, 6
"d:\IDEWORK\lvmen\src\licensedcode\data\rules\eupl-1.0_url_2.yml", "YAML", 0, 0, 0, 5, 0, 0, 1, 6
"d:\IDEWORK\lvmen\src\licensedcode\data\rules\eupl-1.1.SPDX.yml", "YAML", 0, 0, 0, 4, 0, 0, 1, 5
"d:\IDEWORK\lvmen\src\licensedcode\data\rules\eupl-1.1.yml", "YAML", 0, 0, 0, 5, 0, 0, 1, 6
"d:\IDEWORK\lvmen\src\licensedcode\data\rules\eupl-1.1_1.yml", "YAML", 0, 0, 0, 5, 0, 0, 1, 6
"d:\IDEWORK\lvmen\src\licensedcode\data\rules\eupl-1.1_10.yml", "YAML", 0, 0, 0, 5, 0, 0, 1, 6
"d:\IDEWORK\lvmen\src\licensedcode\data\rules\eupl-1.1_11.yml", "YAML", 0, 0, 0, 3, 0, 0, 1, 4
"d:\IDEWORK\lvmen\src\licensedcode\data\rules\eupl-1.1_12.yml", "YAML", 0, 0, 0, 5, 0, 0, 1, 6
"d:\IDEWORK\lvmen\src\licensedcode\data\rules\eupl-1.1_13.yml", "YAML", 0, 0, 0, 3, 0, 0, 1, 4
"d:\IDEWORK\lvmen\src\licensedcode\data\rules\eupl-1.1_14.yml", "YAML", 0, 0, 0, 6, 0, 0, 1, 7
"d:\IDEWORK\lvmen\src\licensedcode\data\rules\eupl-1.1_15.yml", "YAML", 0, 0, 0, 6, 0, 0, 1, 7
"d:\IDEWORK\lvmen\src\licensedcode\data\rules\eupl-1.1_2.yml", "YAML", 0, 0, 0, 4, 0, 0, 1, 5
"d:\IDEWORK\lvmen\src\licensedcode\data\rules\eupl-1.1_3.yml", "YAML", 0, 0, 0, 5, 0, 0, 1, 6
"d:\IDEWORK\lvmen\src\licensedcode\data\rules\eupl-1.1_4.yml", "YAML", 0, 0, 0, 5, 0, 0, 1, 6
"d:\IDEWORK\lvmen\src\licensedcode\data\rules\eupl-1.1_5.yml", "YAML", 0, 0, 0, 5, 0, 0, 1, 6
"d:\IDEWORK\lvmen\src\licensedcode\data\rules\eupl-1.1_6.yml", "YAML", 0, 0, 0, 5, 0, 0, 1, 6
"d:\IDEWORK\lvmen\src\licensedcode\data\rules\eupl-1.1_7.yml", "YAML", 0, 0, 0, 5, 0, 0, 1, 6
"d:\IDEWORK\lvmen\src\licensedcode\data\rules\eupl-1.1_8.yml", "YAML", 0, 0, 0, 5, 0, 0, 1, 6
"d:\IDEWORK\lvmen\src\licensedcode\data\rules\eupl-1.1_9.yml", "YAML", 0, 0, 0, 3, 0, 0, 1, 4
"d:\IDEWORK\lvmen\src\licensedcode\data\rules\eupl-1.1_or_mit_1.yml", "YAML", 0, 0, 0, 7, 0, 0, 1, 8
"d:\IDEWORK\lvmen\src\licensedcode\data\rules\eupl-1.1_url_1.yml", "YAML", 0, 0, 0, 5, 0, 0, 1, 6
"d:\IDEWORK\lvmen\src\licensedcode\data\rules\eupl-1.1_url_2.yml", "YAML", 0, 0, 0, 5, 0, 0, 1, 6
"d:\IDEWORK\lvmen\src\licensedcode\data\rules\eupl-1.1_url_glc_160.yml", "YAML", 0, 0, 0, 5, 0, 0, 1, 6
"d:\IDEWORK\lvmen\src\licensedcode\data\rules\eupl-1.1_url_glc_161.yml", "YAML", 0, 0, 0, 5, 0, 0, 1, 6
"d:\IDEWORK\lvmen\src\licensedcode\data\rules\eupl-1.2_1.yml", "YAML", 0, 0, 0, 6, 0, 0, 1, 7
"d:\IDEWORK\lvmen\src\licensedcode\data\rules\eupl-1.2_10.yml", "YAML", 0, 0, 0, 9, 0, 0, 1, 10
"d:\IDEWORK\lvmen\src\licensedcode\data\rules\eupl-1.2_2.yml", "YAML", 0, 0, 0, 5, 0, 0, 1, 6
"d:\IDEWORK\lvmen\src\licensedcode\data\rules\eupl-1.2_3.yml", "YAML", 0, 0, 0, 5, 0, 0, 1, 6
"d:\IDEWORK\lvmen\src\licensedcode\data\rules\eupl-1.2_4.yml", "YAML", 0, 0, 0, 3, 0, 0, 1, 4
"d:\IDEWORK\lvmen\src\licensedcode\data\rules\eupl-1.2_5.yml", "YAML", 0, 0, 0, 3, 0, 0, 1, 4
"d:\IDEWORK\lvmen\src\licensedcode\data\rules\eupl-1.2_6.yml", "YAML", 0, 0, 0, 6, 0, 0, 1, 7
"d:\IDEWORK\lvmen\src\licensedcode\data\rules\eupl-1.2_7.yml", "YAML", 0, 0, 0, 3, 0, 0, 1, 4
"d:\IDEWORK\lvmen\src\licensedcode\data\rules\eupl-1.2_8.yml", "YAML", 0, 0, 0, 3, 0, 0, 1, 4
"d:\IDEWORK\lvmen\src\licensedcode\data\rules\eupl-1.2_9.yml", "YAML", 0, 0, 0, 5, 0, 0, 1, 6
"d:\IDEWORK\lvmen\src\licensedcode\data\rules\eupl-1.2_and_unknown_1.yml", "YAML", 0, 0, 0, 5, 0, 0, 1, 6
"d:\IDEWORK\lvmen\src\licensedcode\data\rules\eupl-1.2_url_1.yml", "YAML", 0, 0, 0, 5, 0, 0, 1, 6
"d:\IDEWORK\lvmen\src\licensedcode\data\rules\eupl-1.2_url_2.yml", "YAML", 0, 0, 0, 5, 0, 0, 1, 6
"d:\IDEWORK\lvmen\src\licensedcode\data\rules\eurosym_url_1.yml", "YAML", 0, 0, 0, 5, 0, 0, 1, 6
"d:\IDEWORK\lvmen\src\licensedcode\data\rules\eurosym_url_2.yml", "YAML", 0, 0, 0, 5, 0, 0, 1, 6
"d:\IDEWORK\lvmen\src\licensedcode\data\rules\facebook-nuclide_1.yml", "YAML", 0, 0, 0, 3, 0, 0, 1, 4
"d:\IDEWORK\lvmen\src\licensedcode\data\rules\facebook-patent-rights-2_1.yml", "YAML", 0, 0, 0, 5, 0, 0, 1, 6
"d:\IDEWORK\lvmen\src\licensedcode\data\rules\facebook-patent-rights-2_2.yml", "YAML", 0, 0, 0, 3, 0, 0, 1, 4
"d:\IDEWORK\lvmen\src\licensedcode\data\rules\fair.SPDX.yml", "YAML", 0, 0, 0, 4, 0, 0, 1, 5
"d:\IDEWORK\lvmen\src\licensedcode\data\rules\fair.yml", "YAML", 0, 0, 0, 5, 0, 0, 1, 6
"d:\IDEWORK\lvmen\src\licensedcode\data\rules\fair_1.yml", "YAML", 0, 0, 0, 5, 0, 0, 1, 6
"d:\IDEWORK\lvmen\src\licensedcode\data\rules\fair_2.yml", "YAML", 0, 0, 0, 3, 0, 0, 1, 4
"d:\IDEWORK\lvmen\src\licensedcode\data\rules\fair_3.yml", "YAML", 0, 0, 0, 5, 0, 0, 1, 6
"d:\IDEWORK\lvmen\src\licensedcode\data\rules\fair_url_1.yml", "YAML", 0, 0, 0, 5, 0, 0, 1, 6
"d:\IDEWORK\lvmen\src\licensedcode\data\rules\fair_url_2.yml", "YAML", 0, 0, 0, 5, 0, 0, 1, 6
"d:\IDEWORK\lvmen\src\licensedcode\data\rules\fair_url_glc_162.yml", "YAML", 0, 0, 0, 5, 0, 0, 1, 6
"d:\IDEWORK\lvmen\src\licensedcode\data\rules\fair_url_glc_163.yml", "YAML", 0, 0, 0, 5, 0, 0, 1, 6
"d:\IDEWORK\lvmen\src\licensedcode\data\rules\false-positive_1.yml", "YAML", 0, 0, 0, 2, 0, 0, 1, 3
"d:\IDEWORK\lvmen\src\licensedcode\data\rules\false-positive_10.yml", "YAML", 0, 0, 0, 2, 0, 0, 1, 3
"d:\IDEWORK\lvmen\src\licensedcode\data\rules\false-positive_100.yml", "YAML", 0, 0, 0, 2, 0, 0, 1, 3
"d:\IDEWORK\lvmen\src\licensedcode\data\rules\false-positive_1000.yml", "YAML", 0, 0, 0, 2, 0, 0, 1, 3
"d:\IDEWORK\lvmen\src\licensedcode\data\rules\false-positive_1001.yml", "YAML", 0, 0, 0, 2, 0, 0, 1, 3
"d:\IDEWORK\lvmen\src\licensedcode\data\rules\false-positive_1002.yml", "YAML", 0, 0, 0, 2, 0, 0, 1, 3
"d:\IDEWORK\lvmen\src\licensedcode\data\rules\false-positive_1003.yml", "YAML", 0, 0, 0, 2, 0, 0, 1, 3
"d:\IDEWORK\lvmen\src\licensedcode\data\rules\false-positive_1004.yml", "YAML", 0, 0, 0, 2, 0, 0, 1, 3
"d:\IDEWORK\lvmen\src\licensedcode\data\rules\false-positive_1005.yml", "YAML", 0, 0, 0, 2, 0, 0, 1, 3
"d:\IDEWORK\lvmen\src\licensedcode\data\rules\false-positive_1006.yml", "YAML", 0, 0, 0, 2, 0, 0, 1, 3
"d:\IDEWORK\lvmen\src\licensedcode\data\rules\false-positive_1007.yml", "YAML", 0, 0, 0, 2, 0, 0, 1, 3
"d:\IDEWORK\lvmen\src\licensedcode\data\rules\false-positive_1008.yml", "YAML", 0, 0, 0, 2, 0, 0, 1, 3
"d:\IDEWORK\lvmen\src\licensedcode\data\rules\false-positive_1009.yml", "YAML", 0, 0, 0, 2, 0, 0, 1, 3
"d:\IDEWORK\lvmen\src\licensedcode\data\rules\false-positive_101.yml", "YAML", 0, 0, 0, 2, 0, 0, 1, 3
"d:\IDEWORK\lvmen\src\licensedcode\data\rules\false-positive_1010.yml", "YAML", 0, 0, 0, 2, 0, 0, 1, 3
"d:\IDEWORK\lvmen\src\licensedcode\data\rules\false-positive_1011.yml", "YAML", 0, 0, 0, 2, 0, 0, 1, 3
"d:\IDEWORK\lvmen\src\licensedcode\data\rules\false-positive_1012.yml", "YAML", 0, 0, 0, 2, 0, 0, 1, 3
"d:\IDEWORK\lvmen\src\licensedcode\data\rules\false-positive_1013.yml", "YAML", 0, 0, 0, 2, 0, 0, 1, 3
"d:\IDEWORK\lvmen\src\licensedcode\data\rules\false-positive_1014.yml", "YAML", 0, 0, 0, 2, 0, 0, 1, 3
"d:\IDEWORK\lvmen\src\licensedcode\data\rules\false-positive_1015.yml", "YAML", 0, 0, 0, 2, 0, 0, 1, 3
"d:\IDEWORK\lvmen\src\licensedcode\data\rules\false-positive_1016.yml", "YAML", 0, 0, 0, 2, 0, 0, 1, 3
"d:\IDEWORK\lvmen\src\licensedcode\data\rules\false-positive_1017.yml", "YAML", 0, 0, 0, 2, 0, 0, 1, 3
"d:\IDEWORK\lvmen\src\licensedcode\data\rules\false-positive_1018.yml", "YAML", 0, 0, 0, 2, 0, 0, 1, 3
"d:\IDEWORK\lvmen\src\licensedcode\data\rules\false-positive_1019.yml", "YAML", 0, 0, 0, 2, 0, 0, 1, 3
"d:\IDEWORK\lvmen\src\licensedcode\data\rules\false-positive_102.yml", "YAML", 0, 0, 0, 3, 0, 0, 1, 4
"d:\IDEWORK\lvmen\src\licensedcode\data\rules\false-positive_1020.yml", "YAML", 0, 0, 0, 2, 0, 0, 1, 3
"d:\IDEWORK\lvmen\src\licensedcode\data\rules\false-positive_1021.yml", "YAML", 0, 0, 0, 2, 0, 0, 1, 3
"d:\IDEWORK\lvmen\src\licensedcode\data\rules\false-positive_1022.yml", "YAML", 0, 0, 0, 2, 0, 0, 1, 3
"d:\IDEWORK\lvmen\src\licensedcode\data\rules\false-positive_1023.yml", "YAML", 0, 0, 0, 2, 0, 0, 1, 3
"d:\IDEWORK\lvmen\src\licensedcode\data\rules\false-positive_1024.yml", "YAML", 0, 0, 0, 2, 0, 0, 1, 3
"d:\IDEWORK\lvmen\src\licensedcode\data\rules\false-positive_1025.yml", "YAML", 0, 0, 0, 2, 0, 0, 1, 3
"d:\IDEWORK\lvmen\src\licensedcode\data\rules\false-positive_1026.yml", "YAML", 0, 0, 0, 2, 0, 0, 1, 3
"d:\IDEWORK\lvmen\src\licensedcode\data\rules\false-positive_1027.yml", "YAML", 0, 0, 0, 2, 0, 0, 1, 3
"d:\IDEWORK\lvmen\src\licensedcode\data\rules\false-positive_1028.yml", "YAML", 0, 0, 0, 2, 0, 0, 1, 3
"d:\IDEWORK\lvmen\src\licensedcode\data\rules\false-positive_1029.yml", "YAML", 0, 0, 0, 2, 0, 0, 1, 3
"d:\IDEWORK\lvmen\src\licensedcode\data\rules\false-positive_103.yml", "YAML", 0, 0, 0, 2, 0, 0, 1, 3
"d:\IDEWORK\lvmen\src\licensedcode\data\rules\false-positive_1030.yml", "YAML", 0, 0, 0, 2, 0, 0, 1, 3
"d:\IDEWORK\lvmen\src\licensedcode\data\rules\false-positive_1031.yml", "YAML", 0, 0, 0, 2, 0, 0, 1, 3
"d:\IDEWORK\lvmen\src\licensedcode\data\rules\false-positive_1032.yml", "YAML", 0, 0, 0, 2, 0, 0, 1, 3
"d:\IDEWORK\lvmen\src\licensedcode\data\rules\false-positive_1033.yml", "YAML", 0, 0, 0, 2, 0, 0, 1, 3
"d:\IDEWORK\lvmen\src\licensedcode\data\rules\false-positive_1034.yml", "YAML", 0, 0, 0, 2, 0, 0, 1, 3
"d:\IDEWORK\lvmen\src\licensedcode\data\rules\false-positive_1035.yml", "YAML", 0, 0, 0, 2, 0, 0, 1, 3
"d:\IDEWORK\lvmen\src\licensedcode\data\rules\false-positive_1036.yml", "YAML", 0, 0, 0, 2, 0, 0, 1, 3
"d:\IDEWORK\lvmen\src\licensedcode\data\rules\false-positive_1037.yml", "YAML", 0, 0, 0, 2, 0, 0, 1, 3
"d:\IDEWORK\lvmen\src\licensedcode\data\rules\false-positive_1038.yml", "YAML", 0, 0, 0, 2, 0, 0, 1, 3
"d:\IDEWORK\lvmen\src\licensedcode\data\rules\false-positive_1039.yml", "YAML", 0, 0, 0, 2, 0, 0, 1, 3
"d:\IDEWORK\lvmen\src\licensedcode\data\rules\false-positive_104.yml", "YAML", 0, 0, 0, 2, 0, 0, 1, 3
"d:\IDEWORK\lvmen\src\licensedcode\data\rules\false-positive_1040.yml", "YAML", 0, 0, 0, 2, 0, 0, 1, 3
"d:\IDEWORK\lvmen\src\licensedcode\data\rules\false-positive_1041.yml", "YAML", 0, 0, 0, 2, 0, 0, 1, 3
"d:\IDEWORK\lvmen\src\licensedcode\data\rules\false-positive_1042.yml", "YAML", 0, 0, 0, 2, 0, 0, 1, 3
"d:\IDEWORK\lvmen\src\licensedcode\data\rules\false-positive_1043.yml", "YAML", 0, 0, 0, 2, 0, 0, 1, 3
"d:\IDEWORK\lvmen\src\licensedcode\data\rules\false-positive_1044.yml", "YAML", 0, 0, 0, 2, 0, 0, 1, 3
"d:\IDEWORK\lvmen\src\licensedcode\data\rules\false-positive_1045.yml", "YAML", 0, 0, 0, 2, 0, 0, 1, 3
"d:\IDEWORK\lvmen\src\licensedcode\data\rules\false-positive_1046.yml", "YAML", 0, 0, 0, 2, 0, 0, 1, 3
"d:\IDEWORK\lvmen\src\licensedcode\data\rules\false-positive_1047.yml", "YAML", 0, 0, 0, 2, 0, 0, 1, 3
"d:\IDEWORK\lvmen\src\licensedcode\data\rules\false-positive_1048.yml", "YAML", 0, 0, 0, 2, 0, 0, 1, 3
"d:\IDEWORK\lvmen\src\licensedcode\data\rules\false-positive_1049.yml", "YAML", 0, 0, 0, 2, 0, 0, 1, 3
"d:\IDEWORK\lvmen\src\licensedcode\data\rules\false-positive_105.yml", "YAML", 0, 0, 0, 2, 0, 0, 1, 3
"d:\IDEWORK\lvmen\src\licensedcode\data\rules\false-positive_1050.yml", "YAML", 0, 0, 0, 2, 0, 0, 1, 3
"d:\IDEWORK\lvmen\src\licensedcode\data\rules\false-positive_1051.yml", "YAML", 0, 0, 0, 2, 0, 0, 1, 3
"d:\IDEWORK\lvmen\src\licensedcode\data\rules\false-positive_1052.yml", "YAML", 0, 0, 0, 2, 0, 0, 1, 3
"d:\IDEWORK\lvmen\src\licensedcode\data\rules\false-positive_1053.yml", "YAML", 0, 0, 0, 2, 0, 0, 1, 3
"d:\IDEWORK\lvmen\src\licensedcode\data\rules\false-positive_1054.yml", "YAML", 0, 0, 0, 2, 0, 0, 1, 3
"d:\IDEWORK\lvmen\src\licensedcode\data\rules\false-positive_1055.yml", "YAML", 0, 0, 0, 2, 0, 0, 1, 3
"d:\IDEWORK\lvmen\src\licensedcode\data\rules\false-positive_1056.yml", "YAML", 0, 0, 0, 2, 0, 0, 1, 3
"d:\IDEWORK\lvmen\src\licensedcode\data\rules\false-positive_1057.yml", "YAML", 0, 0, 0, 2, 0, 0, 1, 3
"d:\IDEWORK\lvmen\src\licensedcode\data\rules\false-positive_1058.yml", "YAML", 0, 0, 0, 2, 0, 0, 1, 3
"d:\IDEWORK\lvmen\src\licensedcode\data\rules\false-positive_1059.yml", "YAML", 0, 0, 0, 2, 0, 0, 1, 3
"d:\IDEWORK\lvmen\src\licensedcode\data\rules\false-positive_106.yml", "YAML", 0, 0, 0, 3, 0, 0, 1, 4
"d:\IDEWORK\lvmen\src\licensedcode\data\rules\false-positive_1060.yml", "YAML", 0, 0, 0, 2, 0, 0, 1, 3
"d:\IDEWORK\lvmen\src\licensedcode\data\rules\false-positive_1061.yml", "YAML", 0, 0, 0, 2, 0, 0, 1, 3
"d:\IDEWORK\lvmen\src\licensedcode\data\rules\false-positive_1062.yml", "YAML", 0, 0, 0, 2, 0, 0, 1, 3
"d:\IDEWORK\lvmen\src\licensedcode\data\rules\false-positive_1063.yml", "YAML", 0, 0, 0, 2, 0, 0, 1, 3
"d:\IDEWORK\lvmen\src\licensedcode\data\rules\false-positive_1064.yml", "YAML", 0, 0, 0, 2, 0, 0, 1, 3
"d:\IDEWORK\lvmen\src\licensedcode\data\rules\false-positive_1065.yml", "YAML", 0, 0, 0, 2, 0, 0, 1, 3
"d:\IDEWORK\lvmen\src\licensedcode\data\rules\false-positive_1066.yml", "YAML", 0, 0, 0, 2, 0, 0, 1, 3
"d:\IDEWORK\lvmen\src\licensedcode\data\rules\false-positive_1067.yml", "YAML", 0, 0, 0, 2, 0, 0, 1, 3
"d:\IDEWORK\lvmen\src\licensedcode\data\rules\false-positive_1068.yml", "YAML", 0, 0, 0, 2, 0, 0, 1, 3
"d:\IDEWORK\lvmen\src\licensedcode\data\rules\false-positive_1069.yml", "YAML", 0, 0, 0, 2, 0, 0, 1, 3
"d:\IDEWORK\lvmen\src\licensedcode\data\rules\false-positive_107.yml", "YAML", 0, 0, 0, 3, 0, 0, 1, 4
"d:\IDEWORK\lvmen\src\licensedcode\data\rules\false-positive_1070.yml", "YAML", 0, 0, 0, 2, 0, 0, 1, 3
"d:\IDEWORK\lvmen\src\licensedcode\data\rules\false-positive_1071.yml", "YAML", 0, 0, 0, 2, 0, 0, 1, 3
"d:\IDEWORK\lvmen\src\licensedcode\data\rules\false-positive_1072.yml", "YAML", 0, 0, 0, 2, 0, 0, 1, 3
"d:\IDEWORK\lvmen\src\licensedcode\data\rules\false-positive_1073.yml", "YAML", 0, 0, 0, 2, 0, 0, 1, 3
"d:\IDEWORK\lvmen\src\licensedcode\data\rules\false-positive_1074.yml", "YAML", 0, 0, 0, 2, 0, 0, 1, 3
"d:\IDEWORK\lvmen\src\licensedcode\data\rules\false-positive_1075.yml", "YAML", 0, 0, 0, 2, 0, 0, 1, 3
"d:\IDEWORK\lvmen\src\licensedcode\data\rules\false-positive_1076.yml", "YAML", 0, 0, 0, 2, 0, 0, 1, 3
"d:\IDEWORK\lvmen\src\licensedcode\data\rules\false-positive_1077.yml", "YAML", 0, 0, 0, 2, 0, 0, 1, 3
"d:\IDEWORK\lvmen\src\licensedcode\data\rules\false-positive_1078.yml", "YAML", 0, 0, 0, 2, 0, 0, 1, 3
"d:\IDEWORK\lvmen\src\licensedcode\data\rules\false-positive_1079.yml", "YAML", 0, 0, 0, 2, 0, 0, 1, 3
"d:\IDEWORK\lvmen\src\licensedcode\data\rules\false-positive_108.yml", "YAML", 0, 0, 0, 3, 0, 0, 1, 4
"d:\IDEWORK\lvmen\src\licensedcode\data\rules\false-positive_1080.yml", "YAML", 0, 0, 0, 2, 0, 0, 1, 3
"d:\IDEWORK\lvmen\src\licensedcode\data\rules\false-positive_1081.yml", "YAML", 0, 0, 0, 2, 0, 0, 1, 3
"d:\IDEWORK\lvmen\src\licensedcode\data\rules\false-positive_1082.yml", "YAML", 0, 0, 0, 2, 0, 0, 1, 3
"d:\IDEWORK\lvmen\src\licensedcode\data\rules\false-positive_1083.yml", "YAML", 0, 0, 0, 2, 0, 0, 1, 3
"d:\IDEWORK\lvmen\src\licensedcode\data\rules\false-positive_1084.yml", "YAML", 0, 0, 0, 2, 0, 0, 1, 3
"d:\IDEWORK\lvmen\src\licensedcode\data\rules\false-positive_1085.yml", "YAML", 0, 0, 0, 2, 0, 0, 1, 3
"d:\IDEWORK\lvmen\src\licensedcode\data\rules\false-positive_1086.yml", "YAML", 0, 0, 0, 2, 0, 0, 1, 3
"d:\IDEWORK\lvmen\src\licensedcode\data\rules\false-positive_1087.yml", "YAML", 0, 0, 0, 2, 0, 0, 1, 3
"d:\IDEWORK\lvmen\src\licensedcode\data\rules\false-positive_1088.yml", "YAML", 0, 0, 0, 2, 0, 0, 1, 3
"d:\IDEWORK\lvmen\src\licensedcode\data\rules\false-positive_1089.yml", "YAML", 0, 0, 0, 2, 0, 0, 1, 3
"d:\IDEWORK\lvmen\src\licensedcode\data\rules\false-positive_109.yml", "YAML", 0, 0, 0, 2, 0, 0, 1, 3
"d:\IDEWORK\lvmen\src\licensedcode\data\rules\false-positive_1090.yml", "YAML", 0, 0, 0, 2, 0, 0, 1, 3
"d:\IDEWORK\lvmen\src\licensedcode\data\rules\false-positive_1091.yml", "YAML", 0, 0, 0, 2, 0, 0, 1, 3
"d:\IDEWORK\lvmen\src\licensedcode\data\rules\false-positive_1092.yml", "YAML", 0, 0, 0, 2, 0, 0, 1, 3
"d:\IDEWORK\lvmen\src\licensedcode\data\rules\false-positive_1093.yml", "YAML", 0, 0, 0, 2, 0, 0, 1, 3
"d:\IDEWORK\lvmen\src\licensedcode\data\rules\false-positive_1094.yml", "YAML", 0, 0, 0, 2, 0, 0, 1, 3
"d:\IDEWORK\lvmen\src\licensedcode\data\rules\false-positive_1095.yml", "YAML", 0, 0, 0, 2, 0, 0, 1, 3
"d:\IDEWORK\lvmen\src\licensedcode\data\rules\false-positive_1096.yml", "YAML", 0, 0, 0, 2, 0, 0, 1, 3
"d:\IDEWORK\lvmen\src\licensedcode\data\rules\false-positive_1097.yml", "YAML", 0, 0, 0, 2, 0, 0, 1, 3
"d:\IDEWORK\lvmen\src\licensedcode\data\rules\false-positive_1098.yml", "YAML", 0, 0, 0, 2, 0, 0, 1, 3
"d:\IDEWORK\lvmen\src\licensedcode\data\rules\false-positive_1099.yml", "YAML", 0, 0, 0, 2, 0, 0, 1, 3
"d:\IDEWORK\lvmen\src\licensedcode\data\rules\false-positive_11.yml", "YAML", 0, 0, 0, 2, 0, 0, 1, 3
"d:\IDEWORK\lvmen\src\licensedcode\data\rules\false-positive_110.yml", "YAML", 0, 0, 0, 2, 0, 0, 1, 3
"d:\IDEWORK\lvmen\src\licensedcode\data\rules\false-positive_1100.yml", "YAML", 0, 0, 0, 2, 0, 0, 1, 3
"d:\IDEWORK\lvmen\src\licensedcode\data\rules\false-positive_1101.yml", "YAML", 0, 0, 0, 2, 0, 0, 1, 3
"d:\IDEWORK\lvmen\src\licensedcode\data\rules\false-positive_1102.yml", "YAML", 0, 0, 0, 2, 0, 0, 1, 3
"d:\IDEWORK\lvmen\src\licensedcode\data\rules\false-positive_1103.yml", "YAML", 0, 0, 0, 2, 0, 0, 1, 3
"d:\IDEWORK\lvmen\src\licensedcode\data\rules\false-positive_1104.yml", "YAML", 0, 0, 0, 2, 0, 0, 1, 3
"d:\IDEWORK\lvmen\src\licensedcode\data\rules\false-positive_1105.yml", "YAML", 0, 0, 0, 2, 0, 0, 1, 3
"d:\IDEWORK\lvmen\src\licensedcode\data\rules\false-positive_1106.yml", "YAML", 0, 0, 0, 2, 0, 0, 1, 3
"d:\IDEWORK\lvmen\src\licensedcode\data\rules\false-positive_1107.yml", "YAML", 0, 0, 0, 2, 0, 0, 1, 3
"d:\IDEWORK\lvmen\src\licensedcode\data\rules\false-positive_1108.yml", "YAML", 0, 0, 0, 2, 0, 0, 1, 3
"d:\IDEWORK\lvmen\src\licensedcode\data\rules\false-positive_1109.yml", "YAML", 0, 0, 0, 2, 0, 0, 1, 3
"d:\IDEWORK\lvmen\src\licensedcode\data\rules\false-positive_111.yml", "YAML", 0, 0, 0, 2, 0, 0, 1, 3
"d:\IDEWORK\lvmen\src\licensedcode\data\rules\false-positive_1110.yml", "YAML", 0, 0, 0, 2, 0, 0, 1, 3
"d:\IDEWORK\lvmen\src\licensedcode\data\rules\false-positive_1111.yml", "YAML", 0, 0, 0, 2, 0, 0, 1, 3
"d:\IDEWORK\lvmen\src\licensedcode\data\rules\false-positive_1112.yml", "YAML", 0, 0, 0, 2, 0, 0, 1, 3
"d:\IDEWORK\lvmen\src\licensedcode\data\rules\false-positive_1113.yml", "YAML", 0, 0, 0, 2, 0, 0, 1, 3
"d:\IDEWORK\lvmen\src\licensedcode\data\rules\false-positive_1114.yml", "YAML", 0, 0, 0, 2, 0, 0, 1, 3
"d:\IDEWORK\lvmen\src\licensedcode\data\rules\false-positive_1115.yml", "YAML", 0, 0, 0, 2, 0, 0, 1, 3
"d:\IDEWORK\lvmen\src\licensedcode\data\rules\false-positive_1116.yml", "YAML", 0, 0, 0, 2, 0, 0, 1, 3
"d:\IDEWORK\lvmen\src\licensedcode\data\rules\false-positive_1117.yml", "YAML", 0, 0, 0, 2, 0, 0, 1, 3
"d:\IDEWORK\lvmen\src\licensedcode\data\rules\false-positive_1118.yml", "YAML", 0, 0, 0, 2, 0, 0, 1, 3
"d:\IDEWORK\lvmen\src\licensedcode\data\rules\false-positive_1119.yml", "YAML", 0, 0, 0, 2, 0, 0, 1, 3
"d:\IDEWORK\lvmen\src\licensedcode\data\rules\false-positive_112.yml", "YAML", 0, 0, 0, 2, 0, 0, 1, 3
"d:\IDEWORK\lvmen\src\licensedcode\data\rules\false-positive_1120.yml", "YAML", 0, 0, 0, 2, 0, 0, 1, 3
"d:\IDEWORK\lvmen\src\licensedcode\data\rules\false-positive_1121.yml", "YAML", 0, 0, 0, 2, 0, 0, 1, 3
"d:\IDEWORK\lvmen\src\licensedcode\data\rules\false-positive_1122.yml", "YAML", 0, 0, 0, 2, 0, 0, 1, 3
"d:\IDEWORK\lvmen\src\licensedcode\data\rules\false-positive_1123.yml", "YAML", 0, 0, 0, 2, 0, 0, 1, 3
"d:\IDEWORK\lvmen\src\licensedcode\data\rules\false-positive_1124.yml", "YAML", 0, 0, 0, 2, 0, 0, 1, 3
"d:\IDEWORK\lvmen\src\licensedcode\data\rules\false-positive_1125.yml", "YAML", 0, 0, 0, 2, 0, 0, 1, 3
"d:\IDEWORK\lvmen\src\licensedcode\data\rules\false-positive_1126.yml", "YAML", 0, 0, 0, 2, 0, 0, 1, 3
"d:\IDEWORK\lvmen\src\licensedcode\data\rules\false-positive_1127.yml", "YAML", 0, 0, 0, 2, 0, 0, 1, 3
"d:\IDEWORK\lvmen\src\licensedcode\data\rules\false-positive_1128.yml", "YAML", 0, 0, 0, 2, 0, 0, 1, 3
"d:\IDEWORK\lvmen\src\licensedcode\data\rules\false-positive_1129.yml", "YAML", 0, 0, 0, 2, 0, 0, 1, 3
"d:\IDEWORK\lvmen\src\licensedcode\data\rules\false-positive_113.yml", "YAML", 0, 0, 0, 2, 0, 0, 1, 3
"d:\IDEWORK\lvmen\src\licensedcode\data\rules\false-positive_1130.yml", "YAML", 0, 0, 0, 2, 0, 0, 1, 3
"d:\IDEWORK\lvmen\src\licensedcode\data\rules\false-positive_1131.yml", "YAML", 0, 0, 0, 2, 0, 0, 1, 3
"d:\IDEWORK\lvmen\src\licensedcode\data\rules\false-positive_1132.yml", "YAML", 0, 0, 0, 2, 0, 0, 1, 3
"d:\IDEWORK\lvmen\src\licensedcode\data\rules\false-positive_1133.yml", "YAML", 0, 0, 0, 2, 0, 0, 1, 3
"d:\IDEWORK\lvmen\src\licensedcode\data\rules\false-positive_1134.yml", "YAML", 0, 0, 0, 2, 0, 0, 1, 3
"d:\IDEWORK\lvmen\src\licensedcode\data\rules\false-positive_1135.yml", "YAML", 0, 0, 0, 2, 0, 0, 1, 3
"d:\IDEWORK\lvmen\src\licensedcode\data\rules\false-positive_1136.yml", "YAML", 0, 0, 0, 2, 0, 0, 1, 3
"d:\IDEWORK\lvmen\src\licensedcode\data\rules\false-positive_1137.yml", "YAML", 0, 0, 0, 2, 0, 0, 1, 3
"d:\IDEWORK\lvmen\src\licensedcode\data\rules\false-positive_1138.yml", "YAML", 0, 0, 0, 2, 0, 0, 1, 3
"d:\IDEWORK\lvmen\src\licensedcode\data\rules\false-positive_1139.yml", "YAML", 0, 0, 0, 2, 0, 0, 1, 3
"d:\IDEWORK\lvmen\src\licensedcode\data\rules\false-positive_114.yml", "YAML", 0, 0, 0, 2, 0, 0, 1, 3
"d:\IDEWORK\lvmen\src\licensedcode\data\rules\false-positive_1140.yml", "YAML", 0, 0, 0, 2, 0, 0, 1, 3
"d:\IDEWORK\lvmen\src\licensedcode\data\rules\false-positive_1141.yml", "YAML", 0, 0, 0, 2, 0, 0, 1, 3
"d:\IDEWORK\lvmen\src\licensedcode\data\rules\false-positive_1142.yml", "YAML", 0, 0, 0, 2, 0, 0, 1, 3
"d:\IDEWORK\lvmen\src\licensedcode\data\rules\false-positive_1143.yml", "YAML", 0, 0, 0, 2, 0, 0, 1, 3
"d:\IDEWORK\lvmen\src\licensedcode\data\rules\false-positive_1144.yml", "YAML", 0, 0, 0, 2, 0, 0, 1, 3
"d:\IDEWORK\lvmen\src\licensedcode\data\rules\false-positive_1145.yml", "YAML", 0, 0, 0, 2, 0, 0, 1, 3
"d:\IDEWORK\lvmen\src\licensedcode\data\rules\false-positive_1146.yml", "YAML", 0, 0, 0, 2, 0, 0, 1, 3
"d:\IDEWORK\lvmen\src\licensedcode\data\rules\false-positive_1147.yml", "YAML", 0, 0, 0, 2, 0, 0, 1, 3
"d:\IDEWORK\lvmen\src\licensedcode\data\rules\false-positive_1148.yml", "YAML", 0, 0, 0, 2, 0, 0, 1, 3
"d:\IDEWORK\lvmen\src\licensedcode\data\rules\false-positive_1149.yml", "YAML", 0, 0, 0, 2, 0, 0, 1, 3
"d:\IDEWORK\lvmen\src\licensedcode\data\rules\false-positive_115.yml", "YAML", 0, 0, 0, 2, 0, 0, 1, 3
"d:\IDEWORK\lvmen\src\licensedcode\data\rules\false-positive_1150.yml", "YAML", 0, 0, 0, 2, 0, 0, 1, 3
"d:\IDEWORK\lvmen\src\licensedcode\data\rules\false-positive_1151.yml", "YAML", 0, 0, 0, 2, 0, 0, 1, 3
"d:\IDEWORK\lvmen\src\licensedcode\data\rules\false-positive_1152.yml", "YAML", 0, 0, 0, 2, 0, 0, 1, 3
"d:\IDEWORK\lvmen\src\licensedcode\data\rules\false-positive_1153.yml", "YAML", 0, 0, 0, 2, 0, 0, 1, 3
"d:\IDEWORK\lvmen\src\licensedcode\data\rules\false-positive_1154.yml", "YAML", 0, 0, 0, 2, 0, 0, 1, 3
"d:\IDEWORK\lvmen\src\licensedcode\data\rules\false-positive_1155.yml", "YAML", 0, 0, 0, 2, 0, 0, 1, 3
"d:\IDEWORK\lvmen\src\licensedcode\data\rules\false-positive_1156.yml", "YAML", 0, 0, 0, 2, 0, 0, 1, 3
"d:\IDEWORK\lvmen\src\licensedcode\data\rules\false-positive_1157.yml", "YAML", 0, 0, 0, 2, 0, 0, 1, 3
"d:\IDEWORK\lvmen\src\licensedcode\data\rules\false-positive_1158.yml", "YAML", 0, 0, 0, 2, 0, 0, 1, 3
"d:\IDEWORK\lvmen\src\licensedcode\data\rules\false-positive_1159.yml", "YAML", 0, 0, 0, 2, 0, 0, 1, 3
"d:\IDEWORK\lvmen\src\licensedcode\data\rules\false-positive_116.yml", "YAML", 0, 0, 0, 2, 0, 0, 1, 3
"d:\IDEWORK\lvmen\src\licensedcode\data\rules\false-positive_1160.yml", "YAML", 0, 0, 0, 2, 0, 0, 1, 3
"d:\IDEWORK\lvmen\src\licensedcode\data\rules\false-positive_1161.yml", "YAML", 0, 0, 0, 2, 0, 0, 1, 3
"d:\IDEWORK\lvmen\src\licensedcode\data\rules\false-positive_1162.yml", "YAML", 0, 0, 0, 2, 0, 0, 1, 3
"d:\IDEWORK\lvmen\src\licensedcode\data\rules\false-positive_1163.yml", "YAML", 0, 0, 0, 2, 0, 0, 1, 3
"d:\IDEWORK\lvmen\src\licensedcode\data\rules\false-positive_1164.yml", "YAML", 0, 0, 0, 2, 0, 0, 1, 3
"d:\IDEWORK\lvmen\src\licensedcode\data\rules\false-positive_1165.yml", "YAML", 0, 0, 0, 2, 0, 0, 1, 3
"d:\IDEWORK\lvmen\src\licensedcode\data\rules\false-positive_1166.yml", "YAML", 0, 0, 0, 2, 0, 0, 1, 3
"d:\IDEWORK\lvmen\src\licensedcode\data\rules\false-positive_1167.yml", "YAML", 0, 0, 0, 2, 0, 0, 1, 3
"d:\IDEWORK\lvmen\src\licensedcode\data\rules\false-positive_1168.yml", "YAML", 0, 0, 0, 2, 0, 0, 1, 3
"d:\IDEWORK\lvmen\src\licensedcode\data\rules\false-positive_1169.yml", "YAML", 0, 0, 0, 2, 0, 0, 1, 3
"d:\IDEWORK\lvmen\src\licensedcode\data\rules\false-positive_117.yml", "YAML", 0, 0, 0, 3, 0, 0, 1, 4
"d:\IDEWORK\lvmen\src\licensedcode\data\rules\false-positive_1170.yml", "YAML", 0, 0, 0, 2, 0, 0, 1, 3
"d:\IDEWORK\lvmen\src\licensedcode\data\rules\false-positive_1171.yml", "YAML", 0, 0, 0, 2, 0, 0, 1, 3
"d:\IDEWORK\lvmen\src\licensedcode\data\rules\false-positive_1172.yml", "YAML", 0, 0, 0, 2, 0, 0, 1, 3
"d:\IDEWORK\lvmen\src\licensedcode\data\rules\false-positive_1173.yml", "YAML", 0, 0, 0, 2, 0, 0, 1, 3
"d:\IDEWORK\lvmen\src\licensedcode\data\rules\false-positive_1174.yml", "YAML", 0, 0, 0, 2, 0, 0, 1, 3
"d:\IDEWORK\lvmen\src\licensedcode\data\rules\false-positive_1175.yml", "YAML", 0, 0, 0, 2, 0, 0, 1, 3
"d:\IDEWORK\lvmen\src\licensedcode\data\rules\false-positive_1176.yml", "YAML", 0, 0, 0, 2, 0, 0, 1, 3
"d:\IDEWORK\lvmen\src\licensedcode\data\rules\false-positive_1177.yml", "YAML", 0, 0, 0, 2, 0, 0, 1, 3
"d:\IDEWORK\lvmen\src\licensedcode\data\rules\false-positive_1178.yml", "YAML", 0, 0, 0, 2, 0, 0, 1, 3
"d:\IDEWORK\lvmen\src\licensedcode\data\rules\false-positive_1179.yml", "YAML", 0, 0, 0, 2, 0, 0, 1, 3
"d:\IDEWORK\lvmen\src\licensedcode\data\rules\false-positive_118.yml", "YAML", 0, 0, 0, 2, 0, 0, 1, 3
"d:\IDEWORK\lvmen\src\licensedcode\data\rules\false-positive_1180.yml", "YAML", 0, 0, 0, 2, 0, 0, 1, 3
"d:\IDEWORK\lvmen\src\licensedcode\data\rules\false-positive_1181.yml", "YAML", 0, 0, 0, 2, 0, 0, 1, 3
"d:\IDEWORK\lvmen\src\licensedcode\data\rules\false-positive_1182.yml", "YAML", 0, 0, 0, 2, 0, 0, 1, 3
"d:\IDEWORK\lvmen\src\licensedcode\data\rules\false-positive_1183.yml", "YAML", 0, 0, 0, 2, 0, 0, 1, 3
"d:\IDEWORK\lvmen\src\licensedcode\data\rules\false-positive_1184.yml", "YAML", 0, 0, 0, 2, 0, 0, 1, 3
"d:\IDEWORK\lvmen\src\licensedcode\data\rules\false-positive_1185.yml", "YAML", 0, 0, 0, 2, 0, 0, 1, 3
"d:\IDEWORK\lvmen\src\licensedcode\data\rules\false-positive_1186.yml", "YAML", 0, 0, 0, 2, 0, 0, 1, 3
"d:\IDEWORK\lvmen\src\licensedcode\data\rules\false-positive_1187.yml", "YAML", 0, 0, 0, 2, 0, 0, 1, 3
"d:\IDEWORK\lvmen\src\licensedcode\data\rules\false-positive_1188.yml", "YAML", 0, 0, 0, 2, 0, 0, 1, 3
"d:\IDEWORK\lvmen\src\licensedcode\data\rules\false-positive_1189.yml", "YAML", 0, 0, 0, 2, 0, 0, 1, 3
"d:\IDEWORK\lvmen\src\licensedcode\data\rules\false-positive_119.yml", "YAML", 0, 0, 0, 3, 0, 0, 1, 4
"d:\IDEWORK\lvmen\src\licensedcode\data\rules\false-positive_1190.yml", "YAML", 0, 0, 0, 2, 0, 0, 1, 3
"d:\IDEWORK\lvmen\src\licensedcode\data\rules\false-positive_1191.yml", "YAML", 0, 0, 0, 2, 0, 0, 1, 3
"d:\IDEWORK\lvmen\src\licensedcode\data\rules\false-positive_1192.yml", "YAML", 0, 0, 0, 2, 0, 0, 1, 3
"d:\IDEWORK\lvmen\src\licensedcode\data\rules\false-positive_1193.yml", "YAML", 0, 0, 0, 2, 0, 0, 1, 3
"d:\IDEWORK\lvmen\src\licensedcode\data\rules\false-positive_1194.yml", "YAML", 0, 0, 0, 2, 0, 0, 1, 3
"d:\IDEWORK\lvmen\src\licensedcode\data\rules\false-positive_1195.yml", "YAML", 0, 0, 0, 2, 0, 0, 1, 3
"d:\IDEWORK\lvmen\src\licensedcode\data\rules\false-positive_1196.yml", "YAML", 0, 0, 0, 2, 0, 0, 1, 3
"d:\IDEWORK\lvmen\src\licensedcode\data\rules\false-positive_1197.yml", "YAML", 0, 0, 0, 2, 0, 0, 1, 3
"d:\IDEWORK\lvmen\src\licensedcode\data\rules\false-positive_1198.yml", "YAML", 0, 0, 0, 2, 0, 0, 1, 3
"d:\IDEWORK\lvmen\src\licensedcode\data\rules\false-positive_1199.yml", "YAML", 0, 0, 0, 2, 0, 0, 1, 3
"d:\IDEWORK\lvmen\src\licensedcode\data\rules\false-positive_12.yml", "YAML", 0, 0, 0, 3, 0, 0, 1, 4
"d:\IDEWORK\lvmen\src\licensedcode\data\rules\false-positive_120.yml", "YAML", 0, 0, 0, 2, 0, 0, 1, 3
"d:\IDEWORK\lvmen\src\licensedcode\data\rules\false-positive_1200.yml", "YAML", 0, 0, 0, 2, 0, 0, 1, 3
"d:\IDEWORK\lvmen\src\licensedcode\data\rules\false-positive_1201.yml", "YAML", 0, 0, 0, 2, 0, 0, 1, 3
"d:\IDEWORK\lvmen\src\licensedcode\data\rules\false-positive_1202.yml", "YAML", 0, 0, 0, 2, 0, 0, 1, 3
"d:\IDEWORK\lvmen\src\licensedcode\data\rules\false-positive_1203.yml", "YAML", 0, 0, 0, 2, 0, 0, 1, 3
"d:\IDEWORK\lvmen\src\licensedcode\data\rules\false-positive_1204.yml", "YAML", 0, 0, 0, 2, 0, 0, 1, 3
"d:\IDEWORK\lvmen\src\licensedcode\data\rules\false-positive_1205.yml", "YAML", 0, 0, 0, 2, 0, 0, 1, 3
"d:\IDEWORK\lvmen\src\licensedcode\data\rules\false-positive_1206.yml", "YAML", 0, 0, 0, 2, 0, 0, 1, 3
"d:\IDEWORK\lvmen\src\licensedcode\data\rules\false-positive_1207.yml", "YAML", 0, 0, 0, 2, 0, 0, 1, 3
"d:\IDEWORK\lvmen\src\licensedcode\data\rules\false-positive_1208.yml", "YAML", 0, 0, 0, 2, 0, 0, 1, 3
"d:\IDEWORK\lvmen\src\licensedcode\data\rules\false-positive_1209.yml", "YAML", 0, 0, 0, 2, 0, 0, 1, 3
"d:\IDEWORK\lvmen\src\licensedcode\data\rules\false-positive_121.yml", "YAML", 0, 0, 0, 2, 0, 0, 1, 3
"d:\IDEWORK\lvmen\src\licensedcode\data\rules\false-positive_1210.yml", "YAML", 0, 0, 0, 2, 0, 0, 1, 3
"d:\IDEWORK\lvmen\src\licensedcode\data\rules\false-positive_1211.yml", "YAML", 0, 0, 0, 2, 0, 0, 1, 3
"d:\IDEWORK\lvmen\src\licensedcode\data\rules\false-positive_1212.yml", "YAML", 0, 0, 0, 2, 0, 0, 1, 3
"d:\IDEWORK\lvmen\src\licensedcode\data\rules\false-positive_1213.yml", "YAML", 0, 0, 0, 2, 0, 0, 1, 3
"d:\IDEWORK\lvmen\src\licensedcode\data\rules\false-positive_1214.yml", "YAML", 0, 0, 0, 2, 0, 0, 1, 3
"d:\IDEWORK\lvmen\src\licensedcode\data\rules\false-positive_1215.yml", "YAML", 0, 0, 0, 2, 0, 0, 1, 3
"d:\IDEWORK\lvmen\src\licensedcode\data\rules\false-positive_1216.yml", "YAML", 0, 0, 0, 2, 0, 0, 1, 3
"d:\IDEWORK\lvmen\src\licensedcode\data\rules\false-positive_1217.yml", "YAML", 0, 0, 0, 2, 0, 0, 1, 3
"d:\IDEWORK\lvmen\src\licensedcode\data\rules\false-positive_1218.yml", "YAML", 0, 0, 0, 2, 0, 0, 1, 3
"d:\IDEWORK\lvmen\src\licensedcode\data\rules\false-positive_1219.yml", "YAML", 0, 0, 0, 2, 0, 0, 1, 3
"d:\IDEWORK\lvmen\src\licensedcode\data\rules\false-positive_122.yml", "YAML", 0, 0, 0, 2, 0, 0, 1, 3
"d:\IDEWORK\lvmen\src\licensedcode\data\rules\false-positive_1220.yml", "YAML", 0, 0, 0, 2, 0, 0, 1, 3
"d:\IDEWORK\lvmen\src\licensedcode\data\rules\false-positive_1221.yml", "YAML", 0, 0, 0, 2, 0, 0, 1, 3
"d:\IDEWORK\lvmen\src\licensedcode\data\rules\false-positive_1222.yml", "YAML", 0, 0, 0, 2, 0, 0, 1, 3
"d:\IDEWORK\lvmen\src\licensedcode\data\rules\false-positive_1223.yml", "YAML", 0, 0, 0, 2, 0, 0, 1, 3
"d:\IDEWORK\lvmen\src\licensedcode\data\rules\false-positive_1224.yml", "YAML", 0, 0, 0, 2, 0, 0, 1, 3
"d:\IDEWORK\lvmen\src\licensedcode\data\rules\false-positive_1225.yml", "YAML", 0, 0, 0, 2, 0, 0, 1, 3
"d:\IDEWORK\lvmen\src\licensedcode\data\rules\false-positive_1226.yml", "YAML", 0, 0, 0, 2, 0, 0, 1, 3
"d:\IDEWORK\lvmen\src\licensedcode\data\rules\false-positive_1227.yml", "YAML", 0, 0, 0, 2, 0, 0, 1, 3
"d:\IDEWORK\lvmen\src\licensedcode\data\rules\false-positive_1228.yml", "YAML", 0, 0, 0, 2, 0, 0, 1, 3
"d:\IDEWORK\lvmen\src\licensedcode\data\rules\false-positive_1229.yml", "YAML", 0, 0, 0, 2, 0, 0, 1, 3
"d:\IDEWORK\lvmen\src\licensedcode\data\rules\false-positive_123.yml", "YAML", 0, 0, 0, 2, 0, 0, 1, 3
"d:\IDEWORK\lvmen\src\licensedcode\data\rules\false-positive_1230.yml", "YAML", 0, 0, 0, 2, 0, 0, 1, 3
"d:\IDEWORK\lvmen\src\licensedcode\data\rules\false-positive_1231.yml", "YAML", 0, 0, 0, 2, 0, 0, 1, 3
"d:\IDEWORK\lvmen\src\licensedcode\data\rules\false-positive_1232.yml", "YAML", 0, 0, 0, 2, 0, 0, 1, 3
"d:\IDEWORK\lvmen\src\licensedcode\data\rules\false-positive_1233.yml", "YAML", 0, 0, 0, 2, 0, 0, 1, 3
"d:\IDEWORK\lvmen\src\licensedcode\data\rules\false-positive_1234.yml", "YAML", 0, 0, 0, 2, 0, 0, 1, 3
"d:\IDEWORK\lvmen\src\licensedcode\data\rules\false-positive_1235.yml", "YAML", 0, 0, 0, 2, 0, 0, 1, 3
"d:\IDEWORK\lvmen\src\licensedcode\data\rules\false-positive_1236.yml", "YAML", 0, 0, 0, 2, 0, 0, 1, 3
"d:\IDEWORK\lvmen\src\licensedcode\data\rules\false-positive_1237.yml", "YAML", 0, 0, 0, 2, 0, 0, 1, 3
"d:\IDEWORK\lvmen\src\licensedcode\data\rules\false-positive_1238.yml", "YAML", 0, 0, 0, 2, 0, 0, 1, 3
"d:\IDEWORK\lvmen\src\licensedcode\data\rules\false-positive_1239.yml", "YAML", 0, 0, 0, 2, 0, 0, 1, 3
"d:\IDEWORK\lvmen\src\licensedcode\data\rules\false-positive_124.yml", "YAML", 0, 0, 0, 2, 0, 0, 1, 3
"d:\IDEWORK\lvmen\src\licensedcode\data\rules\false-positive_1240.yml", "YAML", 0, 0, 0, 2, 0, 0, 1, 3
"d:\IDEWORK\lvmen\src\licensedcode\data\rules\false-positive_1241.yml", "YAML", 0, 0, 0, 2, 0, 0, 1, 3
"d:\IDEWORK\lvmen\src\licensedcode\data\rules\false-positive_1242.yml", "YAML", 0, 0, 0, 2, 0, 0, 1, 3
"d:\IDEWORK\lvmen\src\licensedcode\data\rules\false-positive_1243.yml", "YAML", 0, 0, 0, 2, 0, 0, 1, 3
"d:\IDEWORK\lvmen\src\licensedcode\data\rules\false-positive_1244.yml", "YAML", 0, 0, 0, 2, 0, 0, 1, 3
"d:\IDEWORK\lvmen\src\licensedcode\data\rules\false-positive_1245.yml", "YAML", 0, 0, 0, 2, 0, 0, 1, 3
"d:\IDEWORK\lvmen\src\licensedcode\data\rules\false-positive_1246.yml", "YAML", 0, 0, 0, 2, 0, 0, 1, 3
"d:\IDEWORK\lvmen\src\licensedcode\data\rules\false-positive_1247.yml", "YAML", 0, 0, 0, 2, 0, 0, 1, 3
"d:\IDEWORK\lvmen\src\licensedcode\data\rules\false-positive_1248.yml", "YAML", 0, 0, 0, 2, 0, 0, 1, 3
"d:\IDEWORK\lvmen\src\licensedcode\data\rules\false-positive_1249.yml", "YAML", 0, 0, 0, 2, 0, 0, 1, 3
"d:\IDEWORK\lvmen\src\licensedcode\data\rules\false-positive_125.yml", "YAML", 0, 0, 0, 2, 0, 0, 1, 3
"d:\IDEWORK\lvmen\src\licensedcode\data\rules\false-positive_1250.yml", "YAML", 0, 0, 0, 2, 0, 0, 1, 3
"d:\IDEWORK\lvmen\src\licensedcode\data\rules\false-positive_1251.yml", "YAML", 0, 0, 0, 2, 0, 0, 1, 3
"d:\IDEWORK\lvmen\src\licensedcode\data\rules\false-positive_1252.yml", "YAML", 0, 0, 0, 2, 0, 0, 1, 3
"d:\IDEWORK\lvmen\src\licensedcode\data\rules\false-positive_1253.yml", "YAML", 0, 0, 0, 2, 0, 0, 1, 3
"d:\IDEWORK\lvmen\src\licensedcode\data\rules\false-positive_1254.yml", "YAML", 0, 0, 0, 2, 0, 0, 1, 3
"d:\IDEWORK\lvmen\src\licensedcode\data\rules\false-positive_1255.yml", "YAML", 0, 0, 0, 2, 0, 0, 1, 3
"d:\IDEWORK\lvmen\src\licensedcode\data\rules\false-positive_1256.yml", "YAML", 0, 0, 0, 2, 0, 0, 1, 3
"d:\IDEWORK\lvmen\src\licensedcode\data\rules\false-positive_1257.yml", "YAML", 0, 0, 0, 2, 0, 0, 1, 3
"d:\IDEWORK\lvmen\src\licensedcode\data\rules\false-positive_1258.yml", "YAML", 0, 0, 0, 2, 0, 0, 1, 3
"d:\IDEWORK\lvmen\src\licensedcode\data\rules\false-positive_1259.yml", "YAML", 0, 0, 0, 2, 0, 0, 1, 3
"d:\IDEWORK\lvmen\src\licensedcode\data\rules\false-positive_126.yml", "YAML", 0, 0, 0, 2, 0, 0, 1, 3
"d:\IDEWORK\lvmen\src\licensedcode\data\rules\false-positive_1260.yml", "YAML", 0, 0, 0, 2, 0, 0, 1, 3
"d:\IDEWORK\lvmen\src\licensedcode\data\rules\false-positive_1261.yml", "YAML", 0, 0, 0, 2, 0, 0, 1, 3
"d:\IDEWORK\lvmen\src\licensedcode\data\rules\false-positive_1262.yml", "YAML", 0, 0, 0, 2, 0, 0, 1, 3
"d:\IDEWORK\lvmen\src\licensedcode\data\rules\false-positive_1263.yml", "YAML", 0, 0, 0, 2, 0, 0, 1, 3
"d:\IDEWORK\lvmen\src\licensedcode\data\rules\false-positive_1264.yml", "YAML", 0, 0, 0, 2, 0, 0, 1, 3
"d:\IDEWORK\lvmen\src\licensedcode\data\rules\false-positive_1265.yml", "YAML", 0, 0, 0, 2, 0, 0, 1, 3
"d:\IDEWORK\lvmen\src\licensedcode\data\rules\false-positive_1266.yml", "YAML", 0, 0, 0, 2, 0, 0, 1, 3
"d:\IDEWORK\lvmen\src\licensedcode\data\rules\false-positive_1267.yml", "YAML", 0, 0, 0, 2, 0, 0, 1, 3
"d:\IDEWORK\lvmen\src\licensedcode\data\rules\false-positive_1268.yml", "YAML", 0, 0, 0, 2, 0, 0, 1, 3
"d:\IDEWORK\lvmen\src\licensedcode\data\rules\false-positive_1269.yml", "YAML", 0, 0, 0, 2, 0, 0, 1, 3
"d:\IDEWORK\lvmen\src\licensedcode\data\rules\false-positive_127.yml", "YAML", 0, 0, 0, 3, 0, 0, 1, 4
"d:\IDEWORK\lvmen\src\licensedcode\data\rules\false-positive_1270.yml", "YAML", 0, 0, 0, 2, 0, 0, 1, 3
"d:\IDEWORK\lvmen\src\licensedcode\data\rules\false-positive_1271.yml", "YAML", 0, 0, 0, 2, 0, 0, 1, 3
"d:\IDEWORK\lvmen\src\licensedcode\data\rules\false-positive_1272.yml", "YAML", 0, 0, 0, 2, 0, 0, 1, 3
"d:\IDEWORK\lvmen\src\licensedcode\data\rules\false-positive_1273.yml", "YAML", 0, 0, 0, 2, 0, 0, 1, 3
"d:\IDEWORK\lvmen\src\licensedcode\data\rules\false-positive_1274.yml", "YAML", 0, 0, 0, 2, 0, 0, 1, 3
"d:\IDEWORK\lvmen\src\licensedcode\data\rules\false-positive_1275.yml", "YAML", 0, 0, 0, 2, 0, 0, 1, 3
"d:\IDEWORK\lvmen\src\licensedcode\data\rules\false-positive_1276.yml", "YAML", 0, 0, 0, 2, 0, 0, 1, 3
"d:\IDEWORK\lvmen\src\licensedcode\data\rules\false-positive_1277.yml", "YAML", 0, 0, 0, 2, 0, 0, 1, 3
"d:\IDEWORK\lvmen\src\licensedcode\data\rules\false-positive_1278.yml", "YAML", 0, 0, 0, 2, 0, 0, 1, 3
"d:\IDEWORK\lvmen\src\licensedcode\data\rules\false-positive_1279.yml", "YAML", 0, 0, 0, 2, 0, 0, 1, 3
"d:\IDEWORK\lvmen\src\licensedcode\data\rules\false-positive_128.yml", "YAML", 0, 0, 0, 2, 0, 0, 1, 3
"d:\IDEWORK\lvmen\src\licensedcode\data\rules\false-positive_1280.yml", "YAML", 0, 0, 0, 2, 0, 0, 1, 3
"d:\IDEWORK\lvmen\src\licensedcode\data\rules\false-positive_1281.yml", "YAML", 0, 0, 0, 2, 0, 0, 1, 3
"d:\IDEWORK\lvmen\src\licensedcode\data\rules\false-positive_1282.yml", "YAML", 0, 0, 0, 2, 0, 0, 1, 3
"d:\IDEWORK\lvmen\src\licensedcode\data\rules\false-positive_1283.yml", "YAML", 0, 0, 0, 2, 0, 0, 1, 3
"d:\IDEWORK\lvmen\src\licensedcode\data\rules\false-positive_1284.yml", "YAML", 0, 0, 0, 2, 0, 0, 1, 3
"d:\IDEWORK\lvmen\src\licensedcode\data\rules\false-positive_1285.yml", "YAML", 0, 0, 0, 2, 0, 0, 1, 3
"d:\IDEWORK\lvmen\src\licensedcode\data\rules\false-positive_1286.yml", "YAML", 0, 0, 0, 2, 0, 0, 1, 3
"d:\IDEWORK\lvmen\src\licensedcode\data\rules\false-positive_1287.yml", "YAML", 0, 0, 0, 2, 0, 0, 1, 3
"d:\IDEWORK\lvmen\src\licensedcode\data\rules\false-positive_1288.yml", "YAML", 0, 0, 0, 2, 0, 0, 1, 3
"d:\IDEWORK\lvmen\src\licensedcode\data\rules\false-positive_1289.yml", "YAML", 0, 0, 0, 2, 0, 0, 1, 3
"d:\IDEWORK\lvmen\src\licensedcode\data\rules\false-positive_129.yml", "YAML", 0, 0, 0, 2, 0, 0, 1, 3
"d:\IDEWORK\lvmen\src\licensedcode\data\rules\false-positive_1290.yml", "YAML", 0, 0, 0, 2, 0, 0, 1, 3
"d:\IDEWORK\lvmen\src\licensedcode\data\rules\false-positive_1291.yml", "YAML", 0, 0, 0, 2, 0, 0, 1, 3
"d:\IDEWORK\lvmen\src\licensedcode\data\rules\false-positive_1292.yml", "YAML", 0, 0, 0, 2, 0, 0, 1, 3
"d:\IDEWORK\lvmen\src\licensedcode\data\rules\false-positive_1293.yml", "YAML", 0, 0, 0, 2, 0, 0, 1, 3
"d:\IDEWORK\lvmen\src\licensedcode\data\rules\false-positive_1294.yml", "YAML", 0, 0, 0, 2, 0, 0, 1, 3
"d:\IDEWORK\lvmen\src\licensedcode\data\rules\false-positive_1295.yml", "YAML", 0, 0, 0, 2, 0, 0, 1, 3
"d:\IDEWORK\lvmen\src\licensedcode\data\rules\false-positive_1296.yml", "YAML", 0, 0, 0, 2, 0, 0, 1, 3
"d:\IDEWORK\lvmen\src\licensedcode\data\rules\false-positive_1297.yml", "YAML", 0, 0, 0, 2, 0, 0, 1, 3
"d:\IDEWORK\lvmen\src\licensedcode\data\rules\false-positive_1298.yml", "YAML", 0, 0, 0, 2, 0, 0, 1, 3
"d:\IDEWORK\lvmen\src\licensedcode\data\rules\false-positive_1299.yml", "YAML", 0, 0, 0, 2, 0, 0, 1, 3
"d:\IDEWORK\lvmen\src\licensedcode\data\rules\false-positive_13.yml", "YAML", 0, 0, 0, 2, 0, 0, 1, 3
"d:\IDEWORK\lvmen\src\licensedcode\data\rules\false-positive_130.yml", "YAML", 0, 0, 0, 2, 0, 0, 1, 3
"d:\IDEWORK\lvmen\src\licensedcode\data\rules\false-positive_1300.yml", "YAML", 0, 0, 0, 2, 0, 0, 1, 3
"d:\IDEWORK\lvmen\src\licensedcode\data\rules\false-positive_1301.yml", "YAML", 0, 0, 0, 2, 0, 0, 1, 3
"d:\IDEWORK\lvmen\src\licensedcode\data\rules\false-positive_1302.yml", "YAML", 0, 0, 0, 2, 0, 0, 1, 3
"d:\IDEWORK\lvmen\src\licensedcode\data\rules\false-positive_1303.yml", "YAML", 0, 0, 0, 2, 0, 0, 1, 3
"d:\IDEWORK\lvmen\src\licensedcode\data\rules\false-positive_1304.yml", "YAML", 0, 0, 0, 2, 0, 0, 1, 3
"d:\IDEWORK\lvmen\src\licensedcode\data\rules\false-positive_1305.yml", "YAML", 0, 0, 0, 2, 0, 0, 1, 3
"d:\IDEWORK\lvmen\src\licensedcode\data\rules\false-positive_1306.yml", "YAML", 0, 0, 0, 2, 0, 0, 1, 3
"d:\IDEWORK\lvmen\src\licensedcode\data\rules\false-positive_1307.yml", "YAML", 0, 0, 0, 2, 0, 0, 1, 3
"d:\IDEWORK\lvmen\src\licensedcode\data\rules\false-positive_1308.yml", "YAML", 0, 0, 0, 2, 0, 0, 1, 3
"d:\IDEWORK\lvmen\src\licensedcode\data\rules\false-positive_1309.yml", "YAML", 0, 0, 0, 2, 0, 0, 1, 3
"d:\IDEWORK\lvmen\src\licensedcode\data\rules\false-positive_131.yml", "YAML", 0, 0, 0, 2, 0, 0, 1, 3
"d:\IDEWORK\lvmen\src\licensedcode\data\rules\false-positive_1310.yml", "YAML", 0, 0, 0, 2, 0, 0, 1, 3
"d:\IDEWORK\lvmen\src\licensedcode\data\rules\false-positive_1311.yml", "YAML", 0, 0, 0, 2, 0, 0, 1, 3
"d:\IDEWORK\lvmen\src\licensedcode\data\rules\false-positive_1312.yml", "YAML", 0, 0, 0, 2, 0, 0, 1, 3
"d:\IDEWORK\lvmen\src\licensedcode\data\rules\false-positive_1313.yml", "YAML", 0, 0, 0, 2, 0, 0, 1, 3
"d:\IDEWORK\lvmen\src\licensedcode\data\rules\false-positive_1314.yml", "YAML", 0, 0, 0, 2, 0, 0, 1, 3
"d:\IDEWORK\lvmen\src\licensedcode\data\rules\false-positive_1315.yml", "YAML", 0, 0, 0, 2, 0, 0, 1, 3
"d:\IDEWORK\lvmen\src\licensedcode\data\rules\false-positive_1316.yml", "YAML", 0, 0, 0, 2, 0, 0, 1, 3
"d:\IDEWORK\lvmen\src\licensedcode\data\rules\false-positive_1317.yml", "YAML", 0, 0, 0, 2, 0, 0, 1, 3
"d:\IDEWORK\lvmen\src\licensedcode\data\rules\false-positive_1318.yml", "YAML", 0, 0, 0, 2, 0, 0, 1, 3
"d:\IDEWORK\lvmen\src\licensedcode\data\rules\false-positive_1319.yml", "YAML", 0, 0, 0, 2, 0, 0, 1, 3
"d:\IDEWORK\lvmen\src\licensedcode\data\rules\false-positive_132.yml", "YAML", 0, 0, 0, 2, 0, 0, 1, 3
"d:\IDEWORK\lvmen\src\licensedcode\data\rules\false-positive_1320.yml", "YAML", 0, 0, 0, 2, 0, 0, 1, 3
"d:\IDEWORK\lvmen\src\licensedcode\data\rules\false-positive_1321.yml", "YAML", 0, 0, 0, 2, 0, 0, 1, 3
"d:\IDEWORK\lvmen\src\licensedcode\data\rules\false-positive_1322.yml", "YAML", 0, 0, 0, 2, 0, 0, 1, 3
"d:\IDEWORK\lvmen\src\licensedcode\data\rules\false-positive_1323.yml", "YAML", 0, 0, 0, 2, 0, 0, 1, 3
"d:\IDEWORK\lvmen\src\licensedcode\data\rules\false-positive_1324.yml", "YAML", 0, 0, 0, 2, 0, 0, 1, 3
"d:\IDEWORK\lvmen\src\licensedcode\data\rules\false-positive_1325.yml", "YAML", 0, 0, 0, 2, 0, 0, 1, 3
"d:\IDEWORK\lvmen\src\licensedcode\data\rules\false-positive_1326.yml", "YAML", 0, 0, 0, 2, 0, 0, 1, 3
"d:\IDEWORK\lvmen\src\licensedcode\data\rules\false-positive_1327.yml", "YAML", 0, 0, 0, 2, 0, 0, 1, 3
"d:\IDEWORK\lvmen\src\licensedcode\data\rules\false-positive_1328.yml", "YAML", 0, 0, 0, 2, 0, 0, 1, 3
"d:\IDEWORK\lvmen\src\licensedcode\data\rules\false-positive_1329.yml", "YAML", 0, 0, 0, 2, 0, 0, 1, 3
"d:\IDEWORK\lvmen\src\licensedcode\data\rules\false-positive_133.yml", "YAML", 0, 0, 0, 2, 0, 0, 1, 3
"d:\IDEWORK\lvmen\src\licensedcode\data\rules\false-positive_1330.yml", "YAML", 0, 0, 0, 2, 0, 0, 1, 3
"d:\IDEWORK\lvmen\src\licensedcode\data\rules\false-positive_1331.yml", "YAML", 0, 0, 0, 2, 0, 0, 1, 3
"d:\IDEWORK\lvmen\src\licensedcode\data\rules\false-positive_1332.yml", "YAML", 0, 0, 0, 2, 0, 0, 1, 3
"d:\IDEWORK\lvmen\src\licensedcode\data\rules\false-positive_1333.yml", "YAML", 0, 0, 0, 2, 0, 0, 1, 3
"d:\IDEWORK\lvmen\src\licensedcode\data\rules\false-positive_1334.yml", "YAML", 0, 0, 0, 2, 0, 0, 1, 3
"d:\IDEWORK\lvmen\src\licensedcode\data\rules\false-positive_1335.yml", "YAML", 0, 0, 0, 2, 0, 0, 1, 3
"d:\IDEWORK\lvmen\src\licensedcode\data\rules\false-positive_1336.yml", "YAML", 0, 0, 0, 2, 0, 0, 1, 3
"d:\IDEWORK\lvmen\src\licensedcode\data\rules\false-positive_1337.yml", "YAML", 0, 0, 0, 2, 0, 0, 1, 3
"d:\IDEWORK\lvmen\src\licensedcode\data\rules\false-positive_1338.yml", "YAML", 0, 0, 0, 2, 0, 0, 1, 3
"d:\IDEWORK\lvmen\src\licensedcode\data\rules\false-positive_1339.yml", "YAML", 0, 0, 0, 2, 0, 0, 1, 3
"d:\IDEWORK\lvmen\src\licensedcode\data\rules\false-positive_134.yml", "YAML", 0, 0, 0, 3, 0, 0, 1, 4
"d:\IDEWORK\lvmen\src\licensedcode\data\rules\false-positive_1340.yml", "YAML", 0, 0, 0, 2, 0, 0, 1, 3
"d:\IDEWORK\lvmen\src\licensedcode\data\rules\false-positive_1341.yml", "YAML", 0, 0, 0, 2, 0, 0, 1, 3
"d:\IDEWORK\lvmen\src\licensedcode\data\rules\false-positive_1342.yml", "YAML", 0, 0, 0, 2, 0, 0, 1, 3
"d:\IDEWORK\lvmen\src\licensedcode\data\rules\false-positive_1343.yml", "YAML", 0, 0, 0, 2, 0, 0, 1, 3
"d:\IDEWORK\lvmen\src\licensedcode\data\rules\false-positive_1344.yml", "YAML", 0, 0, 0, 2, 0, 0, 1, 3
"d:\IDEWORK\lvmen\src\licensedcode\data\rules\false-positive_1345.yml", "YAML", 0, 0, 0, 2, 0, 0, 1, 3
"d:\IDEWORK\lvmen\src\licensedcode\data\rules\false-positive_1346.yml", "YAML", 0, 0, 0, 2, 0, 0, 1, 3
"d:\IDEWORK\lvmen\src\licensedcode\data\rules\false-positive_1347.yml", "YAML", 0, 0, 0, 2, 0, 0, 1, 3
"d:\IDEWORK\lvmen\src\licensedcode\data\rules\false-positive_1348.yml", "YAML", 0, 0, 0, 2, 0, 0, 1, 3
"d:\IDEWORK\lvmen\src\licensedcode\data\rules\false-positive_1349.yml", "YAML", 0, 0, 0, 2, 0, 0, 1, 3
"d:\IDEWORK\lvmen\src\licensedcode\data\rules\false-positive_135.yml", "YAML", 0, 0, 0, 2, 0, 0, 1, 3
"d:\IDEWORK\lvmen\src\licensedcode\data\rules\false-positive_1350.yml", "YAML", 0, 0, 0, 2, 0, 0, 1, 3
"d:\IDEWORK\lvmen\src\licensedcode\data\rules\false-positive_1351.yml", "YAML", 0, 0, 0, 2, 0, 0, 1, 3
"d:\IDEWORK\lvmen\src\licensedcode\data\rules\false-positive_1352.yml", "YAML", 0, 0, 0, 2, 0, 0, 1, 3
"d:\IDEWORK\lvmen\src\licensedcode\data\rules\false-positive_1353.yml", "YAML", 0, 0, 0, 2, 0, 0, 1, 3
"d:\IDEWORK\lvmen\src\licensedcode\data\rules\false-positive_1354.yml", "YAML", 0, 0, 0, 2, 0, 0, 1, 3
"d:\IDEWORK\lvmen\src\licensedcode\data\rules\false-positive_1355.yml", "YAML", 0, 0, 0, 2, 0, 0, 1, 3
"d:\IDEWORK\lvmen\src\licensedcode\data\rules\false-positive_1356.yml", "YAML", 0, 0, 0, 2, 0, 0, 1, 3
"d:\IDEWORK\lvmen\src\licensedcode\data\rules\false-positive_1357.yml", "YAML", 0, 0, 0, 2, 0, 0, 1, 3
"d:\IDEWORK\lvmen\src\licensedcode\data\rules\false-positive_1358.yml", "YAML", 0, 0, 0, 2, 0, 0, 1, 3
"d:\IDEWORK\lvmen\src\licensedcode\data\rules\false-positive_1359.yml", "YAML", 0, 0, 0, 2, 0, 0, 1, 3
"d:\IDEWORK\lvmen\src\licensedcode\data\rules\false-positive_136.yml", "YAML", 0, 0, 0, 2, 0, 0, 1, 3
"d:\IDEWORK\lvmen\src\licensedcode\data\rules\false-positive_1360.yml", "YAML", 0, 0, 0, 2, 0, 0, 1, 3
"d:\IDEWORK\lvmen\src\licensedcode\data\rules\false-positive_1361.yml", "YAML", 0, 0, 0, 2, 0, 0, 1, 3
"d:\IDEWORK\lvmen\src\licensedcode\data\rules\false-positive_1362.yml", "YAML", 0, 0, 0, 2, 0, 0, 1, 3
"d:\IDEWORK\lvmen\src\licensedcode\data\rules\false-positive_1363.yml", "YAML", 0, 0, 0, 2, 0, 0, 1, 3
"d:\IDEWORK\lvmen\src\licensedcode\data\rules\false-positive_1364.yml", "YAML", 0, 0, 0, 2, 0, 0, 1, 3
"d:\IDEWORK\lvmen\src\licensedcode\data\rules\false-positive_1365.yml", "YAML", 0, 0, 0, 2, 0, 0, 1, 3
"d:\IDEWORK\lvmen\src\licensedcode\data\rules\false-positive_1366.yml", "YAML", 0, 0, 0, 2, 0, 0, 1, 3
"d:\IDEWORK\lvmen\src\licensedcode\data\rules\false-positive_1367.yml", "YAML", 0, 0, 0, 2, 0, 0, 1, 3
"d:\IDEWORK\lvmen\src\licensedcode\data\rules\false-positive_1368.yml", "YAML", 0, 0, 0, 2, 0, 0, 1, 3
"d:\IDEWORK\lvmen\src\licensedcode\data\rules\false-positive_1369.yml", "YAML", 0, 0, 0, 2, 0, 0, 1, 3
"d:\IDEWORK\lvmen\src\licensedcode\data\rules\false-positive_137.yml", "YAML", 0, 0, 0, 2, 0, 0, 1, 3
"d:\IDEWORK\lvmen\src\licensedcode\data\rules\false-positive_1370.yml", "YAML", 0, 0, 0, 2, 0, 0, 1, 3
"d:\IDEWORK\lvmen\src\licensedcode\data\rules\false-positive_1371.yml", "YAML", 0, 0, 0, 2, 0, 0, 1, 3
"d:\IDEWORK\lvmen\src\licensedcode\data\rules\false-positive_1372.yml", "YAML", 0, 0, 0, 2, 0, 0, 1, 3
"d:\IDEWORK\lvmen\src\licensedcode\data\rules\false-positive_1373.yml", "YAML", 0, 0, 0, 2, 0, 0, 1, 3
"d:\IDEWORK\lvmen\src\licensedcode\data\rules\false-positive_1374.yml", "YAML", 0, 0, 0, 2, 0, 0, 1, 3
"d:\IDEWORK\lvmen\src\licensedcode\data\rules\false-positive_1375.yml", "YAML", 0, 0, 0, 2, 0, 0, 1, 3
"d:\IDEWORK\lvmen\src\licensedcode\data\rules\false-positive_1376.yml", "YAML", 0, 0, 0, 2, 0, 0, 1, 3
"d:\IDEWORK\lvmen\src\licensedcode\data\rules\false-positive_1377.yml", "YAML", 0, 0, 0, 2, 0, 0, 1, 3
"d:\IDEWORK\lvmen\src\licensedcode\data\rules\false-positive_1378.yml", "YAML", 0, 0, 0, 2, 0, 0, 1, 3
"d:\IDEWORK\lvmen\src\licensedcode\data\rules\false-positive_1379.yml", "YAML", 0, 0, 0, 2, 0, 0, 1, 3
"d:\IDEWORK\lvmen\src\licensedcode\data\rules\false-positive_138.yml", "YAML", 0, 0, 0, 2, 0, 0, 1, 3
"d:\IDEWORK\lvmen\src\licensedcode\data\rules\false-positive_1380.yml", "YAML", 0, 0, 0, 2, 0, 0, 1, 3
"d:\IDEWORK\lvmen\src\licensedcode\data\rules\false-positive_1381.yml", "YAML", 0, 0, 0, 2, 0, 0, 1, 3
"d:\IDEWORK\lvmen\src\licensedcode\data\rules\false-positive_1382.yml", "YAML", 0, 0, 0, 2, 0, 0, 1, 3
"d:\IDEWORK\lvmen\src\licensedcode\data\rules\false-positive_1383.yml", "YAML", 0, 0, 0, 2, 0, 0, 1, 3
"d:\IDEWORK\lvmen\src\licensedcode\data\rules\false-positive_1384.yml", "YAML", 0, 0, 0, 2, 0, 0, 1, 3
"d:\IDEWORK\lvmen\src\licensedcode\data\rules\false-positive_1385.yml", "YAML", 0, 0, 0, 2, 0, 0, 1, 3
"d:\IDEWORK\lvmen\src\licensedcode\data\rules\false-positive_1386.yml", "YAML", 0, 0, 0, 2, 0, 0, 1, 3
"d:\IDEWORK\lvmen\src\licensedcode\data\rules\false-positive_1387.yml", "YAML", 0, 0, 0, 2, 0, 0, 1, 3
"d:\IDEWORK\lvmen\src\licensedcode\data\rules\false-positive_1388.yml", "YAML", 0, 0, 0, 2, 0, 0, 1, 3
"d:\IDEWORK\lvmen\src\licensedcode\data\rules\false-positive_1389.yml", "YAML", 0, 0, 0, 2, 0, 0, 1, 3
"d:\IDEWORK\lvmen\src\licensedcode\data\rules\false-positive_139.yml", "YAML", 0, 0, 0, 3, 0, 0, 1, 4
"d:\IDEWORK\lvmen\src\licensedcode\data\rules\false-positive_1390.yml", "YAML", 0, 0, 0, 2, 0, 0, 1, 3
"d:\IDEWORK\lvmen\src\licensedcode\data\rules\false-positive_1391.yml", "YAML", 0, 0, 0, 2, 0, 0, 1, 3
"d:\IDEWORK\lvmen\src\licensedcode\data\rules\false-positive_1392.yml", "YAML", 0, 0, 0, 2, 0, 0, 1, 3
"d:\IDEWORK\lvmen\src\licensedcode\data\rules\false-positive_1393.yml", "YAML", 0, 0, 0, 2, 0, 0, 1, 3
"d:\IDEWORK\lvmen\src\licensedcode\data\rules\false-positive_1394.yml", "YAML", 0, 0, 0, 2, 0, 0, 1, 3
"d:\IDEWORK\lvmen\src\licensedcode\data\rules\false-positive_1395.yml", "YAML", 0, 0, 0, 2, 0, 0, 1, 3
"d:\IDEWORK\lvmen\src\licensedcode\data\rules\false-positive_1396.yml", "YAML", 0, 0, 0, 2, 0, 0, 1, 3
"d:\IDEWORK\lvmen\src\licensedcode\data\rules\false-positive_1397.yml", "YAML", 0, 0, 0, 2, 0, 0, 1, 3
"d:\IDEWORK\lvmen\src\licensedcode\data\rules\false-positive_1398.yml", "YAML", 0, 0, 0, 2, 0, 0, 1, 3
"d:\IDEWORK\lvmen\src\licensedcode\data\rules\false-positive_1399.yml", "YAML", 0, 0, 0, 2, 0, 0, 1, 3
"d:\IDEWORK\lvmen\src\licensedcode\data\rules\false-positive_14.yml", "YAML", 0, 0, 0, 2, 0, 0, 1, 3
"d:\IDEWORK\lvmen\src\licensedcode\data\rules\false-positive_140.yml", "YAML", 0, 0, 0, 2, 0, 0, 1, 3
"d:\IDEWORK\lvmen\src\licensedcode\data\rules\false-positive_1400.yml", "YAML", 0, 0, 0, 2, 0, 0, 1, 3
"d:\IDEWORK\lvmen\src\licensedcode\data\rules\false-positive_1401.yml", "YAML", 0, 0, 0, 2, 0, 0, 1, 3
"d:\IDEWORK\lvmen\src\licensedcode\data\rules\false-positive_1402.yml", "YAML", 0, 0, 0, 2, 0, 0, 1, 3
"d:\IDEWORK\lvmen\src\licensedcode\data\rules\false-positive_1403.yml", "YAML", 0, 0, 0, 2, 0, 0, 1, 3
"d:\IDEWORK\lvmen\src\licensedcode\data\rules\false-positive_1404.yml", "YAML", 0, 0, 0, 2, 0, 0, 1, 3
"d:\IDEWORK\lvmen\src\licensedcode\data\rules\false-positive_1405.yml", "YAML", 0, 0, 0, 2, 0, 0, 1, 3
"d:\IDEWORK\lvmen\src\licensedcode\data\rules\false-positive_1406.yml", "YAML", 0, 0, 0, 2, 0, 0, 1, 3
"d:\IDEWORK\lvmen\src\licensedcode\data\rules\false-positive_1407.yml", "YAML", 0, 0, 0, 2, 0, 0, 1, 3
"d:\IDEWORK\lvmen\src\licensedcode\data\rules\false-positive_1408.yml", "YAML", 0, 0, 0, 2, 0, 0, 1, 3
"d:\IDEWORK\lvmen\src\licensedcode\data\rules\false-positive_1409.yml", "YAML", 0, 0, 0, 2, 0, 0, 1, 3
"d:\IDEWORK\lvmen\src\licensedcode\data\rules\false-positive_141.yml", "YAML", 0, 0, 0, 3, 0, 0, 1, 4
"d:\IDEWORK\lvmen\src\licensedcode\data\rules\false-positive_1410.yml", "YAML", 0, 0, 0, 2, 0, 0, 1, 3
"d:\IDEWORK\lvmen\src\licensedcode\data\rules\false-positive_1411.yml", "YAML", 0, 0, 0, 2, 0, 0, 1, 3
"d:\IDEWORK\lvmen\src\licensedcode\data\rules\false-positive_1412.yml", "YAML", 0, 0, 0, 2, 0, 0, 1, 3
"d:\IDEWORK\lvmen\src\licensedcode\data\rules\false-positive_1413.yml", "YAML", 0, 0, 0, 2, 0, 0, 1, 3
"d:\IDEWORK\lvmen\src\licensedcode\data\rules\false-positive_1414.yml", "YAML", 0, 0, 0, 2, 0, 0, 1, 3
"d:\IDEWORK\lvmen\src\licensedcode\data\rules\false-positive_1415.yml", "YAML", 0, 0, 0, 2, 0, 0, 1, 3
"d:\IDEWORK\lvmen\src\licensedcode\data\rules\false-positive_1416.yml", "YAML", 0, 0, 0, 2, 0, 0, 1, 3
"d:\IDEWORK\lvmen\src\licensedcode\data\rules\false-positive_1417.yml", "YAML", 0, 0, 0, 2, 0, 0, 1, 3
"d:\IDEWORK\lvmen\src\licensedcode\data\rules\false-positive_1418.yml", "YAML", 0, 0, 0, 2, 0, 0, 1, 3
"d:\IDEWORK\lvmen\src\licensedcode\data\rules\false-positive_1419.yml", "YAML", 0, 0, 0, 2, 0, 0, 1, 3
"d:\IDEWORK\lvmen\src\licensedcode\data\rules\false-positive_142.yml", "YAML", 0, 0, 0, 2, 0, 0, 1, 3
"d:\IDEWORK\lvmen\src\licensedcode\data\rules\false-positive_1420.yml", "YAML", 0, 0, 0, 2, 0, 0, 1, 3
"d:\IDEWORK\lvmen\src\licensedcode\data\rules\false-positive_1421.yml", "YAML", 0, 0, 0, 2, 0, 0, 1, 3
"d:\IDEWORK\lvmen\src\licensedcode\data\rules\false-positive_1422.yml", "YAML", 0, 0, 0, 2, 0, 0, 1, 3
"d:\IDEWORK\lvmen\src\licensedcode\data\rules\false-positive_1423.yml", "YAML", 0, 0, 0, 2, 0, 0, 1, 3
"d:\IDEWORK\lvmen\src\licensedcode\data\rules\false-positive_1424.yml", "YAML", 0, 0, 0, 2, 0, 0, 1, 3
"d:\IDEWORK\lvmen\src\licensedcode\data\rules\false-positive_1425.yml", "YAML", 0, 0, 0, 2, 0, 0, 1, 3
"d:\IDEWORK\lvmen\src\licensedcode\data\rules\false-positive_1426.yml", "YAML", 0, 0, 0, 2, 0, 0, 1, 3
"d:\IDEWORK\lvmen\src\licensedcode\data\rules\false-positive_1427.yml", "YAML", 0, 0, 0, 2, 0, 0, 1, 3
"d:\IDEWORK\lvmen\src\licensedcode\data\rules\false-positive_1428.yml", "YAML", 0, 0, 0, 2, 0, 0, 1, 3
"d:\IDEWORK\lvmen\src\licensedcode\data\rules\false-positive_1429.yml", "YAML", 0, 0, 0, 2, 0, 0, 1, 3
"d:\IDEWORK\lvmen\src\licensedcode\data\rules\false-positive_143.yml", "YAML", 0, 0, 0, 2, 0, 0, 1, 3
"d:\IDEWORK\lvmen\src\licensedcode\data\rules\false-positive_1430.yml", "YAML", 0, 0, 0, 2, 0, 0, 1, 3
"d:\IDEWORK\lvmen\src\licensedcode\data\rules\false-positive_1431.yml", "YAML", 0, 0, 0, 2, 0, 0, 1, 3
"d:\IDEWORK\lvmen\src\licensedcode\data\rules\false-positive_1432.yml", "YAML", 0, 0, 0, 2, 0, 0, 1, 3
"d:\IDEWORK\lvmen\src\licensedcode\data\rules\false-positive_1433.yml", "YAML", 0, 0, 0, 2, 0, 0, 1, 3
"d:\IDEWORK\lvmen\src\licensedcode\data\rules\false-positive_1434.yml", "YAML", 0, 0, 0, 2, 0, 0, 1, 3
"d:\IDEWORK\lvmen\src\licensedcode\data\rules\false-positive_1435.yml", "YAML", 0, 0, 0, 2, 0, 0, 1, 3
"d:\IDEWORK\lvmen\src\licensedcode\data\rules\false-positive_1436.yml", "YAML", 0, 0, 0, 2, 0, 0, 1, 3
"d:\IDEWORK\lvmen\src\licensedcode\data\rules\false-positive_1437.yml", "YAML", 0, 0, 0, 2, 0, 0, 1, 3
"d:\IDEWORK\lvmen\src\licensedcode\data\rules\false-positive_1438.yml", "YAML", 0, 0, 0, 2, 0, 0, 1, 3
"d:\IDEWORK\lvmen\src\licensedcode\data\rules\false-positive_1439.yml", "YAML", 0, 0, 0, 2, 0, 0, 1, 3
"d:\IDEWORK\lvmen\src\licensedcode\data\rules\false-positive_144.yml", "YAML", 0, 0, 0, 2, 0, 0, 1, 3
"d:\IDEWORK\lvmen\src\licensedcode\data\rules\false-positive_1440.yml", "YAML", 0, 0, 0, 2, 0, 0, 1, 3
"d:\IDEWORK\lvmen\src\licensedcode\data\rules\false-positive_1441.yml", "YAML", 0, 0, 0, 2, 0, 0, 1, 3
"d:\IDEWORK\lvmen\src\licensedcode\data\rules\false-positive_1442.yml", "YAML", 0, 0, 0, 2, 0, 0, 1, 3
"d:\IDEWORK\lvmen\src\licensedcode\data\rules\false-positive_1443.yml", "YAML", 0, 0, 0, 2, 0, 0, 1, 3
"d:\IDEWORK\lvmen\src\licensedcode\data\rules\false-positive_1444.yml", "YAML", 0, 0, 0, 2, 0, 0, 1, 3
"d:\IDEWORK\lvmen\src\licensedcode\data\rules\false-positive_1445.yml", "YAML", 0, 0, 0, 2, 0, 0, 1, 3
"d:\IDEWORK\lvmen\src\licensedcode\data\rules\false-positive_1446.yml", "YAML", 0, 0, 0, 2, 0, 0, 1, 3
"d:\IDEWORK\lvmen\src\licensedcode\data\rules\false-positive_1447.yml", "YAML", 0, 0, 0, 2, 0, 0, 1, 3
"d:\IDEWORK\lvmen\src\licensedcode\data\rules\false-positive_1448.yml", "YAML", 0, 0, 0, 2, 0, 0, 1, 3
"d:\IDEWORK\lvmen\src\licensedcode\data\rules\false-positive_1449.yml", "YAML", 0, 0, 0, 2, 0, 0, 1, 3
"d:\IDEWORK\lvmen\src\licensedcode\data\rules\false-positive_145.yml", "YAML", 0, 0, 0, 2, 0, 0, 1, 3
"d:\IDEWORK\lvmen\src\licensedcode\data\rules\false-positive_1450.yml", "YAML", 0, 0, 0, 2, 0, 0, 1, 3
"d:\IDEWORK\lvmen\src\licensedcode\data\rules\false-positive_1451.yml", "YAML", 0, 0, 0, 2, 0, 0, 1, 3
"d:\IDEWORK\lvmen\src\licensedcode\data\rules\false-positive_1452.yml", "YAML", 0, 0, 0, 2, 0, 0, 1, 3
"d:\IDEWORK\lvmen\src\licensedcode\data\rules\false-positive_1453.yml", "YAML", 0, 0, 0, 2, 0, 0, 1, 3
"d:\IDEWORK\lvmen\src\licensedcode\data\rules\false-positive_1454.yml", "YAML", 0, 0, 0, 2, 0, 0, 1, 3
"d:\IDEWORK\lvmen\src\licensedcode\data\rules\false-positive_1455.yml", "YAML", 0, 0, 0, 2, 0, 0, 1, 3
"d:\IDEWORK\lvmen\src\licensedcode\data\rules\false-positive_1456.yml", "YAML", 0, 0, 0, 2, 0, 0, 1, 3
"d:\IDEWORK\lvmen\src\licensedcode\data\rules\false-positive_1457.yml", "YAML", 0, 0, 0, 2, 0, 0, 1, 3
"d:\IDEWORK\lvmen\src\licensedcode\data\rules\false-positive_1458.yml", "YAML", 0, 0, 0, 2, 0, 0, 1, 3
"d:\IDEWORK\lvmen\src\licensedcode\data\rules\false-positive_1459.yml", "YAML", 0, 0, 0, 2, 0, 0, 1, 3
"d:\IDEWORK\lvmen\src\licensedcode\data\rules\false-positive_146.yml", "YAML", 0, 0, 0, 2, 0, 0, 1, 3
"d:\IDEWORK\lvmen\src\licensedcode\data\rules\false-positive_1460.yml", "YAML", 0, 0, 0, 2, 0, 0, 1, 3
"d:\IDEWORK\lvmen\src\licensedcode\data\rules\false-positive_1461.yml", "YAML", 0, 0, 0, 2, 0, 0, 1, 3
"d:\IDEWORK\lvmen\src\licensedcode\data\rules\false-positive_1462.yml", "YAML", 0, 0, 0, 2, 0, 0, 1, 3
"d:\IDEWORK\lvmen\src\licensedcode\data\rules\false-positive_1463.yml", "YAML", 0, 0, 0, 2, 0, 0, 1, 3
"d:\IDEWORK\lvmen\src\licensedcode\data\rules\false-positive_1464.yml", "YAML", 0, 0, 0, 2, 0, 0, 1, 3
"d:\IDEWORK\lvmen\src\licensedcode\data\rules\false-positive_1465.yml", "YAML", 0, 0, 0, 2, 0, 0, 1, 3
"d:\IDEWORK\lvmen\src\licensedcode\data\rules\false-positive_1466.yml", "YAML", 0, 0, 0, 2, 0, 0, 1, 3
"d:\IDEWORK\lvmen\src\licensedcode\data\rules\false-positive_1467.yml", "YAML", 0, 0, 0, 2, 0, 0, 1, 3
"d:\IDEWORK\lvmen\src\licensedcode\data\rules\false-positive_1468.yml", "YAML", 0, 0, 0, 2, 0, 0, 1, 3
"d:\IDEWORK\lvmen\src\licensedcode\data\rules\false-positive_1469.yml", "YAML", 0, 0, 0, 2, 0, 0, 1, 3
"d:\IDEWORK\lvmen\src\licensedcode\data\rules\false-positive_147.yml", "YAML", 0, 0, 0, 2, 0, 0, 1, 3
"d:\IDEWORK\lvmen\src\licensedcode\data\rules\false-positive_1470.yml", "YAML", 0, 0, 0, 2, 0, 0, 1, 3
"d:\IDEWORK\lvmen\src\licensedcode\data\rules\false-positive_1471.yml", "YAML", 0, 0, 0, 2, 0, 0, 1, 3
"d:\IDEWORK\lvmen\src\licensedcode\data\rules\false-positive_1472.yml", "YAML", 0, 0, 0, 2, 0, 0, 1, 3
"d:\IDEWORK\lvmen\src\licensedcode\data\rules\false-positive_1473.yml", "YAML", 0, 0, 0, 2, 0, 0, 1, 3
"d:\IDEWORK\lvmen\src\licensedcode\data\rules\false-positive_1474.yml", "YAML", 0, 0, 0, 2, 0, 0, 1, 3
"d:\IDEWORK\lvmen\src\licensedcode\data\rules\false-positive_1475.yml", "YAML", 0, 0, 0, 2, 0, 0, 1, 3
"d:\IDEWORK\lvmen\src\licensedcode\data\rules\false-positive_1476.yml", "YAML", 0, 0, 0, 2, 0, 0, 1, 3
"d:\IDEWORK\lvmen\src\licensedcode\data\rules\false-positive_1477.yml", "YAML", 0, 0, 0, 2, 0, 0, 1, 3
"d:\IDEWORK\lvmen\src\licensedcode\data\rules\false-positive_1478.yml", "YAML", 0, 0, 0, 2, 0, 0, 1, 3
"d:\IDEWORK\lvmen\src\licensedcode\data\rules\false-positive_1479.yml", "YAML", 0, 0, 0, 2, 0, 0, 1, 3
"d:\IDEWORK\lvmen\src\licensedcode\data\rules\false-positive_148.yml", "YAML", 0, 0, 0, 2, 0, 0, 1, 3
"d:\IDEWORK\lvmen\src\licensedcode\data\rules\false-positive_1480.yml", "YAML", 0, 0, 0, 2, 0, 0, 1, 3
"d:\IDEWORK\lvmen\src\licensedcode\data\rules\false-positive_1481.yml", "YAML", 0, 0, 0, 2, 0, 0, 1, 3
"d:\IDEWORK\lvmen\src\licensedcode\data\rules\false-positive_1482.yml", "YAML", 0, 0, 0, 2, 0, 0, 1, 3
"d:\IDEWORK\lvmen\src\licensedcode\data\rules\false-positive_1483.yml", "YAML", 0, 0, 0, 2, 0, 0, 1, 3
"d:\IDEWORK\lvmen\src\licensedcode\data\rules\false-positive_1484.yml", "YAML", 0, 0, 0, 2, 0, 0, 1, 3
"d:\IDEWORK\lvmen\src\licensedcode\data\rules\false-positive_1485.yml", "YAML", 0, 0, 0, 2, 0, 0, 1, 3
"d:\IDEWORK\lvmen\src\licensedcode\data\rules\false-positive_1486.yml", "YAML", 0, 0, 0, 2, 0, 0, 1, 3
"d:\IDEWORK\lvmen\src\licensedcode\data\rules\false-positive_1487.yml", "YAML", 0, 0, 0, 2, 0, 0, 1, 3
"d:\IDEWORK\lvmen\src\licensedcode\data\rules\false-positive_1488.yml", "YAML", 0, 0, 0, 2, 0, 0, 1, 3
"d:\IDEWORK\lvmen\src\licensedcode\data\rules\false-positive_1489.yml", "YAML", 0, 0, 0, 2, 0, 0, 1, 3
"d:\IDEWORK\lvmen\src\licensedcode\data\rules\false-positive_149.yml", "YAML", 0, 0, 0, 2, 0, 0, 1, 3
"d:\IDEWORK\lvmen\src\licensedcode\data\rules\false-positive_1490.yml", "YAML", 0, 0, 0, 2, 0, 0, 1, 3
"d:\IDEWORK\lvmen\src\licensedcode\data\rules\false-positive_1491.yml", "YAML", 0, 0, 0, 2, 0, 0, 1, 3
"d:\IDEWORK\lvmen\src\licensedcode\data\rules\false-positive_1492.yml", "YAML", 0, 0, 0, 2, 0, 0, 1, 3
"d:\IDEWORK\lvmen\src\licensedcode\data\rules\false-positive_1493.yml", "YAML", 0, 0, 0, 2, 0, 0, 1, 3
"d:\IDEWORK\lvmen\src\licensedcode\data\rules\false-positive_1494.yml", "YAML", 0, 0, 0, 2, 0, 0, 1, 3
"d:\IDEWORK\lvmen\src\licensedcode\data\rules\false-positive_1495.yml", "YAML", 0, 0, 0, 2, 0, 0, 1, 3
"d:\IDEWORK\lvmen\src\licensedcode\data\rules\false-positive_1496.yml", "YAML", 0, 0, 0, 2, 0, 0, 1, 3
"d:\IDEWORK\lvmen\src\licensedcode\data\rules\false-positive_1497.yml", "YAML", 0, 0, 0, 2, 0, 0, 1, 3
"d:\IDEWORK\lvmen\src\licensedcode\data\rules\false-positive_1498.yml", "YAML", 0, 0, 0, 2, 0, 0, 1, 3
"d:\IDEWORK\lvmen\src\licensedcode\data\rules\false-positive_1499.yml", "YAML", 0, 0, 0, 2, 0, 0, 1, 3
"d:\IDEWORK\lvmen\src\licensedcode\data\rules\false-positive_15.yml", "YAML", 0, 0, 0, 2, 0, 0, 1, 3
"d:\IDEWORK\lvmen\src\licensedcode\data\rules\false-positive_150.yml", "YAML", 0, 0, 0, 2, 0, 0, 1, 3
"d:\IDEWORK\lvmen\src\licensedcode\data\rules\false-positive_1500.yml", "YAML", 0, 0, 0, 2, 0, 0, 1, 3
"d:\IDEWORK\lvmen\src\licensedcode\data\rules\false-positive_1501.yml", "YAML", 0, 0, 0, 2, 0, 0, 1, 3
"d:\IDEWORK\lvmen\src\licensedcode\data\rules\false-positive_1502.yml", "YAML", 0, 0, 0, 2, 0, 0, 1, 3
"d:\IDEWORK\lvmen\src\licensedcode\data\rules\false-positive_1503.yml", "YAML", 0, 0, 0, 2, 0, 0, 1, 3
"d:\IDEWORK\lvmen\src\licensedcode\data\rules\false-positive_1504.yml", "YAML", 0, 0, 0, 2, 0, 0, 1, 3
"d:\IDEWORK\lvmen\src\licensedcode\data\rules\false-positive_1505.yml", "YAML", 0, 0, 0, 2, 0, 0, 1, 3
"d:\IDEWORK\lvmen\src\licensedcode\data\rules\false-positive_1506.yml", "YAML", 0, 0, 0, 2, 0, 0, 1, 3
"d:\IDEWORK\lvmen\src\licensedcode\data\rules\false-positive_1507.yml", "YAML", 0, 0, 0, 2, 0, 0, 1, 3
"d:\IDEWORK\lvmen\src\licensedcode\data\rules\false-positive_1508.yml", "YAML", 0, 0, 0, 2, 0, 0, 1, 3
"d:\IDEWORK\lvmen\src\licensedcode\data\rules\false-positive_1509.yml", "YAML", 0, 0, 0, 2, 0, 0, 1, 3
"d:\IDEWORK\lvmen\src\licensedcode\data\rules\false-positive_151.yml", "YAML", 0, 0, 0, 2, 0, 0, 1, 3
"d:\IDEWORK\lvmen\src\licensedcode\data\rules\false-positive_1510.yml", "YAML", 0, 0, 0, 2, 0, 0, 1, 3
"d:\IDEWORK\lvmen\src\licensedcode\data\rules\false-positive_1511.yml", "YAML", 0, 0, 0, 2, 0, 0, 1, 3
"d:\IDEWORK\lvmen\src\licensedcode\data\rules\false-positive_1512.yml", "YAML", 0, 0, 0, 2, 0, 0, 1, 3
"d:\IDEWORK\lvmen\src\licensedcode\data\rules\false-positive_1513.yml", "YAML", 0, 0, 0, 2, 0, 0, 1, 3
"d:\IDEWORK\lvmen\src\licensedcode\data\rules\false-positive_1514.yml", "YAML", 0, 0, 0, 2, 0, 0, 1, 3
"d:\IDEWORK\lvmen\src\licensedcode\data\rules\false-positive_1515.yml", "YAML", 0, 0, 0, 2, 0, 0, 1, 3
"d:\IDEWORK\lvmen\src\licensedcode\data\rules\false-positive_1516.yml", "YAML", 0, 0, 0, 2, 0, 0, 1, 3
"d:\IDEWORK\lvmen\src\licensedcode\data\rules\false-positive_1517.yml", "YAML", 0, 0, 0, 2, 0, 0, 1, 3
"d:\IDEWORK\lvmen\src\licensedcode\data\rules\false-positive_1518.yml", "YAML", 0, 0, 0, 2, 0, 0, 1, 3
"d:\IDEWORK\lvmen\src\licensedcode\data\rules\false-positive_1519.yml", "YAML", 0, 0, 0, 2, 0, 0, 1, 3
"d:\IDEWORK\lvmen\src\licensedcode\data\rules\false-positive_152.yml", "YAML", 0, 0, 0, 2, 0, 0, 1, 3
"d:\IDEWORK\lvmen\src\licensedcode\data\rules\false-positive_1520.yml", "YAML", 0, 0, 0, 2, 0, 0, 1, 3
"d:\IDEWORK\lvmen\src\licensedcode\data\rules\false-positive_1521.yml", "YAML", 0, 0, 0, 2, 0, 0, 1, 3
"d:\IDEWORK\lvmen\src\licensedcode\data\rules\false-positive_1522.yml", "YAML", 0, 0, 0, 2, 0, 0, 1, 3
"d:\IDEWORK\lvmen\src\licensedcode\data\rules\false-positive_1523.yml", "YAML", 0, 0, 0, 2, 0, 0, 1, 3
"d:\IDEWORK\lvmen\src\licensedcode\data\rules\false-positive_1524.yml", "YAML", 0, 0, 0, 2, 0, 0, 1, 3
"d:\IDEWORK\lvmen\src\licensedcode\data\rules\false-positive_1525.yml", "YAML", 0, 0, 0, 2, 0, 0, 1, 3
"d:\IDEWORK\lvmen\src\licensedcode\data\rules\false-positive_1526.yml", "YAML", 0, 0, 0, 2, 0, 0, 1, 3
"d:\IDEWORK\lvmen\src\licensedcode\data\rules\false-positive_1527.yml", "YAML", 0, 0, 0, 2, 0, 0, 1, 3
"d:\IDEWORK\lvmen\src\licensedcode\data\rules\false-positive_1528.yml", "YAML", 0, 0, 0, 2, 0, 0, 1, 3
"d:\IDEWORK\lvmen\src\licensedcode\data\rules\false-positive_1529.yml", "YAML", 0, 0, 0, 2, 0, 0, 1, 3
"d:\IDEWORK\lvmen\src\licensedcode\data\rules\false-positive_153.yml", "YAML", 0, 0, 0, 3, 0, 0, 1, 4
"d:\IDEWORK\lvmen\src\licensedcode\data\rules\false-positive_1530.yml", "YAML", 0, 0, 0, 2, 0, 0, 1, 3
"d:\IDEWORK\lvmen\src\licensedcode\data\rules\false-positive_1531.yml", "YAML", 0, 0, 0, 2, 0, 0, 1, 3
"d:\IDEWORK\lvmen\src\licensedcode\data\rules\false-positive_1532.yml", "YAML", 0, 0, 0, 2, 0, 0, 1, 3
"d:\IDEWORK\lvmen\src\licensedcode\data\rules\false-positive_1533.yml", "YAML", 0, 0, 0, 2, 0, 0, 1, 3
"d:\IDEWORK\lvmen\src\licensedcode\data\rules\false-positive_1534.yml", "YAML", 0, 0, 0, 2, 0, 0, 1, 3
"d:\IDEWORK\lvmen\src\licensedcode\data\rules\false-positive_1535.yml", "YAML", 0, 0, 0, 2, 0, 0, 1, 3
"d:\IDEWORK\lvmen\src\licensedcode\data\rules\false-positive_1536.yml", "YAML", 0, 0, 0, 2, 0, 0, 1, 3
"d:\IDEWORK\lvmen\src\licensedcode\data\rules\false-positive_1537.yml", "YAML", 0, 0, 0, 2, 0, 0, 1, 3
"d:\IDEWORK\lvmen\src\licensedcode\data\rules\false-positive_1538.yml", "YAML", 0, 0, 0, 2, 0, 0, 1, 3
"d:\IDEWORK\lvmen\src\licensedcode\data\rules\false-positive_1539.yml", "YAML", 0, 0, 0, 2, 0, 0, 1, 3
"d:\IDEWORK\lvmen\src\licensedcode\data\rules\false-positive_154.yml", "YAML", 0, 0, 0, 2, 0, 0, 1, 3
"d:\IDEWORK\lvmen\src\licensedcode\data\rules\false-positive_1540.yml", "YAML", 0, 0, 0, 2, 0, 0, 1, 3
"d:\IDEWORK\lvmen\src\licensedcode\data\rules\false-positive_1541.yml", "YAML", 0, 0, 0, 2, 0, 0, 1, 3
"d:\IDEWORK\lvmen\src\licensedcode\data\rules\false-positive_1542.yml", "YAML", 0, 0, 0, 2, 0, 0, 1, 3
"d:\IDEWORK\lvmen\src\licensedcode\data\rules\false-positive_1543.yml", "YAML", 0, 0, 0, 2, 0, 0, 1, 3
"d:\IDEWORK\lvmen\src\licensedcode\data\rules\false-positive_1544.yml", "YAML", 0, 0, 0, 2, 0, 0, 1, 3
"d:\IDEWORK\lvmen\src\licensedcode\data\rules\false-positive_1545.yml", "YAML", 0, 0, 0, 2, 0, 0, 1, 3
"d:\IDEWORK\lvmen\src\licensedcode\data\rules\false-positive_1546.yml", "YAML", 0, 0, 0, 2, 0, 0, 1, 3
"d:\IDEWORK\lvmen\src\licensedcode\data\rules\false-positive_1547.yml", "YAML", 0, 0, 0, 2, 0, 0, 1, 3
"d:\IDEWORK\lvmen\src\licensedcode\data\rules\false-positive_1548.yml", "YAML", 0, 0, 0, 2, 0, 0, 1, 3
"d:\IDEWORK\lvmen\src\licensedcode\data\rules\false-positive_1549.yml", "YAML", 0, 0, 0, 2, 0, 0, 1, 3
"d:\IDEWORK\lvmen\src\licensedcode\data\rules\false-positive_155.yml", "YAML", 0, 0, 0, 2, 0, 0, 1, 3
"d:\IDEWORK\lvmen\src\licensedcode\data\rules\false-positive_1550.yml", "YAML", 0, 0, 0, 2, 0, 0, 1, 3
"d:\IDEWORK\lvmen\src\licensedcode\data\rules\false-positive_1551.yml", "YAML", 0, 0, 0, 2, 0, 0, 1, 3
"d:\IDEWORK\lvmen\src\licensedcode\data\rules\false-positive_1552.yml", "YAML", 0, 0, 0, 2, 0, 0, 1, 3
"d:\IDEWORK\lvmen\src\licensedcode\data\rules\false-positive_1553.yml", "YAML", 0, 0, 0, 2, 0, 0, 1, 3
"d:\IDEWORK\lvmen\src\licensedcode\data\rules\false-positive_1554.yml", "YAML", 0, 0, 0, 2, 0, 0, 1, 3
"d:\IDEWORK\lvmen\src\licensedcode\data\rules\false-positive_1555.yml", "YAML", 0, 0, 0, 2, 0, 0, 1, 3
"d:\IDEWORK\lvmen\src\licensedcode\data\rules\false-positive_1556.yml", "YAML", 0, 0, 0, 2, 0, 0, 1, 3
"d:\IDEWORK\lvmen\src\licensedcode\data\rules\false-positive_1557.yml", "YAML", 0, 0, 0, 2, 0, 0, 1, 3
"d:\IDEWORK\lvmen\src\licensedcode\data\rules\false-positive_1558.yml", "YAML", 0, 0, 0, 2, 0, 0, 1, 3
"d:\IDEWORK\lvmen\src\licensedcode\data\rules\false-positive_1559.yml", "YAML", 0, 0, 0, 2, 0, 0, 1, 3
"d:\IDEWORK\lvmen\src\licensedcode\data\rules\false-positive_156.yml", "YAML", 0, 0, 0, 3, 0, 0, 1, 4
"d:\IDEWORK\lvmen\src\licensedcode\data\rules\false-positive_1560.yml", "YAML", 0, 0, 0, 2, 0, 0, 1, 3
"d:\IDEWORK\lvmen\src\licensedcode\data\rules\false-positive_1561.yml", "YAML", 0, 0, 0, 2, 0, 0, 1, 3
"d:\IDEWORK\lvmen\src\licensedcode\data\rules\false-positive_1562.yml", "YAML", 0, 0, 0, 2, 0, 0, 1, 3
"d:\IDEWORK\lvmen\src\licensedcode\data\rules\false-positive_1563.yml", "YAML", 0, 0, 0, 2, 0, 0, 1, 3
"d:\IDEWORK\lvmen\src\licensedcode\data\rules\false-positive_1564.yml", "YAML", 0, 0, 0, 2, 0, 0, 1, 3
"d:\IDEWORK\lvmen\src\licensedcode\data\rules\false-positive_1565.yml", "YAML", 0, 0, 0, 2, 0, 0, 1, 3
"d:\IDEWORK\lvmen\src\licensedcode\data\rules\false-positive_1566.yml", "YAML", 0, 0, 0, 2, 0, 0, 1, 3
"d:\IDEWORK\lvmen\src\licensedcode\data\rules\false-positive_1567.yml", "YAML", 0, 0, 0, 2, 0, 0, 1, 3
"d:\IDEWORK\lvmen\src\licensedcode\data\rules\false-positive_1568.yml", "YAML", 0, 0, 0, 2, 0, 0, 1, 3
"d:\IDEWORK\lvmen\src\licensedcode\data\rules\false-positive_1569.yml", "YAML", 0, 0, 0, 2, 0, 0, 1, 3
"d:\IDEWORK\lvmen\src\licensedcode\data\rules\false-positive_157.yml", "YAML", 0, 0, 0, 2, 0, 0, 1, 3
"d:\IDEWORK\lvmen\src\licensedcode\data\rules\false-positive_1570.yml", "YAML", 0, 0, 0, 2, 0, 0, 1, 3
"d:\IDEWORK\lvmen\src\licensedcode\data\rules\false-positive_1571.yml", "YAML", 0, 0, 0, 2, 0, 0, 1, 3
"d:\IDEWORK\lvmen\src\licensedcode\data\rules\false-positive_1572.yml", "YAML", 0, 0, 0, 2, 0, 0, 1, 3
"d:\IDEWORK\lvmen\src\licensedcode\data\rules\false-positive_1573.yml", "YAML", 0, 0, 0, 2, 0, 0, 1, 3
"d:\IDEWORK\lvmen\src\licensedcode\data\rules\false-positive_1574.yml", "YAML", 0, 0, 0, 2, 0, 0, 1, 3
"d:\IDEWORK\lvmen\src\licensedcode\data\rules\false-positive_1575.yml", "YAML", 0, 0, 0, 2, 0, 0, 1, 3
"d:\IDEWORK\lvmen\src\licensedcode\data\rules\false-positive_1576.yml", "YAML", 0, 0, 0, 2, 0, 0, 1, 3
"d:\IDEWORK\lvmen\src\licensedcode\data\rules\false-positive_1577.yml", "YAML", 0, 0, 0, 2, 0, 0, 1, 3
"d:\IDEWORK\lvmen\src\licensedcode\data\rules\false-positive_1578.yml", "YAML", 0, 0, 0, 2, 0, 0, 1, 3
"d:\IDEWORK\lvmen\src\licensedcode\data\rules\false-positive_1579.yml", "YAML", 0, 0, 0, 2, 0, 0, 1, 3
"d:\IDEWORK\lvmen\src\licensedcode\data\rules\false-positive_158.yml", "YAML", 0, 0, 0, 3, 0, 0, 1, 4
"d:\IDEWORK\lvmen\src\licensedcode\data\rules\false-positive_1580.yml", "YAML", 0, 0, 0, 2, 0, 0, 1, 3
"d:\IDEWORK\lvmen\src\licensedcode\data\rules\false-positive_1581.yml", "YAML", 0, 0, 0, 2, 0, 0, 1, 3
"d:\IDEWORK\lvmen\src\licensedcode\data\rules\false-positive_1582.yml", "YAML", 0, 0, 0, 2, 0, 0, 1, 3
"d:\IDEWORK\lvmen\src\licensedcode\data\rules\false-positive_1583.yml", "YAML", 0, 0, 0, 2, 0, 0, 1, 3
"d:\IDEWORK\lvmen\src\licensedcode\data\rules\false-positive_1584.yml", "YAML", 0, 0, 0, 2, 0, 0, 1, 3
"d:\IDEWORK\lvmen\src\licensedcode\data\rules\false-positive_1585.yml", "YAML", 0, 0, 0, 2, 0, 0, 1, 3
"d:\IDEWORK\lvmen\src\licensedcode\data\rules\false-positive_1586.yml", "YAML", 0, 0, 0, 2, 0, 0, 1, 3
"d:\IDEWORK\lvmen\src\licensedcode\data\rules\false-positive_1587.yml", "YAML", 0, 0, 0, 2, 0, 0, 1, 3
"d:\IDEWORK\lvmen\src\licensedcode\data\rules\false-positive_1588.yml", "YAML", 0, 0, 0, 2, 0, 0, 1, 3
"d:\IDEWORK\lvmen\src\licensedcode\data\rules\false-positive_1589.yml", "YAML", 0, 0, 0, 2, 0, 0, 1, 3
"d:\IDEWORK\lvmen\src\licensedcode\data\rules\false-positive_159.yml", "YAML", 0, 0, 0, 2, 0, 0, 1, 3
"d:\IDEWORK\lvmen\src\licensedcode\data\rules\false-positive_1590.yml", "YAML", 0, 0, 0, 2, 0, 0, 1, 3
"d:\IDEWORK\lvmen\src\licensedcode\data\rules\false-positive_1591.yml", "YAML", 0, 0, 0, 2, 0, 0, 1, 3
"d:\IDEWORK\lvmen\src\licensedcode\data\rules\false-positive_1592.yml", "YAML", 0, 0, 0, 2, 0, 0, 1, 3
"d:\IDEWORK\lvmen\src\licensedcode\data\rules\false-positive_1593.yml", "YAML", 0, 0, 0, 2, 0, 0, 1, 3
"d:\IDEWORK\lvmen\src\licensedcode\data\rules\false-positive_1594.yml", "YAML", 0, 0, 0, 2, 0, 0, 1, 3
"d:\IDEWORK\lvmen\src\licensedcode\data\rules\false-positive_1595.yml", "YAML", 0, 0, 0, 2, 0, 0, 1, 3
"d:\IDEWORK\lvmen\src\licensedcode\data\rules\false-positive_1596.yml", "YAML", 0, 0, 0, 2, 0, 0, 1, 3
"d:\IDEWORK\lvmen\src\licensedcode\data\rules\false-positive_1597.yml", "YAML", 0, 0, 0, 2, 0, 0, 1, 3
"d:\IDEWORK\lvmen\src\licensedcode\data\rules\false-positive_1598.yml", "YAML", 0, 0, 0, 2, 0, 0, 1, 3
"d:\IDEWORK\lvmen\src\licensedcode\data\rules\false-positive_1599.yml", "YAML", 0, 0, 0, 2, 0, 0, 1, 3
"d:\IDEWORK\lvmen\src\licensedcode\data\rules\false-positive_16.yml", "YAML", 0, 0, 0, 2, 0, 0, 1, 3
"d:\IDEWORK\lvmen\src\licensedcode\data\rules\false-positive_160.yml", "YAML", 0, 0, 0, 2, 0, 0, 1, 3
"d:\IDEWORK\lvmen\src\licensedcode\data\rules\false-positive_1600.yml", "YAML", 0, 0, 0, 2, 0, 0, 1, 3
"d:\IDEWORK\lvmen\src\licensedcode\data\rules\false-positive_1601.yml", "YAML", 0, 0, 0, 2, 0, 0, 1, 3
"d:\IDEWORK\lvmen\src\licensedcode\data\rules\false-positive_1602.yml", "YAML", 0, 0, 0, 2, 0, 0, 1, 3
"d:\IDEWORK\lvmen\src\licensedcode\data\rules\false-positive_1603.yml", "YAML", 0, 0, 0, 2, 0, 0, 1, 3
"d:\IDEWORK\lvmen\src\licensedcode\data\rules\false-positive_1604.yml", "YAML", 0, 0, 0, 2, 0, 0, 1, 3
"d:\IDEWORK\lvmen\src\licensedcode\data\rules\false-positive_1605.yml", "YAML", 0, 0, 0, 2, 0, 0, 1, 3
"d:\IDEWORK\lvmen\src\licensedcode\data\rules\false-positive_1606.yml", "YAML", 0, 0, 0, 2, 0, 0, 1, 3
"d:\IDEWORK\lvmen\src\licensedcode\data\rules\false-positive_1607.yml", "YAML", 0, 0, 0, 2, 0, 0, 1, 3
"d:\IDEWORK\lvmen\src\licensedcode\data\rules\false-positive_1608.yml", "YAML", 0, 0, 0, 2, 0, 0, 1, 3
"d:\IDEWORK\lvmen\src\licensedcode\data\rules\false-positive_1609.yml", "YAML", 0, 0, 0, 2, 0, 0, 1, 3
"d:\IDEWORK\lvmen\src\licensedcode\data\rules\false-positive_161.yml", "YAML", 0, 0, 0, 2, 0, 0, 1, 3
"d:\IDEWORK\lvmen\src\licensedcode\data\rules\false-positive_1610.yml", "YAML", 0, 0, 0, 2, 0, 0, 1, 3
"d:\IDEWORK\lvmen\src\licensedcode\data\rules\false-positive_1611.yml", "YAML", 0, 0, 0, 2, 0, 0, 1, 3
"d:\IDEWORK\lvmen\src\licensedcode\data\rules\false-positive_1612.yml", "YAML", 0, 0, 0, 2, 0, 0, 1, 3
"d:\IDEWORK\lvmen\src\licensedcode\data\rules\false-positive_1613.yml", "YAML", 0, 0, 0, 2, 0, 0, 1, 3
"d:\IDEWORK\lvmen\src\licensedcode\data\rules\false-positive_1614.yml", "YAML", 0, 0, 0, 2, 0, 0, 1, 3
"d:\IDEWORK\lvmen\src\licensedcode\data\rules\false-positive_1615.yml", "YAML", 0, 0, 0, 2, 0, 0, 1, 3
"d:\IDEWORK\lvmen\src\licensedcode\data\rules\false-positive_1616.yml", "YAML", 0, 0, 0, 2, 0, 0, 1, 3
"d:\IDEWORK\lvmen\src\licensedcode\data\rules\false-positive_1617.yml", "YAML", 0, 0, 0, 2, 0, 0, 1, 3
"d:\IDEWORK\lvmen\src\licensedcode\data\rules\false-positive_1618.yml", "YAML", 0, 0, 0, 2, 0, 0, 1, 3
"d:\IDEWORK\lvmen\src\licensedcode\data\rules\false-positive_1619.yml", "YAML", 0, 0, 0, 2, 0, 0, 1, 3
"d:\IDEWORK\lvmen\src\licensedcode\data\rules\false-positive_162.yml", "YAML", 0, 0, 0, 2, 0, 0, 1, 3
"d:\IDEWORK\lvmen\src\licensedcode\data\rules\false-positive_1620.yml", "YAML", 0, 0, 0, 2, 0, 0, 1, 3
"d:\IDEWORK\lvmen\src\licensedcode\data\rules\false-positive_1621.yml", "YAML", 0, 0, 0, 2, 0, 0, 1, 3
"d:\IDEWORK\lvmen\src\licensedcode\data\rules\false-positive_1622.yml", "YAML", 0, 0, 0, 2, 0, 0, 1, 3
"d:\IDEWORK\lvmen\src\licensedcode\data\rules\false-positive_1623.yml", "YAML", 0, 0, 0, 2, 0, 0, 1, 3
"d:\IDEWORK\lvmen\src\licensedcode\data\rules\false-positive_1624.yml", "YAML", 0, 0, 0, 2, 0, 0, 1, 3
"d:\IDEWORK\lvmen\src\licensedcode\data\rules\false-positive_1625.yml", "YAML", 0, 0, 0, 2, 0, 0, 1, 3
"d:\IDEWORK\lvmen\src\licensedcode\data\rules\false-positive_1626.yml", "YAML", 0, 0, 0, 2, 0, 0, 1, 3
"d:\IDEWORK\lvmen\src\licensedcode\data\rules\false-positive_1627.yml", "YAML", 0, 0, 0, 2, 0, 0, 1, 3
"d:\IDEWORK\lvmen\src\licensedcode\data\rules\false-positive_1628.yml", "YAML", 0, 0, 0, 2, 0, 0, 1, 3
"d:\IDEWORK\lvmen\src\licensedcode\data\rules\false-positive_1629.yml", "YAML", 0, 0, 0, 2, 0, 0, 1, 3
"d:\IDEWORK\lvmen\src\licensedcode\data\rules\false-positive_163.yml", "YAML", 0, 0, 0, 2, 0, 0, 1, 3
"d:\IDEWORK\lvmen\src\licensedcode\data\rules\false-positive_1630.yml", "YAML", 0, 0, 0, 2, 0, 0, 1, 3
"d:\IDEWORK\lvmen\src\licensedcode\data\rules\false-positive_1631.yml", "YAML", 0, 0, 0, 2, 0, 0, 1, 3
"d:\IDEWORK\lvmen\src\licensedcode\data\rules\false-positive_1632.yml", "YAML", 0, 0, 0, 2, 0, 0, 1, 3
"d:\IDEWORK\lvmen\src\licensedcode\data\rules\false-positive_1633.yml", "YAML", 0, 0, 0, 2, 0, 0, 1, 3
"d:\IDEWORK\lvmen\src\licensedcode\data\rules\false-positive_1634.yml", "YAML", 0, 0, 0, 2, 0, 0, 1, 3
"d:\IDEWORK\lvmen\src\licensedcode\data\rules\false-positive_1635.yml", "YAML", 0, 0, 0, 2, 0, 0, 1, 3
"d:\IDEWORK\lvmen\src\licensedcode\data\rules\false-positive_1636.yml", "YAML", 0, 0, 0, 2, 0, 0, 1, 3
"d:\IDEWORK\lvmen\src\licensedcode\data\rules\false-positive_1637.yml", "YAML", 0, 0, 0, 2, 0, 0, 1, 3
"d:\IDEWORK\lvmen\src\licensedcode\data\rules\false-positive_1638.yml", "YAML", 0, 0, 0, 2, 0, 0, 1, 3
"d:\IDEWORK\lvmen\src\licensedcode\data\rules\false-positive_1639.yml", "YAML", 0, 0, 0, 2, 0, 0, 1, 3
"d:\IDEWORK\lvmen\src\licensedcode\data\rules\false-positive_164.yml", "YAML", 0, 0, 0, 2, 0, 0, 1, 3
"d:\IDEWORK\lvmen\src\licensedcode\data\rules\false-positive_1640.yml", "YAML", 0, 0, 0, 2, 0, 0, 1, 3
"d:\IDEWORK\lvmen\src\licensedcode\data\rules\false-positive_1641.yml", "YAML", 0, 0, 0, 2, 0, 0, 1, 3
"d:\IDEWORK\lvmen\src\licensedcode\data\rules\false-positive_1642.yml", "YAML", 0, 0, 0, 2, 0, 0, 1, 3
"d:\IDEWORK\lvmen\src\licensedcode\data\rules\false-positive_1643.yml", "YAML", 0, 0, 0, 2, 0, 0, 1, 3
"d:\IDEWORK\lvmen\src\licensedcode\data\rules\false-positive_1644.yml", "YAML", 0, 0, 0, 2, 0, 0, 1, 3
"d:\IDEWORK\lvmen\src\licensedcode\data\rules\false-positive_1645.yml", "YAML", 0, 0, 0, 2, 0, 0, 1, 3
"d:\IDEWORK\lvmen\src\licensedcode\data\rules\false-positive_1646.yml", "YAML", 0, 0, 0, 2, 0, 0, 1, 3
"d:\IDEWORK\lvmen\src\licensedcode\data\rules\false-positive_1647.yml", "YAML", 0, 0, 0, 2, 0, 0, 1, 3
"d:\IDEWORK\lvmen\src\licensedcode\data\rules\false-positive_1648.yml", "YAML", 0, 0, 0, 2, 0, 0, 1, 3
"d:\IDEWORK\lvmen\src\licensedcode\data\rules\false-positive_1649.yml", "YAML", 0, 0, 0, 2, 0, 0, 1, 3
"d:\IDEWORK\lvmen\src\licensedcode\data\rules\false-positive_165.yml", "YAML", 0, 0, 0, 2, 0, 0, 1, 3
"d:\IDEWORK\lvmen\src\licensedcode\data\rules\false-positive_1650.yml", "YAML", 0, 0, 0, 2, 0, 0, 1, 3
"d:\IDEWORK\lvmen\src\licensedcode\data\rules\false-positive_1651.yml", "YAML", 0, 0, 0, 2, 0, 0, 1, 3
"d:\IDEWORK\lvmen\src\licensedcode\data\rules\false-positive_1652.yml", "YAML", 0, 0, 0, 2, 0, 0, 1, 3
"d:\IDEWORK\lvmen\src\licensedcode\data\rules\false-positive_1653.yml", "YAML", 0, 0, 0, 2, 0, 0, 1, 3
"d:\IDEWORK\lvmen\src\licensedcode\data\rules\false-positive_1654.yml", "YAML", 0, 0, 0, 2, 0, 0, 1, 3
"d:\IDEWORK\lvmen\src\licensedcode\data\rules\false-positive_1655.yml", "YAML", 0, 0, 0, 2, 0, 0, 1, 3
"d:\IDEWORK\lvmen\src\licensedcode\data\rules\false-positive_1656.yml", "YAML", 0, 0, 0, 2, 0, 0, 1, 3
"d:\IDEWORK\lvmen\src\licensedcode\data\rules\false-positive_1657.yml", "YAML", 0, 0, 0, 2, 0, 0, 1, 3
"d:\IDEWORK\lvmen\src\licensedcode\data\rules\false-positive_1658.yml", "YAML", 0, 0, 0, 2, 0, 0, 1, 3
"d:\IDEWORK\lvmen\src\licensedcode\data\rules\false-positive_1659.yml", "YAML", 0, 0, 0, 2, 0, 0, 1, 3
"d:\IDEWORK\lvmen\src\licensedcode\data\rules\false-positive_166.yml", "YAML", 0, 0, 0, 2, 0, 0, 1, 3
"d:\IDEWORK\lvmen\src\licensedcode\data\rules\false-positive_1660.yml", "YAML", 0, 0, 0, 2, 0, 0, 1, 3
"d:\IDEWORK\lvmen\src\licensedcode\data\rules\false-positive_1661.yml", "YAML", 0, 0, 0, 2, 0, 0, 1, 3
"d:\IDEWORK\lvmen\src\licensedcode\data\rules\false-positive_1662.yml", "YAML", 0, 0, 0, 2, 0, 0, 1, 3
"d:\IDEWORK\lvmen\src\licensedcode\data\rules\false-positive_1663.yml", "YAML", 0, 0, 0, 2, 0, 0, 1, 3
"d:\IDEWORK\lvmen\src\licensedcode\data\rules\false-positive_1664.yml", "YAML", 0, 0, 0, 2, 0, 0, 1, 3
"d:\IDEWORK\lvmen\src\licensedcode\data\rules\false-positive_1665.yml", "YAML", 0, 0, 0, 2, 0, 0, 1, 3
"d:\IDEWORK\lvmen\src\licensedcode\data\rules\false-positive_1666.yml", "YAML", 0, 0, 0, 2, 0, 0, 1, 3
"d:\IDEWORK\lvmen\src\licensedcode\data\rules\false-positive_1667.yml", "YAML", 0, 0, 0, 2, 0, 0, 1, 3
"d:\IDEWORK\lvmen\src\licensedcode\data\rules\false-positive_1668.yml", "YAML", 0, 0, 0, 2, 0, 0, 1, 3
"d:\IDEWORK\lvmen\src\licensedcode\data\rules\false-positive_1669.yml", "YAML", 0, 0, 0, 2, 0, 0, 1, 3
"d:\IDEWORK\lvmen\src\licensedcode\data\rules\false-positive_167.yml", "YAML", 0, 0, 0, 3, 0, 0, 1, 4
"d:\IDEWORK\lvmen\src\licensedcode\data\rules\false-positive_1670.yml", "YAML", 0, 0, 0, 2, 0, 0, 1, 3
"d:\IDEWORK\lvmen\src\licensedcode\data\rules\false-positive_1671.yml", "YAML", 0, 0, 0, 2, 0, 0, 1, 3
"d:\IDEWORK\lvmen\src\licensedcode\data\rules\false-positive_1672.yml", "YAML", 0, 0, 0, 2, 0, 0, 1, 3
"d:\IDEWORK\lvmen\src\licensedcode\data\rules\false-positive_1673.yml", "YAML", 0, 0, 0, 2, 0, 0, 1, 3
"d:\IDEWORK\lvmen\src\licensedcode\data\rules\false-positive_1674.yml", "YAML", 0, 0, 0, 2, 0, 0, 1, 3
"d:\IDEWORK\lvmen\src\licensedcode\data\rules\false-positive_1675.yml", "YAML", 0, 0, 0, 2, 0, 0, 1, 3
"d:\IDEWORK\lvmen\src\licensedcode\data\rules\false-positive_1676.yml", "YAML", 0, 0, 0, 2, 0, 0, 1, 3
"d:\IDEWORK\lvmen\src\licensedcode\data\rules\false-positive_1677.yml", "YAML", 0, 0, 0, 2, 0, 0, 1, 3
"d:\IDEWORK\lvmen\src\licensedcode\data\rules\false-positive_1678.yml", "YAML", 0, 0, 0, 2, 0, 0, 1, 3
"d:\IDEWORK\lvmen\src\licensedcode\data\rules\false-positive_1679.yml", "YAML", 0, 0, 0, 2, 0, 0, 1, 3
"d:\IDEWORK\lvmen\src\licensedcode\data\rules\false-positive_168.yml", "YAML", 0, 0, 0, 2, 0, 0, 1, 3
"d:\IDEWORK\lvmen\src\licensedcode\data\rules\false-positive_1680.yml", "YAML", 0, 0, 0, 2, 0, 0, 1, 3
"d:\IDEWORK\lvmen\src\licensedcode\data\rules\false-positive_1681.yml", "YAML", 0, 0, 0, 2, 0, 0, 1, 3
"d:\IDEWORK\lvmen\src\licensedcode\data\rules\false-positive_1682.yml", "YAML", 0, 0, 0, 2, 0, 0, 1, 3
"d:\IDEWORK\lvmen\src\licensedcode\data\rules\false-positive_1683.yml", "YAML", 0, 0, 0, 2, 0, 0, 1, 3
"d:\IDEWORK\lvmen\src\licensedcode\data\rules\false-positive_1684.yml", "YAML", 0, 0, 0, 2, 0, 0, 1, 3
"d:\IDEWORK\lvmen\src\licensedcode\data\rules\false-positive_1685.yml", "YAML", 0, 0, 0, 2, 0, 0, 1, 3
"d:\IDEWORK\lvmen\src\licensedcode\data\rules\false-positive_1686.yml", "YAML", 0, 0, 0, 2, 0, 0, 1, 3
"d:\IDEWORK\lvmen\src\licensedcode\data\rules\false-positive_1687.yml", "YAML", 0, 0, 0, 2, 0, 0, 1, 3
"d:\IDEWORK\lvmen\src\licensedcode\data\rules\false-positive_1688.yml", "YAML", 0, 0, 0, 2, 0, 0, 1, 3
"d:\IDEWORK\lvmen\src\licensedcode\data\rules\false-positive_1689.yml", "YAML", 0, 0, 0, 2, 0, 0, 1, 3
"d:\IDEWORK\lvmen\src\licensedcode\data\rules\false-positive_169.yml", "YAML", 0, 0, 0, 2, 0, 0, 1, 3
"d:\IDEWORK\lvmen\src\licensedcode\data\rules\false-positive_1690.yml", "YAML", 0, 0, 0, 2, 0, 0, 1, 3
"d:\IDEWORK\lvmen\src\licensedcode\data\rules\false-positive_1691.yml", "YAML", 0, 0, 0, 2, 0, 0, 1, 3
"d:\IDEWORK\lvmen\src\licensedcode\data\rules\false-positive_1692.yml", "YAML", 0, 0, 0, 2, 0, 0, 1, 3
"d:\IDEWORK\lvmen\src\licensedcode\data\rules\false-positive_1693.yml", "YAML", 0, 0, 0, 2, 0, 0, 1, 3
"d:\IDEWORK\lvmen\src\licensedcode\data\rules\false-positive_1694.yml", "YAML", 0, 0, 0, 2, 0, 0, 1, 3
"d:\IDEWORK\lvmen\src\licensedcode\data\rules\false-positive_1695.yml", "YAML", 0, 0, 0, 2, 0, 0, 1, 3
"d:\IDEWORK\lvmen\src\licensedcode\data\rules\false-positive_1696.yml", "YAML", 0, 0, 0, 2, 0, 0, 1, 3
"d:\IDEWORK\lvmen\src\licensedcode\data\rules\false-positive_1697.yml", "YAML", 0, 0, 0, 2, 0, 0, 1, 3
"d:\IDEWORK\lvmen\src\licensedcode\data\rules\false-positive_1698.yml", "YAML", 0, 0, 0, 2, 0, 0, 1, 3
"d:\IDEWORK\lvmen\src\licensedcode\data\rules\false-positive_1699.yml", "YAML", 0, 0, 0, 2, 0, 0, 1, 3
"d:\IDEWORK\lvmen\src\licensedcode\data\rules\false-positive_17.yml", "YAML", 0, 0, 0, 2, 0, 0, 1, 3
"d:\IDEWORK\lvmen\src\licensedcode\data\rules\false-positive_170.yml", "YAML", 0, 0, 0, 2, 0, 0, 1, 3
"d:\IDEWORK\lvmen\src\licensedcode\data\rules\false-positive_1700.yml", "YAML", 0, 0, 0, 2, 0, 0, 1, 3
"d:\IDEWORK\lvmen\src\licensedcode\data\rules\false-positive_1701.yml", "YAML", 0, 0, 0, 2, 0, 0, 1, 3
"d:\IDEWORK\lvmen\src\licensedcode\data\rules\false-positive_1702.yml", "YAML", 0, 0, 0, 2, 0, 0, 1, 3
"d:\IDEWORK\lvmen\src\licensedcode\data\rules\false-positive_1703.yml", "YAML", 0, 0, 0, 2, 0, 0, 1, 3
"d:\IDEWORK\lvmen\src\licensedcode\data\rules\false-positive_1704.yml", "YAML", 0, 0, 0, 2, 0, 0, 1, 3
"d:\IDEWORK\lvmen\src\licensedcode\data\rules\false-positive_1705.yml", "YAML", 0, 0, 0, 2, 0, 0, 1, 3
"d:\IDEWORK\lvmen\src\licensedcode\data\rules\false-positive_1706.yml", "YAML", 0, 0, 0, 2, 0, 0, 1, 3
"d:\IDEWORK\lvmen\src\licensedcode\data\rules\false-positive_1707.yml", "YAML", 0, 0, 0, 2, 0, 0, 1, 3
"d:\IDEWORK\lvmen\src\licensedcode\data\rules\false-positive_1708.yml", "YAML", 0, 0, 0, 2, 0, 0, 1, 3
"d:\IDEWORK\lvmen\src\licensedcode\data\rules\false-positive_1709.yml", "YAML", 0, 0, 0, 2, 0, 0, 1, 3
"d:\IDEWORK\lvmen\src\licensedcode\data\rules\false-positive_171.yml", "YAML", 0, 0, 0, 3, 0, 0, 1, 4
"d:\IDEWORK\lvmen\src\licensedcode\data\rules\false-positive_1710.yml", "YAML", 0, 0, 0, 2, 0, 0, 1, 3
"d:\IDEWORK\lvmen\src\licensedcode\data\rules\false-positive_1711.yml", "YAML", 0, 0, 0, 2, 0, 0, 1, 3
"d:\IDEWORK\lvmen\src\licensedcode\data\rules\false-positive_1712.yml", "YAML", 0, 0, 0, 2, 0, 0, 1, 3
"d:\IDEWORK\lvmen\src\licensedcode\data\rules\false-positive_1713.yml", "YAML", 0, 0, 0, 2, 0, 0, 1, 3
"d:\IDEWORK\lvmen\src\licensedcode\data\rules\false-positive_1714.yml", "YAML", 0, 0, 0, 2, 0, 0, 1, 3
"d:\IDEWORK\lvmen\src\licensedcode\data\rules\false-positive_1715.yml", "YAML", 0, 0, 0, 2, 0, 0, 1, 3
"d:\IDEWORK\lvmen\src\licensedcode\data\rules\false-positive_1716.yml", "YAML", 0, 0, 0, 2, 0, 0, 1, 3
"d:\IDEWORK\lvmen\src\licensedcode\data\rules\false-positive_1717.yml", "YAML", 0, 0, 0, 2, 0, 0, 1, 3
"d:\IDEWORK\lvmen\src\licensedcode\data\rules\false-positive_1718.yml", "YAML", 0, 0, 0, 2, 0, 0, 1, 3
"d:\IDEWORK\lvmen\src\licensedcode\data\rules\false-positive_1719.yml", "YAML", 0, 0, 0, 2, 0, 0, 1, 3
"d:\IDEWORK\lvmen\src\licensedcode\data\rules\false-positive_172.yml", "YAML", 0, 0, 0, 2, 0, 0, 1, 3
"d:\IDEWORK\lvmen\src\licensedcode\data\rules\false-positive_1720.yml", "YAML", 0, 0, 0, 2, 0, 0, 1, 3
"d:\IDEWORK\lvmen\src\licensedcode\data\rules\false-positive_1721.yml", "YAML", 0, 0, 0, 2, 0, 0, 1, 3
"d:\IDEWORK\lvmen\src\licensedcode\data\rules\false-positive_1722.yml", "YAML", 0, 0, 0, 2, 0, 0, 1, 3
"d:\IDEWORK\lvmen\src\licensedcode\data\rules\false-positive_1723.yml", "YAML", 0, 0, 0, 2, 0, 0, 1, 3
"d:\IDEWORK\lvmen\src\licensedcode\data\rules\false-positive_1724.yml", "YAML", 0, 0, 0, 2, 0, 0, 1, 3
"d:\IDEWORK\lvmen\src\licensedcode\data\rules\false-positive_1725.yml", "YAML", 0, 0, 0, 2, 0, 0, 1, 3
"d:\IDEWORK\lvmen\src\licensedcode\data\rules\false-positive_1726.yml", "YAML", 0, 0, 0, 2, 0, 0, 1, 3
"d:\IDEWORK\lvmen\src\licensedcode\data\rules\false-positive_1727.yml", "YAML", 0, 0, 0, 2, 0, 0, 1, 3
"d:\IDEWORK\lvmen\src\licensedcode\data\rules\false-positive_1728.yml", "YAML", 0, 0, 0, 2, 0, 0, 1, 3
"d:\IDEWORK\lvmen\src\licensedcode\data\rules\false-positive_1729.yml", "YAML", 0, 0, 0, 2, 0, 0, 1, 3
"d:\IDEWORK\lvmen\src\licensedcode\data\rules\false-positive_173.yml", "YAML", 0, 0, 0, 2, 0, 0, 1, 3
"d:\IDEWORK\lvmen\src\licensedcode\data\rules\false-positive_1730.yml", "YAML", 0, 0, 0, 2, 0, 0, 1, 3
"d:\IDEWORK\lvmen\src\licensedcode\data\rules\false-positive_1731.yml", "YAML", 0, 0, 0, 2, 0, 0, 1, 3
"d:\IDEWORK\lvmen\src\licensedcode\data\rules\false-positive_1732.yml", "YAML", 0, 0, 0, 2, 0, 0, 1, 3
"d:\IDEWORK\lvmen\src\licensedcode\data\rules\false-positive_1733.yml", "YAML", 0, 0, 0, 2, 0, 0, 1, 3
"d:\IDEWORK\lvmen\src\licensedcode\data\rules\false-positive_1734.yml", "YAML", 0, 0, 0, 2, 0, 0, 1, 3
"d:\IDEWORK\lvmen\src\licensedcode\data\rules\false-positive_1735.yml", "YAML", 0, 0, 0, 2, 0, 0, 1, 3
"d:\IDEWORK\lvmen\src\licensedcode\data\rules\false-positive_1736.yml", "YAML", 0, 0, 0, 2, 0, 0, 1, 3
"d:\IDEWORK\lvmen\src\licensedcode\data\rules\false-positive_1737.yml", "YAML", 0, 0, 0, 2, 0, 0, 1, 3
"d:\IDEWORK\lvmen\src\licensedcode\data\rules\false-positive_1738.yml", "YAML", 0, 0, 0, 2, 0, 0, 1, 3
"d:\IDEWORK\lvmen\src\licensedcode\data\rules\false-positive_1739.yml", "YAML", 0, 0, 0, 2, 0, 0, 1, 3
"d:\IDEWORK\lvmen\src\licensedcode\data\rules\false-positive_174.yml", "YAML", 0, 0, 0, 2, 0, 0, 1, 3
"d:\IDEWORK\lvmen\src\licensedcode\data\rules\false-positive_1740.yml", "YAML", 0, 0, 0, 2, 0, 0, 1, 3
"d:\IDEWORK\lvmen\src\licensedcode\data\rules\false-positive_1741.yml", "YAML", 0, 0, 0, 2, 0, 0, 1, 3
"d:\IDEWORK\lvmen\src\licensedcode\data\rules\false-positive_1742.yml", "YAML", 0, 0, 0, 2, 0, 0, 1, 3
"d:\IDEWORK\lvmen\src\licensedcode\data\rules\false-positive_1743.yml", "YAML", 0, 0, 0, 2, 0, 0, 1, 3
"d:\IDEWORK\lvmen\src\licensedcode\data\rules\false-positive_1744.yml", "YAML", 0, 0, 0, 2, 0, 0, 1, 3
"d:\IDEWORK\lvmen\src\licensedcode\data\rules\false-positive_1745.yml", "YAML", 0, 0, 0, 2, 0, 0, 1, 3
"d:\IDEWORK\lvmen\src\licensedcode\data\rules\false-positive_1746.yml", "YAML", 0, 0, 0, 2, 0, 0, 1, 3
"d:\IDEWORK\lvmen\src\licensedcode\data\rules\false-positive_1747.yml", "YAML", 0, 0, 0, 2, 0, 0, 1, 3
"d:\IDEWORK\lvmen\src\licensedcode\data\rules\false-positive_1748.yml", "YAML", 0, 0, 0, 2, 0, 0, 1, 3
"d:\IDEWORK\lvmen\src\licensedcode\data\rules\false-positive_1749.yml", "YAML", 0, 0, 0, 2, 0, 0, 1, 3
"d:\IDEWORK\lvmen\src\licensedcode\data\rules\false-positive_175.yml", "YAML", 0, 0, 0, 2, 0, 0, 1, 3
"d:\IDEWORK\lvmen\src\licensedcode\data\rules\false-positive_1750.yml", "YAML", 0, 0, 0, 2, 0, 0, 1, 3
"d:\IDEWORK\lvmen\src\licensedcode\data\rules\false-positive_1751.yml", "YAML", 0, 0, 0, 2, 0, 0, 1, 3
"d:\IDEWORK\lvmen\src\licensedcode\data\rules\false-positive_1752.yml", "YAML", 0, 0, 0, 2, 0, 0, 1, 3
"d:\IDEWORK\lvmen\src\licensedcode\data\rules\false-positive_1753.yml", "YAML", 0, 0, 0, 2, 0, 0, 1, 3
"d:\IDEWORK\lvmen\src\licensedcode\data\rules\false-positive_1754.yml", "YAML", 0, 0, 0, 2, 0, 0, 1, 3
"d:\IDEWORK\lvmen\src\licensedcode\data\rules\false-positive_1755.yml", "YAML", 0, 0, 0, 2, 0, 0, 1, 3
"d:\IDEWORK\lvmen\src\licensedcode\data\rules\false-positive_1756.yml", "YAML", 0, 0, 0, 2, 0, 0, 1, 3
"d:\IDEWORK\lvmen\src\licensedcode\data\rules\false-positive_1757.yml", "YAML", 0, 0, 0, 2, 0, 0, 1, 3
"d:\IDEWORK\lvmen\src\licensedcode\data\rules\false-positive_1758.yml", "YAML", 0, 0, 0, 2, 0, 0, 1, 3
"d:\IDEWORK\lvmen\src\licensedcode\data\rules\false-positive_1759.yml", "YAML", 0, 0, 0, 2, 0, 0, 1, 3
"d:\IDEWORK\lvmen\src\licensedcode\data\rules\false-positive_176.yml", "YAML", 0, 0, 0, 3, 0, 0, 1, 4
"d:\IDEWORK\lvmen\src\licensedcode\data\rules\false-positive_1760.yml", "YAML", 0, 0, 0, 2, 0, 0, 1, 3
"d:\IDEWORK\lvmen\src\licensedcode\data\rules\false-positive_1761.yml", "YAML", 0, 0, 0, 2, 0, 0, 1, 3
"d:\IDEWORK\lvmen\src\licensedcode\data\rules\false-positive_1762.yml", "YAML", 0, 0, 0, 2, 0, 0, 1, 3
"d:\IDEWORK\lvmen\src\licensedcode\data\rules\false-positive_1763.yml", "YAML", 0, 0, 0, 2, 0, 0, 1, 3
"d:\IDEWORK\lvmen\src\licensedcode\data\rules\false-positive_1764.yml", "YAML", 0, 0, 0, 2, 0, 0, 1, 3
"d:\IDEWORK\lvmen\src\licensedcode\data\rules\false-positive_1765.yml", "YAML", 0, 0, 0, 2, 0, 0, 1, 3
"d:\IDEWORK\lvmen\src\licensedcode\data\rules\false-positive_1766.yml", "YAML", 0, 0, 0, 2, 0, 0, 1, 3
"d:\IDEWORK\lvmen\src\licensedcode\data\rules\false-positive_1767.yml", "YAML", 0, 0, 0, 2, 0, 0, 1, 3
"d:\IDEWORK\lvmen\src\licensedcode\data\rules\false-positive_1768.yml", "YAML", 0, 0, 0, 2, 0, 0, 1, 3
"d:\IDEWORK\lvmen\src\licensedcode\data\rules\false-positive_1769.yml", "YAML", 0, 0, 0, 2, 0, 0, 1, 3
"d:\IDEWORK\lvmen\src\licensedcode\data\rules\false-positive_177.yml", "YAML", 0, 0, 0, 2, 0, 0, 1, 3
"d:\IDEWORK\lvmen\src\licensedcode\data\rules\false-positive_1770.yml", "YAML", 0, 0, 0, 2, 0, 0, 1, 3
"d:\IDEWORK\lvmen\src\licensedcode\data\rules\false-positive_1771.yml", "YAML", 0, 0, 0, 2, 0, 0, 1, 3
"d:\IDEWORK\lvmen\src\licensedcode\data\rules\false-positive_1772.yml", "YAML", 0, 0, 0, 2, 0, 0, 1, 3
"d:\IDEWORK\lvmen\src\licensedcode\data\rules\false-positive_1773.yml", "YAML", 0, 0, 0, 2, 0, 0, 1, 3
"d:\IDEWORK\lvmen\src\licensedcode\data\rules\false-positive_1774.yml", "YAML", 0, 0, 0, 2, 0, 0, 1, 3
"d:\IDEWORK\lvmen\src\licensedcode\data\rules\false-positive_1775.yml", "YAML", 0, 0, 0, 2, 0, 0, 1, 3
"d:\IDEWORK\lvmen\src\licensedcode\data\rules\false-positive_1776.yml", "YAML", 0, 0, 0, 2, 0, 0, 1, 3
"d:\IDEWORK\lvmen\src\licensedcode\data\rules\false-positive_1777.yml", "YAML", 0, 0, 0, 2, 0, 0, 1, 3
"d:\IDEWORK\lvmen\src\licensedcode\data\rules\false-positive_1778.yml", "YAML", 0, 0, 0, 2, 0, 0, 1, 3
"d:\IDEWORK\lvmen\src\licensedcode\data\rules\false-positive_1779.yml", "YAML", 0, 0, 0, 2, 0, 0, 1, 3
"d:\IDEWORK\lvmen\src\licensedcode\data\rules\false-positive_178.yml", "YAML", 0, 0, 0, 2, 0, 0, 1, 3
"d:\IDEWORK\lvmen\src\licensedcode\data\rules\false-positive_1780.yml", "YAML", 0, 0, 0, 2, 0, 0, 1, 3
"d:\IDEWORK\lvmen\src\licensedcode\data\rules\false-positive_1781.yml", "YAML", 0, 0, 0, 2, 0, 0, 1, 3
"d:\IDEWORK\lvmen\src\licensedcode\data\rules\false-positive_1782.yml", "YAML", 0, 0, 0, 2, 0, 0, 1, 3
"d:\IDEWORK\lvmen\src\licensedcode\data\rules\false-positive_1783.yml", "YAML", 0, 0, 0, 2, 0, 0, 1, 3
"d:\IDEWORK\lvmen\src\licensedcode\data\rules\false-positive_1784.yml", "YAML", 0, 0, 0, 2, 0, 0, 1, 3
"d:\IDEWORK\lvmen\src\licensedcode\data\rules\false-positive_1785.yml", "YAML", 0, 0, 0, 2, 0, 0, 1, 3
"d:\IDEWORK\lvmen\src\licensedcode\data\rules\false-positive_1786.yml", "YAML", 0, 0, 0, 2, 0, 0, 1, 3
"d:\IDEWORK\lvmen\src\licensedcode\data\rules\false-positive_1787.yml", "YAML", 0, 0, 0, 2, 0, 0, 1, 3
"d:\IDEWORK\lvmen\src\licensedcode\data\rules\false-positive_1788.yml", "YAML", 0, 0, 0, 2, 0, 0, 1, 3
"d:\IDEWORK\lvmen\src\licensedcode\data\rules\false-positive_1789.yml", "YAML", 0, 0, 0, 2, 0, 0, 1, 3
"d:\IDEWORK\lvmen\src\licensedcode\data\rules\false-positive_179.yml", "YAML", 0, 0, 0, 3, 0, 0, 1, 4
"d:\IDEWORK\lvmen\src\licensedcode\data\rules\false-positive_1790.yml", "YAML", 0, 0, 0, 2, 0, 0, 1, 3
"d:\IDEWORK\lvmen\src\licensedcode\data\rules\false-positive_1791.yml", "YAML", 0, 0, 0, 2, 0, 0, 1, 3
"d:\IDEWORK\lvmen\src\licensedcode\data\rules\false-positive_1792.yml", "YAML", 0, 0, 0, 2, 0, 0, 1, 3
"d:\IDEWORK\lvmen\src\licensedcode\data\rules\false-positive_1793.yml", "YAML", 0, 0, 0, 2, 0, 0, 1, 3
"d:\IDEWORK\lvmen\src\licensedcode\data\rules\false-positive_1794.yml", "YAML", 0, 0, 0, 2, 0, 0, 1, 3
"d:\IDEWORK\lvmen\src\licensedcode\data\rules\false-positive_1795.yml", "YAML", 0, 0, 0, 2, 0, 0, 1, 3
"d:\IDEWORK\lvmen\src\licensedcode\data\rules\false-positive_1796.yml", "YAML", 0, 0, 0, 2, 0, 0, 1, 3
"d:\IDEWORK\lvmen\src\licensedcode\data\rules\false-positive_1797.yml", "YAML", 0, 0, 0, 2, 0, 0, 1, 3
"d:\IDEWORK\lvmen\src\licensedcode\data\rules\false-positive_1798.yml", "YAML", 0, 0, 0, 2, 0, 0, 1, 3
"d:\IDEWORK\lvmen\src\licensedcode\data\rules\false-positive_1799.yml", "YAML", 0, 0, 0, 2, 0, 0, 1, 3
"d:\IDEWORK\lvmen\src\licensedcode\data\rules\false-positive_18.yml", "YAML", 0, 0, 0, 2, 0, 0, 1, 3
"d:\IDEWORK\lvmen\src\licensedcode\data\rules\false-positive_180.yml", "YAML", 0, 0, 0, 2, 0, 0, 1, 3
"d:\IDEWORK\lvmen\src\licensedcode\data\rules\false-positive_1800.yml", "YAML", 0, 0, 0, 2, 0, 0, 1, 3
"d:\IDEWORK\lvmen\src\licensedcode\data\rules\false-positive_1801.yml", "YAML", 0, 0, 0, 2, 0, 0, 1, 3
"d:\IDEWORK\lvmen\src\licensedcode\data\rules\false-positive_1802.yml", "YAML", 0, 0, 0, 2, 0, 0, 1, 3
"d:\IDEWORK\lvmen\src\licensedcode\data\rules\false-positive_1803.yml", "YAML", 0, 0, 0, 2, 0, 0, 1, 3
"d:\IDEWORK\lvmen\src\licensedcode\data\rules\false-positive_1804.yml", "YAML", 0, 0, 0, 2, 0, 0, 1, 3
"d:\IDEWORK\lvmen\src\licensedcode\data\rules\false-positive_1805.yml", "YAML", 0, 0, 0, 2, 0, 0, 1, 3
"d:\IDEWORK\lvmen\src\licensedcode\data\rules\false-positive_1806.yml", "YAML", 0, 0, 0, 2, 0, 0, 1, 3
"d:\IDEWORK\lvmen\src\licensedcode\data\rules\false-positive_1807.yml", "YAML", 0, 0, 0, 2, 0, 0, 1, 3
"d:\IDEWORK\lvmen\src\licensedcode\data\rules\false-positive_1808.yml", "YAML", 0, 0, 0, 2, 0, 0, 1, 3
"d:\IDEWORK\lvmen\src\licensedcode\data\rules\false-positive_1809.yml", "YAML", 0, 0, 0, 2, 0, 0, 1, 3
"d:\IDEWORK\lvmen\src\licensedcode\data\rules\false-positive_181.yml", "YAML", 0, 0, 0, 2, 0, 0, 1, 3
"d:\IDEWORK\lvmen\src\licensedcode\data\rules\false-positive_1810.yml", "YAML", 0, 0, 0, 2, 0, 0, 1, 3
"d:\IDEWORK\lvmen\src\licensedcode\data\rules\false-positive_1811.yml", "YAML", 0, 0, 0, 2, 0, 0, 1, 3
"d:\IDEWORK\lvmen\src\licensedcode\data\rules\false-positive_1812.yml", "YAML", 0, 0, 0, 2, 0, 0, 1, 3
"d:\IDEWORK\lvmen\src\licensedcode\data\rules\false-positive_1813.yml", "YAML", 0, 0, 0, 2, 0, 0, 1, 3
"d:\IDEWORK\lvmen\src\licensedcode\data\rules\false-positive_1814.yml", "YAML", 0, 0, 0, 2, 0, 0, 1, 3
"d:\IDEWORK\lvmen\src\licensedcode\data\rules\false-positive_1815.yml", "YAML", 0, 0, 0, 2, 0, 0, 1, 3
"d:\IDEWORK\lvmen\src\licensedcode\data\rules\false-positive_1816.yml", "YAML", 0, 0, 0, 2, 0, 0, 1, 3
"d:\IDEWORK\lvmen\src\licensedcode\data\rules\false-positive_1817.yml", "YAML", 0, 0, 0, 2, 0, 0, 1, 3
"d:\IDEWORK\lvmen\src\licensedcode\data\rules\false-positive_1818.yml", "YAML", 0, 0, 0, 2, 0, 0, 1, 3
"d:\IDEWORK\lvmen\src\licensedcode\data\rules\false-positive_1819.yml", "YAML", 0, 0, 0, 2, 0, 0, 1, 3
"d:\IDEWORK\lvmen\src\licensedcode\data\rules\false-positive_182.yml", "YAML", 0, 0, 0, 2, 0, 0, 1, 3
"d:\IDEWORK\lvmen\src\licensedcode\data\rules\false-positive_1820.yml", "YAML", 0, 0, 0, 2, 0, 0, 1, 3
"d:\IDEWORK\lvmen\src\licensedcode\data\rules\false-positive_1821.yml", "YAML", 0, 0, 0, 2, 0, 0, 1, 3
"d:\IDEWORK\lvmen\src\licensedcode\data\rules\false-positive_1822.yml", "YAML", 0, 0, 0, 2, 0, 0, 1, 3
"d:\IDEWORK\lvmen\src\licensedcode\data\rules\false-positive_1823.yml", "YAML", 0, 0, 0, 2, 0, 0, 1, 3
"d:\IDEWORK\lvmen\src\licensedcode\data\rules\false-positive_1824.yml", "YAML", 0, 0, 0, 2, 0, 0, 1, 3
"d:\IDEWORK\lvmen\src\licensedcode\data\rules\false-positive_1825.yml", "YAML", 0, 0, 0, 2, 0, 0, 1, 3
"d:\IDEWORK\lvmen\src\licensedcode\data\rules\false-positive_1826.yml", "YAML", 0, 0, 0, 2, 0, 0, 1, 3
"d:\IDEWORK\lvmen\src\licensedcode\data\rules\false-positive_1827.yml", "YAML", 0, 0, 0, 2, 0, 0, 1, 3
"d:\IDEWORK\lvmen\src\licensedcode\data\rules\false-positive_1828.yml", "YAML", 0, 0, 0, 2, 0, 0, 1, 3
"d:\IDEWORK\lvmen\src\licensedcode\data\rules\false-positive_1829.yml", "YAML", 0, 0, 0, 2, 0, 0, 1, 3
"d:\IDEWORK\lvmen\src\licensedcode\data\rules\false-positive_183.yml", "YAML", 0, 0, 0, 3, 0, 0, 1, 4
"d:\IDEWORK\lvmen\src\licensedcode\data\rules\false-positive_1830.yml", "YAML", 0, 0, 0, 2, 0, 0, 1, 3
"d:\IDEWORK\lvmen\src\licensedcode\data\rules\false-positive_1831.yml", "YAML", 0, 0, 0, 2, 0, 0, 1, 3
"d:\IDEWORK\lvmen\src\licensedcode\data\rules\false-positive_1832.yml", "YAML", 0, 0, 0, 2, 0, 0, 1, 3
"d:\IDEWORK\lvmen\src\licensedcode\data\rules\false-positive_1833.yml", "YAML", 0, 0, 0, 2, 0, 0, 1, 3
"d:\IDEWORK\lvmen\src\licensedcode\data\rules\false-positive_1834.yml", "YAML", 0, 0, 0, 2, 0, 0, 1, 3
"d:\IDEWORK\lvmen\src\licensedcode\data\rules\false-positive_1835.yml", "YAML", 0, 0, 0, 2, 0, 0, 1, 3
"d:\IDEWORK\lvmen\src\licensedcode\data\rules\false-positive_1836.yml", "YAML", 0, 0, 0, 2, 0, 0, 1, 3
"d:\IDEWORK\lvmen\src\licensedcode\data\rules\false-positive_1837.yml", "YAML", 0, 0, 0, 2, 0, 0, 1, 3
"d:\IDEWORK\lvmen\src\licensedcode\data\rules\false-positive_1838.yml", "YAML", 0, 0, 0, 2, 0, 0, 1, 3
"d:\IDEWORK\lvmen\src\licensedcode\data\rules\false-positive_1839.yml", "YAML", 0, 0, 0, 2, 0, 0, 1, 3
"d:\IDEWORK\lvmen\src\licensedcode\data\rules\false-positive_184.yml", "YAML", 0, 0, 0, 2, 0, 0, 1, 3
"d:\IDEWORK\lvmen\src\licensedcode\data\rules\false-positive_1840.yml", "YAML", 0, 0, 0, 2, 0, 0, 1, 3
"d:\IDEWORK\lvmen\src\licensedcode\data\rules\false-positive_1841.yml", "YAML", 0, 0, 0, 2, 0, 0, 1, 3
"d:\IDEWORK\lvmen\src\licensedcode\data\rules\false-positive_1842.yml", "YAML", 0, 0, 0, 2, 0, 0, 1, 3
"d:\IDEWORK\lvmen\src\licensedcode\data\rules\false-positive_1843.yml", "YAML", 0, 0, 0, 2, 0, 0, 1, 3
"d:\IDEWORK\lvmen\src\licensedcode\data\rules\false-positive_1844.yml", "YAML", 0, 0, 0, 2, 0, 0, 1, 3
"d:\IDEWORK\lvmen\src\licensedcode\data\rules\false-positive_1845.yml", "YAML", 0, 0, 0, 2, 0, 0, 1, 3
"d:\IDEWORK\lvmen\src\licensedcode\data\rules\false-positive_1846.yml", "YAML", 0, 0, 0, 2, 0, 0, 1, 3
"d:\IDEWORK\lvmen\src\licensedcode\data\rules\false-positive_1847.yml", "YAML", 0, 0, 0, 2, 0, 0, 1, 3
"d:\IDEWORK\lvmen\src\licensedcode\data\rules\false-positive_1848.yml", "YAML", 0, 0, 0, 2, 0, 0, 1, 3
"d:\IDEWORK\lvmen\src\licensedcode\data\rules\false-positive_1849.yml", "YAML", 0, 0, 0, 2, 0, 0, 1, 3
"d:\IDEWORK\lvmen\src\licensedcode\data\rules\false-positive_185.yml", "YAML", 0, 0, 0, 2, 0, 0, 1, 3
"d:\IDEWORK\lvmen\src\licensedcode\data\rules\false-positive_1850.yml", "YAML", 0, 0, 0, 2, 0, 0, 1, 3
"d:\IDEWORK\lvmen\src\licensedcode\data\rules\false-positive_1851.yml", "YAML", 0, 0, 0, 2, 0, 0, 1, 3
"d:\IDEWORK\lvmen\src\licensedcode\data\rules\false-positive_1852.yml", "YAML", 0, 0, 0, 2, 0, 0, 1, 3
"d:\IDEWORK\lvmen\src\licensedcode\data\rules\false-positive_1853.yml", "YAML", 0, 0, 0, 2, 0, 0, 1, 3
"d:\IDEWORK\lvmen\src\licensedcode\data\rules\false-positive_1854.yml", "YAML", 0, 0, 0, 2, 0, 0, 1, 3
"d:\IDEWORK\lvmen\src\licensedcode\data\rules\false-positive_1855.yml", "YAML", 0, 0, 0, 2, 0, 0, 1, 3
"d:\IDEWORK\lvmen\src\licensedcode\data\rules\false-positive_1856.yml", "YAML", 0, 0, 0, 2, 0, 0, 1, 3
"d:\IDEWORK\lvmen\src\licensedcode\data\rules\false-positive_1857.yml", "YAML", 0, 0, 0, 2, 0, 0, 1, 3
"d:\IDEWORK\lvmen\src\licensedcode\data\rules\false-positive_1858.yml", "YAML", 0, 0, 0, 2, 0, 0, 1, 3
"d:\IDEWORK\lvmen\src\licensedcode\data\rules\false-positive_1859.yml", "YAML", 0, 0, 0, 2, 0, 0, 1, 3
"d:\IDEWORK\lvmen\src\licensedcode\data\rules\false-positive_186.yml", "YAML", 0, 0, 0, 3, 0, 0, 1, 4
"d:\IDEWORK\lvmen\src\licensedcode\data\rules\false-positive_1860.yml", "YAML", 0, 0, 0, 2, 0, 0, 1, 3
"d:\IDEWORK\lvmen\src\licensedcode\data\rules\false-positive_1861.yml", "YAML", 0, 0, 0, 2, 0, 0, 1, 3
"d:\IDEWORK\lvmen\src\licensedcode\data\rules\false-positive_1862.yml", "YAML", 0, 0, 0, 2, 0, 0, 1, 3
"d:\IDEWORK\lvmen\src\licensedcode\data\rules\false-positive_1863.yml", "YAML", 0, 0, 0, 2, 0, 0, 1, 3
"d:\IDEWORK\lvmen\src\licensedcode\data\rules\false-positive_1864.yml", "YAML", 0, 0, 0, 2, 0, 0, 1, 3
"d:\IDEWORK\lvmen\src\licensedcode\data\rules\false-positive_1865.yml", "YAML", 0, 0, 0, 2, 0, 0, 1, 3
"d:\IDEWORK\lvmen\src\licensedcode\data\rules\false-positive_1866.yml", "YAML", 0, 0, 0, 2, 0, 0, 1, 3
"d:\IDEWORK\lvmen\src\licensedcode\data\rules\false-positive_1867.yml", "YAML", 0, 0, 0, 2, 0, 0, 1, 3
"d:\IDEWORK\lvmen\src\licensedcode\data\rules\false-positive_1868.yml", "YAML", 0, 0, 0, 2, 0, 0, 1, 3
"d:\IDEWORK\lvmen\src\licensedcode\data\rules\false-positive_1869.yml", "YAML", 0, 0, 0, 2, 0, 0, 1, 3
"d:\IDEWORK\lvmen\src\licensedcode\data\rules\false-positive_187.yml", "YAML", 0, 0, 0, 2, 0, 0, 1, 3
"d:\IDEWORK\lvmen\src\licensedcode\data\rules\false-positive_1870.yml", "YAML", 0, 0, 0, 2, 0, 0, 1, 3
"d:\IDEWORK\lvmen\src\licensedcode\data\rules\false-positive_1871.yml", "YAML", 0, 0, 0, 2, 0, 0, 1, 3
"d:\IDEWORK\lvmen\src\licensedcode\data\rules\false-positive_1872.yml", "YAML", 0, 0, 0, 2, 0, 0, 1, 3
"d:\IDEWORK\lvmen\src\licensedcode\data\rules\false-positive_1873.yml", "YAML", 0, 0, 0, 2, 0, 0, 1, 3
"d:\IDEWORK\lvmen\src\licensedcode\data\rules\false-positive_1874.yml", "YAML", 0, 0, 0, 2, 0, 0, 1, 3
"d:\IDEWORK\lvmen\src\licensedcode\data\rules\false-positive_1875.yml", "YAML", 0, 0, 0, 2, 0, 0, 1, 3
"d:\IDEWORK\lvmen\src\licensedcode\data\rules\false-positive_1876.yml", "YAML", 0, 0, 0, 2, 0, 0, 1, 3
"d:\IDEWORK\lvmen\src\licensedcode\data\rules\false-positive_1877.yml", "YAML", 0, 0, 0, 2, 0, 0, 1, 3
"d:\IDEWORK\lvmen\src\licensedcode\data\rules\false-positive_1878.yml", "YAML", 0, 0, 0, 2, 0, 0, 1, 3
"d:\IDEWORK\lvmen\src\licensedcode\data\rules\false-positive_1879.yml", "YAML", 0, 0, 0, 2, 0, 0, 1, 3
"d:\IDEWORK\lvmen\src\licensedcode\data\rules\false-positive_188.yml", "YAML", 0, 0, 0, 3, 0, 0, 1, 4
"d:\IDEWORK\lvmen\src\licensedcode\data\rules\false-positive_1880.yml", "YAML", 0, 0, 0, 2, 0, 0, 1, 3
"d:\IDEWORK\lvmen\src\licensedcode\data\rules\false-positive_1881.yml", "YAML", 0, 0, 0, 2, 0, 0, 1, 3
"d:\IDEWORK\lvmen\src\licensedcode\data\rules\false-positive_1882.yml", "YAML", 0, 0, 0, 2, 0, 0, 1, 3
"d:\IDEWORK\lvmen\src\licensedcode\data\rules\false-positive_1883.yml", "YAML", 0, 0, 0, 2, 0, 0, 1, 3
"d:\IDEWORK\lvmen\src\licensedcode\data\rules\false-positive_1884.yml", "YAML", 0, 0, 0, 2, 0, 0, 1, 3
"d:\IDEWORK\lvmen\src\licensedcode\data\rules\false-positive_1885.yml", "YAML", 0, 0, 0, 2, 0, 0, 1, 3
"d:\IDEWORK\lvmen\src\licensedcode\data\rules\false-positive_1886.yml", "YAML", 0, 0, 0, 2, 0, 0, 1, 3
"d:\IDEWORK\lvmen\src\licensedcode\data\rules\false-positive_1887.yml", "YAML", 0, 0, 0, 2, 0, 0, 1, 3
"d:\IDEWORK\lvmen\src\licensedcode\data\rules\false-positive_1888.yml", "YAML", 0, 0, 0, 2, 0, 0, 1, 3
"d:\IDEWORK\lvmen\src\licensedcode\data\rules\false-positive_1889.yml", "YAML", 0, 0, 0, 2, 0, 0, 1, 3
"d:\IDEWORK\lvmen\src\licensedcode\data\rules\false-positive_189.yml", "YAML", 0, 0, 0, 2, 0, 0, 1, 3
"d:\IDEWORK\lvmen\src\licensedcode\data\rules\false-positive_1890.yml", "YAML", 0, 0, 0, 2, 0, 0, 1, 3
"d:\IDEWORK\lvmen\src\licensedcode\data\rules\false-positive_1891.yml", "YAML", 0, 0, 0, 2, 0, 0, 1, 3
"d:\IDEWORK\lvmen\src\licensedcode\data\rules\false-positive_1892.yml", "YAML", 0, 0, 0, 2, 0, 0, 1, 3
"d:\IDEWORK\lvmen\src\licensedcode\data\rules\false-positive_1893.yml", "YAML", 0, 0, 0, 2, 0, 0, 1, 3
"d:\IDEWORK\lvmen\src\licensedcode\data\rules\false-positive_1894.yml", "YAML", 0, 0, 0, 2, 0, 0, 1, 3
"d:\IDEWORK\lvmen\src\licensedcode\data\rules\false-positive_1895.yml", "YAML", 0, 0, 0, 2, 0, 0, 1, 3
"d:\IDEWORK\lvmen\src\licensedcode\data\rules\false-positive_1896.yml", "YAML", 0, 0, 0, 2, 0, 0, 1, 3
"d:\IDEWORK\lvmen\src\licensedcode\data\rules\false-positive_1897.yml", "YAML", 0, 0, 0, 2, 0, 0, 1, 3
"d:\IDEWORK\lvmen\src\licensedcode\data\rules\false-positive_1898.yml", "YAML", 0, 0, 0, 2, 0, 0, 1, 3
"d:\IDEWORK\lvmen\src\licensedcode\data\rules\false-positive_1899.yml", "YAML", 0, 0, 0, 2, 0, 0, 1, 3
"d:\IDEWORK\lvmen\src\licensedcode\data\rules\false-positive_19.yml", "YAML", 0, 0, 0, 2, 0, 0, 1, 3
"d:\IDEWORK\lvmen\src\licensedcode\data\rules\false-positive_190.yml", "YAML", 0, 0, 0, 2, 0, 0, 1, 3
"d:\IDEWORK\lvmen\src\licensedcode\data\rules\false-positive_1900.yml", "YAML", 0, 0, 0, 2, 0, 0, 1, 3
"d:\IDEWORK\lvmen\src\licensedcode\data\rules\false-positive_1901.yml", "YAML", 0, 0, 0, 2, 0, 0, 1, 3
"d:\IDEWORK\lvmen\src\licensedcode\data\rules\false-positive_1902.yml", "YAML", 0, 0, 0, 2, 0, 0, 1, 3
"d:\IDEWORK\lvmen\src\licensedcode\data\rules\false-positive_1903.yml", "YAML", 0, 0, 0, 2, 0, 0, 1, 3
"d:\IDEWORK\lvmen\src\licensedcode\data\rules\false-positive_1904.yml", "YAML", 0, 0, 0, 2, 0, 0, 1, 3
"d:\IDEWORK\lvmen\src\licensedcode\data\rules\false-positive_1905.yml", "YAML", 0, 0, 0, 2, 0, 0, 1, 3
"d:\IDEWORK\lvmen\src\licensedcode\data\rules\false-positive_1906.yml", "YAML", 0, 0, 0, 2, 0, 0, 1, 3
"d:\IDEWORK\lvmen\src\licensedcode\data\rules\false-positive_1907.yml", "YAML", 0, 0, 0, 2, 0, 0, 1, 3
"d:\IDEWORK\lvmen\src\licensedcode\data\rules\false-positive_1908.yml", "YAML", 0, 0, 0, 2, 0, 0, 1, 3
"d:\IDEWORK\lvmen\src\licensedcode\data\rules\false-positive_1909.yml", "YAML", 0, 0, 0, 2, 0, 0, 1, 3
"d:\IDEWORK\lvmen\src\licensedcode\data\rules\false-positive_191.yml", "YAML", 0, 0, 0, 2, 0, 0, 1, 3
"d:\IDEWORK\lvmen\src\licensedcode\data\rules\false-positive_1910.yml", "YAML", 0, 0, 0, 2, 0, 0, 1, 3
"d:\IDEWORK\lvmen\src\licensedcode\data\rules\false-positive_1911.yml", "YAML", 0, 0, 0, 2, 0, 0, 1, 3
"d:\IDEWORK\lvmen\src\licensedcode\data\rules\false-positive_1912.yml", "YAML", 0, 0, 0, 2, 0, 0, 1, 3
"d:\IDEWORK\lvmen\src\licensedcode\data\rules\false-positive_1913.yml", "YAML", 0, 0, 0, 2, 0, 0, 1, 3
"d:\IDEWORK\lvmen\src\licensedcode\data\rules\false-positive_1914.yml", "YAML", 0, 0, 0, 2, 0, 0, 1, 3
"d:\IDEWORK\lvmen\src\licensedcode\data\rules\false-positive_1915.yml", "YAML", 0, 0, 0, 2, 0, 0, 1, 3
"d:\IDEWORK\lvmen\src\licensedcode\data\rules\false-positive_1916.yml", "YAML", 0, 0, 0, 2, 0, 0, 1, 3
"d:\IDEWORK\lvmen\src\licensedcode\data\rules\false-positive_1917.yml", "YAML", 0, 0, 0, 2, 0, 0, 1, 3
"d:\IDEWORK\lvmen\src\licensedcode\data\rules\false-positive_1918.yml", "YAML", 0, 0, 0, 2, 0, 0, 1, 3
"d:\IDEWORK\lvmen\src\licensedcode\data\rules\false-positive_1919.yml", "YAML", 0, 0, 0, 2, 0, 0, 1, 3
"d:\IDEWORK\lvmen\src\licensedcode\data\rules\false-positive_192.yml", "YAML", 0, 0, 0, 3, 0, 0, 1, 4
"d:\IDEWORK\lvmen\src\licensedcode\data\rules\false-positive_1920.yml", "YAML", 0, 0, 0, 2, 0, 0, 1, 3
"d:\IDEWORK\lvmen\src\licensedcode\data\rules\false-positive_1921.yml", "YAML", 0, 0, 0, 2, 0, 0, 1, 3
"d:\IDEWORK\lvmen\src\licensedcode\data\rules\false-positive_1922.yml", "YAML", 0, 0, 0, 2, 0, 0, 1, 3
"d:\IDEWORK\lvmen\src\licensedcode\data\rules\false-positive_1923.yml", "YAML", 0, 0, 0, 2, 0, 0, 1, 3
"d:\IDEWORK\lvmen\src\licensedcode\data\rules\false-positive_1924.yml", "YAML", 0, 0, 0, 2, 0, 0, 1, 3
"d:\IDEWORK\lvmen\src\licensedcode\data\rules\false-positive_1925.yml", "YAML", 0, 0, 0, 2, 0, 0, 1, 3
"d:\IDEWORK\lvmen\src\licensedcode\data\rules\false-positive_1926.yml", "YAML", 0, 0, 0, 2, 0, 0, 1, 3
"d:\IDEWORK\lvmen\src\licensedcode\data\rules\false-positive_1927.yml", "YAML", 0, 0, 0, 2, 0, 0, 1, 3
"d:\IDEWORK\lvmen\src\licensedcode\data\rules\false-positive_1928.yml", "YAML", 0, 0, 0, 2, 0, 0, 1, 3
"d:\IDEWORK\lvmen\src\licensedcode\data\rules\false-positive_1929.yml", "YAML", 0, 0, 0, 2, 0, 0, 1, 3
"d:\IDEWORK\lvmen\src\licensedcode\data\rules\false-positive_193.yml", "YAML", 0, 0, 0, 2, 0, 0, 1, 3
"d:\IDEWORK\lvmen\src\licensedcode\data\rules\false-positive_1930.yml", "YAML", 0, 0, 0, 2, 0, 0, 1, 3
"d:\IDEWORK\lvmen\src\licensedcode\data\rules\false-positive_1931.yml", "YAML", 0, 0, 0, 2, 0, 0, 1, 3
"d:\IDEWORK\lvmen\src\licensedcode\data\rules\false-positive_1932.yml", "YAML", 0, 0, 0, 2, 0, 0, 1, 3
"d:\IDEWORK\lvmen\src\licensedcode\data\rules\false-positive_1933.yml", "YAML", 0, 0, 0, 2, 0, 0, 1, 3
"d:\IDEWORK\lvmen\src\licensedcode\data\rules\false-positive_1934.yml", "YAML", 0, 0, 0, 2, 0, 0, 1, 3
"d:\IDEWORK\lvmen\src\licensedcode\data\rules\false-positive_1935.yml", "YAML", 0, 0, 0, 2, 0, 0, 1, 3
"d:\IDEWORK\lvmen\src\licensedcode\data\rules\false-positive_1936.yml", "YAML", 0, 0, 0, 2, 0, 0, 1, 3
"d:\IDEWORK\lvmen\src\licensedcode\data\rules\false-positive_1937.yml", "YAML", 0, 0, 0, 2, 0, 0, 1, 3
"d:\IDEWORK\lvmen\src\licensedcode\data\rules\false-positive_1938.yml", "YAML", 0, 0, 0, 2, 0, 0, 1, 3
"d:\IDEWORK\lvmen\src\licensedcode\data\rules\false-positive_1939.yml", "YAML", 0, 0, 0, 2, 0, 0, 1, 3
"d:\IDEWORK\lvmen\src\licensedcode\data\rules\false-positive_194.yml", "YAML", 0, 0, 0, 3, 0, 0, 1, 4
"d:\IDEWORK\lvmen\src\licensedcode\data\rules\false-positive_1940.yml", "YAML", 0, 0, 0, 2, 0, 0, 1, 3
"d:\IDEWORK\lvmen\src\licensedcode\data\rules\false-positive_1941.yml", "YAML", 0, 0, 0, 2, 0, 0, 1, 3
"d:\IDEWORK\lvmen\src\licensedcode\data\rules\false-positive_1942.yml", "YAML", 0, 0, 0, 2, 0, 0, 1, 3
"d:\IDEWORK\lvmen\src\licensedcode\data\rules\false-positive_1943.yml", "YAML", 0, 0, 0, 2, 0, 0, 1, 3
"d:\IDEWORK\lvmen\src\licensedcode\data\rules\false-positive_1944.yml", "YAML", 0, 0, 0, 2, 0, 0, 1, 3
"d:\IDEWORK\lvmen\src\licensedcode\data\rules\false-positive_1945.yml", "YAML", 0, 0, 0, 2, 0, 0, 1, 3
"d:\IDEWORK\lvmen\src\licensedcode\data\rules\false-positive_1946.yml", "YAML", 0, 0, 0, 2, 0, 0, 1, 3
"d:\IDEWORK\lvmen\src\licensedcode\data\rules\false-positive_1947.yml", "YAML", 0, 0, 0, 2, 0, 0, 1, 3
"d:\IDEWORK\lvmen\src\licensedcode\data\rules\false-positive_1948.yml", "YAML", 0, 0, 0, 2, 0, 0, 1, 3
"d:\IDEWORK\lvmen\src\licensedcode\data\rules\false-positive_1949.yml", "YAML", 0, 0, 0, 2, 0, 0, 1, 3
"d:\IDEWORK\lvmen\src\licensedcode\data\rules\false-positive_195.yml", "YAML", 0, 0, 0, 2, 0, 0, 1, 3
"d:\IDEWORK\lvmen\src\licensedcode\data\rules\false-positive_1950.yml", "YAML", 0, 0, 0, 2, 0, 0, 1, 3
"d:\IDEWORK\lvmen\src\licensedcode\data\rules\false-positive_1951.yml", "YAML", 0, 0, 0, 2, 0, 0, 1, 3
"d:\IDEWORK\lvmen\src\licensedcode\data\rules\false-positive_1952.yml", "YAML", 0, 0, 0, 2, 0, 0, 1, 3
"d:\IDEWORK\lvmen\src\licensedcode\data\rules\false-positive_1953.yml", "YAML", 0, 0, 0, 2, 0, 0, 1, 3
"d:\IDEWORK\lvmen\src\licensedcode\data\rules\false-positive_1954.yml", "YAML", 0, 0, 0, 2, 0, 0, 1, 3
"d:\IDEWORK\lvmen\src\licensedcode\data\rules\false-positive_1955.yml", "YAML", 0, 0, 0, 2, 0, 0, 1, 3
"d:\IDEWORK\lvmen\src\licensedcode\data\rules\false-positive_1956.yml", "YAML", 0, 0, 0, 2, 0, 0, 1, 3
"d:\IDEWORK\lvmen\src\licensedcode\data\rules\false-positive_1957.yml", "YAML", 0, 0, 0, 2, 0, 0, 1, 3
"d:\IDEWORK\lvmen\src\licensedcode\data\rules\false-positive_1958.yml", "YAML", 0, 0, 0, 2, 0, 0, 1, 3
"d:\IDEWORK\lvmen\src\licensedcode\data\rules\false-positive_1959.yml", "YAML", 0, 0, 0, 2, 0, 0, 1, 3
"d:\IDEWORK\lvmen\src\licensedcode\data\rules\false-positive_196.yml", "YAML", 0, 0, 0, 2, 0, 0, 1, 3
"d:\IDEWORK\lvmen\src\licensedcode\data\rules\false-positive_1960.yml", "YAML", 0, 0, 0, 2, 0, 0, 1, 3
"d:\IDEWORK\lvmen\src\licensedcode\data\rules\false-positive_1961.yml", "YAML", 0, 0, 0, 2, 0, 0, 1, 3
"d:\IDEWORK\lvmen\src\licensedcode\data\rules\false-positive_1962.yml", "YAML", 0, 0, 0, 2, 0, 0, 1, 3
"d:\IDEWORK\lvmen\src\licensedcode\data\rules\false-positive_1963.yml", "YAML", 0, 0, 0, 2, 0, 0, 1, 3
"d:\IDEWORK\lvmen\src\licensedcode\data\rules\false-positive_1964.yml", "YAML", 0, 0, 0, 2, 0, 0, 1, 3
"d:\IDEWORK\lvmen\src\licensedcode\data\rules\false-positive_1965.yml", "YAML", 0, 0, 0, 2, 0, 0, 1, 3
"d:\IDEWORK\lvmen\src\licensedcode\data\rules\false-positive_1966.yml", "YAML", 0, 0, 0, 2, 0, 0, 1, 3
"d:\IDEWORK\lvmen\src\licensedcode\data\rules\false-positive_1967.yml", "YAML", 0, 0, 0, 2, 0, 0, 1, 3
"d:\IDEWORK\lvmen\src\licensedcode\data\rules\false-positive_1968.yml", "YAML", 0, 0, 0, 2, 0, 0, 1, 3
"d:\IDEWORK\lvmen\src\licensedcode\data\rules\false-positive_1969.yml", "YAML", 0, 0, 0, 2, 0, 0, 1, 3
"d:\IDEWORK\lvmen\src\licensedcode\data\rules\false-positive_197.yml", "YAML", 0, 0, 0, 2, 0, 0, 1, 3
"d:\IDEWORK\lvmen\src\licensedcode\data\rules\false-positive_1970.yml", "YAML", 0, 0, 0, 2, 0, 0, 1, 3
"d:\IDEWORK\lvmen\src\licensedcode\data\rules\false-positive_1971.yml", "YAML", 0, 0, 0, 2, 0, 0, 1, 3
"d:\IDEWORK\lvmen\src\licensedcode\data\rules\false-positive_1972.yml", "YAML", 0, 0, 0, 2, 0, 0, 1, 3
"d:\IDEWORK\lvmen\src\licensedcode\data\rules\false-positive_1973.yml", "YAML", 0, 0, 0, 2, 0, 0, 1, 3
"d:\IDEWORK\lvmen\src\licensedcode\data\rules\false-positive_1974.yml", "YAML", 0, 0, 0, 2, 0, 0, 1, 3
"d:\IDEWORK\lvmen\src\licensedcode\data\rules\false-positive_1975.yml", "YAML", 0, 0, 0, 2, 0, 0, 1, 3
"d:\IDEWORK\lvmen\src\licensedcode\data\rules\false-positive_1976.yml", "YAML", 0, 0, 0, 2, 0, 0, 1, 3
"d:\IDEWORK\lvmen\src\licensedcode\data\rules\false-positive_1977.yml", "YAML", 0, 0, 0, 2, 0, 0, 1, 3
"d:\IDEWORK\lvmen\src\licensedcode\data\rules\false-positive_1978.yml", "YAML", 0, 0, 0, 2, 0, 0, 1, 3
"d:\IDEWORK\lvmen\src\licensedcode\data\rules\false-positive_1979.yml", "YAML", 0, 0, 0, 2, 0, 0, 1, 3
"d:\IDEWORK\lvmen\src\licensedcode\data\rules\false-positive_198.yml", "YAML", 0, 0, 0, 3, 0, 0, 1, 4
"d:\IDEWORK\lvmen\src\licensedcode\data\rules\false-positive_1980.yml", "YAML", 0, 0, 0, 2, 0, 0, 1, 3
"d:\IDEWORK\lvmen\src\licensedcode\data\rules\false-positive_1981.yml", "YAML", 0, 0, 0, 2, 0, 0, 1, 3
"d:\IDEWORK\lvmen\src\licensedcode\data\rules\false-positive_1982.yml", "YAML", 0, 0, 0, 2, 0, 0, 1, 3
"d:\IDEWORK\lvmen\src\licensedcode\data\rules\false-positive_1983.yml", "YAML", 0, 0, 0, 2, 0, 0, 1, 3
"d:\IDEWORK\lvmen\src\licensedcode\data\rules\false-positive_1984.yml", "YAML", 0, 0, 0, 2, 0, 0, 1, 3
"d:\IDEWORK\lvmen\src\licensedcode\data\rules\false-positive_1985.yml", "YAML", 0, 0, 0, 2, 0, 0, 1, 3
"d:\IDEWORK\lvmen\src\licensedcode\data\rules\false-positive_1986.yml", "YAML", 0, 0, 0, 2, 0, 0, 1, 3
"d:\IDEWORK\lvmen\src\licensedcode\data\rules\false-positive_1987.yml", "YAML", 0, 0, 0, 2, 0, 0, 1, 3
"d:\IDEWORK\lvmen\src\licensedcode\data\rules\false-positive_1988.yml", "YAML", 0, 0, 0, 2, 0, 0, 1, 3
"d:\IDEWORK\lvmen\src\licensedcode\data\rules\false-positive_1989.yml", "YAML", 0, 0, 0, 2, 0, 0, 1, 3
"d:\IDEWORK\lvmen\src\licensedcode\data\rules\false-positive_199.yml", "YAML", 0, 0, 0, 2, 0, 0, 1, 3
"d:\IDEWORK\lvmen\src\licensedcode\data\rules\false-positive_1990.yml", "YAML", 0, 0, 0, 2, 0, 0, 1, 3
"d:\IDEWORK\lvmen\src\licensedcode\data\rules\false-positive_1991.yml", "YAML", 0, 0, 0, 2, 0, 0, 1, 3
"d:\IDEWORK\lvmen\src\licensedcode\data\rules\false-positive_1992.yml", "YAML", 0, 0, 0, 2, 0, 0, 1, 3
"d:\IDEWORK\lvmen\src\licensedcode\data\rules\false-positive_1993.yml", "YAML", 0, 0, 0, 2, 0, 0, 1, 3
"d:\IDEWORK\lvmen\src\licensedcode\data\rules\false-positive_1994.yml", "YAML", 0, 0, 0, 2, 0, 0, 1, 3
"d:\IDEWORK\lvmen\src\licensedcode\data\rules\false-positive_1995.yml", "YAML", 0, 0, 0, 2, 0, 0, 1, 3
"d:\IDEWORK\lvmen\src\licensedcode\data\rules\false-positive_1996.yml", "YAML", 0, 0, 0, 2, 0, 0, 1, 3
"d:\IDEWORK\lvmen\src\licensedcode\data\rules\false-positive_1997.yml", "YAML", 0, 0, 0, 2, 0, 0, 1, 3
"d:\IDEWORK\lvmen\src\licensedcode\data\rules\false-positive_1998.yml", "YAML", 0, 0, 0, 2, 0, 0, 1, 3
"d:\IDEWORK\lvmen\src\licensedcode\data\rules\false-positive_1999.yml", "YAML", 0, 0, 0, 2, 0, 0, 1, 3
"d:\IDEWORK\lvmen\src\licensedcode\data\rules\false-positive_2.yml", "YAML", 0, 0, 0, 2, 0, 0, 1, 3
"d:\IDEWORK\lvmen\src\licensedcode\data\rules\false-positive_20.yml", "YAML", 0, 0, 0, 2, 0, 0, 1, 3
"d:\IDEWORK\lvmen\src\licensedcode\data\rules\false-positive_200.yml", "YAML", 0, 0, 0, 2, 0, 0, 1, 3
"d:\IDEWORK\lvmen\src\licensedcode\data\rules\false-positive_2000.yml", "YAML", 0, 0, 0, 2, 0, 0, 1, 3
"d:\IDEWORK\lvmen\src\licensedcode\data\rules\false-positive_2001.yml", "YAML", 0, 0, 0, 2, 0, 0, 1, 3
"d:\IDEWORK\lvmen\src\licensedcode\data\rules\false-positive_2002.yml", "YAML", 0, 0, 0, 2, 0, 0, 1, 3
"d:\IDEWORK\lvmen\src\licensedcode\data\rules\false-positive_2003.yml", "YAML", 0, 0, 0, 2, 0, 0, 1, 3
"d:\IDEWORK\lvmen\src\licensedcode\data\rules\false-positive_2004.yml", "YAML", 0, 0, 0, 2, 0, 0, 1, 3
"d:\IDEWORK\lvmen\src\licensedcode\data\rules\false-positive_2005.yml", "YAML", 0, 0, 0, 2, 0, 0, 1, 3
"d:\IDEWORK\lvmen\src\licensedcode\data\rules\false-positive_2006.yml", "YAML", 0, 0, 0, 2, 0, 0, 1, 3
"d:\IDEWORK\lvmen\src\licensedcode\data\rules\false-positive_2007.yml", "YAML", 0, 0, 0, 2, 0, 0, 1, 3
"d:\IDEWORK\lvmen\src\licensedcode\data\rules\false-positive_2008.yml", "YAML", 0, 0, 0, 2, 0, 0, 1, 3
"d:\IDEWORK\lvmen\src\licensedcode\data\rules\false-positive_2009.yml", "YAML", 0, 0, 0, 2, 0, 0, 1, 3
"d:\IDEWORK\lvmen\src\licensedcode\data\rules\false-positive_201.yml", "YAML", 0, 0, 0, 3, 0, 0, 1, 4
"d:\IDEWORK\lvmen\src\licensedcode\data\rules\false-positive_2010.yml", "YAML", 0, 0, 0, 2, 0, 0, 1, 3
"d:\IDEWORK\lvmen\src\licensedcode\data\rules\false-positive_2011.yml", "YAML", 0, 0, 0, 2, 0, 0, 1, 3
"d:\IDEWORK\lvmen\src\licensedcode\data\rules\false-positive_2012.yml", "YAML", 0, 0, 0, 2, 0, 0, 1, 3
"d:\IDEWORK\lvmen\src\licensedcode\data\rules\false-positive_2013.yml", "YAML", 0, 0, 0, 2, 0, 0, 1, 3
"d:\IDEWORK\lvmen\src\licensedcode\data\rules\false-positive_2014.yml", "YAML", 0, 0, 0, 2, 0, 0, 1, 3
"d:\IDEWORK\lvmen\src\licensedcode\data\rules\false-positive_2015.yml", "YAML", 0, 0, 0, 2, 0, 0, 1, 3
"d:\IDEWORK\lvmen\src\licensedcode\data\rules\false-positive_2016.yml", "YAML", 0, 0, 0, 2, 0, 0, 1, 3
"d:\IDEWORK\lvmen\src\licensedcode\data\rules\false-positive_2017.yml", "YAML", 0, 0, 0, 2, 0, 0, 1, 3
"d:\IDEWORK\lvmen\src\licensedcode\data\rules\false-positive_2018.yml", "YAML", 0, 0, 0, 2, 0, 0, 1, 3
"d:\IDEWORK\lvmen\src\licensedcode\data\rules\false-positive_2019.yml", "YAML", 0, 0, 0, 2, 0, 0, 1, 3
"d:\IDEWORK\lvmen\src\licensedcode\data\rules\false-positive_202.yml", "YAML", 0, 0, 0, 2, 0, 0, 1, 3
"d:\IDEWORK\lvmen\src\licensedcode\data\rules\false-positive_2020.yml", "YAML", 0, 0, 0, 2, 0, 0, 1, 3
"d:\IDEWORK\lvmen\src\licensedcode\data\rules\false-positive_2021.yml", "YAML", 0, 0, 0, 2, 0, 0, 1, 3
"d:\IDEWORK\lvmen\src\licensedcode\data\rules\false-positive_2022.yml", "YAML", 0, 0, 0, 2, 0, 0, 1, 3
"d:\IDEWORK\lvmen\src\licensedcode\data\rules\false-positive_2023.yml", "YAML", 0, 0, 0, 2, 0, 0, 1, 3
"d:\IDEWORK\lvmen\src\licensedcode\data\rules\false-positive_2024.yml", "YAML", 0, 0, 0, 2, 0, 0, 1, 3
"d:\IDEWORK\lvmen\src\licensedcode\data\rules\false-positive_2025.yml", "YAML", 0, 0, 0, 2, 0, 0, 1, 3
"d:\IDEWORK\lvmen\src\licensedcode\data\rules\false-positive_2026.yml", "YAML", 0, 0, 0, 2, 0, 0, 1, 3
"d:\IDEWORK\lvmen\src\licensedcode\data\rules\false-positive_2027.yml", "YAML", 0, 0, 0, 2, 0, 0, 1, 3
"d:\IDEWORK\lvmen\src\licensedcode\data\rules\false-positive_2028.yml", "YAML", 0, 0, 0, 2, 0, 0, 1, 3
"d:\IDEWORK\lvmen\src\licensedcode\data\rules\false-positive_2029.yml", "YAML", 0, 0, 0, 2, 0, 0, 1, 3
"d:\IDEWORK\lvmen\src\licensedcode\data\rules\false-positive_203.yml", "YAML", 0, 0, 0, 2, 0, 0, 1, 3
"d:\IDEWORK\lvmen\src\licensedcode\data\rules\false-positive_2030.yml", "YAML", 0, 0, 0, 2, 0, 0, 1, 3
"d:\IDEWORK\lvmen\src\licensedcode\data\rules\false-positive_2031.yml", "YAML", 0, 0, 0, 2, 0, 0, 1, 3
"d:\IDEWORK\lvmen\src\licensedcode\data\rules\false-positive_2032.yml", "YAML", 0, 0, 0, 2, 0, 0, 1, 3
"d:\IDEWORK\lvmen\src\licensedcode\data\rules\false-positive_2033.yml", "YAML", 0, 0, 0, 2, 0, 0, 1, 3
"d:\IDEWORK\lvmen\src\licensedcode\data\rules\false-positive_2034.yml", "YAML", 0, 0, 0, 2, 0, 0, 1, 3
"d:\IDEWORK\lvmen\src\licensedcode\data\rules\false-positive_2035.yml", "YAML", 0, 0, 0, 2, 0, 0, 1, 3
"d:\IDEWORK\lvmen\src\licensedcode\data\rules\false-positive_2036.yml", "YAML", 0, 0, 0, 2, 0, 0, 1, 3
"d:\IDEWORK\lvmen\src\licensedcode\data\rules\false-positive_2037.yml", "YAML", 0, 0, 0, 2, 0, 0, 1, 3
"d:\IDEWORK\lvmen\src\licensedcode\data\rules\false-positive_2038.yml", "YAML", 0, 0, 0, 2, 0, 0, 1, 3
"d:\IDEWORK\lvmen\src\licensedcode\data\rules\false-positive_2039.yml", "YAML", 0, 0, 0, 2, 0, 0, 1, 3
"d:\IDEWORK\lvmen\src\licensedcode\data\rules\false-positive_204.yml", "YAML", 0, 0, 0, 3, 0, 0, 1, 4
"d:\IDEWORK\lvmen\src\licensedcode\data\rules\false-positive_2040.yml", "YAML", 0, 0, 0, 2, 0, 0, 1, 3
"d:\IDEWORK\lvmen\src\licensedcode\data\rules\false-positive_2041.yml", "YAML", 0, 0, 0, 2, 0, 0, 1, 3
"d:\IDEWORK\lvmen\src\licensedcode\data\rules\false-positive_2042.yml", "YAML", 0, 0, 0, 2, 0, 0, 1, 3
"d:\IDEWORK\lvmen\src\licensedcode\data\rules\false-positive_2043.yml", "YAML", 0, 0, 0, 2, 0, 0, 1, 3
"d:\IDEWORK\lvmen\src\licensedcode\data\rules\false-positive_2044.yml", "YAML", 0, 0, 0, 2, 0, 0, 1, 3
"d:\IDEWORK\lvmen\src\licensedcode\data\rules\false-positive_2045.yml", "YAML", 0, 0, 0, 2, 0, 0, 1, 3
"d:\IDEWORK\lvmen\src\licensedcode\data\rules\false-positive_2046.yml", "YAML", 0, 0, 0, 2, 0, 0, 1, 3
"d:\IDEWORK\lvmen\src\licensedcode\data\rules\false-positive_2047.yml", "YAML", 0, 0, 0, 2, 0, 0, 1, 3
"d:\IDEWORK\lvmen\src\licensedcode\data\rules\false-positive_2048.yml", "YAML", 0, 0, 0, 2, 0, 0, 1, 3
"d:\IDEWORK\lvmen\src\licensedcode\data\rules\false-positive_2049.yml", "YAML", 0, 0, 0, 2, 0, 0, 1, 3
"d:\IDEWORK\lvmen\src\licensedcode\data\rules\false-positive_205.yml", "YAML", 0, 0, 0, 2, 0, 0, 1, 3
"d:\IDEWORK\lvmen\src\licensedcode\data\rules\false-positive_2050.yml", "YAML", 0, 0, 0, 2, 0, 0, 1, 3
"d:\IDEWORK\lvmen\src\licensedcode\data\rules\false-positive_2051.yml", "YAML", 0, 0, 0, 2, 0, 0, 1, 3
"d:\IDEWORK\lvmen\src\licensedcode\data\rules\false-positive_2052.yml", "YAML", 0, 0, 0, 2, 0, 0, 1, 3
"d:\IDEWORK\lvmen\src\licensedcode\data\rules\false-positive_2053.yml", "YAML", 0, 0, 0, 2, 0, 0, 1, 3
"d:\IDEWORK\lvmen\src\licensedcode\data\rules\false-positive_2054.yml", "YAML", 0, 0, 0, 2, 0, 0, 1, 3
"d:\IDEWORK\lvmen\src\licensedcode\data\rules\false-positive_2055.yml", "YAML", 0, 0, 0, 2, 0, 0, 1, 3
"d:\IDEWORK\lvmen\src\licensedcode\data\rules\false-positive_2056.yml", "YAML", 0, 0, 0, 2, 0, 0, 1, 3
"d:\IDEWORK\lvmen\src\licensedcode\data\rules\false-positive_2057.yml", "YAML", 0, 0, 0, 2, 0, 0, 1, 3
"d:\IDEWORK\lvmen\src\licensedcode\data\rules\false-positive_2058.yml", "YAML", 0, 0, 0, 2, 0, 0, 1, 3
"d:\IDEWORK\lvmen\src\licensedcode\data\rules\false-positive_2059.yml", "YAML", 0, 0, 0, 2, 0, 0, 1, 3
"d:\IDEWORK\lvmen\src\licensedcode\data\rules\false-positive_206.yml", "YAML", 0, 0, 0, 2, 0, 0, 1, 3
"d:\IDEWORK\lvmen\src\licensedcode\data\rules\false-positive_2060.yml", "YAML", 0, 0, 0, 2, 0, 0, 1, 3
"d:\IDEWORK\lvmen\src\licensedcode\data\rules\false-positive_2061.yml", "YAML", 0, 0, 0, 2, 0, 0, 1, 3
"d:\IDEWORK\lvmen\src\licensedcode\data\rules\false-positive_2062.yml", "YAML", 0, 0, 0, 2, 0, 0, 1, 3
"d:\IDEWORK\lvmen\src\licensedcode\data\rules\false-positive_2063.yml", "YAML", 0, 0, 0, 2, 0, 0, 1, 3
"d:\IDEWORK\lvmen\src\licensedcode\data\rules\false-positive_2064.yml", "YAML", 0, 0, 0, 2, 0, 0, 1, 3
"d:\IDEWORK\lvmen\src\licensedcode\data\rules\false-positive_2065.yml", "YAML", 0, 0, 0, 2, 0, 0, 1, 3
"d:\IDEWORK\lvmen\src\licensedcode\data\rules\false-positive_2066.yml", "YAML", 0, 0, 0, 2, 0, 0, 1, 3
"d:\IDEWORK\lvmen\src\licensedcode\data\rules\false-positive_2067.yml", "YAML", 0, 0, 0, 2, 0, 0, 1, 3
"d:\IDEWORK\lvmen\src\licensedcode\data\rules\false-positive_2068.yml", "YAML", 0, 0, 0, 2, 0, 0, 1, 3
"d:\IDEWORK\lvmen\src\licensedcode\data\rules\false-positive_2069.yml", "YAML", 0, 0, 0, 2, 0, 0, 1, 3
"d:\IDEWORK\lvmen\src\licensedcode\data\rules\false-positive_207.yml", "YAML", 0, 0, 0, 2, 0, 0, 1, 3
"d:\IDEWORK\lvmen\src\licensedcode\data\rules\false-positive_2070.yml", "YAML", 0, 0, 0, 2, 0, 0, 1, 3
"d:\IDEWORK\lvmen\src\licensedcode\data\rules\false-positive_2071.yml", "YAML", 0, 0, 0, 2, 0, 0, 1, 3
"d:\IDEWORK\lvmen\src\licensedcode\data\rules\false-positive_2072.yml", "YAML", 0, 0, 0, 2, 0, 0, 1, 3
"d:\IDEWORK\lvmen\src\licensedcode\data\rules\false-positive_2073.yml", "YAML", 0, 0, 0, 2, 0, 0, 1, 3
"d:\IDEWORK\lvmen\src\licensedcode\data\rules\false-positive_2074.yml", "YAML", 0, 0, 0, 2, 0, 0, 1, 3
"d:\IDEWORK\lvmen\src\licensedcode\data\rules\false-positive_2075.yml", "YAML", 0, 0, 0, 2, 0, 0, 1, 3
"d:\IDEWORK\lvmen\src\licensedcode\data\rules\false-positive_2076.yml", "YAML", 0, 0, 0, 2, 0, 0, 1, 3
"d:\IDEWORK\lvmen\src\licensedcode\data\rules\false-positive_2077.yml", "YAML", 0, 0, 0, 2, 0, 0, 1, 3
"d:\IDEWORK\lvmen\src\licensedcode\data\rules\false-positive_2078.yml", "YAML", 0, 0, 0, 2, 0, 0, 1, 3
"d:\IDEWORK\lvmen\src\licensedcode\data\rules\false-positive_2079.yml", "YAML", 0, 0, 0, 2, 0, 0, 1, 3
"d:\IDEWORK\lvmen\src\licensedcode\data\rules\false-positive_208.yml", "YAML", 0, 0, 0, 3, 0, 0, 1, 4
"d:\IDEWORK\lvmen\src\licensedcode\data\rules\false-positive_2080.yml", "YAML", 0, 0, 0, 2, 0, 0, 1, 3
"d:\IDEWORK\lvmen\src\licensedcode\data\rules\false-positive_2081.yml", "YAML", 0, 0, 0, 2, 0, 0, 1, 3
"d:\IDEWORK\lvmen\src\licensedcode\data\rules\false-positive_2082.yml", "YAML", 0, 0, 0, 2, 0, 0, 1, 3
"d:\IDEWORK\lvmen\src\licensedcode\data\rules\false-positive_2083.yml", "YAML", 0, 0, 0, 2, 0, 0, 1, 3
"d:\IDEWORK\lvmen\src\licensedcode\data\rules\false-positive_2084.yml", "YAML", 0, 0, 0, 2, 0, 0, 1, 3
"d:\IDEWORK\lvmen\src\licensedcode\data\rules\false-positive_2085.yml", "YAML", 0, 0, 0, 2, 0, 0, 1, 3
"d:\IDEWORK\lvmen\src\licensedcode\data\rules\false-positive_2086.yml", "YAML", 0, 0, 0, 2, 0, 0, 1, 3
"d:\IDEWORK\lvmen\src\licensedcode\data\rules\false-positive_2087.yml", "YAML", 0, 0, 0, 2, 0, 0, 1, 3
"d:\IDEWORK\lvmen\src\licensedcode\data\rules\false-positive_2088.yml", "YAML", 0, 0, 0, 2, 0, 0, 1, 3
"d:\IDEWORK\lvmen\src\licensedcode\data\rules\false-positive_2089.yml", "YAML", 0, 0, 0, 2, 0, 0, 1, 3
"d:\IDEWORK\lvmen\src\licensedcode\data\rules\false-positive_209.yml", "YAML", 0, 0, 0, 2, 0, 0, 1, 3
"d:\IDEWORK\lvmen\src\licensedcode\data\rules\false-positive_2090.yml", "YAML", 0, 0, 0, 2, 0, 0, 1, 3
"d:\IDEWORK\lvmen\src\licensedcode\data\rules\false-positive_2091.yml", "YAML", 0, 0, 0, 2, 0, 0, 1, 3
"d:\IDEWORK\lvmen\src\licensedcode\data\rules\false-positive_2092.yml", "YAML", 0, 0, 0, 2, 0, 0, 1, 3
"d:\IDEWORK\lvmen\src\licensedcode\data\rules\false-positive_2093.yml", "YAML", 0, 0, 0, 2, 0, 0, 1, 3
"d:\IDEWORK\lvmen\src\licensedcode\data\rules\false-positive_2094.yml", "YAML", 0, 0, 0, 2, 0, 0, 1, 3
"d:\IDEWORK\lvmen\src\licensedcode\data\rules\false-positive_2095.yml", "YAML", 0, 0, 0, 2, 0, 0, 1, 3
"d:\IDEWORK\lvmen\src\licensedcode\data\rules\false-positive_2096.yml", "YAML", 0, 0, 0, 2, 0, 0, 1, 3
"d:\IDEWORK\lvmen\src\licensedcode\data\rules\false-positive_2097.yml", "YAML", 0, 0, 0, 2, 0, 0, 1, 3
"d:\IDEWORK\lvmen\src\licensedcode\data\rules\false-positive_2098.yml", "YAML", 0, 0, 0, 2, 0, 0, 1, 3
"d:\IDEWORK\lvmen\src\licensedcode\data\rules\false-positive_2099.yml", "YAML", 0, 0, 0, 2, 0, 0, 1, 3
"d:\IDEWORK\lvmen\src\licensedcode\data\rules\false-positive_21.yml", "YAML", 0, 0, 0, 2, 0, 0, 1, 3
"d:\IDEWORK\lvmen\src\licensedcode\data\rules\false-positive_210.yml", "YAML", 0, 0, 0, 2, 0, 0, 1, 3
"d:\IDEWORK\lvmen\src\licensedcode\data\rules\false-positive_2100.yml", "YAML", 0, 0, 0, 2, 0, 0, 1, 3
"d:\IDEWORK\lvmen\src\licensedcode\data\rules\false-positive_2101.yml", "YAML", 0, 0, 0, 2, 0, 0, 1, 3
"d:\IDEWORK\lvmen\src\licensedcode\data\rules\false-positive_2102.yml", "YAML", 0, 0, 0, 2, 0, 0, 1, 3
"d:\IDEWORK\lvmen\src\licensedcode\data\rules\false-positive_2103.yml", "YAML", 0, 0, 0, 2, 0, 0, 1, 3
"d:\IDEWORK\lvmen\src\licensedcode\data\rules\false-positive_2104.yml", "YAML", 0, 0, 0, 2, 0, 0, 1, 3
"d:\IDEWORK\lvmen\src\licensedcode\data\rules\false-positive_2105.yml", "YAML", 0, 0, 0, 2, 0, 0, 1, 3
"d:\IDEWORK\lvmen\src\licensedcode\data\rules\false-positive_2106.yml", "YAML", 0, 0, 0, 2, 0, 0, 1, 3
"d:\IDEWORK\lvmen\src\licensedcode\data\rules\false-positive_2107.yml", "YAML", 0, 0, 0, 2, 0, 0, 1, 3
"d:\IDEWORK\lvmen\src\licensedcode\data\rules\false-positive_2108.yml", "YAML", 0, 0, 0, 2, 0, 0, 1, 3
"d:\IDEWORK\lvmen\src\licensedcode\data\rules\false-positive_2109.yml", "YAML", 0, 0, 0, 2, 0, 0, 1, 3
"d:\IDEWORK\lvmen\src\licensedcode\data\rules\false-positive_211.yml", "YAML", 0, 0, 0, 2, 0, 0, 1, 3
"d:\IDEWORK\lvmen\src\licensedcode\data\rules\false-positive_2110.yml", "YAML", 0, 0, 0, 2, 0, 0, 1, 3
"d:\IDEWORK\lvmen\src\licensedcode\data\rules\false-positive_2111.yml", "YAML", 0, 0, 0, 2, 0, 0, 1, 3
"d:\IDEWORK\lvmen\src\licensedcode\data\rules\false-positive_2112.yml", "YAML", 0, 0, 0, 2, 0, 0, 1, 3
"d:\IDEWORK\lvmen\src\licensedcode\data\rules\false-positive_2113.yml", "YAML", 0, 0, 0, 2, 0, 0, 1, 3
"d:\IDEWORK\lvmen\src\licensedcode\data\rules\false-positive_2114.yml", "YAML", 0, 0, 0, 2, 0, 0, 1, 3
"d:\IDEWORK\lvmen\src\licensedcode\data\rules\false-positive_2115.yml", "YAML", 0, 0, 0, 2, 0, 0, 1, 3
"d:\IDEWORK\lvmen\src\licensedcode\data\rules\false-positive_2116.yml", "YAML", 0, 0, 0, 2, 0, 0, 1, 3
"d:\IDEWORK\lvmen\src\licensedcode\data\rules\false-positive_2117.yml", "YAML", 0, 0, 0, 2, 0, 0, 1, 3
"d:\IDEWORK\lvmen\src\licensedcode\data\rules\false-positive_2118.yml", "YAML", 0, 0, 0, 2, 0, 0, 1, 3
"d:\IDEWORK\lvmen\src\licensedcode\data\rules\false-positive_2119.yml", "YAML", 0, 0, 0, 2, 0, 0, 1, 3
"d:\IDEWORK\lvmen\src\licensedcode\data\rules\false-positive_212.yml", "YAML", 0, 0, 0, 2, 0, 0, 1, 3
"d:\IDEWORK\lvmen\src\licensedcode\data\rules\false-positive_2120.yml", "YAML", 0, 0, 0, 2, 0, 0, 1, 3
"d:\IDEWORK\lvmen\src\licensedcode\data\rules\false-positive_2121.yml", "YAML", 0, 0, 0, 2, 0, 0, 1, 3
"d:\IDEWORK\lvmen\src\licensedcode\data\rules\false-positive_2122.yml", "YAML", 0, 0, 0, 2, 0, 0, 1, 3
"d:\IDEWORK\lvmen\src\licensedcode\data\rules\false-positive_2123.yml", "YAML", 0, 0, 0, 2, 0, 0, 1, 3
"d:\IDEWORK\lvmen\src\licensedcode\data\rules\false-positive_2124.yml", "YAML", 0, 0, 0, 2, 0, 0, 1, 3
"d:\IDEWORK\lvmen\src\licensedcode\data\rules\false-positive_2125.yml", "YAML", 0, 0, 0, 2, 0, 0, 1, 3
"d:\IDEWORK\lvmen\src\licensedcode\data\rules\false-positive_2126.yml", "YAML", 0, 0, 0, 2, 0, 0, 1, 3
"d:\IDEWORK\lvmen\src\licensedcode\data\rules\false-positive_2127.yml", "YAML", 0, 0, 0, 2, 0, 0, 1, 3
"d:\IDEWORK\lvmen\src\licensedcode\data\rules\false-positive_2128.yml", "YAML", 0, 0, 0, 2, 0, 0, 1, 3
"d:\IDEWORK\lvmen\src\licensedcode\data\rules\false-positive_2129.yml", "YAML", 0, 0, 0, 2, 0, 0, 1, 3
"d:\IDEWORK\lvmen\src\licensedcode\data\rules\false-positive_213.yml", "YAML", 0, 0, 0, 2, 0, 0, 1, 3
"d:\IDEWORK\lvmen\src\licensedcode\data\rules\false-positive_2130.yml", "YAML", 0, 0, 0, 2, 0, 0, 1, 3
"d:\IDEWORK\lvmen\src\licensedcode\data\rules\false-positive_2131.yml", "YAML", 0, 0, 0, 2, 0, 0, 1, 3
"d:\IDEWORK\lvmen\src\licensedcode\data\rules\false-positive_2132.yml", "YAML", 0, 0, 0, 2, 0, 0, 1, 3
"d:\IDEWORK\lvmen\src\licensedcode\data\rules\false-positive_2133.yml", "YAML", 0, 0, 0, 2, 0, 0, 1, 3
"d:\IDEWORK\lvmen\src\licensedcode\data\rules\false-positive_2134.yml", "YAML", 0, 0, 0, 2, 0, 0, 1, 3
"d:\IDEWORK\lvmen\src\licensedcode\data\rules\false-positive_2135.yml", "YAML", 0, 0, 0, 2, 0, 0, 1, 3
"d:\IDEWORK\lvmen\src\licensedcode\data\rules\false-positive_2136.yml", "YAML", 0, 0, 0, 2, 0, 0, 1, 3
"d:\IDEWORK\lvmen\src\licensedcode\data\rules\false-positive_2137.yml", "YAML", 0, 0, 0, 2, 0, 0, 1, 3
"d:\IDEWORK\lvmen\src\licensedcode\data\rules\false-positive_2138.yml", "YAML", 0, 0, 0, 2, 0, 0, 1, 3
"d:\IDEWORK\lvmen\src\licensedcode\data\rules\false-positive_2139.yml", "YAML", 0, 0, 0, 2, 0, 0, 1, 3
"d:\IDEWORK\lvmen\src\licensedcode\data\rules\false-positive_214.yml", "YAML", 0, 0, 0, 2, 0, 0, 1, 3
"d:\IDEWORK\lvmen\src\licensedcode\data\rules\false-positive_2140.yml", "YAML", 0, 0, 0, 2, 0, 0, 1, 3
"d:\IDEWORK\lvmen\src\licensedcode\data\rules\false-positive_2141.yml", "YAML", 0, 0, 0, 2, 0, 0, 1, 3
"d:\IDEWORK\lvmen\src\licensedcode\data\rules\false-positive_2142.yml", "YAML", 0, 0, 0, 2, 0, 0, 1, 3
"d:\IDEWORK\lvmen\src\licensedcode\data\rules\false-positive_2143.yml", "YAML", 0, 0, 0, 2, 0, 0, 1, 3
"d:\IDEWORK\lvmen\src\licensedcode\data\rules\false-positive_2144.yml", "YAML", 0, 0, 0, 2, 0, 0, 1, 3
"d:\IDEWORK\lvmen\src\licensedcode\data\rules\false-positive_2145.yml", "YAML", 0, 0, 0, 2, 0, 0, 1, 3
"d:\IDEWORK\lvmen\src\licensedcode\data\rules\false-positive_2146.yml", "YAML", 0, 0, 0, 2, 0, 0, 1, 3
"d:\IDEWORK\lvmen\src\licensedcode\data\rules\false-positive_2147.yml", "YAML", 0, 0, 0, 2, 0, 0, 1, 3
"d:\IDEWORK\lvmen\src\licensedcode\data\rules\false-positive_2148.yml", "YAML", 0, 0, 0, 2, 0, 0, 1, 3
"d:\IDEWORK\lvmen\src\licensedcode\data\rules\false-positive_2149.yml", "YAML", 0, 0, 0, 2, 0, 0, 1, 3
"d:\IDEWORK\lvmen\src\licensedcode\data\rules\false-positive_215.yml", "YAML", 0, 0, 0, 3, 0, 0, 1, 4
"d:\IDEWORK\lvmen\src\licensedcode\data\rules\false-positive_2150.yml", "YAML", 0, 0, 0, 2, 0, 0, 1, 3
"d:\IDEWORK\lvmen\src\licensedcode\data\rules\false-positive_2151.yml", "YAML", 0, 0, 0, 2, 0, 0, 1, 3
"d:\IDEWORK\lvmen\src\licensedcode\data\rules\false-positive_2152.yml", "YAML", 0, 0, 0, 2, 0, 0, 1, 3
"d:\IDEWORK\lvmen\src\licensedcode\data\rules\false-positive_2153.yml", "YAML", 0, 0, 0, 2, 0, 0, 1, 3
"d:\IDEWORK\lvmen\src\licensedcode\data\rules\false-positive_2154.yml", "YAML", 0, 0, 0, 2, 0, 0, 1, 3
"d:\IDEWORK\lvmen\src\licensedcode\data\rules\false-positive_2155.yml", "YAML", 0, 0, 0, 2, 0, 0, 1, 3
"d:\IDEWORK\lvmen\src\licensedcode\data\rules\false-positive_2156.yml", "YAML", 0, 0, 0, 2, 0, 0, 1, 3
"d:\IDEWORK\lvmen\src\licensedcode\data\rules\false-positive_2157.yml", "YAML", 0, 0, 0, 2, 0, 0, 1, 3
"d:\IDEWORK\lvmen\src\licensedcode\data\rules\false-positive_2158.yml", "YAML", 0, 0, 0, 2, 0, 0, 1, 3
"d:\IDEWORK\lvmen\src\licensedcode\data\rules\false-positive_2159.yml", "YAML", 0, 0, 0, 2, 0, 0, 1, 3
"d:\IDEWORK\lvmen\src\licensedcode\data\rules\false-positive_216.yml", "YAML", 0, 0, 0, 2, 0, 0, 1, 3
"d:\IDEWORK\lvmen\src\licensedcode\data\rules\false-positive_2160.yml", "YAML", 0, 0, 0, 2, 0, 0, 1, 3
"d:\IDEWORK\lvmen\src\licensedcode\data\rules\false-positive_2161.yml", "YAML", 0, 0, 0, 2, 0, 0, 1, 3
"d:\IDEWORK\lvmen\src\licensedcode\data\rules\false-positive_2162.yml", "YAML", 0, 0, 0, 2, 0, 0, 1, 3
"d:\IDEWORK\lvmen\src\licensedcode\data\rules\false-positive_2163.yml", "YAML", 0, 0, 0, 2, 0, 0, 1, 3
"d:\IDEWORK\lvmen\src\licensedcode\data\rules\false-positive_2164.yml", "YAML", 0, 0, 0, 2, 0, 0, 1, 3
"d:\IDEWORK\lvmen\src\licensedcode\data\rules\false-positive_2165.yml", "YAML", 0, 0, 0, 2, 0, 0, 1, 3
"d:\IDEWORK\lvmen\src\licensedcode\data\rules\false-positive_2166.yml", "YAML", 0, 0, 0, 2, 0, 0, 1, 3
"d:\IDEWORK\lvmen\src\licensedcode\data\rules\false-positive_2167.yml", "YAML", 0, 0, 0, 2, 0, 0, 1, 3
"d:\IDEWORK\lvmen\src\licensedcode\data\rules\false-positive_2168.yml", "YAML", 0, 0, 0, 2, 0, 0, 1, 3
"d:\IDEWORK\lvmen\src\licensedcode\data\rules\false-positive_2169.yml", "YAML", 0, 0, 0, 2, 0, 0, 1, 3
"d:\IDEWORK\lvmen\src\licensedcode\data\rules\false-positive_217.yml", "YAML", 0, 0, 0, 3, 0, 0, 1, 4
"d:\IDEWORK\lvmen\src\licensedcode\data\rules\false-positive_2170.yml", "YAML", 0, 0, 0, 2, 0, 0, 1, 3
"d:\IDEWORK\lvmen\src\licensedcode\data\rules\false-positive_2171.yml", "YAML", 0, 0, 0, 2, 0, 0, 1, 3
"d:\IDEWORK\lvmen\src\licensedcode\data\rules\false-positive_2172.yml", "YAML", 0, 0, 0, 2, 0, 0, 1, 3
"d:\IDEWORK\lvmen\src\licensedcode\data\rules\false-positive_2173.yml", "YAML", 0, 0, 0, 2, 0, 0, 1, 3
"d:\IDEWORK\lvmen\src\licensedcode\data\rules\false-positive_2174.yml", "YAML", 0, 0, 0, 2, 0, 0, 1, 3
"d:\IDEWORK\lvmen\src\licensedcode\data\rules\false-positive_2175.yml", "YAML", 0, 0, 0, 2, 0, 0, 1, 3
"d:\IDEWORK\lvmen\src\licensedcode\data\rules\false-positive_2176.yml", "YAML", 0, 0, 0, 2, 0, 0, 1, 3
"d:\IDEWORK\lvmen\src\licensedcode\data\rules\false-positive_2177.yml", "YAML", 0, 0, 0, 2, 0, 0, 1, 3
"d:\IDEWORK\lvmen\src\licensedcode\data\rules\false-positive_2178.yml", "YAML", 0, 0, 0, 2, 0, 0, 1, 3
"d:\IDEWORK\lvmen\src\licensedcode\data\rules\false-positive_2179.yml", "YAML", 0, 0, 0, 2, 0, 0, 1, 3
"d:\IDEWORK\lvmen\src\licensedcode\data\rules\false-positive_218.yml", "YAML", 0, 0, 0, 2, 0, 0, 1, 3
"d:\IDEWORK\lvmen\src\licensedcode\data\rules\false-positive_2180.yml", "YAML", 0, 0, 0, 2, 0, 0, 1, 3
"d:\IDEWORK\lvmen\src\licensedcode\data\rules\false-positive_2181.yml", "YAML", 0, 0, 0, 2, 0, 0, 1, 3
"d:\IDEWORK\lvmen\src\licensedcode\data\rules\false-positive_2182.yml", "YAML", 0, 0, 0, 2, 0, 0, 1, 3
"d:\IDEWORK\lvmen\src\licensedcode\data\rules\false-positive_2183.yml", "YAML", 0, 0, 0, 2, 0, 0, 1, 3
"d:\IDEWORK\lvmen\src\licensedcode\data\rules\false-positive_2184.yml", "YAML", 0, 0, 0, 2, 0, 0, 1, 3
"d:\IDEWORK\lvmen\src\licensedcode\data\rules\false-positive_2185.yml", "YAML", 0, 0, 0, 2, 0, 0, 1, 3
"d:\IDEWORK\lvmen\src\licensedcode\data\rules\false-positive_2186.yml", "YAML", 0, 0, 0, 2, 0, 0, 1, 3
"d:\IDEWORK\lvmen\src\licensedcode\data\rules\false-positive_2187.yml", "YAML", 0, 0, 0, 2, 0, 0, 1, 3
"d:\IDEWORK\lvmen\src\licensedcode\data\rules\false-positive_2188.yml", "YAML", 0, 0, 0, 2, 0, 0, 1, 3
"d:\IDEWORK\lvmen\src\licensedcode\data\rules\false-positive_2189.yml", "YAML", 0, 0, 0, 2, 0, 0, 1, 3
"d:\IDEWORK\lvmen\src\licensedcode\data\rules\false-positive_219.yml", "YAML", 0, 0, 0, 2, 0, 0, 1, 3
"d:\IDEWORK\lvmen\src\licensedcode\data\rules\false-positive_2190.yml", "YAML", 0, 0, 0, 2, 0, 0, 1, 3
"d:\IDEWORK\lvmen\src\licensedcode\data\rules\false-positive_2191.yml", "YAML", 0, 0, 0, 2, 0, 0, 1, 3
"d:\IDEWORK\lvmen\src\licensedcode\data\rules\false-positive_2192.yml", "YAML", 0, 0, 0, 2, 0, 0, 1, 3
"d:\IDEWORK\lvmen\src\licensedcode\data\rules\false-positive_2193.yml", "YAML", 0, 0, 0, 2, 0, 0, 1, 3
"d:\IDEWORK\lvmen\src\licensedcode\data\rules\false-positive_2194.yml", "YAML", 0, 0, 0, 2, 0, 0, 1, 3
"d:\IDEWORK\lvmen\src\licensedcode\data\rules\false-positive_2195.yml", "YAML", 0, 0, 0, 2, 0, 0, 1, 3
"d:\IDEWORK\lvmen\src\licensedcode\data\rules\false-positive_2196.yml", "YAML", 0, 0, 0, 2, 0, 0, 1, 3
"d:\IDEWORK\lvmen\src\licensedcode\data\rules\false-positive_2197.yml", "YAML", 0, 0, 0, 2, 0, 0, 1, 3
"d:\IDEWORK\lvmen\src\licensedcode\data\rules\false-positive_2198.yml", "YAML", 0, 0, 0, 2, 0, 0, 1, 3
"d:\IDEWORK\lvmen\src\licensedcode\data\rules\false-positive_2199.yml", "YAML", 0, 0, 0, 2, 0, 0, 1, 3
"d:\IDEWORK\lvmen\src\licensedcode\data\rules\false-positive_22.yml", "YAML", 0, 0, 0, 2, 0, 0, 1, 3
"d:\IDEWORK\lvmen\src\licensedcode\data\rules\false-positive_220.yml", "YAML", 0, 0, 0, 2, 0, 0, 1, 3
"d:\IDEWORK\lvmen\src\licensedcode\data\rules\false-positive_2200.yml", "YAML", 0, 0, 0, 2, 0, 0, 1, 3
"d:\IDEWORK\lvmen\src\licensedcode\data\rules\false-positive_2201.yml", "YAML", 0, 0, 0, 2, 0, 0, 1, 3
"d:\IDEWORK\lvmen\src\licensedcode\data\rules\false-positive_2202.yml", "YAML", 0, 0, 0, 2, 0, 0, 1, 3
"d:\IDEWORK\lvmen\src\licensedcode\data\rules\false-positive_2203.yml", "YAML", 0, 0, 0, 2, 0, 0, 1, 3
"d:\IDEWORK\lvmen\src\licensedcode\data\rules\false-positive_2204.yml", "YAML", 0, 0, 0, 2, 0, 0, 1, 3
"d:\IDEWORK\lvmen\src\licensedcode\data\rules\false-positive_2205.yml", "YAML", 0, 0, 0, 2, 0, 0, 1, 3
"d:\IDEWORK\lvmen\src\licensedcode\data\rules\false-positive_2206.yml", "YAML", 0, 0, 0, 2, 0, 0, 1, 3
"d:\IDEWORK\lvmen\src\licensedcode\data\rules\false-positive_2207.yml", "YAML", 0, 0, 0, 2, 0, 0, 1, 3
"d:\IDEWORK\lvmen\src\licensedcode\data\rules\false-positive_2208.yml", "YAML", 0, 0, 0, 2, 0, 0, 1, 3
"d:\IDEWORK\lvmen\src\licensedcode\data\rules\false-positive_2209.yml", "YAML", 0, 0, 0, 2, 0, 0, 1, 3
"d:\IDEWORK\lvmen\src\licensedcode\data\rules\false-positive_221.yml", "YAML", 0, 0, 0, 2, 0, 0, 1, 3
"d:\IDEWORK\lvmen\src\licensedcode\data\rules\false-positive_2210.yml", "YAML", 0, 0, 0, 2, 0, 0, 1, 3
"d:\IDEWORK\lvmen\src\licensedcode\data\rules\false-positive_2211.yml", "YAML", 0, 0, 0, 2, 0, 0, 1, 3
"d:\IDEWORK\lvmen\src\licensedcode\data\rules\false-positive_2212.yml", "YAML", 0, 0, 0, 2, 0, 0, 1, 3
"d:\IDEWORK\lvmen\src\licensedcode\data\rules\false-positive_2213.yml", "YAML", 0, 0, 0, 2, 0, 0, 1, 3
"d:\IDEWORK\lvmen\src\licensedcode\data\rules\false-positive_2214.yml", "YAML", 0, 0, 0, 2, 0, 0, 1, 3
"d:\IDEWORK\lvmen\src\licensedcode\data\rules\false-positive_2215.yml", "YAML", 0, 0, 0, 2, 0, 0, 1, 3
"d:\IDEWORK\lvmen\src\licensedcode\data\rules\false-positive_2216.yml", "YAML", 0, 0, 0, 2, 0, 0, 1, 3
"d:\IDEWORK\lvmen\src\licensedcode\data\rules\false-positive_2217.yml", "YAML", 0, 0, 0, 2, 0, 0, 1, 3
"d:\IDEWORK\lvmen\src\licensedcode\data\rules\false-positive_2218.yml", "YAML", 0, 0, 0, 2, 0, 0, 1, 3
"d:\IDEWORK\lvmen\src\licensedcode\data\rules\false-positive_2219.yml", "YAML", 0, 0, 0, 2, 0, 0, 1, 3
"d:\IDEWORK\lvmen\src\licensedcode\data\rules\false-positive_222.yml", "YAML", 0, 0, 0, 2, 0, 0, 1, 3
"d:\IDEWORK\lvmen\src\licensedcode\data\rules\false-positive_2220.yml", "YAML", 0, 0, 0, 2, 0, 0, 1, 3
"d:\IDEWORK\lvmen\src\licensedcode\data\rules\false-positive_2221.yml", "YAML", 0, 0, 0, 2, 0, 0, 1, 3
"d:\IDEWORK\lvmen\src\licensedcode\data\rules\false-positive_2222.yml", "YAML", 0, 0, 0, 2, 0, 0, 1, 3
"d:\IDEWORK\lvmen\src\licensedcode\data\rules\false-positive_2223.yml", "YAML", 0, 0, 0, 2, 0, 0, 1, 3
"d:\IDEWORK\lvmen\src\licensedcode\data\rules\false-positive_2224.yml", "YAML", 0, 0, 0, 2, 0, 0, 1, 3
"d:\IDEWORK\lvmen\src\licensedcode\data\rules\false-positive_2225.yml", "YAML", 0, 0, 0, 2, 0, 0, 1, 3
"d:\IDEWORK\lvmen\src\licensedcode\data\rules\false-positive_2226.yml", "YAML", 0, 0, 0, 2, 0, 0, 1, 3
"d:\IDEWORK\lvmen\src\licensedcode\data\rules\false-positive_2227.yml", "YAML", 0, 0, 0, 2, 0, 0, 1, 3
"d:\IDEWORK\lvmen\src\licensedcode\data\rules\false-positive_2228.yml", "YAML", 0, 0, 0, 2, 0, 0, 1, 3
"d:\IDEWORK\lvmen\src\licensedcode\data\rules\false-positive_2229.yml", "YAML", 0, 0, 0, 2, 0, 0, 1, 3
"d:\IDEWORK\lvmen\src\licensedcode\data\rules\false-positive_223.yml", "YAML", 0, 0, 0, 3, 0, 0, 1, 4
"d:\IDEWORK\lvmen\src\licensedcode\data\rules\false-positive_2230.yml", "YAML", 0, 0, 0, 2, 0, 0, 1, 3
"d:\IDEWORK\lvmen\src\licensedcode\data\rules\false-positive_2231.yml", "YAML", 0, 0, 0, 2, 0, 0, 1, 3
"d:\IDEWORK\lvmen\src\licensedcode\data\rules\false-positive_2232.yml", "YAML", 0, 0, 0, 2, 0, 0, 1, 3
"d:\IDEWORK\lvmen\src\licensedcode\data\rules\false-positive_2233.yml", "YAML", 0, 0, 0, 2, 0, 0, 1, 3
"d:\IDEWORK\lvmen\src\licensedcode\data\rules\false-positive_2234.yml", "YAML", 0, 0, 0, 2, 0, 0, 1, 3
"d:\IDEWORK\lvmen\src\licensedcode\data\rules\false-positive_2235.yml", "YAML", 0, 0, 0, 2, 0, 0, 1, 3
"d:\IDEWORK\lvmen\src\licensedcode\data\rules\false-positive_2236.yml", "YAML", 0, 0, 0, 2, 0, 0, 1, 3
"d:\IDEWORK\lvmen\src\licensedcode\data\rules\false-positive_2237.yml", "YAML", 0, 0, 0, 2, 0, 0, 1, 3
"d:\IDEWORK\lvmen\src\licensedcode\data\rules\false-positive_2238.yml", "YAML", 0, 0, 0, 2, 0, 0, 1, 3
"d:\IDEWORK\lvmen\src\licensedcode\data\rules\false-positive_2239.yml", "YAML", 0, 0, 0, 2, 0, 0, 1, 3
"d:\IDEWORK\lvmen\src\licensedcode\data\rules\false-positive_224.yml", "YAML", 0, 0, 0, 2, 0, 0, 1, 3
"d:\IDEWORK\lvmen\src\licensedcode\data\rules\false-positive_2240.yml", "YAML", 0, 0, 0, 2, 0, 0, 1, 3
"d:\IDEWORK\lvmen\src\licensedcode\data\rules\false-positive_2241.yml", "YAML", 0, 0, 0, 2, 0, 0, 1, 3
"d:\IDEWORK\lvmen\src\licensedcode\data\rules\false-positive_2242.yml", "YAML", 0, 0, 0, 2, 0, 0, 1, 3
"d:\IDEWORK\lvmen\src\licensedcode\data\rules\false-positive_2243.yml", "YAML", 0, 0, 0, 2, 0, 0, 1, 3
"d:\IDEWORK\lvmen\src\licensedcode\data\rules\false-positive_2244.yml", "YAML", 0, 0, 0, 2, 0, 0, 1, 3
"d:\IDEWORK\lvmen\src\licensedcode\data\rules\false-positive_2245.yml", "YAML", 0, 0, 0, 2, 0, 0, 1, 3
"d:\IDEWORK\lvmen\src\licensedcode\data\rules\false-positive_2246.yml", "YAML", 0, 0, 0, 2, 0, 0, 1, 3
"d:\IDEWORK\lvmen\src\licensedcode\data\rules\false-positive_2247.yml", "YAML", 0, 0, 0, 2, 0, 0, 1, 3
"d:\IDEWORK\lvmen\src\licensedcode\data\rules\false-positive_2248.yml", "YAML", 0, 0, 0, 2, 0, 0, 1, 3
"d:\IDEWORK\lvmen\src\licensedcode\data\rules\false-positive_2249.yml", "YAML", 0, 0, 0, 2, 0, 0, 1, 3
"d:\IDEWORK\lvmen\src\licensedcode\data\rules\false-positive_225.yml", "YAML", 0, 0, 0, 2, 0, 0, 1, 3
"d:\IDEWORK\lvmen\src\licensedcode\data\rules\false-positive_2250.yml", "YAML", 0, 0, 0, 2, 0, 0, 1, 3
"d:\IDEWORK\lvmen\src\licensedcode\data\rules\false-positive_2251.yml", "YAML", 0, 0, 0, 2, 0, 0, 1, 3
"d:\IDEWORK\lvmen\src\licensedcode\data\rules\false-positive_2252.yml", "YAML", 0, 0, 0, 2, 0, 0, 1, 3
"d:\IDEWORK\lvmen\src\licensedcode\data\rules\false-positive_2253.yml", "YAML", 0, 0, 0, 2, 0, 0, 1, 3
"d:\IDEWORK\lvmen\src\licensedcode\data\rules\false-positive_2254.yml", "YAML", 0, 0, 0, 2, 0, 0, 1, 3
"d:\IDEWORK\lvmen\src\licensedcode\data\rules\false-positive_2255.yml", "YAML", 0, 0, 0, 2, 0, 0, 1, 3
"d:\IDEWORK\lvmen\src\licensedcode\data\rules\false-positive_2256.yml", "YAML", 0, 0, 0, 2, 0, 0, 1, 3
"d:\IDEWORK\lvmen\src\licensedcode\data\rules\false-positive_2257.yml", "YAML", 0, 0, 0, 2, 0, 0, 1, 3
"d:\IDEWORK\lvmen\src\licensedcode\data\rules\false-positive_2258.yml", "YAML", 0, 0, 0, 2, 0, 0, 1, 3
"d:\IDEWORK\lvmen\src\licensedcode\data\rules\false-positive_2259.yml", "YAML", 0, 0, 0, 2, 0, 0, 1, 3
"d:\IDEWORK\lvmen\src\licensedcode\data\rules\false-positive_226.yml", "YAML", 0, 0, 0, 2, 0, 0, 1, 3
"d:\IDEWORK\lvmen\src\licensedcode\data\rules\false-positive_2260.yml", "YAML", 0, 0, 0, 2, 0, 0, 1, 3
"d:\IDEWORK\lvmen\src\licensedcode\data\rules\false-positive_2261.yml", "YAML", 0, 0, 0, 2, 0, 0, 1, 3
"d:\IDEWORK\lvmen\src\licensedcode\data\rules\false-positive_2262.yml", "YAML", 0, 0, 0, 2, 0, 0, 1, 3
"d:\IDEWORK\lvmen\src\licensedcode\data\rules\false-positive_2263.yml", "YAML", 0, 0, 0, 2, 0, 0, 1, 3
"d:\IDEWORK\lvmen\src\licensedcode\data\rules\false-positive_2264.yml", "YAML", 0, 0, 0, 2, 0, 0, 1, 3
"d:\IDEWORK\lvmen\src\licensedcode\data\rules\false-positive_2265.yml", "YAML", 0, 0, 0, 2, 0, 0, 1, 3
"d:\IDEWORK\lvmen\src\licensedcode\data\rules\false-positive_2266.yml", "YAML", 0, 0, 0, 2, 0, 0, 1, 3
"d:\IDEWORK\lvmen\src\licensedcode\data\rules\false-positive_2267.yml", "YAML", 0, 0, 0, 2, 0, 0, 1, 3
"d:\IDEWORK\lvmen\src\licensedcode\data\rules\false-positive_2268.yml", "YAML", 0, 0, 0, 2, 0, 0, 1, 3
"d:\IDEWORK\lvmen\src\licensedcode\data\rules\false-positive_2269.yml", "YAML", 0, 0, 0, 2, 0, 0, 1, 3
"d:\IDEWORK\lvmen\src\licensedcode\data\rules\false-positive_227.yml", "YAML", 0, 0, 0, 2, 0, 0, 1, 3
"d:\IDEWORK\lvmen\src\licensedcode\data\rules\false-positive_2270.yml", "YAML", 0, 0, 0, 2, 0, 0, 1, 3
"d:\IDEWORK\lvmen\src\licensedcode\data\rules\false-positive_2271.yml", "YAML", 0, 0, 0, 2, 0, 0, 1, 3
"d:\IDEWORK\lvmen\src\licensedcode\data\rules\false-positive_2272.yml", "YAML", 0, 0, 0, 2, 0, 0, 1, 3
"d:\IDEWORK\lvmen\src\licensedcode\data\rules\false-positive_2273.yml", "YAML", 0, 0, 0, 2, 0, 0, 1, 3
"d:\IDEWORK\lvmen\src\licensedcode\data\rules\false-positive_2274.yml", "YAML", 0, 0, 0, 2, 0, 0, 1, 3
"d:\IDEWORK\lvmen\src\licensedcode\data\rules\false-positive_2275.yml", "YAML", 0, 0, 0, 2, 0, 0, 1, 3
"d:\IDEWORK\lvmen\src\licensedcode\data\rules\false-positive_2276.yml", "YAML", 0, 0, 0, 2, 0, 0, 1, 3
"d:\IDEWORK\lvmen\src\licensedcode\data\rules\false-positive_2277.yml", "YAML", 0, 0, 0, 2, 0, 0, 1, 3
"d:\IDEWORK\lvmen\src\licensedcode\data\rules\false-positive_2278.yml", "YAML", 0, 0, 0, 2, 0, 0, 1, 3
"d:\IDEWORK\lvmen\src\licensedcode\data\rules\false-positive_2279.yml", "YAML", 0, 0, 0, 2, 0, 0, 1, 3
"d:\IDEWORK\lvmen\src\licensedcode\data\rules\false-positive_228.yml", "YAML", 0, 0, 0, 3, 0, 0, 1, 4
"d:\IDEWORK\lvmen\src\licensedcode\data\rules\false-positive_2280.yml", "YAML", 0, 0, 0, 2, 0, 0, 1, 3
"d:\IDEWORK\lvmen\src\licensedcode\data\rules\false-positive_2281.yml", "YAML", 0, 0, 0, 2, 0, 0, 1, 3
"d:\IDEWORK\lvmen\src\licensedcode\data\rules\false-positive_2282.yml", "YAML", 0, 0, 0, 2, 0, 0, 1, 3
"d:\IDEWORK\lvmen\src\licensedcode\data\rules\false-positive_2283.yml", "YAML", 0, 0, 0, 2, 0, 0, 1, 3
"d:\IDEWORK\lvmen\src\licensedcode\data\rules\false-positive_2284.yml", "YAML", 0, 0, 0, 2, 0, 0, 1, 3
"d:\IDEWORK\lvmen\src\licensedcode\data\rules\false-positive_2285.yml", "YAML", 0, 0, 0, 2, 0, 0, 1, 3
"d:\IDEWORK\lvmen\src\licensedcode\data\rules\false-positive_2286.yml", "YAML", 0, 0, 0, 2, 0, 0, 1, 3
"d:\IDEWORK\lvmen\src\licensedcode\data\rules\false-positive_2287.yml", "YAML", 0, 0, 0, 2, 0, 0, 1, 3
"d:\IDEWORK\lvmen\src\licensedcode\data\rules\false-positive_2288.yml", "YAML", 0, 0, 0, 2, 0, 0, 1, 3
"d:\IDEWORK\lvmen\src\licensedcode\data\rules\false-positive_2289.yml", "YAML", 0, 0, 0, 2, 0, 0, 1, 3
"d:\IDEWORK\lvmen\src\licensedcode\data\rules\false-positive_229.yml", "YAML", 0, 0, 0, 2, 0, 0, 1, 3
"d:\IDEWORK\lvmen\src\licensedcode\data\rules\false-positive_2290.yml", "YAML", 0, 0, 0, 2, 0, 0, 1, 3
"d:\IDEWORK\lvmen\src\licensedcode\data\rules\false-positive_2291.yml", "YAML", 0, 0, 0, 2, 0, 0, 1, 3
"d:\IDEWORK\lvmen\src\licensedcode\data\rules\false-positive_2292.yml", "YAML", 0, 0, 0, 2, 0, 0, 1, 3
"d:\IDEWORK\lvmen\src\licensedcode\data\rules\false-positive_2293.yml", "YAML", 0, 0, 0, 2, 0, 0, 1, 3
"d:\IDEWORK\lvmen\src\licensedcode\data\rules\false-positive_2294.yml", "YAML", 0, 0, 0, 2, 0, 0, 1, 3
"d:\IDEWORK\lvmen\src\licensedcode\data\rules\false-positive_2295.yml", "YAML", 0, 0, 0, 2, 0, 0, 1, 3
"d:\IDEWORK\lvmen\src\licensedcode\data\rules\false-positive_2296.yml", "YAML", 0, 0, 0, 2, 0, 0, 1, 3
"d:\IDEWORK\lvmen\src\licensedcode\data\rules\false-positive_2297.yml", "YAML", 0, 0, 0, 2, 0, 0, 1, 3
"d:\IDEWORK\lvmen\src\licensedcode\data\rules\false-positive_2298.yml", "YAML", 0, 0, 0, 2, 0, 0, 1, 3
"d:\IDEWORK\lvmen\src\licensedcode\data\rules\false-positive_2299.yml", "YAML", 0, 0, 0, 2, 0, 0, 1, 3
"d:\IDEWORK\lvmen\src\licensedcode\data\rules\false-positive_23.yml", "YAML", 0, 0, 0, 2, 0, 0, 1, 3
"d:\IDEWORK\lvmen\src\licensedcode\data\rules\false-positive_230.yml", "YAML", 0, 0, 0, 2, 0, 0, 1, 3
"d:\IDEWORK\lvmen\src\licensedcode\data\rules\false-positive_2300.yml", "YAML", 0, 0, 0, 2, 0, 0, 1, 3
"d:\IDEWORK\lvmen\src\licensedcode\data\rules\false-positive_2301.yml", "YAML", 0, 0, 0, 2, 0, 0, 1, 3
"d:\IDEWORK\lvmen\src\licensedcode\data\rules\false-positive_2302.yml", "YAML", 0, 0, 0, 2, 0, 0, 1, 3
"d:\IDEWORK\lvmen\src\licensedcode\data\rules\false-positive_2303.yml", "YAML", 0, 0, 0, 2, 0, 0, 1, 3
"d:\IDEWORK\lvmen\src\licensedcode\data\rules\false-positive_2304.yml", "YAML", 0, 0, 0, 2, 0, 0, 1, 3
"d:\IDEWORK\lvmen\src\licensedcode\data\rules\false-positive_2305.yml", "YAML", 0, 0, 0, 2, 0, 0, 1, 3
"d:\IDEWORK\lvmen\src\licensedcode\data\rules\false-positive_2306.yml", "YAML", 0, 0, 0, 2, 0, 0, 1, 3
"d:\IDEWORK\lvmen\src\licensedcode\data\rules\false-positive_2307.yml", "YAML", 0, 0, 0, 2, 0, 0, 1, 3
"d:\IDEWORK\lvmen\src\licensedcode\data\rules\false-positive_2308.yml", "YAML", 0, 0, 0, 2, 0, 0, 1, 3
"d:\IDEWORK\lvmen\src\licensedcode\data\rules\false-positive_2309.yml", "YAML", 0, 0, 0, 2, 0, 0, 1, 3
"d:\IDEWORK\lvmen\src\licensedcode\data\rules\false-positive_231.yml", "YAML", 0, 0, 0, 2, 0, 0, 1, 3
"d:\IDEWORK\lvmen\src\licensedcode\data\rules\false-positive_2310.yml", "YAML", 0, 0, 0, 2, 0, 0, 1, 3
"d:\IDEWORK\lvmen\src\licensedcode\data\rules\false-positive_2311.yml", "YAML", 0, 0, 0, 2, 0, 0, 1, 3
"d:\IDEWORK\lvmen\src\licensedcode\data\rules\false-positive_2312.yml", "YAML", 0, 0, 0, 2, 0, 0, 1, 3
"d:\IDEWORK\lvmen\src\licensedcode\data\rules\false-positive_2313.yml", "YAML", 0, 0, 0, 2, 0, 0, 1, 3
"d:\IDEWORK\lvmen\src\licensedcode\data\rules\false-positive_2314.yml", "YAML", 0, 0, 0, 2, 0, 0, 1, 3
"d:\IDEWORK\lvmen\src\licensedcode\data\rules\false-positive_2315.yml", "YAML", 0, 0, 0, 2, 0, 0, 1, 3
"d:\IDEWORK\lvmen\src\licensedcode\data\rules\false-positive_2316.yml", "YAML", 0, 0, 0, 2, 0, 0, 1, 3
"d:\IDEWORK\lvmen\src\licensedcode\data\rules\false-positive_2317.yml", "YAML", 0, 0, 0, 2, 0, 0, 1, 3
"d:\IDEWORK\lvmen\src\licensedcode\data\rules\false-positive_2318.yml", "YAML", 0, 0, 0, 2, 0, 0, 1, 3
"d:\IDEWORK\lvmen\src\licensedcode\data\rules\false-positive_2319.yml", "YAML", 0, 0, 0, 2, 0, 0, 1, 3
"d:\IDEWORK\lvmen\src\licensedcode\data\rules\false-positive_232.yml", "YAML", 0, 0, 0, 2, 0, 0, 1, 3
"d:\IDEWORK\lvmen\src\licensedcode\data\rules\false-positive_2320.yml", "YAML", 0, 0, 0, 2, 0, 0, 1, 3
"d:\IDEWORK\lvmen\src\licensedcode\data\rules\false-positive_2321.yml", "YAML", 0, 0, 0, 2, 0, 0, 1, 3
"d:\IDEWORK\lvmen\src\licensedcode\data\rules\false-positive_2322.yml", "YAML", 0, 0, 0, 2, 0, 0, 1, 3
"d:\IDEWORK\lvmen\src\licensedcode\data\rules\false-positive_2323.yml", "YAML", 0, 0, 0, 2, 0, 0, 1, 3
"d:\IDEWORK\lvmen\src\licensedcode\data\rules\false-positive_2324.yml", "YAML", 0, 0, 0, 2, 0, 0, 1, 3
"d:\IDEWORK\lvmen\src\licensedcode\data\rules\false-positive_2325.yml", "YAML", 0, 0, 0, 2, 0, 0, 1, 3
"d:\IDEWORK\lvmen\src\licensedcode\data\rules\false-positive_2326.yml", "YAML", 0, 0, 0, 2, 0, 0, 1, 3
"d:\IDEWORK\lvmen\src\licensedcode\data\rules\false-positive_2327.yml", "YAML", 0, 0, 0, 2, 0, 0, 1, 3
"d:\IDEWORK\lvmen\src\licensedcode\data\rules\false-positive_2328.yml", "YAML", 0, 0, 0, 2, 0, 0, 1, 3
"d:\IDEWORK\lvmen\src\licensedcode\data\rules\false-positive_2329.yml", "YAML", 0, 0, 0, 2, 0, 0, 1, 3
"d:\IDEWORK\lvmen\src\licensedcode\data\rules\false-positive_233.yml", "YAML", 0, 0, 0, 2, 0, 0, 1, 3
"d:\IDEWORK\lvmen\src\licensedcode\data\rules\false-positive_2330.yml", "YAML", 0, 0, 0, 2, 0, 0, 1, 3
"d:\IDEWORK\lvmen\src\licensedcode\data\rules\false-positive_2331.yml", "YAML", 0, 0, 0, 2, 0, 0, 1, 3
"d:\IDEWORK\lvmen\src\licensedcode\data\rules\false-positive_2332.yml", "YAML", 0, 0, 0, 2, 0, 0, 1, 3
"d:\IDEWORK\lvmen\src\licensedcode\data\rules\false-positive_2333.yml", "YAML", 0, 0, 0, 2, 0, 0, 1, 3
"d:\IDEWORK\lvmen\src\licensedcode\data\rules\false-positive_2334.yml", "YAML", 0, 0, 0, 2, 0, 0, 1, 3
"d:\IDEWORK\lvmen\src\licensedcode\data\rules\false-positive_2335.yml", "YAML", 0, 0, 0, 2, 0, 0, 1, 3
"d:\IDEWORK\lvmen\src\licensedcode\data\rules\false-positive_2336.yml", "YAML", 0, 0, 0, 2, 0, 0, 1, 3
"d:\IDEWORK\lvmen\src\licensedcode\data\rules\false-positive_2337.yml", "YAML", 0, 0, 0, 2, 0, 0, 1, 3
"d:\IDEWORK\lvmen\src\licensedcode\data\rules\false-positive_2338.yml", "YAML", 0, 0, 0, 2, 0, 0, 1, 3
"d:\IDEWORK\lvmen\src\licensedcode\data\rules\false-positive_2339.yml", "YAML", 0, 0, 0, 2, 0, 0, 1, 3
"d:\IDEWORK\lvmen\src\licensedcode\data\rules\false-positive_234.yml", "YAML", 0, 0, 0, 2, 0, 0, 1, 3
"d:\IDEWORK\lvmen\src\licensedcode\data\rules\false-positive_2340.yml", "YAML", 0, 0, 0, 2, 0, 0, 1, 3
"d:\IDEWORK\lvmen\src\licensedcode\data\rules\false-positive_2341.yml", "YAML", 0, 0, 0, 2, 0, 0, 1, 3
"d:\IDEWORK\lvmen\src\licensedcode\data\rules\false-positive_2342.yml", "YAML", 0, 0, 0, 2, 0, 0, 1, 3
"d:\IDEWORK\lvmen\src\licensedcode\data\rules\false-positive_2343.yml", "YAML", 0, 0, 0, 2, 0, 0, 1, 3
"d:\IDEWORK\lvmen\src\licensedcode\data\rules\false-positive_2344.yml", "YAML", 0, 0, 0, 2, 0, 0, 1, 3
"d:\IDEWORK\lvmen\src\licensedcode\data\rules\false-positive_2345.yml", "YAML", 0, 0, 0, 2, 0, 0, 1, 3
"d:\IDEWORK\lvmen\src\licensedcode\data\rules\false-positive_2346.yml", "YAML", 0, 0, 0, 2, 0, 0, 1, 3
"d:\IDEWORK\lvmen\src\licensedcode\data\rules\false-positive_2347.yml", "YAML", 0, 0, 0, 2, 0, 0, 1, 3
"d:\IDEWORK\lvmen\src\licensedcode\data\rules\false-positive_2348.yml", "YAML", 0, 0, 0, 2, 0, 0, 1, 3
"d:\IDEWORK\lvmen\src\licensedcode\data\rules\false-positive_2349.yml", "YAML", 0, 0, 0, 2, 0, 0, 1, 3
"d:\IDEWORK\lvmen\src\licensedcode\data\rules\false-positive_235.yml", "YAML", 0, 0, 0, 2, 0, 0, 1, 3
"d:\IDEWORK\lvmen\src\licensedcode\data\rules\false-positive_2350.yml", "YAML", 0, 0, 0, 2, 0, 0, 1, 3
"d:\IDEWORK\lvmen\src\licensedcode\data\rules\false-positive_2351.yml", "YAML", 0, 0, 0, 2, 0, 0, 1, 3
"d:\IDEWORK\lvmen\src\licensedcode\data\rules\false-positive_2352.yml", "YAML", 0, 0, 0, 2, 0, 0, 1, 3
"d:\IDEWORK\lvmen\src\licensedcode\data\rules\false-positive_2353.yml", "YAML", 0, 0, 0, 2, 0, 0, 1, 3
"d:\IDEWORK\lvmen\src\licensedcode\data\rules\false-positive_2354.yml", "YAML", 0, 0, 0, 2, 0, 0, 1, 3
"d:\IDEWORK\lvmen\src\licensedcode\data\rules\false-positive_2355.yml", "YAML", 0, 0, 0, 2, 0, 0, 1, 3
"d:\IDEWORK\lvmen\src\licensedcode\data\rules\false-positive_2356.yml", "YAML", 0, 0, 0, 2, 0, 0, 1, 3
"d:\IDEWORK\lvmen\src\licensedcode\data\rules\false-positive_2357.yml", "YAML", 0, 0, 0, 2, 0, 0, 1, 3
"d:\IDEWORK\lvmen\src\licensedcode\data\rules\false-positive_2358.yml", "YAML", 0, 0, 0, 2, 0, 0, 1, 3
"d:\IDEWORK\lvmen\src\licensedcode\data\rules\false-positive_2359.yml", "YAML", 0, 0, 0, 2, 0, 0, 1, 3
"d:\IDEWORK\lvmen\src\licensedcode\data\rules\false-positive_236.yml", "YAML", 0, 0, 0, 2, 0, 0, 1, 3
"d:\IDEWORK\lvmen\src\licensedcode\data\rules\false-positive_2360.yml", "YAML", 0, 0, 0, 2, 0, 0, 1, 3
"d:\IDEWORK\lvmen\src\licensedcode\data\rules\false-positive_2361.yml", "YAML", 0, 0, 0, 2, 0, 0, 1, 3
"d:\IDEWORK\lvmen\src\licensedcode\data\rules\false-positive_2362.yml", "YAML", 0, 0, 0, 2, 0, 0, 1, 3
"d:\IDEWORK\lvmen\src\licensedcode\data\rules\false-positive_2363.yml", "YAML", 0, 0, 0, 2, 0, 0, 1, 3
"d:\IDEWORK\lvmen\src\licensedcode\data\rules\false-positive_2364.yml", "YAML", 0, 0, 0, 2, 0, 0, 1, 3
"d:\IDEWORK\lvmen\src\licensedcode\data\rules\false-positive_2365.yml", "YAML", 0, 0, 0, 2, 0, 0, 1, 3
"d:\IDEWORK\lvmen\src\licensedcode\data\rules\false-positive_2366.yml", "YAML", 0, 0, 0, 2, 0, 0, 1, 3
"d:\IDEWORK\lvmen\src\licensedcode\data\rules\false-positive_2367.yml", "YAML", 0, 0, 0, 2, 0, 0, 1, 3
"d:\IDEWORK\lvmen\src\licensedcode\data\rules\false-positive_2368.yml", "YAML", 0, 0, 0, 2, 0, 0, 1, 3
"d:\IDEWORK\lvmen\src\licensedcode\data\rules\false-positive_2369.yml", "YAML", 0, 0, 0, 2, 0, 0, 1, 3
"d:\IDEWORK\lvmen\src\licensedcode\data\rules\false-positive_237.yml", "YAML", 0, 0, 0, 2, 0, 0, 1, 3
"d:\IDEWORK\lvmen\src\licensedcode\data\rules\false-positive_2370.yml", "YAML", 0, 0, 0, 2, 0, 0, 1, 3
"d:\IDEWORK\lvmen\src\licensedcode\data\rules\false-positive_2371.yml", "YAML", 0, 0, 0, 2, 0, 0, 1, 3
"d:\IDEWORK\lvmen\src\licensedcode\data\rules\false-positive_2372.yml", "YAML", 0, 0, 0, 2, 0, 0, 1, 3
"d:\IDEWORK\lvmen\src\licensedcode\data\rules\false-positive_2373.yml", "YAML", 0, 0, 0, 2, 0, 0, 1, 3
"d:\IDEWORK\lvmen\src\licensedcode\data\rules\false-positive_2374.yml", "YAML", 0, 0, 0, 2, 0, 0, 1, 3
"d:\IDEWORK\lvmen\src\licensedcode\data\rules\false-positive_2375.yml", "YAML", 0, 0, 0, 2, 0, 0, 1, 3
"d:\IDEWORK\lvmen\src\licensedcode\data\rules\false-positive_2376.yml", "YAML", 0, 0, 0, 2, 0, 0, 1, 3
"d:\IDEWORK\lvmen\src\licensedcode\data\rules\false-positive_2377.yml", "YAML", 0, 0, 0, 2, 0, 0, 1, 3
"d:\IDEWORK\lvmen\src\licensedcode\data\rules\false-positive_2378.yml", "YAML", 0, 0, 0, 2, 0, 0, 1, 3
"d:\IDEWORK\lvmen\src\licensedcode\data\rules\false-positive_2379.yml", "YAML", 0, 0, 0, 2, 0, 0, 1, 3
"d:\IDEWORK\lvmen\src\licensedcode\data\rules\false-positive_238.yml", "YAML", 0, 0, 0, 2, 0, 0, 1, 3
"d:\IDEWORK\lvmen\src\licensedcode\data\rules\false-positive_2380.yml", "YAML", 0, 0, 0, 2, 0, 0, 1, 3
"d:\IDEWORK\lvmen\src\licensedcode\data\rules\false-positive_2381.yml", "YAML", 0, 0, 0, 2, 0, 0, 1, 3
"d:\IDEWORK\lvmen\src\licensedcode\data\rules\false-positive_2382.yml", "YAML", 0, 0, 0, 2, 0, 0, 1, 3
"d:\IDEWORK\lvmen\src\licensedcode\data\rules\false-positive_2383.yml", "YAML", 0, 0, 0, 2, 0, 0, 1, 3
"d:\IDEWORK\lvmen\src\licensedcode\data\rules\false-positive_2384.yml", "YAML", 0, 0, 0, 2, 0, 0, 1, 3
"d:\IDEWORK\lvmen\src\licensedcode\data\rules\false-positive_2385.yml", "YAML", 0, 0, 0, 2, 0, 0, 1, 3
"d:\IDEWORK\lvmen\src\licensedcode\data\rules\false-positive_2386.yml", "YAML", 0, 0, 0, 2, 0, 0, 1, 3
"d:\IDEWORK\lvmen\src\licensedcode\data\rules\false-positive_2387.yml", "YAML", 0, 0, 0, 2, 0, 0, 1, 3
"d:\IDEWORK\lvmen\src\licensedcode\data\rules\false-positive_2388.yml", "YAML", 0, 0, 0, 2, 0, 0, 1, 3
"d:\IDEWORK\lvmen\src\licensedcode\data\rules\false-positive_2389.yml", "YAML", 0, 0, 0, 2, 0, 0, 1, 3
"d:\IDEWORK\lvmen\src\licensedcode\data\rules\false-positive_239.yml", "YAML", 0, 0, 0, 2, 0, 0, 1, 3
"d:\IDEWORK\lvmen\src\licensedcode\data\rules\false-positive_2390.yml", "YAML", 0, 0, 0, 2, 0, 0, 1, 3
"d:\IDEWORK\lvmen\src\licensedcode\data\rules\false-positive_2391.yml", "YAML", 0, 0, 0, 2, 0, 0, 1, 3
"d:\IDEWORK\lvmen\src\licensedcode\data\rules\false-positive_2392.yml", "YAML", 0, 0, 0, 2, 0, 0, 1, 3
"d:\IDEWORK\lvmen\src\licensedcode\data\rules\false-positive_2393.yml", "YAML", 0, 0, 0, 2, 0, 0, 1, 3
"d:\IDEWORK\lvmen\src\licensedcode\data\rules\false-positive_2394.yml", "YAML", 0, 0, 0, 2, 0, 0, 1, 3
"d:\IDEWORK\lvmen\src\licensedcode\data\rules\false-positive_2395.yml", "YAML", 0, 0, 0, 2, 0, 0, 1, 3
"d:\IDEWORK\lvmen\src\licensedcode\data\rules\false-positive_2396.yml", "YAML", 0, 0, 0, 2, 0, 0, 1, 3
"d:\IDEWORK\lvmen\src\licensedcode\data\rules\false-positive_2397.yml", "YAML", 0, 0, 0, 2, 0, 0, 1, 3
"d:\IDEWORK\lvmen\src\licensedcode\data\rules\false-positive_2398.yml", "YAML", 0, 0, 0, 2, 0, 0, 1, 3
"d:\IDEWORK\lvmen\src\licensedcode\data\rules\false-positive_2399.yml", "YAML", 0, 0, 0, 2, 0, 0, 1, 3
"d:\IDEWORK\lvmen\src\licensedcode\data\rules\false-positive_24.yml", "YAML", 0, 0, 0, 2, 0, 0, 1, 3
"d:\IDEWORK\lvmen\src\licensedcode\data\rules\false-positive_240.yml", "YAML", 0, 0, 0, 2, 0, 0, 1, 3
"d:\IDEWORK\lvmen\src\licensedcode\data\rules\false-positive_2400.yml", "YAML", 0, 0, 0, 2, 0, 0, 1, 3
"d:\IDEWORK\lvmen\src\licensedcode\data\rules\false-positive_2401.yml", "YAML", 0, 0, 0, 2, 0, 0, 1, 3
"d:\IDEWORK\lvmen\src\licensedcode\data\rules\false-positive_2402.yml", "YAML", 0, 0, 0, 2, 0, 0, 1, 3
"d:\IDEWORK\lvmen\src\licensedcode\data\rules\false-positive_2403.yml", "YAML", 0, 0, 0, 2, 0, 0, 1, 3
"d:\IDEWORK\lvmen\src\licensedcode\data\rules\false-positive_2404.yml", "YAML", 0, 0, 0, 2, 0, 0, 1, 3
"d:\IDEWORK\lvmen\src\licensedcode\data\rules\false-positive_2405.yml", "YAML", 0, 0, 0, 2, 0, 0, 1, 3
"d:\IDEWORK\lvmen\src\licensedcode\data\rules\false-positive_2406.yml", "YAML", 0, 0, 0, 2, 0, 0, 1, 3
"d:\IDEWORK\lvmen\src\licensedcode\data\rules\false-positive_2407.yml", "YAML", 0, 0, 0, 2, 0, 0, 1, 3
"d:\IDEWORK\lvmen\src\licensedcode\data\rules\false-positive_2408.yml", "YAML", 0, 0, 0, 2, 0, 0, 1, 3
"d:\IDEWORK\lvmen\src\licensedcode\data\rules\false-positive_2409.yml", "YAML", 0, 0, 0, 2, 0, 0, 1, 3
"d:\IDEWORK\lvmen\src\licensedcode\data\rules\false-positive_241.yml", "YAML", 0, 0, 0, 2, 0, 0, 1, 3
"d:\IDEWORK\lvmen\src\licensedcode\data\rules\false-positive_2410.yml", "YAML", 0, 0, 0, 2, 0, 0, 1, 3
"d:\IDEWORK\lvmen\src\licensedcode\data\rules\false-positive_2411.yml", "YAML", 0, 0, 0, 2, 0, 0, 1, 3
"d:\IDEWORK\lvmen\src\licensedcode\data\rules\false-positive_2412.yml", "YAML", 0, 0, 0, 2, 0, 0, 1, 3
"d:\IDEWORK\lvmen\src\licensedcode\data\rules\false-positive_2413.yml", "YAML", 0, 0, 0, 2, 0, 0, 1, 3
"d:\IDEWORK\lvmen\src\licensedcode\data\rules\false-positive_2414.yml", "YAML", 0, 0, 0, 2, 0, 0, 1, 3
"d:\IDEWORK\lvmen\src\licensedcode\data\rules\false-positive_2415.yml", "YAML", 0, 0, 0, 2, 0, 0, 1, 3
"d:\IDEWORK\lvmen\src\licensedcode\data\rules\false-positive_2416.yml", "YAML", 0, 0, 0, 2, 0, 0, 1, 3
"d:\IDEWORK\lvmen\src\licensedcode\data\rules\false-positive_2417.yml", "YAML", 0, 0, 0, 2, 0, 0, 1, 3
"d:\IDEWORK\lvmen\src\licensedcode\data\rules\false-positive_2418.yml", "YAML", 0, 0, 0, 2, 0, 0, 1, 3
"d:\IDEWORK\lvmen\src\licensedcode\data\rules\false-positive_2419.yml", "YAML", 0, 0, 0, 2, 0, 0, 1, 3
"d:\IDEWORK\lvmen\src\licensedcode\data\rules\false-positive_242.yml", "YAML", 0, 0, 0, 2, 0, 0, 1, 3
"d:\IDEWORK\lvmen\src\licensedcode\data\rules\false-positive_2420.yml", "YAML", 0, 0, 0, 2, 0, 0, 1, 3
"d:\IDEWORK\lvmen\src\licensedcode\data\rules\false-positive_2421.yml", "YAML", 0, 0, 0, 2, 0, 0, 1, 3
"d:\IDEWORK\lvmen\src\licensedcode\data\rules\false-positive_2422.yml", "YAML", 0, 0, 0, 2, 0, 0, 1, 3
"d:\IDEWORK\lvmen\src\licensedcode\data\rules\false-positive_2423.yml", "YAML", 0, 0, 0, 2, 0, 0, 1, 3
"d:\IDEWORK\lvmen\src\licensedcode\data\rules\false-positive_2424.yml", "YAML", 0, 0, 0, 2, 0, 0, 1, 3
"d:\IDEWORK\lvmen\src\licensedcode\data\rules\false-positive_2425.yml", "YAML", 0, 0, 0, 2, 0, 0, 1, 3
"d:\IDEWORK\lvmen\src\licensedcode\data\rules\false-positive_2426.yml", "YAML", 0, 0, 0, 2, 0, 0, 1, 3
"d:\IDEWORK\lvmen\src\licensedcode\data\rules\false-positive_2427.yml", "YAML", 0, 0, 0, 2, 0, 0, 1, 3
"d:\IDEWORK\lvmen\src\licensedcode\data\rules\false-positive_2428.yml", "YAML", 0, 0, 0, 2, 0, 0, 1, 3
"d:\IDEWORK\lvmen\src\licensedcode\data\rules\false-positive_2429.yml", "YAML", 0, 0, 0, 2, 0, 0, 1, 3
"d:\IDEWORK\lvmen\src\licensedcode\data\rules\false-positive_243.yml", "YAML", 0, 0, 0, 2, 0, 0, 1, 3
"d:\IDEWORK\lvmen\src\licensedcode\data\rules\false-positive_2430.yml", "YAML", 0, 0, 0, 2, 0, 0, 1, 3
"d:\IDEWORK\lvmen\src\licensedcode\data\rules\false-positive_2431.yml", "YAML", 0, 0, 0, 2, 0, 0, 1, 3
"d:\IDEWORK\lvmen\src\licensedcode\data\rules\false-positive_2432.yml", "YAML", 0, 0, 0, 2, 0, 0, 1, 3
"d:\IDEWORK\lvmen\src\licensedcode\data\rules\false-positive_2433.yml", "YAML", 0, 0, 0, 2, 0, 0, 1, 3
"d:\IDEWORK\lvmen\src\licensedcode\data\rules\false-positive_2434.yml", "YAML", 0, 0, 0, 2, 0, 0, 1, 3
"d:\IDEWORK\lvmen\src\licensedcode\data\rules\false-positive_2435.yml", "YAML", 0, 0, 0, 2, 0, 0, 1, 3
"d:\IDEWORK\lvmen\src\licensedcode\data\rules\false-positive_2436.yml", "YAML", 0, 0, 0, 2, 0, 0, 1, 3
"d:\IDEWORK\lvmen\src\licensedcode\data\rules\false-positive_2437.yml", "YAML", 0, 0, 0, 2, 0, 0, 1, 3
"d:\IDEWORK\lvmen\src\licensedcode\data\rules\false-positive_2438.yml", "YAML", 0, 0, 0, 2, 0, 0, 1, 3
"d:\IDEWORK\lvmen\src\licensedcode\data\rules\false-positive_2439.yml", "YAML", 0, 0, 0, 2, 0, 0, 1, 3
"d:\IDEWORK\lvmen\src\licensedcode\data\rules\false-positive_244.yml", "YAML", 0, 0, 0, 2, 0, 0, 1, 3
"d:\IDEWORK\lvmen\src\licensedcode\data\rules\false-positive_2440.yml", "YAML", 0, 0, 0, 2, 0, 0, 1, 3
"d:\IDEWORK\lvmen\src\licensedcode\data\rules\false-positive_2441.yml", "YAML", 0, 0, 0, 2, 0, 0, 1, 3
"d:\IDEWORK\lvmen\src\licensedcode\data\rules\false-positive_2442.yml", "YAML", 0, 0, 0, 2, 0, 0, 1, 3
"d:\IDEWORK\lvmen\src\licensedcode\data\rules\false-positive_2443.yml", "YAML", 0, 0, 0, 2, 0, 0, 1, 3
"d:\IDEWORK\lvmen\src\licensedcode\data\rules\false-positive_2444.yml", "YAML", 0, 0, 0, 2, 0, 0, 1, 3
"d:\IDEWORK\lvmen\src\licensedcode\data\rules\false-positive_2445.yml", "YAML", 0, 0, 0, 2, 0, 0, 1, 3
"d:\IDEWORK\lvmen\src\licensedcode\data\rules\false-positive_2446.yml", "YAML", 0, 0, 0, 2, 0, 0, 1, 3
"d:\IDEWORK\lvmen\src\licensedcode\data\rules\false-positive_2447.yml", "YAML", 0, 0, 0, 2, 0, 0, 1, 3
"d:\IDEWORK\lvmen\src\licensedcode\data\rules\false-positive_2448.yml", "YAML", 0, 0, 0, 2, 0, 0, 1, 3
"d:\IDEWORK\lvmen\src\licensedcode\data\rules\false-positive_2449.yml", "YAML", 0, 0, 0, 2, 0, 0, 1, 3
"d:\IDEWORK\lvmen\src\licensedcode\data\rules\false-positive_245.yml", "YAML", 0, 0, 0, 2, 0, 0, 1, 3
"d:\IDEWORK\lvmen\src\licensedcode\data\rules\false-positive_2450.yml", "YAML", 0, 0, 0, 2, 0, 0, 1, 3
"d:\IDEWORK\lvmen\src\licensedcode\data\rules\false-positive_2451.yml", "YAML", 0, 0, 0, 2, 0, 0, 1, 3
"d:\IDEWORK\lvmen\src\licensedcode\data\rules\false-positive_2452.yml", "YAML", 0, 0, 0, 2, 0, 0, 1, 3
"d:\IDEWORK\lvmen\src\licensedcode\data\rules\false-positive_2453.yml", "YAML", 0, 0, 0, 2, 0, 0, 1, 3
"d:\IDEWORK\lvmen\src\licensedcode\data\rules\false-positive_2454.yml", "YAML", 0, 0, 0, 2, 0, 0, 1, 3
"d:\IDEWORK\lvmen\src\licensedcode\data\rules\false-positive_2455.yml", "YAML", 0, 0, 0, 2, 0, 0, 1, 3
"d:\IDEWORK\lvmen\src\licensedcode\data\rules\false-positive_2456.yml", "YAML", 0, 0, 0, 2, 0, 0, 1, 3
"d:\IDEWORK\lvmen\src\licensedcode\data\rules\false-positive_2457.yml", "YAML", 0, 0, 0, 2, 0, 0, 1, 3
"d:\IDEWORK\lvmen\src\licensedcode\data\rules\false-positive_2458.yml", "YAML", 0, 0, 0, 2, 0, 0, 1, 3
"d:\IDEWORK\lvmen\src\licensedcode\data\rules\false-positive_2459.yml", "YAML", 0, 0, 0, 2, 0, 0, 1, 3
"d:\IDEWORK\lvmen\src\licensedcode\data\rules\false-positive_246.yml", "YAML", 0, 0, 0, 2, 0, 0, 1, 3
"d:\IDEWORK\lvmen\src\licensedcode\data\rules\false-positive_2460.yml", "YAML", 0, 0, 0, 2, 0, 0, 1, 3
"d:\IDEWORK\lvmen\src\licensedcode\data\rules\false-positive_2461.yml", "YAML", 0, 0, 0, 2, 0, 0, 1, 3
"d:\IDEWORK\lvmen\src\licensedcode\data\rules\false-positive_2462.yml", "YAML", 0, 0, 0, 2, 0, 0, 1, 3
"d:\IDEWORK\lvmen\src\licensedcode\data\rules\false-positive_2463.yml", "YAML", 0, 0, 0, 2, 0, 0, 1, 3
"d:\IDEWORK\lvmen\src\licensedcode\data\rules\false-positive_2464.yml", "YAML", 0, 0, 0, 2, 0, 0, 1, 3
"d:\IDEWORK\lvmen\src\licensedcode\data\rules\false-positive_2465.yml", "YAML", 0, 0, 0, 2, 0, 0, 1, 3
"d:\IDEWORK\lvmen\src\licensedcode\data\rules\false-positive_2466.yml", "YAML", 0, 0, 0, 2, 0, 0, 1, 3
"d:\IDEWORK\lvmen\src\licensedcode\data\rules\false-positive_2467.yml", "YAML", 0, 0, 0, 2, 0, 0, 1, 3
"d:\IDEWORK\lvmen\src\licensedcode\data\rules\false-positive_2468.yml", "YAML", 0, 0, 0, 2, 0, 0, 1, 3
"d:\IDEWORK\lvmen\src\licensedcode\data\rules\false-positive_2469.yml", "YAML", 0, 0, 0, 2, 0, 0, 1, 3
"d:\IDEWORK\lvmen\src\licensedcode\data\rules\false-positive_247.yml", "YAML", 0, 0, 0, 2, 0, 0, 1, 3
"d:\IDEWORK\lvmen\src\licensedcode\data\rules\false-positive_2470.yml", "YAML", 0, 0, 0, 2, 0, 0, 1, 3
"d:\IDEWORK\lvmen\src\licensedcode\data\rules\false-positive_2471.yml", "YAML", 0, 0, 0, 2, 0, 0, 1, 3
"d:\IDEWORK\lvmen\src\licensedcode\data\rules\false-positive_2472.yml", "YAML", 0, 0, 0, 2, 0, 0, 1, 3
"d:\IDEWORK\lvmen\src\licensedcode\data\rules\false-positive_2473.yml", "YAML", 0, 0, 0, 2, 0, 0, 1, 3
"d:\IDEWORK\lvmen\src\licensedcode\data\rules\false-positive_2474.yml", "YAML", 0, 0, 0, 2, 0, 0, 1, 3
"d:\IDEWORK\lvmen\src\licensedcode\data\rules\false-positive_2475.yml", "YAML", 0, 0, 0, 2, 0, 0, 1, 3
"d:\IDEWORK\lvmen\src\licensedcode\data\rules\false-positive_2476.yml", "YAML", 0, 0, 0, 2, 0, 0, 1, 3
"d:\IDEWORK\lvmen\src\licensedcode\data\rules\false-positive_2477.yml", "YAML", 0, 0, 0, 2, 0, 0, 1, 3
"d:\IDEWORK\lvmen\src\licensedcode\data\rules\false-positive_2478.yml", "YAML", 0, 0, 0, 2, 0, 0, 1, 3
"d:\IDEWORK\lvmen\src\licensedcode\data\rules\false-positive_2479.yml", "YAML", 0, 0, 0, 2, 0, 0, 1, 3
"d:\IDEWORK\lvmen\src\licensedcode\data\rules\false-positive_248.yml", "YAML", 0, 0, 0, 2, 0, 0, 1, 3
"d:\IDEWORK\lvmen\src\licensedcode\data\rules\false-positive_2480.yml", "YAML", 0, 0, 0, 2, 0, 0, 1, 3
"d:\IDEWORK\lvmen\src\licensedcode\data\rules\false-positive_2481.yml", "YAML", 0, 0, 0, 2, 0, 0, 1, 3
"d:\IDEWORK\lvmen\src\licensedcode\data\rules\false-positive_2482.yml", "YAML", 0, 0, 0, 2, 0, 0, 1, 3
"d:\IDEWORK\lvmen\src\licensedcode\data\rules\false-positive_2483.yml", "YAML", 0, 0, 0, 2, 0, 0, 1, 3
"d:\IDEWORK\lvmen\src\licensedcode\data\rules\false-positive_2484.yml", "YAML", 0, 0, 0, 2, 0, 0, 1, 3
"d:\IDEWORK\lvmen\src\licensedcode\data\rules\false-positive_2485.yml", "YAML", 0, 0, 0, 2, 0, 0, 1, 3
"d:\IDEWORK\lvmen\src\licensedcode\data\rules\false-positive_2486.yml", "YAML", 0, 0, 0, 2, 0, 0, 1, 3
"d:\IDEWORK\lvmen\src\licensedcode\data\rules\false-positive_2487.yml", "YAML", 0, 0, 0, 2, 0, 0, 1, 3
"d:\IDEWORK\lvmen\src\licensedcode\data\rules\false-positive_2488.yml", "YAML", 0, 0, 0, 2, 0, 0, 1, 3
"d:\IDEWORK\lvmen\src\licensedcode\data\rules\false-positive_2489.yml", "YAML", 0, 0, 0, 2, 0, 0, 1, 3
"d:\IDEWORK\lvmen\src\licensedcode\data\rules\false-positive_249.yml", "YAML", 0, 0, 0, 3, 0, 0, 1, 4
"d:\IDEWORK\lvmen\src\licensedcode\data\rules\false-positive_2490.yml", "YAML", 0, 0, 0, 2, 0, 0, 1, 3
"d:\IDEWORK\lvmen\src\licensedcode\data\rules\false-positive_2491.yml", "YAML", 0, 0, 0, 2, 0, 0, 1, 3
"d:\IDEWORK\lvmen\src\licensedcode\data\rules\false-positive_2492.yml", "YAML", 0, 0, 0, 2, 0, 0, 1, 3
"d:\IDEWORK\lvmen\src\licensedcode\data\rules\false-positive_2493.yml", "YAML", 0, 0, 0, 2, 0, 0, 1, 3
"d:\IDEWORK\lvmen\src\licensedcode\data\rules\false-positive_2494.yml", "YAML", 0, 0, 0, 2, 0, 0, 1, 3
"d:\IDEWORK\lvmen\src\licensedcode\data\rules\false-positive_2495.yml", "YAML", 0, 0, 0, 2, 0, 0, 1, 3
"d:\IDEWORK\lvmen\src\licensedcode\data\rules\false-positive_2496.yml", "YAML", 0, 0, 0, 2, 0, 0, 1, 3
"d:\IDEWORK\lvmen\src\licensedcode\data\rules\false-positive_2497.yml", "YAML", 0, 0, 0, 2, 0, 0, 1, 3
"d:\IDEWORK\lvmen\src\licensedcode\data\rules\false-positive_2498.yml", "YAML", 0, 0, 0, 2, 0, 0, 1, 3
"d:\IDEWORK\lvmen\src\licensedcode\data\rules\false-positive_2499.yml", "YAML", 0, 0, 0, 2, 0, 0, 1, 3
"d:\IDEWORK\lvmen\src\licensedcode\data\rules\false-positive_25.yml", "YAML", 0, 0, 0, 3, 0, 0, 1, 4
"d:\IDEWORK\lvmen\src\licensedcode\data\rules\false-positive_250.yml", "YAML", 0, 0, 0, 2, 0, 0, 1, 3
"d:\IDEWORK\lvmen\src\licensedcode\data\rules\false-positive_2500.yml", "YAML", 0, 0, 0, 2, 0, 0, 1, 3
"d:\IDEWORK\lvmen\src\licensedcode\data\rules\false-positive_2501.yml", "YAML", 0, 0, 0, 2, 0, 0, 1, 3
"d:\IDEWORK\lvmen\src\licensedcode\data\rules\false-positive_2502.yml", "YAML", 0, 0, 0, 2, 0, 0, 1, 3
"d:\IDEWORK\lvmen\src\licensedcode\data\rules\false-positive_2503.yml", "YAML", 0, 0, 0, 2, 0, 0, 1, 3
"d:\IDEWORK\lvmen\src\licensedcode\data\rules\false-positive_2504.yml", "YAML", 0, 0, 0, 2, 0, 0, 1, 3
"d:\IDEWORK\lvmen\src\licensedcode\data\rules\false-positive_2505.yml", "YAML", 0, 0, 0, 2, 0, 0, 1, 3
"d:\IDEWORK\lvmen\src\licensedcode\data\rules\false-positive_2506.yml", "YAML", 0, 0, 0, 2, 0, 0, 1, 3
"d:\IDEWORK\lvmen\src\licensedcode\data\rules\false-positive_2507.yml", "YAML", 0, 0, 0, 2, 0, 0, 1, 3
"d:\IDEWORK\lvmen\src\licensedcode\data\rules\false-positive_2508.yml", "YAML", 0, 0, 0, 2, 0, 0, 1, 3
"d:\IDEWORK\lvmen\src\licensedcode\data\rules\false-positive_2509.yml", "YAML", 0, 0, 0, 2, 0, 0, 1, 3
"d:\IDEWORK\lvmen\src\licensedcode\data\rules\false-positive_251.yml", "YAML", 0, 0, 0, 2, 0, 0, 1, 3
"d:\IDEWORK\lvmen\src\licensedcode\data\rules\false-positive_2510.yml", "YAML", 0, 0, 0, 2, 0, 0, 1, 3
"d:\IDEWORK\lvmen\src\licensedcode\data\rules\false-positive_2511.yml", "YAML", 0, 0, 0, 2, 0, 0, 1, 3
"d:\IDEWORK\lvmen\src\licensedcode\data\rules\false-positive_2512.yml", "YAML", 0, 0, 0, 2, 0, 0, 1, 3
"d:\IDEWORK\lvmen\src\licensedcode\data\rules\false-positive_2513.yml", "YAML", 0, 0, 0, 2, 0, 0, 1, 3
"d:\IDEWORK\lvmen\src\licensedcode\data\rules\false-positive_2514.yml", "YAML", 0, 0, 0, 2, 0, 0, 1, 3
"d:\IDEWORK\lvmen\src\licensedcode\data\rules\false-positive_2515.yml", "YAML", 0, 0, 0, 2, 0, 0, 1, 3
"d:\IDEWORK\lvmen\src\licensedcode\data\rules\false-positive_2516.yml", "YAML", 0, 0, 0, 2, 0, 0, 1, 3
"d:\IDEWORK\lvmen\src\licensedcode\data\rules\false-positive_2517.yml", "YAML", 0, 0, 0, 2, 0, 0, 1, 3
"d:\IDEWORK\lvmen\src\licensedcode\data\rules\false-positive_2518.yml", "YAML", 0, 0, 0, 2, 0, 0, 1, 3
"d:\IDEWORK\lvmen\src\licensedcode\data\rules\false-positive_2519.yml", "YAML", 0, 0, 0, 2, 0, 0, 1, 3
"d:\IDEWORK\lvmen\src\licensedcode\data\rules\false-positive_252.yml", "YAML", 0, 0, 0, 2, 0, 0, 1, 3
"d:\IDEWORK\lvmen\src\licensedcode\data\rules\false-positive_2520.yml", "YAML", 0, 0, 0, 2, 0, 0, 1, 3
"d:\IDEWORK\lvmen\src\licensedcode\data\rules\false-positive_2521.yml", "YAML", 0, 0, 0, 2, 0, 0, 1, 3
"d:\IDEWORK\lvmen\src\licensedcode\data\rules\false-positive_2522.yml", "YAML", 0, 0, 0, 2, 0, 0, 1, 3
"d:\IDEWORK\lvmen\src\licensedcode\data\rules\false-positive_2523.yml", "YAML", 0, 0, 0, 2, 0, 0, 1, 3
"d:\IDEWORK\lvmen\src\licensedcode\data\rules\false-positive_2524.yml", "YAML", 0, 0, 0, 2, 0, 0, 1, 3
"d:\IDEWORK\lvmen\src\licensedcode\data\rules\false-positive_2525.yml", "YAML", 0, 0, 0, 2, 0, 0, 1, 3
"d:\IDEWORK\lvmen\src\licensedcode\data\rules\false-positive_2526.yml", "YAML", 0, 0, 0, 2, 0, 0, 1, 3
"d:\IDEWORK\lvmen\src\licensedcode\data\rules\false-positive_2527.yml", "YAML", 0, 0, 0, 2, 0, 0, 1, 3
"d:\IDEWORK\lvmen\src\licensedcode\data\rules\false-positive_2528.yml", "YAML", 0, 0, 0, 2, 0, 0, 1, 3
"d:\IDEWORK\lvmen\src\licensedcode\data\rules\false-positive_2529.yml", "YAML", 0, 0, 0, 2, 0, 0, 1, 3
"d:\IDEWORK\lvmen\src\licensedcode\data\rules\false-positive_253.yml", "YAML", 0, 0, 0, 3, 0, 0, 1, 4
"d:\IDEWORK\lvmen\src\licensedcode\data\rules\false-positive_2530.yml", "YAML", 0, 0, 0, 2, 0, 0, 1, 3
"d:\IDEWORK\lvmen\src\licensedcode\data\rules\false-positive_2531.yml", "YAML", 0, 0, 0, 2, 0, 0, 1, 3
"d:\IDEWORK\lvmen\src\licensedcode\data\rules\false-positive_2532.yml", "YAML", 0, 0, 0, 2, 0, 0, 1, 3
"d:\IDEWORK\lvmen\src\licensedcode\data\rules\false-positive_2533.yml", "YAML", 0, 0, 0, 2, 0, 0, 1, 3
"d:\IDEWORK\lvmen\src\licensedcode\data\rules\false-positive_2534.yml", "YAML", 0, 0, 0, 2, 0, 0, 1, 3
"d:\IDEWORK\lvmen\src\licensedcode\data\rules\false-positive_2535.yml", "YAML", 0, 0, 0, 2, 0, 0, 1, 3
"d:\IDEWORK\lvmen\src\licensedcode\data\rules\false-positive_2536.yml", "YAML", 0, 0, 0, 2, 0, 0, 1, 3
"d:\IDEWORK\lvmen\src\licensedcode\data\rules\false-positive_2537.yml", "YAML", 0, 0, 0, 2, 0, 0, 1, 3
"d:\IDEWORK\lvmen\src\licensedcode\data\rules\false-positive_2538.yml", "YAML", 0, 0, 0, 2, 0, 0, 1, 3
"d:\IDEWORK\lvmen\src\licensedcode\data\rules\false-positive_2539.yml", "YAML", 0, 0, 0, 2, 0, 0, 1, 3
"d:\IDEWORK\lvmen\src\licensedcode\data\rules\false-positive_254.yml", "YAML", 0, 0, 0, 2, 0, 0, 1, 3
"d:\IDEWORK\lvmen\src\licensedcode\data\rules\false-positive_2540.yml", "YAML", 0, 0, 0, 2, 0, 0, 1, 3
"d:\IDEWORK\lvmen\src\licensedcode\data\rules\false-positive_2541.yml", "YAML", 0, 0, 0, 2, 0, 0, 1, 3
"d:\IDEWORK\lvmen\src\licensedcode\data\rules\false-positive_2542.yml", "YAML", 0, 0, 0, 2, 0, 0, 1, 3
"d:\IDEWORK\lvmen\src\licensedcode\data\rules\false-positive_2543.yml", "YAML", 0, 0, 0, 2, 0, 0, 1, 3
"d:\IDEWORK\lvmen\src\licensedcode\data\rules\false-positive_2544.yml", "YAML", 0, 0, 0, 2, 0, 0, 1, 3
"d:\IDEWORK\lvmen\src\licensedcode\data\rules\false-positive_2545.yml", "YAML", 0, 0, 0, 2, 0, 0, 1, 3
"d:\IDEWORK\lvmen\src\licensedcode\data\rules\false-positive_2546.yml", "YAML", 0, 0, 0, 2, 0, 0, 1, 3
"d:\IDEWORK\lvmen\src\licensedcode\data\rules\false-positive_2547.yml", "YAML", 0, 0, 0, 2, 0, 0, 1, 3
"d:\IDEWORK\lvmen\src\licensedcode\data\rules\false-positive_2548.yml", "YAML", 0, 0, 0, 2, 0, 0, 1, 3
"d:\IDEWORK\lvmen\src\licensedcode\data\rules\false-positive_2549.yml", "YAML", 0, 0, 0, 2, 0, 0, 1, 3
"d:\IDEWORK\lvmen\src\licensedcode\data\rules\false-positive_255.yml", "YAML", 0, 0, 0, 2, 0, 0, 1, 3
"d:\IDEWORK\lvmen\src\licensedcode\data\rules\false-positive_2550.yml", "YAML", 0, 0, 0, 2, 0, 0, 1, 3
"d:\IDEWORK\lvmen\src\licensedcode\data\rules\false-positive_2551.yml", "YAML", 0, 0, 0, 2, 0, 0, 1, 3
"d:\IDEWORK\lvmen\src\licensedcode\data\rules\false-positive_2552.yml", "YAML", 0, 0, 0, 2, 0, 0, 1, 3
"d:\IDEWORK\lvmen\src\licensedcode\data\rules\false-positive_2553.yml", "YAML", 0, 0, 0, 2, 0, 0, 1, 3
"d:\IDEWORK\lvmen\src\licensedcode\data\rules\false-positive_2554.yml", "YAML", 0, 0, 0, 2, 0, 0, 1, 3
"d:\IDEWORK\lvmen\src\licensedcode\data\rules\false-positive_2555.yml", "YAML", 0, 0, 0, 2, 0, 0, 1, 3
"d:\IDEWORK\lvmen\src\licensedcode\data\rules\false-positive_2556.yml", "YAML", 0, 0, 0, 2, 0, 0, 1, 3
"d:\IDEWORK\lvmen\src\licensedcode\data\rules\false-positive_2557.yml", "YAML", 0, 0, 0, 2, 0, 0, 1, 3
"d:\IDEWORK\lvmen\src\licensedcode\data\rules\false-positive_2558.yml", "YAML", 0, 0, 0, 2, 0, 0, 1, 3
"d:\IDEWORK\lvmen\src\licensedcode\data\rules\false-positive_2559.yml", "YAML", 0, 0, 0, 2, 0, 0, 1, 3
"d:\IDEWORK\lvmen\src\licensedcode\data\rules\false-positive_256.yml", "YAML", 0, 0, 0, 2, 0, 0, 1, 3
"d:\IDEWORK\lvmen\src\licensedcode\data\rules\false-positive_2560.yml", "YAML", 0, 0, 0, 2, 0, 0, 1, 3
"d:\IDEWORK\lvmen\src\licensedcode\data\rules\false-positive_2561.yml", "YAML", 0, 0, 0, 2, 0, 0, 1, 3
"d:\IDEWORK\lvmen\src\licensedcode\data\rules\false-positive_2562.yml", "YAML", 0, 0, 0, 2, 0, 0, 1, 3
"d:\IDEWORK\lvmen\src\licensedcode\data\rules\false-positive_2563.yml", "YAML", 0, 0, 0, 2, 0, 0, 1, 3
"d:\IDEWORK\lvmen\src\licensedcode\data\rules\false-positive_2564.yml", "YAML", 0, 0, 0, 2, 0, 0, 1, 3
"d:\IDEWORK\lvmen\src\licensedcode\data\rules\false-positive_2565.yml", "YAML", 0, 0, 0, 2, 0, 0, 1, 3
"d:\IDEWORK\lvmen\src\licensedcode\data\rules\false-positive_2566.yml", "YAML", 0, 0, 0, 2, 0, 0, 1, 3
"d:\IDEWORK\lvmen\src\licensedcode\data\rules\false-positive_2567.yml", "YAML", 0, 0, 0, 2, 0, 0, 1, 3
"d:\IDEWORK\lvmen\src\licensedcode\data\rules\false-positive_2568.yml", "YAML", 0, 0, 0, 2, 0, 0, 1, 3
"d:\IDEWORK\lvmen\src\licensedcode\data\rules\false-positive_2569.yml", "YAML", 0, 0, 0, 2, 0, 0, 1, 3
"d:\IDEWORK\lvmen\src\licensedcode\data\rules\false-positive_257.yml", "YAML", 0, 0, 0, 3, 0, 0, 1, 4
"d:\IDEWORK\lvmen\src\licensedcode\data\rules\false-positive_2570.yml", "YAML", 0, 0, 0, 2, 0, 0, 1, 3
"d:\IDEWORK\lvmen\src\licensedcode\data\rules\false-positive_2571.yml", "YAML", 0, 0, 0, 2, 0, 0, 1, 3
"d:\IDEWORK\lvmen\src\licensedcode\data\rules\false-positive_2572.yml", "YAML", 0, 0, 0, 2, 0, 0, 1, 3
"d:\IDEWORK\lvmen\src\licensedcode\data\rules\false-positive_2573.yml", "YAML", 0, 0, 0, 2, 0, 0, 1, 3
"d:\IDEWORK\lvmen\src\licensedcode\data\rules\false-positive_2574.yml", "YAML", 0, 0, 0, 2, 0, 0, 1, 3
"d:\IDEWORK\lvmen\src\licensedcode\data\rules\false-positive_2575.yml", "YAML", 0, 0, 0, 2, 0, 0, 1, 3
"d:\IDEWORK\lvmen\src\licensedcode\data\rules\false-positive_2576.yml", "YAML", 0, 0, 0, 2, 0, 0, 1, 3
"d:\IDEWORK\lvmen\src\licensedcode\data\rules\false-positive_2577.yml", "YAML", 0, 0, 0, 2, 0, 0, 1, 3
"d:\IDEWORK\lvmen\src\licensedcode\data\rules\false-positive_2578.yml", "YAML", 0, 0, 0, 2, 0, 0, 1, 3
"d:\IDEWORK\lvmen\src\licensedcode\data\rules\false-positive_2579.yml", "YAML", 0, 0, 0, 2, 0, 0, 1, 3
"d:\IDEWORK\lvmen\src\licensedcode\data\rules\false-positive_258.yml", "YAML", 0, 0, 0, 2, 0, 0, 1, 3
"d:\IDEWORK\lvmen\src\licensedcode\data\rules\false-positive_2580.yml", "YAML", 0, 0, 0, 2, 0, 0, 1, 3
"d:\IDEWORK\lvmen\src\licensedcode\data\rules\false-positive_2581.yml", "YAML", 0, 0, 0, 2, 0, 0, 1, 3
"d:\IDEWORK\lvmen\src\licensedcode\data\rules\false-positive_2582.yml", "YAML", 0, 0, 0, 2, 0, 0, 1, 3
"d:\IDEWORK\lvmen\src\licensedcode\data\rules\false-positive_2583.yml", "YAML", 0, 0, 0, 2, 0, 0, 1, 3
"d:\IDEWORK\lvmen\src\licensedcode\data\rules\false-positive_2584.yml", "YAML", 0, 0, 0, 2, 0, 0, 1, 3
"d:\IDEWORK\lvmen\src\licensedcode\data\rules\false-positive_2585.yml", "YAML", 0, 0, 0, 2, 0, 0, 1, 3
"d:\IDEWORK\lvmen\src\licensedcode\data\rules\false-positive_2586.yml", "YAML", 0, 0, 0, 2, 0, 0, 1, 3
"d:\IDEWORK\lvmen\src\licensedcode\data\rules\false-positive_2587.yml", "YAML", 0, 0, 0, 2, 0, 0, 1, 3
"d:\IDEWORK\lvmen\src\licensedcode\data\rules\false-positive_2588.yml", "YAML", 0, 0, 0, 2, 0, 0, 1, 3
"d:\IDEWORK\lvmen\src\licensedcode\data\rules\false-positive_2589.yml", "YAML", 0, 0, 0, 2, 0, 0, 1, 3
"d:\IDEWORK\lvmen\src\licensedcode\data\rules\false-positive_259.yml", "YAML", 0, 0, 0, 2, 0, 0, 1, 3
"d:\IDEWORK\lvmen\src\licensedcode\data\rules\false-positive_2590.yml", "YAML", 0, 0, 0, 2, 0, 0, 1, 3
"d:\IDEWORK\lvmen\src\licensedcode\data\rules\false-positive_2591.yml", "YAML", 0, 0, 0, 2, 0, 0, 1, 3
"d:\IDEWORK\lvmen\src\licensedcode\data\rules\false-positive_2592.yml", "YAML", 0, 0, 0, 2, 0, 0, 1, 3
"d:\IDEWORK\lvmen\src\licensedcode\data\rules\false-positive_2593.yml", "YAML", 0, 0, 0, 2, 0, 0, 1, 3
"d:\IDEWORK\lvmen\src\licensedcode\data\rules\false-positive_2594.yml", "YAML", 0, 0, 0, 2, 0, 0, 1, 3
"d:\IDEWORK\lvmen\src\licensedcode\data\rules\false-positive_2595.yml", "YAML", 0, 0, 0, 2, 0, 0, 1, 3
"d:\IDEWORK\lvmen\src\licensedcode\data\rules\false-positive_2596.yml", "YAML", 0, 0, 0, 2, 0, 0, 1, 3
"d:\IDEWORK\lvmen\src\licensedcode\data\rules\false-positive_2597.yml", "YAML", 0, 0, 0, 2, 0, 0, 1, 3
"d:\IDEWORK\lvmen\src\licensedcode\data\rules\false-positive_2598.yml", "YAML", 0, 0, 0, 2, 0, 0, 1, 3
"d:\IDEWORK\lvmen\src\licensedcode\data\rules\false-positive_2599.yml", "YAML", 0, 0, 0, 2, 0, 0, 1, 3
"d:\IDEWORK\lvmen\src\licensedcode\data\rules\false-positive_26.yml", "YAML", 0, 0, 0, 3, 0, 0, 1, 4
"d:\IDEWORK\lvmen\src\licensedcode\data\rules\false-positive_260.yml", "YAML", 0, 0, 0, 3, 0, 0, 1, 4
"d:\IDEWORK\lvmen\src\licensedcode\data\rules\false-positive_2600.yml", "YAML", 0, 0, 0, 2, 0, 0, 1, 3
"d:\IDEWORK\lvmen\src\licensedcode\data\rules\false-positive_2601.yml", "YAML", 0, 0, 0, 2, 0, 0, 1, 3
"d:\IDEWORK\lvmen\src\licensedcode\data\rules\false-positive_2602.yml", "YAML", 0, 0, 0, 2, 0, 0, 1, 3
"d:\IDEWORK\lvmen\src\licensedcode\data\rules\false-positive_2603.yml", "YAML", 0, 0, 0, 2, 0, 0, 1, 3
"d:\IDEWORK\lvmen\src\licensedcode\data\rules\false-positive_2604.yml", "YAML", 0, 0, 0, 2, 0, 0, 1, 3
"d:\IDEWORK\lvmen\src\licensedcode\data\rules\false-positive_2605.yml", "YAML", 0, 0, 0, 2, 0, 0, 1, 3
"d:\IDEWORK\lvmen\src\licensedcode\data\rules\false-positive_2606.yml", "YAML", 0, 0, 0, 2, 0, 0, 1, 3
"d:\IDEWORK\lvmen\src\licensedcode\data\rules\false-positive_2607.yml", "YAML", 0, 0, 0, 2, 0, 0, 1, 3
"d:\IDEWORK\lvmen\src\licensedcode\data\rules\false-positive_2608.yml", "YAML", 0, 0, 0, 2, 0, 0, 1, 3
"d:\IDEWORK\lvmen\src\licensedcode\data\rules\false-positive_2609.yml", "YAML", 0, 0, 0, 2, 0, 0, 1, 3
"d:\IDEWORK\lvmen\src\licensedcode\data\rules\false-positive_261.yml", "YAML", 0, 0, 0, 2, 0, 0, 1, 3
"d:\IDEWORK\lvmen\src\licensedcode\data\rules\false-positive_2610.yml", "YAML", 0, 0, 0, 2, 0, 0, 1, 3
"d:\IDEWORK\lvmen\src\licensedcode\data\rules\false-positive_2611.yml", "YAML", 0, 0, 0, 2, 0, 0, 1, 3
"d:\IDEWORK\lvmen\src\licensedcode\data\rules\false-positive_2612.yml", "YAML", 0, 0, 0, 2, 0, 0, 1, 3
"d:\IDEWORK\lvmen\src\licensedcode\data\rules\false-positive_2613.yml", "YAML", 0, 0, 0, 2, 0, 0, 1, 3
"d:\IDEWORK\lvmen\src\licensedcode\data\rules\false-positive_2614.yml", "YAML", 0, 0, 0, 2, 0, 0, 1, 3
"d:\IDEWORK\lvmen\src\licensedcode\data\rules\false-positive_2615.yml", "YAML", 0, 0, 0, 2, 0, 0, 1, 3
"d:\IDEWORK\lvmen\src\licensedcode\data\rules\false-positive_2616.yml", "YAML", 0, 0, 0, 2, 0, 0, 1, 3
"d:\IDEWORK\lvmen\src\licensedcode\data\rules\false-positive_2617.yml", "YAML", 0, 0, 0, 2, 0, 0, 1, 3
"d:\IDEWORK\lvmen\src\licensedcode\data\rules\false-positive_2618.yml", "YAML", 0, 0, 0, 2, 0, 0, 1, 3
"d:\IDEWORK\lvmen\src\licensedcode\data\rules\false-positive_2619.yml", "YAML", 0, 0, 0, 2, 0, 0, 1, 3
"d:\IDEWORK\lvmen\src\licensedcode\data\rules\false-positive_262.yml", "YAML", 0, 0, 0, 2, 0, 0, 1, 3
"d:\IDEWORK\lvmen\src\licensedcode\data\rules\false-positive_2620.yml", "YAML", 0, 0, 0, 2, 0, 0, 1, 3
"d:\IDEWORK\lvmen\src\licensedcode\data\rules\false-positive_2621.yml", "YAML", 0, 0, 0, 2, 0, 0, 1, 3
"d:\IDEWORK\lvmen\src\licensedcode\data\rules\false-positive_2622.yml", "YAML", 0, 0, 0, 2, 0, 0, 1, 3
"d:\IDEWORK\lvmen\src\licensedcode\data\rules\false-positive_2623.yml", "YAML", 0, 0, 0, 2, 0, 0, 1, 3
"d:\IDEWORK\lvmen\src\licensedcode\data\rules\false-positive_2624.yml", "YAML", 0, 0, 0, 2, 0, 0, 1, 3
"d:\IDEWORK\lvmen\src\licensedcode\data\rules\false-positive_2625.yml", "YAML", 0, 0, 0, 2, 0, 0, 1, 3
"d:\IDEWORK\lvmen\src\licensedcode\data\rules\false-positive_2626.yml", "YAML", 0, 0, 0, 2, 0, 0, 1, 3
"d:\IDEWORK\lvmen\src\licensedcode\data\rules\false-positive_2627.yml", "YAML", 0, 0, 0, 2, 0, 0, 1, 3
"d:\IDEWORK\lvmen\src\licensedcode\data\rules\false-positive_2628.yml", "YAML", 0, 0, 0, 2, 0, 0, 1, 3
"d:\IDEWORK\lvmen\src\licensedcode\data\rules\false-positive_2629.yml", "YAML", 0, 0, 0, 2, 0, 0, 1, 3
"d:\IDEWORK\lvmen\src\licensedcode\data\rules\false-positive_263.yml", "YAML", 0, 0, 0, 2, 0, 0, 1, 3
"d:\IDEWORK\lvmen\src\licensedcode\data\rules\false-positive_2630.yml", "YAML", 0, 0, 0, 2, 0, 0, 1, 3
"d:\IDEWORK\lvmen\src\licensedcode\data\rules\false-positive_2631.yml", "YAML", 0, 0, 0, 2, 0, 0, 1, 3
"d:\IDEWORK\lvmen\src\licensedcode\data\rules\false-positive_2632.yml", "YAML", 0, 0, 0, 2, 0, 0, 1, 3
"d:\IDEWORK\lvmen\src\licensedcode\data\rules\false-positive_2633.yml", "YAML", 0, 0, 0, 2, 0, 0, 1, 3
"d:\IDEWORK\lvmen\src\licensedcode\data\rules\false-positive_2634.yml", "YAML", 0, 0, 0, 2, 0, 0, 1, 3
"d:\IDEWORK\lvmen\src\licensedcode\data\rules\false-positive_2635.yml", "YAML", 0, 0, 0, 2, 0, 0, 1, 3
"d:\IDEWORK\lvmen\src\licensedcode\data\rules\false-positive_2636.yml", "YAML", 0, 0, 0, 2, 0, 0, 1, 3
"d:\IDEWORK\lvmen\src\licensedcode\data\rules\false-positive_2637.yml", "YAML", 0, 0, 0, 2, 0, 0, 1, 3
"d:\IDEWORK\lvmen\src\licensedcode\data\rules\false-positive_2638.yml", "YAML", 0, 0, 0, 2, 0, 0, 1, 3
"d:\IDEWORK\lvmen\src\licensedcode\data\rules\false-positive_2639.yml", "YAML", 0, 0, 0, 2, 0, 0, 1, 3
"d:\IDEWORK\lvmen\src\licensedcode\data\rules\false-positive_264.yml", "YAML", 0, 0, 0, 2, 0, 0, 1, 3
"d:\IDEWORK\lvmen\src\licensedcode\data\rules\false-positive_2640.yml", "YAML", 0, 0, 0, 2, 0, 0, 1, 3
"d:\IDEWORK\lvmen\src\licensedcode\data\rules\false-positive_2641.yml", "YAML", 0, 0, 0, 2, 0, 0, 1, 3
"d:\IDEWORK\lvmen\src\licensedcode\data\rules\false-positive_2642.yml", "YAML", 0, 0, 0, 2, 0, 0, 1, 3
"d:\IDEWORK\lvmen\src\licensedcode\data\rules\false-positive_2643.yml", "YAML", 0, 0, 0, 2, 0, 0, 1, 3
"d:\IDEWORK\lvmen\src\licensedcode\data\rules\false-positive_2644.yml", "YAML", 0, 0, 0, 2, 0, 0, 1, 3
"d:\IDEWORK\lvmen\src\licensedcode\data\rules\false-positive_2645.yml", "YAML", 0, 0, 0, 2, 0, 0, 1, 3
"d:\IDEWORK\lvmen\src\licensedcode\data\rules\false-positive_2646.yml", "YAML", 0, 0, 0, 2, 0, 0, 1, 3
"d:\IDEWORK\lvmen\src\licensedcode\data\rules\false-positive_2647.yml", "YAML", 0, 0, 0, 2, 0, 0, 1, 3
"d:\IDEWORK\lvmen\src\licensedcode\data\rules\false-positive_2648.yml", "YAML", 0, 0, 0, 2, 0, 0, 1, 3
"d:\IDEWORK\lvmen\src\licensedcode\data\rules\false-positive_2649.yml", "YAML", 0, 0, 0, 2, 0, 0, 1, 3
"d:\IDEWORK\lvmen\src\licensedcode\data\rules\false-positive_265.yml", "YAML", 0, 0, 0, 2, 0, 0, 1, 3
"d:\IDEWORK\lvmen\src\licensedcode\data\rules\false-positive_2650.yml", "YAML", 0, 0, 0, 2, 0, 0, 1, 3
"d:\IDEWORK\lvmen\src\licensedcode\data\rules\false-positive_2651.yml", "YAML", 0, 0, 0, 2, 0, 0, 1, 3
"d:\IDEWORK\lvmen\src\licensedcode\data\rules\false-positive_2652.yml", "YAML", 0, 0, 0, 2, 0, 0, 1, 3
"d:\IDEWORK\lvmen\src\licensedcode\data\rules\false-positive_2653.yml", "YAML", 0, 0, 0, 2, 0, 0, 1, 3
"d:\IDEWORK\lvmen\src\licensedcode\data\rules\false-positive_2654.yml", "YAML", 0, 0, 0, 2, 0, 0, 1, 3
"d:\IDEWORK\lvmen\src\licensedcode\data\rules\false-positive_2655.yml", "YAML", 0, 0, 0, 2, 0, 0, 1, 3
"d:\IDEWORK\lvmen\src\licensedcode\data\rules\false-positive_2656.yml", "YAML", 0, 0, 0, 2, 0, 0, 1, 3
"d:\IDEWORK\lvmen\src\licensedcode\data\rules\false-positive_2657.yml", "YAML", 0, 0, 0, 2, 0, 0, 1, 3
"d:\IDEWORK\lvmen\src\licensedcode\data\rules\false-positive_2658.yml", "YAML", 0, 0, 0, 2, 0, 0, 1, 3
"d:\IDEWORK\lvmen\src\licensedcode\data\rules\false-positive_2659.yml", "YAML", 0, 0, 0, 2, 0, 0, 1, 3
"d:\IDEWORK\lvmen\src\licensedcode\data\rules\false-positive_266.yml", "YAML", 0, 0, 0, 2, 0, 0, 1, 3
"d:\IDEWORK\lvmen\src\licensedcode\data\rules\false-positive_2660.yml", "YAML", 0, 0, 0, 2, 0, 0, 1, 3
"d:\IDEWORK\lvmen\src\licensedcode\data\rules\false-positive_2661.yml", "YAML", 0, 0, 0, 2, 0, 0, 1, 3
"d:\IDEWORK\lvmen\src\licensedcode\data\rules\false-positive_2662.yml", "YAML", 0, 0, 0, 2, 0, 0, 1, 3
"d:\IDEWORK\lvmen\src\licensedcode\data\rules\false-positive_2663.yml", "YAML", 0, 0, 0, 2, 0, 0, 1, 3
"d:\IDEWORK\lvmen\src\licensedcode\data\rules\false-positive_2664.yml", "YAML", 0, 0, 0, 2, 0, 0, 1, 3
"d:\IDEWORK\lvmen\src\licensedcode\data\rules\false-positive_2665.yml", "YAML", 0, 0, 0, 2, 0, 0, 1, 3
"d:\IDEWORK\lvmen\src\licensedcode\data\rules\false-positive_2666.yml", "YAML", 0, 0, 0, 2, 0, 0, 1, 3
"d:\IDEWORK\lvmen\src\licensedcode\data\rules\false-positive_2667.yml", "YAML", 0, 0, 0, 2, 0, 0, 1, 3
"d:\IDEWORK\lvmen\src\licensedcode\data\rules\false-positive_2668.yml", "YAML", 0, 0, 0, 2, 0, 0, 1, 3
"d:\IDEWORK\lvmen\src\licensedcode\data\rules\false-positive_2669.yml", "YAML", 0, 0, 0, 2, 0, 0, 1, 3
"d:\IDEWORK\lvmen\src\licensedcode\data\rules\false-positive_267.yml", "YAML", 0, 0, 0, 2, 0, 0, 1, 3
"d:\IDEWORK\lvmen\src\licensedcode\data\rules\false-positive_2670.yml", "YAML", 0, 0, 0, 2, 0, 0, 1, 3
"d:\IDEWORK\lvmen\src\licensedcode\data\rules\false-positive_2671.yml", "YAML", 0, 0, 0, 2, 0, 0, 1, 3
"d:\IDEWORK\lvmen\src\licensedcode\data\rules\false-positive_2672.yml", "YAML", 0, 0, 0, 2, 0, 0, 1, 3
"d:\IDEWORK\lvmen\src\licensedcode\data\rules\false-positive_2673.yml", "YAML", 0, 0, 0, 2, 0, 0, 1, 3
"d:\IDEWORK\lvmen\src\licensedcode\data\rules\false-positive_2674.yml", "YAML", 0, 0, 0, 2, 0, 0, 1, 3
"d:\IDEWORK\lvmen\src\licensedcode\data\rules\false-positive_2675.yml", "YAML", 0, 0, 0, 2, 0, 0, 1, 3
"d:\IDEWORK\lvmen\src\licensedcode\data\rules\false-positive_2676.yml", "YAML", 0, 0, 0, 2, 0, 0, 1, 3
"d:\IDEWORK\lvmen\src\licensedcode\data\rules\false-positive_2677.yml", "YAML", 0, 0, 0, 2, 0, 0, 1, 3
"d:\IDEWORK\lvmen\src\licensedcode\data\rules\false-positive_2678.yml", "YAML", 0, 0, 0, 2, 0, 0, 1, 3
"d:\IDEWORK\lvmen\src\licensedcode\data\rules\false-positive_2679.yml", "YAML", 0, 0, 0, 2, 0, 0, 1, 3
"d:\IDEWORK\lvmen\src\licensedcode\data\rules\false-positive_268.yml", "YAML", 0, 0, 0, 2, 0, 0, 1, 3
"d:\IDEWORK\lvmen\src\licensedcode\data\rules\false-positive_2680.yml", "YAML", 0, 0, 0, 2, 0, 0, 1, 3
"d:\IDEWORK\lvmen\src\licensedcode\data\rules\false-positive_2681.yml", "YAML", 0, 0, 0, 2, 0, 0, 1, 3
"d:\IDEWORK\lvmen\src\licensedcode\data\rules\false-positive_2682.yml", "YAML", 0, 0, 0, 2, 0, 0, 1, 3
"d:\IDEWORK\lvmen\src\licensedcode\data\rules\false-positive_2683.yml", "YAML", 0, 0, 0, 2, 0, 0, 1, 3
"d:\IDEWORK\lvmen\src\licensedcode\data\rules\false-positive_2684.yml", "YAML", 0, 0, 0, 2, 0, 0, 1, 3
"d:\IDEWORK\lvmen\src\licensedcode\data\rules\false-positive_2685.yml", "YAML", 0, 0, 0, 2, 0, 0, 1, 3
"d:\IDEWORK\lvmen\src\licensedcode\data\rules\false-positive_2686.yml", "YAML", 0, 0, 0, 2, 0, 0, 1, 3
"d:\IDEWORK\lvmen\src\licensedcode\data\rules\false-positive_2687.yml", "YAML", 0, 0, 0, 2, 0, 0, 1, 3
"d:\IDEWORK\lvmen\src\licensedcode\data\rules\false-positive_2688.yml", "YAML", 0, 0, 0, 2, 0, 0, 1, 3
"d:\IDEWORK\lvmen\src\licensedcode\data\rules\false-positive_2689.yml", "YAML", 0, 0, 0, 2, 0, 0, 1, 3
"d:\IDEWORK\lvmen\src\licensedcode\data\rules\false-positive_269.yml", "YAML", 0, 0, 0, 2, 0, 0, 1, 3
"d:\IDEWORK\lvmen\src\licensedcode\data\rules\false-positive_2690.yml", "YAML", 0, 0, 0, 2, 0, 0, 1, 3
"d:\IDEWORK\lvmen\src\licensedcode\data\rules\false-positive_2691.yml", "YAML", 0, 0, 0, 2, 0, 0, 1, 3
"d:\IDEWORK\lvmen\src\licensedcode\data\rules\false-positive_2692.yml", "YAML", 0, 0, 0, 2, 0, 0, 1, 3
"d:\IDEWORK\lvmen\src\licensedcode\data\rules\false-positive_2693.yml", "YAML", 0, 0, 0, 2, 0, 0, 1, 3
"d:\IDEWORK\lvmen\src\licensedcode\data\rules\false-positive_2694.yml", "YAML", 0, 0, 0, 2, 0, 0, 1, 3
"d:\IDEWORK\lvmen\src\licensedcode\data\rules\false-positive_2695.yml", "YAML", 0, 0, 0, 2, 0, 0, 1, 3
"d:\IDEWORK\lvmen\src\licensedcode\data\rules\false-positive_2696.yml", "YAML", 0, 0, 0, 2, 0, 0, 1, 3
"d:\IDEWORK\lvmen\src\licensedcode\data\rules\false-positive_2697.yml", "YAML", 0, 0, 0, 2, 0, 0, 1, 3
"d:\IDEWORK\lvmen\src\licensedcode\data\rules\false-positive_2698.yml", "YAML", 0, 0, 0, 2, 0, 0, 1, 3
"d:\IDEWORK\lvmen\src\licensedcode\data\rules\false-positive_2699.yml", "YAML", 0, 0, 0, 2, 0, 0, 1, 3
"d:\IDEWORK\lvmen\src\licensedcode\data\rules\false-positive_27.yml", "YAML", 0, 0, 0, 3, 0, 0, 1, 4
"d:\IDEWORK\lvmen\src\licensedcode\data\rules\false-positive_270.yml", "YAML", 0, 0, 0, 2, 0, 0, 1, 3
"d:\IDEWORK\lvmen\src\licensedcode\data\rules\false-positive_2700.yml", "YAML", 0, 0, 0, 2, 0, 0, 1, 3
"d:\IDEWORK\lvmen\src\licensedcode\data\rules\false-positive_2701.yml", "YAML", 0, 0, 0, 2, 0, 0, 1, 3
"d:\IDEWORK\lvmen\src\licensedcode\data\rules\false-positive_2702.yml", "YAML", 0, 0, 0, 2, 0, 0, 1, 3
"d:\IDEWORK\lvmen\src\licensedcode\data\rules\false-positive_2703.yml", "YAML", 0, 0, 0, 2, 0, 0, 1, 3
"d:\IDEWORK\lvmen\src\licensedcode\data\rules\false-positive_2704.yml", "YAML", 0, 0, 0, 2, 0, 0, 1, 3
"d:\IDEWORK\lvmen\src\licensedcode\data\rules\false-positive_2705.yml", "YAML", 0, 0, 0, 2, 0, 0, 1, 3
"d:\IDEWORK\lvmen\src\licensedcode\data\rules\false-positive_2706.yml", "YAML", 0, 0, 0, 2, 0, 0, 1, 3
"d:\IDEWORK\lvmen\src\licensedcode\data\rules\false-positive_2707.yml", "YAML", 0, 0, 0, 2, 0, 0, 1, 3
"d:\IDEWORK\lvmen\src\licensedcode\data\rules\false-positive_2708.yml", "YAML", 0, 0, 0, 2, 0, 0, 1, 3
"d:\IDEWORK\lvmen\src\licensedcode\data\rules\false-positive_2709.yml", "YAML", 0, 0, 0, 2, 0, 0, 1, 3
"d:\IDEWORK\lvmen\src\licensedcode\data\rules\false-positive_271.yml", "YAML", 0, 0, 0, 2, 0, 0, 1, 3
"d:\IDEWORK\lvmen\src\licensedcode\data\rules\false-positive_2710.yml", "YAML", 0, 0, 0, 2, 0, 0, 1, 3
"d:\IDEWORK\lvmen\src\licensedcode\data\rules\false-positive_2711.yml", "YAML", 0, 0, 0, 2, 0, 0, 1, 3
"d:\IDEWORK\lvmen\src\licensedcode\data\rules\false-positive_2712.yml", "YAML", 0, 0, 0, 2, 0, 0, 1, 3
"d:\IDEWORK\lvmen\src\licensedcode\data\rules\false-positive_2713.yml", "YAML", 0, 0, 0, 2, 0, 0, 1, 3
"d:\IDEWORK\lvmen\src\licensedcode\data\rules\false-positive_2714.yml", "YAML", 0, 0, 0, 2, 0, 0, 1, 3
"d:\IDEWORK\lvmen\src\licensedcode\data\rules\false-positive_2715.yml", "YAML", 0, 0, 0, 2, 0, 0, 1, 3
"d:\IDEWORK\lvmen\src\licensedcode\data\rules\false-positive_2716.yml", "YAML", 0, 0, 0, 2, 0, 0, 1, 3
"d:\IDEWORK\lvmen\src\licensedcode\data\rules\false-positive_2717.yml", "YAML", 0, 0, 0, 2, 0, 0, 1, 3
"d:\IDEWORK\lvmen\src\licensedcode\data\rules\false-positive_2718.yml", "YAML", 0, 0, 0, 2, 0, 0, 1, 3
"d:\IDEWORK\lvmen\src\licensedcode\data\rules\false-positive_2719.yml", "YAML", 0, 0, 0, 2, 0, 0, 1, 3
"d:\IDEWORK\lvmen\src\licensedcode\data\rules\false-positive_272.yml", "YAML", 0, 0, 0, 2, 0, 0, 1, 3
"d:\IDEWORK\lvmen\src\licensedcode\data\rules\false-positive_2720.yml", "YAML", 0, 0, 0, 2, 0, 0, 1, 3
"d:\IDEWORK\lvmen\src\licensedcode\data\rules\false-positive_2721.yml", "YAML", 0, 0, 0, 2, 0, 0, 1, 3
"d:\IDEWORK\lvmen\src\licensedcode\data\rules\false-positive_2722.yml", "YAML", 0, 0, 0, 2, 0, 0, 1, 3
"d:\IDEWORK\lvmen\src\licensedcode\data\rules\false-positive_2723.yml", "YAML", 0, 0, 0, 2, 0, 0, 1, 3
"d:\IDEWORK\lvmen\src\licensedcode\data\rules\false-positive_2724.yml", "YAML", 0, 0, 0, 2, 0, 0, 1, 3
"d:\IDEWORK\lvmen\src\licensedcode\data\rules\false-positive_2725.yml", "YAML", 0, 0, 0, 2, 0, 0, 1, 3
"d:\IDEWORK\lvmen\src\licensedcode\data\rules\false-positive_2726.yml", "YAML", 0, 0, 0, 2, 0, 0, 1, 3
"d:\IDEWORK\lvmen\src\licensedcode\data\rules\false-positive_2727.yml", "YAML", 0, 0, 0, 2, 0, 0, 1, 3
"d:\IDEWORK\lvmen\src\licensedcode\data\rules\false-positive_2728.yml", "YAML", 0, 0, 0, 2, 0, 0, 1, 3
"d:\IDEWORK\lvmen\src\licensedcode\data\rules\false-positive_2729.yml", "YAML", 0, 0, 0, 2, 0, 0, 1, 3
"d:\IDEWORK\lvmen\src\licensedcode\data\rules\false-positive_273.yml", "YAML", 0, 0, 0, 2, 0, 0, 1, 3
"d:\IDEWORK\lvmen\src\licensedcode\data\rules\false-positive_2730.yml", "YAML", 0, 0, 0, 2, 0, 0, 1, 3
"d:\IDEWORK\lvmen\src\licensedcode\data\rules\false-positive_2731.yml", "YAML", 0, 0, 0, 2, 0, 0, 1, 3
"d:\IDEWORK\lvmen\src\licensedcode\data\rules\false-positive_2732.yml", "YAML", 0, 0, 0, 2, 0, 0, 1, 3
"d:\IDEWORK\lvmen\src\licensedcode\data\rules\false-positive_2733.yml", "YAML", 0, 0, 0, 2, 0, 0, 1, 3
"d:\IDEWORK\lvmen\src\licensedcode\data\rules\false-positive_2734.yml", "YAML", 0, 0, 0, 2, 0, 0, 1, 3
"d:\IDEWORK\lvmen\src\licensedcode\data\rules\false-positive_2735.yml", "YAML", 0, 0, 0, 2, 0, 0, 1, 3
"d:\IDEWORK\lvmen\src\licensedcode\data\rules\false-positive_2736.yml", "YAML", 0, 0, 0, 2, 0, 0, 1, 3
"d:\IDEWORK\lvmen\src\licensedcode\data\rules\false-positive_2737.yml", "YAML", 0, 0, 0, 2, 0, 0, 1, 3
"d:\IDEWORK\lvmen\src\licensedcode\data\rules\false-positive_2738.yml", "YAML", 0, 0, 0, 2, 0, 0, 1, 3
"d:\IDEWORK\lvmen\src\licensedcode\data\rules\false-positive_2739.yml", "YAML", 0, 0, 0, 2, 0, 0, 1, 3
"d:\IDEWORK\lvmen\src\licensedcode\data\rules\false-positive_274.yml", "YAML", 0, 0, 0, 2, 0, 0, 1, 3
"d:\IDEWORK\lvmen\src\licensedcode\data\rules\false-positive_2740.yml", "YAML", 0, 0, 0, 2, 0, 0, 1, 3
"d:\IDEWORK\lvmen\src\licensedcode\data\rules\false-positive_2741.yml", "YAML", 0, 0, 0, 2, 0, 0, 1, 3
"d:\IDEWORK\lvmen\src\licensedcode\data\rules\false-positive_2742.yml", "YAML", 0, 0, 0, 2, 0, 0, 1, 3
"d:\IDEWORK\lvmen\src\licensedcode\data\rules\false-positive_2743.yml", "YAML", 0, 0, 0, 2, 0, 0, 1, 3
"d:\IDEWORK\lvmen\src\licensedcode\data\rules\false-positive_2744.yml", "YAML", 0, 0, 0, 2, 0, 0, 1, 3
"d:\IDEWORK\lvmen\src\licensedcode\data\rules\false-positive_2745.yml", "YAML", 0, 0, 0, 2, 0, 0, 1, 3
"d:\IDEWORK\lvmen\src\licensedcode\data\rules\false-positive_2746.yml", "YAML", 0, 0, 0, 2, 0, 0, 1, 3
"d:\IDEWORK\lvmen\src\licensedcode\data\rules\false-positive_2747.yml", "YAML", 0, 0, 0, 2, 0, 0, 1, 3
"d:\IDEWORK\lvmen\src\licensedcode\data\rules\false-positive_2748.yml", "YAML", 0, 0, 0, 2, 0, 0, 1, 3
"d:\IDEWORK\lvmen\src\licensedcode\data\rules\false-positive_2749.yml", "YAML", 0, 0, 0, 2, 0, 0, 1, 3
"d:\IDEWORK\lvmen\src\licensedcode\data\rules\false-positive_275.yml", "YAML", 0, 0, 0, 2, 0, 0, 1, 3
"d:\IDEWORK\lvmen\src\licensedcode\data\rules\false-positive_2750.yml", "YAML", 0, 0, 0, 2, 0, 0, 1, 3
"d:\IDEWORK\lvmen\src\licensedcode\data\rules\false-positive_2751.yml", "YAML", 0, 0, 0, 2, 0, 0, 1, 3
"d:\IDEWORK\lvmen\src\licensedcode\data\rules\false-positive_2752.yml", "YAML", 0, 0, 0, 2, 0, 0, 1, 3
"d:\IDEWORK\lvmen\src\licensedcode\data\rules\false-positive_2753.yml", "YAML", 0, 0, 0, 2, 0, 0, 1, 3
"d:\IDEWORK\lvmen\src\licensedcode\data\rules\false-positive_2754.yml", "YAML", 0, 0, 0, 2, 0, 0, 1, 3
"d:\IDEWORK\lvmen\src\licensedcode\data\rules\false-positive_2755.yml", "YAML", 0, 0, 0, 2, 0, 0, 1, 3
"d:\IDEWORK\lvmen\src\licensedcode\data\rules\false-positive_2756.yml", "YAML", 0, 0, 0, 2, 0, 0, 1, 3
"d:\IDEWORK\lvmen\src\licensedcode\data\rules\false-positive_2757.yml", "YAML", 0, 0, 0, 2, 0, 0, 1, 3
"d:\IDEWORK\lvmen\src\licensedcode\data\rules\false-positive_2758.yml", "YAML", 0, 0, 0, 2, 0, 0, 1, 3
"d:\IDEWORK\lvmen\src\licensedcode\data\rules\false-positive_2759.yml", "YAML", 0, 0, 0, 2, 0, 0, 1, 3
"d:\IDEWORK\lvmen\src\licensedcode\data\rules\false-positive_276.yml", "YAML", 0, 0, 0, 3, 0, 0, 1, 4
"d:\IDEWORK\lvmen\src\licensedcode\data\rules\false-positive_2760.yml", "YAML", 0, 0, 0, 2, 0, 0, 1, 3
"d:\IDEWORK\lvmen\src\licensedcode\data\rules\false-positive_2761.yml", "YAML", 0, 0, 0, 2, 0, 0, 1, 3
"d:\IDEWORK\lvmen\src\licensedcode\data\rules\false-positive_2762.yml", "YAML", 0, 0, 0, 2, 0, 0, 1, 3
"d:\IDEWORK\lvmen\src\licensedcode\data\rules\false-positive_2763.yml", "YAML", 0, 0, 0, 2, 0, 0, 1, 3
"d:\IDEWORK\lvmen\src\licensedcode\data\rules\false-positive_2764.yml", "YAML", 0, 0, 0, 2, 0, 0, 1, 3
"d:\IDEWORK\lvmen\src\licensedcode\data\rules\false-positive_2765.yml", "YAML", 0, 0, 0, 2, 0, 0, 1, 3
"d:\IDEWORK\lvmen\src\licensedcode\data\rules\false-positive_2766.yml", "YAML", 0, 0, 0, 2, 0, 0, 1, 3
"d:\IDEWORK\lvmen\src\licensedcode\data\rules\false-positive_2767.yml", "YAML", 0, 0, 0, 2, 0, 0, 1, 3
"d:\IDEWORK\lvmen\src\licensedcode\data\rules\false-positive_2768.yml", "YAML", 0, 0, 0, 2, 0, 0, 1, 3
"d:\IDEWORK\lvmen\src\licensedcode\data\rules\false-positive_2769.yml", "YAML", 0, 0, 0, 2, 0, 0, 1, 3
"d:\IDEWORK\lvmen\src\licensedcode\data\rules\false-positive_277.yml", "YAML", 0, 0, 0, 2, 0, 0, 1, 3
"d:\IDEWORK\lvmen\src\licensedcode\data\rules\false-positive_2770.yml", "YAML", 0, 0, 0, 2, 0, 0, 1, 3
"d:\IDEWORK\lvmen\src\licensedcode\data\rules\false-positive_2771.yml", "YAML", 0, 0, 0, 2, 0, 0, 1, 3
"d:\IDEWORK\lvmen\src\licensedcode\data\rules\false-positive_2772.yml", "YAML", 0, 0, 0, 2, 0, 0, 1, 3
"d:\IDEWORK\lvmen\src\licensedcode\data\rules\false-positive_2773.yml", "YAML", 0, 0, 0, 2, 0, 0, 1, 3
"d:\IDEWORK\lvmen\src\licensedcode\data\rules\false-positive_2774.yml", "YAML", 0, 0, 0, 2, 0, 0, 1, 3
"d:\IDEWORK\lvmen\src\licensedcode\data\rules\false-positive_2775.yml", "YAML", 0, 0, 0, 2, 0, 0, 1, 3
"d:\IDEWORK\lvmen\src\licensedcode\data\rules\false-positive_2776.yml", "YAML", 0, 0, 0, 2, 0, 0, 1, 3
"d:\IDEWORK\lvmen\src\licensedcode\data\rules\false-positive_2777.yml", "YAML", 0, 0, 0, 2, 0, 0, 1, 3
"d:\IDEWORK\lvmen\src\licensedcode\data\rules\false-positive_2778.yml", "YAML", 0, 0, 0, 2, 0, 0, 1, 3
"d:\IDEWORK\lvmen\src\licensedcode\data\rules\false-positive_2779.yml", "YAML", 0, 0, 0, 2, 0, 0, 1, 3
"d:\IDEWORK\lvmen\src\licensedcode\data\rules\false-positive_278.yml", "YAML", 0, 0, 0, 3, 0, 0, 1, 4
"d:\IDEWORK\lvmen\src\licensedcode\data\rules\false-positive_2780.yml", "YAML", 0, 0, 0, 2, 0, 0, 1, 3
"d:\IDEWORK\lvmen\src\licensedcode\data\rules\false-positive_2781.yml", "YAML", 0, 0, 0, 2, 0, 0, 1, 3
"d:\IDEWORK\lvmen\src\licensedcode\data\rules\false-positive_2782.yml", "YAML", 0, 0, 0, 2, 0, 0, 1, 3
"d:\IDEWORK\lvmen\src\licensedcode\data\rules\false-positive_2783.yml", "YAML", 0, 0, 0, 2, 0, 0, 1, 3
"d:\IDEWORK\lvmen\src\licensedcode\data\rules\false-positive_2784.yml", "YAML", 0, 0, 0, 2, 0, 0, 1, 3
"d:\IDEWORK\lvmen\src\licensedcode\data\rules\false-positive_2785.yml", "YAML", 0, 0, 0, 2, 0, 0, 1, 3
"d:\IDEWORK\lvmen\src\licensedcode\data\rules\false-positive_2786.yml", "YAML", 0, 0, 0, 2, 0, 0, 1, 3
"d:\IDEWORK\lvmen\src\licensedcode\data\rules\false-positive_2787.yml", "YAML", 0, 0, 0, 2, 0, 0, 1, 3
"d:\IDEWORK\lvmen\src\licensedcode\data\rules\false-positive_2788.yml", "YAML", 0, 0, 0, 2, 0, 0, 1, 3
"d:\IDEWORK\lvmen\src\licensedcode\data\rules\false-positive_2789.yml", "YAML", 0, 0, 0, 2, 0, 0, 1, 3
"d:\IDEWORK\lvmen\src\licensedcode\data\rules\false-positive_279.yml", "YAML", 0, 0, 0, 2, 0, 0, 1, 3
"d:\IDEWORK\lvmen\src\licensedcode\data\rules\false-positive_2790.yml", "YAML", 0, 0, 0, 2, 0, 0, 1, 3
"d:\IDEWORK\lvmen\src\licensedcode\data\rules\false-positive_2791.yml", "YAML", 0, 0, 0, 2, 0, 0, 1, 3
"d:\IDEWORK\lvmen\src\licensedcode\data\rules\false-positive_2792.yml", "YAML", 0, 0, 0, 2, 0, 0, 1, 3
"d:\IDEWORK\lvmen\src\licensedcode\data\rules\false-positive_2793.yml", "YAML", 0, 0, 0, 2, 0, 0, 1, 3
"d:\IDEWORK\lvmen\src\licensedcode\data\rules\false-positive_2794.yml", "YAML", 0, 0, 0, 2, 0, 0, 1, 3
"d:\IDEWORK\lvmen\src\licensedcode\data\rules\false-positive_2795.yml", "YAML", 0, 0, 0, 2, 0, 0, 1, 3
"d:\IDEWORK\lvmen\src\licensedcode\data\rules\false-positive_2796.yml", "YAML", 0, 0, 0, 2, 0, 0, 1, 3
"d:\IDEWORK\lvmen\src\licensedcode\data\rules\false-positive_2797.yml", "YAML", 0, 0, 0, 2, 0, 0, 1, 3
"d:\IDEWORK\lvmen\src\licensedcode\data\rules\false-positive_2798.yml", "YAML", 0, 0, 0, 2, 0, 0, 1, 3
"d:\IDEWORK\lvmen\src\licensedcode\data\rules\false-positive_2799.yml", "YAML", 0, 0, 0, 2, 0, 0, 1, 3
"d:\IDEWORK\lvmen\src\licensedcode\data\rules\false-positive_28.yml", "YAML", 0, 0, 0, 2, 0, 0, 1, 3
"d:\IDEWORK\lvmen\src\licensedcode\data\rules\false-positive_280.yml", "YAML", 0, 0, 0, 2, 0, 0, 1, 3
"d:\IDEWORK\lvmen\src\licensedcode\data\rules\false-positive_2800.yml", "YAML", 0, 0, 0, 2, 0, 0, 1, 3
"d:\IDEWORK\lvmen\src\licensedcode\data\rules\false-positive_2801.yml", "YAML", 0, 0, 0, 2, 0, 0, 1, 3
"d:\IDEWORK\lvmen\src\licensedcode\data\rules\false-positive_2802.yml", "YAML", 0, 0, 0, 2, 0, 0, 1, 3
"d:\IDEWORK\lvmen\src\licensedcode\data\rules\false-positive_2803.yml", "YAML", 0, 0, 0, 2, 0, 0, 1, 3
"d:\IDEWORK\lvmen\src\licensedcode\data\rules\false-positive_2804.yml", "YAML", 0, 0, 0, 2, 0, 0, 1, 3
"d:\IDEWORK\lvmen\src\licensedcode\data\rules\false-positive_2805.yml", "YAML", 0, 0, 0, 2, 0, 0, 1, 3
"d:\IDEWORK\lvmen\src\licensedcode\data\rules\false-positive_2806.yml", "YAML", 0, 0, 0, 2, 0, 0, 1, 3
"d:\IDEWORK\lvmen\src\licensedcode\data\rules\false-positive_2807.yml", "YAML", 0, 0, 0, 2, 0, 0, 1, 3
"d:\IDEWORK\lvmen\src\licensedcode\data\rules\false-positive_2808.yml", "YAML", 0, 0, 0, 2, 0, 0, 1, 3
"d:\IDEWORK\lvmen\src\licensedcode\data\rules\false-positive_2809.yml", "YAML", 0, 0, 0, 2, 0, 0, 1, 3
"d:\IDEWORK\lvmen\src\licensedcode\data\rules\false-positive_281.yml", "YAML", 0, 0, 0, 2, 0, 0, 1, 3
"d:\IDEWORK\lvmen\src\licensedcode\data\rules\false-positive_2810.yml", "YAML", 0, 0, 0, 2, 0, 0, 1, 3
"d:\IDEWORK\lvmen\src\licensedcode\data\rules\false-positive_2811.yml", "YAML", 0, 0, 0, 2, 0, 0, 1, 3
"d:\IDEWORK\lvmen\src\licensedcode\data\rules\false-positive_2812.yml", "YAML", 0, 0, 0, 2, 0, 0, 1, 3
"d:\IDEWORK\lvmen\src\licensedcode\data\rules\false-positive_2813.yml", "YAML", 0, 0, 0, 2, 0, 0, 1, 3
"d:\IDEWORK\lvmen\src\licensedcode\data\rules\false-positive_2814.yml", "YAML", 0, 0, 0, 2, 0, 0, 1, 3
"d:\IDEWORK\lvmen\src\licensedcode\data\rules\false-positive_2815.yml", "YAML", 0, 0, 0, 2, 0, 0, 1, 3
"d:\IDEWORK\lvmen\src\licensedcode\data\rules\false-positive_2816.yml", "YAML", 0, 0, 0, 2, 0, 0, 1, 3
"d:\IDEWORK\lvmen\src\licensedcode\data\rules\false-positive_2817.yml", "YAML", 0, 0, 0, 2, 0, 0, 1, 3
"d:\IDEWORK\lvmen\src\licensedcode\data\rules\false-positive_2818.yml", "YAML", 0, 0, 0, 2, 0, 0, 1, 3
"d:\IDEWORK\lvmen\src\licensedcode\data\rules\false-positive_2819.yml", "YAML", 0, 0, 0, 2, 0, 0, 1, 3
"d:\IDEWORK\lvmen\src\licensedcode\data\rules\false-positive_282.yml", "YAML", 0, 0, 0, 2, 0, 0, 1, 3
"d:\IDEWORK\lvmen\src\licensedcode\data\rules\false-positive_2820.yml", "YAML", 0, 0, 0, 2, 0, 0, 1, 3
"d:\IDEWORK\lvmen\src\licensedcode\data\rules\false-positive_2821.yml", "YAML", 0, 0, 0, 2, 0, 0, 1, 3
"d:\IDEWORK\lvmen\src\licensedcode\data\rules\false-positive_2822.yml", "YAML", 0, 0, 0, 2, 0, 0, 1, 3
"d:\IDEWORK\lvmen\src\licensedcode\data\rules\false-positive_2823.yml", "YAML", 0, 0, 0, 2, 0, 0, 1, 3
"d:\IDEWORK\lvmen\src\licensedcode\data\rules\false-positive_2824.yml", "YAML", 0, 0, 0, 2, 0, 0, 1, 3
"d:\IDEWORK\lvmen\src\licensedcode\data\rules\false-positive_2825.yml", "YAML", 0, 0, 0, 2, 0, 0, 1, 3
"d:\IDEWORK\lvmen\src\licensedcode\data\rules\false-positive_2826.yml", "YAML", 0, 0, 0, 2, 0, 0, 1, 3
"d:\IDEWORK\lvmen\src\licensedcode\data\rules\false-positive_2827.yml", "YAML", 0, 0, 0, 2, 0, 0, 1, 3
"d:\IDEWORK\lvmen\src\licensedcode\data\rules\false-positive_2828.yml", "YAML", 0, 0, 0, 2, 0, 0, 1, 3
"d:\IDEWORK\lvmen\src\licensedcode\data\rules\false-positive_2829.yml", "YAML", 0, 0, 0, 2, 0, 0, 1, 3
"d:\IDEWORK\lvmen\src\licensedcode\data\rules\false-positive_283.yml", "YAML", 0, 0, 0, 2, 0, 0, 1, 3
"d:\IDEWORK\lvmen\src\licensedcode\data\rules\false-positive_2830.yml", "YAML", 0, 0, 0, 2, 0, 0, 1, 3
"d:\IDEWORK\lvmen\src\licensedcode\data\rules\false-positive_2831.yml", "YAML", 0, 0, 0, 2, 0, 0, 1, 3
"d:\IDEWORK\lvmen\src\licensedcode\data\rules\false-positive_2832.yml", "YAML", 0, 0, 0, 2, 0, 0, 1, 3
"d:\IDEWORK\lvmen\src\licensedcode\data\rules\false-positive_2833.yml", "YAML", 0, 0, 0, 2, 0, 0, 1, 3
"d:\IDEWORK\lvmen\src\licensedcode\data\rules\false-positive_2834.yml", "YAML", 0, 0, 0, 2, 0, 0, 1, 3
"d:\IDEWORK\lvmen\src\licensedcode\data\rules\false-positive_2835.yml", "YAML", 0, 0, 0, 2, 0, 0, 1, 3
"d:\IDEWORK\lvmen\src\licensedcode\data\rules\false-positive_2836.yml", "YAML", 0, 0, 0, 2, 0, 0, 1, 3
"d:\IDEWORK\lvmen\src\licensedcode\data\rules\false-positive_2837.yml", "YAML", 0, 0, 0, 2, 0, 0, 1, 3
"d:\IDEWORK\lvmen\src\licensedcode\data\rules\false-positive_2838.yml", "YAML", 0, 0, 0, 2, 0, 0, 1, 3
"d:\IDEWORK\lvmen\src\licensedcode\data\rules\false-positive_2839.yml", "YAML", 0, 0, 0, 2, 0, 0, 1, 3
"d:\IDEWORK\lvmen\src\licensedcode\data\rules\false-positive_284.yml", "YAML", 0, 0, 0, 2, 0, 0, 1, 3
"d:\IDEWORK\lvmen\src\licensedcode\data\rules\false-positive_2840.yml", "YAML", 0, 0, 0, 2, 0, 0, 1, 3
"d:\IDEWORK\lvmen\src\licensedcode\data\rules\false-positive_2841.yml", "YAML", 0, 0, 0, 2, 0, 0, 1, 3
"d:\IDEWORK\lvmen\src\licensedcode\data\rules\false-positive_2842.yml", "YAML", 0, 0, 0, 2, 0, 0, 1, 3
"d:\IDEWORK\lvmen\src\licensedcode\data\rules\false-positive_2843.yml", "YAML", 0, 0, 0, 2, 0, 0, 1, 3
"d:\IDEWORK\lvmen\src\licensedcode\data\rules\false-positive_2844.yml", "YAML", 0, 0, 0, 2, 0, 0, 1, 3
"d:\IDEWORK\lvmen\src\licensedcode\data\rules\false-positive_2845.yml", "YAML", 0, 0, 0, 2, 0, 0, 1, 3
"d:\IDEWORK\lvmen\src\licensedcode\data\rules\false-positive_2846.yml", "YAML", 0, 0, 0, 2, 0, 0, 1, 3
"d:\IDEWORK\lvmen\src\licensedcode\data\rules\false-positive_2847.yml", "YAML", 0, 0, 0, 2, 0, 0, 1, 3
"d:\IDEWORK\lvmen\src\licensedcode\data\rules\false-positive_2848.yml", "YAML", 0, 0, 0, 2, 0, 0, 1, 3
"d:\IDEWORK\lvmen\src\licensedcode\data\rules\false-positive_2849.yml", "YAML", 0, 0, 0, 2, 0, 0, 1, 3
"d:\IDEWORK\lvmen\src\licensedcode\data\rules\false-positive_285.yml", "YAML", 0, 0, 0, 2, 0, 0, 1, 3
"d:\IDEWORK\lvmen\src\licensedcode\data\rules\false-positive_2850.yml", "YAML", 0, 0, 0, 2, 0, 0, 1, 3
"d:\IDEWORK\lvmen\src\licensedcode\data\rules\false-positive_2851.yml", "YAML", 0, 0, 0, 2, 0, 0, 1, 3
"d:\IDEWORK\lvmen\src\licensedcode\data\rules\false-positive_2852.yml", "YAML", 0, 0, 0, 2, 0, 0, 1, 3
"d:\IDEWORK\lvmen\src\licensedcode\data\rules\false-positive_2853.yml", "YAML", 0, 0, 0, 2, 0, 0, 1, 3
"d:\IDEWORK\lvmen\src\licensedcode\data\rules\false-positive_2854.yml", "YAML", 0, 0, 0, 2, 0, 0, 1, 3
"d:\IDEWORK\lvmen\src\licensedcode\data\rules\false-positive_2855.yml", "YAML", 0, 0, 0, 2, 0, 0, 1, 3
"d:\IDEWORK\lvmen\src\licensedcode\data\rules\false-positive_2856.yml", "YAML", 0, 0, 0, 2, 0, 0, 1, 3
"d:\IDEWORK\lvmen\src\licensedcode\data\rules\false-positive_2857.yml", "YAML", 0, 0, 0, 2, 0, 0, 1, 3
"d:\IDEWORK\lvmen\src\licensedcode\data\rules\false-positive_2858.yml", "YAML", 0, 0, 0, 2, 0, 0, 1, 3
"d:\IDEWORK\lvmen\src\licensedcode\data\rules\false-positive_2859.yml", "YAML", 0, 0, 0, 2, 0, 0, 1, 3
"d:\IDEWORK\lvmen\src\licensedcode\data\rules\false-positive_286.yml", "YAML", 0, 0, 0, 3, 0, 0, 1, 4
"d:\IDEWORK\lvmen\src\licensedcode\data\rules\false-positive_2860.yml", "YAML", 0, 0, 0, 2, 0, 0, 1, 3
"d:\IDEWORK\lvmen\src\licensedcode\data\rules\false-positive_2861.yml", "YAML", 0, 0, 0, 2, 0, 0, 1, 3
"d:\IDEWORK\lvmen\src\licensedcode\data\rules\false-positive_2862.yml", "YAML", 0, 0, 0, 2, 0, 0, 1, 3
"d:\IDEWORK\lvmen\src\licensedcode\data\rules\false-positive_2863.yml", "YAML", 0, 0, 0, 2, 0, 0, 1, 3
"d:\IDEWORK\lvmen\src\licensedcode\data\rules\false-positive_2864.yml", "YAML", 0, 0, 0, 2, 0, 0, 1, 3
"d:\IDEWORK\lvmen\src\licensedcode\data\rules\false-positive_2865.yml", "YAML", 0, 0, 0, 2, 0, 0, 1, 3
"d:\IDEWORK\lvmen\src\licensedcode\data\rules\false-positive_2866.yml", "YAML", 0, 0, 0, 2, 0, 0, 1, 3
"d:\IDEWORK\lvmen\src\licensedcode\data\rules\false-positive_2867.yml", "YAML", 0, 0, 0, 2, 0, 0, 1, 3
"d:\IDEWORK\lvmen\src\licensedcode\data\rules\false-positive_2868.yml", "YAML", 0, 0, 0, 2, 0, 0, 1, 3
"d:\IDEWORK\lvmen\src\licensedcode\data\rules\false-positive_2869.yml", "YAML", 0, 0, 0, 2, 0, 0, 1, 3
"d:\IDEWORK\lvmen\src\licensedcode\data\rules\false-positive_287.yml", "YAML", 0, 0, 0, 2, 0, 0, 1, 3
"d:\IDEWORK\lvmen\src\licensedcode\data\rules\false-positive_2870.yml", "YAML", 0, 0, 0, 2, 0, 0, 1, 3
"d:\IDEWORK\lvmen\src\licensedcode\data\rules\false-positive_2871.yml", "YAML", 0, 0, 0, 2, 0, 0, 1, 3
"d:\IDEWORK\lvmen\src\licensedcode\data\rules\false-positive_2872.yml", "YAML", 0, 0, 0, 2, 0, 0, 1, 3
"d:\IDEWORK\lvmen\src\licensedcode\data\rules\false-positive_2873.yml", "YAML", 0, 0, 0, 2, 0, 0, 1, 3
"d:\IDEWORK\lvmen\src\licensedcode\data\rules\false-positive_2874.yml", "YAML", 0, 0, 0, 2, 0, 0, 1, 3
"d:\IDEWORK\lvmen\src\licensedcode\data\rules\false-positive_2875.yml", "YAML", 0, 0, 0, 2, 0, 0, 1, 3
"d:\IDEWORK\lvmen\src\licensedcode\data\rules\false-positive_2876.yml", "YAML", 0, 0, 0, 2, 0, 0, 1, 3
"d:\IDEWORK\lvmen\src\licensedcode\data\rules\false-positive_2877.yml", "YAML", 0, 0, 0, 2, 0, 0, 1, 3
"d:\IDEWORK\lvmen\src\licensedcode\data\rules\false-positive_2878.yml", "YAML", 0, 0, 0, 2, 0, 0, 1, 3
"d:\IDEWORK\lvmen\src\licensedcode\data\rules\false-positive_2879.yml", "YAML", 0, 0, 0, 2, 0, 0, 1, 3
"d:\IDEWORK\lvmen\src\licensedcode\data\rules\false-positive_288.yml", "YAML", 0, 0, 0, 2, 0, 0, 1, 3
"d:\IDEWORK\lvmen\src\licensedcode\data\rules\false-positive_2880.yml", "YAML", 0, 0, 0, 2, 0, 0, 1, 3
"d:\IDEWORK\lvmen\src\licensedcode\data\rules\false-positive_2881.yml", "YAML", 0, 0, 0, 2, 0, 0, 1, 3
"d:\IDEWORK\lvmen\src\licensedcode\data\rules\false-positive_2882.yml", "YAML", 0, 0, 0, 2, 0, 0, 1, 3
"d:\IDEWORK\lvmen\src\licensedcode\data\rules\false-positive_2883.yml", "YAML", 0, 0, 0, 2, 0, 0, 1, 3
"d:\IDEWORK\lvmen\src\licensedcode\data\rules\false-positive_2884.yml", "YAML", 0, 0, 0, 2, 0, 0, 1, 3
"d:\IDEWORK\lvmen\src\licensedcode\data\rules\false-positive_2885.yml", "YAML", 0, 0, 0, 2, 0, 0, 1, 3
"d:\IDEWORK\lvmen\src\licensedcode\data\rules\false-positive_2886.yml", "YAML", 0, 0, 0, 2, 0, 0, 1, 3
"d:\IDEWORK\lvmen\src\licensedcode\data\rules\false-positive_2887.yml", "YAML", 0, 0, 0, 2, 0, 0, 1, 3
"d:\IDEWORK\lvmen\src\licensedcode\data\rules\false-positive_2888.yml", "YAML", 0, 0, 0, 2, 0, 0, 1, 3
"d:\IDEWORK\lvmen\src\licensedcode\data\rules\false-positive_2889.yml", "YAML", 0, 0, 0, 2, 0, 0, 1, 3
"d:\IDEWORK\lvmen\src\licensedcode\data\rules\false-positive_289.yml", "YAML", 0, 0, 0, 2, 0, 0, 1, 3
"d:\IDEWORK\lvmen\src\licensedcode\data\rules\false-positive_2890.yml", "YAML", 0, 0, 0, 2, 0, 0, 1, 3
"d:\IDEWORK\lvmen\src\licensedcode\data\rules\false-positive_2891.yml", "YAML", 0, 0, 0, 2, 0, 0, 1, 3
"d:\IDEWORK\lvmen\src\licensedcode\data\rules\false-positive_2892.yml", "YAML", 0, 0, 0, 2, 0, 0, 1, 3
"d:\IDEWORK\lvmen\src\licensedcode\data\rules\false-positive_2893.yml", "YAML", 0, 0, 0, 2, 0, 0, 1, 3
"d:\IDEWORK\lvmen\src\licensedcode\data\rules\false-positive_2894.yml", "YAML", 0, 0, 0, 2, 0, 0, 1, 3
"d:\IDEWORK\lvmen\src\licensedcode\data\rules\false-positive_2895.yml", "YAML", 0, 0, 0, 2, 0, 0, 1, 3
"d:\IDEWORK\lvmen\src\licensedcode\data\rules\false-positive_2896.yml", "YAML", 0, 0, 0, 2, 0, 0, 1, 3
"d:\IDEWORK\lvmen\src\licensedcode\data\rules\false-positive_2897.yml", "YAML", 0, 0, 0, 2, 0, 0, 1, 3
"d:\IDEWORK\lvmen\src\licensedcode\data\rules\false-positive_2898.yml", "YAML", 0, 0, 0, 2, 0, 0, 1, 3
"d:\IDEWORK\lvmen\src\licensedcode\data\rules\false-positive_2899.yml", "YAML", 0, 0, 0, 2, 0, 0, 1, 3
"d:\IDEWORK\lvmen\src\licensedcode\data\rules\false-positive_29.yml", "YAML", 0, 0, 0, 2, 0, 0, 1, 3
"d:\IDEWORK\lvmen\src\licensedcode\data\rules\false-positive_290.yml", "YAML", 0, 0, 0, 2, 0, 0, 1, 3
"d:\IDEWORK\lvmen\src\licensedcode\data\rules\false-positive_2900.yml", "YAML", 0, 0, 0, 2, 0, 0, 1, 3
"d:\IDEWORK\lvmen\src\licensedcode\data\rules\false-positive_2901.yml", "YAML", 0, 0, 0, 2, 0, 0, 1, 3
"d:\IDEWORK\lvmen\src\licensedcode\data\rules\false-positive_2902.yml", "YAML", 0, 0, 0, 2, 0, 0, 1, 3
"d:\IDEWORK\lvmen\src\licensedcode\data\rules\false-positive_2903.yml", "YAML", 0, 0, 0, 2, 0, 0, 1, 3
"d:\IDEWORK\lvmen\src\licensedcode\data\rules\false-positive_2904.yml", "YAML", 0, 0, 0, 2, 0, 0, 1, 3
"d:\IDEWORK\lvmen\src\licensedcode\data\rules\false-positive_2905.yml", "YAML", 0, 0, 0, 2, 0, 0, 1, 3
"d:\IDEWORK\lvmen\src\licensedcode\data\rules\false-positive_2906.yml", "YAML", 0, 0, 0, 2, 0, 0, 1, 3
"d:\IDEWORK\lvmen\src\licensedcode\data\rules\false-positive_2907.yml", "YAML", 0, 0, 0, 2, 0, 0, 1, 3
"d:\IDEWORK\lvmen\src\licensedcode\data\rules\false-positive_2908.yml", "YAML", 0, 0, 0, 2, 0, 0, 1, 3
"d:\IDEWORK\lvmen\src\licensedcode\data\rules\false-positive_2909.yml", "YAML", 0, 0, 0, 2, 0, 0, 1, 3
"d:\IDEWORK\lvmen\src\licensedcode\data\rules\false-positive_291.yml", "YAML", 0, 0, 0, 2, 0, 0, 1, 3
"d:\IDEWORK\lvmen\src\licensedcode\data\rules\false-positive_2910.yml", "YAML", 0, 0, 0, 2, 0, 0, 1, 3
"d:\IDEWORK\lvmen\src\licensedcode\data\rules\false-positive_2911.yml", "YAML", 0, 0, 0, 2, 0, 0, 1, 3
"d:\IDEWORK\lvmen\src\licensedcode\data\rules\false-positive_2912.yml", "YAML", 0, 0, 0, 2, 0, 0, 1, 3
"d:\IDEWORK\lvmen\src\licensedcode\data\rules\false-positive_2913.yml", "YAML", 0, 0, 0, 2, 0, 0, 1, 3
"d:\IDEWORK\lvmen\src\licensedcode\data\rules\false-positive_2914.yml", "YAML", 0, 0, 0, 2, 0, 0, 1, 3
"d:\IDEWORK\lvmen\src\licensedcode\data\rules\false-positive_2915.yml", "YAML", 0, 0, 0, 2, 0, 0, 1, 3
"d:\IDEWORK\lvmen\src\licensedcode\data\rules\false-positive_2916.yml", "YAML", 0, 0, 0, 2, 0, 0, 1, 3
"d:\IDEWORK\lvmen\src\licensedcode\data\rules\false-positive_2917.yml", "YAML", 0, 0, 0, 2, 0, 0, 1, 3
"d:\IDEWORK\lvmen\src\licensedcode\data\rules\false-positive_2918.yml", "YAML", 0, 0, 0, 2, 0, 0, 1, 3
"d:\IDEWORK\lvmen\src\licensedcode\data\rules\false-positive_2919.yml", "YAML", 0, 0, 0, 2, 0, 0, 1, 3
"d:\IDEWORK\lvmen\src\licensedcode\data\rules\false-positive_292.yml", "YAML", 0, 0, 0, 2, 0, 0, 1, 3
"d:\IDEWORK\lvmen\src\licensedcode\data\rules\false-positive_2920.yml", "YAML", 0, 0, 0, 2, 0, 0, 1, 3
"d:\IDEWORK\lvmen\src\licensedcode\data\rules\false-positive_2921.yml", "YAML", 0, 0, 0, 2, 0, 0, 1, 3
"d:\IDEWORK\lvmen\src\licensedcode\data\rules\false-positive_2922.yml", "YAML", 0, 0, 0, 2, 0, 0, 1, 3
"d:\IDEWORK\lvmen\src\licensedcode\data\rules\false-positive_2923.yml", "YAML", 0, 0, 0, 2, 0, 0, 1, 3
"d:\IDEWORK\lvmen\src\licensedcode\data\rules\false-positive_2924.yml", "YAML", 0, 0, 0, 2, 0, 0, 1, 3
"d:\IDEWORK\lvmen\src\licensedcode\data\rules\false-positive_2925.yml", "YAML", 0, 0, 0, 2, 0, 0, 1, 3
"d:\IDEWORK\lvmen\src\licensedcode\data\rules\false-positive_2926.yml", "YAML", 0, 0, 0, 2, 0, 0, 1, 3
"d:\IDEWORK\lvmen\src\licensedcode\data\rules\false-positive_2927.yml", "YAML", 0, 0, 0, 2, 0, 0, 1, 3
"d:\IDEWORK\lvmen\src\licensedcode\data\rules\false-positive_2928.yml", "YAML", 0, 0, 0, 2, 0, 0, 1, 3
"d:\IDEWORK\lvmen\src\licensedcode\data\rules\false-positive_2929.yml", "YAML", 0, 0, 0, 2, 0, 0, 1, 3
"d:\IDEWORK\lvmen\src\licensedcode\data\rules\false-positive_293.yml", "YAML", 0, 0, 0, 2, 0, 0, 1, 3
"d:\IDEWORK\lvmen\src\licensedcode\data\rules\false-positive_2930.yml", "YAML", 0, 0, 0, 2, 0, 0, 1, 3
"d:\IDEWORK\lvmen\src\licensedcode\data\rules\false-positive_2931.yml", "YAML", 0, 0, 0, 2, 0, 0, 1, 3
"d:\IDEWORK\lvmen\src\licensedcode\data\rules\false-positive_2932.yml", "YAML", 0, 0, 0, 2, 0, 0, 1, 3
"d:\IDEWORK\lvmen\src\licensedcode\data\rules\false-positive_2933.yml", "YAML", 0, 0, 0, 2, 0, 0, 1, 3
"d:\IDEWORK\lvmen\src\licensedcode\data\rules\false-positive_2934.yml", "YAML", 0, 0, 0, 2, 0, 0, 1, 3
"d:\IDEWORK\lvmen\src\licensedcode\data\rules\false-positive_2935.yml", "YAML", 0, 0, 0, 2, 0, 0, 1, 3
"d:\IDEWORK\lvmen\src\licensedcode\data\rules\false-positive_2936.yml", "YAML", 0, 0, 0, 2, 0, 0, 1, 3
"d:\IDEWORK\lvmen\src\licensedcode\data\rules\false-positive_2937.yml", "YAML", 0, 0, 0, 2, 0, 0, 1, 3
"d:\IDEWORK\lvmen\src\licensedcode\data\rules\false-positive_2938.yml", "YAML", 0, 0, 0, 2, 0, 0, 1, 3
"d:\IDEWORK\lvmen\src\licensedcode\data\rules\false-positive_2939.yml", "YAML", 0, 0, 0, 2, 0, 0, 1, 3
"d:\IDEWORK\lvmen\src\licensedcode\data\rules\false-positive_294.yml", "YAML", 0, 0, 0, 2, 0, 0, 1, 3
"d:\IDEWORK\lvmen\src\licensedcode\data\rules\false-positive_2940.yml", "YAML", 0, 0, 0, 2, 0, 0, 1, 3
"d:\IDEWORK\lvmen\src\licensedcode\data\rules\false-positive_2941.yml", "YAML", 0, 0, 0, 2, 0, 0, 1, 3
"d:\IDEWORK\lvmen\src\licensedcode\data\rules\false-positive_2942.yml", "YAML", 0, 0, 0, 2, 0, 0, 1, 3
"d:\IDEWORK\lvmen\src\licensedcode\data\rules\false-positive_2943.yml", "YAML", 0, 0, 0, 2, 0, 0, 1, 3
"d:\IDEWORK\lvmen\src\licensedcode\data\rules\false-positive_2944.yml", "YAML", 0, 0, 0, 2, 0, 0, 1, 3
"d:\IDEWORK\lvmen\src\licensedcode\data\rules\false-positive_2945.yml", "YAML", 0, 0, 0, 2, 0, 0, 1, 3
"d:\IDEWORK\lvmen\src\licensedcode\data\rules\false-positive_2946.yml", "YAML", 0, 0, 0, 2, 0, 0, 1, 3
"d:\IDEWORK\lvmen\src\licensedcode\data\rules\false-positive_2947.yml", "YAML", 0, 0, 0, 2, 0, 0, 1, 3
"d:\IDEWORK\lvmen\src\licensedcode\data\rules\false-positive_2948.yml", "YAML", 0, 0, 0, 2, 0, 0, 1, 3
"d:\IDEWORK\lvmen\src\licensedcode\data\rules\false-positive_2949.yml", "YAML", 0, 0, 0, 2, 0, 0, 1, 3
"d:\IDEWORK\lvmen\src\licensedcode\data\rules\false-positive_295.yml", "YAML", 0, 0, 0, 2, 0, 0, 1, 3
"d:\IDEWORK\lvmen\src\licensedcode\data\rules\false-positive_2950.yml", "YAML", 0, 0, 0, 2, 0, 0, 1, 3
"d:\IDEWORK\lvmen\src\licensedcode\data\rules\false-positive_2951.yml", "YAML", 0, 0, 0, 2, 0, 0, 1, 3
"d:\IDEWORK\lvmen\src\licensedcode\data\rules\false-positive_2952.yml", "YAML", 0, 0, 0, 2, 0, 0, 1, 3
"d:\IDEWORK\lvmen\src\licensedcode\data\rules\false-positive_2953.yml", "YAML", 0, 0, 0, 2, 0, 0, 1, 3
"d:\IDEWORK\lvmen\src\licensedcode\data\rules\false-positive_2954.yml", "YAML", 0, 0, 0, 2, 0, 0, 1, 3
"d:\IDEWORK\lvmen\src\licensedcode\data\rules\false-positive_2955.yml", "YAML", 0, 0, 0, 2, 0, 0, 1, 3
"d:\IDEWORK\lvmen\src\licensedcode\data\rules\false-positive_2956.yml", "YAML", 0, 0, 0, 2, 0, 0, 1, 3
"d:\IDEWORK\lvmen\src\licensedcode\data\rules\false-positive_2957.yml", "YAML", 0, 0, 0, 2, 0, 0, 1, 3
"d:\IDEWORK\lvmen\src\licensedcode\data\rules\false-positive_2958.yml", "YAML", 0, 0, 0, 2, 0, 0, 1, 3
"d:\IDEWORK\lvmen\src\licensedcode\data\rules\false-positive_2959.yml", "YAML", 0, 0, 0, 2, 0, 0, 1, 3
"d:\IDEWORK\lvmen\src\licensedcode\data\rules\false-positive_296.yml", "YAML", 0, 0, 0, 2, 0, 0, 1, 3
"d:\IDEWORK\lvmen\src\licensedcode\data\rules\false-positive_2960.yml", "YAML", 0, 0, 0, 2, 0, 0, 1, 3
"d:\IDEWORK\lvmen\src\licensedcode\data\rules\false-positive_2961.yml", "YAML", 0, 0, 0, 2, 0, 0, 1, 3
"d:\IDEWORK\lvmen\src\licensedcode\data\rules\false-positive_2962.yml", "YAML", 0, 0, 0, 2, 0, 0, 1, 3
"d:\IDEWORK\lvmen\src\licensedcode\data\rules\false-positive_2963.yml", "YAML", 0, 0, 0, 2, 0, 0, 1, 3
"d:\IDEWORK\lvmen\src\licensedcode\data\rules\false-positive_2964.yml", "YAML", 0, 0, 0, 2, 0, 0, 1, 3
"d:\IDEWORK\lvmen\src\licensedcode\data\rules\false-positive_2965.yml", "YAML", 0, 0, 0, 2, 0, 0, 1, 3
"d:\IDEWORK\lvmen\src\licensedcode\data\rules\false-positive_2966.yml", "YAML", 0, 0, 0, 2, 0, 0, 1, 3
"d:\IDEWORK\lvmen\src\licensedcode\data\rules\false-positive_2967.yml", "YAML", 0, 0, 0, 2, 0, 0, 1, 3
"d:\IDEWORK\lvmen\src\licensedcode\data\rules\false-positive_2968.yml", "YAML", 0, 0, 0, 2, 0, 0, 1, 3
"d:\IDEWORK\lvmen\src\licensedcode\data\rules\false-positive_2969.yml", "YAML", 0, 0, 0, 2, 0, 0, 1, 3
"d:\IDEWORK\lvmen\src\licensedcode\data\rules\false-positive_297.yml", "YAML", 0, 0, 0, 2, 0, 0, 1, 3
"d:\IDEWORK\lvmen\src\licensedcode\data\rules\false-positive_2970.yml", "YAML", 0, 0, 0, 2, 0, 0, 1, 3
"d:\IDEWORK\lvmen\src\licensedcode\data\rules\false-positive_2971.yml", "YAML", 0, 0, 0, 2, 0, 0, 1, 3
"d:\IDEWORK\lvmen\src\licensedcode\data\rules\false-positive_2972.yml", "YAML", 0, 0, 0, 2, 0, 0, 1, 3
"d:\IDEWORK\lvmen\src\licensedcode\data\rules\false-positive_2973.yml", "YAML", 0, 0, 0, 2, 0, 0, 1, 3
"d:\IDEWORK\lvmen\src\licensedcode\data\rules\false-positive_2974.yml", "YAML", 0, 0, 0, 2, 0, 0, 1, 3
"d:\IDEWORK\lvmen\src\licensedcode\data\rules\false-positive_2975.yml", "YAML", 0, 0, 0, 2, 0, 0, 1, 3
"d:\IDEWORK\lvmen\src\licensedcode\data\rules\false-positive_2976.yml", "YAML", 0, 0, 0, 2, 0, 0, 1, 3
"d:\IDEWORK\lvmen\src\licensedcode\data\rules\false-positive_2977.yml", "YAML", 0, 0, 0, 2, 0, 0, 1, 3
"d:\IDEWORK\lvmen\src\licensedcode\data\rules\false-positive_2978.yml", "YAML", 0, 0, 0, 2, 0, 0, 1, 3
"d:\IDEWORK\lvmen\src\licensedcode\data\rules\false-positive_2979.yml", "YAML", 0, 0, 0, 2, 0, 0, 1, 3
"d:\IDEWORK\lvmen\src\licensedcode\data\rules\false-positive_298.yml", "YAML", 0, 0, 0, 2, 0, 0, 1, 3
"d:\IDEWORK\lvmen\src\licensedcode\data\rules\false-positive_2980.yml", "YAML", 0, 0, 0, 2, 0, 0, 1, 3
"d:\IDEWORK\lvmen\src\licensedcode\data\rules\false-positive_2981.yml", "YAML", 0, 0, 0, 2, 0, 0, 1, 3
"d:\IDEWORK\lvmen\src\licensedcode\data\rules\false-positive_2982.yml", "YAML", 0, 0, 0, 2, 0, 0, 1, 3
"d:\IDEWORK\lvmen\src\licensedcode\data\rules\false-positive_2983.yml", "YAML", 0, 0, 0, 2, 0, 0, 1, 3
"d:\IDEWORK\lvmen\src\licensedcode\data\rules\false-positive_2984.yml", "YAML", 0, 0, 0, 2, 0, 0, 1, 3
"d:\IDEWORK\lvmen\src\licensedcode\data\rules\false-positive_2985.yml", "YAML", 0, 0, 0, 2, 0, 0, 1, 3
"d:\IDEWORK\lvmen\src\licensedcode\data\rules\false-positive_2986.yml", "YAML", 0, 0, 0, 2, 0, 0, 1, 3
"d:\IDEWORK\lvmen\src\licensedcode\data\rules\false-positive_2987.yml", "YAML", 0, 0, 0, 2, 0, 0, 1, 3
"d:\IDEWORK\lvmen\src\licensedcode\data\rules\false-positive_2988.yml", "YAML", 0, 0, 0, 2, 0, 0, 1, 3
"d:\IDEWORK\lvmen\src\licensedcode\data\rules\false-positive_2989.yml", "YAML", 0, 0, 0, 2, 0, 0, 1, 3
"d:\IDEWORK\lvmen\src\licensedcode\data\rules\false-positive_299.yml", "YAML", 0, 0, 0, 2, 0, 0, 1, 3
"d:\IDEWORK\lvmen\src\licensedcode\data\rules\false-positive_2990.yml", "YAML", 0, 0, 0, 2, 0, 0, 1, 3
"d:\IDEWORK\lvmen\src\licensedcode\data\rules\false-positive_2991.yml", "YAML", 0, 0, 0, 2, 0, 0, 1, 3
"d:\IDEWORK\lvmen\src\licensedcode\data\rules\false-positive_2992.yml", "YAML", 0, 0, 0, 2, 0, 0, 1, 3
"d:\IDEWORK\lvmen\src\licensedcode\data\rules\false-positive_2993.yml", "YAML", 0, 0, 0, 2, 0, 0, 1, 3
"d:\IDEWORK\lvmen\src\licensedcode\data\rules\false-positive_2994.yml", "YAML", 0, 0, 0, 2, 0, 0, 1, 3
"d:\IDEWORK\lvmen\src\licensedcode\data\rules\false-positive_2995.yml", "YAML", 0, 0, 0, 2, 0, 0, 1, 3
"d:\IDEWORK\lvmen\src\licensedcode\data\rules\false-positive_2996.yml", "YAML", 0, 0, 0, 2, 0, 0, 1, 3
"d:\IDEWORK\lvmen\src\licensedcode\data\rules\false-positive_2997.yml", "YAML", 0, 0, 0, 2, 0, 0, 1, 3
"d:\IDEWORK\lvmen\src\licensedcode\data\rules\false-positive_2998.yml", "YAML", 0, 0, 0, 2, 0, 0, 1, 3
"d:\IDEWORK\lvmen\src\licensedcode\data\rules\false-positive_2999.yml", "YAML", 0, 0, 0, 2, 0, 0, 1, 3
"d:\IDEWORK\lvmen\src\licensedcode\data\rules\false-positive_3.yml", "YAML", 0, 0, 0, 2, 0, 0, 1, 3
"d:\IDEWORK\lvmen\src\licensedcode\data\rules\false-positive_30.yml", "YAML", 0, 0, 0, 2, 0, 0, 1, 3
"d:\IDEWORK\lvmen\src\licensedcode\data\rules\false-positive_300.yml", "YAML", 0, 0, 0, 2, 0, 0, 1, 3
"d:\IDEWORK\lvmen\src\licensedcode\data\rules\false-positive_3000.yml", "YAML", 0, 0, 0, 2, 0, 0, 1, 3
"d:\IDEWORK\lvmen\src\licensedcode\data\rules\false-positive_3001.yml", "YAML", 0, 0, 0, 2, 0, 0, 1, 3
"d:\IDEWORK\lvmen\src\licensedcode\data\rules\false-positive_3002.yml", "YAML", 0, 0, 0, 2, 0, 0, 1, 3
"d:\IDEWORK\lvmen\src\licensedcode\data\rules\false-positive_3003.yml", "YAML", 0, 0, 0, 2, 0, 0, 1, 3
"d:\IDEWORK\lvmen\src\licensedcode\data\rules\false-positive_3004.yml", "YAML", 0, 0, 0, 2, 0, 0, 1, 3
"d:\IDEWORK\lvmen\src\licensedcode\data\rules\false-positive_3005.yml", "YAML", 0, 0, 0, 2, 0, 0, 1, 3
"d:\IDEWORK\lvmen\src\licensedcode\data\rules\false-positive_3006.yml", "YAML", 0, 0, 0, 2, 0, 0, 1, 3
"d:\IDEWORK\lvmen\src\licensedcode\data\rules\false-positive_3007.yml", "YAML", 0, 0, 0, 2, 0, 0, 1, 3
"d:\IDEWORK\lvmen\src\licensedcode\data\rules\false-positive_3008.yml", "YAML", 0, 0, 0, 2, 0, 0, 1, 3
"d:\IDEWORK\lvmen\src\licensedcode\data\rules\false-positive_3009.yml", "YAML", 0, 0, 0, 2, 0, 0, 1, 3
"d:\IDEWORK\lvmen\src\licensedcode\data\rules\false-positive_301.yml", "YAML", 0, 0, 0, 2, 0, 0, 1, 3
"d:\IDEWORK\lvmen\src\licensedcode\data\rules\false-positive_3010.yml", "YAML", 0, 0, 0, 2, 0, 0, 1, 3
"d:\IDEWORK\lvmen\src\licensedcode\data\rules\false-positive_3011.yml", "YAML", 0, 0, 0, 2, 0, 0, 1, 3
"d:\IDEWORK\lvmen\src\licensedcode\data\rules\false-positive_3012.yml", "YAML", 0, 0, 0, 2, 0, 0, 1, 3
"d:\IDEWORK\lvmen\src\licensedcode\data\rules\false-positive_3013.yml", "YAML", 0, 0, 0, 2, 0, 0, 1, 3
"d:\IDEWORK\lvmen\src\licensedcode\data\rules\false-positive_3014.yml", "YAML", 0, 0, 0, 2, 0, 0, 1, 3
"d:\IDEWORK\lvmen\src\licensedcode\data\rules\false-positive_3015.yml", "YAML", 0, 0, 0, 2, 0, 0, 1, 3
"d:\IDEWORK\lvmen\src\licensedcode\data\rules\false-positive_3016.yml", "YAML", 0, 0, 0, 2, 0, 0, 1, 3
"d:\IDEWORK\lvmen\src\licensedcode\data\rules\false-positive_3017.yml", "YAML", 0, 0, 0, 2, 0, 0, 1, 3
"d:\IDEWORK\lvmen\src\licensedcode\data\rules\false-positive_3018.yml", "YAML", 0, 0, 0, 2, 0, 0, 1, 3
"d:\IDEWORK\lvmen\src\licensedcode\data\rules\false-positive_3019.yml", "YAML", 0, 0, 0, 2, 0, 0, 1, 3
"d:\IDEWORK\lvmen\src\licensedcode\data\rules\false-positive_302.yml", "YAML", 0, 0, 0, 2, 0, 0, 1, 3
"d:\IDEWORK\lvmen\src\licensedcode\data\rules\false-positive_3020.yml", "YAML", 0, 0, 0, 2, 0, 0, 1, 3
"d:\IDEWORK\lvmen\src\licensedcode\data\rules\false-positive_3021.yml", "YAML", 0, 0, 0, 2, 0, 0, 1, 3
"d:\IDEWORK\lvmen\src\licensedcode\data\rules\false-positive_3022.yml", "YAML", 0, 0, 0, 2, 0, 0, 1, 3
"d:\IDEWORK\lvmen\src\licensedcode\data\rules\false-positive_3023.yml", "YAML", 0, 0, 0, 2, 0, 0, 1, 3
"d:\IDEWORK\lvmen\src\licensedcode\data\rules\false-positive_3024.yml", "YAML", 0, 0, 0, 2, 0, 0, 1, 3
"d:\IDEWORK\lvmen\src\licensedcode\data\rules\false-positive_3025.yml", "YAML", 0, 0, 0, 2, 0, 0, 1, 3
"d:\IDEWORK\lvmen\src\licensedcode\data\rules\false-positive_3026.yml", "YAML", 0, 0, 0, 2, 0, 0, 1, 3
"d:\IDEWORK\lvmen\src\licensedcode\data\rules\false-positive_3027.yml", "YAML", 0, 0, 0, 2, 0, 0, 1, 3
"d:\IDEWORK\lvmen\src\licensedcode\data\rules\false-positive_3028.yml", "YAML", 0, 0, 0, 2, 0, 0, 1, 3
"d:\IDEWORK\lvmen\src\licensedcode\data\rules\false-positive_3029.yml", "YAML", 0, 0, 0, 2, 0, 0, 1, 3
"d:\IDEWORK\lvmen\src\licensedcode\data\rules\false-positive_303.yml", "YAML", 0, 0, 0, 2, 0, 0, 1, 3
"d:\IDEWORK\lvmen\src\licensedcode\data\rules\false-positive_3030.yml", "YAML", 0, 0, 0, 2, 0, 0, 1, 3
"d:\IDEWORK\lvmen\src\licensedcode\data\rules\false-positive_3031.yml", "YAML", 0, 0, 0, 2, 0, 0, 1, 3
"d:\IDEWORK\lvmen\src\licensedcode\data\rules\false-positive_3032.yml", "YAML", 0, 0, 0, 2, 0, 0, 1, 3
"d:\IDEWORK\lvmen\src\licensedcode\data\rules\false-positive_3033.yml", "YAML", 0, 0, 0, 2, 0, 0, 1, 3
"d:\IDEWORK\lvmen\src\licensedcode\data\rules\false-positive_3034.yml", "YAML", 0, 0, 0, 2, 0, 0, 1, 3
"d:\IDEWORK\lvmen\src\licensedcode\data\rules\false-positive_3035.yml", "YAML", 0, 0, 0, 2, 0, 0, 1, 3
"d:\IDEWORK\lvmen\src\licensedcode\data\rules\false-positive_3036.yml", "YAML", 0, 0, 0, 2, 0, 0, 1, 3
"d:\IDEWORK\lvmen\src\licensedcode\data\rules\false-positive_3037.yml", "YAML", 0, 0, 0, 2, 0, 0, 1, 3
"d:\IDEWORK\lvmen\src\licensedcode\data\rules\false-positive_3038.yml", "YAML", 0, 0, 0, 2, 0, 0, 1, 3
"d:\IDEWORK\lvmen\src\licensedcode\data\rules\false-positive_3039.yml", "YAML", 0, 0, 0, 2, 0, 0, 1, 3
"d:\IDEWORK\lvmen\src\licensedcode\data\rules\false-positive_304.yml", "YAML", 0, 0, 0, 2, 0, 0, 1, 3
"d:\IDEWORK\lvmen\src\licensedcode\data\rules\false-positive_3040.yml", "YAML", 0, 0, 0, 2, 0, 0, 1, 3
"d:\IDEWORK\lvmen\src\licensedcode\data\rules\false-positive_3041.yml", "YAML", 0, 0, 0, 2, 0, 0, 1, 3
"d:\IDEWORK\lvmen\src\licensedcode\data\rules\false-positive_3042.yml", "YAML", 0, 0, 0, 2, 0, 0, 1, 3
"d:\IDEWORK\lvmen\src\licensedcode\data\rules\false-positive_3043.yml", "YAML", 0, 0, 0, 2, 0, 0, 1, 3
"d:\IDEWORK\lvmen\src\licensedcode\data\rules\false-positive_3044.yml", "YAML", 0, 0, 0, 2, 0, 0, 1, 3
"d:\IDEWORK\lvmen\src\licensedcode\data\rules\false-positive_3045.yml", "YAML", 0, 0, 0, 2, 0, 0, 1, 3
"d:\IDEWORK\lvmen\src\licensedcode\data\rules\false-positive_3046.yml", "YAML", 0, 0, 0, 2, 0, 0, 1, 3
"d:\IDEWORK\lvmen\src\licensedcode\data\rules\false-positive_3047.yml", "YAML", 0, 0, 0, 2, 0, 0, 1, 3
"d:\IDEWORK\lvmen\src\licensedcode\data\rules\false-positive_3048.yml", "YAML", 0, 0, 0, 2, 0, 0, 1, 3
"d:\IDEWORK\lvmen\src\licensedcode\data\rules\false-positive_3049.yml", "YAML", 0, 0, 0, 2, 0, 0, 1, 3
"d:\IDEWORK\lvmen\src\licensedcode\data\rules\false-positive_305.yml", "YAML", 0, 0, 0, 2, 0, 0, 1, 3
"d:\IDEWORK\lvmen\src\licensedcode\data\rules\false-positive_3050.yml", "YAML", 0, 0, 0, 2, 0, 0, 1, 3
"d:\IDEWORK\lvmen\src\licensedcode\data\rules\false-positive_3051.yml", "YAML", 0, 0, 0, 2, 0, 0, 1, 3
"d:\IDEWORK\lvmen\src\licensedcode\data\rules\false-positive_3052.yml", "YAML", 0, 0, 0, 2, 0, 0, 1, 3
"d:\IDEWORK\lvmen\src\licensedcode\data\rules\false-positive_3053.yml", "YAML", 0, 0, 0, 2, 0, 0, 1, 3
"d:\IDEWORK\lvmen\src\licensedcode\data\rules\false-positive_3054.yml", "YAML", 0, 0, 0, 2, 0, 0, 1, 3
"d:\IDEWORK\lvmen\src\licensedcode\data\rules\false-positive_3055.yml", "YAML", 0, 0, 0, 2, 0, 0, 1, 3
"d:\IDEWORK\lvmen\src\licensedcode\data\rules\false-positive_3056.yml", "YAML", 0, 0, 0, 2, 0, 0, 1, 3
"d:\IDEWORK\lvmen\src\licensedcode\data\rules\false-positive_3057.yml", "YAML", 0, 0, 0, 2, 0, 0, 1, 3
"d:\IDEWORK\lvmen\src\licensedcode\data\rules\false-positive_3058.yml", "YAML", 0, 0, 0, 2, 0, 0, 1, 3
"d:\IDEWORK\lvmen\src\licensedcode\data\rules\false-positive_3059.yml", "YAML", 0, 0, 0, 2, 0, 0, 1, 3
"d:\IDEWORK\lvmen\src\licensedcode\data\rules\false-positive_306.yml", "YAML", 0, 0, 0, 2, 0, 0, 1, 3
"d:\IDEWORK\lvmen\src\licensedcode\data\rules\false-positive_3060.yml", "YAML", 0, 0, 0, 2, 0, 0, 1, 3
"d:\IDEWORK\lvmen\src\licensedcode\data\rules\false-positive_3061.yml", "YAML", 0, 0, 0, 2, 0, 0, 1, 3
"d:\IDEWORK\lvmen\src\licensedcode\data\rules\false-positive_3062.yml", "YAML", 0, 0, 0, 2, 0, 0, 1, 3
"d:\IDEWORK\lvmen\src\licensedcode\data\rules\false-positive_3063.yml", "YAML", 0, 0, 0, 2, 0, 0, 1, 3
"d:\IDEWORK\lvmen\src\licensedcode\data\rules\false-positive_3064.yml", "YAML", 0, 0, 0, 2, 0, 0, 1, 3
"d:\IDEWORK\lvmen\src\licensedcode\data\rules\false-positive_3065.yml", "YAML", 0, 0, 0, 2, 0, 0, 1, 3
"d:\IDEWORK\lvmen\src\licensedcode\data\rules\false-positive_3066.yml", "YAML", 0, 0, 0, 2, 0, 0, 1, 3
"d:\IDEWORK\lvmen\src\licensedcode\data\rules\false-positive_3067.yml", "YAML", 0, 0, 0, 2, 0, 0, 1, 3
"d:\IDEWORK\lvmen\src\licensedcode\data\rules\false-positive_3068.yml", "YAML", 0, 0, 0, 2, 0, 0, 1, 3
"d:\IDEWORK\lvmen\src\licensedcode\data\rules\false-positive_3069.yml", "YAML", 0, 0, 0, 2, 0, 0, 1, 3
"d:\IDEWORK\lvmen\src\licensedcode\data\rules\false-positive_307.yml", "YAML", 0, 0, 0, 2, 0, 0, 1, 3
"d:\IDEWORK\lvmen\src\licensedcode\data\rules\false-positive_3070.yml", "YAML", 0, 0, 0, 2, 0, 0, 1, 3
"d:\IDEWORK\lvmen\src\licensedcode\data\rules\false-positive_3071.yml", "YAML", 0, 0, 0, 2, 0, 0, 1, 3
"d:\IDEWORK\lvmen\src\licensedcode\data\rules\false-positive_3072.yml", "YAML", 0, 0, 0, 2, 0, 0, 1, 3
"d:\IDEWORK\lvmen\src\licensedcode\data\rules\false-positive_3073.yml", "YAML", 0, 0, 0, 2, 0, 0, 1, 3
"d:\IDEWORK\lvmen\src\licensedcode\data\rules\false-positive_3074.yml", "YAML", 0, 0, 0, 2, 0, 0, 1, 3
"d:\IDEWORK\lvmen\src\licensedcode\data\rules\false-positive_3075.yml", "YAML", 0, 0, 0, 2, 0, 0, 1, 3
"d:\IDEWORK\lvmen\src\licensedcode\data\rules\false-positive_3076.yml", "YAML", 0, 0, 0, 2, 0, 0, 1, 3
"d:\IDEWORK\lvmen\src\licensedcode\data\rules\false-positive_3077.yml", "YAML", 0, 0, 0, 2, 0, 0, 1, 3
"d:\IDEWORK\lvmen\src\licensedcode\data\rules\false-positive_3078.yml", "YAML", 0, 0, 0, 2, 0, 0, 1, 3
"d:\IDEWORK\lvmen\src\licensedcode\data\rules\false-positive_3079.yml", "YAML", 0, 0, 0, 2, 0, 0, 1, 3
"d:\IDEWORK\lvmen\src\licensedcode\data\rules\false-positive_308.yml", "YAML", 0, 0, 0, 2, 0, 0, 1, 3
"d:\IDEWORK\lvmen\src\licensedcode\data\rules\false-positive_3080.yml", "YAML", 0, 0, 0, 2, 0, 0, 1, 3
"d:\IDEWORK\lvmen\src\licensedcode\data\rules\false-positive_3081.yml", "YAML", 0, 0, 0, 2, 0, 0, 1, 3
"d:\IDEWORK\lvmen\src\licensedcode\data\rules\false-positive_3082.yml", "YAML", 0, 0, 0, 2, 0, 0, 1, 3
"d:\IDEWORK\lvmen\src\licensedcode\data\rules\false-positive_3083.yml", "YAML", 0, 0, 0, 2, 0, 0, 1, 3
"d:\IDEWORK\lvmen\src\licensedcode\data\rules\false-positive_3084.yml", "YAML", 0, 0, 0, 2, 0, 0, 1, 3
"d:\IDEWORK\lvmen\src\licensedcode\data\rules\false-positive_3085.yml", "YAML", 0, 0, 0, 2, 0, 0, 1, 3
"d:\IDEWORK\lvmen\src\licensedcode\data\rules\false-positive_3086.yml", "YAML", 0, 0, 0, 2, 0, 0, 1, 3
"d:\IDEWORK\lvmen\src\licensedcode\data\rules\false-positive_3087.yml", "YAML", 0, 0, 0, 2, 0, 0, 1, 3
"d:\IDEWORK\lvmen\src\licensedcode\data\rules\false-positive_3088.yml", "YAML", 0, 0, 0, 2, 0, 0, 1, 3
"d:\IDEWORK\lvmen\src\licensedcode\data\rules\false-positive_3089.yml", "YAML", 0, 0, 0, 2, 0, 0, 1, 3
"d:\IDEWORK\lvmen\src\licensedcode\data\rules\false-positive_309.yml", "YAML", 0, 0, 0, 2, 0, 0, 1, 3
"d:\IDEWORK\lvmen\src\licensedcode\data\rules\false-positive_3090.yml", "YAML", 0, 0, 0, 2, 0, 0, 1, 3
"d:\IDEWORK\lvmen\src\licensedcode\data\rules\false-positive_3091.yml", "YAML", 0, 0, 0, 2, 0, 0, 1, 3
"d:\IDEWORK\lvmen\src\licensedcode\data\rules\false-positive_3092.yml", "YAML", 0, 0, 0, 2, 0, 0, 1, 3
"d:\IDEWORK\lvmen\src\licensedcode\data\rules\false-positive_3093.yml", "YAML", 0, 0, 0, 2, 0, 0, 1, 3
"d:\IDEWORK\lvmen\src\licensedcode\data\rules\false-positive_3094.yml", "YAML", 0, 0, 0, 2, 0, 0, 1, 3
"d:\IDEWORK\lvmen\src\licensedcode\data\rules\false-positive_3095.yml", "YAML", 0, 0, 0, 2, 0, 0, 1, 3
"d:\IDEWORK\lvmen\src\licensedcode\data\rules\false-positive_3096.yml", "YAML", 0, 0, 0, 2, 0, 0, 1, 3
"d:\IDEWORK\lvmen\src\licensedcode\data\rules\false-positive_3097.yml", "YAML", 0, 0, 0, 2, 0, 0, 1, 3
"d:\IDEWORK\lvmen\src\licensedcode\data\rules\false-positive_3098.yml", "YAML", 0, 0, 0, 2, 0, 0, 1, 3
"d:\IDEWORK\lvmen\src\licensedcode\data\rules\false-positive_3099.yml", "YAML", 0, 0, 0, 2, 0, 0, 1, 3
"d:\IDEWORK\lvmen\src\licensedcode\data\rules\false-positive_31.yml", "YAML", 0, 0, 0, 2, 0, 0, 1, 3
"d:\IDEWORK\lvmen\src\licensedcode\data\rules\false-positive_310.yml", "YAML", 0, 0, 0, 2, 0, 0, 1, 3
"d:\IDEWORK\lvmen\src\licensedcode\data\rules\false-positive_3100.yml", "YAML", 0, 0, 0, 2, 0, 0, 1, 3
"d:\IDEWORK\lvmen\src\licensedcode\data\rules\false-positive_3101.yml", "YAML", 0, 0, 0, 2, 0, 0, 1, 3
"d:\IDEWORK\lvmen\src\licensedcode\data\rules\false-positive_3102.yml", "YAML", 0, 0, 0, 2, 0, 0, 1, 3
"d:\IDEWORK\lvmen\src\licensedcode\data\rules\false-positive_3103.yml", "YAML", 0, 0, 0, 2, 0, 0, 1, 3
"d:\IDEWORK\lvmen\src\licensedcode\data\rules\false-positive_3104.yml", "YAML", 0, 0, 0, 2, 0, 0, 1, 3
"d:\IDEWORK\lvmen\src\licensedcode\data\rules\false-positive_3105.yml", "YAML", 0, 0, 0, 2, 0, 0, 1, 3
"d:\IDEWORK\lvmen\src\licensedcode\data\rules\false-positive_3106.yml", "YAML", 0, 0, 0, 2, 0, 0, 1, 3
"d:\IDEWORK\lvmen\src\licensedcode\data\rules\false-positive_3107.yml", "YAML", 0, 0, 0, 2, 0, 0, 1, 3
"d:\IDEWORK\lvmen\src\licensedcode\data\rules\false-positive_3108.yml", "YAML", 0, 0, 0, 2, 0, 0, 1, 3
"d:\IDEWORK\lvmen\src\licensedcode\data\rules\false-positive_3109.yml", "YAML", 0, 0, 0, 2, 0, 0, 1, 3
"d:\IDEWORK\lvmen\src\licensedcode\data\rules\false-positive_311.yml", "YAML", 0, 0, 0, 2, 0, 0, 1, 3
"d:\IDEWORK\lvmen\src\licensedcode\data\rules\false-positive_3110.yml", "YAML", 0, 0, 0, 2, 0, 0, 1, 3
"d:\IDEWORK\lvmen\src\licensedcode\data\rules\false-positive_3111.yml", "YAML", 0, 0, 0, 2, 0, 0, 1, 3
"d:\IDEWORK\lvmen\src\licensedcode\data\rules\false-positive_3112.yml", "YAML", 0, 0, 0, 2, 0, 0, 1, 3
"d:\IDEWORK\lvmen\src\licensedcode\data\rules\false-positive_3113.yml", "YAML", 0, 0, 0, 2, 0, 0, 1, 3
"d:\IDEWORK\lvmen\src\licensedcode\data\rules\false-positive_3114.yml", "YAML", 0, 0, 0, 2, 0, 0, 1, 3
"d:\IDEWORK\lvmen\src\licensedcode\data\rules\false-positive_3115.yml", "YAML", 0, 0, 0, 2, 0, 0, 1, 3
"d:\IDEWORK\lvmen\src\licensedcode\data\rules\false-positive_3116.yml", "YAML", 0, 0, 0, 2, 0, 0, 1, 3
"d:\IDEWORK\lvmen\src\licensedcode\data\rules\false-positive_3117.yml", "YAML", 0, 0, 0, 2, 0, 0, 1, 3
"d:\IDEWORK\lvmen\src\licensedcode\data\rules\false-positive_3118.yml", "YAML", 0, 0, 0, 2, 0, 0, 1, 3
"d:\IDEWORK\lvmen\src\licensedcode\data\rules\false-positive_3119.yml", "YAML", 0, 0, 0, 2, 0, 0, 1, 3
"d:\IDEWORK\lvmen\src\licensedcode\data\rules\false-positive_312.yml", "YAML", 0, 0, 0, 3, 0, 0, 1, 4
"d:\IDEWORK\lvmen\src\licensedcode\data\rules\false-positive_3120.yml", "YAML", 0, 0, 0, 2, 0, 0, 1, 3
"d:\IDEWORK\lvmen\src\licensedcode\data\rules\false-positive_3121.yml", "YAML", 0, 0, 0, 2, 0, 0, 1, 3
"d:\IDEWORK\lvmen\src\licensedcode\data\rules\false-positive_3122.yml", "YAML", 0, 0, 0, 2, 0, 0, 1, 3
"d:\IDEWORK\lvmen\src\licensedcode\data\rules\false-positive_3123.yml", "YAML", 0, 0, 0, 2, 0, 0, 1, 3
"d:\IDEWORK\lvmen\src\licensedcode\data\rules\false-positive_3124.yml", "YAML", 0, 0, 0, 2, 0, 0, 1, 3
"d:\IDEWORK\lvmen\src\licensedcode\data\rules\false-positive_3125.yml", "YAML", 0, 0, 0, 2, 0, 0, 1, 3
"d:\IDEWORK\lvmen\src\licensedcode\data\rules\false-positive_3126.yml", "YAML", 0, 0, 0, 2, 0, 0, 1, 3
"d:\IDEWORK\lvmen\src\licensedcode\data\rules\false-positive_3127.yml", "YAML", 0, 0, 0, 2, 0, 0, 1, 3
"d:\IDEWORK\lvmen\src\licensedcode\data\rules\false-positive_3128.yml", "YAML", 0, 0, 0, 2, 0, 0, 1, 3
"d:\IDEWORK\lvmen\src\licensedcode\data\rules\false-positive_3129.yml", "YAML", 0, 0, 0, 2, 0, 0, 1, 3
"d:\IDEWORK\lvmen\src\licensedcode\data\rules\false-positive_313.yml", "YAML", 0, 0, 0, 3, 0, 0, 1, 4
"d:\IDEWORK\lvmen\src\licensedcode\data\rules\false-positive_3130.yml", "YAML", 0, 0, 0, 2, 0, 0, 1, 3
"d:\IDEWORK\lvmen\src\licensedcode\data\rules\false-positive_3131.yml", "YAML", 0, 0, 0, 2, 0, 0, 1, 3
"d:\IDEWORK\lvmen\src\licensedcode\data\rules\false-positive_3132.yml", "YAML", 0, 0, 0, 2, 0, 0, 1, 3
"d:\IDEWORK\lvmen\src\licensedcode\data\rules\false-positive_3133.yml", "YAML", 0, 0, 0, 2, 0, 0, 1, 3
"d:\IDEWORK\lvmen\src\licensedcode\data\rules\false-positive_3134.yml", "YAML", 0, 0, 0, 2, 0, 0, 1, 3
"d:\IDEWORK\lvmen\src\licensedcode\data\rules\false-positive_3135.yml", "YAML", 0, 0, 0, 2, 0, 0, 1, 3
"d:\IDEWORK\lvmen\src\licensedcode\data\rules\false-positive_3136.yml", "YAML", 0, 0, 0, 2, 0, 0, 1, 3
"d:\IDEWORK\lvmen\src\licensedcode\data\rules\false-positive_3137.yml", "YAML", 0, 0, 0, 2, 0, 0, 1, 3
"d:\IDEWORK\lvmen\src\licensedcode\data\rules\false-positive_3138.yml", "YAML", 0, 0, 0, 2, 0, 0, 1, 3
"d:\IDEWORK\lvmen\src\licensedcode\data\rules\false-positive_3139.yml", "YAML", 0, 0, 0, 2, 0, 0, 1, 3
"d:\IDEWORK\lvmen\src\licensedcode\data\rules\false-positive_314.yml", "YAML", 0, 0, 0, 2, 0, 0, 1, 3
"d:\IDEWORK\lvmen\src\licensedcode\data\rules\false-positive_3140.yml", "YAML", 0, 0, 0, 2, 0, 0, 1, 3
"d:\IDEWORK\lvmen\src\licensedcode\data\rules\false-positive_3141.yml", "YAML", 0, 0, 0, 2, 0, 0, 1, 3
"d:\IDEWORK\lvmen\src\licensedcode\data\rules\false-positive_3142.yml", "YAML", 0, 0, 0, 2, 0, 0, 1, 3
"d:\IDEWORK\lvmen\src\licensedcode\data\rules\false-positive_3143.yml", "YAML", 0, 0, 0, 2, 0, 0, 1, 3
"d:\IDEWORK\lvmen\src\licensedcode\data\rules\false-positive_3144.yml", "YAML", 0, 0, 0, 2, 0, 0, 1, 3
"d:\IDEWORK\lvmen\src\licensedcode\data\rules\false-positive_3145.yml", "YAML", 0, 0, 0, 2, 0, 0, 1, 3
"d:\IDEWORK\lvmen\src\licensedcode\data\rules\false-positive_3146.yml", "YAML", 0, 0, 0, 2, 0, 0, 1, 3
"d:\IDEWORK\lvmen\src\licensedcode\data\rules\false-positive_3147.yml", "YAML", 0, 0, 0, 2, 0, 0, 1, 3
"d:\IDEWORK\lvmen\src\licensedcode\data\rules\false-positive_3148.yml", "YAML", 0, 0, 0, 2, 0, 0, 1, 3
"d:\IDEWORK\lvmen\src\licensedcode\data\rules\false-positive_3149.yml", "YAML", 0, 0, 0, 2, 0, 0, 1, 3
"d:\IDEWORK\lvmen\src\licensedcode\data\rules\false-positive_315.yml", "YAML", 0, 0, 0, 2, 0, 0, 1, 3
"d:\IDEWORK\lvmen\src\licensedcode\data\rules\false-positive_3150.yml", "YAML", 0, 0, 0, 2, 0, 0, 1, 3
"d:\IDEWORK\lvmen\src\licensedcode\data\rules\false-positive_3151.yml", "YAML", 0, 0, 0, 2, 0, 0, 1, 3
"d:\IDEWORK\lvmen\src\licensedcode\data\rules\false-positive_3152.yml", "YAML", 0, 0, 0, 2, 0, 0, 1, 3
"d:\IDEWORK\lvmen\src\licensedcode\data\rules\false-positive_3153.yml", "YAML", 0, 0, 0, 2, 0, 0, 1, 3
"d:\IDEWORK\lvmen\src\licensedcode\data\rules\false-positive_3154.yml", "YAML", 0, 0, 0, 2, 0, 0, 1, 3
"d:\IDEWORK\lvmen\src\licensedcode\data\rules\false-positive_3155.yml", "YAML", 0, 0, 0, 2, 0, 0, 1, 3
"d:\IDEWORK\lvmen\src\licensedcode\data\rules\false-positive_3156.yml", "YAML", 0, 0, 0, 2, 0, 0, 1, 3
"d:\IDEWORK\lvmen\src\licensedcode\data\rules\false-positive_3157.yml", "YAML", 0, 0, 0, 2, 0, 0, 1, 3
"d:\IDEWORK\lvmen\src\licensedcode\data\rules\false-positive_3158.yml", "YAML", 0, 0, 0, 2, 0, 0, 1, 3
"d:\IDEWORK\lvmen\src\licensedcode\data\rules\false-positive_3159.yml", "YAML", 0, 0, 0, 2, 0, 0, 1, 3
"d:\IDEWORK\lvmen\src\licensedcode\data\rules\false-positive_316.yml", "YAML", 0, 0, 0, 2, 0, 0, 1, 3
"d:\IDEWORK\lvmen\src\licensedcode\data\rules\false-positive_3160.yml", "YAML", 0, 0, 0, 2, 0, 0, 1, 3
"d:\IDEWORK\lvmen\src\licensedcode\data\rules\false-positive_3161.yml", "YAML", 0, 0, 0, 2, 0, 0, 1, 3
"d:\IDEWORK\lvmen\src\licensedcode\data\rules\false-positive_3162.yml", "YAML", 0, 0, 0, 2, 0, 0, 1, 3
"d:\IDEWORK\lvmen\src\licensedcode\data\rules\false-positive_3163.yml", "YAML", 0, 0, 0, 2, 0, 0, 1, 3
"d:\IDEWORK\lvmen\src\licensedcode\data\rules\false-positive_3164.yml", "YAML", 0, 0, 0, 2, 0, 0, 1, 3
"d:\IDEWORK\lvmen\src\licensedcode\data\rules\false-positive_3165.yml", "YAML", 0, 0, 0, 2, 0, 0, 1, 3
"d:\IDEWORK\lvmen\src\licensedcode\data\rules\false-positive_3166.yml", "YAML", 0, 0, 0, 2, 0, 0, 1, 3
"d:\IDEWORK\lvmen\src\licensedcode\data\rules\false-positive_3167.yml", "YAML", 0, 0, 0, 2, 0, 0, 1, 3
"d:\IDEWORK\lvmen\src\licensedcode\data\rules\false-positive_3168.yml", "YAML", 0, 0, 0, 2, 0, 0, 1, 3
"d:\IDEWORK\lvmen\src\licensedcode\data\rules\false-positive_3169.yml", "YAML", 0, 0, 0, 2, 0, 0, 1, 3
"d:\IDEWORK\lvmen\src\licensedcode\data\rules\false-positive_317.yml", "YAML", 0, 0, 0, 2, 0, 0, 1, 3
"d:\IDEWORK\lvmen\src\licensedcode\data\rules\false-positive_3170.yml", "YAML", 0, 0, 0, 2, 0, 0, 1, 3
"d:\IDEWORK\lvmen\src\licensedcode\data\rules\false-positive_3171.yml", "YAML", 0, 0, 0, 2, 0, 0, 1, 3
"d:\IDEWORK\lvmen\src\licensedcode\data\rules\false-positive_3172.yml", "YAML", 0, 0, 0, 2, 0, 0, 1, 3
"d:\IDEWORK\lvmen\src\licensedcode\data\rules\false-positive_3173.yml", "YAML", 0, 0, 0, 2, 0, 0, 1, 3
"d:\IDEWORK\lvmen\src\licensedcode\data\rules\false-positive_3174.yml", "YAML", 0, 0, 0, 2, 0, 0, 1, 3
"d:\IDEWORK\lvmen\src\licensedcode\data\rules\false-positive_3175.yml", "YAML", 0, 0, 0, 2, 0, 0, 1, 3
"d:\IDEWORK\lvmen\src\licensedcode\data\rules\false-positive_3176.yml", "YAML", 0, 0, 0, 2, 0, 0, 1, 3
"d:\IDEWORK\lvmen\src\licensedcode\data\rules\false-positive_3177.yml", "YAML", 0, 0, 0, 2, 0, 0, 1, 3
"d:\IDEWORK\lvmen\src\licensedcode\data\rules\false-positive_3178.yml", "YAML", 0, 0, 0, 2, 0, 0, 1, 3
"d:\IDEWORK\lvmen\src\licensedcode\data\rules\false-positive_3179.yml", "YAML", 0, 0, 0, 2, 0, 0, 1, 3
"d:\IDEWORK\lvmen\src\licensedcode\data\rules\false-positive_318.yml", "YAML", 0, 0, 0, 3, 0, 0, 1, 4
"d:\IDEWORK\lvmen\src\licensedcode\data\rules\false-positive_3180.yml", "YAML", 0, 0, 0, 2, 0, 0, 1, 3
"d:\IDEWORK\lvmen\src\licensedcode\data\rules\false-positive_3181.yml", "YAML", 0, 0, 0, 2, 0, 0, 1, 3
"d:\IDEWORK\lvmen\src\licensedcode\data\rules\false-positive_3182.yml", "YAML", 0, 0, 0, 2, 0, 0, 1, 3
"d:\IDEWORK\lvmen\src\licensedcode\data\rules\false-positive_3183.yml", "YAML", 0, 0, 0, 2, 0, 0, 1, 3
"d:\IDEWORK\lvmen\src\licensedcode\data\rules\false-positive_3184.yml", "YAML", 0, 0, 0, 2, 0, 0, 1, 3
"d:\IDEWORK\lvmen\src\licensedcode\data\rules\false-positive_3185.yml", "YAML", 0, 0, 0, 2, 0, 0, 1, 3
"d:\IDEWORK\lvmen\src\licensedcode\data\rules\false-positive_3186.yml", "YAML", 0, 0, 0, 2, 0, 0, 1, 3
"d:\IDEWORK\lvmen\src\licensedcode\data\rules\false-positive_3187.yml", "YAML", 0, 0, 0, 2, 0, 0, 1, 3
"d:\IDEWORK\lvmen\src\licensedcode\data\rules\false-positive_3188.yml", "YAML", 0, 0, 0, 2, 0, 0, 1, 3
"d:\IDEWORK\lvmen\src\licensedcode\data\rules\false-positive_3189.yml", "YAML", 0, 0, 0, 2, 0, 0, 1, 3
"d:\IDEWORK\lvmen\src\licensedcode\data\rules\false-positive_319.yml", "YAML", 0, 0, 0, 2, 0, 0, 1, 3
"d:\IDEWORK\lvmen\src\licensedcode\data\rules\false-positive_3190.yml", "YAML", 0, 0, 0, 2, 0, 0, 1, 3
"d:\IDEWORK\lvmen\src\licensedcode\data\rules\false-positive_3191.yml", "YAML", 0, 0, 0, 2, 0, 0, 1, 3
"d:\IDEWORK\lvmen\src\licensedcode\data\rules\false-positive_3192.yml", "YAML", 0, 0, 0, 2, 0, 0, 1, 3
"d:\IDEWORK\lvmen\src\licensedcode\data\rules\false-positive_3193.yml", "YAML", 0, 0, 0, 2, 0, 0, 1, 3
"d:\IDEWORK\lvmen\src\licensedcode\data\rules\false-positive_3194.yml", "YAML", 0, 0, 0, 2, 0, 0, 1, 3
"d:\IDEWORK\lvmen\src\licensedcode\data\rules\false-positive_3195.yml", "YAML", 0, 0, 0, 2, 0, 0, 1, 3
"d:\IDEWORK\lvmen\src\licensedcode\data\rules\false-positive_3196.yml", "YAML", 0, 0, 0, 2, 0, 0, 1, 3
"d:\IDEWORK\lvmen\src\licensedcode\data\rules\false-positive_3197.yml", "YAML", 0, 0, 0, 2, 0, 0, 1, 3
"d:\IDEWORK\lvmen\src\licensedcode\data\rules\false-positive_3198.yml", "YAML", 0, 0, 0, 2, 0, 0, 1, 3
"d:\IDEWORK\lvmen\src\licensedcode\data\rules\false-positive_3199.yml", "YAML", 0, 0, 0, 2, 0, 0, 1, 3
"d:\IDEWORK\lvmen\src\licensedcode\data\rules\false-positive_32.yml", "YAML", 0, 0, 0, 2, 0, 0, 1, 3
"d:\IDEWORK\lvmen\src\licensedcode\data\rules\false-positive_320.yml", "YAML", 0, 0, 0, 2, 0, 0, 1, 3
"d:\IDEWORK\lvmen\src\licensedcode\data\rules\false-positive_3200.yml", "YAML", 0, 0, 0, 2, 0, 0, 1, 3
"d:\IDEWORK\lvmen\src\licensedcode\data\rules\false-positive_3201.yml", "YAML", 0, 0, 0, 2, 0, 0, 1, 3
"d:\IDEWORK\lvmen\src\licensedcode\data\rules\false-positive_3202.yml", "YAML", 0, 0, 0, 2, 0, 0, 1, 3
"d:\IDEWORK\lvmen\src\licensedcode\data\rules\false-positive_3203.yml", "YAML", 0, 0, 0, 2, 0, 0, 1, 3
"d:\IDEWORK\lvmen\src\licensedcode\data\rules\false-positive_3204.yml", "YAML", 0, 0, 0, 2, 0, 0, 1, 3
"d:\IDEWORK\lvmen\src\licensedcode\data\rules\false-positive_3205.yml", "YAML", 0, 0, 0, 2, 0, 0, 1, 3
"d:\IDEWORK\lvmen\src\licensedcode\data\rules\false-positive_3206.yml", "YAML", 0, 0, 0, 2, 0, 0, 1, 3
"d:\IDEWORK\lvmen\src\licensedcode\data\rules\false-positive_3207.yml", "YAML", 0, 0, 0, 2, 0, 0, 1, 3
"d:\IDEWORK\lvmen\src\licensedcode\data\rules\false-positive_3208.yml", "YAML", 0, 0, 0, 2, 0, 0, 1, 3
"d:\IDEWORK\lvmen\src\licensedcode\data\rules\false-positive_3209.yml", "YAML", 0, 0, 0, 2, 0, 0, 1, 3
"d:\IDEWORK\lvmen\src\licensedcode\data\rules\false-positive_321.yml", "YAML", 0, 0, 0, 2, 0, 0, 1, 3
"d:\IDEWORK\lvmen\src\licensedcode\data\rules\false-positive_3210.yml", "YAML", 0, 0, 0, 2, 0, 0, 1, 3
"d:\IDEWORK\lvmen\src\licensedcode\data\rules\false-positive_3211.yml", "YAML", 0, 0, 0, 2, 0, 0, 1, 3
"d:\IDEWORK\lvmen\src\licensedcode\data\rules\false-positive_3212.yml", "YAML", 0, 0, 0, 2, 0, 0, 1, 3
"d:\IDEWORK\lvmen\src\licensedcode\data\rules\false-positive_3213.yml", "YAML", 0, 0, 0, 2, 0, 0, 1, 3
"d:\IDEWORK\lvmen\src\licensedcode\data\rules\false-positive_3214.yml", "YAML", 0, 0, 0, 2, 0, 0, 1, 3
"d:\IDEWORK\lvmen\src\licensedcode\data\rules\false-positive_3215.yml", "YAML", 0, 0, 0, 2, 0, 0, 1, 3
"d:\IDEWORK\lvmen\src\licensedcode\data\rules\false-positive_3216.yml", "YAML", 0, 0, 0, 2, 0, 0, 1, 3
"d:\IDEWORK\lvmen\src\licensedcode\data\rules\false-positive_3217.yml", "YAML", 0, 0, 0, 2, 0, 0, 1, 3
"d:\IDEWORK\lvmen\src\licensedcode\data\rules\false-positive_3218.yml", "YAML", 0, 0, 0, 2, 0, 0, 1, 3
"d:\IDEWORK\lvmen\src\licensedcode\data\rules\false-positive_3219.yml", "YAML", 0, 0, 0, 2, 0, 0, 1, 3
"d:\IDEWORK\lvmen\src\licensedcode\data\rules\false-positive_322.yml", "YAML", 0, 0, 0, 3, 0, 0, 1, 4
"d:\IDEWORK\lvmen\src\licensedcode\data\rules\false-positive_3220.yml", "YAML", 0, 0, 0, 2, 0, 0, 1, 3
"d:\IDEWORK\lvmen\src\licensedcode\data\rules\false-positive_3221.yml", "YAML", 0, 0, 0, 2, 0, 0, 1, 3
"d:\IDEWORK\lvmen\src\licensedcode\data\rules\false-positive_3222.yml", "YAML", 0, 0, 0, 2, 0, 0, 1, 3
"d:\IDEWORK\lvmen\src\licensedcode\data\rules\false-positive_3223.yml", "YAML", 0, 0, 0, 2, 0, 0, 1, 3
"d:\IDEWORK\lvmen\src\licensedcode\data\rules\false-positive_3224.yml", "YAML", 0, 0, 0, 2, 0, 0, 1, 3
"d:\IDEWORK\lvmen\src\licensedcode\data\rules\false-positive_3225.yml", "YAML", 0, 0, 0, 2, 0, 0, 1, 3
"d:\IDEWORK\lvmen\src\licensedcode\data\rules\false-positive_3226.yml", "YAML", 0, 0, 0, 2, 0, 0, 1, 3
"d:\IDEWORK\lvmen\src\licensedcode\data\rules\false-positive_3227.yml", "YAML", 0, 0, 0, 2, 0, 0, 1, 3
"d:\IDEWORK\lvmen\src\licensedcode\data\rules\false-positive_3228.yml", "YAML", 0, 0, 0, 2, 0, 0, 1, 3
"d:\IDEWORK\lvmen\src\licensedcode\data\rules\false-positive_3229.yml", "YAML", 0, 0, 0, 2, 0, 0, 1, 3
"d:\IDEWORK\lvmen\src\licensedcode\data\rules\false-positive_323.yml", "YAML", 0, 0, 0, 2, 0, 0, 1, 3
"d:\IDEWORK\lvmen\src\licensedcode\data\rules\false-positive_3230.yml", "YAML", 0, 0, 0, 2, 0, 0, 1, 3
"d:\IDEWORK\lvmen\src\licensedcode\data\rules\false-positive_3231.yml", "YAML", 0, 0, 0, 2, 0, 0, 1, 3
"d:\IDEWORK\lvmen\src\licensedcode\data\rules\false-positive_3232.yml", "YAML", 0, 0, 0, 2, 0, 0, 1, 3
"d:\IDEWORK\lvmen\src\licensedcode\data\rules\false-positive_3233.yml", "YAML", 0, 0, 0, 2, 0, 0, 1, 3
"d:\IDEWORK\lvmen\src\licensedcode\data\rules\false-positive_3234.yml", "YAML", 0, 0, 0, 2, 0, 0, 1, 3
"d:\IDEWORK\lvmen\src\licensedcode\data\rules\false-positive_3235.yml", "YAML", 0, 0, 0, 2, 0, 0, 1, 3
"d:\IDEWORK\lvmen\src\licensedcode\data\rules\false-positive_3236.yml", "YAML", 0, 0, 0, 2, 0, 0, 1, 3
"d:\IDEWORK\lvmen\src\licensedcode\data\rules\false-positive_3237.yml", "YAML", 0, 0, 0, 2, 0, 0, 1, 3
"d:\IDEWORK\lvmen\src\licensedcode\data\rules\false-positive_3238.yml", "YAML", 0, 0, 0, 2, 0, 0, 1, 3
"d:\IDEWORK\lvmen\src\licensedcode\data\rules\false-positive_3239.yml", "YAML", 0, 0, 0, 2, 0, 0, 1, 3
"d:\IDEWORK\lvmen\src\licensedcode\data\rules\false-positive_324.yml", "YAML", 0, 0, 0, 3, 0, 0, 1, 4
"d:\IDEWORK\lvmen\src\licensedcode\data\rules\false-positive_3240.yml", "YAML", 0, 0, 0, 2, 0, 0, 1, 3
"d:\IDEWORK\lvmen\src\licensedcode\data\rules\false-positive_3241.yml", "YAML", 0, 0, 0, 2, 0, 0, 1, 3
"d:\IDEWORK\lvmen\src\licensedcode\data\rules\false-positive_3242.yml", "YAML", 0, 0, 0, 2, 0, 0, 1, 3
"d:\IDEWORK\lvmen\src\licensedcode\data\rules\false-positive_3243.yml", "YAML", 0, 0, 0, 2, 0, 0, 1, 3
"d:\IDEWORK\lvmen\src\licensedcode\data\rules\false-positive_3244.yml", "YAML", 0, 0, 0, 2, 0, 0, 1, 3
"d:\IDEWORK\lvmen\src\licensedcode\data\rules\false-positive_3245.yml", "YAML", 0, 0, 0, 2, 0, 0, 1, 3
"d:\IDEWORK\lvmen\src\licensedcode\data\rules\false-positive_3246.yml", "YAML", 0, 0, 0, 2, 0, 0, 1, 3
"d:\IDEWORK\lvmen\src\licensedcode\data\rules\false-positive_3247.yml", "YAML", 0, 0, 0, 2, 0, 0, 1, 3
"d:\IDEWORK\lvmen\src\licensedcode\data\rules\false-positive_3248.yml", "YAML", 0, 0, 0, 2, 0, 0, 1, 3
"d:\IDEWORK\lvmen\src\licensedcode\data\rules\false-positive_3249.yml", "YAML", 0, 0, 0, 2, 0, 0, 1, 3
"d:\IDEWORK\lvmen\src\licensedcode\data\rules\false-positive_325.yml", "YAML", 0, 0, 0, 2, 0, 0, 1, 3
"d:\IDEWORK\lvmen\src\licensedcode\data\rules\false-positive_3250.yml", "YAML", 0, 0, 0, 2, 0, 0, 1, 3
"d:\IDEWORK\lvmen\src\licensedcode\data\rules\false-positive_3251.yml", "YAML", 0, 0, 0, 2, 0, 0, 1, 3
"d:\IDEWORK\lvmen\src\licensedcode\data\rules\false-positive_3252.yml", "YAML", 0, 0, 0, 2, 0, 0, 1, 3
"d:\IDEWORK\lvmen\src\licensedcode\data\rules\false-positive_3253.yml", "YAML", 0, 0, 0, 2, 0, 0, 1, 3
"d:\IDEWORK\lvmen\src\licensedcode\data\rules\false-positive_3254.yml", "YAML", 0, 0, 0, 2, 0, 0, 1, 3
"d:\IDEWORK\lvmen\src\licensedcode\data\rules\false-positive_3255.yml", "YAML", 0, 0, 0, 2, 0, 0, 1, 3
"d:\IDEWORK\lvmen\src\licensedcode\data\rules\false-positive_3256.yml", "YAML", 0, 0, 0, 2, 0, 0, 1, 3
"d:\IDEWORK\lvmen\src\licensedcode\data\rules\false-positive_3257.yml", "YAML", 0, 0, 0, 2, 0, 0, 1, 3
"d:\IDEWORK\lvmen\src\licensedcode\data\rules\false-positive_3258.yml", "YAML", 0, 0, 0, 2, 0, 0, 1, 3
"d:\IDEWORK\lvmen\src\licensedcode\data\rules\false-positive_3259.yml", "YAML", 0, 0, 0, 2, 0, 0, 1, 3
"d:\IDEWORK\lvmen\src\licensedcode\data\rules\false-positive_326.yml", "YAML", 0, 0, 0, 2, 0, 0, 1, 3
"d:\IDEWORK\lvmen\src\licensedcode\data\rules\false-positive_3260.yml", "YAML", 0, 0, 0, 2, 0, 0, 1, 3
"d:\IDEWORK\lvmen\src\licensedcode\data\rules\false-positive_3261.yml", "YAML", 0, 0, 0, 2, 0, 0, 1, 3
"d:\IDEWORK\lvmen\src\licensedcode\data\rules\false-positive_3262.yml", "YAML", 0, 0, 0, 2, 0, 0, 1, 3
"d:\IDEWORK\lvmen\src\licensedcode\data\rules\false-positive_3263.yml", "YAML", 0, 0, 0, 2, 0, 0, 1, 3
"d:\IDEWORK\lvmen\src\licensedcode\data\rules\false-positive_3264.yml", "YAML", 0, 0, 0, 2, 0, 0, 1, 3
"d:\IDEWORK\lvmen\src\licensedcode\data\rules\false-positive_3265.yml", "YAML", 0, 0, 0, 2, 0, 0, 1, 3
"d:\IDEWORK\lvmen\src\licensedcode\data\rules\false-positive_3266.yml", "YAML", 0, 0, 0, 2, 0, 0, 1, 3
"d:\IDEWORK\lvmen\src\licensedcode\data\rules\false-positive_3267.yml", "YAML", 0, 0, 0, 2, 0, 0, 1, 3
"d:\IDEWORK\lvmen\src\licensedcode\data\rules\false-positive_3268.yml", "YAML", 0, 0, 0, 2, 0, 0, 1, 3
"d:\IDEWORK\lvmen\src\licensedcode\data\rules\false-positive_3269.yml", "YAML", 0, 0, 0, 2, 0, 0, 1, 3
"d:\IDEWORK\lvmen\src\licensedcode\data\rules\false-positive_327.yml", "YAML", 0, 0, 0, 2, 0, 0, 1, 3
"d:\IDEWORK\lvmen\src\licensedcode\data\rules\false-positive_3270.yml", "YAML", 0, 0, 0, 2, 0, 0, 1, 3
"d:\IDEWORK\lvmen\src\licensedcode\data\rules\false-positive_3271.yml", "YAML", 0, 0, 0, 2, 0, 0, 1, 3
"d:\IDEWORK\lvmen\src\licensedcode\data\rules\false-positive_3272.yml", "YAML", 0, 0, 0, 2, 0, 0, 1, 3
"d:\IDEWORK\lvmen\src\licensedcode\data\rules\false-positive_3273.yml", "YAML", 0, 0, 0, 2, 0, 0, 1, 3
"d:\IDEWORK\lvmen\src\licensedcode\data\rules\false-positive_3274.yml", "YAML", 0, 0, 0, 2, 0, 0, 1, 3
"d:\IDEWORK\lvmen\src\licensedcode\data\rules\false-positive_3275.yml", "YAML", 0, 0, 0, 2, 0, 0, 1, 3
"d:\IDEWORK\lvmen\src\licensedcode\data\rules\false-positive_3276.yml", "YAML", 0, 0, 0, 2, 0, 0, 1, 3
"d:\IDEWORK\lvmen\src\licensedcode\data\rules\false-positive_3277.yml", "YAML", 0, 0, 0, 2, 0, 0, 1, 3
"d:\IDEWORK\lvmen\src\licensedcode\data\rules\false-positive_3278.yml", "YAML", 0, 0, 0, 2, 0, 0, 1, 3
"d:\IDEWORK\lvmen\src\licensedcode\data\rules\false-positive_3279.yml", "YAML", 0, 0, 0, 2, 0, 0, 1, 3
"d:\IDEWORK\lvmen\src\licensedcode\data\rules\false-positive_328.yml", "YAML", 0, 0, 0, 3, 0, 0, 1, 4
"d:\IDEWORK\lvmen\src\licensedcode\data\rules\false-positive_3280.yml", "YAML", 0, 0, 0, 2, 0, 0, 1, 3
"d:\IDEWORK\lvmen\src\licensedcode\data\rules\false-positive_3281.yml", "YAML", 0, 0, 0, 2, 0, 0, 1, 3
"d:\IDEWORK\lvmen\src\licensedcode\data\rules\false-positive_3282.yml", "YAML", 0, 0, 0, 2, 0, 0, 1, 3
"d:\IDEWORK\lvmen\src\licensedcode\data\rules\false-positive_3283.yml", "YAML", 0, 0, 0, 2, 0, 0, 1, 3
"d:\IDEWORK\lvmen\src\licensedcode\data\rules\false-positive_3284.yml", "YAML", 0, 0, 0, 2, 0, 0, 1, 3
"d:\IDEWORK\lvmen\src\licensedcode\data\rules\false-positive_3285.yml", "YAML", 0, 0, 0, 2, 0, 0, 1, 3
"d:\IDEWORK\lvmen\src\licensedcode\data\rules\false-positive_3286.yml", "YAML", 0, 0, 0, 2, 0, 0, 1, 3
"d:\IDEWORK\lvmen\src\licensedcode\data\rules\false-positive_3287.yml", "YAML", 0, 0, 0, 2, 0, 0, 1, 3
"d:\IDEWORK\lvmen\src\licensedcode\data\rules\false-positive_3288.yml", "YAML", 0, 0, 0, 2, 0, 0, 1, 3
"d:\IDEWORK\lvmen\src\licensedcode\data\rules\false-positive_3289.yml", "YAML", 0, 0, 0, 2, 0, 0, 1, 3
"d:\IDEWORK\lvmen\src\licensedcode\data\rules\false-positive_329.yml", "YAML", 0, 0, 0, 2, 0, 0, 1, 3
"d:\IDEWORK\lvmen\src\licensedcode\data\rules\false-positive_3290.yml", "YAML", 0, 0, 0, 2, 0, 0, 1, 3
"d:\IDEWORK\lvmen\src\licensedcode\data\rules\false-positive_3291.yml", "YAML", 0, 0, 0, 2, 0, 0, 1, 3
"d:\IDEWORK\lvmen\src\licensedcode\data\rules\false-positive_3292.yml", "YAML", 0, 0, 0, 2, 0, 0, 1, 3
"d:\IDEWORK\lvmen\src\licensedcode\data\rules\false-positive_3293.yml", "YAML", 0, 0, 0, 2, 0, 0, 1, 3
"d:\IDEWORK\lvmen\src\licensedcode\data\rules\false-positive_3294.yml", "YAML", 0, 0, 0, 2, 0, 0, 1, 3
"d:\IDEWORK\lvmen\src\licensedcode\data\rules\false-positive_3295.yml", "YAML", 0, 0, 0, 2, 0, 0, 1, 3
"d:\IDEWORK\lvmen\src\licensedcode\data\rules\false-positive_3296.yml", "YAML", 0, 0, 0, 2, 0, 0, 1, 3
"d:\IDEWORK\lvmen\src\licensedcode\data\rules\false-positive_3297.yml", "YAML", 0, 0, 0, 2, 0, 0, 1, 3
"d:\IDEWORK\lvmen\src\licensedcode\data\rules\false-positive_3298.yml", "YAML", 0, 0, 0, 2, 0, 0, 1, 3
"d:\IDEWORK\lvmen\src\licensedcode\data\rules\false-positive_3299.yml", "YAML", 0, 0, 0, 2, 0, 0, 1, 3
"d:\IDEWORK\lvmen\src\licensedcode\data\rules\false-positive_33.yml", "YAML", 0, 0, 0, 2, 0, 0, 1, 3
"d:\IDEWORK\lvmen\src\licensedcode\data\rules\false-positive_330.yml", "YAML", 0, 0, 0, 2, 0, 0, 1, 3
"d:\IDEWORK\lvmen\src\licensedcode\data\rules\false-positive_3300.yml", "YAML", 0, 0, 0, 2, 0, 0, 1, 3
"d:\IDEWORK\lvmen\src\licensedcode\data\rules\false-positive_3301.yml", "YAML", 0, 0, 0, 2, 0, 0, 1, 3
"d:\IDEWORK\lvmen\src\licensedcode\data\rules\false-positive_3302.yml", "YAML", 0, 0, 0, 2, 0, 0, 1, 3
"d:\IDEWORK\lvmen\src\licensedcode\data\rules\false-positive_3303.yml", "YAML", 0, 0, 0, 2, 0, 0, 1, 3
"d:\IDEWORK\lvmen\src\licensedcode\data\rules\false-positive_3304.yml", "YAML", 0, 0, 0, 2, 0, 0, 1, 3
"d:\IDEWORK\lvmen\src\licensedcode\data\rules\false-positive_3305.yml", "YAML", 0, 0, 0, 2, 0, 0, 1, 3
"d:\IDEWORK\lvmen\src\licensedcode\data\rules\false-positive_3306.yml", "YAML", 0, 0, 0, 2, 0, 0, 1, 3
"d:\IDEWORK\lvmen\src\licensedcode\data\rules\false-positive_3307.yml", "YAML", 0, 0, 0, 2, 0, 0, 1, 3
"d:\IDEWORK\lvmen\src\licensedcode\data\rules\false-positive_3308.yml", "YAML", 0, 0, 0, 2, 0, 0, 1, 3
"d:\IDEWORK\lvmen\src\licensedcode\data\rules\false-positive_3309.yml", "YAML", 0, 0, 0, 2, 0, 0, 1, 3
"d:\IDEWORK\lvmen\src\licensedcode\data\rules\false-positive_331.yml", "YAML", 0, 0, 0, 2, 0, 0, 1, 3
"d:\IDEWORK\lvmen\src\licensedcode\data\rules\false-positive_3310.yml", "YAML", 0, 0, 0, 2, 0, 0, 1, 3
"d:\IDEWORK\lvmen\src\licensedcode\data\rules\false-positive_3311.yml", "YAML", 0, 0, 0, 2, 0, 0, 1, 3
"d:\IDEWORK\lvmen\src\licensedcode\data\rules\false-positive_3312.yml", "YAML", 0, 0, 0, 2, 0, 0, 1, 3
"d:\IDEWORK\lvmen\src\licensedcode\data\rules\false-positive_3313.yml", "YAML", 0, 0, 0, 2, 0, 0, 1, 3
"d:\IDEWORK\lvmen\src\licensedcode\data\rules\false-positive_3314.yml", "YAML", 0, 0, 0, 2, 0, 0, 1, 3
"d:\IDEWORK\lvmen\src\licensedcode\data\rules\false-positive_3315.yml", "YAML", 0, 0, 0, 2, 0, 0, 1, 3
"d:\IDEWORK\lvmen\src\licensedcode\data\rules\false-positive_3316.yml", "YAML", 0, 0, 0, 2, 0, 0, 1, 3
"d:\IDEWORK\lvmen\src\licensedcode\data\rules\false-positive_3317.yml", "YAML", 0, 0, 0, 2, 0, 0, 1, 3
"d:\IDEWORK\lvmen\src\licensedcode\data\rules\false-positive_3318.yml", "YAML", 0, 0, 0, 2, 0, 0, 1, 3
"d:\IDEWORK\lvmen\src\licensedcode\data\rules\false-positive_3319.yml", "YAML", 0, 0, 0, 2, 0, 0, 1, 3
"d:\IDEWORK\lvmen\src\licensedcode\data\rules\false-positive_332.yml", "YAML", 0, 0, 0, 3, 0, 0, 1, 4
"d:\IDEWORK\lvmen\src\licensedcode\data\rules\false-positive_3320.yml", "YAML", 0, 0, 0, 2, 0, 0, 1, 3
"d:\IDEWORK\lvmen\src\licensedcode\data\rules\false-positive_3321.yml", "YAML", 0, 0, 0, 2, 0, 0, 1, 3
"d:\IDEWORK\lvmen\src\licensedcode\data\rules\false-positive_3322.yml", "YAML", 0, 0, 0, 2, 0, 0, 1, 3
"d:\IDEWORK\lvmen\src\licensedcode\data\rules\false-positive_3323.yml", "YAML", 0, 0, 0, 2, 0, 0, 1, 3
"d:\IDEWORK\lvmen\src\licensedcode\data\rules\false-positive_3324.yml", "YAML", 0, 0, 0, 2, 0, 0, 1, 3
"d:\IDEWORK\lvmen\src\licensedcode\data\rules\false-positive_3325.yml", "YAML", 0, 0, 0, 2, 0, 0, 1, 3
"d:\IDEWORK\lvmen\src\licensedcode\data\rules\false-positive_3326.yml", "YAML", 0, 0, 0, 2, 0, 0, 1, 3
"d:\IDEWORK\lvmen\src\licensedcode\data\rules\false-positive_3327.yml", "YAML", 0, 0, 0, 2, 0, 0, 1, 3
"d:\IDEWORK\lvmen\src\licensedcode\data\rules\false-positive_3328.yml", "YAML", 0, 0, 0, 2, 0, 0, 1, 3
"d:\IDEWORK\lvmen\src\licensedcode\data\rules\false-positive_3329.yml", "YAML", 0, 0, 0, 2, 0, 0, 1, 3
"d:\IDEWORK\lvmen\src\licensedcode\data\rules\false-positive_333.yml", "YAML", 0, 0, 0, 2, 0, 0, 1, 3
"d:\IDEWORK\lvmen\src\licensedcode\data\rules\false-positive_3330.yml", "YAML", 0, 0, 0, 2, 0, 0, 1, 3
"d:\IDEWORK\lvmen\src\licensedcode\data\rules\false-positive_3331.yml", "YAML", 0, 0, 0, 2, 0, 0, 1, 3
"d:\IDEWORK\lvmen\src\licensedcode\data\rules\false-positive_3332.yml", "YAML", 0, 0, 0, 2, 0, 0, 1, 3
"d:\IDEWORK\lvmen\src\licensedcode\data\rules\false-positive_3333.yml", "YAML", 0, 0, 0, 2, 0, 0, 1, 3
"d:\IDEWORK\lvmen\src\licensedcode\data\rules\false-positive_3334.yml", "YAML", 0, 0, 0, 2, 0, 0, 1, 3
"d:\IDEWORK\lvmen\src\licensedcode\data\rules\false-positive_3335.yml", "YAML", 0, 0, 0, 2, 0, 0, 1, 3
"d:\IDEWORK\lvmen\src\licensedcode\data\rules\false-positive_3336.yml", "YAML", 0, 0, 0, 2, 0, 0, 1, 3
"d:\IDEWORK\lvmen\src\licensedcode\data\rules\false-positive_3337.yml", "YAML", 0, 0, 0, 2, 0, 0, 1, 3
"d:\IDEWORK\lvmen\src\licensedcode\data\rules\false-positive_3338.yml", "YAML", 0, 0, 0, 2, 0, 0, 1, 3
"d:\IDEWORK\lvmen\src\licensedcode\data\rules\false-positive_3339.yml", "YAML", 0, 0, 0, 2, 0, 0, 1, 3
"d:\IDEWORK\lvmen\src\licensedcode\data\rules\false-positive_334.yml", "YAML", 0, 0, 0, 2, 0, 0, 1, 3
"d:\IDEWORK\lvmen\src\licensedcode\data\rules\false-positive_3340.yml", "YAML", 0, 0, 0, 2, 0, 0, 1, 3
"d:\IDEWORK\lvmen\src\licensedcode\data\rules\false-positive_3341.yml", "YAML", 0, 0, 0, 2, 0, 0, 1, 3
"d:\IDEWORK\lvmen\src\licensedcode\data\rules\false-positive_3342.yml", "YAML", 0, 0, 0, 2, 0, 0, 1, 3
"d:\IDEWORK\lvmen\src\licensedcode\data\rules\false-positive_3343.yml", "YAML", 0, 0, 0, 2, 0, 0, 1, 3
"d:\IDEWORK\lvmen\src\licensedcode\data\rules\false-positive_3344.yml", "YAML", 0, 0, 0, 2, 0, 0, 1, 3
"d:\IDEWORK\lvmen\src\licensedcode\data\rules\false-positive_3345.yml", "YAML", 0, 0, 0, 2, 0, 0, 1, 3
"d:\IDEWORK\lvmen\src\licensedcode\data\rules\false-positive_3346.yml", "YAML", 0, 0, 0, 2, 0, 0, 1, 3
"d:\IDEWORK\lvmen\src\licensedcode\data\rules\false-positive_3347.yml", "YAML", 0, 0, 0, 2, 0, 0, 1, 3
"d:\IDEWORK\lvmen\src\licensedcode\data\rules\false-positive_3348.yml", "YAML", 0, 0, 0, 2, 0, 0, 1, 3
"d:\IDEWORK\lvmen\src\licensedcode\data\rules\false-positive_3349.yml", "YAML", 0, 0, 0, 2, 0, 0, 1, 3
"d:\IDEWORK\lvmen\src\licensedcode\data\rules\false-positive_335.yml", "YAML", 0, 0, 0, 2, 0, 0, 1, 3
"d:\IDEWORK\lvmen\src\licensedcode\data\rules\false-positive_3350.yml", "YAML", 0, 0, 0, 2, 0, 0, 1, 3
"d:\IDEWORK\lvmen\src\licensedcode\data\rules\false-positive_3351.yml", "YAML", 0, 0, 0, 2, 0, 0, 1, 3
"d:\IDEWORK\lvmen\src\licensedcode\data\rules\false-positive_3352.yml", "YAML", 0, 0, 0, 2, 0, 0, 1, 3
"d:\IDEWORK\lvmen\src\licensedcode\data\rules\false-positive_3353.yml", "YAML", 0, 0, 0, 2, 0, 0, 1, 3
"d:\IDEWORK\lvmen\src\licensedcode\data\rules\false-positive_3354.yml", "YAML", 0, 0, 0, 2, 0, 0, 1, 3
"d:\IDEWORK\lvmen\src\licensedcode\data\rules\false-positive_3355.yml", "YAML", 0, 0, 0, 2, 0, 0, 1, 3
"d:\IDEWORK\lvmen\src\licensedcode\data\rules\false-positive_3356.yml", "YAML", 0, 0, 0, 2, 0, 0, 1, 3
"d:\IDEWORK\lvmen\src\licensedcode\data\rules\false-positive_3357.yml", "YAML", 0, 0, 0, 2, 0, 0, 1, 3
"d:\IDEWORK\lvmen\src\licensedcode\data\rules\false-positive_3358.yml", "YAML", 0, 0, 0, 2, 0, 0, 1, 3
"d:\IDEWORK\lvmen\src\licensedcode\data\rules\false-positive_3359.yml", "YAML", 0, 0, 0, 2, 0, 0, 1, 3
"d:\IDEWORK\lvmen\src\licensedcode\data\rules\false-positive_336.yml", "YAML", 0, 0, 0, 3, 0, 0, 1, 4
"d:\IDEWORK\lvmen\src\licensedcode\data\rules\false-positive_3360.yml", "YAML", 0, 0, 0, 2, 0, 0, 1, 3
"d:\IDEWORK\lvmen\src\licensedcode\data\rules\false-positive_3361.yml", "YAML", 0, 0, 0, 2, 0, 0, 1, 3
"d:\IDEWORK\lvmen\src\licensedcode\data\rules\false-positive_3362.yml", "YAML", 0, 0, 0, 2, 0, 0, 1, 3
"d:\IDEWORK\lvmen\src\licensedcode\data\rules\false-positive_3363.yml", "YAML", 0, 0, 0, 2, 0, 0, 1, 3
"d:\IDEWORK\lvmen\src\licensedcode\data\rules\false-positive_3364.yml", "YAML", 0, 0, 0, 2, 0, 0, 1, 3
"d:\IDEWORK\lvmen\src\licensedcode\data\rules\false-positive_3365.yml", "YAML", 0, 0, 0, 2, 0, 0, 1, 3
"d:\IDEWORK\lvmen\src\licensedcode\data\rules\false-positive_3366.yml", "YAML", 0, 0, 0, 2, 0, 0, 1, 3
"d:\IDEWORK\lvmen\src\licensedcode\data\rules\false-positive_3367.yml", "YAML", 0, 0, 0, 2, 0, 0, 1, 3
"d:\IDEWORK\lvmen\src\licensedcode\data\rules\false-positive_3368.yml", "YAML", 0, 0, 0, 2, 0, 0, 1, 3
"d:\IDEWORK\lvmen\src\licensedcode\data\rules\false-positive_3369.yml", "YAML", 0, 0, 0, 2, 0, 0, 1, 3
"d:\IDEWORK\lvmen\src\licensedcode\data\rules\false-positive_337.yml", "YAML", 0, 0, 0, 2, 0, 0, 1, 3
"d:\IDEWORK\lvmen\src\licensedcode\data\rules\false-positive_3370.yml", "YAML", 0, 0, 0, 2, 0, 0, 1, 3
"d:\IDEWORK\lvmen\src\licensedcode\data\rules\false-positive_3371.yml", "YAML", 0, 0, 0, 2, 0, 0, 1, 3
"d:\IDEWORK\lvmen\src\licensedcode\data\rules\false-positive_3372.yml", "YAML", 0, 0, 0, 2, 0, 0, 1, 3
"d:\IDEWORK\lvmen\src\licensedcode\data\rules\false-positive_3373.yml", "YAML", 0, 0, 0, 2, 0, 0, 1, 3
"d:\IDEWORK\lvmen\src\licensedcode\data\rules\false-positive_3374.yml", "YAML", 0, 0, 0, 2, 0, 0, 1, 3
"d:\IDEWORK\lvmen\src\licensedcode\data\rules\false-positive_3375.yml", "YAML", 0, 0, 0, 2, 0, 0, 1, 3
"d:\IDEWORK\lvmen\src\licensedcode\data\rules\false-positive_3376.yml", "YAML", 0, 0, 0, 2, 0, 0, 1, 3
"d:\IDEWORK\lvmen\src\licensedcode\data\rules\false-positive_3377.yml", "YAML", 0, 0, 0, 2, 0, 0, 1, 3
"d:\IDEWORK\lvmen\src\licensedcode\data\rules\false-positive_3378.yml", "YAML", 0, 0, 0, 2, 0, 0, 1, 3
"d:\IDEWORK\lvmen\src\licensedcode\data\rules\false-positive_3379.yml", "YAML", 0, 0, 0, 2, 0, 0, 1, 3
"d:\IDEWORK\lvmen\src\licensedcode\data\rules\false-positive_338.yml", "YAML", 0, 0, 0, 2, 0, 0, 1, 3
"d:\IDEWORK\lvmen\src\licensedcode\data\rules\false-positive_3380.yml", "YAML", 0, 0, 0, 2, 0, 0, 1, 3
"d:\IDEWORK\lvmen\src\licensedcode\data\rules\false-positive_3381.yml", "YAML", 0, 0, 0, 2, 0, 0, 1, 3
"d:\IDEWORK\lvmen\src\licensedcode\data\rules\false-positive_3382.yml", "YAML", 0, 0, 0, 2, 0, 0, 1, 3
"d:\IDEWORK\lvmen\src\licensedcode\data\rules\false-positive_3383.yml", "YAML", 0, 0, 0, 2, 0, 0, 1, 3
"d:\IDEWORK\lvmen\src\licensedcode\data\rules\false-positive_3384.yml", "YAML", 0, 0, 0, 2, 0, 0, 1, 3
"d:\IDEWORK\lvmen\src\licensedcode\data\rules\false-positive_3385.yml", "YAML", 0, 0, 0, 2, 0, 0, 1, 3
"d:\IDEWORK\lvmen\src\licensedcode\data\rules\false-positive_3386.yml", "YAML", 0, 0, 0, 2, 0, 0, 1, 3
"d:\IDEWORK\lvmen\src\licensedcode\data\rules\false-positive_3387.yml", "YAML", 0, 0, 0, 2, 0, 0, 1, 3
"d:\IDEWORK\lvmen\src\licensedcode\data\rules\false-positive_3388.yml", "YAML", 0, 0, 0, 2, 0, 0, 1, 3
"d:\IDEWORK\lvmen\src\licensedcode\data\rules\false-positive_3389.yml", "YAML", 0, 0, 0, 2, 0, 0, 1, 3
"d:\IDEWORK\lvmen\src\licensedcode\data\rules\false-positive_339.yml", "YAML", 0, 0, 0, 2, 0, 0, 1, 3
"d:\IDEWORK\lvmen\src\licensedcode\data\rules\false-positive_3390.yml", "YAML", 0, 0, 0, 2, 0, 0, 1, 3
"d:\IDEWORK\lvmen\src\licensedcode\data\rules\false-positive_3391.yml", "YAML", 0, 0, 0, 2, 0, 0, 1, 3
"d:\IDEWORK\lvmen\src\licensedcode\data\rules\false-positive_3392.yml", "YAML", 0, 0, 0, 2, 0, 0, 1, 3
"d:\IDEWORK\lvmen\src\licensedcode\data\rules\false-positive_3393.yml", "YAML", 0, 0, 0, 2, 0, 0, 1, 3
"d:\IDEWORK\lvmen\src\licensedcode\data\rules\false-positive_3394.yml", "YAML", 0, 0, 0, 2, 0, 0, 1, 3
"d:\IDEWORK\lvmen\src\licensedcode\data\rules\false-positive_3395.yml", "YAML", 0, 0, 0, 2, 0, 0, 1, 3
"d:\IDEWORK\lvmen\src\licensedcode\data\rules\false-positive_3396.yml", "YAML", 0, 0, 0, 2, 0, 0, 1, 3
"d:\IDEWORK\lvmen\src\licensedcode\data\rules\false-positive_3397.yml", "YAML", 0, 0, 0, 2, 0, 0, 1, 3
"d:\IDEWORK\lvmen\src\licensedcode\data\rules\false-positive_3398.yml", "YAML", 0, 0, 0, 2, 0, 0, 1, 3
"d:\IDEWORK\lvmen\src\licensedcode\data\rules\false-positive_3399.yml", "YAML", 0, 0, 0, 2, 0, 0, 1, 3
"d:\IDEWORK\lvmen\src\licensedcode\data\rules\false-positive_34.yml", "YAML", 0, 0, 0, 2, 0, 0, 1, 3
"d:\IDEWORK\lvmen\src\licensedcode\data\rules\false-positive_340.yml", "YAML", 0, 0, 0, 2, 0, 0, 1, 3
"d:\IDEWORK\lvmen\src\licensedcode\data\rules\false-positive_3400.yml", "YAML", 0, 0, 0, 2, 0, 0, 1, 3
"d:\IDEWORK\lvmen\src\licensedcode\data\rules\false-positive_3401.yml", "YAML", 0, 0, 0, 2, 0, 0, 1, 3
"d:\IDEWORK\lvmen\src\licensedcode\data\rules\false-positive_3402.yml", "YAML", 0, 0, 0, 2, 0, 0, 1, 3
"d:\IDEWORK\lvmen\src\licensedcode\data\rules\false-positive_3403.yml", "YAML", 0, 0, 0, 2, 0, 0, 1, 3
"d:\IDEWORK\lvmen\src\licensedcode\data\rules\false-positive_3404.yml", "YAML", 0, 0, 0, 2, 0, 0, 1, 3
"d:\IDEWORK\lvmen\src\licensedcode\data\rules\false-positive_3405.yml", "YAML", 0, 0, 0, 2, 0, 0, 1, 3
"d:\IDEWORK\lvmen\src\licensedcode\data\rules\false-positive_3406.yml", "YAML", 0, 0, 0, 2, 0, 0, 1, 3
"d:\IDEWORK\lvmen\src\licensedcode\data\rules\false-positive_3407.yml", "YAML", 0, 0, 0, 2, 0, 0, 1, 3
"d:\IDEWORK\lvmen\src\licensedcode\data\rules\false-positive_3408.yml", "YAML", 0, 0, 0, 2, 0, 0, 1, 3
"d:\IDEWORK\lvmen\src\licensedcode\data\rules\false-positive_3409.yml", "YAML", 0, 0, 0, 2, 0, 0, 1, 3
"d:\IDEWORK\lvmen\src\licensedcode\data\rules\false-positive_341.yml", "YAML", 0, 0, 0, 3, 0, 0, 1, 4
"d:\IDEWORK\lvmen\src\licensedcode\data\rules\false-positive_3410.yml", "YAML", 0, 0, 0, 2, 0, 0, 1, 3
"d:\IDEWORK\lvmen\src\licensedcode\data\rules\false-positive_3411.yml", "YAML", 0, 0, 0, 2, 0, 0, 1, 3
"d:\IDEWORK\lvmen\src\licensedcode\data\rules\false-positive_3412.yml", "YAML", 0, 0, 0, 2, 0, 0, 1, 3
"d:\IDEWORK\lvmen\src\licensedcode\data\rules\false-positive_3413.yml", "YAML", 0, 0, 0, 2, 0, 0, 1, 3
"d:\IDEWORK\lvmen\src\licensedcode\data\rules\false-positive_3414.yml", "YAML", 0, 0, 0, 2, 0, 0, 1, 3
"d:\IDEWORK\lvmen\src\licensedcode\data\rules\false-positive_3415.yml", "YAML", 0, 0, 0, 2, 0, 0, 1, 3
"d:\IDEWORK\lvmen\src\licensedcode\data\rules\false-positive_3416.yml", "YAML", 0, 0, 0, 2, 0, 0, 1, 3
"d:\IDEWORK\lvmen\src\licensedcode\data\rules\false-positive_3417.yml", "YAML", 0, 0, 0, 2, 0, 0, 1, 3
"d:\IDEWORK\lvmen\src\licensedcode\data\rules\false-positive_3418.yml", "YAML", 0, 0, 0, 2, 0, 0, 1, 3
"d:\IDEWORK\lvmen\src\licensedcode\data\rules\false-positive_3419.yml", "YAML", 0, 0, 0, 2, 0, 0, 1, 3
"d:\IDEWORK\lvmen\src\licensedcode\data\rules\false-positive_342.yml", "YAML", 0, 0, 0, 3, 0, 0, 1, 4
"d:\IDEWORK\lvmen\src\licensedcode\data\rules\false-positive_3420.yml", "YAML", 0, 0, 0, 2, 0, 0, 1, 3
"d:\IDEWORK\lvmen\src\licensedcode\data\rules\false-positive_3421.yml", "YAML", 0, 0, 0, 2, 0, 0, 1, 3
"d:\IDEWORK\lvmen\src\licensedcode\data\rules\false-positive_3422.yml", "YAML", 0, 0, 0, 2, 0, 0, 1, 3
"d:\IDEWORK\lvmen\src\licensedcode\data\rules\false-positive_3423.yml", "YAML", 0, 0, 0, 2, 0, 0, 1, 3
"d:\IDEWORK\lvmen\src\licensedcode\data\rules\false-positive_3424.yml", "YAML", 0, 0, 0, 2, 0, 0, 1, 3
"d:\IDEWORK\lvmen\src\licensedcode\data\rules\false-positive_3425.yml", "YAML", 0, 0, 0, 2, 0, 0, 1, 3
"d:\IDEWORK\lvmen\src\licensedcode\data\rules\false-positive_3426.yml", "YAML", 0, 0, 0, 2, 0, 0, 1, 3
"d:\IDEWORK\lvmen\src\licensedcode\data\rules\false-positive_3427.yml", "YAML", 0, 0, 0, 2, 0, 0, 1, 3
"d:\IDEWORK\lvmen\src\licensedcode\data\rules\false-positive_3428.yml", "YAML", 0, 0, 0, 2, 0, 0, 1, 3
"d:\IDEWORK\lvmen\src\licensedcode\data\rules\false-positive_3429.yml", "YAML", 0, 0, 0, 2, 0, 0, 1, 3
"d:\IDEWORK\lvmen\src\licensedcode\data\rules\false-positive_343.yml", "YAML", 0, 0, 0, 3, 0, 0, 1, 4
"d:\IDEWORK\lvmen\src\licensedcode\data\rules\false-positive_3430.yml", "YAML", 0, 0, 0, 2, 0, 0, 1, 3
"d:\IDEWORK\lvmen\src\licensedcode\data\rules\false-positive_3431.yml", "YAML", 0, 0, 0, 2, 0, 0, 1, 3
"d:\IDEWORK\lvmen\src\licensedcode\data\rules\false-positive_3432.yml", "YAML", 0, 0, 0, 2, 0, 0, 1, 3
"d:\IDEWORK\lvmen\src\licensedcode\data\rules\false-positive_3433.yml", "YAML", 0, 0, 0, 2, 0, 0, 1, 3
"d:\IDEWORK\lvmen\src\licensedcode\data\rules\false-positive_3434.yml", "YAML", 0, 0, 0, 2, 0, 0, 1, 3
"d:\IDEWORK\lvmen\src\licensedcode\data\rules\false-positive_3435.yml", "YAML", 0, 0, 0, 2, 0, 0, 1, 3
"d:\IDEWORK\lvmen\src\licensedcode\data\rules\false-positive_3436.yml", "YAML", 0, 0, 0, 2, 0, 0, 1, 3
"d:\IDEWORK\lvmen\src\licensedcode\data\rules\false-positive_3437.yml", "YAML", 0, 0, 0, 2, 0, 0, 1, 3
"d:\IDEWORK\lvmen\src\licensedcode\data\rules\false-positive_3438.yml", "YAML", 0, 0, 0, 2, 0, 0, 1, 3
"d:\IDEWORK\lvmen\src\licensedcode\data\rules\false-positive_3439.yml", "YAML", 0, 0, 0, 2, 0, 0, 1, 3
"d:\IDEWORK\lvmen\src\licensedcode\data\rules\false-positive_344.yml", "YAML", 0, 0, 0, 3, 0, 0, 1, 4
"d:\IDEWORK\lvmen\src\licensedcode\data\rules\false-positive_3440.yml", "YAML", 0, 0, 0, 2, 0, 0, 1, 3
"d:\IDEWORK\lvmen\src\licensedcode\data\rules\false-positive_3441.yml", "YAML", 0, 0, 0, 2, 0, 0, 1, 3
"d:\IDEWORK\lvmen\src\licensedcode\data\rules\false-positive_3442.yml", "YAML", 0, 0, 0, 2, 0, 0, 1, 3
"d:\IDEWORK\lvmen\src\licensedcode\data\rules\false-positive_3443.yml", "YAML", 0, 0, 0, 2, 0, 0, 1, 3
"d:\IDEWORK\lvmen\src\licensedcode\data\rules\false-positive_3444.yml", "YAML", 0, 0, 0, 2, 0, 0, 1, 3
"d:\IDEWORK\lvmen\src\licensedcode\data\rules\false-positive_3445.yml", "YAML", 0, 0, 0, 2, 0, 0, 1, 3
"d:\IDEWORK\lvmen\src\licensedcode\data\rules\false-positive_3446.yml", "YAML", 0, 0, 0, 2, 0, 0, 1, 3
"d:\IDEWORK\lvmen\src\licensedcode\data\rules\false-positive_3447.yml", "YAML", 0, 0, 0, 2, 0, 0, 1, 3
"d:\IDEWORK\lvmen\src\licensedcode\data\rules\false-positive_3448.yml", "YAML", 0, 0, 0, 2, 0, 0, 1, 3
"d:\IDEWORK\lvmen\src\licensedcode\data\rules\false-positive_3449.yml", "YAML", 0, 0, 0, 2, 0, 0, 1, 3
"d:\IDEWORK\lvmen\src\licensedcode\data\rules\false-positive_345.yml", "YAML", 0, 0, 0, 3, 0, 0, 1, 4
"d:\IDEWORK\lvmen\src\licensedcode\data\rules\false-positive_3450.yml", "YAML", 0, 0, 0, 2, 0, 0, 1, 3
"d:\IDEWORK\lvmen\src\licensedcode\data\rules\false-positive_3451.yml", "YAML", 0, 0, 0, 2, 0, 0, 1, 3
"d:\IDEWORK\lvmen\src\licensedcode\data\rules\false-positive_3452.yml", "YAML", 0, 0, 0, 2, 0, 0, 1, 3
"d:\IDEWORK\lvmen\src\licensedcode\data\rules\false-positive_3453.yml", "YAML", 0, 0, 0, 2, 0, 0, 1, 3
"d:\IDEWORK\lvmen\src\licensedcode\data\rules\false-positive_3454.yml", "YAML", 0, 0, 0, 2, 0, 0, 1, 3
"d:\IDEWORK\lvmen\src\licensedcode\data\rules\false-positive_3455.yml", "YAML", 0, 0, 0, 2, 0, 0, 1, 3
"d:\IDEWORK\lvmen\src\licensedcode\data\rules\false-positive_3456.yml", "YAML", 0, 0, 0, 2, 0, 0, 1, 3
"d:\IDEWORK\lvmen\src\licensedcode\data\rules\false-positive_3457.yml", "YAML", 0, 0, 0, 2, 0, 0, 1, 3
"d:\IDEWORK\lvmen\src\licensedcode\data\rules\false-positive_3458.yml", "YAML", 0, 0, 0, 2, 0, 0, 1, 3
"d:\IDEWORK\lvmen\src\licensedcode\data\rules\false-positive_3459.yml", "YAML", 0, 0, 0, 2, 0, 0, 1, 3
"d:\IDEWORK\lvmen\src\licensedcode\data\rules\false-positive_346.yml", "YAML", 0, 0, 0, 2, 0, 0, 1, 3
"d:\IDEWORK\lvmen\src\licensedcode\data\rules\false-positive_3460.yml", "YAML", 0, 0, 0, 2, 0, 0, 1, 3
"d:\IDEWORK\lvmen\src\licensedcode\data\rules\false-positive_3461.yml", "YAML", 0, 0, 0, 2, 0, 0, 1, 3
"d:\IDEWORK\lvmen\src\licensedcode\data\rules\false-positive_3462.yml", "YAML", 0, 0, 0, 2, 0, 0, 1, 3
"d:\IDEWORK\lvmen\src\licensedcode\data\rules\false-positive_3463.yml", "YAML", 0, 0, 0, 2, 0, 0, 1, 3
"d:\IDEWORK\lvmen\src\licensedcode\data\rules\false-positive_3464.yml", "YAML", 0, 0, 0, 2, 0, 0, 1, 3
"d:\IDEWORK\lvmen\src\licensedcode\data\rules\false-positive_3465.yml", "YAML", 0, 0, 0, 2, 0, 0, 1, 3
"d:\IDEWORK\lvmen\src\licensedcode\data\rules\false-positive_3466.yml", "YAML", 0, 0, 0, 2, 0, 0, 1, 3
"d:\IDEWORK\lvmen\src\licensedcode\data\rules\false-positive_3467.yml", "YAML", 0, 0, 0, 2, 0, 0, 1, 3
"d:\IDEWORK\lvmen\src\licensedcode\data\rules\false-positive_3468.yml", "YAML", 0, 0, 0, 2, 0, 0, 1, 3
"d:\IDEWORK\lvmen\src\licensedcode\data\rules\false-positive_3469.yml", "YAML", 0, 0, 0, 2, 0, 0, 1, 3
"d:\IDEWORK\lvmen\src\licensedcode\data\rules\false-positive_347.yml", "YAML", 0, 0, 0, 2, 0, 0, 1, 3
"d:\IDEWORK\lvmen\src\licensedcode\data\rules\false-positive_3470.yml", "YAML", 0, 0, 0, 2, 0, 0, 1, 3
"d:\IDEWORK\lvmen\src\licensedcode\data\rules\false-positive_3471.yml", "YAML", 0, 0, 0, 2, 0, 0, 1, 3
"d:\IDEWORK\lvmen\src\licensedcode\data\rules\false-positive_3472.yml", "YAML", 0, 0, 0, 2, 0, 0, 1, 3
"d:\IDEWORK\lvmen\src\licensedcode\data\rules\false-positive_3473.yml", "YAML", 0, 0, 0, 2, 0, 0, 1, 3
"d:\IDEWORK\lvmen\src\licensedcode\data\rules\false-positive_3474.yml", "YAML", 0, 0, 0, 2, 0, 0, 1, 3
"d:\IDEWORK\lvmen\src\licensedcode\data\rules\false-positive_3475.yml", "YAML", 0, 0, 0, 2, 0, 0, 1, 3
"d:\IDEWORK\lvmen\src\licensedcode\data\rules\false-positive_3476.yml", "YAML", 0, 0, 0, 2, 0, 0, 1, 3
"d:\IDEWORK\lvmen\src\licensedcode\data\rules\false-positive_3477.yml", "YAML", 0, 0, 0, 2, 0, 0, 1, 3
"d:\IDEWORK\lvmen\src\licensedcode\data\rules\false-positive_3478.yml", "YAML", 0, 0, 0, 2, 0, 0, 1, 3
"d:\IDEWORK\lvmen\src\licensedcode\data\rules\false-positive_3479.yml", "YAML", 0, 0, 0, 2, 0, 0, 1, 3
"d:\IDEWORK\lvmen\src\licensedcode\data\rules\false-positive_348.yml", "YAML", 0, 0, 0, 2, 0, 0, 1, 3
"d:\IDEWORK\lvmen\src\licensedcode\data\rules\false-positive_3480.yml", "YAML", 0, 0, 0, 2, 0, 0, 1, 3
"d:\IDEWORK\lvmen\src\licensedcode\data\rules\false-positive_3481.yml", "YAML", 0, 0, 0, 2, 0, 0, 1, 3
"d:\IDEWORK\lvmen\src\licensedcode\data\rules\false-positive_3482.yml", "YAML", 0, 0, 0, 2, 0, 0, 1, 3
"d:\IDEWORK\lvmen\src\licensedcode\data\rules\false-positive_3483.yml", "YAML", 0, 0, 0, 2, 0, 0, 1, 3
"d:\IDEWORK\lvmen\src\licensedcode\data\rules\false-positive_3484.yml", "YAML", 0, 0, 0, 2, 0, 0, 1, 3
"d:\IDEWORK\lvmen\src\licensedcode\data\rules\false-positive_3485.yml", "YAML", 0, 0, 0, 2, 0, 0, 1, 3
"d:\IDEWORK\lvmen\src\licensedcode\data\rules\false-positive_3486.yml", "YAML", 0, 0, 0, 2, 0, 0, 1, 3
"d:\IDEWORK\lvmen\src\licensedcode\data\rules\false-positive_3487.yml", "YAML", 0, 0, 0, 2, 0, 0, 1, 3
"d:\IDEWORK\lvmen\src\licensedcode\data\rules\false-positive_3488.yml", "YAML", 0, 0, 0, 2, 0, 0, 1, 3
"d:\IDEWORK\lvmen\src\licensedcode\data\rules\false-positive_3489.yml", "YAML", 0, 0, 0, 2, 0, 0, 1, 3
"d:\IDEWORK\lvmen\src\licensedcode\data\rules\false-positive_349.yml", "YAML", 0, 0, 0, 2, 0, 0, 1, 3
"d:\IDEWORK\lvmen\src\licensedcode\data\rules\false-positive_3490.yml", "YAML", 0, 0, 0, 2, 0, 0, 1, 3
"d:\IDEWORK\lvmen\src\licensedcode\data\rules\false-positive_3491.yml", "YAML", 0, 0, 0, 2, 0, 0, 1, 3
"d:\IDEWORK\lvmen\src\licensedcode\data\rules\false-positive_3492.yml", "YAML", 0, 0, 0, 2, 0, 0, 1, 3
"d:\IDEWORK\lvmen\src\licensedcode\data\rules\false-positive_3493.yml", "YAML", 0, 0, 0, 2, 0, 0, 1, 3
"d:\IDEWORK\lvmen\src\licensedcode\data\rules\false-positive_3494.yml", "YAML", 0, 0, 0, 2, 0, 0, 1, 3
"d:\IDEWORK\lvmen\src\licensedcode\data\rules\false-positive_3495.yml", "YAML", 0, 0, 0, 2, 0, 0, 1, 3
"d:\IDEWORK\lvmen\src\licensedcode\data\rules\false-positive_3496.yml", "YAML", 0, 0, 0, 2, 0, 0, 1, 3
"d:\IDEWORK\lvmen\src\licensedcode\data\rules\false-positive_3497.yml", "YAML", 0, 0, 0, 2, 0, 0, 1, 3
"d:\IDEWORK\lvmen\src\licensedcode\data\rules\false-positive_3498.yml", "YAML", 0, 0, 0, 2, 0, 0, 1, 3
"d:\IDEWORK\lvmen\src\licensedcode\data\rules\false-positive_3499.yml", "YAML", 0, 0, 0, 2, 0, 0, 1, 3
"d:\IDEWORK\lvmen\src\licensedcode\data\rules\false-positive_35.yml", "YAML", 0, 0, 0, 2, 0, 0, 1, 3
"d:\IDEWORK\lvmen\src\licensedcode\data\rules\false-positive_350.yml", "YAML", 0, 0, 0, 3, 0, 0, 1, 4
"d:\IDEWORK\lvmen\src\licensedcode\data\rules\false-positive_3500.yml", "YAML", 0, 0, 0, 2, 0, 0, 1, 3
"d:\IDEWORK\lvmen\src\licensedcode\data\rules\false-positive_3501.yml", "YAML", 0, 0, 0, 2, 0, 0, 1, 3
"d:\IDEWORK\lvmen\src\licensedcode\data\rules\false-positive_3502.yml", "YAML", 0, 0, 0, 2, 0, 0, 1, 3
"d:\IDEWORK\lvmen\src\licensedcode\data\rules\false-positive_3503.yml", "YAML", 0, 0, 0, 2, 0, 0, 1, 3
"d:\IDEWORK\lvmen\src\licensedcode\data\rules\false-positive_3504.yml", "YAML", 0, 0, 0, 2, 0, 0, 1, 3
"d:\IDEWORK\lvmen\src\licensedcode\data\rules\false-positive_3505.yml", "YAML", 0, 0, 0, 2, 0, 0, 1, 3
"d:\IDEWORK\lvmen\src\licensedcode\data\rules\false-positive_3506.yml", "YAML", 0, 0, 0, 2, 0, 0, 1, 3
"d:\IDEWORK\lvmen\src\licensedcode\data\rules\false-positive_3507.yml", "YAML", 0, 0, 0, 2, 0, 0, 1, 3
"d:\IDEWORK\lvmen\src\licensedcode\data\rules\false-positive_3508.yml", "YAML", 0, 0, 0, 2, 0, 0, 1, 3
"d:\IDEWORK\lvmen\src\licensedcode\data\rules\false-positive_3509.yml", "YAML", 0, 0, 0, 2, 0, 0, 1, 3
"d:\IDEWORK\lvmen\src\licensedcode\data\rules\false-positive_351.yml", "YAML", 0, 0, 0, 2, 0, 0, 1, 3
"d:\IDEWORK\lvmen\src\licensedcode\data\rules\false-positive_3510.yml", "YAML", 0, 0, 0, 2, 0, 0, 1, 3
"d:\IDEWORK\lvmen\src\licensedcode\data\rules\false-positive_3511.yml", "YAML", 0, 0, 0, 2, 0, 0, 1, 3
"d:\IDEWORK\lvmen\src\licensedcode\data\rules\false-positive_3512.yml", "YAML", 0, 0, 0, 2, 0, 0, 1, 3
"d:\IDEWORK\lvmen\src\licensedcode\data\rules\false-positive_3513.yml", "YAML", 0, 0, 0, 2, 0, 0, 1, 3
"d:\IDEWORK\lvmen\src\licensedcode\data\rules\false-positive_3514.yml", "YAML", 0, 0, 0, 2, 0, 0, 1, 3
"d:\IDEWORK\lvmen\src\licensedcode\data\rules\false-positive_3515.yml", "YAML", 0, 0, 0, 2, 0, 0, 1, 3
"d:\IDEWORK\lvmen\src\licensedcode\data\rules\false-positive_3516.yml", "YAML", 0, 0, 0, 2, 0, 0, 1, 3
"d:\IDEWORK\lvmen\src\licensedcode\data\rules\false-positive_3517.yml", "YAML", 0, 0, 0, 2, 0, 0, 1, 3
"d:\IDEWORK\lvmen\src\licensedcode\data\rules\false-positive_3518.yml", "YAML", 0, 0, 0, 2, 0, 0, 1, 3
"d:\IDEWORK\lvmen\src\licensedcode\data\rules\false-positive_3519.yml", "YAML", 0, 0, 0, 2, 0, 0, 1, 3
"d:\IDEWORK\lvmen\src\licensedcode\data\rules\false-positive_352.yml", "YAML", 0, 0, 0, 3, 0, 0, 1, 4
"d:\IDEWORK\lvmen\src\licensedcode\data\rules\false-positive_3520.yml", "YAML", 0, 0, 0, 2, 0, 0, 1, 3
"d:\IDEWORK\lvmen\src\licensedcode\data\rules\false-positive_3521.yml", "YAML", 0, 0, 0, 2, 0, 0, 1, 3
"d:\IDEWORK\lvmen\src\licensedcode\data\rules\false-positive_3522.yml", "YAML", 0, 0, 0, 2, 0, 0, 1, 3
"d:\IDEWORK\lvmen\src\licensedcode\data\rules\false-positive_3523.yml", "YAML", 0, 0, 0, 2, 0, 0, 1, 3
"d:\IDEWORK\lvmen\src\licensedcode\data\rules\false-positive_3524.yml", "YAML", 0, 0, 0, 2, 0, 0, 1, 3
"d:\IDEWORK\lvmen\src\licensedcode\data\rules\false-positive_3525.yml", "YAML", 0, 0, 0, 2, 0, 0, 1, 3
"d:\IDEWORK\lvmen\src\licensedcode\data\rules\false-positive_3526.yml", "YAML", 0, 0, 0, 2, 0, 0, 1, 3
"d:\IDEWORK\lvmen\src\licensedcode\data\rules\false-positive_3527.yml", "YAML", 0, 0, 0, 2, 0, 0, 1, 3
"d:\IDEWORK\lvmen\src\licensedcode\data\rules\false-positive_3528.yml", "YAML", 0, 0, 0, 2, 0, 0, 1, 3
"d:\IDEWORK\lvmen\src\licensedcode\data\rules\false-positive_3529.yml", "YAML", 0, 0, 0, 2, 0, 0, 1, 3
"d:\IDEWORK\lvmen\src\licensedcode\data\rules\false-positive_353.yml", "YAML", 0, 0, 0, 2, 0, 0, 1, 3
"d:\IDEWORK\lvmen\src\licensedcode\data\rules\false-positive_3530.yml", "YAML", 0, 0, 0, 2, 0, 0, 1, 3
"d:\IDEWORK\lvmen\src\licensedcode\data\rules\false-positive_3531.yml", "YAML", 0, 0, 0, 2, 0, 0, 1, 3
"d:\IDEWORK\lvmen\src\licensedcode\data\rules\false-positive_3532.yml", "YAML", 0, 0, 0, 2, 0, 0, 1, 3
"d:\IDEWORK\lvmen\src\licensedcode\data\rules\false-positive_3533.yml", "YAML", 0, 0, 0, 2, 0, 0, 1, 3
"d:\IDEWORK\lvmen\src\licensedcode\data\rules\false-positive_3534.yml", "YAML", 0, 0, 0, 2, 0, 0, 1, 3
"d:\IDEWORK\lvmen\src\licensedcode\data\rules\false-positive_3535.yml", "YAML", 0, 0, 0, 2, 0, 0, 1, 3
"d:\IDEWORK\lvmen\src\licensedcode\data\rules\false-positive_3536.yml", "YAML", 0, 0, 0, 2, 0, 0, 1, 3
"d:\IDEWORK\lvmen\src\licensedcode\data\rules\false-positive_3537.yml", "YAML", 0, 0, 0, 2, 0, 0, 1, 3
"d:\IDEWORK\lvmen\src\licensedcode\data\rules\false-positive_3538.yml", "YAML", 0, 0, 0, 2, 0, 0, 1, 3
"d:\IDEWORK\lvmen\src\licensedcode\data\rules\false-positive_3539.yml", "YAML", 0, 0, 0, 2, 0, 0, 1, 3
"d:\IDEWORK\lvmen\src\licensedcode\data\rules\false-positive_354.yml", "YAML", 0, 0, 0, 3, 0, 0, 1, 4
"d:\IDEWORK\lvmen\src\licensedcode\data\rules\false-positive_3540.yml", "YAML", 0, 0, 0, 2, 0, 0, 1, 3
"d:\IDEWORK\lvmen\src\licensedcode\data\rules\false-positive_3541.yml", "YAML", 0, 0, 0, 2, 0, 0, 1, 3
"d:\IDEWORK\lvmen\src\licensedcode\data\rules\false-positive_3542.yml", "YAML", 0, 0, 0, 2, 0, 0, 1, 3
"d:\IDEWORK\lvmen\src\licensedcode\data\rules\false-positive_3543.yml", "YAML", 0, 0, 0, 2, 0, 0, 1, 3
"d:\IDEWORK\lvmen\src\licensedcode\data\rules\false-positive_3544.yml", "YAML", 0, 0, 0, 2, 0, 0, 1, 3
"d:\IDEWORK\lvmen\src\licensedcode\data\rules\false-positive_3545.yml", "YAML", 0, 0, 0, 2, 0, 0, 1, 3
"d:\IDEWORK\lvmen\src\licensedcode\data\rules\false-positive_3546.yml", "YAML", 0, 0, 0, 2, 0, 0, 1, 3
"d:\IDEWORK\lvmen\src\licensedcode\data\rules\false-positive_3547.yml", "YAML", 0, 0, 0, 2, 0, 0, 1, 3
"d:\IDEWORK\lvmen\src\licensedcode\data\rules\false-positive_3548.yml", "YAML", 0, 0, 0, 2, 0, 0, 1, 3
"d:\IDEWORK\lvmen\src\licensedcode\data\rules\false-positive_3549.yml", "YAML", 0, 0, 0, 2, 0, 0, 1, 3
"d:\IDEWORK\lvmen\src\licensedcode\data\rules\false-positive_355.yml", "YAML", 0, 0, 0, 2, 0, 0, 1, 3
"d:\IDEWORK\lvmen\src\licensedcode\data\rules\false-positive_3550.yml", "YAML", 0, 0, 0, 2, 0, 0, 1, 3
"d:\IDEWORK\lvmen\src\licensedcode\data\rules\false-positive_3551.yml", "YAML", 0, 0, 0, 2, 0, 0, 1, 3
"d:\IDEWORK\lvmen\src\licensedcode\data\rules\false-positive_3552.yml", "YAML", 0, 0, 0, 2, 0, 0, 1, 3
"d:\IDEWORK\lvmen\src\licensedcode\data\rules\false-positive_3553.yml", "YAML", 0, 0, 0, 2, 0, 0, 1, 3
"d:\IDEWORK\lvmen\src\licensedcode\data\rules\false-positive_3554.yml", "YAML", 0, 0, 0, 2, 0, 0, 1, 3
"d:\IDEWORK\lvmen\src\licensedcode\data\rules\false-positive_3555.yml", "YAML", 0, 0, 0, 2, 0, 0, 1, 3
"d:\IDEWORK\lvmen\src\licensedcode\data\rules\false-positive_3556.yml", "YAML", 0, 0, 0, 2, 0, 0, 1, 3
"d:\IDEWORK\lvmen\src\licensedcode\data\rules\false-positive_3557.yml", "YAML", 0, 0, 0, 2, 0, 0, 1, 3
"d:\IDEWORK\lvmen\src\licensedcode\data\rules\false-positive_3558.yml", "YAML", 0, 0, 0, 2, 0, 0, 1, 3
"d:\IDEWORK\lvmen\src\licensedcode\data\rules\false-positive_3559.yml", "YAML", 0, 0, 0, 2, 0, 0, 1, 3
"d:\IDEWORK\lvmen\src\licensedcode\data\rules\false-positive_356.yml", "YAML", 0, 0, 0, 2, 0, 0, 1, 3
"d:\IDEWORK\lvmen\src\licensedcode\data\rules\false-positive_3560.yml", "YAML", 0, 0, 0, 2, 0, 0, 1, 3
"d:\IDEWORK\lvmen\src\licensedcode\data\rules\false-positive_3561.yml", "YAML", 0, 0, 0, 2, 0, 0, 1, 3
"d:\IDEWORK\lvmen\src\licensedcode\data\rules\false-positive_3562.yml", "YAML", 0, 0, 0, 2, 0, 0, 1, 3
"d:\IDEWORK\lvmen\src\licensedcode\data\rules\false-positive_3563.yml", "YAML", 0, 0, 0, 2, 0, 0, 1, 3
"d:\IDEWORK\lvmen\src\licensedcode\data\rules\false-positive_3564.yml", "YAML", 0, 0, 0, 2, 0, 0, 1, 3
"d:\IDEWORK\lvmen\src\licensedcode\data\rules\false-positive_3565.yml", "YAML", 0, 0, 0, 2, 0, 0, 1, 3
"d:\IDEWORK\lvmen\src\licensedcode\data\rules\false-positive_3566.yml", "YAML", 0, 0, 0, 2, 0, 0, 1, 3
"d:\IDEWORK\lvmen\src\licensedcode\data\rules\false-positive_3567.yml", "YAML", 0, 0, 0, 2, 0, 0, 1, 3
"d:\IDEWORK\lvmen\src\licensedcode\data\rules\false-positive_3568.yml", "YAML", 0, 0, 0, 2, 0, 0, 1, 3
"d:\IDEWORK\lvmen\src\licensedcode\data\rules\false-positive_3569.yml", "YAML", 0, 0, 0, 2, 0, 0, 1, 3
"d:\IDEWORK\lvmen\src\licensedcode\data\rules\false-positive_357.yml", "YAML", 0, 0, 0, 2, 0, 0, 1, 3
"d:\IDEWORK\lvmen\src\licensedcode\data\rules\false-positive_3570.yml", "YAML", 0, 0, 0, 2, 0, 0, 1, 3
"d:\IDEWORK\lvmen\src\licensedcode\data\rules\false-positive_3571.yml", "YAML", 0, 0, 0, 2, 0, 0, 1, 3
"d:\IDEWORK\lvmen\src\licensedcode\data\rules\false-positive_3572.yml", "YAML", 0, 0, 0, 2, 0, 0, 1, 3
"d:\IDEWORK\lvmen\src\licensedcode\data\rules\false-positive_3573.yml", "YAML", 0, 0, 0, 2, 0, 0, 1, 3
"d:\IDEWORK\lvmen\src\licensedcode\data\rules\false-positive_3574.yml", "YAML", 0, 0, 0, 2, 0, 0, 1, 3
"d:\IDEWORK\lvmen\src\licensedcode\data\rules\false-positive_3575.yml", "YAML", 0, 0, 0, 2, 0, 0, 1, 3
"d:\IDEWORK\lvmen\src\licensedcode\data\rules\false-positive_3576.yml", "YAML", 0, 0, 0, 2, 0, 0, 1, 3
"d:\IDEWORK\lvmen\src\licensedcode\data\rules\false-positive_3577.yml", "YAML", 0, 0, 0, 2, 0, 0, 1, 3
"d:\IDEWORK\lvmen\src\licensedcode\data\rules\false-positive_3578.yml", "YAML", 0, 0, 0, 2, 0, 0, 1, 3
"d:\IDEWORK\lvmen\src\licensedcode\data\rules\false-positive_3579.yml", "YAML", 0, 0, 0, 2, 0, 0, 1, 3
"d:\IDEWORK\lvmen\src\licensedcode\data\rules\false-positive_358.yml", "YAML", 0, 0, 0, 2, 0, 0, 1, 3
"d:\IDEWORK\lvmen\src\licensedcode\data\rules\false-positive_3580.yml", "YAML", 0, 0, 0, 2, 0, 0, 1, 3
"d:\IDEWORK\lvmen\src\licensedcode\data\rules\false-positive_3581.yml", "YAML", 0, 0, 0, 2, 0, 0, 1, 3
"d:\IDEWORK\lvmen\src\licensedcode\data\rules\false-positive_3582.yml", "YAML", 0, 0, 0, 2, 0, 0, 1, 3
"d:\IDEWORK\lvmen\src\licensedcode\data\rules\false-positive_3583.yml", "YAML", 0, 0, 0, 2, 0, 0, 1, 3
"d:\IDEWORK\lvmen\src\licensedcode\data\rules\false-positive_3584.yml", "YAML", 0, 0, 0, 2, 0, 0, 1, 3
"d:\IDEWORK\lvmen\src\licensedcode\data\rules\false-positive_3585.yml", "YAML", 0, 0, 0, 2, 0, 0, 1, 3
"d:\IDEWORK\lvmen\src\licensedcode\data\rules\false-positive_3586.yml", "YAML", 0, 0, 0, 2, 0, 0, 1, 3
"d:\IDEWORK\lvmen\src\licensedcode\data\rules\false-positive_3587.yml", "YAML", 0, 0, 0, 2, 0, 0, 1, 3
"d:\IDEWORK\lvmen\src\licensedcode\data\rules\false-positive_3588.yml", "YAML", 0, 0, 0, 2, 0, 0, 1, 3
"d:\IDEWORK\lvmen\src\licensedcode\data\rules\false-positive_3589.yml", "YAML", 0, 0, 0, 2, 0, 0, 1, 3
"d:\IDEWORK\lvmen\src\licensedcode\data\rules\false-positive_359.yml", "YAML", 0, 0, 0, 3, 0, 0, 1, 4
"d:\IDEWORK\lvmen\src\licensedcode\data\rules\false-positive_3590.yml", "YAML", 0, 0, 0, 2, 0, 0, 1, 3
"d:\IDEWORK\lvmen\src\licensedcode\data\rules\false-positive_3591.yml", "YAML", 0, 0, 0, 2, 0, 0, 1, 3
"d:\IDEWORK\lvmen\src\licensedcode\data\rules\false-positive_3592.yml", "YAML", 0, 0, 0, 2, 0, 0, 1, 3
"d:\IDEWORK\lvmen\src\licensedcode\data\rules\false-positive_3593.yml", "YAML", 0, 0, 0, 2, 0, 0, 1, 3
"d:\IDEWORK\lvmen\src\licensedcode\data\rules\false-positive_3594.yml", "YAML", 0, 0, 0, 2, 0, 0, 1, 3
"d:\IDEWORK\lvmen\src\licensedcode\data\rules\false-positive_3595.yml", "YAML", 0, 0, 0, 2, 0, 0, 1, 3
"d:\IDEWORK\lvmen\src\licensedcode\data\rules\false-positive_3596.yml", "YAML", 0, 0, 0, 2, 0, 0, 1, 3
"d:\IDEWORK\lvmen\src\licensedcode\data\rules\false-positive_3597.yml", "YAML", 0, 0, 0, 2, 0, 0, 1, 3
"d:\IDEWORK\lvmen\src\licensedcode\data\rules\false-positive_3598.yml", "YAML", 0, 0, 0, 2, 0, 0, 1, 3
"d:\IDEWORK\lvmen\src\licensedcode\data\rules\false-positive_3599.yml", "YAML", 0, 0, 0, 2, 0, 0, 1, 3
"d:\IDEWORK\lvmen\src\licensedcode\data\rules\false-positive_36.yml", "YAML", 0, 0, 0, 3, 0, 0, 1, 4
"d:\IDEWORK\lvmen\src\licensedcode\data\rules\false-positive_360.yml", "YAML", 0, 0, 0, 2, 0, 0, 1, 3
"d:\IDEWORK\lvmen\src\licensedcode\data\rules\false-positive_3600.yml", "YAML", 0, 0, 0, 2, 0, 0, 1, 3
"d:\IDEWORK\lvmen\src\licensedcode\data\rules\false-positive_3601.yml", "YAML", 0, 0, 0, 2, 0, 0, 1, 3
"d:\IDEWORK\lvmen\src\licensedcode\data\rules\false-positive_3602.yml", "YAML", 0, 0, 0, 2, 0, 0, 1, 3
"d:\IDEWORK\lvmen\src\licensedcode\data\rules\false-positive_3603.yml", "YAML", 0, 0, 0, 2, 0, 0, 1, 3
"d:\IDEWORK\lvmen\src\licensedcode\data\rules\false-positive_3604.yml", "YAML", 0, 0, 0, 2, 0, 0, 1, 3
"d:\IDEWORK\lvmen\src\licensedcode\data\rules\false-positive_3605.yml", "YAML", 0, 0, 0, 2, 0, 0, 1, 3
"d:\IDEWORK\lvmen\src\licensedcode\data\rules\false-positive_3606.yml", "YAML", 0, 0, 0, 2, 0, 0, 1, 3
"d:\IDEWORK\lvmen\src\licensedcode\data\rules\false-positive_3607.yml", "YAML", 0, 0, 0, 2, 0, 0, 1, 3
"d:\IDEWORK\lvmen\src\licensedcode\data\rules\false-positive_3608.yml", "YAML", 0, 0, 0, 2, 0, 0, 1, 3
"d:\IDEWORK\lvmen\src\licensedcode\data\rules\false-positive_3609.yml", "YAML", 0, 0, 0, 2, 0, 0, 1, 3
"d:\IDEWORK\lvmen\src\licensedcode\data\rules\false-positive_361.yml", "YAML", 0, 0, 0, 2, 0, 0, 1, 3
"d:\IDEWORK\lvmen\src\licensedcode\data\rules\false-positive_3610.yml", "YAML", 0, 0, 0, 2, 0, 0, 1, 3
"d:\IDEWORK\lvmen\src\licensedcode\data\rules\false-positive_3611.yml", "YAML", 0, 0, 0, 2, 0, 0, 1, 3
"d:\IDEWORK\lvmen\src\licensedcode\data\rules\false-positive_3612.yml", "YAML", 0, 0, 0, 2, 0, 0, 1, 3
"d:\IDEWORK\lvmen\src\licensedcode\data\rules\false-positive_3613.yml", "YAML", 0, 0, 0, 2, 0, 0, 1, 3
"d:\IDEWORK\lvmen\src\licensedcode\data\rules\false-positive_3614.yml", "YAML", 0, 0, 0, 2, 0, 0, 1, 3
"d:\IDEWORK\lvmen\src\licensedcode\data\rules\false-positive_3615.yml", "YAML", 0, 0, 0, 2, 0, 0, 1, 3
"d:\IDEWORK\lvmen\src\licensedcode\data\rules\false-positive_3616.yml", "YAML", 0, 0, 0, 2, 0, 0, 1, 3
"d:\IDEWORK\lvmen\src\licensedcode\data\rules\false-positive_3617.yml", "YAML", 0, 0, 0, 2, 0, 0, 1, 3
"d:\IDEWORK\lvmen\src\licensedcode\data\rules\false-positive_3618.yml", "YAML", 0, 0, 0, 2, 0, 0, 1, 3
"d:\IDEWORK\lvmen\src\licensedcode\data\rules\false-positive_3619.yml", "YAML", 0, 0, 0, 2, 0, 0, 1, 3
"d:\IDEWORK\lvmen\src\licensedcode\data\rules\false-positive_362.yml", "YAML", 0, 0, 0, 2, 0, 0, 1, 3
"d:\IDEWORK\lvmen\src\licensedcode\data\rules\false-positive_3620.yml", "YAML", 0, 0, 0, 2, 0, 0, 1, 3
"d:\IDEWORK\lvmen\src\licensedcode\data\rules\false-positive_3621.yml", "YAML", 0, 0, 0, 2, 0, 0, 1, 3
"d:\IDEWORK\lvmen\src\licensedcode\data\rules\false-positive_3622.yml", "YAML", 0, 0, 0, 2, 0, 0, 1, 3
"d:\IDEWORK\lvmen\src\licensedcode\data\rules\false-positive_3623.yml", "YAML", 0, 0, 0, 2, 0, 0, 1, 3
"d:\IDEWORK\lvmen\src\licensedcode\data\rules\false-positive_3624.yml", "YAML", 0, 0, 0, 2, 0, 0, 1, 3
"d:\IDEWORK\lvmen\src\licensedcode\data\rules\false-positive_3625.yml", "YAML", 0, 0, 0, 2, 0, 0, 1, 3
"d:\IDEWORK\lvmen\src\licensedcode\data\rules\false-positive_3626.yml", "YAML", 0, 0, 0, 2, 0, 0, 1, 3
"d:\IDEWORK\lvmen\src\licensedcode\data\rules\false-positive_3627.yml", "YAML", 0, 0, 0, 2, 0, 0, 1, 3
"d:\IDEWORK\lvmen\src\licensedcode\data\rules\false-positive_3628.yml", "YAML", 0, 0, 0, 2, 0, 0, 1, 3
"d:\IDEWORK\lvmen\src\licensedcode\data\rules\false-positive_3629.yml", "YAML", 0, 0, 0, 2, 0, 0, 1, 3
"d:\IDEWORK\lvmen\src\licensedcode\data\rules\false-positive_363.yml", "YAML", 0, 0, 0, 2, 0, 0, 1, 3
"d:\IDEWORK\lvmen\src\licensedcode\data\rules\false-positive_3630.yml", "YAML", 0, 0, 0, 2, 0, 0, 1, 3
"d:\IDEWORK\lvmen\src\licensedcode\data\rules\false-positive_3631.yml", "YAML", 0, 0, 0, 2, 0, 0, 1, 3
"d:\IDEWORK\lvmen\src\licensedcode\data\rules\false-positive_3632.yml", "YAML", 0, 0, 0, 2, 0, 0, 1, 3
"d:\IDEWORK\lvmen\src\licensedcode\data\rules\false-positive_3633.yml", "YAML", 0, 0, 0, 2, 0, 0, 1, 3
"d:\IDEWORK\lvmen\src\licensedcode\data\rules\false-positive_3634.yml", "YAML", 0, 0, 0, 2, 0, 0, 1, 3
"d:\IDEWORK\lvmen\src\licensedcode\data\rules\false-positive_3635.yml", "YAML", 0, 0, 0, 2, 0, 0, 1, 3
"d:\IDEWORK\lvmen\src\licensedcode\data\rules\false-positive_3636.yml", "YAML", 0, 0, 0, 2, 0, 0, 1, 3
"d:\IDEWORK\lvmen\src\licensedcode\data\rules\false-positive_3637.yml", "YAML", 0, 0, 0, 2, 0, 0, 1, 3
"d:\IDEWORK\lvmen\src\licensedcode\data\rules\false-positive_3638.yml", "YAML", 0, 0, 0, 2, 0, 0, 1, 3
"d:\IDEWORK\lvmen\src\licensedcode\data\rules\false-positive_3639.yml", "YAML", 0, 0, 0, 2, 0, 0, 1, 3
"d:\IDEWORK\lvmen\src\licensedcode\data\rules\false-positive_364.yml", "YAML", 0, 0, 0, 2, 0, 0, 1, 3
"d:\IDEWORK\lvmen\src\licensedcode\data\rules\false-positive_3640.yml", "YAML", 0, 0, 0, 2, 0, 0, 1, 3
"d:\IDEWORK\lvmen\src\licensedcode\data\rules\false-positive_3641.yml", "YAML", 0, 0, 0, 2, 0, 0, 1, 3
"d:\IDEWORK\lvmen\src\licensedcode\data\rules\false-positive_3642.yml", "YAML", 0, 0, 0, 2, 0, 0, 1, 3
"d:\IDEWORK\lvmen\src\licensedcode\data\rules\false-positive_3643.yml", "YAML", 0, 0, 0, 2, 0, 0, 1, 3
"d:\IDEWORK\lvmen\src\licensedcode\data\rules\false-positive_3644.yml", "YAML", 0, 0, 0, 2, 0, 0, 1, 3
"d:\IDEWORK\lvmen\src\licensedcode\data\rules\false-positive_3645.yml", "YAML", 0, 0, 0, 2, 0, 0, 1, 3
"d:\IDEWORK\lvmen\src\licensedcode\data\rules\false-positive_3646.yml", "YAML", 0, 0, 0, 2, 0, 0, 1, 3
"d:\IDEWORK\lvmen\src\licensedcode\data\rules\false-positive_3647.yml", "YAML", 0, 0, 0, 2, 0, 0, 1, 3
"d:\IDEWORK\lvmen\src\licensedcode\data\rules\false-positive_3648.yml", "YAML", 0, 0, 0, 2, 0, 0, 1, 3
"d:\IDEWORK\lvmen\src\licensedcode\data\rules\false-positive_3649.yml", "YAML", 0, 0, 0, 2, 0, 0, 1, 3
"d:\IDEWORK\lvmen\src\licensedcode\data\rules\false-positive_365.yml", "YAML", 0, 0, 0, 2, 0, 0, 1, 3
"d:\IDEWORK\lvmen\src\licensedcode\data\rules\false-positive_3650.yml", "YAML", 0, 0, 0, 2, 0, 0, 1, 3
"d:\IDEWORK\lvmen\src\licensedcode\data\rules\false-positive_3651.yml", "YAML", 0, 0, 0, 2, 0, 0, 1, 3
"d:\IDEWORK\lvmen\src\licensedcode\data\rules\false-positive_3652.yml", "YAML", 0, 0, 0, 2, 0, 0, 1, 3
"d:\IDEWORK\lvmen\src\licensedcode\data\rules\false-positive_3653.yml", "YAML", 0, 0, 0, 2, 0, 0, 1, 3
"d:\IDEWORK\lvmen\src\licensedcode\data\rules\false-positive_3654.yml", "YAML", 0, 0, 0, 2, 0, 0, 1, 3
"d:\IDEWORK\lvmen\src\licensedcode\data\rules\false-positive_3655.yml", "YAML", 0, 0, 0, 2, 0, 0, 1, 3
"d:\IDEWORK\lvmen\src\licensedcode\data\rules\false-positive_3656.yml", "YAML", 0, 0, 0, 2, 0, 0, 1, 3
"d:\IDEWORK\lvmen\src\licensedcode\data\rules\false-positive_3657.yml", "YAML", 0, 0, 0, 2, 0, 0, 1, 3
"d:\IDEWORK\lvmen\src\licensedcode\data\rules\false-positive_3658.yml", "YAML", 0, 0, 0, 2, 0, 0, 1, 3
"d:\IDEWORK\lvmen\src\licensedcode\data\rules\false-positive_3659.yml", "YAML", 0, 0, 0, 2, 0, 0, 1, 3
"d:\IDEWORK\lvmen\src\licensedcode\data\rules\false-positive_366.yml", "YAML", 0, 0, 0, 2, 0, 0, 1, 3
"d:\IDEWORK\lvmen\src\licensedcode\data\rules\false-positive_3660.yml", "YAML", 0, 0, 0, 2, 0, 0, 1, 3
"d:\IDEWORK\lvmen\src\licensedcode\data\rules\false-positive_3661.yml", "YAML", 0, 0, 0, 2, 0, 0, 1, 3
"d:\IDEWORK\lvmen\src\licensedcode\data\rules\false-positive_3662.yml", "YAML", 0, 0, 0, 2, 0, 0, 1, 3
"d:\IDEWORK\lvmen\src\licensedcode\data\rules\false-positive_3663.yml", "YAML", 0, 0, 0, 2, 0, 0, 1, 3
"d:\IDEWORK\lvmen\src\licensedcode\data\rules\false-positive_3664.yml", "YAML", 0, 0, 0, 2, 0, 0, 1, 3
"d:\IDEWORK\lvmen\src\licensedcode\data\rules\false-positive_3665.yml", "YAML", 0, 0, 0, 2, 0, 0, 1, 3
"d:\IDEWORK\lvmen\src\licensedcode\data\rules\false-positive_3666.yml", "YAML", 0, 0, 0, 2, 0, 0, 1, 3
"d:\IDEWORK\lvmen\src\licensedcode\data\rules\false-positive_3667.yml", "YAML", 0, 0, 0, 2, 0, 0, 1, 3
"d:\IDEWORK\lvmen\src\licensedcode\data\rules\false-positive_3668.yml", "YAML", 0, 0, 0, 2, 0, 0, 1, 3
"d:\IDEWORK\lvmen\src\licensedcode\data\rules\false-positive_3669.yml", "YAML", 0, 0, 0, 2, 0, 0, 1, 3
"d:\IDEWORK\lvmen\src\licensedcode\data\rules\false-positive_367.yml", "YAML", 0, 0, 0, 3, 0, 0, 1, 4
"d:\IDEWORK\lvmen\src\licensedcode\data\rules\false-positive_3670.yml", "YAML", 0, 0, 0, 2, 0, 0, 1, 3
"d:\IDEWORK\lvmen\src\licensedcode\data\rules\false-positive_3671.yml", "YAML", 0, 0, 0, 2, 0, 0, 1, 3
"d:\IDEWORK\lvmen\src\licensedcode\data\rules\false-positive_3672.yml", "YAML", 0, 0, 0, 2, 0, 0, 1, 3
"d:\IDEWORK\lvmen\src\licensedcode\data\rules\false-positive_3673.yml", "YAML", 0, 0, 0, 2, 0, 0, 1, 3
"d:\IDEWORK\lvmen\src\licensedcode\data\rules\false-positive_3674.yml", "YAML", 0, 0, 0, 2, 0, 0, 1, 3
"d:\IDEWORK\lvmen\src\licensedcode\data\rules\false-positive_3675.yml", "YAML", 0, 0, 0, 2, 0, 0, 1, 3
"d:\IDEWORK\lvmen\src\licensedcode\data\rules\false-positive_3676.yml", "YAML", 0, 0, 0, 2, 0, 0, 1, 3
"d:\IDEWORK\lvmen\src\licensedcode\data\rules\false-positive_3677.yml", "YAML", 0, 0, 0, 2, 0, 0, 1, 3
"d:\IDEWORK\lvmen\src\licensedcode\data\rules\false-positive_3678.yml", "YAML", 0, 0, 0, 2, 0, 0, 1, 3
"d:\IDEWORK\lvmen\src\licensedcode\data\rules\false-positive_3679.yml", "YAML", 0, 0, 0, 2, 0, 0, 1, 3
"d:\IDEWORK\lvmen\src\licensedcode\data\rules\false-positive_368.yml", "YAML", 0, 0, 0, 2, 0, 0, 1, 3
"d:\IDEWORK\lvmen\src\licensedcode\data\rules\false-positive_3680.yml", "YAML", 0, 0, 0, 2, 0, 0, 1, 3
"d:\IDEWORK\lvmen\src\licensedcode\data\rules\false-positive_3681.yml", "YAML", 0, 0, 0, 2, 0, 0, 1, 3
"d:\IDEWORK\lvmen\src\licensedcode\data\rules\false-positive_3682.yml", "YAML", 0, 0, 0, 2, 0, 0, 1, 3
"d:\IDEWORK\lvmen\src\licensedcode\data\rules\false-positive_3683.yml", "YAML", 0, 0, 0, 2, 0, 0, 1, 3
"d:\IDEWORK\lvmen\src\licensedcode\data\rules\false-positive_3684.yml", "YAML", 0, 0, 0, 2, 0, 0, 1, 3
"d:\IDEWORK\lvmen\src\licensedcode\data\rules\false-positive_3685.yml", "YAML", 0, 0, 0, 2, 0, 0, 1, 3
"d:\IDEWORK\lvmen\src\licensedcode\data\rules\false-positive_3686.yml", "YAML", 0, 0, 0, 2, 0, 0, 1, 3
"d:\IDEWORK\lvmen\src\licensedcode\data\rules\false-positive_3687.yml", "YAML", 0, 0, 0, 2, 0, 0, 1, 3
"d:\IDEWORK\lvmen\src\licensedcode\data\rules\false-positive_3688.yml", "YAML", 0, 0, 0, 2, 0, 0, 1, 3
"d:\IDEWORK\lvmen\src\licensedcode\data\rules\false-positive_3689.yml", "YAML", 0, 0, 0, 2, 0, 0, 1, 3
"d:\IDEWORK\lvmen\src\licensedcode\data\rules\false-positive_369.yml", "YAML", 0, 0, 0, 2, 0, 0, 1, 3
"d:\IDEWORK\lvmen\src\licensedcode\data\rules\false-positive_3690.yml", "YAML", 0, 0, 0, 2, 0, 0, 1, 3
"d:\IDEWORK\lvmen\src\licensedcode\data\rules\false-positive_3691.yml", "YAML", 0, 0, 0, 2, 0, 0, 1, 3
"d:\IDEWORK\lvmen\src\licensedcode\data\rules\false-positive_3692.yml", "YAML", 0, 0, 0, 2, 0, 0, 1, 3
"d:\IDEWORK\lvmen\src\licensedcode\data\rules\false-positive_3693.yml", "YAML", 0, 0, 0, 2, 0, 0, 1, 3
"d:\IDEWORK\lvmen\src\licensedcode\data\rules\false-positive_3694.yml", "YAML", 0, 0, 0, 2, 0, 0, 1, 3
"d:\IDEWORK\lvmen\src\licensedcode\data\rules\false-positive_3695.yml", "YAML", 0, 0, 0, 2, 0, 0, 1, 3
"d:\IDEWORK\lvmen\src\licensedcode\data\rules\false-positive_3696.yml", "YAML", 0, 0, 0, 2, 0, 0, 1, 3
"d:\IDEWORK\lvmen\src\licensedcode\data\rules\false-positive_3697.yml", "YAML", 0, 0, 0, 2, 0, 0, 1, 3
"d:\IDEWORK\lvmen\src\licensedcode\data\rules\false-positive_3698.yml", "YAML", 0, 0, 0, 2, 0, 0, 1, 3
"d:\IDEWORK\lvmen\src\licensedcode\data\rules\false-positive_3699.yml", "YAML", 0, 0, 0, 2, 0, 0, 1, 3
"d:\IDEWORK\lvmen\src\licensedcode\data\rules\false-positive_37.yml", "YAML", 0, 0, 0, 2, 0, 0, 1, 3
"d:\IDEWORK\lvmen\src\licensedcode\data\rules\false-positive_370.yml", "YAML", 0, 0, 0, 2, 0, 0, 1, 3
"d:\IDEWORK\lvmen\src\licensedcode\data\rules\false-positive_3700.yml", "YAML", 0, 0, 0, 2, 0, 0, 1, 3
"d:\IDEWORK\lvmen\src\licensedcode\data\rules\false-positive_3701.yml", "YAML", 0, 0, 0, 2, 0, 0, 1, 3
"d:\IDEWORK\lvmen\src\licensedcode\data\rules\false-positive_3702.yml", "YAML", 0, 0, 0, 2, 0, 0, 1, 3
"d:\IDEWORK\lvmen\src\licensedcode\data\rules\false-positive_3703.yml", "YAML", 0, 0, 0, 2, 0, 0, 1, 3
"d:\IDEWORK\lvmen\src\licensedcode\data\rules\false-positive_3704.yml", "YAML", 0, 0, 0, 2, 0, 0, 1, 3
"d:\IDEWORK\lvmen\src\licensedcode\data\rules\false-positive_3705.yml", "YAML", 0, 0, 0, 2, 0, 0, 1, 3
"d:\IDEWORK\lvmen\src\licensedcode\data\rules\false-positive_3706.yml", "YAML", 0, 0, 0, 2, 0, 0, 1, 3
"d:\IDEWORK\lvmen\src\licensedcode\data\rules\false-positive_3707.yml", "YAML", 0, 0, 0, 2, 0, 0, 1, 3
"d:\IDEWORK\lvmen\src\licensedcode\data\rules\false-positive_3708.yml", "YAML", 0, 0, 0, 2, 0, 0, 1, 3
"d:\IDEWORK\lvmen\src\licensedcode\data\rules\false-positive_3709.yml", "YAML", 0, 0, 0, 2, 0, 0, 1, 3
"d:\IDEWORK\lvmen\src\licensedcode\data\rules\false-positive_371.yml", "YAML", 0, 0, 0, 2, 0, 0, 1, 3
"d:\IDEWORK\lvmen\src\licensedcode\data\rules\false-positive_3710.yml", "YAML", 0, 0, 0, 2, 0, 0, 1, 3
"d:\IDEWORK\lvmen\src\licensedcode\data\rules\false-positive_3711.yml", "YAML", 0, 0, 0, 2, 0, 0, 1, 3
"d:\IDEWORK\lvmen\src\licensedcode\data\rules\false-positive_3712.yml", "YAML", 0, 0, 0, 2, 0, 0, 1, 3
"d:\IDEWORK\lvmen\src\licensedcode\data\rules\false-positive_3713.yml", "YAML", 0, 0, 0, 2, 0, 0, 1, 3
"d:\IDEWORK\lvmen\src\licensedcode\data\rules\false-positive_3714.yml", "YAML", 0, 0, 0, 2, 0, 0, 1, 3
"d:\IDEWORK\lvmen\src\licensedcode\data\rules\false-positive_3715.yml", "YAML", 0, 0, 0, 2, 0, 0, 1, 3
"d:\IDEWORK\lvmen\src\licensedcode\data\rules\false-positive_3716.yml", "YAML", 0, 0, 0, 2, 0, 0, 1, 3
"d:\IDEWORK\lvmen\src\licensedcode\data\rules\false-positive_3717.yml", "YAML", 0, 0, 0, 2, 0, 0, 1, 3
"d:\IDEWORK\lvmen\src\licensedcode\data\rules\false-positive_3718.yml", "YAML", 0, 0, 0, 2, 0, 0, 1, 3
"d:\IDEWORK\lvmen\src\licensedcode\data\rules\false-positive_3719.yml", "YAML", 0, 0, 0, 2, 0, 0, 1, 3
"d:\IDEWORK\lvmen\src\licensedcode\data\rules\false-positive_372.yml", "YAML", 0, 0, 0, 3, 0, 0, 1, 4
"d:\IDEWORK\lvmen\src\licensedcode\data\rules\false-positive_3720.yml", "YAML", 0, 0, 0, 2, 0, 0, 1, 3
"d:\IDEWORK\lvmen\src\licensedcode\data\rules\false-positive_3721.yml", "YAML", 0, 0, 0, 2, 0, 0, 1, 3
"d:\IDEWORK\lvmen\src\licensedcode\data\rules\false-positive_3722.yml", "YAML", 0, 0, 0, 2, 0, 0, 1, 3
"d:\IDEWORK\lvmen\src\licensedcode\data\rules\false-positive_3723.yml", "YAML", 0, 0, 0, 2, 0, 0, 1, 3
"d:\IDEWORK\lvmen\src\licensedcode\data\rules\false-positive_3724.yml", "YAML", 0, 0, 0, 2, 0, 0, 1, 3
"d:\IDEWORK\lvmen\src\licensedcode\data\rules\false-positive_3725.yml", "YAML", 0, 0, 0, 2, 0, 0, 1, 3
"d:\IDEWORK\lvmen\src\licensedcode\data\rules\false-positive_3726.yml", "YAML", 0, 0, 0, 2, 0, 0, 1, 3
"d:\IDEWORK\lvmen\src\licensedcode\data\rules\false-positive_3727.yml", "YAML", 0, 0, 0, 2, 0, 0, 1, 3
"d:\IDEWORK\lvmen\src\licensedcode\data\rules\false-positive_3728.yml", "YAML", 0, 0, 0, 2, 0, 0, 1, 3
"d:\IDEWORK\lvmen\src\licensedcode\data\rules\false-positive_3729.yml", "YAML", 0, 0, 0, 2, 0, 0, 1, 3
"d:\IDEWORK\lvmen\src\licensedcode\data\rules\false-positive_373.yml", "YAML", 0, 0, 0, 3, 0, 0, 1, 4
"d:\IDEWORK\lvmen\src\licensedcode\data\rules\false-positive_3730.yml", "YAML", 0, 0, 0, 2, 0, 0, 1, 3
"d:\IDEWORK\lvmen\src\licensedcode\data\rules\false-positive_3731.yml", "YAML", 0, 0, 0, 2, 0, 0, 1, 3
"d:\IDEWORK\lvmen\src\licensedcode\data\rules\false-positive_3732.yml", "YAML", 0, 0, 0, 2, 0, 0, 1, 3
"d:\IDEWORK\lvmen\src\licensedcode\data\rules\false-positive_3733.yml", "YAML", 0, 0, 0, 2, 0, 0, 1, 3
"d:\IDEWORK\lvmen\src\licensedcode\data\rules\false-positive_3734.yml", "YAML", 0, 0, 0, 2, 0, 0, 1, 3
"d:\IDEWORK\lvmen\src\licensedcode\data\rules\false-positive_3735.yml", "YAML", 0, 0, 0, 2, 0, 0, 1, 3
"d:\IDEWORK\lvmen\src\licensedcode\data\rules\false-positive_3736.yml", "YAML", 0, 0, 0, 2, 0, 0, 1, 3
"d:\IDEWORK\lvmen\src\licensedcode\data\rules\false-positive_3737.yml", "YAML", 0, 0, 0, 2, 0, 0, 1, 3
"d:\IDEWORK\lvmen\src\licensedcode\data\rules\false-positive_3738.yml", "YAML", 0, 0, 0, 2, 0, 0, 1, 3
"d:\IDEWORK\lvmen\src\licensedcode\data\rules\false-positive_3739.yml", "YAML", 0, 0, 0, 2, 0, 0, 1, 3
"d:\IDEWORK\lvmen\src\licensedcode\data\rules\false-positive_374.yml", "YAML", 0, 0, 0, 2, 0, 0, 1, 3
"d:\IDEWORK\lvmen\src\licensedcode\data\rules\false-positive_3740.yml", "YAML", 0, 0, 0, 2, 0, 0, 1, 3
"d:\IDEWORK\lvmen\src\licensedcode\data\rules\false-positive_3741.yml", "YAML", 0, 0, 0, 2, 0, 0, 1, 3
"d:\IDEWORK\lvmen\src\licensedcode\data\rules\false-positive_3742.yml", "YAML", 0, 0, 0, 2, 0, 0, 1, 3
"d:\IDEWORK\lvmen\src\licensedcode\data\rules\false-positive_3743.yml", "YAML", 0, 0, 0, 2, 0, 0, 1, 3
"d:\IDEWORK\lvmen\src\licensedcode\data\rules\false-positive_3744.yml", "YAML", 0, 0, 0, 2, 0, 0, 1, 3
"d:\IDEWORK\lvmen\src\licensedcode\data\rules\false-positive_3745.yml", "YAML", 0, 0, 0, 2, 0, 0, 1, 3
"d:\IDEWORK\lvmen\src\licensedcode\data\rules\false-positive_3746.yml", "YAML", 0, 0, 0, 2, 0, 0, 1, 3
"d:\IDEWORK\lvmen\src\licensedcode\data\rules\false-positive_3747.yml", "YAML", 0, 0, 0, 2, 0, 0, 1, 3
"d:\IDEWORK\lvmen\src\licensedcode\data\rules\false-positive_3748.yml", "YAML", 0, 0, 0, 2, 0, 0, 1, 3
"d:\IDEWORK\lvmen\src\licensedcode\data\rules\false-positive_3749.yml", "YAML", 0, 0, 0, 2, 0, 0, 1, 3
"d:\IDEWORK\lvmen\src\licensedcode\data\rules\false-positive_375.yml", "YAML", 0, 0, 0, 2, 0, 0, 1, 3
"d:\IDEWORK\lvmen\src\licensedcode\data\rules\false-positive_3750.yml", "YAML", 0, 0, 0, 2, 0, 0, 1, 3
"d:\IDEWORK\lvmen\src\licensedcode\data\rules\false-positive_3751.yml", "YAML", 0, 0, 0, 2, 0, 0, 1, 3
"d:\IDEWORK\lvmen\src\licensedcode\data\rules\false-positive_3752.yml", "YAML", 0, 0, 0, 2, 0, 0, 1, 3
"d:\IDEWORK\lvmen\src\licensedcode\data\rules\false-positive_3753.yml", "YAML", 0, 0, 0, 2, 0, 0, 1, 3
"d:\IDEWORK\lvmen\src\licensedcode\data\rules\false-positive_3754.yml", "YAML", 0, 0, 0, 2, 0, 0, 1, 3
"d:\IDEWORK\lvmen\src\licensedcode\data\rules\false-positive_3755.yml", "YAML", 0, 0, 0, 2, 0, 0, 1, 3
"d:\IDEWORK\lvmen\src\licensedcode\data\rules\false-positive_3756.yml", "YAML", 0, 0, 0, 2, 0, 0, 1, 3
"d:\IDEWORK\lvmen\src\licensedcode\data\rules\false-positive_3757.yml", "YAML", 0, 0, 0, 2, 0, 0, 1, 3
"d:\IDEWORK\lvmen\src\licensedcode\data\rules\false-positive_3758.yml", "YAML", 0, 0, 0, 2, 0, 0, 1, 3
"d:\IDEWORK\lvmen\src\licensedcode\data\rules\false-positive_3759.yml", "YAML", 0, 0, 0, 2, 0, 0, 1, 3
"d:\IDEWORK\lvmen\src\licensedcode\data\rules\false-positive_376.yml", "YAML", 0, 0, 0, 2, 0, 0, 1, 3
"d:\IDEWORK\lvmen\src\licensedcode\data\rules\false-positive_3760.yml", "YAML", 0, 0, 0, 2, 0, 0, 1, 3
"d:\IDEWORK\lvmen\src\licensedcode\data\rules\false-positive_3761.yml", "YAML", 0, 0, 0, 2, 0, 0, 1, 3
"d:\IDEWORK\lvmen\src\licensedcode\data\rules\false-positive_3762.yml", "YAML", 0, 0, 0, 2, 0, 0, 1, 3
"d:\IDEWORK\lvmen\src\licensedcode\data\rules\false-positive_3763.yml", "YAML", 0, 0, 0, 2, 0, 0, 1, 3
"d:\IDEWORK\lvmen\src\licensedcode\data\rules\false-positive_3764.yml", "YAML", 0, 0, 0, 2, 0, 0, 1, 3
"d:\IDEWORK\lvmen\src\licensedcode\data\rules\false-positive_3765.yml", "YAML", 0, 0, 0, 2, 0, 0, 1, 3
"d:\IDEWORK\lvmen\src\licensedcode\data\rules\false-positive_3766.yml", "YAML", 0, 0, 0, 2, 0, 0, 1, 3
"d:\IDEWORK\lvmen\src\licensedcode\data\rules\false-positive_3767.yml", "YAML", 0, 0, 0, 2, 0, 0, 1, 3
"d:\IDEWORK\lvmen\src\licensedcode\data\rules\false-positive_3768.yml", "YAML", 0, 0, 0, 2, 0, 0, 1, 3
"d:\IDEWORK\lvmen\src\licensedcode\data\rules\false-positive_3769.yml", "YAML", 0, 0, 0, 2, 0, 0, 1, 3
"d:\IDEWORK\lvmen\src\licensedcode\data\rules\false-positive_377.yml", "YAML", 0, 0, 0, 3, 0, 0, 1, 4
"d:\IDEWORK\lvmen\src\licensedcode\data\rules\false-positive_3770.yml", "YAML", 0, 0, 0, 2, 0, 0, 1, 3
"d:\IDEWORK\lvmen\src\licensedcode\data\rules\false-positive_3771.yml", "YAML", 0, 0, 0, 2, 0, 0, 1, 3
"d:\IDEWORK\lvmen\src\licensedcode\data\rules\false-positive_3772.yml", "YAML", 0, 0, 0, 2, 0, 0, 1, 3
"d:\IDEWORK\lvmen\src\licensedcode\data\rules\false-positive_3773.yml", "YAML", 0, 0, 0, 2, 0, 0, 1, 3
"d:\IDEWORK\lvmen\src\licensedcode\data\rules\false-positive_3774.yml", "YAML", 0, 0, 0, 2, 0, 0, 1, 3
"d:\IDEWORK\lvmen\src\licensedcode\data\rules\false-positive_3775.yml", "YAML", 0, 0, 0, 2, 0, 0, 1, 3
"d:\IDEWORK\lvmen\src\licensedcode\data\rules\false-positive_3776.yml", "YAML", 0, 0, 0, 2, 0, 0, 1, 3
"d:\IDEWORK\lvmen\src\licensedcode\data\rules\false-positive_3777.yml", "YAML", 0, 0, 0, 2, 0, 0, 1, 3
"d:\IDEWORK\lvmen\src\licensedcode\data\rules\false-positive_3778.yml", "YAML", 0, 0, 0, 2, 0, 0, 1, 3
"d:\IDEWORK\lvmen\src\licensedcode\data\rules\false-positive_3779.yml", "YAML", 0, 0, 0, 2, 0, 0, 1, 3
"d:\IDEWORK\lvmen\src\licensedcode\data\rules\false-positive_378.yml", "YAML", 0, 0, 0, 3, 0, 0, 1, 4
"d:\IDEWORK\lvmen\src\licensedcode\data\rules\false-positive_3780.yml", "YAML", 0, 0, 0, 2, 0, 0, 1, 3
"d:\IDEWORK\lvmen\src\licensedcode\data\rules\false-positive_3781.yml", "YAML", 0, 0, 0, 2, 0, 0, 1, 3
"d:\IDEWORK\lvmen\src\licensedcode\data\rules\false-positive_3782.yml", "YAML", 0, 0, 0, 2, 0, 0, 1, 3
"d:\IDEWORK\lvmen\src\licensedcode\data\rules\false-positive_3783.yml", "YAML", 0, 0, 0, 2, 0, 0, 1, 3
"d:\IDEWORK\lvmen\src\licensedcode\data\rules\false-positive_3784.yml", "YAML", 0, 0, 0, 2, 0, 0, 1, 3
"d:\IDEWORK\lvmen\src\licensedcode\data\rules\false-positive_3785.yml", "YAML", 0, 0, 0, 2, 0, 0, 1, 3
"d:\IDEWORK\lvmen\src\licensedcode\data\rules\false-positive_3786.yml", "YAML", 0, 0, 0, 2, 0, 0, 1, 3
"d:\IDEWORK\lvmen\src\licensedcode\data\rules\false-positive_3787.yml", "YAML", 0, 0, 0, 2, 0, 0, 1, 3
"d:\IDEWORK\lvmen\src\licensedcode\data\rules\false-positive_3788.yml", "YAML", 0, 0, 0, 2, 0, 0, 1, 3
"d:\IDEWORK\lvmen\src\licensedcode\data\rules\false-positive_3789.yml", "YAML", 0, 0, 0, 2, 0, 0, 1, 3
"d:\IDEWORK\lvmen\src\licensedcode\data\rules\false-positive_379.yml", "YAML", 0, 0, 0, 2, 0, 0, 1, 3
"d:\IDEWORK\lvmen\src\licensedcode\data\rules\false-positive_3790.yml", "YAML", 0, 0, 0, 2, 0, 0, 1, 3
"d:\IDEWORK\lvmen\src\licensedcode\data\rules\false-positive_3791.yml", "YAML", 0, 0, 0, 2, 0, 0, 1, 3
"d:\IDEWORK\lvmen\src\licensedcode\data\rules\false-positive_3792.yml", "YAML", 0, 0, 0, 2, 0, 0, 1, 3
"d:\IDEWORK\lvmen\src\licensedcode\data\rules\false-positive_3793.yml", "YAML", 0, 0, 0, 2, 0, 0, 1, 3
"d:\IDEWORK\lvmen\src\licensedcode\data\rules\false-positive_3794.yml", "YAML", 0, 0, 0, 2, 0, 0, 1, 3
"d:\IDEWORK\lvmen\src\licensedcode\data\rules\false-positive_3795.yml", "YAML", 0, 0, 0, 2, 0, 0, 1, 3
"d:\IDEWORK\lvmen\src\licensedcode\data\rules\false-positive_3796.yml", "YAML", 0, 0, 0, 2, 0, 0, 1, 3
"d:\IDEWORK\lvmen\src\licensedcode\data\rules\false-positive_3797.yml", "YAML", 0, 0, 0, 2, 0, 0, 1, 3
"d:\IDEWORK\lvmen\src\licensedcode\data\rules\false-positive_3798.yml", "YAML", 0, 0, 0, 2, 0, 0, 1, 3
"d:\IDEWORK\lvmen\src\licensedcode\data\rules\false-positive_3799.yml", "YAML", 0, 0, 0, 2, 0, 0, 1, 3
"d:\IDEWORK\lvmen\src\licensedcode\data\rules\false-positive_38.yml", "YAML", 0, 0, 0, 2, 0, 0, 1, 3
"d:\IDEWORK\lvmen\src\licensedcode\data\rules\false-positive_380.yml", "YAML", 0, 0, 0, 2, 0, 0, 1, 3
"d:\IDEWORK\lvmen\src\licensedcode\data\rules\false-positive_3800.yml", "YAML", 0, 0, 0, 2, 0, 0, 1, 3
"d:\IDEWORK\lvmen\src\licensedcode\data\rules\false-positive_3801.yml", "YAML", 0, 0, 0, 2, 0, 0, 1, 3
"d:\IDEWORK\lvmen\src\licensedcode\data\rules\false-positive_3802.yml", "YAML", 0, 0, 0, 2, 0, 0, 1, 3
"d:\IDEWORK\lvmen\src\licensedcode\data\rules\false-positive_3803.yml", "YAML", 0, 0, 0, 2, 0, 0, 1, 3
"d:\IDEWORK\lvmen\src\licensedcode\data\rules\false-positive_3804.yml", "YAML", 0, 0, 0, 2, 0, 0, 1, 3
"d:\IDEWORK\lvmen\src\licensedcode\data\rules\false-positive_3805.yml", "YAML", 0, 0, 0, 2, 0, 0, 1, 3
"d:\IDEWORK\lvmen\src\licensedcode\data\rules\false-positive_3806.yml", "YAML", 0, 0, 0, 2, 0, 0, 1, 3
"d:\IDEWORK\lvmen\src\licensedcode\data\rules\false-positive_3807.yml", "YAML", 0, 0, 0, 2, 0, 0, 1, 3
"d:\IDEWORK\lvmen\src\licensedcode\data\rules\false-positive_3808.yml", "YAML", 0, 0, 0, 2, 0, 0, 1, 3
"d:\IDEWORK\lvmen\src\licensedcode\data\rules\false-positive_3809.yml", "YAML", 0, 0, 0, 2, 0, 0, 1, 3
"d:\IDEWORK\lvmen\src\licensedcode\data\rules\false-positive_381.yml", "YAML", 0, 0, 0, 3, 0, 0, 1, 4
"d:\IDEWORK\lvmen\src\licensedcode\data\rules\false-positive_3810.yml", "YAML", 0, 0, 0, 2, 0, 0, 1, 3
"d:\IDEWORK\lvmen\src\licensedcode\data\rules\false-positive_3811.yml", "YAML", 0, 0, 0, 2, 0, 0, 1, 3
"d:\IDEWORK\lvmen\src\licensedcode\data\rules\false-positive_3812.yml", "YAML", 0, 0, 0, 2, 0, 0, 1, 3
"d:\IDEWORK\lvmen\src\licensedcode\data\rules\false-positive_3813.yml", "YAML", 0, 0, 0, 2, 0, 0, 1, 3
"d:\IDEWORK\lvmen\src\licensedcode\data\rules\false-positive_3814.yml", "YAML", 0, 0, 0, 2, 0, 0, 1, 3
"d:\IDEWORK\lvmen\src\licensedcode\data\rules\false-positive_3815.yml", "YAML", 0, 0, 0, 2, 0, 0, 1, 3
"d:\IDEWORK\lvmen\src\licensedcode\data\rules\false-positive_3816.yml", "YAML", 0, 0, 0, 2, 0, 0, 1, 3
"d:\IDEWORK\lvmen\src\licensedcode\data\rules\false-positive_3817.yml", "YAML", 0, 0, 0, 2, 0, 0, 1, 3
"d:\IDEWORK\lvmen\src\licensedcode\data\rules\false-positive_3818.yml", "YAML", 0, 0, 0, 2, 0, 0, 1, 3
"d:\IDEWORK\lvmen\src\licensedcode\data\rules\false-positive_3819.yml", "YAML", 0, 0, 0, 2, 0, 0, 1, 3
"d:\IDEWORK\lvmen\src\licensedcode\data\rules\false-positive_382.yml", "YAML", 0, 0, 0, 2, 0, 0, 1, 3
"d:\IDEWORK\lvmen\src\licensedcode\data\rules\false-positive_3820.yml", "YAML", 0, 0, 0, 2, 0, 0, 1, 3
"d:\IDEWORK\lvmen\src\licensedcode\data\rules\false-positive_3821.yml", "YAML", 0, 0, 0, 2, 0, 0, 1, 3
"d:\IDEWORK\lvmen\src\licensedcode\data\rules\false-positive_3822.yml", "YAML", 0, 0, 0, 2, 0, 0, 1, 3
"d:\IDEWORK\lvmen\src\licensedcode\data\rules\false-positive_3823.yml", "YAML", 0, 0, 0, 2, 0, 0, 1, 3
"d:\IDEWORK\lvmen\src\licensedcode\data\rules\false-positive_3824.yml", "YAML", 0, 0, 0, 2, 0, 0, 1, 3
"d:\IDEWORK\lvmen\src\licensedcode\data\rules\false-positive_3825.yml", "YAML", 0, 0, 0, 2, 0, 0, 1, 3
"d:\IDEWORK\lvmen\src\licensedcode\data\rules\false-positive_3826.yml", "YAML", 0, 0, 0, 2, 0, 0, 1, 3
"d:\IDEWORK\lvmen\src\licensedcode\data\rules\false-positive_3827.yml", "YAML", 0, 0, 0, 2, 0, 0, 1, 3
"d:\IDEWORK\lvmen\src\licensedcode\data\rules\false-positive_3828.yml", "YAML", 0, 0, 0, 2, 0, 0, 1, 3
"d:\IDEWORK\lvmen\src\licensedcode\data\rules\false-positive_3829.yml", "YAML", 0, 0, 0, 2, 0, 0, 1, 3
"d:\IDEWORK\lvmen\src\licensedcode\data\rules\false-positive_383.yml", "YAML", 0, 0, 0, 2, 0, 0, 1, 3
"d:\IDEWORK\lvmen\src\licensedcode\data\rules\false-positive_3830.yml", "YAML", 0, 0, 0, 2, 0, 0, 1, 3
"d:\IDEWORK\lvmen\src\licensedcode\data\rules\false-positive_3831.yml", "YAML", 0, 0, 0, 2, 0, 0, 1, 3
"d:\IDEWORK\lvmen\src\licensedcode\data\rules\false-positive_3832.yml", "YAML", 0, 0, 0, 2, 0, 0, 1, 3
"d:\IDEWORK\lvmen\src\licensedcode\data\rules\false-positive_3833.yml", "YAML", 0, 0, 0, 2, 0, 0, 1, 3
"d:\IDEWORK\lvmen\src\licensedcode\data\rules\false-positive_3834.yml", "YAML", 0, 0, 0, 2, 0, 0, 1, 3
"d:\IDEWORK\lvmen\src\licensedcode\data\rules\false-positive_3835.yml", "YAML", 0, 0, 0, 2, 0, 0, 1, 3
"d:\IDEWORK\lvmen\src\licensedcode\data\rules\false-positive_3836.yml", "YAML", 0, 0, 0, 2, 0, 0, 1, 3
"d:\IDEWORK\lvmen\src\licensedcode\data\rules\false-positive_3837.yml", "YAML", 0, 0, 0, 2, 0, 0, 1, 3
"d:\IDEWORK\lvmen\src\licensedcode\data\rules\false-positive_3838.yml", "YAML", 0, 0, 0, 2, 0, 0, 1, 3
"d:\IDEWORK\lvmen\src\licensedcode\data\rules\false-positive_3839.yml", "YAML", 0, 0, 0, 2, 0, 0, 1, 3
"d:\IDEWORK\lvmen\src\licensedcode\data\rules\false-positive_384.yml", "YAML", 0, 0, 0, 2, 0, 0, 1, 3
"d:\IDEWORK\lvmen\src\licensedcode\data\rules\false-positive_3840.yml", "YAML", 0, 0, 0, 2, 0, 0, 1, 3
"d:\IDEWORK\lvmen\src\licensedcode\data\rules\false-positive_3841.yml", "YAML", 0, 0, 0, 2, 0, 0, 1, 3
"d:\IDEWORK\lvmen\src\licensedcode\data\rules\false-positive_3842.yml", "YAML", 0, 0, 0, 2, 0, 0, 1, 3
"d:\IDEWORK\lvmen\src\licensedcode\data\rules\false-positive_3843.yml", "YAML", 0, 0, 0, 2, 0, 0, 1, 3
"d:\IDEWORK\lvmen\src\licensedcode\data\rules\false-positive_3844.yml", "YAML", 0, 0, 0, 2, 0, 0, 1, 3
"d:\IDEWORK\lvmen\src\licensedcode\data\rules\false-positive_3845.yml", "YAML", 0, 0, 0, 2, 0, 0, 1, 3
"d:\IDEWORK\lvmen\src\licensedcode\data\rules\false-positive_3846.yml", "YAML", 0, 0, 0, 2, 0, 0, 1, 3
"d:\IDEWORK\lvmen\src\licensedcode\data\rules\false-positive_3847.yml", "YAML", 0, 0, 0, 2, 0, 0, 1, 3
"d:\IDEWORK\lvmen\src\licensedcode\data\rules\false-positive_3848.yml", "YAML", 0, 0, 0, 2, 0, 0, 1, 3
"d:\IDEWORK\lvmen\src\licensedcode\data\rules\false-positive_3849.yml", "YAML", 0, 0, 0, 2, 0, 0, 1, 3
"d:\IDEWORK\lvmen\src\licensedcode\data\rules\false-positive_385.yml", "YAML", 0, 0, 0, 2, 0, 0, 1, 3
"d:\IDEWORK\lvmen\src\licensedcode\data\rules\false-positive_3850.yml", "YAML", 0, 0, 0, 2, 0, 0, 1, 3
"d:\IDEWORK\lvmen\src\licensedcode\data\rules\false-positive_3851.yml", "YAML", 0, 0, 0, 2, 0, 0, 1, 3
"d:\IDEWORK\lvmen\src\licensedcode\data\rules\false-positive_3852.yml", "YAML", 0, 0, 0, 2, 0, 0, 1, 3
"d:\IDEWORK\lvmen\src\licensedcode\data\rules\false-positive_3853.yml", "YAML", 0, 0, 0, 2, 0, 0, 1, 3
"d:\IDEWORK\lvmen\src\licensedcode\data\rules\false-positive_3854.yml", "YAML", 0, 0, 0, 2, 0, 0, 1, 3
"d:\IDEWORK\lvmen\src\licensedcode\data\rules\false-positive_3855.yml", "YAML", 0, 0, 0, 2, 0, 0, 1, 3
"d:\IDEWORK\lvmen\src\licensedcode\data\rules\false-positive_3856.yml", "YAML", 0, 0, 0, 2, 0, 0, 1, 3
"d:\IDEWORK\lvmen\src\licensedcode\data\rules\false-positive_3857.yml", "YAML", 0, 0, 0, 2, 0, 0, 1, 3
"d:\IDEWORK\lvmen\src\licensedcode\data\rules\false-positive_3858.yml", "YAML", 0, 0, 0, 2, 0, 0, 1, 3
"d:\IDEWORK\lvmen\src\licensedcode\data\rules\false-positive_3859.yml", "YAML", 0, 0, 0, 2, 0, 0, 1, 3
"d:\IDEWORK\lvmen\src\licensedcode\data\rules\false-positive_386.yml", "YAML", 0, 0, 0, 3, 0, 0, 1, 4
"d:\IDEWORK\lvmen\src\licensedcode\data\rules\false-positive_3860.yml", "YAML", 0, 0, 0, 2, 0, 0, 1, 3
"d:\IDEWORK\lvmen\src\licensedcode\data\rules\false-positive_3861.yml", "YAML", 0, 0, 0, 2, 0, 0, 1, 3
"d:\IDEWORK\lvmen\src\licensedcode\data\rules\false-positive_3862.yml", "YAML", 0, 0, 0, 2, 0, 0, 1, 3
"d:\IDEWORK\lvmen\src\licensedcode\data\rules\false-positive_3863.yml", "YAML", 0, 0, 0, 2, 0, 0, 1, 3
"d:\IDEWORK\lvmen\src\licensedcode\data\rules\false-positive_3864.yml", "YAML", 0, 0, 0, 2, 0, 0, 1, 3
"d:\IDEWORK\lvmen\src\licensedcode\data\rules\false-positive_3865.yml", "YAML", 0, 0, 0, 2, 0, 0, 1, 3
"d:\IDEWORK\lvmen\src\licensedcode\data\rules\false-positive_3866.yml", "YAML", 0, 0, 0, 2, 0, 0, 1, 3
"d:\IDEWORK\lvmen\src\licensedcode\data\rules\false-positive_3867.yml", "YAML", 0, 0, 0, 2, 0, 0, 1, 3
"d:\IDEWORK\lvmen\src\licensedcode\data\rules\false-positive_3868.yml", "YAML", 0, 0, 0, 2, 0, 0, 1, 3
"d:\IDEWORK\lvmen\src\licensedcode\data\rules\false-positive_3869.yml", "YAML", 0, 0, 0, 2, 0, 0, 1, 3
"d:\IDEWORK\lvmen\src\licensedcode\data\rules\false-positive_387.yml", "YAML", 0, 0, 0, 2, 0, 0, 1, 3
"d:\IDEWORK\lvmen\src\licensedcode\data\rules\false-positive_3870.yml", "YAML", 0, 0, 0, 2, 0, 0, 1, 3
"d:\IDEWORK\lvmen\src\licensedcode\data\rules\false-positive_3871.yml", "YAML", 0, 0, 0, 2, 0, 0, 1, 3
"d:\IDEWORK\lvmen\src\licensedcode\data\rules\false-positive_3872.yml", "YAML", 0, 0, 0, 2, 0, 0, 1, 3
"d:\IDEWORK\lvmen\src\licensedcode\data\rules\false-positive_3873.yml", "YAML", 0, 0, 0, 2, 0, 0, 1, 3
"d:\IDEWORK\lvmen\src\licensedcode\data\rules\false-positive_3874.yml", "YAML", 0, 0, 0, 2, 0, 0, 1, 3
"d:\IDEWORK\lvmen\src\licensedcode\data\rules\false-positive_3875.yml", "YAML", 0, 0, 0, 2, 0, 0, 1, 3
"d:\IDEWORK\lvmen\src\licensedcode\data\rules\false-positive_3876.yml", "YAML", 0, 0, 0, 2, 0, 0, 1, 3
"d:\IDEWORK\lvmen\src\licensedcode\data\rules\false-positive_3877.yml", "YAML", 0, 0, 0, 2, 0, 0, 1, 3
"d:\IDEWORK\lvmen\src\licensedcode\data\rules\false-positive_3878.yml", "YAML", 0, 0, 0, 2, 0, 0, 1, 3
"d:\IDEWORK\lvmen\src\licensedcode\data\rules\false-positive_3879.yml", "YAML", 0, 0, 0, 2, 0, 0, 1, 3
"d:\IDEWORK\lvmen\src\licensedcode\data\rules\false-positive_388.yml", "YAML", 0, 0, 0, 2, 0, 0, 1, 3
"d:\IDEWORK\lvmen\src\licensedcode\data\rules\false-positive_3880.yml", "YAML", 0, 0, 0, 2, 0, 0, 1, 3
"d:\IDEWORK\lvmen\src\licensedcode\data\rules\false-positive_3881.yml", "YAML", 0, 0, 0, 2, 0, 0, 1, 3
"d:\IDEWORK\lvmen\src\licensedcode\data\rules\false-positive_3882.yml", "YAML", 0, 0, 0, 2, 0, 0, 1, 3
"d:\IDEWORK\lvmen\src\licensedcode\data\rules\false-positive_3883.yml", "YAML", 0, 0, 0, 2, 0, 0, 1, 3
"d:\IDEWORK\lvmen\src\licensedcode\data\rules\false-positive_3884.yml", "YAML", 0, 0, 0, 2, 0, 0, 1, 3
"d:\IDEWORK\lvmen\src\licensedcode\data\rules\false-positive_3885.yml", "YAML", 0, 0, 0, 2, 0, 0, 1, 3
"d:\IDEWORK\lvmen\src\licensedcode\data\rules\false-positive_3886.yml", "YAML", 0, 0, 0, 2, 0, 0, 1, 3
"d:\IDEWORK\lvmen\src\licensedcode\data\rules\false-positive_3887.yml", "YAML", 0, 0, 0, 2, 0, 0, 1, 3
"d:\IDEWORK\lvmen\src\licensedcode\data\rules\false-positive_3888.yml", "YAML", 0, 0, 0, 2, 0, 0, 1, 3
"d:\IDEWORK\lvmen\src\licensedcode\data\rules\false-positive_3889.yml", "YAML", 0, 0, 0, 2, 0, 0, 1, 3
"d:\IDEWORK\lvmen\src\licensedcode\data\rules\false-positive_389.yml", "YAML", 0, 0, 0, 2, 0, 0, 1, 3
"d:\IDEWORK\lvmen\src\licensedcode\data\rules\false-positive_3890.yml", "YAML", 0, 0, 0, 2, 0, 0, 1, 3
"d:\IDEWORK\lvmen\src\licensedcode\data\rules\false-positive_3891.yml", "YAML", 0, 0, 0, 2, 0, 0, 1, 3
"d:\IDEWORK\lvmen\src\licensedcode\data\rules\false-positive_3892.yml", "YAML", 0, 0, 0, 2, 0, 0, 1, 3
"d:\IDEWORK\lvmen\src\licensedcode\data\rules\false-positive_3893.yml", "YAML", 0, 0, 0, 2, 0, 0, 1, 3
"d:\IDEWORK\lvmen\src\licensedcode\data\rules\false-positive_3894.yml", "YAML", 0, 0, 0, 2, 0, 0, 1, 3
"d:\IDEWORK\lvmen\src\licensedcode\data\rules\false-positive_3895.yml", "YAML", 0, 0, 0, 2, 0, 0, 1, 3
"d:\IDEWORK\lvmen\src\licensedcode\data\rules\false-positive_3896.yml", "YAML", 0, 0, 0, 2, 0, 0, 1, 3
"d:\IDEWORK\lvmen\src\licensedcode\data\rules\false-positive_3897.yml", "YAML", 0, 0, 0, 2, 0, 0, 1, 3
"d:\IDEWORK\lvmen\src\licensedcode\data\rules\false-positive_3898.yml", "YAML", 0, 0, 0, 2, 0, 0, 1, 3
"d:\IDEWORK\lvmen\src\licensedcode\data\rules\false-positive_3899.yml", "YAML", 0, 0, 0, 2, 0, 0, 1, 3
"d:\IDEWORK\lvmen\src\licensedcode\data\rules\false-positive_39.yml", "YAML", 0, 0, 0, 2, 0, 0, 1, 3
"d:\IDEWORK\lvmen\src\licensedcode\data\rules\false-positive_390.yml", "YAML", 0, 0, 0, 2, 0, 0, 1, 3
"d:\IDEWORK\lvmen\src\licensedcode\data\rules\false-positive_3900.yml", "YAML", 0, 0, 0, 2, 0, 0, 1, 3
"d:\IDEWORK\lvmen\src\licensedcode\data\rules\false-positive_3901.yml", "YAML", 0, 0, 0, 2, 0, 0, 1, 3
"d:\IDEWORK\lvmen\src\licensedcode\data\rules\false-positive_3902.yml", "YAML", 0, 0, 0, 2, 0, 0, 1, 3
"d:\IDEWORK\lvmen\src\licensedcode\data\rules\false-positive_3903.yml", "YAML", 0, 0, 0, 2, 0, 0, 1, 3
"d:\IDEWORK\lvmen\src\licensedcode\data\rules\false-positive_3904.yml", "YAML", 0, 0, 0, 2, 0, 0, 1, 3
"d:\IDEWORK\lvmen\src\licensedcode\data\rules\false-positive_3905.yml", "YAML", 0, 0, 0, 2, 0, 0, 1, 3
"d:\IDEWORK\lvmen\src\licensedcode\data\rules\false-positive_3906.yml", "YAML", 0, 0, 0, 2, 0, 0, 1, 3
"d:\IDEWORK\lvmen\src\licensedcode\data\rules\false-positive_3907.yml", "YAML", 0, 0, 0, 2, 0, 0, 1, 3
"d:\IDEWORK\lvmen\src\licensedcode\data\rules\false-positive_3908.yml", "YAML", 0, 0, 0, 2, 0, 0, 1, 3
"d:\IDEWORK\lvmen\src\licensedcode\data\rules\false-positive_3909.yml", "YAML", 0, 0, 0, 2, 0, 0, 1, 3
"d:\IDEWORK\lvmen\src\licensedcode\data\rules\false-positive_391.yml", "YAML", 0, 0, 0, 2, 0, 0, 1, 3
"d:\IDEWORK\lvmen\src\licensedcode\data\rules\false-positive_3910.yml", "YAML", 0, 0, 0, 2, 0, 0, 1, 3
"d:\IDEWORK\lvmen\src\licensedcode\data\rules\false-positive_3911.yml", "YAML", 0, 0, 0, 2, 0, 0, 1, 3
"d:\IDEWORK\lvmen\src\licensedcode\data\rules\false-positive_3912.yml", "YAML", 0, 0, 0, 2, 0, 0, 1, 3
"d:\IDEWORK\lvmen\src\licensedcode\data\rules\false-positive_3913.yml", "YAML", 0, 0, 0, 2, 0, 0, 1, 3
"d:\IDEWORK\lvmen\src\licensedcode\data\rules\false-positive_3914.yml", "YAML", 0, 0, 0, 2, 0, 0, 1, 3
"d:\IDEWORK\lvmen\src\licensedcode\data\rules\false-positive_3915.yml", "YAML", 0, 0, 0, 2, 0, 0, 1, 3
"d:\IDEWORK\lvmen\src\licensedcode\data\rules\false-positive_3916.yml", "YAML", 0, 0, 0, 2, 0, 0, 1, 3
"d:\IDEWORK\lvmen\src\licensedcode\data\rules\false-positive_3917.yml", "YAML", 0, 0, 0, 2, 0, 0, 1, 3
"d:\IDEWORK\lvmen\src\licensedcode\data\rules\false-positive_3918.yml", "YAML", 0, 0, 0, 2, 0, 0, 1, 3
"d:\IDEWORK\lvmen\src\licensedcode\data\rules\false-positive_3919.yml", "YAML", 0, 0, 0, 2, 0, 0, 1, 3
"d:\IDEWORK\lvmen\src\licensedcode\data\rules\false-positive_392.yml", "YAML", 0, 0, 0, 2, 0, 0, 1, 3
"d:\IDEWORK\lvmen\src\licensedcode\data\rules\false-positive_3920.yml", "YAML", 0, 0, 0, 2, 0, 0, 1, 3
"d:\IDEWORK\lvmen\src\licensedcode\data\rules\false-positive_3921.yml", "YAML", 0, 0, 0, 2, 0, 0, 1, 3
"d:\IDEWORK\lvmen\src\licensedcode\data\rules\false-positive_3922.yml", "YAML", 0, 0, 0, 2, 0, 0, 1, 3
"d:\IDEWORK\lvmen\src\licensedcode\data\rules\false-positive_3923.yml", "YAML", 0, 0, 0, 2, 0, 0, 1, 3
"d:\IDEWORK\lvmen\src\licensedcode\data\rules\false-positive_3924.yml", "YAML", 0, 0, 0, 2, 0, 0, 1, 3
"d:\IDEWORK\lvmen\src\licensedcode\data\rules\false-positive_3925.yml", "YAML", 0, 0, 0, 2, 0, 0, 1, 3
"d:\IDEWORK\lvmen\src\licensedcode\data\rules\false-positive_3926.yml", "YAML", 0, 0, 0, 2, 0, 0, 1, 3
"d:\IDEWORK\lvmen\src\licensedcode\data\rules\false-positive_3927.yml", "YAML", 0, 0, 0, 2, 0, 0, 1, 3
"d:\IDEWORK\lvmen\src\licensedcode\data\rules\false-positive_3928.yml", "YAML", 0, 0, 0, 2, 0, 0, 1, 3
"d:\IDEWORK\lvmen\src\licensedcode\data\rules\false-positive_3929.yml", "YAML", 0, 0, 0, 2, 0, 0, 1, 3
"d:\IDEWORK\lvmen\src\licensedcode\data\rules\false-positive_393.yml", "YAML", 0, 0, 0, 2, 0, 0, 1, 3
"d:\IDEWORK\lvmen\src\licensedcode\data\rules\false-positive_3930.yml", "YAML", 0, 0, 0, 2, 0, 0, 1, 3
"d:\IDEWORK\lvmen\src\licensedcode\data\rules\false-positive_3931.yml", "YAML", 0, 0, 0, 2, 0, 0, 1, 3
"d:\IDEWORK\lvmen\src\licensedcode\data\rules\false-positive_3932.yml", "YAML", 0, 0, 0, 2, 0, 0, 1, 3
"d:\IDEWORK\lvmen\src\licensedcode\data\rules\false-positive_3933.yml", "YAML", 0, 0, 0, 2, 0, 0, 1, 3
"d:\IDEWORK\lvmen\src\licensedcode\data\rules\false-positive_3934.yml", "YAML", 0, 0, 0, 2, 0, 0, 1, 3
"d:\IDEWORK\lvmen\src\licensedcode\data\rules\false-positive_3935.yml", "YAML", 0, 0, 0, 2, 0, 0, 1, 3
"d:\IDEWORK\lvmen\src\licensedcode\data\rules\false-positive_3936.yml", "YAML", 0, 0, 0, 2, 0, 0, 1, 3
"d:\IDEWORK\lvmen\src\licensedcode\data\rules\false-positive_3937.yml", "YAML", 0, 0, 0, 2, 0, 0, 1, 3
"d:\IDEWORK\lvmen\src\licensedcode\data\rules\false-positive_3938.yml", "YAML", 0, 0, 0, 2, 0, 0, 1, 3
"d:\IDEWORK\lvmen\src\licensedcode\data\rules\false-positive_3939.yml", "YAML", 0, 0, 0, 2, 0, 0, 1, 3
"d:\IDEWORK\lvmen\src\licensedcode\data\rules\false-positive_394.yml", "YAML", 0, 0, 0, 3, 0, 0, 1, 4
"d:\IDEWORK\lvmen\src\licensedcode\data\rules\false-positive_3940.yml", "YAML", 0, 0, 0, 2, 0, 0, 1, 3
"d:\IDEWORK\lvmen\src\licensedcode\data\rules\false-positive_3941.yml", "YAML", 0, 0, 0, 2, 0, 0, 1, 3
"d:\IDEWORK\lvmen\src\licensedcode\data\rules\false-positive_3942.yml", "YAML", 0, 0, 0, 2, 0, 0, 1, 3
"d:\IDEWORK\lvmen\src\licensedcode\data\rules\false-positive_3943.yml", "YAML", 0, 0, 0, 2, 0, 0, 1, 3
"d:\IDEWORK\lvmen\src\licensedcode\data\rules\false-positive_3944.yml", "YAML", 0, 0, 0, 2, 0, 0, 1, 3
"d:\IDEWORK\lvmen\src\licensedcode\data\rules\false-positive_3945.yml", "YAML", 0, 0, 0, 2, 0, 0, 1, 3
"d:\IDEWORK\lvmen\src\licensedcode\data\rules\false-positive_3946.yml", "YAML", 0, 0, 0, 2, 0, 0, 1, 3
"d:\IDEWORK\lvmen\src\licensedcode\data\rules\false-positive_3947.yml", "YAML", 0, 0, 0, 2, 0, 0, 1, 3
"d:\IDEWORK\lvmen\src\licensedcode\data\rules\false-positive_3948.yml", "YAML", 0, 0, 0, 2, 0, 0, 1, 3
"d:\IDEWORK\lvmen\src\licensedcode\data\rules\false-positive_3949.yml", "YAML", 0, 0, 0, 2, 0, 0, 1, 3
"d:\IDEWORK\lvmen\src\licensedcode\data\rules\false-positive_395.yml", "YAML", 0, 0, 0, 2, 0, 0, 1, 3
"d:\IDEWORK\lvmen\src\licensedcode\data\rules\false-positive_3950.yml", "YAML", 0, 0, 0, 2, 0, 0, 1, 3
"d:\IDEWORK\lvmen\src\licensedcode\data\rules\false-positive_3951.yml", "YAML", 0, 0, 0, 2, 0, 0, 1, 3
"d:\IDEWORK\lvmen\src\licensedcode\data\rules\false-positive_3952.yml", "YAML", 0, 0, 0, 2, 0, 0, 1, 3
"d:\IDEWORK\lvmen\src\licensedcode\data\rules\false-positive_3953.yml", "YAML", 0, 0, 0, 2, 0, 0, 1, 3
"d:\IDEWORK\lvmen\src\licensedcode\data\rules\false-positive_3954.yml", "YAML", 0, 0, 0, 2, 0, 0, 1, 3
"d:\IDEWORK\lvmen\src\licensedcode\data\rules\false-positive_3955.yml", "YAML", 0, 0, 0, 2, 0, 0, 1, 3
"d:\IDEWORK\lvmen\src\licensedcode\data\rules\false-positive_3956.yml", "YAML", 0, 0, 0, 2, 0, 0, 1, 3
"d:\IDEWORK\lvmen\src\licensedcode\data\rules\false-positive_3957.yml", "YAML", 0, 0, 0, 2, 0, 0, 1, 3
"d:\IDEWORK\lvmen\src\licensedcode\data\rules\false-positive_3958.yml", "YAML", 0, 0, 0, 2, 0, 0, 1, 3
"d:\IDEWORK\lvmen\src\licensedcode\data\rules\false-positive_3959.yml", "YAML", 0, 0, 0, 2, 0, 0, 1, 3
"d:\IDEWORK\lvmen\src\licensedcode\data\rules\false-positive_396.yml", "YAML", 0, 0, 0, 2, 0, 0, 1, 3
"d:\IDEWORK\lvmen\src\licensedcode\data\rules\false-positive_3960.yml", "YAML", 0, 0, 0, 2, 0, 0, 1, 3
"d:\IDEWORK\lvmen\src\licensedcode\data\rules\false-positive_3961.yml", "YAML", 0, 0, 0, 2, 0, 0, 1, 3
"d:\IDEWORK\lvmen\src\licensedcode\data\rules\false-positive_3962.yml", "YAML", 0, 0, 0, 2, 0, 0, 1, 3
"d:\IDEWORK\lvmen\src\licensedcode\data\rules\false-positive_3963.yml", "YAML", 0, 0, 0, 2, 0, 0, 1, 3
"d:\IDEWORK\lvmen\src\licensedcode\data\rules\false-positive_3964.yml", "YAML", 0, 0, 0, 2, 0, 0, 1, 3
"d:\IDEWORK\lvmen\src\licensedcode\data\rules\false-positive_3965.yml", "YAML", 0, 0, 0, 2, 0, 0, 1, 3
"d:\IDEWORK\lvmen\src\licensedcode\data\rules\false-positive_3966.yml", "YAML", 0, 0, 0, 2, 0, 0, 1, 3
"d:\IDEWORK\lvmen\src\licensedcode\data\rules\false-positive_3967.yml", "YAML", 0, 0, 0, 2, 0, 0, 1, 3
"d:\IDEWORK\lvmen\src\licensedcode\data\rules\false-positive_3968.yml", "YAML", 0, 0, 0, 2, 0, 0, 1, 3
"d:\IDEWORK\lvmen\src\licensedcode\data\rules\false-positive_3969.yml", "YAML", 0, 0, 0, 2, 0, 0, 1, 3
"d:\IDEWORK\lvmen\src\licensedcode\data\rules\false-positive_397.yml", "YAML", 0, 0, 0, 2, 0, 0, 1, 3
"d:\IDEWORK\lvmen\src\licensedcode\data\rules\false-positive_3970.yml", "YAML", 0, 0, 0, 2, 0, 0, 1, 3
"d:\IDEWORK\lvmen\src\licensedcode\data\rules\false-positive_3971.yml", "YAML", 0, 0, 0, 2, 0, 0, 1, 3
"d:\IDEWORK\lvmen\src\licensedcode\data\rules\false-positive_3972.yml", "YAML", 0, 0, 0, 2, 0, 0, 1, 3
"d:\IDEWORK\lvmen\src\licensedcode\data\rules\false-positive_3973.yml", "YAML", 0, 0, 0, 2, 0, 0, 1, 3
"d:\IDEWORK\lvmen\src\licensedcode\data\rules\false-positive_3974.yml", "YAML", 0, 0, 0, 2, 0, 0, 1, 3
"d:\IDEWORK\lvmen\src\licensedcode\data\rules\false-positive_3975.yml", "YAML", 0, 0, 0, 2, 0, 0, 1, 3
"d:\IDEWORK\lvmen\src\licensedcode\data\rules\false-positive_3976.yml", "YAML", 0, 0, 0, 2, 0, 0, 1, 3
"d:\IDEWORK\lvmen\src\licensedcode\data\rules\false-positive_3977.yml", "YAML", 0, 0, 0, 2, 0, 0, 1, 3
"d:\IDEWORK\lvmen\src\licensedcode\data\rules\false-positive_3978.yml", "YAML", 0, 0, 0, 2, 0, 0, 1, 3
"d:\IDEWORK\lvmen\src\licensedcode\data\rules\false-positive_3979.yml", "YAML", 0, 0, 0, 2, 0, 0, 1, 3
"d:\IDEWORK\lvmen\src\licensedcode\data\rules\false-positive_398.yml", "YAML", 0, 0, 0, 2, 0, 0, 1, 3
"d:\IDEWORK\lvmen\src\licensedcode\data\rules\false-positive_3980.yml", "YAML", 0, 0, 0, 2, 0, 0, 1, 3
"d:\IDEWORK\lvmen\src\licensedcode\data\rules\false-positive_3981.yml", "YAML", 0, 0, 0, 2, 0, 0, 1, 3
"d:\IDEWORK\lvmen\src\licensedcode\data\rules\false-positive_3982.yml", "YAML", 0, 0, 0, 2, 0, 0, 1, 3
"d:\IDEWORK\lvmen\src\licensedcode\data\rules\false-positive_3983.yml", "YAML", 0, 0, 0, 2, 0, 0, 1, 3
"d:\IDEWORK\lvmen\src\licensedcode\data\rules\false-positive_3984.yml", "YAML", 0, 0, 0, 2, 0, 0, 1, 3
"d:\IDEWORK\lvmen\src\licensedcode\data\rules\false-positive_3985.yml", "YAML", 0, 0, 0, 2, 0, 0, 1, 3
"d:\IDEWORK\lvmen\src\licensedcode\data\rules\false-positive_3986.yml", "YAML", 0, 0, 0, 2, 0, 0, 1, 3
"d:\IDEWORK\lvmen\src\licensedcode\data\rules\false-positive_3987.yml", "YAML", 0, 0, 0, 2, 0, 0, 1, 3
"d:\IDEWORK\lvmen\src\licensedcode\data\rules\false-positive_3988.yml", "YAML", 0, 0, 0, 2, 0, 0, 1, 3
"d:\IDEWORK\lvmen\src\licensedcode\data\rules\false-positive_3989.yml", "YAML", 0, 0, 0, 2, 0, 0, 1, 3
"d:\IDEWORK\lvmen\src\licensedcode\data\rules\false-positive_399.yml", "YAML", 0, 0, 0, 2, 0, 0, 1, 3
"d:\IDEWORK\lvmen\src\licensedcode\data\rules\false-positive_3990.yml", "YAML", 0, 0, 0, 2, 0, 0, 1, 3
"d:\IDEWORK\lvmen\src\licensedcode\data\rules\false-positive_3991.yml", "YAML", 0, 0, 0, 2, 0, 0, 1, 3
"d:\IDEWORK\lvmen\src\licensedcode\data\rules\false-positive_3992.yml", "YAML", 0, 0, 0, 2, 0, 0, 1, 3
"d:\IDEWORK\lvmen\src\licensedcode\data\rules\false-positive_3993.yml", "YAML", 0, 0, 0, 2, 0, 0, 1, 3
"d:\IDEWORK\lvmen\src\licensedcode\data\rules\false-positive_3994.yml", "YAML", 0, 0, 0, 2, 0, 0, 1, 3
"d:\IDEWORK\lvmen\src\licensedcode\data\rules\false-positive_3995.yml", "YAML", 0, 0, 0, 2, 0, 0, 1, 3
"d:\IDEWORK\lvmen\src\licensedcode\data\rules\false-positive_3996.yml", "YAML", 0, 0, 0, 2, 0, 0, 1, 3
"d:\IDEWORK\lvmen\src\licensedcode\data\rules\false-positive_3997.yml", "YAML", 0, 0, 0, 2, 0, 0, 1, 3
"d:\IDEWORK\lvmen\src\licensedcode\data\rules\false-positive_3998.yml", "YAML", 0, 0, 0, 2, 0, 0, 1, 3
"d:\IDEWORK\lvmen\src\licensedcode\data\rules\false-positive_3999.yml", "YAML", 0, 0, 0, 2, 0, 0, 1, 3
"d:\IDEWORK\lvmen\src\licensedcode\data\rules\false-positive_4.yml", "YAML", 0, 0, 0, 2, 0, 0, 1, 3
"d:\IDEWORK\lvmen\src\licensedcode\data\rules\false-positive_40.yml", "YAML", 0, 0, 0, 3, 0, 0, 1, 4
"d:\IDEWORK\lvmen\src\licensedcode\data\rules\false-positive_400.yml", "YAML", 0, 0, 0, 2, 0, 0, 1, 3
"d:\IDEWORK\lvmen\src\licensedcode\data\rules\false-positive_4000.yml", "YAML", 0, 0, 0, 2, 0, 0, 1, 3
"d:\IDEWORK\lvmen\src\licensedcode\data\rules\false-positive_4001.yml", "YAML", 0, 0, 0, 2, 0, 0, 1, 3
"d:\IDEWORK\lvmen\src\licensedcode\data\rules\false-positive_4002.yml", "YAML", 0, 0, 0, 2, 0, 0, 1, 3
"d:\IDEWORK\lvmen\src\licensedcode\data\rules\false-positive_4003.yml", "YAML", 0, 0, 0, 2, 0, 0, 1, 3
"d:\IDEWORK\lvmen\src\licensedcode\data\rules\false-positive_4004.yml", "YAML", 0, 0, 0, 2, 0, 0, 1, 3
"d:\IDEWORK\lvmen\src\licensedcode\data\rules\false-positive_4005.yml", "YAML", 0, 0, 0, 2, 0, 0, 1, 3
"d:\IDEWORK\lvmen\src\licensedcode\data\rules\false-positive_4006.yml", "YAML", 0, 0, 0, 2, 0, 0, 1, 3
"d:\IDEWORK\lvmen\src\licensedcode\data\rules\false-positive_4007.yml", "YAML", 0, 0, 0, 2, 0, 0, 1, 3
"d:\IDEWORK\lvmen\src\licensedcode\data\rules\false-positive_4008.yml", "YAML", 0, 0, 0, 2, 0, 0, 1, 3
"d:\IDEWORK\lvmen\src\licensedcode\data\rules\false-positive_4009.yml", "YAML", 0, 0, 0, 2, 0, 0, 1, 3
"d:\IDEWORK\lvmen\src\licensedcode\data\rules\false-positive_401.yml", "YAML", 0, 0, 0, 2, 0, 0, 1, 3
"d:\IDEWORK\lvmen\src\licensedcode\data\rules\false-positive_4010.yml", "YAML", 0, 0, 0, 2, 0, 0, 1, 3
"d:\IDEWORK\lvmen\src\licensedcode\data\rules\false-positive_4011.yml", "YAML", 0, 0, 0, 2, 0, 0, 1, 3
"d:\IDEWORK\lvmen\src\licensedcode\data\rules\false-positive_4012.yml", "YAML", 0, 0, 0, 2, 0, 0, 1, 3
"d:\IDEWORK\lvmen\src\licensedcode\data\rules\false-positive_4013.yml", "YAML", 0, 0, 0, 2, 0, 0, 1, 3
"d:\IDEWORK\lvmen\src\licensedcode\data\rules\false-positive_4014.yml", "YAML", 0, 0, 0, 2, 0, 0, 1, 3
"d:\IDEWORK\lvmen\src\licensedcode\data\rules\false-positive_4015.yml", "YAML", 0, 0, 0, 2, 0, 0, 1, 3
"d:\IDEWORK\lvmen\src\licensedcode\data\rules\false-positive_4016.yml", "YAML", 0, 0, 0, 2, 0, 0, 1, 3
"d:\IDEWORK\lvmen\src\licensedcode\data\rules\false-positive_4017.yml", "YAML", 0, 0, 0, 2, 0, 0, 1, 3
"d:\IDEWORK\lvmen\src\licensedcode\data\rules\false-positive_4018.yml", "YAML", 0, 0, 0, 2, 0, 0, 1, 3
"d:\IDEWORK\lvmen\src\licensedcode\data\rules\false-positive_4019.yml", "YAML", 0, 0, 0, 2, 0, 0, 1, 3
"d:\IDEWORK\lvmen\src\licensedcode\data\rules\false-positive_402.yml", "YAML", 0, 0, 0, 2, 0, 0, 1, 3
"d:\IDEWORK\lvmen\src\licensedcode\data\rules\false-positive_4020.yml", "YAML", 0, 0, 0, 2, 0, 0, 1, 3
"d:\IDEWORK\lvmen\src\licensedcode\data\rules\false-positive_4021.yml", "YAML", 0, 0, 0, 2, 0, 0, 1, 3
"d:\IDEWORK\lvmen\src\licensedcode\data\rules\false-positive_4022.yml", "YAML", 0, 0, 0, 2, 0, 0, 1, 3
"d:\IDEWORK\lvmen\src\licensedcode\data\rules\false-positive_4023.yml", "YAML", 0, 0, 0, 2, 0, 0, 1, 3
"d:\IDEWORK\lvmen\src\licensedcode\data\rules\false-positive_4024.yml", "YAML", 0, 0, 0, 2, 0, 0, 1, 3
"d:\IDEWORK\lvmen\src\licensedcode\data\rules\false-positive_4025.yml", "YAML", 0, 0, 0, 2, 0, 0, 1, 3
"d:\IDEWORK\lvmen\src\licensedcode\data\rules\false-positive_4026.yml", "YAML", 0, 0, 0, 2, 0, 0, 1, 3
"d:\IDEWORK\lvmen\src\licensedcode\data\rules\false-positive_4027.yml", "YAML", 0, 0, 0, 2, 0, 0, 1, 3
"d:\IDEWORK\lvmen\src\licensedcode\data\rules\false-positive_4028.yml", "YAML", 0, 0, 0, 2, 0, 0, 1, 3
"d:\IDEWORK\lvmen\src\licensedcode\data\rules\false-positive_4029.yml", "YAML", 0, 0, 0, 2, 0, 0, 1, 3
"d:\IDEWORK\lvmen\src\licensedcode\data\rules\false-positive_403.yml", "YAML", 0, 0, 0, 2, 0, 0, 1, 3
"d:\IDEWORK\lvmen\src\licensedcode\data\rules\false-positive_4030.yml", "YAML", 0, 0, 0, 2, 0, 0, 1, 3
"d:\IDEWORK\lvmen\src\licensedcode\data\rules\false-positive_4031.yml", "YAML", 0, 0, 0, 2, 0, 0, 1, 3
"d:\IDEWORK\lvmen\src\licensedcode\data\rules\false-positive_4032.yml", "YAML", 0, 0, 0, 2, 0, 0, 1, 3
"d:\IDEWORK\lvmen\src\licensedcode\data\rules\false-positive_4033.yml", "YAML", 0, 0, 0, 2, 0, 0, 1, 3
"d:\IDEWORK\lvmen\src\licensedcode\data\rules\false-positive_4034.yml", "YAML", 0, 0, 0, 2, 0, 0, 1, 3
"d:\IDEWORK\lvmen\src\licensedcode\data\rules\false-positive_4035.yml", "YAML", 0, 0, 0, 2, 0, 0, 1, 3
"d:\IDEWORK\lvmen\src\licensedcode\data\rules\false-positive_4036.yml", "YAML", 0, 0, 0, 2, 0, 0, 1, 3
"d:\IDEWORK\lvmen\src\licensedcode\data\rules\false-positive_4037.yml", "YAML", 0, 0, 0, 2, 0, 0, 1, 3
"d:\IDEWORK\lvmen\src\licensedcode\data\rules\false-positive_4038.yml", "YAML", 0, 0, 0, 2, 0, 0, 1, 3
"d:\IDEWORK\lvmen\src\licensedcode\data\rules\false-positive_4039.yml", "YAML", 0, 0, 0, 2, 0, 0, 1, 3
"d:\IDEWORK\lvmen\src\licensedcode\data\rules\false-positive_404.yml", "YAML", 0, 0, 0, 3, 0, 0, 1, 4
"d:\IDEWORK\lvmen\src\licensedcode\data\rules\false-positive_4040.yml", "YAML", 0, 0, 0, 2, 0, 0, 1, 3
"d:\IDEWORK\lvmen\src\licensedcode\data\rules\false-positive_4041.yml", "YAML", 0, 0, 0, 2, 0, 0, 1, 3
"d:\IDEWORK\lvmen\src\licensedcode\data\rules\false-positive_4042.yml", "YAML", 0, 0, 0, 2, 0, 0, 1, 3
"d:\IDEWORK\lvmen\src\licensedcode\data\rules\false-positive_4043.yml", "YAML", 0, 0, 0, 2, 0, 0, 1, 3
"d:\IDEWORK\lvmen\src\licensedcode\data\rules\false-positive_4044.yml", "YAML", 0, 0, 0, 2, 0, 0, 1, 3
"d:\IDEWORK\lvmen\src\licensedcode\data\rules\false-positive_4045.yml", "YAML", 0, 0, 0, 2, 0, 0, 1, 3
"d:\IDEWORK\lvmen\src\licensedcode\data\rules\false-positive_4046.yml", "YAML", 0, 0, 0, 2, 0, 0, 1, 3
"d:\IDEWORK\lvmen\src\licensedcode\data\rules\false-positive_4047.yml", "YAML", 0, 0, 0, 2, 0, 0, 1, 3
"d:\IDEWORK\lvmen\src\licensedcode\data\rules\false-positive_4048.yml", "YAML", 0, 0, 0, 2, 0, 0, 1, 3
"d:\IDEWORK\lvmen\src\licensedcode\data\rules\false-positive_4049.yml", "YAML", 0, 0, 0, 2, 0, 0, 1, 3
"d:\IDEWORK\lvmen\src\licensedcode\data\rules\false-positive_405.yml", "YAML", 0, 0, 0, 3, 0, 0, 1, 4
"d:\IDEWORK\lvmen\src\licensedcode\data\rules\false-positive_4050.yml", "YAML", 0, 0, 0, 2, 0, 0, 1, 3
"d:\IDEWORK\lvmen\src\licensedcode\data\rules\false-positive_4051.yml", "YAML", 0, 0, 0, 2, 0, 0, 1, 3
"d:\IDEWORK\lvmen\src\licensedcode\data\rules\false-positive_4052.yml", "YAML", 0, 0, 0, 2, 0, 0, 1, 3
"d:\IDEWORK\lvmen\src\licensedcode\data\rules\false-positive_4053.yml", "YAML", 0, 0, 0, 2, 0, 0, 1, 3
"d:\IDEWORK\lvmen\src\licensedcode\data\rules\false-positive_4054.yml", "YAML", 0, 0, 0, 2, 0, 0, 1, 3
"d:\IDEWORK\lvmen\src\licensedcode\data\rules\false-positive_4055.yml", "YAML", 0, 0, 0, 2, 0, 0, 1, 3
"d:\IDEWORK\lvmen\src\licensedcode\data\rules\false-positive_4056.yml", "YAML", 0, 0, 0, 2, 0, 0, 1, 3
"d:\IDEWORK\lvmen\src\licensedcode\data\rules\false-positive_4057.yml", "YAML", 0, 0, 0, 2, 0, 0, 1, 3
"d:\IDEWORK\lvmen\src\licensedcode\data\rules\false-positive_4058.yml", "YAML", 0, 0, 0, 2, 0, 0, 1, 3
"d:\IDEWORK\lvmen\src\licensedcode\data\rules\false-positive_4059.yml", "YAML", 0, 0, 0, 2, 0, 0, 1, 3
"d:\IDEWORK\lvmen\src\licensedcode\data\rules\false-positive_406.yml", "YAML", 0, 0, 0, 2, 0, 0, 1, 3
"d:\IDEWORK\lvmen\src\licensedcode\data\rules\false-positive_4060.yml", "YAML", 0, 0, 0, 2, 0, 0, 1, 3
"d:\IDEWORK\lvmen\src\licensedcode\data\rules\false-positive_4061.yml", "YAML", 0, 0, 0, 2, 0, 0, 1, 3
"d:\IDEWORK\lvmen\src\licensedcode\data\rules\false-positive_4062.yml", "YAML", 0, 0, 0, 2, 0, 0, 1, 3
"d:\IDEWORK\lvmen\src\licensedcode\data\rules\false-positive_4063.yml", "YAML", 0, 0, 0, 2, 0, 0, 1, 3
"d:\IDEWORK\lvmen\src\licensedcode\data\rules\false-positive_4064.yml", "YAML", 0, 0, 0, 2, 0, 0, 1, 3
"d:\IDEWORK\lvmen\src\licensedcode\data\rules\false-positive_4065.yml", "YAML", 0, 0, 0, 2, 0, 0, 1, 3
"d:\IDEWORK\lvmen\src\licensedcode\data\rules\false-positive_4066.yml", "YAML", 0, 0, 0, 2, 0, 0, 1, 3
"d:\IDEWORK\lvmen\src\licensedcode\data\rules\false-positive_4067.yml", "YAML", 0, 0, 0, 2, 0, 0, 1, 3
"d:\IDEWORK\lvmen\src\licensedcode\data\rules\false-positive_4068.yml", "YAML", 0, 0, 0, 2, 0, 0, 1, 3
"d:\IDEWORK\lvmen\src\licensedcode\data\rules\false-positive_4069.yml", "YAML", 0, 0, 0, 2, 0, 0, 1, 3
"d:\IDEWORK\lvmen\src\licensedcode\data\rules\false-positive_407.yml", "YAML", 0, 0, 0, 3, 0, 0, 1, 4
"d:\IDEWORK\lvmen\src\licensedcode\data\rules\false-positive_4070.yml", "YAML", 0, 0, 0, 2, 0, 0, 1, 3
"d:\IDEWORK\lvmen\src\licensedcode\data\rules\false-positive_4071.yml", "YAML", 0, 0, 0, 2, 0, 0, 1, 3
"d:\IDEWORK\lvmen\src\licensedcode\data\rules\false-positive_4072.yml", "YAML", 0, 0, 0, 2, 0, 0, 1, 3
"d:\IDEWORK\lvmen\src\licensedcode\data\rules\false-positive_4073.yml", "YAML", 0, 0, 0, 2, 0, 0, 1, 3
"d:\IDEWORK\lvmen\src\licensedcode\data\rules\false-positive_4074.yml", "YAML", 0, 0, 0, 2, 0, 0, 1, 3
"d:\IDEWORK\lvmen\src\licensedcode\data\rules\false-positive_4075.yml", "YAML", 0, 0, 0, 2, 0, 0, 1, 3
"d:\IDEWORK\lvmen\src\licensedcode\data\rules\false-positive_4076.yml", "YAML", 0, 0, 0, 2, 0, 0, 1, 3
"d:\IDEWORK\lvmen\src\licensedcode\data\rules\false-positive_4077.yml", "YAML", 0, 0, 0, 2, 0, 0, 1, 3
"d:\IDEWORK\lvmen\src\licensedcode\data\rules\false-positive_4078.yml", "YAML", 0, 0, 0, 2, 0, 0, 1, 3
"d:\IDEWORK\lvmen\src\licensedcode\data\rules\false-positive_4079.yml", "YAML", 0, 0, 0, 2, 0, 0, 1, 3
"d:\IDEWORK\lvmen\src\licensedcode\data\rules\false-positive_408.yml", "YAML", 0, 0, 0, 3, 0, 0, 1, 4
"d:\IDEWORK\lvmen\src\licensedcode\data\rules\false-positive_4080.yml", "YAML", 0, 0, 0, 2, 0, 0, 1, 3
"d:\IDEWORK\lvmen\src\licensedcode\data\rules\false-positive_4081.yml", "YAML", 0, 0, 0, 2, 0, 0, 1, 3
"d:\IDEWORK\lvmen\src\licensedcode\data\rules\false-positive_4082.yml", "YAML", 0, 0, 0, 2, 0, 0, 1, 3
"d:\IDEWORK\lvmen\src\licensedcode\data\rules\false-positive_4083.yml", "YAML", 0, 0, 0, 2, 0, 0, 1, 3
"d:\IDEWORK\lvmen\src\licensedcode\data\rules\false-positive_4084.yml", "YAML", 0, 0, 0, 2, 0, 0, 1, 3
"d:\IDEWORK\lvmen\src\licensedcode\data\rules\false-positive_4085.yml", "YAML", 0, 0, 0, 2, 0, 0, 1, 3
"d:\IDEWORK\lvmen\src\licensedcode\data\rules\false-positive_4086.yml", "YAML", 0, 0, 0, 2, 0, 0, 1, 3
"d:\IDEWORK\lvmen\src\licensedcode\data\rules\false-positive_4087.yml", "YAML", 0, 0, 0, 2, 0, 0, 1, 3
"d:\IDEWORK\lvmen\src\licensedcode\data\rules\false-positive_4088.yml", "YAML", 0, 0, 0, 2, 0, 0, 1, 3
"d:\IDEWORK\lvmen\src\licensedcode\data\rules\false-positive_4089.yml", "YAML", 0, 0, 0, 2, 0, 0, 1, 3
"d:\IDEWORK\lvmen\src\licensedcode\data\rules\false-positive_409.yml", "YAML", 0, 0, 0, 3, 0, 0, 1, 4
"d:\IDEWORK\lvmen\src\licensedcode\data\rules\false-positive_4090.yml", "YAML", 0, 0, 0, 2, 0, 0, 1, 3
"d:\IDEWORK\lvmen\src\licensedcode\data\rules\false-positive_4091.yml", "YAML", 0, 0, 0, 2, 0, 0, 1, 3
"d:\IDEWORK\lvmen\src\licensedcode\data\rules\false-positive_4092.yml", "YAML", 0, 0, 0, 2, 0, 0, 1, 3
"d:\IDEWORK\lvmen\src\licensedcode\data\rules\false-positive_4093.yml", "YAML", 0, 0, 0, 2, 0, 0, 1, 3
"d:\IDEWORK\lvmen\src\licensedcode\data\rules\false-positive_4094.yml", "YAML", 0, 0, 0, 2, 0, 0, 1, 3
"d:\IDEWORK\lvmen\src\licensedcode\data\rules\false-positive_4095.yml", "YAML", 0, 0, 0, 2, 0, 0, 1, 3
"d:\IDEWORK\lvmen\src\licensedcode\data\rules\false-positive_4096.yml", "YAML", 0, 0, 0, 2, 0, 0, 1, 3
"d:\IDEWORK\lvmen\src\licensedcode\data\rules\false-positive_4097.yml", "YAML", 0, 0, 0, 2, 0, 0, 1, 3
"d:\IDEWORK\lvmen\src\licensedcode\data\rules\false-positive_4098.yml", "YAML", 0, 0, 0, 2, 0, 0, 1, 3
"d:\IDEWORK\lvmen\src\licensedcode\data\rules\false-positive_4099.yml", "YAML", 0, 0, 0, 2, 0, 0, 1, 3
"d:\IDEWORK\lvmen\src\licensedcode\data\rules\false-positive_41.yml", "YAML", 0, 0, 0, 2, 0, 0, 1, 3
"d:\IDEWORK\lvmen\src\licensedcode\data\rules\false-positive_410.yml", "YAML", 0, 0, 0, 2, 0, 0, 1, 3
"d:\IDEWORK\lvmen\src\licensedcode\data\rules\false-positive_4100.yml", "YAML", 0, 0, 0, 2, 0, 0, 1, 3
"d:\IDEWORK\lvmen\src\licensedcode\data\rules\false-positive_4101.yml", "YAML", 0, 0, 0, 2, 0, 0, 1, 3
"d:\IDEWORK\lvmen\src\licensedcode\data\rules\false-positive_4102.yml", "YAML", 0, 0, 0, 2, 0, 0, 1, 3
"d:\IDEWORK\lvmen\src\licensedcode\data\rules\false-positive_4103.yml", "YAML", 0, 0, 0, 2, 0, 0, 1, 3
"d:\IDEWORK\lvmen\src\licensedcode\data\rules\false-positive_4104.yml", "YAML", 0, 0, 0, 2, 0, 0, 1, 3
"d:\IDEWORK\lvmen\src\licensedcode\data\rules\false-positive_4105.yml", "YAML", 0, 0, 0, 2, 0, 0, 1, 3
"d:\IDEWORK\lvmen\src\licensedcode\data\rules\false-positive_4106.yml", "YAML", 0, 0, 0, 2, 0, 0, 1, 3
"d:\IDEWORK\lvmen\src\licensedcode\data\rules\false-positive_4107.yml", "YAML", 0, 0, 0, 2, 0, 0, 1, 3
"d:\IDEWORK\lvmen\src\licensedcode\data\rules\false-positive_4108.yml", "YAML", 0, 0, 0, 2, 0, 0, 1, 3
"d:\IDEWORK\lvmen\src\licensedcode\data\rules\false-positive_4109.yml", "YAML", 0, 0, 0, 2, 0, 0, 1, 3
"d:\IDEWORK\lvmen\src\licensedcode\data\rules\false-positive_411.yml", "YAML", 0, 0, 0, 2, 0, 0, 1, 3
"d:\IDEWORK\lvmen\src\licensedcode\data\rules\false-positive_4110.yml", "YAML", 0, 0, 0, 2, 0, 0, 1, 3
"d:\IDEWORK\lvmen\src\licensedcode\data\rules\false-positive_4111.yml", "YAML", 0, 0, 0, 2, 0, 0, 1, 3
"d:\IDEWORK\lvmen\src\licensedcode\data\rules\false-positive_4112.yml", "YAML", 0, 0, 0, 2, 0, 0, 1, 3
"d:\IDEWORK\lvmen\src\licensedcode\data\rules\false-positive_4113.yml", "YAML", 0, 0, 0, 2, 0, 0, 1, 3
"d:\IDEWORK\lvmen\src\licensedcode\data\rules\false-positive_4114.yml", "YAML", 0, 0, 0, 2, 0, 0, 1, 3
"d:\IDEWORK\lvmen\src\licensedcode\data\rules\false-positive_4115.yml", "YAML", 0, 0, 0, 2, 0, 0, 1, 3
"d:\IDEWORK\lvmen\src\licensedcode\data\rules\false-positive_4116.yml", "YAML", 0, 0, 0, 2, 0, 0, 1, 3
"d:\IDEWORK\lvmen\src\licensedcode\data\rules\false-positive_4117.yml", "YAML", 0, 0, 0, 2, 0, 0, 1, 3
"d:\IDEWORK\lvmen\src\licensedcode\data\rules\false-positive_4118.yml", "YAML", 0, 0, 0, 2, 0, 0, 1, 3
"d:\IDEWORK\lvmen\src\licensedcode\data\rules\false-positive_4119.yml", "YAML", 0, 0, 0, 2, 0, 0, 1, 3
"d:\IDEWORK\lvmen\src\licensedcode\data\rules\false-positive_412.yml", "YAML", 0, 0, 0, 2, 0, 0, 1, 3
"d:\IDEWORK\lvmen\src\licensedcode\data\rules\false-positive_4120.yml", "YAML", 0, 0, 0, 2, 0, 0, 1, 3
"d:\IDEWORK\lvmen\src\licensedcode\data\rules\false-positive_4121.yml", "YAML", 0, 0, 0, 2, 0, 0, 1, 3
"d:\IDEWORK\lvmen\src\licensedcode\data\rules\false-positive_4122.yml", "YAML", 0, 0, 0, 2, 0, 0, 1, 3
"d:\IDEWORK\lvmen\src\licensedcode\data\rules\false-positive_4123.yml", "YAML", 0, 0, 0, 2, 0, 0, 1, 3
"d:\IDEWORK\lvmen\src\licensedcode\data\rules\false-positive_4124.yml", "YAML", 0, 0, 0, 2, 0, 0, 1, 3
"d:\IDEWORK\lvmen\src\licensedcode\data\rules\false-positive_4125.yml", "YAML", 0, 0, 0, 2, 0, 0, 1, 3
"d:\IDEWORK\lvmen\src\licensedcode\data\rules\false-positive_4126.yml", "YAML", 0, 0, 0, 2, 0, 0, 1, 3
"d:\IDEWORK\lvmen\src\licensedcode\data\rules\false-positive_4127.yml", "YAML", 0, 0, 0, 2, 0, 0, 1, 3
"d:\IDEWORK\lvmen\src\licensedcode\data\rules\false-positive_4128.yml", "YAML", 0, 0, 0, 2, 0, 0, 1, 3
"d:\IDEWORK\lvmen\src\licensedcode\data\rules\false-positive_4129.yml", "YAML", 0, 0, 0, 2, 0, 0, 1, 3
"d:\IDEWORK\lvmen\src\licensedcode\data\rules\false-positive_413.yml", "YAML", 0, 0, 0, 2, 0, 0, 1, 3
"d:\IDEWORK\lvmen\src\licensedcode\data\rules\false-positive_4130.yml", "YAML", 0, 0, 0, 2, 0, 0, 1, 3
"d:\IDEWORK\lvmen\src\licensedcode\data\rules\false-positive_4131.yml", "YAML", 0, 0, 0, 2, 0, 0, 1, 3
"d:\IDEWORK\lvmen\src\licensedcode\data\rules\false-positive_4132.yml", "YAML", 0, 0, 0, 2, 0, 0, 1, 3
"d:\IDEWORK\lvmen\src\licensedcode\data\rules\false-positive_4133.yml", "YAML", 0, 0, 0, 2, 0, 0, 1, 3
"d:\IDEWORK\lvmen\src\licensedcode\data\rules\false-positive_4134.yml", "YAML", 0, 0, 0, 2, 0, 0, 1, 3
"d:\IDEWORK\lvmen\src\licensedcode\data\rules\false-positive_4135.yml", "YAML", 0, 0, 0, 2, 0, 0, 1, 3
"d:\IDEWORK\lvmen\src\licensedcode\data\rules\false-positive_4136.yml", "YAML", 0, 0, 0, 2, 0, 0, 1, 3
"d:\IDEWORK\lvmen\src\licensedcode\data\rules\false-positive_4137.yml", "YAML", 0, 0, 0, 2, 0, 0, 1, 3
"d:\IDEWORK\lvmen\src\licensedcode\data\rules\false-positive_4138.yml", "YAML", 0, 0, 0, 2, 0, 0, 1, 3
"d:\IDEWORK\lvmen\src\licensedcode\data\rules\false-positive_4139.yml", "YAML", 0, 0, 0, 2, 0, 0, 1, 3
"d:\IDEWORK\lvmen\src\licensedcode\data\rules\false-positive_414.yml", "YAML", 0, 0, 0, 2, 0, 0, 1, 3
"d:\IDEWORK\lvmen\src\licensedcode\data\rules\false-positive_4140.yml", "YAML", 0, 0, 0, 2, 0, 0, 1, 3
"d:\IDEWORK\lvmen\src\licensedcode\data\rules\false-positive_4141.yml", "YAML", 0, 0, 0, 2, 0, 0, 1, 3
"d:\IDEWORK\lvmen\src\licensedcode\data\rules\false-positive_4142.yml", "YAML", 0, 0, 0, 2, 0, 0, 1, 3
"d:\IDEWORK\lvmen\src\licensedcode\data\rules\false-positive_4143.yml", "YAML", 0, 0, 0, 2, 0, 0, 1, 3
"d:\IDEWORK\lvmen\src\licensedcode\data\rules\false-positive_4144.yml", "YAML", 0, 0, 0, 2, 0, 0, 1, 3
"d:\IDEWORK\lvmen\src\licensedcode\data\rules\false-positive_4145.yml", "YAML", 0, 0, 0, 2, 0, 0, 1, 3
"d:\IDEWORK\lvmen\src\licensedcode\data\rules\false-positive_4146.yml", "YAML", 0, 0, 0, 2, 0, 0, 1, 3
"d:\IDEWORK\lvmen\src\licensedcode\data\rules\false-positive_4147.yml", "YAML", 0, 0, 0, 2, 0, 0, 1, 3
"d:\IDEWORK\lvmen\src\licensedcode\data\rules\false-positive_4148.yml", "YAML", 0, 0, 0, 2, 0, 0, 1, 3
"d:\IDEWORK\lvmen\src\licensedcode\data\rules\false-positive_4149.yml", "YAML", 0, 0, 0, 2, 0, 0, 1, 3
"d:\IDEWORK\lvmen\src\licensedcode\data\rules\false-positive_415.yml", "YAML", 0, 0, 0, 2, 0, 0, 1, 3
"d:\IDEWORK\lvmen\src\licensedcode\data\rules\false-positive_4150.yml", "YAML", 0, 0, 0, 2, 0, 0, 1, 3
"d:\IDEWORK\lvmen\src\licensedcode\data\rules\false-positive_4151.yml", "YAML", 0, 0, 0, 2, 0, 0, 1, 3
"d:\IDEWORK\lvmen\src\licensedcode\data\rules\false-positive_4152.yml", "YAML", 0, 0, 0, 2, 0, 0, 1, 3
"d:\IDEWORK\lvmen\src\licensedcode\data\rules\false-positive_4153.yml", "YAML", 0, 0, 0, 2, 0, 0, 1, 3
"d:\IDEWORK\lvmen\src\licensedcode\data\rules\false-positive_4154.yml", "YAML", 0, 0, 0, 2, 0, 0, 1, 3
"d:\IDEWORK\lvmen\src\licensedcode\data\rules\false-positive_4155.yml", "YAML", 0, 0, 0, 2, 0, 0, 1, 3
"d:\IDEWORK\lvmen\src\licensedcode\data\rules\false-positive_4156.yml", "YAML", 0, 0, 0, 2, 0, 0, 1, 3
"d:\IDEWORK\lvmen\src\licensedcode\data\rules\false-positive_4157.yml", "YAML", 0, 0, 0, 2, 0, 0, 1, 3
"d:\IDEWORK\lvmen\src\licensedcode\data\rules\false-positive_4158.yml", "YAML", 0, 0, 0, 2, 0, 0, 1, 3
"d:\IDEWORK\lvmen\src\licensedcode\data\rules\false-positive_4159.yml", "YAML", 0, 0, 0, 2, 0, 0, 1, 3
"d:\IDEWORK\lvmen\src\licensedcode\data\rules\false-positive_416.yml", "YAML", 0, 0, 0, 2, 0, 0, 1, 3
"d:\IDEWORK\lvmen\src\licensedcode\data\rules\false-positive_4160.yml", "YAML", 0, 0, 0, 2, 0, 0, 1, 3
"d:\IDEWORK\lvmen\src\licensedcode\data\rules\false-positive_4161.yml", "YAML", 0, 0, 0, 2, 0, 0, 1, 3
"d:\IDEWORK\lvmen\src\licensedcode\data\rules\false-positive_4162.yml", "YAML", 0, 0, 0, 2, 0, 0, 1, 3
"d:\IDEWORK\lvmen\src\licensedcode\data\rules\false-positive_4163.yml", "YAML", 0, 0, 0, 2, 0, 0, 1, 3
"d:\IDEWORK\lvmen\src\licensedcode\data\rules\false-positive_4164.yml", "YAML", 0, 0, 0, 2, 0, 0, 1, 3
"d:\IDEWORK\lvmen\src\licensedcode\data\rules\false-positive_4165.yml", "YAML", 0, 0, 0, 2, 0, 0, 1, 3
"d:\IDEWORK\lvmen\src\licensedcode\data\rules\false-positive_4166.yml", "YAML", 0, 0, 0, 2, 0, 0, 1, 3
"d:\IDEWORK\lvmen\src\licensedcode\data\rules\false-positive_4167.yml", "YAML", 0, 0, 0, 2, 0, 0, 1, 3
"d:\IDEWORK\lvmen\src\licensedcode\data\rules\false-positive_4168.yml", "YAML", 0, 0, 0, 2, 0, 0, 1, 3
"d:\IDEWORK\lvmen\src\licensedcode\data\rules\false-positive_4169.yml", "YAML", 0, 0, 0, 2, 0, 0, 1, 3
"d:\IDEWORK\lvmen\src\licensedcode\data\rules\false-positive_417.yml", "YAML", 0, 0, 0, 2, 0, 0, 1, 3
"d:\IDEWORK\lvmen\src\licensedcode\data\rules\false-positive_4170.yml", "YAML", 0, 0, 0, 2, 0, 0, 1, 3
"d:\IDEWORK\lvmen\src\licensedcode\data\rules\false-positive_4171.yml", "YAML", 0, 0, 0, 2, 0, 0, 1, 3
"d:\IDEWORK\lvmen\src\licensedcode\data\rules\false-positive_4172.yml", "YAML", 0, 0, 0, 2, 0, 0, 1, 3
"d:\IDEWORK\lvmen\src\licensedcode\data\rules\false-positive_4173.yml", "YAML", 0, 0, 0, 2, 0, 0, 1, 3
"d:\IDEWORK\lvmen\src\licensedcode\data\rules\false-positive_4174.yml", "YAML", 0, 0, 0, 2, 0, 0, 1, 3
"d:\IDEWORK\lvmen\src\licensedcode\data\rules\false-positive_4175.yml", "YAML", 0, 0, 0, 2, 0, 0, 1, 3
"d:\IDEWORK\lvmen\src\licensedcode\data\rules\false-positive_4176.yml", "YAML", 0, 0, 0, 2, 0, 0, 1, 3
"d:\IDEWORK\lvmen\src\licensedcode\data\rules\false-positive_4177.yml", "YAML", 0, 0, 0, 2, 0, 0, 1, 3
"d:\IDEWORK\lvmen\src\licensedcode\data\rules\false-positive_4178.yml", "YAML", 0, 0, 0, 2, 0, 0, 1, 3
"d:\IDEWORK\lvmen\src\licensedcode\data\rules\false-positive_4179.yml", "YAML", 0, 0, 0, 2, 0, 0, 1, 3
"d:\IDEWORK\lvmen\src\licensedcode\data\rules\false-positive_418.yml", "YAML", 0, 0, 0, 2, 0, 0, 1, 3
"d:\IDEWORK\lvmen\src\licensedcode\data\rules\false-positive_4180.yml", "YAML", 0, 0, 0, 2, 0, 0, 1, 3
"d:\IDEWORK\lvmen\src\licensedcode\data\rules\false-positive_4181.yml", "YAML", 0, 0, 0, 2, 0, 0, 1, 3
"d:\IDEWORK\lvmen\src\licensedcode\data\rules\false-positive_4182.yml", "YAML", 0, 0, 0, 2, 0, 0, 1, 3
"d:\IDEWORK\lvmen\src\licensedcode\data\rules\false-positive_4183.yml", "YAML", 0, 0, 0, 2, 0, 0, 1, 3
"d:\IDEWORK\lvmen\src\licensedcode\data\rules\false-positive_4184.yml", "YAML", 0, 0, 0, 2, 0, 0, 1, 3
"d:\IDEWORK\lvmen\src\licensedcode\data\rules\false-positive_4185.yml", "YAML", 0, 0, 0, 2, 0, 0, 1, 3
"d:\IDEWORK\lvmen\src\licensedcode\data\rules\false-positive_4186.yml", "YAML", 0, 0, 0, 2, 0, 0, 1, 3
"d:\IDEWORK\lvmen\src\licensedcode\data\rules\false-positive_4187.yml", "YAML", 0, 0, 0, 2, 0, 0, 1, 3
"d:\IDEWORK\lvmen\src\licensedcode\data\rules\false-positive_4188.yml", "YAML", 0, 0, 0, 2, 0, 0, 1, 3
"d:\IDEWORK\lvmen\src\licensedcode\data\rules\false-positive_4189.yml", "YAML", 0, 0, 0, 2, 0, 0, 1, 3
"d:\IDEWORK\lvmen\src\licensedcode\data\rules\false-positive_419.yml", "YAML", 0, 0, 0, 2, 0, 0, 1, 3
"d:\IDEWORK\lvmen\src\licensedcode\data\rules\false-positive_4190.yml", "YAML", 0, 0, 0, 2, 0, 0, 1, 3
"d:\IDEWORK\lvmen\src\licensedcode\data\rules\false-positive_4191.yml", "YAML", 0, 0, 0, 2, 0, 0, 1, 3
"d:\IDEWORK\lvmen\src\licensedcode\data\rules\false-positive_4192.yml", "YAML", 0, 0, 0, 2, 0, 0, 1, 3
"d:\IDEWORK\lvmen\src\licensedcode\data\rules\false-positive_4193.yml", "YAML", 0, 0, 0, 2, 0, 0, 1, 3
"d:\IDEWORK\lvmen\src\licensedcode\data\rules\false-positive_4194.yml", "YAML", 0, 0, 0, 2, 0, 0, 1, 3
"d:\IDEWORK\lvmen\src\licensedcode\data\rules\false-positive_4195.yml", "YAML", 0, 0, 0, 2, 0, 0, 1, 3
"d:\IDEWORK\lvmen\src\licensedcode\data\rules\false-positive_4196.yml", "YAML", 0, 0, 0, 2, 0, 0, 1, 3
"d:\IDEWORK\lvmen\src\licensedcode\data\rules\false-positive_4197.yml", "YAML", 0, 0, 0, 2, 0, 0, 1, 3
"d:\IDEWORK\lvmen\src\licensedcode\data\rules\false-positive_4198.yml", "YAML", 0, 0, 0, 2, 0, 0, 1, 3
"d:\IDEWORK\lvmen\src\licensedcode\data\rules\false-positive_4199.yml", "YAML", 0, 0, 0, 2, 0, 0, 1, 3
"d:\IDEWORK\lvmen\src\licensedcode\data\rules\false-positive_42.yml", "YAML", 0, 0, 0, 2, 0, 0, 1, 3
"d:\IDEWORK\lvmen\src\licensedcode\data\rules\false-positive_420.yml", "YAML", 0, 0, 0, 2, 0, 0, 1, 3
"d:\IDEWORK\lvmen\src\licensedcode\data\rules\false-positive_4200.yml", "YAML", 0, 0, 0, 2, 0, 0, 1, 3
"d:\IDEWORK\lvmen\src\licensedcode\data\rules\false-positive_4201.yml", "YAML", 0, 0, 0, 2, 0, 0, 1, 3
"d:\IDEWORK\lvmen\src\licensedcode\data\rules\false-positive_4202.yml", "YAML", 0, 0, 0, 2, 0, 0, 1, 3
"d:\IDEWORK\lvmen\src\licensedcode\data\rules\false-positive_4203.yml", "YAML", 0, 0, 0, 2, 0, 0, 1, 3
"d:\IDEWORK\lvmen\src\licensedcode\data\rules\false-positive_4204.yml", "YAML", 0, 0, 0, 2, 0, 0, 1, 3
"d:\IDEWORK\lvmen\src\licensedcode\data\rules\false-positive_4205.yml", "YAML", 0, 0, 0, 2, 0, 0, 1, 3
"d:\IDEWORK\lvmen\src\licensedcode\data\rules\false-positive_4206.yml", "YAML", 0, 0, 0, 2, 0, 0, 1, 3
"d:\IDEWORK\lvmen\src\licensedcode\data\rules\false-positive_4207.yml", "YAML", 0, 0, 0, 2, 0, 0, 1, 3
"d:\IDEWORK\lvmen\src\licensedcode\data\rules\false-positive_4208.yml", "YAML", 0, 0, 0, 2, 0, 0, 1, 3
"d:\IDEWORK\lvmen\src\licensedcode\data\rules\false-positive_4209.yml", "YAML", 0, 0, 0, 2, 0, 0, 1, 3
"d:\IDEWORK\lvmen\src\licensedcode\data\rules\false-positive_421.yml", "YAML", 0, 0, 0, 2, 0, 0, 1, 3
"d:\IDEWORK\lvmen\src\licensedcode\data\rules\false-positive_4210.yml", "YAML", 0, 0, 0, 2, 0, 0, 1, 3
"d:\IDEWORK\lvmen\src\licensedcode\data\rules\false-positive_4211.yml", "YAML", 0, 0, 0, 2, 0, 0, 1, 3
"d:\IDEWORK\lvmen\src\licensedcode\data\rules\false-positive_4212.yml", "YAML", 0, 0, 0, 2, 0, 0, 1, 3
"d:\IDEWORK\lvmen\src\licensedcode\data\rules\false-positive_4213.yml", "YAML", 0, 0, 0, 2, 0, 0, 1, 3
"d:\IDEWORK\lvmen\src\licensedcode\data\rules\false-positive_4214.yml", "YAML", 0, 0, 0, 2, 0, 0, 1, 3
"d:\IDEWORK\lvmen\src\licensedcode\data\rules\false-positive_4215.yml", "YAML", 0, 0, 0, 2, 0, 0, 1, 3
"d:\IDEWORK\lvmen\src\licensedcode\data\rules\false-positive_4216.yml", "YAML", 0, 0, 0, 2, 0, 0, 1, 3
"d:\IDEWORK\lvmen\src\licensedcode\data\rules\false-positive_4217.yml", "YAML", 0, 0, 0, 2, 0, 0, 1, 3
"d:\IDEWORK\lvmen\src\licensedcode\data\rules\false-positive_4218.yml", "YAML", 0, 0, 0, 2, 0, 0, 1, 3
"d:\IDEWORK\lvmen\src\licensedcode\data\rules\false-positive_4219.yml", "YAML", 0, 0, 0, 2, 0, 0, 1, 3
"d:\IDEWORK\lvmen\src\licensedcode\data\rules\false-positive_422.yml", "YAML", 0, 0, 0, 2, 0, 0, 1, 3
"d:\IDEWORK\lvmen\src\licensedcode\data\rules\false-positive_4220.yml", "YAML", 0, 0, 0, 2, 0, 0, 1, 3
"d:\IDEWORK\lvmen\src\licensedcode\data\rules\false-positive_4221.yml", "YAML", 0, 0, 0, 2, 0, 0, 1, 3
"d:\IDEWORK\lvmen\src\licensedcode\data\rules\false-positive_4222.yml", "YAML", 0, 0, 0, 2, 0, 0, 1, 3
"d:\IDEWORK\lvmen\src\licensedcode\data\rules\false-positive_4223.yml", "YAML", 0, 0, 0, 2, 0, 0, 1, 3
"d:\IDEWORK\lvmen\src\licensedcode\data\rules\false-positive_4224.yml", "YAML", 0, 0, 0, 2, 0, 0, 1, 3
"d:\IDEWORK\lvmen\src\licensedcode\data\rules\false-positive_4225.yml", "YAML", 0, 0, 0, 2, 0, 0, 1, 3
"d:\IDEWORK\lvmen\src\licensedcode\data\rules\false-positive_4226.yml", "YAML", 0, 0, 0, 2, 0, 0, 1, 3
"d:\IDEWORK\lvmen\src\licensedcode\data\rules\false-positive_4227.yml", "YAML", 0, 0, 0, 2, 0, 0, 1, 3
"d:\IDEWORK\lvmen\src\licensedcode\data\rules\false-positive_4228.yml", "YAML", 0, 0, 0, 2, 0, 0, 1, 3
"d:\IDEWORK\lvmen\src\licensedcode\data\rules\false-positive_4229.yml", "YAML", 0, 0, 0, 2, 0, 0, 1, 3
"d:\IDEWORK\lvmen\src\licensedcode\data\rules\false-positive_423.yml", "YAML", 0, 0, 0, 2, 0, 0, 1, 3
"d:\IDEWORK\lvmen\src\licensedcode\data\rules\false-positive_4230.yml", "YAML", 0, 0, 0, 2, 0, 0, 1, 3
"d:\IDEWORK\lvmen\src\licensedcode\data\rules\false-positive_4231.yml", "YAML", 0, 0, 0, 2, 0, 0, 1, 3
"d:\IDEWORK\lvmen\src\licensedcode\data\rules\false-positive_4232.yml", "YAML", 0, 0, 0, 2, 0, 0, 1, 3
"d:\IDEWORK\lvmen\src\licensedcode\data\rules\false-positive_4233.yml", "YAML", 0, 0, 0, 2, 0, 0, 1, 3
"d:\IDEWORK\lvmen\src\licensedcode\data\rules\false-positive_4234.yml", "YAML", 0, 0, 0, 2, 0, 0, 1, 3
"d:\IDEWORK\lvmen\src\licensedcode\data\rules\false-positive_4235.yml", "YAML", 0, 0, 0, 2, 0, 0, 1, 3
"d:\IDEWORK\lvmen\src\licensedcode\data\rules\false-positive_4236.yml", "YAML", 0, 0, 0, 2, 0, 0, 1, 3
"d:\IDEWORK\lvmen\src\licensedcode\data\rules\false-positive_4237.yml", "YAML", 0, 0, 0, 2, 0, 0, 1, 3
"d:\IDEWORK\lvmen\src\licensedcode\data\rules\false-positive_4238.yml", "YAML", 0, 0, 0, 2, 0, 0, 1, 3
"d:\IDEWORK\lvmen\src\licensedcode\data\rules\false-positive_4239.yml", "YAML", 0, 0, 0, 2, 0, 0, 1, 3
"d:\IDEWORK\lvmen\src\licensedcode\data\rules\false-positive_424.yml", "YAML", 0, 0, 0, 2, 0, 0, 1, 3
"d:\IDEWORK\lvmen\src\licensedcode\data\rules\false-positive_4240.yml", "YAML", 0, 0, 0, 2, 0, 0, 1, 3
"d:\IDEWORK\lvmen\src\licensedcode\data\rules\false-positive_4241.yml", "YAML", 0, 0, 0, 2, 0, 0, 1, 3
"d:\IDEWORK\lvmen\src\licensedcode\data\rules\false-positive_4242.yml", "YAML", 0, 0, 0, 2, 0, 0, 1, 3
"d:\IDEWORK\lvmen\src\licensedcode\data\rules\false-positive_4243.yml", "YAML", 0, 0, 0, 2, 0, 0, 1, 3
"d:\IDEWORK\lvmen\src\licensedcode\data\rules\false-positive_4244.yml", "YAML", 0, 0, 0, 2, 0, 0, 1, 3
"d:\IDEWORK\lvmen\src\licensedcode\data\rules\false-positive_4245.yml", "YAML", 0, 0, 0, 2, 0, 0, 1, 3
"d:\IDEWORK\lvmen\src\licensedcode\data\rules\false-positive_4246.yml", "YAML", 0, 0, 0, 2, 0, 0, 1, 3
"d:\IDEWORK\lvmen\src\licensedcode\data\rules\false-positive_4247.yml", "YAML", 0, 0, 0, 2, 0, 0, 1, 3
"d:\IDEWORK\lvmen\src\licensedcode\data\rules\false-positive_4248.yml", "YAML", 0, 0, 0, 2, 0, 0, 1, 3
"d:\IDEWORK\lvmen\src\licensedcode\data\rules\false-positive_4249.yml", "YAML", 0, 0, 0, 2, 0, 0, 1, 3
"d:\IDEWORK\lvmen\src\licensedcode\data\rules\false-positive_425.yml", "YAML", 0, 0, 0, 2, 0, 0, 1, 3
"d:\IDEWORK\lvmen\src\licensedcode\data\rules\false-positive_4250.yml", "YAML", 0, 0, 0, 2, 0, 0, 1, 3
"d:\IDEWORK\lvmen\src\licensedcode\data\rules\false-positive_4251.yml", "YAML", 0, 0, 0, 2, 0, 0, 1, 3
"d:\IDEWORK\lvmen\src\licensedcode\data\rules\false-positive_4252.yml", "YAML", 0, 0, 0, 2, 0, 0, 1, 3
"d:\IDEWORK\lvmen\src\licensedcode\data\rules\false-positive_4253.yml", "YAML", 0, 0, 0, 2, 0, 0, 1, 3
"d:\IDEWORK\lvmen\src\licensedcode\data\rules\false-positive_4254.yml", "YAML", 0, 0, 0, 2, 0, 0, 1, 3
"d:\IDEWORK\lvmen\src\licensedcode\data\rules\false-positive_4255.yml", "YAML", 0, 0, 0, 2, 0, 0, 1, 3
"d:\IDEWORK\lvmen\src\licensedcode\data\rules\false-positive_4256.yml", "YAML", 0, 0, 0, 2, 0, 0, 1, 3
"d:\IDEWORK\lvmen\src\licensedcode\data\rules\false-positive_4257.yml", "YAML", 0, 0, 0, 2, 0, 0, 1, 3
"d:\IDEWORK\lvmen\src\licensedcode\data\rules\false-positive_4258.yml", "YAML", 0, 0, 0, 2, 0, 0, 1, 3
"d:\IDEWORK\lvmen\src\licensedcode\data\rules\false-positive_4259.yml", "YAML", 0, 0, 0, 2, 0, 0, 1, 3
"d:\IDEWORK\lvmen\src\licensedcode\data\rules\false-positive_426.yml", "YAML", 0, 0, 0, 2, 0, 0, 1, 3
"d:\IDEWORK\lvmen\src\licensedcode\data\rules\false-positive_4260.yml", "YAML", 0, 0, 0, 2, 0, 0, 1, 3
"d:\IDEWORK\lvmen\src\licensedcode\data\rules\false-positive_4261.yml", "YAML", 0, 0, 0, 2, 0, 0, 1, 3
"d:\IDEWORK\lvmen\src\licensedcode\data\rules\false-positive_4262.yml", "YAML", 0, 0, 0, 2, 0, 0, 1, 3
"d:\IDEWORK\lvmen\src\licensedcode\data\rules\false-positive_4263.yml", "YAML", 0, 0, 0, 2, 0, 0, 1, 3
"d:\IDEWORK\lvmen\src\licensedcode\data\rules\false-positive_4264.yml", "YAML", 0, 0, 0, 2, 0, 0, 1, 3
"d:\IDEWORK\lvmen\src\licensedcode\data\rules\false-positive_4265.yml", "YAML", 0, 0, 0, 2, 0, 0, 1, 3
"d:\IDEWORK\lvmen\src\licensedcode\data\rules\false-positive_4266.yml", "YAML", 0, 0, 0, 2, 0, 0, 1, 3
"d:\IDEWORK\lvmen\src\licensedcode\data\rules\false-positive_4267.yml", "YAML", 0, 0, 0, 2, 0, 0, 1, 3
"d:\IDEWORK\lvmen\src\licensedcode\data\rules\false-positive_4268.yml", "YAML", 0, 0, 0, 2, 0, 0, 1, 3
"d:\IDEWORK\lvmen\src\licensedcode\data\rules\false-positive_4269.yml", "YAML", 0, 0, 0, 2, 0, 0, 1, 3
"d:\IDEWORK\lvmen\src\licensedcode\data\rules\false-positive_427.yml", "YAML", 0, 0, 0, 3, 0, 0, 1, 4
"d:\IDEWORK\lvmen\src\licensedcode\data\rules\false-positive_4270.yml", "YAML", 0, 0, 0, 2, 0, 0, 1, 3
"d:\IDEWORK\lvmen\src\licensedcode\data\rules\false-positive_4271.yml", "YAML", 0, 0, 0, 2, 0, 0, 1, 3
"d:\IDEWORK\lvmen\src\licensedcode\data\rules\false-positive_4272.yml", "YAML", 0, 0, 0, 2, 0, 0, 1, 3
"d:\IDEWORK\lvmen\src\licensedcode\data\rules\false-positive_4273.yml", "YAML", 0, 0, 0, 2, 0, 0, 1, 3
"d:\IDEWORK\lvmen\src\licensedcode\data\rules\false-positive_4274.yml", "YAML", 0, 0, 0, 2, 0, 0, 1, 3
"d:\IDEWORK\lvmen\src\licensedcode\data\rules\false-positive_4275.yml", "YAML", 0, 0, 0, 2, 0, 0, 1, 3
"d:\IDEWORK\lvmen\src\licensedcode\data\rules\false-positive_4276.yml", "YAML", 0, 0, 0, 2, 0, 0, 1, 3
"d:\IDEWORK\lvmen\src\licensedcode\data\rules\false-positive_4277.yml", "YAML", 0, 0, 0, 2, 0, 0, 1, 3
"d:\IDEWORK\lvmen\src\licensedcode\data\rules\false-positive_4278.yml", "YAML", 0, 0, 0, 2, 0, 0, 1, 3
"d:\IDEWORK\lvmen\src\licensedcode\data\rules\false-positive_4279.yml", "YAML", 0, 0, 0, 2, 0, 0, 1, 3
"d:\IDEWORK\lvmen\src\licensedcode\data\rules\false-positive_428.yml", "YAML", 0, 0, 0, 2, 0, 0, 1, 3
"d:\IDEWORK\lvmen\src\licensedcode\data\rules\false-positive_4280.yml", "YAML", 0, 0, 0, 2, 0, 0, 1, 3
"d:\IDEWORK\lvmen\src\licensedcode\data\rules\false-positive_4281.yml", "YAML", 0, 0, 0, 2, 0, 0, 1, 3
"d:\IDEWORK\lvmen\src\licensedcode\data\rules\false-positive_4282.yml", "YAML", 0, 0, 0, 2, 0, 0, 1, 3
"d:\IDEWORK\lvmen\src\licensedcode\data\rules\false-positive_4283.yml", "YAML", 0, 0, 0, 2, 0, 0, 1, 3
"d:\IDEWORK\lvmen\src\licensedcode\data\rules\false-positive_4284.yml", "YAML", 0, 0, 0, 2, 0, 0, 1, 3
"d:\IDEWORK\lvmen\src\licensedcode\data\rules\false-positive_4285.yml", "YAML", 0, 0, 0, 2, 0, 0, 1, 3
"d:\IDEWORK\lvmen\src\licensedcode\data\rules\false-positive_4286.yml", "YAML", 0, 0, 0, 2, 0, 0, 1, 3
"d:\IDEWORK\lvmen\src\licensedcode\data\rules\false-positive_4287.yml", "YAML", 0, 0, 0, 2, 0, 0, 1, 3
"d:\IDEWORK\lvmen\src\licensedcode\data\rules\false-positive_4288.yml", "YAML", 0, 0, 0, 2, 0, 0, 1, 3
"d:\IDEWORK\lvmen\src\licensedcode\data\rules\false-positive_4289.yml", "YAML", 0, 0, 0, 2, 0, 0, 1, 3
"d:\IDEWORK\lvmen\src\licensedcode\data\rules\false-positive_429.yml", "YAML", 0, 0, 0, 2, 0, 0, 1, 3
"d:\IDEWORK\lvmen\src\licensedcode\data\rules\false-positive_4290.yml", "YAML", 0, 0, 0, 2, 0, 0, 1, 3
"d:\IDEWORK\lvmen\src\licensedcode\data\rules\false-positive_4291.yml", "YAML", 0, 0, 0, 2, 0, 0, 1, 3
"d:\IDEWORK\lvmen\src\licensedcode\data\rules\false-positive_4292.yml", "YAML", 0, 0, 0, 2, 0, 0, 1, 3
"d:\IDEWORK\lvmen\src\licensedcode\data\rules\false-positive_4293.yml", "YAML", 0, 0, 0, 2, 0, 0, 1, 3
"d:\IDEWORK\lvmen\src\licensedcode\data\rules\false-positive_4294.yml", "YAML", 0, 0, 0, 2, 0, 0, 1, 3
"d:\IDEWORK\lvmen\src\licensedcode\data\rules\false-positive_4295.yml", "YAML", 0, 0, 0, 2, 0, 0, 1, 3
"d:\IDEWORK\lvmen\src\licensedcode\data\rules\false-positive_4296.yml", "YAML", 0, 0, 0, 2, 0, 0, 1, 3
"d:\IDEWORK\lvmen\src\licensedcode\data\rules\false-positive_4297.yml", "YAML", 0, 0, 0, 2, 0, 0, 1, 3
"d:\IDEWORK\lvmen\src\licensedcode\data\rules\false-positive_4298.yml", "YAML", 0, 0, 0, 2, 0, 0, 1, 3
"d:\IDEWORK\lvmen\src\licensedcode\data\rules\false-positive_4299.yml", "YAML", 0, 0, 0, 2, 0, 0, 1, 3
"d:\IDEWORK\lvmen\src\licensedcode\data\rules\false-positive_43.yml", "YAML", 0, 0, 0, 2, 0, 0, 1, 3
"d:\IDEWORK\lvmen\src\licensedcode\data\rules\false-positive_430.yml", "YAML", 0, 0, 0, 3, 0, 0, 1, 4
"d:\IDEWORK\lvmen\src\licensedcode\data\rules\false-positive_4300.yml", "YAML", 0, 0, 0, 2, 0, 0, 1, 3
"d:\IDEWORK\lvmen\src\licensedcode\data\rules\false-positive_4301.yml", "YAML", 0, 0, 0, 2, 0, 0, 1, 3
"d:\IDEWORK\lvmen\src\licensedcode\data\rules\false-positive_4302.yml", "YAML", 0, 0, 0, 2, 0, 0, 1, 3
"d:\IDEWORK\lvmen\src\licensedcode\data\rules\false-positive_4303.yml", "YAML", 0, 0, 0, 2, 0, 0, 1, 3
"d:\IDEWORK\lvmen\src\licensedcode\data\rules\false-positive_4304.yml", "YAML", 0, 0, 0, 2, 0, 0, 1, 3
"d:\IDEWORK\lvmen\src\licensedcode\data\rules\false-positive_4305.yml", "YAML", 0, 0, 0, 2, 0, 0, 1, 3
"d:\IDEWORK\lvmen\src\licensedcode\data\rules\false-positive_4306.yml", "YAML", 0, 0, 0, 2, 0, 0, 1, 3
"d:\IDEWORK\lvmen\src\licensedcode\data\rules\false-positive_4307.yml", "YAML", 0, 0, 0, 2, 0, 0, 1, 3
"d:\IDEWORK\lvmen\src\licensedcode\data\rules\false-positive_4308.yml", "YAML", 0, 0, 0, 2, 0, 0, 1, 3
"d:\IDEWORK\lvmen\src\licensedcode\data\rules\false-positive_4309.yml", "YAML", 0, 0, 0, 2, 0, 0, 1, 3
"d:\IDEWORK\lvmen\src\licensedcode\data\rules\false-positive_431.yml", "YAML", 0, 0, 0, 3, 0, 0, 1, 4
"d:\IDEWORK\lvmen\src\licensedcode\data\rules\false-positive_4310.yml", "YAML", 0, 0, 0, 2, 0, 0, 1, 3
"d:\IDEWORK\lvmen\src\licensedcode\data\rules\false-positive_4311.yml", "YAML", 0, 0, 0, 2, 0, 0, 1, 3
"d:\IDEWORK\lvmen\src\licensedcode\data\rules\false-positive_4312.yml", "YAML", 0, 0, 0, 2, 0, 0, 1, 3
"d:\IDEWORK\lvmen\src\licensedcode\data\rules\false-positive_4313.yml", "YAML", 0, 0, 0, 2, 0, 0, 1, 3
"d:\IDEWORK\lvmen\src\licensedcode\data\rules\false-positive_4314.yml", "YAML", 0, 0, 0, 2, 0, 0, 1, 3
"d:\IDEWORK\lvmen\src\licensedcode\data\rules\false-positive_4315.yml", "YAML", 0, 0, 0, 2, 0, 0, 1, 3
"d:\IDEWORK\lvmen\src\licensedcode\data\rules\false-positive_4316.yml", "YAML", 0, 0, 0, 2, 0, 0, 1, 3
"d:\IDEWORK\lvmen\src\licensedcode\data\rules\false-positive_4317.yml", "YAML", 0, 0, 0, 2, 0, 0, 1, 3
"d:\IDEWORK\lvmen\src\licensedcode\data\rules\false-positive_4318.yml", "YAML", 0, 0, 0, 2, 0, 0, 1, 3
"d:\IDEWORK\lvmen\src\licensedcode\data\rules\false-positive_4319.yml", "YAML", 0, 0, 0, 2, 0, 0, 1, 3
"d:\IDEWORK\lvmen\src\licensedcode\data\rules\false-positive_432.yml", "YAML", 0, 0, 0, 2, 0, 0, 1, 3
"d:\IDEWORK\lvmen\src\licensedcode\data\rules\false-positive_4320.yml", "YAML", 0, 0, 0, 2, 0, 0, 1, 3
"d:\IDEWORK\lvmen\src\licensedcode\data\rules\false-positive_4321.yml", "YAML", 0, 0, 0, 2, 0, 0, 1, 3
"d:\IDEWORK\lvmen\src\licensedcode\data\rules\false-positive_4322.yml", "YAML", 0, 0, 0, 2, 0, 0, 1, 3
"d:\IDEWORK\lvmen\src\licensedcode\data\rules\false-positive_4323.yml", "YAML", 0, 0, 0, 2, 0, 0, 1, 3
"d:\IDEWORK\lvmen\src\licensedcode\data\rules\false-positive_4324.yml", "YAML", 0, 0, 0, 2, 0, 0, 1, 3
"d:\IDEWORK\lvmen\src\licensedcode\data\rules\false-positive_4325.yml", "YAML", 0, 0, 0, 2, 0, 0, 1, 3
"d:\IDEWORK\lvmen\src\licensedcode\data\rules\false-positive_4326.yml", "YAML", 0, 0, 0, 2, 0, 0, 1, 3
"d:\IDEWORK\lvmen\src\licensedcode\data\rules\false-positive_4327.yml", "YAML", 0, 0, 0, 2, 0, 0, 1, 3
"d:\IDEWORK\lvmen\src\licensedcode\data\rules\false-positive_4328.yml", "YAML", 0, 0, 0, 2, 0, 0, 1, 3
"d:\IDEWORK\lvmen\src\licensedcode\data\rules\false-positive_4329.yml", "YAML", 0, 0, 0, 2, 0, 0, 1, 3
"d:\IDEWORK\lvmen\src\licensedcode\data\rules\false-positive_433.yml", "YAML", 0, 0, 0, 2, 0, 0, 1, 3
"d:\IDEWORK\lvmen\src\licensedcode\data\rules\false-positive_4330.yml", "YAML", 0, 0, 0, 2, 0, 0, 1, 3
"d:\IDEWORK\lvmen\src\licensedcode\data\rules\false-positive_4331.yml", "YAML", 0, 0, 0, 2, 0, 0, 1, 3
"d:\IDEWORK\lvmen\src\licensedcode\data\rules\false-positive_4332.yml", "YAML", 0, 0, 0, 2, 0, 0, 1, 3
"d:\IDEWORK\lvmen\src\licensedcode\data\rules\false-positive_4333.yml", "YAML", 0, 0, 0, 2, 0, 0, 1, 3
"d:\IDEWORK\lvmen\src\licensedcode\data\rules\false-positive_4334.yml", "YAML", 0, 0, 0, 2, 0, 0, 1, 3
"d:\IDEWORK\lvmen\src\licensedcode\data\rules\false-positive_4335.yml", "YAML", 0, 0, 0, 2, 0, 0, 1, 3
"d:\IDEWORK\lvmen\src\licensedcode\data\rules\false-positive_4336.yml", "YAML", 0, 0, 0, 2, 0, 0, 1, 3
"d:\IDEWORK\lvmen\src\licensedcode\data\rules\false-positive_4337.yml", "YAML", 0, 0, 0, 2, 0, 0, 1, 3
"d:\IDEWORK\lvmen\src\licensedcode\data\rules\false-positive_4338.yml", "YAML", 0, 0, 0, 2, 0, 0, 1, 3
"d:\IDEWORK\lvmen\src\licensedcode\data\rules\false-positive_4339.yml", "YAML", 0, 0, 0, 2, 0, 0, 1, 3
"d:\IDEWORK\lvmen\src\licensedcode\data\rules\false-positive_434.yml", "YAML", 0, 0, 0, 2, 0, 0, 1, 3
"d:\IDEWORK\lvmen\src\licensedcode\data\rules\false-positive_4340.yml", "YAML", 0, 0, 0, 2, 0, 0, 1, 3
"d:\IDEWORK\lvmen\src\licensedcode\data\rules\false-positive_4341.yml", "YAML", 0, 0, 0, 2, 0, 0, 1, 3
"d:\IDEWORK\lvmen\src\licensedcode\data\rules\false-positive_4342.yml", "YAML", 0, 0, 0, 2, 0, 0, 1, 3
"d:\IDEWORK\lvmen\src\licensedcode\data\rules\false-positive_4343.yml", "YAML", 0, 0, 0, 2, 0, 0, 1, 3
"d:\IDEWORK\lvmen\src\licensedcode\data\rules\false-positive_4344.yml", "YAML", 0, 0, 0, 2, 0, 0, 1, 3
"d:\IDEWORK\lvmen\src\licensedcode\data\rules\false-positive_4345.yml", "YAML", 0, 0, 0, 2, 0, 0, 1, 3
"d:\IDEWORK\lvmen\src\licensedcode\data\rules\false-positive_4346.yml", "YAML", 0, 0, 0, 2, 0, 0, 1, 3
"d:\IDEWORK\lvmen\src\licensedcode\data\rules\false-positive_4347.yml", "YAML", 0, 0, 0, 2, 0, 0, 1, 3
"d:\IDEWORK\lvmen\src\licensedcode\data\rules\false-positive_4348.yml", "YAML", 0, 0, 0, 2, 0, 0, 1, 3
"d:\IDEWORK\lvmen\src\licensedcode\data\rules\false-positive_4349.yml", "YAML", 0, 0, 0, 2, 0, 0, 1, 3
"d:\IDEWORK\lvmen\src\licensedcode\data\rules\false-positive_435.yml", "YAML", 0, 0, 0, 2, 0, 0, 1, 3
"d:\IDEWORK\lvmen\src\licensedcode\data\rules\false-positive_4350.yml", "YAML", 0, 0, 0, 2, 0, 0, 1, 3
"d:\IDEWORK\lvmen\src\licensedcode\data\rules\false-positive_4351.yml", "YAML", 0, 0, 0, 2, 0, 0, 1, 3
"d:\IDEWORK\lvmen\src\licensedcode\data\rules\false-positive_4352.yml", "YAML", 0, 0, 0, 2, 0, 0, 1, 3
"d:\IDEWORK\lvmen\src\licensedcode\data\rules\false-positive_4353.yml", "YAML", 0, 0, 0, 2, 0, 0, 1, 3
"d:\IDEWORK\lvmen\src\licensedcode\data\rules\false-positive_4354.yml", "YAML", 0, 0, 0, 2, 0, 0, 1, 3
"d:\IDEWORK\lvmen\src\licensedcode\data\rules\false-positive_4355.yml", "YAML", 0, 0, 0, 2, 0, 0, 1, 3
"d:\IDEWORK\lvmen\src\licensedcode\data\rules\false-positive_4356.yml", "YAML", 0, 0, 0, 2, 0, 0, 1, 3
"d:\IDEWORK\lvmen\src\licensedcode\data\rules\false-positive_4357.yml", "YAML", 0, 0, 0, 2, 0, 0, 1, 3
"d:\IDEWORK\lvmen\src\licensedcode\data\rules\false-positive_4358.yml", "YAML", 0, 0, 0, 2, 0, 0, 1, 3
"d:\IDEWORK\lvmen\src\licensedcode\data\rules\false-positive_4359.yml", "YAML", 0, 0, 0, 2, 0, 0, 1, 3
"d:\IDEWORK\lvmen\src\licensedcode\data\rules\false-positive_436.yml", "YAML", 0, 0, 0, 2, 0, 0, 1, 3
"d:\IDEWORK\lvmen\src\licensedcode\data\rules\false-positive_4360.yml", "YAML", 0, 0, 0, 2, 0, 0, 1, 3
"d:\IDEWORK\lvmen\src\licensedcode\data\rules\false-positive_4361.yml", "YAML", 0, 0, 0, 2, 0, 0, 1, 3
"d:\IDEWORK\lvmen\src\licensedcode\data\rules\false-positive_4362.yml", "YAML", 0, 0, 0, 2, 0, 0, 1, 3
"d:\IDEWORK\lvmen\src\licensedcode\data\rules\false-positive_4363.yml", "YAML", 0, 0, 0, 2, 0, 0, 1, 3
"d:\IDEWORK\lvmen\src\licensedcode\data\rules\false-positive_4364.yml", "YAML", 0, 0, 0, 2, 0, 0, 1, 3
"d:\IDEWORK\lvmen\src\licensedcode\data\rules\false-positive_4365.yml", "YAML", 0, 0, 0, 2, 0, 0, 1, 3
"d:\IDEWORK\lvmen\src\licensedcode\data\rules\false-positive_4366.yml", "YAML", 0, 0, 0, 2, 0, 0, 1, 3
"d:\IDEWORK\lvmen\src\licensedcode\data\rules\false-positive_4367.yml", "YAML", 0, 0, 0, 2, 0, 0, 1, 3
"d:\IDEWORK\lvmen\src\licensedcode\data\rules\false-positive_4368.yml", "YAML", 0, 0, 0, 2, 0, 0, 1, 3
"d:\IDEWORK\lvmen\src\licensedcode\data\rules\false-positive_4369.yml", "YAML", 0, 0, 0, 2, 0, 0, 1, 3
"d:\IDEWORK\lvmen\src\licensedcode\data\rules\false-positive_437.yml", "YAML", 0, 0, 0, 2, 0, 0, 1, 3
"d:\IDEWORK\lvmen\src\licensedcode\data\rules\false-positive_4370.yml", "YAML", 0, 0, 0, 2, 0, 0, 1, 3
"d:\IDEWORK\lvmen\src\licensedcode\data\rules\false-positive_4371.yml", "YAML", 0, 0, 0, 2, 0, 0, 1, 3
"d:\IDEWORK\lvmen\src\licensedcode\data\rules\false-positive_4372.yml", "YAML", 0, 0, 0, 2, 0, 0, 1, 3
"d:\IDEWORK\lvmen\src\licensedcode\data\rules\false-positive_4373.yml", "YAML", 0, 0, 0, 2, 0, 0, 1, 3
"d:\IDEWORK\lvmen\src\licensedcode\data\rules\false-positive_4374.yml", "YAML", 0, 0, 0, 2, 0, 0, 1, 3
"d:\IDEWORK\lvmen\src\licensedcode\data\rules\false-positive_4375.yml", "YAML", 0, 0, 0, 2, 0, 0, 1, 3
"d:\IDEWORK\lvmen\src\licensedcode\data\rules\false-positive_4376.yml", "YAML", 0, 0, 0, 2, 0, 0, 1, 3
"d:\IDEWORK\lvmen\src\licensedcode\data\rules\false-positive_4377.yml", "YAML", 0, 0, 0, 2, 0, 0, 1, 3
"d:\IDEWORK\lvmen\src\licensedcode\data\rules\false-positive_4378.yml", "YAML", 0, 0, 0, 2, 0, 0, 1, 3
"d:\IDEWORK\lvmen\src\licensedcode\data\rules\false-positive_4379.yml", "YAML", 0, 0, 0, 2, 0, 0, 1, 3
"d:\IDEWORK\lvmen\src\licensedcode\data\rules\false-positive_438.yml", "YAML", 0, 0, 0, 2, 0, 0, 1, 3
"d:\IDEWORK\lvmen\src\licensedcode\data\rules\false-positive_4380.yml", "YAML", 0, 0, 0, 2, 0, 0, 1, 3
"d:\IDEWORK\lvmen\src\licensedcode\data\rules\false-positive_4381.yml", "YAML", 0, 0, 0, 2, 0, 0, 1, 3
"d:\IDEWORK\lvmen\src\licensedcode\data\rules\false-positive_4382.yml", "YAML", 0, 0, 0, 2, 0, 0, 1, 3
"d:\IDEWORK\lvmen\src\licensedcode\data\rules\false-positive_4383.yml", "YAML", 0, 0, 0, 2, 0, 0, 1, 3
"d:\IDEWORK\lvmen\src\licensedcode\data\rules\false-positive_4384.yml", "YAML", 0, 0, 0, 2, 0, 0, 1, 3
"d:\IDEWORK\lvmen\src\licensedcode\data\rules\false-positive_4385.yml", "YAML", 0, 0, 0, 2, 0, 0, 1, 3
"d:\IDEWORK\lvmen\src\licensedcode\data\rules\false-positive_4386.yml", "YAML", 0, 0, 0, 2, 0, 0, 1, 3
"d:\IDEWORK\lvmen\src\licensedcode\data\rules\false-positive_4387.yml", "YAML", 0, 0, 0, 2, 0, 0, 1, 3
"d:\IDEWORK\lvmen\src\licensedcode\data\rules\false-positive_4388.yml", "YAML", 0, 0, 0, 2, 0, 0, 1, 3
"d:\IDEWORK\lvmen\src\licensedcode\data\rules\false-positive_4389.yml", "YAML", 0, 0, 0, 2, 0, 0, 1, 3
"d:\IDEWORK\lvmen\src\licensedcode\data\rules\false-positive_439.yml", "YAML", 0, 0, 0, 2, 0, 0, 1, 3
"d:\IDEWORK\lvmen\src\licensedcode\data\rules\false-positive_4390.yml", "YAML", 0, 0, 0, 2, 0, 0, 1, 3
"d:\IDEWORK\lvmen\src\licensedcode\data\rules\false-positive_4391.yml", "YAML", 0, 0, 0, 2, 0, 0, 1, 3
"d:\IDEWORK\lvmen\src\licensedcode\data\rules\false-positive_4392.yml", "YAML", 0, 0, 0, 2, 0, 0, 1, 3
"d:\IDEWORK\lvmen\src\licensedcode\data\rules\false-positive_4393.yml", "YAML", 0, 0, 0, 2, 0, 0, 1, 3
"d:\IDEWORK\lvmen\src\licensedcode\data\rules\false-positive_4394.yml", "YAML", 0, 0, 0, 2, 0, 0, 1, 3
"d:\IDEWORK\lvmen\src\licensedcode\data\rules\false-positive_4395.yml", "YAML", 0, 0, 0, 2, 0, 0, 1, 3
"d:\IDEWORK\lvmen\src\licensedcode\data\rules\false-positive_4396.yml", "YAML", 0, 0, 0, 2, 0, 0, 1, 3
"d:\IDEWORK\lvmen\src\licensedcode\data\rules\false-positive_4397.yml", "YAML", 0, 0, 0, 2, 0, 0, 1, 3
"d:\IDEWORK\lvmen\src\licensedcode\data\rules\false-positive_4398.yml", "YAML", 0, 0, 0, 2, 0, 0, 1, 3
"d:\IDEWORK\lvmen\src\licensedcode\data\rules\false-positive_4399.yml", "YAML", 0, 0, 0, 2, 0, 0, 1, 3
"d:\IDEWORK\lvmen\src\licensedcode\data\rules\false-positive_44.yml", "YAML", 0, 0, 0, 2, 0, 0, 1, 3
"d:\IDEWORK\lvmen\src\licensedcode\data\rules\false-positive_440.yml", "YAML", 0, 0, 0, 2, 0, 0, 1, 3
"d:\IDEWORK\lvmen\src\licensedcode\data\rules\false-positive_4400.yml", "YAML", 0, 0, 0, 2, 0, 0, 1, 3
"d:\IDEWORK\lvmen\src\licensedcode\data\rules\false-positive_4401.yml", "YAML", 0, 0, 0, 2, 0, 0, 1, 3
"d:\IDEWORK\lvmen\src\licensedcode\data\rules\false-positive_4402.yml", "YAML", 0, 0, 0, 2, 0, 0, 1, 3
"d:\IDEWORK\lvmen\src\licensedcode\data\rules\false-positive_4403.yml", "YAML", 0, 0, 0, 2, 0, 0, 1, 3
"d:\IDEWORK\lvmen\src\licensedcode\data\rules\false-positive_4404.yml", "YAML", 0, 0, 0, 2, 0, 0, 1, 3
"d:\IDEWORK\lvmen\src\licensedcode\data\rules\false-positive_4405.yml", "YAML", 0, 0, 0, 2, 0, 0, 1, 3
"d:\IDEWORK\lvmen\src\licensedcode\data\rules\false-positive_4406.yml", "YAML", 0, 0, 0, 2, 0, 0, 1, 3
"d:\IDEWORK\lvmen\src\licensedcode\data\rules\false-positive_4407.yml", "YAML", 0, 0, 0, 2, 0, 0, 1, 3
"d:\IDEWORK\lvmen\src\licensedcode\data\rules\false-positive_4408.yml", "YAML", 0, 0, 0, 2, 0, 0, 1, 3
"d:\IDEWORK\lvmen\src\licensedcode\data\rules\false-positive_4409.yml", "YAML", 0, 0, 0, 2, 0, 0, 1, 3
"d:\IDEWORK\lvmen\src\licensedcode\data\rules\false-positive_441.yml", "YAML", 0, 0, 0, 2, 0, 0, 1, 3
"d:\IDEWORK\lvmen\src\licensedcode\data\rules\false-positive_4410.yml", "YAML", 0, 0, 0, 2, 0, 0, 1, 3
"d:\IDEWORK\lvmen\src\licensedcode\data\rules\false-positive_4411.yml", "YAML", 0, 0, 0, 2, 0, 0, 1, 3
"d:\IDEWORK\lvmen\src\licensedcode\data\rules\false-positive_4412.yml", "YAML", 0, 0, 0, 2, 0, 0, 1, 3
"d:\IDEWORK\lvmen\src\licensedcode\data\rules\false-positive_4413.yml", "YAML", 0, 0, 0, 2, 0, 0, 1, 3
"d:\IDEWORK\lvmen\src\licensedcode\data\rules\false-positive_4414.yml", "YAML", 0, 0, 0, 2, 0, 0, 1, 3
"d:\IDEWORK\lvmen\src\licensedcode\data\rules\false-positive_4415.yml", "YAML", 0, 0, 0, 2, 0, 0, 1, 3
"d:\IDEWORK\lvmen\src\licensedcode\data\rules\false-positive_4416.yml", "YAML", 0, 0, 0, 2, 0, 0, 1, 3
"d:\IDEWORK\lvmen\src\licensedcode\data\rules\false-positive_4417.yml", "YAML", 0, 0, 0, 2, 0, 0, 1, 3
"d:\IDEWORK\lvmen\src\licensedcode\data\rules\false-positive_4418.yml", "YAML", 0, 0, 0, 2, 0, 0, 1, 3
"d:\IDEWORK\lvmen\src\licensedcode\data\rules\false-positive_4419.yml", "YAML", 0, 0, 0, 2, 0, 0, 1, 3
"d:\IDEWORK\lvmen\src\licensedcode\data\rules\false-positive_442.yml", "YAML", 0, 0, 0, 3, 0, 0, 1, 4
"d:\IDEWORK\lvmen\src\licensedcode\data\rules\false-positive_4420.yml", "YAML", 0, 0, 0, 2, 0, 0, 1, 3
"d:\IDEWORK\lvmen\src\licensedcode\data\rules\false-positive_4421.yml", "YAML", 0, 0, 0, 2, 0, 0, 1, 3
"d:\IDEWORK\lvmen\src\licensedcode\data\rules\false-positive_4422.yml", "YAML", 0, 0, 0, 2, 0, 0, 1, 3
"d:\IDEWORK\lvmen\src\licensedcode\data\rules\false-positive_4423.yml", "YAML", 0, 0, 0, 2, 0, 0, 1, 3
"d:\IDEWORK\lvmen\src\licensedcode\data\rules\false-positive_4424.yml", "YAML", 0, 0, 0, 2, 0, 0, 1, 3
"d:\IDEWORK\lvmen\src\licensedcode\data\rules\false-positive_4425.yml", "YAML", 0, 0, 0, 2, 0, 0, 1, 3
"d:\IDEWORK\lvmen\src\licensedcode\data\rules\false-positive_4426.yml", "YAML", 0, 0, 0, 2, 0, 0, 1, 3
"d:\IDEWORK\lvmen\src\licensedcode\data\rules\false-positive_4427.yml", "YAML", 0, 0, 0, 2, 0, 0, 1, 3
"d:\IDEWORK\lvmen\src\licensedcode\data\rules\false-positive_4428.yml", "YAML", 0, 0, 0, 2, 0, 0, 1, 3
"d:\IDEWORK\lvmen\src\licensedcode\data\rules\false-positive_4429.yml", "YAML", 0, 0, 0, 2, 0, 0, 1, 3
"d:\IDEWORK\lvmen\src\licensedcode\data\rules\false-positive_443.yml", "YAML", 0, 0, 0, 2, 0, 0, 1, 3
"d:\IDEWORK\lvmen\src\licensedcode\data\rules\false-positive_4430.yml", "YAML", 0, 0, 0, 2, 0, 0, 1, 3
"d:\IDEWORK\lvmen\src\licensedcode\data\rules\false-positive_4431.yml", "YAML", 0, 0, 0, 2, 0, 0, 1, 3
"d:\IDEWORK\lvmen\src\licensedcode\data\rules\false-positive_4432.yml", "YAML", 0, 0, 0, 2, 0, 0, 1, 3
"d:\IDEWORK\lvmen\src\licensedcode\data\rules\false-positive_4433.yml", "YAML", 0, 0, 0, 2, 0, 0, 1, 3
"d:\IDEWORK\lvmen\src\licensedcode\data\rules\false-positive_4434.yml", "YAML", 0, 0, 0, 2, 0, 0, 1, 3
"d:\IDEWORK\lvmen\src\licensedcode\data\rules\false-positive_4435.yml", "YAML", 0, 0, 0, 2, 0, 0, 1, 3
"d:\IDEWORK\lvmen\src\licensedcode\data\rules\false-positive_4436.yml", "YAML", 0, 0, 0, 2, 0, 0, 1, 3
"d:\IDEWORK\lvmen\src\licensedcode\data\rules\false-positive_4437.yml", "YAML", 0, 0, 0, 2, 0, 0, 1, 3
"d:\IDEWORK\lvmen\src\licensedcode\data\rules\false-positive_4438.yml", "YAML", 0, 0, 0, 2, 0, 0, 1, 3
"d:\IDEWORK\lvmen\src\licensedcode\data\rules\false-positive_4439.yml", "YAML", 0, 0, 0, 2, 0, 0, 1, 3
"d:\IDEWORK\lvmen\src\licensedcode\data\rules\false-positive_444.yml", "YAML", 0, 0, 0, 2, 0, 0, 1, 3
"d:\IDEWORK\lvmen\src\licensedcode\data\rules\false-positive_4440.yml", "YAML", 0, 0, 0, 2, 0, 0, 1, 3
"d:\IDEWORK\lvmen\src\licensedcode\data\rules\false-positive_4441.yml", "YAML", 0, 0, 0, 2, 0, 0, 1, 3
"d:\IDEWORK\lvmen\src\licensedcode\data\rules\false-positive_4442.yml", "YAML", 0, 0, 0, 2, 0, 0, 1, 3
"d:\IDEWORK\lvmen\src\licensedcode\data\rules\false-positive_4443.yml", "YAML", 0, 0, 0, 2, 0, 0, 1, 3
"d:\IDEWORK\lvmen\src\licensedcode\data\rules\false-positive_4444.yml", "YAML", 0, 0, 0, 2, 0, 0, 1, 3
"d:\IDEWORK\lvmen\src\licensedcode\data\rules\false-positive_4445.yml", "YAML", 0, 0, 0, 2, 0, 0, 1, 3
"d:\IDEWORK\lvmen\src\licensedcode\data\rules\false-positive_4446.yml", "YAML", 0, 0, 0, 2, 0, 0, 1, 3
"d:\IDEWORK\lvmen\src\licensedcode\data\rules\false-positive_4447.yml", "YAML", 0, 0, 0, 2, 0, 0, 1, 3
"d:\IDEWORK\lvmen\src\licensedcode\data\rules\false-positive_4448.yml", "YAML", 0, 0, 0, 2, 0, 0, 1, 3
"d:\IDEWORK\lvmen\src\licensedcode\data\rules\false-positive_4449.yml", "YAML", 0, 0, 0, 2, 0, 0, 1, 3
"d:\IDEWORK\lvmen\src\licensedcode\data\rules\false-positive_445.yml", "YAML", 0, 0, 0, 2, 0, 0, 1, 3
"d:\IDEWORK\lvmen\src\licensedcode\data\rules\false-positive_4450.yml", "YAML", 0, 0, 0, 2, 0, 0, 1, 3
"d:\IDEWORK\lvmen\src\licensedcode\data\rules\false-positive_4451.yml", "YAML", 0, 0, 0, 2, 0, 0, 1, 3
"d:\IDEWORK\lvmen\src\licensedcode\data\rules\false-positive_4452.yml", "YAML", 0, 0, 0, 2, 0, 0, 1, 3
"d:\IDEWORK\lvmen\src\licensedcode\data\rules\false-positive_4453.yml", "YAML", 0, 0, 0, 2, 0, 0, 1, 3
"d:\IDEWORK\lvmen\src\licensedcode\data\rules\false-positive_4454.yml", "YAML", 0, 0, 0, 2, 0, 0, 1, 3
"d:\IDEWORK\lvmen\src\licensedcode\data\rules\false-positive_4455.yml", "YAML", 0, 0, 0, 2, 0, 0, 1, 3
"d:\IDEWORK\lvmen\src\licensedcode\data\rules\false-positive_4456.yml", "YAML", 0, 0, 0, 2, 0, 0, 1, 3
"d:\IDEWORK\lvmen\src\licensedcode\data\rules\false-positive_4457.yml", "YAML", 0, 0, 0, 2, 0, 0, 1, 3
"d:\IDEWORK\lvmen\src\licensedcode\data\rules\false-positive_4458.yml", "YAML", 0, 0, 0, 2, 0, 0, 1, 3
"d:\IDEWORK\lvmen\src\licensedcode\data\rules\false-positive_4459.yml", "YAML", 0, 0, 0, 2, 0, 0, 1, 3
"d:\IDEWORK\lvmen\src\licensedcode\data\rules\false-positive_446.yml", "YAML", 0, 0, 0, 2, 0, 0, 1, 3
"d:\IDEWORK\lvmen\src\licensedcode\data\rules\false-positive_4460.yml", "YAML", 0, 0, 0, 2, 0, 0, 1, 3
"d:\IDEWORK\lvmen\src\licensedcode\data\rules\false-positive_4461.yml", "YAML", 0, 0, 0, 2, 0, 0, 1, 3
"d:\IDEWORK\lvmen\src\licensedcode\data\rules\false-positive_4462.yml", "YAML", 0, 0, 0, 2, 0, 0, 1, 3
"d:\IDEWORK\lvmen\src\licensedcode\data\rules\false-positive_4463.yml", "YAML", 0, 0, 0, 2, 0, 0, 1, 3
"d:\IDEWORK\lvmen\src\licensedcode\data\rules\false-positive_4464.yml", "YAML", 0, 0, 0, 2, 0, 0, 1, 3
"d:\IDEWORK\lvmen\src\licensedcode\data\rules\false-positive_4465.yml", "YAML", 0, 0, 0, 2, 0, 0, 1, 3
"d:\IDEWORK\lvmen\src\licensedcode\data\rules\false-positive_4466.yml", "YAML", 0, 0, 0, 2, 0, 0, 1, 3
"d:\IDEWORK\lvmen\src\licensedcode\data\rules\false-positive_4467.yml", "YAML", 0, 0, 0, 2, 0, 0, 1, 3
"d:\IDEWORK\lvmen\src\licensedcode\data\rules\false-positive_4468.yml", "YAML", 0, 0, 0, 2, 0, 0, 1, 3
"d:\IDEWORK\lvmen\src\licensedcode\data\rules\false-positive_4469.yml", "YAML", 0, 0, 0, 2, 0, 0, 1, 3
"d:\IDEWORK\lvmen\src\licensedcode\data\rules\false-positive_447.yml", "YAML", 0, 0, 0, 2, 0, 0, 1, 3
"d:\IDEWORK\lvmen\src\licensedcode\data\rules\false-positive_4470.yml", "YAML", 0, 0, 0, 2, 0, 0, 1, 3
"d:\IDEWORK\lvmen\src\licensedcode\data\rules\false-positive_4471.yml", "YAML", 0, 0, 0, 2, 0, 0, 1, 3
"d:\IDEWORK\lvmen\src\licensedcode\data\rules\false-positive_4472.yml", "YAML", 0, 0, 0, 2, 0, 0, 1, 3
"d:\IDEWORK\lvmen\src\licensedcode\data\rules\false-positive_4473.yml", "YAML", 0, 0, 0, 2, 0, 0, 1, 3
"d:\IDEWORK\lvmen\src\licensedcode\data\rules\false-positive_4474.yml", "YAML", 0, 0, 0, 2, 0, 0, 1, 3
"d:\IDEWORK\lvmen\src\licensedcode\data\rules\false-positive_4475.yml", "YAML", 0, 0, 0, 2, 0, 0, 1, 3
"d:\IDEWORK\lvmen\src\licensedcode\data\rules\false-positive_4476.yml", "YAML", 0, 0, 0, 2, 0, 0, 1, 3
"d:\IDEWORK\lvmen\src\licensedcode\data\rules\false-positive_4477.yml", "YAML", 0, 0, 0, 2, 0, 0, 1, 3
"d:\IDEWORK\lvmen\src\licensedcode\data\rules\false-positive_4478.yml", "YAML", 0, 0, 0, 2, 0, 0, 1, 3
"d:\IDEWORK\lvmen\src\licensedcode\data\rules\false-positive_4479.yml", "YAML", 0, 0, 0, 2, 0, 0, 1, 3
"d:\IDEWORK\lvmen\src\licensedcode\data\rules\false-positive_448.yml", "YAML", 0, 0, 0, 2, 0, 0, 1, 3
"d:\IDEWORK\lvmen\src\licensedcode\data\rules\false-positive_4480.yml", "YAML", 0, 0, 0, 2, 0, 0, 1, 3
"d:\IDEWORK\lvmen\src\licensedcode\data\rules\false-positive_4481.yml", "YAML", 0, 0, 0, 2, 0, 0, 1, 3
"d:\IDEWORK\lvmen\src\licensedcode\data\rules\false-positive_4482.yml", "YAML", 0, 0, 0, 2, 0, 0, 1, 3
"d:\IDEWORK\lvmen\src\licensedcode\data\rules\false-positive_4483.yml", "YAML", 0, 0, 0, 2, 0, 0, 1, 3
"d:\IDEWORK\lvmen\src\licensedcode\data\rules\false-positive_4484.yml", "YAML", 0, 0, 0, 2, 0, 0, 1, 3
"d:\IDEWORK\lvmen\src\licensedcode\data\rules\false-positive_4485.yml", "YAML", 0, 0, 0, 2, 0, 0, 1, 3
"d:\IDEWORK\lvmen\src\licensedcode\data\rules\false-positive_4486.yml", "YAML", 0, 0, 0, 2, 0, 0, 1, 3
"d:\IDEWORK\lvmen\src\licensedcode\data\rules\false-positive_4487.yml", "YAML", 0, 0, 0, 2, 0, 0, 1, 3
"d:\IDEWORK\lvmen\src\licensedcode\data\rules\false-positive_4488.yml", "YAML", 0, 0, 0, 2, 0, 0, 1, 3
"d:\IDEWORK\lvmen\src\licensedcode\data\rules\false-positive_4489.yml", "YAML", 0, 0, 0, 2, 0, 0, 1, 3
"d:\IDEWORK\lvmen\src\licensedcode\data\rules\false-positive_449.yml", "YAML", 0, 0, 0, 2, 0, 0, 1, 3
"d:\IDEWORK\lvmen\src\licensedcode\data\rules\false-positive_4490.yml", "YAML", 0, 0, 0, 2, 0, 0, 1, 3
"d:\IDEWORK\lvmen\src\licensedcode\data\rules\false-positive_4491.yml", "YAML", 0, 0, 0, 2, 0, 0, 1, 3
"d:\IDEWORK\lvmen\src\licensedcode\data\rules\false-positive_4492.yml", "YAML", 0, 0, 0, 2, 0, 0, 1, 3
"d:\IDEWORK\lvmen\src\licensedcode\data\rules\false-positive_4493.yml", "YAML", 0, 0, 0, 2, 0, 0, 1, 3
"d:\IDEWORK\lvmen\src\licensedcode\data\rules\false-positive_4494.yml", "YAML", 0, 0, 0, 2, 0, 0, 1, 3
"d:\IDEWORK\lvmen\src\licensedcode\data\rules\false-positive_4495.yml", "YAML", 0, 0, 0, 2, 0, 0, 1, 3
"d:\IDEWORK\lvmen\src\licensedcode\data\rules\false-positive_4496.yml", "YAML", 0, 0, 0, 2, 0, 0, 1, 3
"d:\IDEWORK\lvmen\src\licensedcode\data\rules\false-positive_4497.yml", "YAML", 0, 0, 0, 2, 0, 0, 1, 3
"d:\IDEWORK\lvmen\src\licensedcode\data\rules\false-positive_4498.yml", "YAML", 0, 0, 0, 2, 0, 0, 1, 3
"d:\IDEWORK\lvmen\src\licensedcode\data\rules\false-positive_4499.yml", "YAML", 0, 0, 0, 2, 0, 0, 1, 3
"d:\IDEWORK\lvmen\src\licensedcode\data\rules\false-positive_45.yml", "YAML", 0, 0, 0, 2, 0, 0, 1, 3
"d:\IDEWORK\lvmen\src\licensedcode\data\rules\false-positive_450.yml", "YAML", 0, 0, 0, 2, 0, 0, 1, 3
"d:\IDEWORK\lvmen\src\licensedcode\data\rules\false-positive_4500.yml", "YAML", 0, 0, 0, 2, 0, 0, 1, 3
"d:\IDEWORK\lvmen\src\licensedcode\data\rules\false-positive_4501.yml", "YAML", 0, 0, 0, 2, 0, 0, 1, 3
"d:\IDEWORK\lvmen\src\licensedcode\data\rules\false-positive_4502.yml", "YAML", 0, 0, 0, 2, 0, 0, 1, 3
"d:\IDEWORK\lvmen\src\licensedcode\data\rules\false-positive_4503.yml", "YAML", 0, 0, 0, 2, 0, 0, 1, 3
"d:\IDEWORK\lvmen\src\licensedcode\data\rules\false-positive_4504.yml", "YAML", 0, 0, 0, 2, 0, 0, 1, 3
"d:\IDEWORK\lvmen\src\licensedcode\data\rules\false-positive_4505.yml", "YAML", 0, 0, 0, 2, 0, 0, 1, 3
"d:\IDEWORK\lvmen\src\licensedcode\data\rules\false-positive_4506.yml", "YAML", 0, 0, 0, 2, 0, 0, 1, 3
"d:\IDEWORK\lvmen\src\licensedcode\data\rules\false-positive_4507.yml", "YAML", 0, 0, 0, 2, 0, 0, 1, 3
"d:\IDEWORK\lvmen\src\licensedcode\data\rules\false-positive_4508.yml", "YAML", 0, 0, 0, 2, 0, 0, 1, 3
"d:\IDEWORK\lvmen\src\licensedcode\data\rules\false-positive_4509.yml", "YAML", 0, 0, 0, 2, 0, 0, 1, 3
"d:\IDEWORK\lvmen\src\licensedcode\data\rules\false-positive_451.yml", "YAML", 0, 0, 0, 3, 0, 0, 1, 4
"d:\IDEWORK\lvmen\src\licensedcode\data\rules\false-positive_4510.yml", "YAML", 0, 0, 0, 2, 0, 0, 1, 3
"d:\IDEWORK\lvmen\src\licensedcode\data\rules\false-positive_4511.yml", "YAML", 0, 0, 0, 2, 0, 0, 1, 3
"d:\IDEWORK\lvmen\src\licensedcode\data\rules\false-positive_4512.yml", "YAML", 0, 0, 0, 2, 0, 0, 1, 3
"d:\IDEWORK\lvmen\src\licensedcode\data\rules\false-positive_4513.yml", "YAML", 0, 0, 0, 2, 0, 0, 1, 3
"d:\IDEWORK\lvmen\src\licensedcode\data\rules\false-positive_4514.yml", "YAML", 0, 0, 0, 2, 0, 0, 1, 3
"d:\IDEWORK\lvmen\src\licensedcode\data\rules\false-positive_4515.yml", "YAML", 0, 0, 0, 2, 0, 0, 1, 3
"d:\IDEWORK\lvmen\src\licensedcode\data\rules\false-positive_4516.yml", "YAML", 0, 0, 0, 2, 0, 0, 1, 3
"d:\IDEWORK\lvmen\src\licensedcode\data\rules\false-positive_4517.yml", "YAML", 0, 0, 0, 2, 0, 0, 1, 3
"d:\IDEWORK\lvmen\src\licensedcode\data\rules\false-positive_4518.yml", "YAML", 0, 0, 0, 2, 0, 0, 1, 3
"d:\IDEWORK\lvmen\src\licensedcode\data\rules\false-positive_4519.yml", "YAML", 0, 0, 0, 2, 0, 0, 1, 3
"d:\IDEWORK\lvmen\src\licensedcode\data\rules\false-positive_452.yml", "YAML", 0, 0, 0, 2, 0, 0, 1, 3
"d:\IDEWORK\lvmen\src\licensedcode\data\rules\false-positive_4520.yml", "YAML", 0, 0, 0, 2, 0, 0, 1, 3
"d:\IDEWORK\lvmen\src\licensedcode\data\rules\false-positive_4521.yml", "YAML", 0, 0, 0, 2, 0, 0, 1, 3
"d:\IDEWORK\lvmen\src\licensedcode\data\rules\false-positive_4522.yml", "YAML", 0, 0, 0, 2, 0, 0, 1, 3
"d:\IDEWORK\lvmen\src\licensedcode\data\rules\false-positive_4523.yml", "YAML", 0, 0, 0, 2, 0, 0, 1, 3
"d:\IDEWORK\lvmen\src\licensedcode\data\rules\false-positive_4524.yml", "YAML", 0, 0, 0, 2, 0, 0, 1, 3
"d:\IDEWORK\lvmen\src\licensedcode\data\rules\false-positive_4525.yml", "YAML", 0, 0, 0, 2, 0, 0, 1, 3
"d:\IDEWORK\lvmen\src\licensedcode\data\rules\false-positive_4526.yml", "YAML", 0, 0, 0, 2, 0, 0, 1, 3
"d:\IDEWORK\lvmen\src\licensedcode\data\rules\false-positive_4527.yml", "YAML", 0, 0, 0, 2, 0, 0, 1, 3
"d:\IDEWORK\lvmen\src\licensedcode\data\rules\false-positive_4528.yml", "YAML", 0, 0, 0, 2, 0, 0, 1, 3
"d:\IDEWORK\lvmen\src\licensedcode\data\rules\false-positive_4529.yml", "YAML", 0, 0, 0, 2, 0, 0, 1, 3
"d:\IDEWORK\lvmen\src\licensedcode\data\rules\false-positive_453.yml", "YAML", 0, 0, 0, 2, 0, 0, 1, 3
"d:\IDEWORK\lvmen\src\licensedcode\data\rules\false-positive_4530.yml", "YAML", 0, 0, 0, 2, 0, 0, 1, 3
"d:\IDEWORK\lvmen\src\licensedcode\data\rules\false-positive_4531.yml", "YAML", 0, 0, 0, 2, 0, 0, 1, 3
"d:\IDEWORK\lvmen\src\licensedcode\data\rules\false-positive_4532.yml", "YAML", 0, 0, 0, 2, 0, 0, 1, 3
"d:\IDEWORK\lvmen\src\licensedcode\data\rules\false-positive_4533.yml", "YAML", 0, 0, 0, 2, 0, 0, 1, 3
"d:\IDEWORK\lvmen\src\licensedcode\data\rules\false-positive_4534.yml", "YAML", 0, 0, 0, 2, 0, 0, 1, 3
"d:\IDEWORK\lvmen\src\licensedcode\data\rules\false-positive_4535.yml", "YAML", 0, 0, 0, 2, 0, 0, 1, 3
"d:\IDEWORK\lvmen\src\licensedcode\data\rules\false-positive_4536.yml", "YAML", 0, 0, 0, 2, 0, 0, 1, 3
"d:\IDEWORK\lvmen\src\licensedcode\data\rules\false-positive_4537.yml", "YAML", 0, 0, 0, 2, 0, 0, 1, 3
"d:\IDEWORK\lvmen\src\licensedcode\data\rules\false-positive_4538.yml", "YAML", 0, 0, 0, 2, 0, 0, 1, 3
"d:\IDEWORK\lvmen\src\licensedcode\data\rules\false-positive_4539.yml", "YAML", 0, 0, 0, 2, 0, 0, 1, 3
"d:\IDEWORK\lvmen\src\licensedcode\data\rules\false-positive_454.yml", "YAML", 0, 0, 0, 2, 0, 0, 1, 3
"d:\IDEWORK\lvmen\src\licensedcode\data\rules\false-positive_4540.yml", "YAML", 0, 0, 0, 2, 0, 0, 1, 3
"d:\IDEWORK\lvmen\src\licensedcode\data\rules\false-positive_4541.yml", "YAML", 0, 0, 0, 2, 0, 0, 1, 3
"d:\IDEWORK\lvmen\src\licensedcode\data\rules\false-positive_4542.yml", "YAML", 0, 0, 0, 2, 0, 0, 1, 3
"d:\IDEWORK\lvmen\src\licensedcode\data\rules\false-positive_4543.yml", "YAML", 0, 0, 0, 2, 0, 0, 1, 3
"d:\IDEWORK\lvmen\src\licensedcode\data\rules\false-positive_4544.yml", "YAML", 0, 0, 0, 2, 0, 0, 1, 3
"d:\IDEWORK\lvmen\src\licensedcode\data\rules\false-positive_4545.yml", "YAML", 0, 0, 0, 2, 0, 0, 1, 3
"d:\IDEWORK\lvmen\src\licensedcode\data\rules\false-positive_4546.yml", "YAML", 0, 0, 0, 2, 0, 0, 1, 3
"d:\IDEWORK\lvmen\src\licensedcode\data\rules\false-positive_4547.yml", "YAML", 0, 0, 0, 2, 0, 0, 1, 3
"d:\IDEWORK\lvmen\src\licensedcode\data\rules\false-positive_4548.yml", "YAML", 0, 0, 0, 2, 0, 0, 1, 3
"d:\IDEWORK\lvmen\src\licensedcode\data\rules\false-positive_4549.yml", "YAML", 0, 0, 0, 2, 0, 0, 1, 3
"d:\IDEWORK\lvmen\src\licensedcode\data\rules\false-positive_455.yml", "YAML", 0, 0, 0, 2, 0, 0, 1, 3
"d:\IDEWORK\lvmen\src\licensedcode\data\rules\false-positive_4550.yml", "YAML", 0, 0, 0, 2, 0, 0, 1, 3
"d:\IDEWORK\lvmen\src\licensedcode\data\rules\false-positive_4551.yml", "YAML", 0, 0, 0, 2, 0, 0, 1, 3
"d:\IDEWORK\lvmen\src\licensedcode\data\rules\false-positive_4552.yml", "YAML", 0, 0, 0, 2, 0, 0, 1, 3
"d:\IDEWORK\lvmen\src\licensedcode\data\rules\false-positive_4553.yml", "YAML", 0, 0, 0, 2, 0, 0, 1, 3
"d:\IDEWORK\lvmen\src\licensedcode\data\rules\false-positive_4554.yml", "YAML", 0, 0, 0, 2, 0, 0, 1, 3
"d:\IDEWORK\lvmen\src\licensedcode\data\rules\false-positive_4555.yml", "YAML", 0, 0, 0, 2, 0, 0, 1, 3
"d:\IDEWORK\lvmen\src\licensedcode\data\rules\false-positive_4556.yml", "YAML", 0, 0, 0, 2, 0, 0, 1, 3
"d:\IDEWORK\lvmen\src\licensedcode\data\rules\false-positive_4557.yml", "YAML", 0, 0, 0, 2, 0, 0, 1, 3
"d:\IDEWORK\lvmen\src\licensedcode\data\rules\false-positive_4558.yml", "YAML", 0, 0, 0, 2, 0, 0, 1, 3
"d:\IDEWORK\lvmen\src\licensedcode\data\rules\false-positive_4559.yml", "YAML", 0, 0, 0, 2, 0, 0, 1, 3
"d:\IDEWORK\lvmen\src\licensedcode\data\rules\false-positive_456.yml", "YAML", 0, 0, 0, 2, 0, 0, 1, 3
"d:\IDEWORK\lvmen\src\licensedcode\data\rules\false-positive_4560.yml", "YAML", 0, 0, 0, 2, 0, 0, 1, 3
"d:\IDEWORK\lvmen\src\licensedcode\data\rules\false-positive_4561.yml", "YAML", 0, 0, 0, 2, 0, 0, 1, 3
"d:\IDEWORK\lvmen\src\licensedcode\data\rules\false-positive_4562.yml", "YAML", 0, 0, 0, 2, 0, 0, 1, 3
"d:\IDEWORK\lvmen\src\licensedcode\data\rules\false-positive_4563.yml", "YAML", 0, 0, 0, 2, 0, 0, 1, 3
"d:\IDEWORK\lvmen\src\licensedcode\data\rules\false-positive_4564.yml", "YAML", 0, 0, 0, 2, 0, 0, 1, 3
"d:\IDEWORK\lvmen\src\licensedcode\data\rules\false-positive_4565.yml", "YAML", 0, 0, 0, 2, 0, 0, 1, 3
"d:\IDEWORK\lvmen\src\licensedcode\data\rules\false-positive_4566.yml", "YAML", 0, 0, 0, 2, 0, 0, 1, 3
"d:\IDEWORK\lvmen\src\licensedcode\data\rules\false-positive_4567.yml", "YAML", 0, 0, 0, 2, 0, 0, 1, 3
"d:\IDEWORK\lvmen\src\licensedcode\data\rules\false-positive_4568.yml", "YAML", 0, 0, 0, 2, 0, 0, 1, 3
"d:\IDEWORK\lvmen\src\licensedcode\data\rules\false-positive_4569.yml", "YAML", 0, 0, 0, 2, 0, 0, 1, 3
"d:\IDEWORK\lvmen\src\licensedcode\data\rules\false-positive_457.yml", "YAML", 0, 0, 0, 2, 0, 0, 1, 3
"d:\IDEWORK\lvmen\src\licensedcode\data\rules\false-positive_4570.yml", "YAML", 0, 0, 0, 2, 0, 0, 1, 3
"d:\IDEWORK\lvmen\src\licensedcode\data\rules\false-positive_4571.yml", "YAML", 0, 0, 0, 2, 0, 0, 1, 3
"d:\IDEWORK\lvmen\src\licensedcode\data\rules\false-positive_4572.yml", "YAML", 0, 0, 0, 2, 0, 0, 1, 3
"d:\IDEWORK\lvmen\src\licensedcode\data\rules\false-positive_4573.yml", "YAML", 0, 0, 0, 2, 0, 0, 1, 3
"d:\IDEWORK\lvmen\src\licensedcode\data\rules\false-positive_4574.yml", "YAML", 0, 0, 0, 2, 0, 0, 1, 3
"d:\IDEWORK\lvmen\src\licensedcode\data\rules\false-positive_4575.yml", "YAML", 0, 0, 0, 2, 0, 0, 1, 3
"d:\IDEWORK\lvmen\src\licensedcode\data\rules\false-positive_4576.yml", "YAML", 0, 0, 0, 2, 0, 0, 1, 3
"d:\IDEWORK\lvmen\src\licensedcode\data\rules\false-positive_4577.yml", "YAML", 0, 0, 0, 2, 0, 0, 1, 3
"d:\IDEWORK\lvmen\src\licensedcode\data\rules\false-positive_4578.yml", "YAML", 0, 0, 0, 2, 0, 0, 1, 3
"d:\IDEWORK\lvmen\src\licensedcode\data\rules\false-positive_4579.yml", "YAML", 0, 0, 0, 2, 0, 0, 1, 3
"d:\IDEWORK\lvmen\src\licensedcode\data\rules\false-positive_458.yml", "YAML", 0, 0, 0, 2, 0, 0, 1, 3
"d:\IDEWORK\lvmen\src\licensedcode\data\rules\false-positive_4580.yml", "YAML", 0, 0, 0, 2, 0, 0, 1, 3
"d:\IDEWORK\lvmen\src\licensedcode\data\rules\false-positive_4581.yml", "YAML", 0, 0, 0, 2, 0, 0, 1, 3
"d:\IDEWORK\lvmen\src\licensedcode\data\rules\false-positive_4582.yml", "YAML", 0, 0, 0, 2, 0, 0, 1, 3
"d:\IDEWORK\lvmen\src\licensedcode\data\rules\false-positive_4583.yml", "YAML", 0, 0, 0, 2, 0, 0, 1, 3
"d:\IDEWORK\lvmen\src\licensedcode\data\rules\false-positive_4584.yml", "YAML", 0, 0, 0, 2, 0, 0, 1, 3
"d:\IDEWORK\lvmen\src\licensedcode\data\rules\false-positive_4585.yml", "YAML", 0, 0, 0, 2, 0, 0, 1, 3
"d:\IDEWORK\lvmen\src\licensedcode\data\rules\false-positive_4586.yml", "YAML", 0, 0, 0, 2, 0, 0, 1, 3
"d:\IDEWORK\lvmen\src\licensedcode\data\rules\false-positive_4587.yml", "YAML", 0, 0, 0, 2, 0, 0, 1, 3
"d:\IDEWORK\lvmen\src\licensedcode\data\rules\false-positive_4588.yml", "YAML", 0, 0, 0, 2, 0, 0, 1, 3
"d:\IDEWORK\lvmen\src\licensedcode\data\rules\false-positive_4589.yml", "YAML", 0, 0, 0, 2, 0, 0, 1, 3
"d:\IDEWORK\lvmen\src\licensedcode\data\rules\false-positive_459.yml", "YAML", 0, 0, 0, 3, 0, 0, 1, 4
"d:\IDEWORK\lvmen\src\licensedcode\data\rules\false-positive_4590.yml", "YAML", 0, 0, 0, 2, 0, 0, 1, 3
"d:\IDEWORK\lvmen\src\licensedcode\data\rules\false-positive_4591.yml", "YAML", 0, 0, 0, 2, 0, 0, 1, 3
"d:\IDEWORK\lvmen\src\licensedcode\data\rules\false-positive_4592.yml", "YAML", 0, 0, 0, 2, 0, 0, 1, 3
"d:\IDEWORK\lvmen\src\licensedcode\data\rules\false-positive_4593.yml", "YAML", 0, 0, 0, 2, 0, 0, 1, 3
"d:\IDEWORK\lvmen\src\licensedcode\data\rules\false-positive_4594.yml", "YAML", 0, 0, 0, 2, 0, 0, 1, 3
"d:\IDEWORK\lvmen\src\licensedcode\data\rules\false-positive_4595.yml", "YAML", 0, 0, 0, 2, 0, 0, 1, 3
"d:\IDEWORK\lvmen\src\licensedcode\data\rules\false-positive_4596.yml", "YAML", 0, 0, 0, 2, 0, 0, 1, 3
"d:\IDEWORK\lvmen\src\licensedcode\data\rules\false-positive_4597.yml", "YAML", 0, 0, 0, 2, 0, 0, 1, 3
"d:\IDEWORK\lvmen\src\licensedcode\data\rules\false-positive_4598.yml", "YAML", 0, 0, 0, 2, 0, 0, 1, 3
"d:\IDEWORK\lvmen\src\licensedcode\data\rules\false-positive_4599.yml", "YAML", 0, 0, 0, 2, 0, 0, 1, 3
"d:\IDEWORK\lvmen\src\licensedcode\data\rules\false-positive_46.yml", "YAML", 0, 0, 0, 2, 0, 0, 1, 3
"d:\IDEWORK\lvmen\src\licensedcode\data\rules\false-positive_460.yml", "YAML", 0, 0, 0, 3, 0, 0, 1, 4
"d:\IDEWORK\lvmen\src\licensedcode\data\rules\false-positive_4600.yml", "YAML", 0, 0, 0, 2, 0, 0, 1, 3
"d:\IDEWORK\lvmen\src\licensedcode\data\rules\false-positive_4601.yml", "YAML", 0, 0, 0, 2, 0, 0, 1, 3
"d:\IDEWORK\lvmen\src\licensedcode\data\rules\false-positive_4602.yml", "YAML", 0, 0, 0, 2, 0, 0, 1, 3
"d:\IDEWORK\lvmen\src\licensedcode\data\rules\false-positive_4603.yml", "YAML", 0, 0, 0, 2, 0, 0, 1, 3
"d:\IDEWORK\lvmen\src\licensedcode\data\rules\false-positive_4604.yml", "YAML", 0, 0, 0, 2, 0, 0, 1, 3
"d:\IDEWORK\lvmen\src\licensedcode\data\rules\false-positive_4605.yml", "YAML", 0, 0, 0, 2, 0, 0, 1, 3
"d:\IDEWORK\lvmen\src\licensedcode\data\rules\false-positive_4606.yml", "YAML", 0, 0, 0, 2, 0, 0, 1, 3
"d:\IDEWORK\lvmen\src\licensedcode\data\rules\false-positive_4607.yml", "YAML", 0, 0, 0, 2, 0, 0, 1, 3
"d:\IDEWORK\lvmen\src\licensedcode\data\rules\false-positive_4608.yml", "YAML", 0, 0, 0, 2, 0, 0, 1, 3
"d:\IDEWORK\lvmen\src\licensedcode\data\rules\false-positive_4609.yml", "YAML", 0, 0, 0, 2, 0, 0, 1, 3
"d:\IDEWORK\lvmen\src\licensedcode\data\rules\false-positive_461.yml", "YAML", 0, 0, 0, 2, 0, 0, 1, 3
"d:\IDEWORK\lvmen\src\licensedcode\data\rules\false-positive_4610.yml", "YAML", 0, 0, 0, 2, 0, 0, 1, 3
"d:\IDEWORK\lvmen\src\licensedcode\data\rules\false-positive_4611.yml", "YAML", 0, 0, 0, 2, 0, 0, 1, 3
"d:\IDEWORK\lvmen\src\licensedcode\data\rules\false-positive_4612.yml", "YAML", 0, 0, 0, 2, 0, 0, 1, 3
"d:\IDEWORK\lvmen\src\licensedcode\data\rules\false-positive_4613.yml", "YAML", 0, 0, 0, 2, 0, 0, 1, 3
"d:\IDEWORK\lvmen\src\licensedcode\data\rules\false-positive_4614.yml", "YAML", 0, 0, 0, 2, 0, 0, 1, 3
"d:\IDEWORK\lvmen\src\licensedcode\data\rules\false-positive_4615.yml", "YAML", 0, 0, 0, 2, 0, 0, 1, 3
"d:\IDEWORK\lvmen\src\licensedcode\data\rules\false-positive_4616.yml", "YAML", 0, 0, 0, 2, 0, 0, 1, 3
"d:\IDEWORK\lvmen\src\licensedcode\data\rules\false-positive_4617.yml", "YAML", 0, 0, 0, 2, 0, 0, 1, 3
"d:\IDEWORK\lvmen\src\licensedcode\data\rules\false-positive_4618.yml", "YAML", 0, 0, 0, 2, 0, 0, 1, 3
"d:\IDEWORK\lvmen\src\licensedcode\data\rules\false-positive_4619.yml", "YAML", 0, 0, 0, 2, 0, 0, 1, 3
"d:\IDEWORK\lvmen\src\licensedcode\data\rules\false-positive_462.yml", "YAML", 0, 0, 0, 3, 0, 0, 1, 4
"d:\IDEWORK\lvmen\src\licensedcode\data\rules\false-positive_4620.yml", "YAML", 0, 0, 0, 2, 0, 0, 1, 3
"d:\IDEWORK\lvmen\src\licensedcode\data\rules\false-positive_4621.yml", "YAML", 0, 0, 0, 2, 0, 0, 1, 3
"d:\IDEWORK\lvmen\src\licensedcode\data\rules\false-positive_4622.yml", "YAML", 0, 0, 0, 2, 0, 0, 1, 3
"d:\IDEWORK\lvmen\src\licensedcode\data\rules\false-positive_4623.yml", "YAML", 0, 0, 0, 2, 0, 0, 1, 3
"d:\IDEWORK\lvmen\src\licensedcode\data\rules\false-positive_4624.yml", "YAML", 0, 0, 0, 2, 0, 0, 1, 3
"d:\IDEWORK\lvmen\src\licensedcode\data\rules\false-positive_4625.yml", "YAML", 0, 0, 0, 2, 0, 0, 1, 3
"d:\IDEWORK\lvmen\src\licensedcode\data\rules\false-positive_4626.yml", "YAML", 0, 0, 0, 2, 0, 0, 1, 3
"d:\IDEWORK\lvmen\src\licensedcode\data\rules\false-positive_4627.yml", "YAML", 0, 0, 0, 2, 0, 0, 1, 3
"d:\IDEWORK\lvmen\src\licensedcode\data\rules\false-positive_4628.yml", "YAML", 0, 0, 0, 2, 0, 0, 1, 3
"d:\IDEWORK\lvmen\src\licensedcode\data\rules\false-positive_4629.yml", "YAML", 0, 0, 0, 2, 0, 0, 1, 3
"d:\IDEWORK\lvmen\src\licensedcode\data\rules\false-positive_463.yml", "YAML", 0, 0, 0, 2, 0, 0, 1, 3
"d:\IDEWORK\lvmen\src\licensedcode\data\rules\false-positive_4630.yml", "YAML", 0, 0, 0, 2, 0, 0, 1, 3
"d:\IDEWORK\lvmen\src\licensedcode\data\rules\false-positive_4631.yml", "YAML", 0, 0, 0, 2, 0, 0, 1, 3
"d:\IDEWORK\lvmen\src\licensedcode\data\rules\false-positive_4632.yml", "YAML", 0, 0, 0, 2, 0, 0, 1, 3
"d:\IDEWORK\lvmen\src\licensedcode\data\rules\false-positive_4633.yml", "YAML", 0, 0, 0, 2, 0, 0, 1, 3
"d:\IDEWORK\lvmen\src\licensedcode\data\rules\false-positive_4634.yml", "YAML", 0, 0, 0, 2, 0, 0, 1, 3
"d:\IDEWORK\lvmen\src\licensedcode\data\rules\false-positive_4635.yml", "YAML", 0, 0, 0, 2, 0, 0, 1, 3
"d:\IDEWORK\lvmen\src\licensedcode\data\rules\false-positive_4636.yml", "YAML", 0, 0, 0, 2, 0, 0, 1, 3
"d:\IDEWORK\lvmen\src\licensedcode\data\rules\false-positive_4637.yml", "YAML", 0, 0, 0, 2, 0, 0, 1, 3
"d:\IDEWORK\lvmen\src\licensedcode\data\rules\false-positive_4638.yml", "YAML", 0, 0, 0, 2, 0, 0, 1, 3
"d:\IDEWORK\lvmen\src\licensedcode\data\rules\false-positive_4639.yml", "YAML", 0, 0, 0, 2, 0, 0, 1, 3
"d:\IDEWORK\lvmen\src\licensedcode\data\rules\false-positive_464.yml", "YAML", 0, 0, 0, 3, 0, 0, 1, 4
"d:\IDEWORK\lvmen\src\licensedcode\data\rules\false-positive_4640.yml", "YAML", 0, 0, 0, 2, 0, 0, 1, 3
"d:\IDEWORK\lvmen\src\licensedcode\data\rules\false-positive_4641.yml", "YAML", 0, 0, 0, 2, 0, 0, 1, 3
"d:\IDEWORK\lvmen\src\licensedcode\data\rules\false-positive_4642.yml", "YAML", 0, 0, 0, 2, 0, 0, 1, 3
"d:\IDEWORK\lvmen\src\licensedcode\data\rules\false-positive_4643.yml", "YAML", 0, 0, 0, 2, 0, 0, 1, 3
"d:\IDEWORK\lvmen\src\licensedcode\data\rules\false-positive_4644.yml", "YAML", 0, 0, 0, 2, 0, 0, 1, 3
"d:\IDEWORK\lvmen\src\licensedcode\data\rules\false-positive_4645.yml", "YAML", 0, 0, 0, 2, 0, 0, 1, 3
"d:\IDEWORK\lvmen\src\licensedcode\data\rules\false-positive_4646.yml", "YAML", 0, 0, 0, 2, 0, 0, 1, 3
"d:\IDEWORK\lvmen\src\licensedcode\data\rules\false-positive_4647.yml", "YAML", 0, 0, 0, 2, 0, 0, 1, 3
"d:\IDEWORK\lvmen\src\licensedcode\data\rules\false-positive_4648.yml", "YAML", 0, 0, 0, 2, 0, 0, 1, 3
"d:\IDEWORK\lvmen\src\licensedcode\data\rules\false-positive_4649.yml", "YAML", 0, 0, 0, 2, 0, 0, 1, 3
"d:\IDEWORK\lvmen\src\licensedcode\data\rules\false-positive_465.yml", "YAML", 0, 0, 0, 2, 0, 0, 1, 3
"d:\IDEWORK\lvmen\src\licensedcode\data\rules\false-positive_4650.yml", "YAML", 0, 0, 0, 2, 0, 0, 1, 3
"d:\IDEWORK\lvmen\src\licensedcode\data\rules\false-positive_4651.yml", "YAML", 0, 0, 0, 2, 0, 0, 1, 3
"d:\IDEWORK\lvmen\src\licensedcode\data\rules\false-positive_4652.yml", "YAML", 0, 0, 0, 2, 0, 0, 1, 3
"d:\IDEWORK\lvmen\src\licensedcode\data\rules\false-positive_4653.yml", "YAML", 0, 0, 0, 2, 0, 0, 1, 3
"d:\IDEWORK\lvmen\src\licensedcode\data\rules\false-positive_4654.yml", "YAML", 0, 0, 0, 2, 0, 0, 1, 3
"d:\IDEWORK\lvmen\src\licensedcode\data\rules\false-positive_4655.yml", "YAML", 0, 0, 0, 2, 0, 0, 1, 3
"d:\IDEWORK\lvmen\src\licensedcode\data\rules\false-positive_4656.yml", "YAML", 0, 0, 0, 2, 0, 0, 1, 3
"d:\IDEWORK\lvmen\src\licensedcode\data\rules\false-positive_4657.yml", "YAML", 0, 0, 0, 2, 0, 0, 1, 3
"d:\IDEWORK\lvmen\src\licensedcode\data\rules\false-positive_4658.yml", "YAML", 0, 0, 0, 2, 0, 0, 1, 3
"d:\IDEWORK\lvmen\src\licensedcode\data\rules\false-positive_4659.yml", "YAML", 0, 0, 0, 2, 0, 0, 1, 3
"d:\IDEWORK\lvmen\src\licensedcode\data\rules\false-positive_466.yml", "YAML", 0, 0, 0, 2, 0, 0, 1, 3
"d:\IDEWORK\lvmen\src\licensedcode\data\rules\false-positive_4660.yml", "YAML", 0, 0, 0, 2, 0, 0, 1, 3
"d:\IDEWORK\lvmen\src\licensedcode\data\rules\false-positive_4661.yml", "YAML", 0, 0, 0, 2, 0, 0, 1, 3
"d:\IDEWORK\lvmen\src\licensedcode\data\rules\false-positive_4662.yml", "YAML", 0, 0, 0, 2, 0, 0, 1, 3
"d:\IDEWORK\lvmen\src\licensedcode\data\rules\false-positive_4663.yml", "YAML", 0, 0, 0, 2, 0, 0, 1, 3
"d:\IDEWORK\lvmen\src\licensedcode\data\rules\false-positive_4664.yml", "YAML", 0, 0, 0, 2, 0, 0, 1, 3
"d:\IDEWORK\lvmen\src\licensedcode\data\rules\false-positive_4665.yml", "YAML", 0, 0, 0, 2, 0, 0, 1, 3
"d:\IDEWORK\lvmen\src\licensedcode\data\rules\false-positive_4666.yml", "YAML", 0, 0, 0, 2, 0, 0, 1, 3
"d:\IDEWORK\lvmen\src\licensedcode\data\rules\false-positive_4667.yml", "YAML", 0, 0, 0, 2, 0, 0, 1, 3
"d:\IDEWORK\lvmen\src\licensedcode\data\rules\false-positive_4668.yml", "YAML", 0, 0, 0, 2, 0, 0, 1, 3
"d:\IDEWORK\lvmen\src\licensedcode\data\rules\false-positive_4669.yml", "YAML", 0, 0, 0, 2, 0, 0, 1, 3
"d:\IDEWORK\lvmen\src\licensedcode\data\rules\false-positive_467.yml", "YAML", 0, 0, 0, 2, 0, 0, 1, 3
"d:\IDEWORK\lvmen\src\licensedcode\data\rules\false-positive_4670.yml", "YAML", 0, 0, 0, 2, 0, 0, 1, 3
"d:\IDEWORK\lvmen\src\licensedcode\data\rules\false-positive_4671.yml", "YAML", 0, 0, 0, 2, 0, 0, 1, 3
"d:\IDEWORK\lvmen\src\licensedcode\data\rules\false-positive_4672.yml", "YAML", 0, 0, 0, 2, 0, 0, 1, 3
"d:\IDEWORK\lvmen\src\licensedcode\data\rules\false-positive_4673.yml", "YAML", 0, 0, 0, 2, 0, 0, 1, 3
"d:\IDEWORK\lvmen\src\licensedcode\data\rules\false-positive_4674.yml", "YAML", 0, 0, 0, 2, 0, 0, 1, 3
"d:\IDEWORK\lvmen\src\licensedcode\data\rules\false-positive_4675.yml", "YAML", 0, 0, 0, 2, 0, 0, 1, 3
"d:\IDEWORK\lvmen\src\licensedcode\data\rules\false-positive_4676.yml", "YAML", 0, 0, 0, 2, 0, 0, 1, 3
"d:\IDEWORK\lvmen\src\licensedcode\data\rules\false-positive_4677.yml", "YAML", 0, 0, 0, 2, 0, 0, 1, 3
"d:\IDEWORK\lvmen\src\licensedcode\data\rules\false-positive_4678.yml", "YAML", 0, 0, 0, 2, 0, 0, 1, 3
"d:\IDEWORK\lvmen\src\licensedcode\data\rules\false-positive_4679.yml", "YAML", 0, 0, 0, 2, 0, 0, 1, 3
"d:\IDEWORK\lvmen\src\licensedcode\data\rules\false-positive_468.yml", "YAML", 0, 0, 0, 2, 0, 0, 1, 3
"d:\IDEWORK\lvmen\src\licensedcode\data\rules\false-positive_4680.yml", "YAML", 0, 0, 0, 2, 0, 0, 1, 3
"d:\IDEWORK\lvmen\src\licensedcode\data\rules\false-positive_4681.yml", "YAML", 0, 0, 0, 2, 0, 0, 1, 3
"d:\IDEWORK\lvmen\src\licensedcode\data\rules\false-positive_4682.yml", "YAML", 0, 0, 0, 2, 0, 0, 1, 3
"d:\IDEWORK\lvmen\src\licensedcode\data\rules\false-positive_4683.yml", "YAML", 0, 0, 0, 2, 0, 0, 1, 3
"d:\IDEWORK\lvmen\src\licensedcode\data\rules\false-positive_4684.yml", "YAML", 0, 0, 0, 2, 0, 0, 1, 3
"d:\IDEWORK\lvmen\src\licensedcode\data\rules\false-positive_4685.yml", "YAML", 0, 0, 0, 2, 0, 0, 1, 3
"d:\IDEWORK\lvmen\src\licensedcode\data\rules\false-positive_4686.yml", "YAML", 0, 0, 0, 2, 0, 0, 1, 3
"d:\IDEWORK\lvmen\src\licensedcode\data\rules\false-positive_4687.yml", "YAML", 0, 0, 0, 2, 0, 0, 1, 3
"d:\IDEWORK\lvmen\src\licensedcode\data\rules\false-positive_4688.yml", "YAML", 0, 0, 0, 2, 0, 0, 1, 3
"d:\IDEWORK\lvmen\src\licensedcode\data\rules\false-positive_4689.yml", "YAML", 0, 0, 0, 2, 0, 0, 1, 3
"d:\IDEWORK\lvmen\src\licensedcode\data\rules\false-positive_469.yml", "YAML", 0, 0, 0, 2, 0, 0, 1, 3
"d:\IDEWORK\lvmen\src\licensedcode\data\rules\false-positive_4690.yml", "YAML", 0, 0, 0, 2, 0, 0, 1, 3
"d:\IDEWORK\lvmen\src\licensedcode\data\rules\false-positive_4691.yml", "YAML", 0, 0, 0, 2, 0, 0, 1, 3
"d:\IDEWORK\lvmen\src\licensedcode\data\rules\false-positive_4692.yml", "YAML", 0, 0, 0, 2, 0, 0, 1, 3
"d:\IDEWORK\lvmen\src\licensedcode\data\rules\false-positive_4693.yml", "YAML", 0, 0, 0, 2, 0, 0, 1, 3
"d:\IDEWORK\lvmen\src\licensedcode\data\rules\false-positive_4694.yml", "YAML", 0, 0, 0, 2, 0, 0, 1, 3
"d:\IDEWORK\lvmen\src\licensedcode\data\rules\false-positive_4695.yml", "YAML", 0, 0, 0, 2, 0, 0, 1, 3
"d:\IDEWORK\lvmen\src\licensedcode\data\rules\false-positive_4696.yml", "YAML", 0, 0, 0, 2, 0, 0, 1, 3
"d:\IDEWORK\lvmen\src\licensedcode\data\rules\false-positive_4697.yml", "YAML", 0, 0, 0, 2, 0, 0, 1, 3
"d:\IDEWORK\lvmen\src\licensedcode\data\rules\false-positive_4698.yml", "YAML", 0, 0, 0, 2, 0, 0, 1, 3
"d:\IDEWORK\lvmen\src\licensedcode\data\rules\false-positive_4699.yml", "YAML", 0, 0, 0, 2, 0, 0, 1, 3
"d:\IDEWORK\lvmen\src\licensedcode\data\rules\false-positive_47.yml", "YAML", 0, 0, 0, 2, 0, 0, 1, 3
"d:\IDEWORK\lvmen\src\licensedcode\data\rules\false-positive_470.yml", "YAML", 0, 0, 0, 3, 0, 0, 1, 4
"d:\IDEWORK\lvmen\src\licensedcode\data\rules\false-positive_4700.yml", "YAML", 0, 0, 0, 2, 0, 0, 1, 3
"d:\IDEWORK\lvmen\src\licensedcode\data\rules\false-positive_4701.yml", "YAML", 0, 0, 0, 2, 0, 0, 1, 3
"d:\IDEWORK\lvmen\src\licensedcode\data\rules\false-positive_4702.yml", "YAML", 0, 0, 0, 2, 0, 0, 1, 3
"d:\IDEWORK\lvmen\src\licensedcode\data\rules\false-positive_4703.yml", "YAML", 0, 0, 0, 2, 0, 0, 1, 3
"d:\IDEWORK\lvmen\src\licensedcode\data\rules\false-positive_4704.yml", "YAML", 0, 0, 0, 2, 0, 0, 1, 3
"d:\IDEWORK\lvmen\src\licensedcode\data\rules\false-positive_4705.yml", "YAML", 0, 0, 0, 2, 0, 0, 1, 3
"d:\IDEWORK\lvmen\src\licensedcode\data\rules\false-positive_4706.yml", "YAML", 0, 0, 0, 2, 0, 0, 1, 3
"d:\IDEWORK\lvmen\src\licensedcode\data\rules\false-positive_4707.yml", "YAML", 0, 0, 0, 2, 0, 0, 1, 3
"d:\IDEWORK\lvmen\src\licensedcode\data\rules\false-positive_4708.yml", "YAML", 0, 0, 0, 2, 0, 0, 1, 3
"d:\IDEWORK\lvmen\src\licensedcode\data\rules\false-positive_4709.yml", "YAML", 0, 0, 0, 2, 0, 0, 1, 3
"d:\IDEWORK\lvmen\src\licensedcode\data\rules\false-positive_471.yml", "YAML", 0, 0, 0, 3, 0, 0, 1, 4
"d:\IDEWORK\lvmen\src\licensedcode\data\rules\false-positive_4710.yml", "YAML", 0, 0, 0, 2, 0, 0, 1, 3
"d:\IDEWORK\lvmen\src\licensedcode\data\rules\false-positive_4711.yml", "YAML", 0, 0, 0, 2, 0, 0, 1, 3
"d:\IDEWORK\lvmen\src\licensedcode\data\rules\false-positive_4712.yml", "YAML", 0, 0, 0, 2, 0, 0, 1, 3
"d:\IDEWORK\lvmen\src\licensedcode\data\rules\false-positive_4713.yml", "YAML", 0, 0, 0, 2, 0, 0, 1, 3
"d:\IDEWORK\lvmen\src\licensedcode\data\rules\false-positive_4714.yml", "YAML", 0, 0, 0, 2, 0, 0, 1, 3
"d:\IDEWORK\lvmen\src\licensedcode\data\rules\false-positive_4715.yml", "YAML", 0, 0, 0, 2, 0, 0, 1, 3
"d:\IDEWORK\lvmen\src\licensedcode\data\rules\false-positive_4716.yml", "YAML", 0, 0, 0, 2, 0, 0, 1, 3
"d:\IDEWORK\lvmen\src\licensedcode\data\rules\false-positive_4717.yml", "YAML", 0, 0, 0, 2, 0, 0, 1, 3
"d:\IDEWORK\lvmen\src\licensedcode\data\rules\false-positive_4718.yml", "YAML", 0, 0, 0, 2, 0, 0, 1, 3
"d:\IDEWORK\lvmen\src\licensedcode\data\rules\false-positive_4719.yml", "YAML", 0, 0, 0, 2, 0, 0, 1, 3
"d:\IDEWORK\lvmen\src\licensedcode\data\rules\false-positive_472.yml", "YAML", 0, 0, 0, 2, 0, 0, 1, 3
"d:\IDEWORK\lvmen\src\licensedcode\data\rules\false-positive_4720.yml", "YAML", 0, 0, 0, 2, 0, 0, 1, 3
"d:\IDEWORK\lvmen\src\licensedcode\data\rules\false-positive_4721.yml", "YAML", 0, 0, 0, 2, 0, 0, 1, 3
"d:\IDEWORK\lvmen\src\licensedcode\data\rules\false-positive_4722.yml", "YAML", 0, 0, 0, 2, 0, 0, 1, 3
"d:\IDEWORK\lvmen\src\licensedcode\data\rules\false-positive_4723.yml", "YAML", 0, 0, 0, 2, 0, 0, 1, 3
"d:\IDEWORK\lvmen\src\licensedcode\data\rules\false-positive_4724.yml", "YAML", 0, 0, 0, 2, 0, 0, 1, 3
"d:\IDEWORK\lvmen\src\licensedcode\data\rules\false-positive_4725.yml", "YAML", 0, 0, 0, 2, 0, 0, 1, 3
"d:\IDEWORK\lvmen\src\licensedcode\data\rules\false-positive_4726.yml", "YAML", 0, 0, 0, 2, 0, 0, 1, 3
"d:\IDEWORK\lvmen\src\licensedcode\data\rules\false-positive_4727.yml", "YAML", 0, 0, 0, 2, 0, 0, 1, 3
"d:\IDEWORK\lvmen\src\licensedcode\data\rules\false-positive_4728.yml", "YAML", 0, 0, 0, 2, 0, 0, 1, 3
"d:\IDEWORK\lvmen\src\licensedcode\data\rules\false-positive_4729.yml", "YAML", 0, 0, 0, 2, 0, 0, 1, 3
"d:\IDEWORK\lvmen\src\licensedcode\data\rules\false-positive_473.yml", "YAML", 0, 0, 0, 2, 0, 0, 1, 3
"d:\IDEWORK\lvmen\src\licensedcode\data\rules\false-positive_4730.yml", "YAML", 0, 0, 0, 2, 0, 0, 1, 3
"d:\IDEWORK\lvmen\src\licensedcode\data\rules\false-positive_4731.yml", "YAML", 0, 0, 0, 2, 0, 0, 1, 3
"d:\IDEWORK\lvmen\src\licensedcode\data\rules\false-positive_4732.yml", "YAML", 0, 0, 0, 2, 0, 0, 1, 3
"d:\IDEWORK\lvmen\src\licensedcode\data\rules\false-positive_4733.yml", "YAML", 0, 0, 0, 2, 0, 0, 1, 3
"d:\IDEWORK\lvmen\src\licensedcode\data\rules\false-positive_4734.yml", "YAML", 0, 0, 0, 2, 0, 0, 1, 3
"d:\IDEWORK\lvmen\src\licensedcode\data\rules\false-positive_4735.yml", "YAML", 0, 0, 0, 2, 0, 0, 1, 3
"d:\IDEWORK\lvmen\src\licensedcode\data\rules\false-positive_4736.yml", "YAML", 0, 0, 0, 2, 0, 0, 1, 3
"d:\IDEWORK\lvmen\src\licensedcode\data\rules\false-positive_4737.yml", "YAML", 0, 0, 0, 2, 0, 0, 1, 3
"d:\IDEWORK\lvmen\src\licensedcode\data\rules\false-positive_4738.yml", "YAML", 0, 0, 0, 2, 0, 0, 1, 3
"d:\IDEWORK\lvmen\src\licensedcode\data\rules\false-positive_4739.yml", "YAML", 0, 0, 0, 2, 0, 0, 1, 3
"d:\IDEWORK\lvmen\src\licensedcode\data\rules\false-positive_474.yml", "YAML", 0, 0, 0, 2, 0, 0, 1, 3
"d:\IDEWORK\lvmen\src\licensedcode\data\rules\false-positive_4740.yml", "YAML", 0, 0, 0, 2, 0, 0, 1, 3
"d:\IDEWORK\lvmen\src\licensedcode\data\rules\false-positive_4741.yml", "YAML", 0, 0, 0, 2, 0, 0, 1, 3
"d:\IDEWORK\lvmen\src\licensedcode\data\rules\false-positive_4742.yml", "YAML", 0, 0, 0, 2, 0, 0, 1, 3
"d:\IDEWORK\lvmen\src\licensedcode\data\rules\false-positive_4743.yml", "YAML", 0, 0, 0, 2, 0, 0, 1, 3
"d:\IDEWORK\lvmen\src\licensedcode\data\rules\false-positive_4744.yml", "YAML", 0, 0, 0, 2, 0, 0, 1, 3
"d:\IDEWORK\lvmen\src\licensedcode\data\rules\false-positive_4745.yml", "YAML", 0, 0, 0, 2, 0, 0, 1, 3
"d:\IDEWORK\lvmen\src\licensedcode\data\rules\false-positive_4746.yml", "YAML", 0, 0, 0, 2, 0, 0, 1, 3
"d:\IDEWORK\lvmen\src\licensedcode\data\rules\false-positive_4747.yml", "YAML", 0, 0, 0, 2, 0, 0, 1, 3
"d:\IDEWORK\lvmen\src\licensedcode\data\rules\false-positive_4748.yml", "YAML", 0, 0, 0, 2, 0, 0, 1, 3
"d:\IDEWORK\lvmen\src\licensedcode\data\rules\false-positive_4749.yml", "YAML", 0, 0, 0, 2, 0, 0, 1, 3
"d:\IDEWORK\lvmen\src\licensedcode\data\rules\false-positive_475.yml", "YAML", 0, 0, 0, 2, 0, 0, 1, 3
"d:\IDEWORK\lvmen\src\licensedcode\data\rules\false-positive_4750.yml", "YAML", 0, 0, 0, 2, 0, 0, 1, 3
"d:\IDEWORK\lvmen\src\licensedcode\data\rules\false-positive_4751.yml", "YAML", 0, 0, 0, 2, 0, 0, 1, 3
"d:\IDEWORK\lvmen\src\licensedcode\data\rules\false-positive_4752.yml", "YAML", 0, 0, 0, 2, 0, 0, 1, 3
"d:\IDEWORK\lvmen\src\licensedcode\data\rules\false-positive_4753.yml", "YAML", 0, 0, 0, 2, 0, 0, 1, 3
"d:\IDEWORK\lvmen\src\licensedcode\data\rules\false-positive_4754.yml", "YAML", 0, 0, 0, 2, 0, 0, 1, 3
"d:\IDEWORK\lvmen\src\licensedcode\data\rules\false-positive_4755.yml", "YAML", 0, 0, 0, 2, 0, 0, 1, 3
"d:\IDEWORK\lvmen\src\licensedcode\data\rules\false-positive_4756.yml", "YAML", 0, 0, 0, 2, 0, 0, 1, 3
"d:\IDEWORK\lvmen\src\licensedcode\data\rules\false-positive_4757.yml", "YAML", 0, 0, 0, 2, 0, 0, 1, 3
"d:\IDEWORK\lvmen\src\licensedcode\data\rules\false-positive_4758.yml", "YAML", 0, 0, 0, 2, 0, 0, 1, 3
"d:\IDEWORK\lvmen\src\licensedcode\data\rules\false-positive_4759.yml", "YAML", 0, 0, 0, 2, 0, 0, 1, 3
"d:\IDEWORK\lvmen\src\licensedcode\data\rules\false-positive_476.yml", "YAML", 0, 0, 0, 2, 0, 0, 1, 3
"d:\IDEWORK\lvmen\src\licensedcode\data\rules\false-positive_4760.yml", "YAML", 0, 0, 0, 2, 0, 0, 1, 3
"d:\IDEWORK\lvmen\src\licensedcode\data\rules\false-positive_4761.yml", "YAML", 0, 0, 0, 2, 0, 0, 1, 3
"d:\IDEWORK\lvmen\src\licensedcode\data\rules\false-positive_4762.yml", "YAML", 0, 0, 0, 2, 0, 0, 1, 3
"d:\IDEWORK\lvmen\src\licensedcode\data\rules\false-positive_4763.yml", "YAML", 0, 0, 0, 2, 0, 0, 1, 3
"d:\IDEWORK\lvmen\src\licensedcode\data\rules\false-positive_4764.yml", "YAML", 0, 0, 0, 2, 0, 0, 1, 3
"d:\IDEWORK\lvmen\src\licensedcode\data\rules\false-positive_4765.yml", "YAML", 0, 0, 0, 2, 0, 0, 1, 3
"d:\IDEWORK\lvmen\src\licensedcode\data\rules\false-positive_4766.yml", "YAML", 0, 0, 0, 2, 0, 0, 1, 3
"d:\IDEWORK\lvmen\src\licensedcode\data\rules\false-positive_4767.yml", "YAML", 0, 0, 0, 2, 0, 0, 1, 3
"d:\IDEWORK\lvmen\src\licensedcode\data\rules\false-positive_4768.yml", "YAML", 0, 0, 0, 2, 0, 0, 1, 3
"d:\IDEWORK\lvmen\src\licensedcode\data\rules\false-positive_4769.yml", "YAML", 0, 0, 0, 2, 0, 0, 1, 3
"d:\IDEWORK\lvmen\src\licensedcode\data\rules\false-positive_477.yml", "YAML", 0, 0, 0, 2, 0, 0, 1, 3
"d:\IDEWORK\lvmen\src\licensedcode\data\rules\false-positive_4770.yml", "YAML", 0, 0, 0, 2, 0, 0, 1, 3
"d:\IDEWORK\lvmen\src\licensedcode\data\rules\false-positive_4771.yml", "YAML", 0, 0, 0, 2, 0, 0, 1, 3
"d:\IDEWORK\lvmen\src\licensedcode\data\rules\false-positive_4772.yml", "YAML", 0, 0, 0, 2, 0, 0, 1, 3
"d:\IDEWORK\lvmen\src\licensedcode\data\rules\false-positive_4773.yml", "YAML", 0, 0, 0, 2, 0, 0, 1, 3
"d:\IDEWORK\lvmen\src\licensedcode\data\rules\false-positive_4774.yml", "YAML", 0, 0, 0, 2, 0, 0, 1, 3
"d:\IDEWORK\lvmen\src\licensedcode\data\rules\false-positive_4775.yml", "YAML", 0, 0, 0, 2, 0, 0, 1, 3
"d:\IDEWORK\lvmen\src\licensedcode\data\rules\false-positive_4776.yml", "YAML", 0, 0, 0, 2, 0, 0, 1, 3
"d:\IDEWORK\lvmen\src\licensedcode\data\rules\false-positive_4777.yml", "YAML", 0, 0, 0, 2, 0, 0, 1, 3
"d:\IDEWORK\lvmen\src\licensedcode\data\rules\false-positive_4778.yml", "YAML", 0, 0, 0, 2, 0, 0, 1, 3
"d:\IDEWORK\lvmen\src\licensedcode\data\rules\false-positive_4779.yml", "YAML", 0, 0, 0, 2, 0, 0, 1, 3
"d:\IDEWORK\lvmen\src\licensedcode\data\rules\false-positive_478.yml", "YAML", 0, 0, 0, 3, 0, 0, 1, 4
"d:\IDEWORK\lvmen\src\licensedcode\data\rules\false-positive_4780.yml", "YAML", 0, 0, 0, 2, 0, 0, 1, 3
"d:\IDEWORK\lvmen\src\licensedcode\data\rules\false-positive_4781.yml", "YAML", 0, 0, 0, 2, 0, 0, 1, 3
"d:\IDEWORK\lvmen\src\licensedcode\data\rules\false-positive_4782.yml", "YAML", 0, 0, 0, 2, 0, 0, 1, 3
"d:\IDEWORK\lvmen\src\licensedcode\data\rules\false-positive_4783.yml", "YAML", 0, 0, 0, 2, 0, 0, 1, 3
"d:\IDEWORK\lvmen\src\licensedcode\data\rules\false-positive_4784.yml", "YAML", 0, 0, 0, 2, 0, 0, 1, 3
"d:\IDEWORK\lvmen\src\licensedcode\data\rules\false-positive_4785.yml", "YAML", 0, 0, 0, 2, 0, 0, 1, 3
"d:\IDEWORK\lvmen\src\licensedcode\data\rules\false-positive_4786.yml", "YAML", 0, 0, 0, 2, 0, 0, 1, 3
"d:\IDEWORK\lvmen\src\licensedcode\data\rules\false-positive_4787.yml", "YAML", 0, 0, 0, 2, 0, 0, 1, 3
"d:\IDEWORK\lvmen\src\licensedcode\data\rules\false-positive_4788.yml", "YAML", 0, 0, 0, 2, 0, 0, 1, 3
"d:\IDEWORK\lvmen\src\licensedcode\data\rules\false-positive_4789.yml", "YAML", 0, 0, 0, 2, 0, 0, 1, 3
"d:\IDEWORK\lvmen\src\licensedcode\data\rules\false-positive_479.yml", "YAML", 0, 0, 0, 2, 0, 0, 1, 3
"d:\IDEWORK\lvmen\src\licensedcode\data\rules\false-positive_4790.yml", "YAML", 0, 0, 0, 2, 0, 0, 1, 3
"d:\IDEWORK\lvmen\src\licensedcode\data\rules\false-positive_4791.yml", "YAML", 0, 0, 0, 2, 0, 0, 1, 3
"d:\IDEWORK\lvmen\src\licensedcode\data\rules\false-positive_4792.yml", "YAML", 0, 0, 0, 2, 0, 0, 1, 3
"d:\IDEWORK\lvmen\src\licensedcode\data\rules\false-positive_4793.yml", "YAML", 0, 0, 0, 2, 0, 0, 1, 3
"d:\IDEWORK\lvmen\src\licensedcode\data\rules\false-positive_4794.yml", "YAML", 0, 0, 0, 2, 0, 0, 1, 3
"d:\IDEWORK\lvmen\src\licensedcode\data\rules\false-positive_4795.yml", "YAML", 0, 0, 0, 2, 0, 0, 1, 3
"d:\IDEWORK\lvmen\src\licensedcode\data\rules\false-positive_4796.yml", "YAML", 0, 0, 0, 2, 0, 0, 1, 3
"d:\IDEWORK\lvmen\src\licensedcode\data\rules\false-positive_4797.yml", "YAML", 0, 0, 0, 2, 0, 0, 1, 3
"d:\IDEWORK\lvmen\src\licensedcode\data\rules\false-positive_4798.yml", "YAML", 0, 0, 0, 2, 0, 0, 1, 3
"d:\IDEWORK\lvmen\src\licensedcode\data\rules\false-positive_4799.yml", "YAML", 0, 0, 0, 2, 0, 0, 1, 3
"d:\IDEWORK\lvmen\src\licensedcode\data\rules\false-positive_48.yml", "YAML", 0, 0, 0, 3, 0, 0, 1, 4
"d:\IDEWORK\lvmen\src\licensedcode\data\rules\false-positive_480.yml", "YAML", 0, 0, 0, 2, 0, 0, 1, 3
"d:\IDEWORK\lvmen\src\licensedcode\data\rules\false-positive_4800.yml", "YAML", 0, 0, 0, 2, 0, 0, 1, 3
"d:\IDEWORK\lvmen\src\licensedcode\data\rules\false-positive_4801.yml", "YAML", 0, 0, 0, 2, 0, 0, 1, 3
"d:\IDEWORK\lvmen\src\licensedcode\data\rules\false-positive_4802.yml", "YAML", 0, 0, 0, 2, 0, 0, 1, 3
"d:\IDEWORK\lvmen\src\licensedcode\data\rules\false-positive_4803.yml", "YAML", 0, 0, 0, 2, 0, 0, 1, 3
"d:\IDEWORK\lvmen\src\licensedcode\data\rules\false-positive_4804.yml", "YAML", 0, 0, 0, 2, 0, 0, 1, 3
"d:\IDEWORK\lvmen\src\licensedcode\data\rules\false-positive_4805.yml", "YAML", 0, 0, 0, 2, 0, 0, 1, 3
"d:\IDEWORK\lvmen\src\licensedcode\data\rules\false-positive_4806.yml", "YAML", 0, 0, 0, 2, 0, 0, 1, 3
"d:\IDEWORK\lvmen\src\licensedcode\data\rules\false-positive_4807.yml", "YAML", 0, 0, 0, 2, 0, 0, 1, 3
"d:\IDEWORK\lvmen\src\licensedcode\data\rules\false-positive_4808.yml", "YAML", 0, 0, 0, 2, 0, 0, 1, 3
"d:\IDEWORK\lvmen\src\licensedcode\data\rules\false-positive_4809.yml", "YAML", 0, 0, 0, 2, 0, 0, 1, 3
"d:\IDEWORK\lvmen\src\licensedcode\data\rules\false-positive_481.yml", "YAML", 0, 0, 0, 3, 0, 0, 1, 4
"d:\IDEWORK\lvmen\src\licensedcode\data\rules\false-positive_4810.yml", "YAML", 0, 0, 0, 2, 0, 0, 1, 3
"d:\IDEWORK\lvmen\src\licensedcode\data\rules\false-positive_4811.yml", "YAML", 0, 0, 0, 2, 0, 0, 1, 3
"d:\IDEWORK\lvmen\src\licensedcode\data\rules\false-positive_4812.yml", "YAML", 0, 0, 0, 2, 0, 0, 1, 3
"d:\IDEWORK\lvmen\src\licensedcode\data\rules\false-positive_4813.yml", "YAML", 0, 0, 0, 2, 0, 0, 1, 3
"d:\IDEWORK\lvmen\src\licensedcode\data\rules\false-positive_4814.yml", "YAML", 0, 0, 0, 2, 0, 0, 1, 3
"d:\IDEWORK\lvmen\src\licensedcode\data\rules\false-positive_4815.yml", "YAML", 0, 0, 0, 2, 0, 0, 1, 3
"d:\IDEWORK\lvmen\src\licensedcode\data\rules\false-positive_4816.yml", "YAML", 0, 0, 0, 2, 0, 0, 1, 3
"d:\IDEWORK\lvmen\src\licensedcode\data\rules\false-positive_4817.yml", "YAML", 0, 0, 0, 2, 0, 0, 1, 3
"d:\IDEWORK\lvmen\src\licensedcode\data\rules\false-positive_4818.yml", "YAML", 0, 0, 0, 2, 0, 0, 1, 3
"d:\IDEWORK\lvmen\src\licensedcode\data\rules\false-positive_4819.yml", "YAML", 0, 0, 0, 2, 0, 0, 1, 3
"d:\IDEWORK\lvmen\src\licensedcode\data\rules\false-positive_482.yml", "YAML", 0, 0, 0, 2, 0, 0, 1, 3
"d:\IDEWORK\lvmen\src\licensedcode\data\rules\false-positive_4820.yml", "YAML", 0, 0, 0, 2, 0, 0, 1, 3
"d:\IDEWORK\lvmen\src\licensedcode\data\rules\false-positive_4821.yml", "YAML", 0, 0, 0, 2, 0, 0, 1, 3
"d:\IDEWORK\lvmen\src\licensedcode\data\rules\false-positive_4822.yml", "YAML", 0, 0, 0, 2, 0, 0, 1, 3
"d:\IDEWORK\lvmen\src\licensedcode\data\rules\false-positive_4823.yml", "YAML", 0, 0, 0, 2, 0, 0, 1, 3
"d:\IDEWORK\lvmen\src\licensedcode\data\rules\false-positive_4824.yml", "YAML", 0, 0, 0, 2, 0, 0, 1, 3
"d:\IDEWORK\lvmen\src\licensedcode\data\rules\false-positive_4825.yml", "YAML", 0, 0, 0, 2, 0, 0, 1, 3
"d:\IDEWORK\lvmen\src\licensedcode\data\rules\false-positive_4826.yml", "YAML", 0, 0, 0, 2, 0, 0, 1, 3
"d:\IDEWORK\lvmen\src\licensedcode\data\rules\false-positive_4827.yml", "YAML", 0, 0, 0, 2, 0, 0, 1, 3
"d:\IDEWORK\lvmen\src\licensedcode\data\rules\false-positive_4828.yml", "YAML", 0, 0, 0, 2, 0, 0, 1, 3
"d:\IDEWORK\lvmen\src\licensedcode\data\rules\false-positive_4829.yml", "YAML", 0, 0, 0, 2, 0, 0, 1, 3
"d:\IDEWORK\lvmen\src\licensedcode\data\rules\false-positive_483.yml", "YAML", 0, 0, 0, 2, 0, 0, 1, 3
"d:\IDEWORK\lvmen\src\licensedcode\data\rules\false-positive_4830.yml", "YAML", 0, 0, 0, 2, 0, 0, 1, 3
"d:\IDEWORK\lvmen\src\licensedcode\data\rules\false-positive_4831.yml", "YAML", 0, 0, 0, 2, 0, 0, 1, 3
"d:\IDEWORK\lvmen\src\licensedcode\data\rules\false-positive_4832.yml", "YAML", 0, 0, 0, 2, 0, 0, 1, 3
"d:\IDEWORK\lvmen\src\licensedcode\data\rules\false-positive_4833.yml", "YAML", 0, 0, 0, 2, 0, 0, 1, 3
"d:\IDEWORK\lvmen\src\licensedcode\data\rules\false-positive_4834.yml", "YAML", 0, 0, 0, 2, 0, 0, 1, 3
"d:\IDEWORK\lvmen\src\licensedcode\data\rules\false-positive_4835.yml", "YAML", 0, 0, 0, 2, 0, 0, 1, 3
"d:\IDEWORK\lvmen\src\licensedcode\data\rules\false-positive_4836.yml", "YAML", 0, 0, 0, 2, 0, 0, 1, 3
"d:\IDEWORK\lvmen\src\licensedcode\data\rules\false-positive_4837.yml", "YAML", 0, 0, 0, 2, 0, 0, 1, 3
"d:\IDEWORK\lvmen\src\licensedcode\data\rules\false-positive_4838.yml", "YAML", 0, 0, 0, 2, 0, 0, 1, 3
"d:\IDEWORK\lvmen\src\licensedcode\data\rules\false-positive_4839.yml", "YAML", 0, 0, 0, 2, 0, 0, 1, 3
"d:\IDEWORK\lvmen\src\licensedcode\data\rules\false-positive_484.yml", "YAML", 0, 0, 0, 2, 0, 0, 1, 3
"d:\IDEWORK\lvmen\src\licensedcode\data\rules\false-positive_4840.yml", "YAML", 0, 0, 0, 2, 0, 0, 1, 3
"d:\IDEWORK\lvmen\src\licensedcode\data\rules\false-positive_4841.yml", "YAML", 0, 0, 0, 2, 0, 0, 1, 3
"d:\IDEWORK\lvmen\src\licensedcode\data\rules\false-positive_4842.yml", "YAML", 0, 0, 0, 2, 0, 0, 1, 3
"d:\IDEWORK\lvmen\src\licensedcode\data\rules\false-positive_4843.yml", "YAML", 0, 0, 0, 2, 0, 0, 1, 3
"d:\IDEWORK\lvmen\src\licensedcode\data\rules\false-positive_4844.yml", "YAML", 0, 0, 0, 2, 0, 0, 1, 3
"d:\IDEWORK\lvmen\src\licensedcode\data\rules\false-positive_4845.yml", "YAML", 0, 0, 0, 2, 0, 0, 1, 3
"d:\IDEWORK\lvmen\src\licensedcode\data\rules\false-positive_4846.yml", "YAML", 0, 0, 0, 2, 0, 0, 1, 3
"d:\IDEWORK\lvmen\src\licensedcode\data\rules\false-positive_4847.yml", "YAML", 0, 0, 0, 2, 0, 0, 1, 3
"d:\IDEWORK\lvmen\src\licensedcode\data\rules\false-positive_4848.yml", "YAML", 0, 0, 0, 2, 0, 0, 1, 3
"d:\IDEWORK\lvmen\src\licensedcode\data\rules\false-positive_4849.yml", "YAML", 0, 0, 0, 2, 0, 0, 1, 3
"d:\IDEWORK\lvmen\src\licensedcode\data\rules\false-positive_485.yml", "YAML", 0, 0, 0, 2, 0, 0, 1, 3
"d:\IDEWORK\lvmen\src\licensedcode\data\rules\false-positive_4850.yml", "YAML", 0, 0, 0, 2, 0, 0, 1, 3
"d:\IDEWORK\lvmen\src\licensedcode\data\rules\false-positive_4851.yml", "YAML", 0, 0, 0, 2, 0, 0, 1, 3
"d:\IDEWORK\lvmen\src\licensedcode\data\rules\false-positive_4852.yml", "YAML", 0, 0, 0, 2, 0, 0, 1, 3
"d:\IDEWORK\lvmen\src\licensedcode\data\rules\false-positive_4853.yml", "YAML", 0, 0, 0, 2, 0, 0, 1, 3
"d:\IDEWORK\lvmen\src\licensedcode\data\rules\false-positive_4854.yml", "YAML", 0, 0, 0, 2, 0, 0, 1, 3
"d:\IDEWORK\lvmen\src\licensedcode\data\rules\false-positive_4855.yml", "YAML", 0, 0, 0, 2, 0, 0, 1, 3
"d:\IDEWORK\lvmen\src\licensedcode\data\rules\false-positive_4856.yml", "YAML", 0, 0, 0, 2, 0, 0, 1, 3
"d:\IDEWORK\lvmen\src\licensedcode\data\rules\false-positive_4857.yml", "YAML", 0, 0, 0, 2, 0, 0, 1, 3
"d:\IDEWORK\lvmen\src\licensedcode\data\rules\false-positive_4858.yml", "YAML", 0, 0, 0, 2, 0, 0, 1, 3
"d:\IDEWORK\lvmen\src\licensedcode\data\rules\false-positive_4859.yml", "YAML", 0, 0, 0, 2, 0, 0, 1, 3
"d:\IDEWORK\lvmen\src\licensedcode\data\rules\false-positive_486.yml", "YAML", 0, 0, 0, 2, 0, 0, 1, 3
"d:\IDEWORK\lvmen\src\licensedcode\data\rules\false-positive_4860.yml", "YAML", 0, 0, 0, 2, 0, 0, 1, 3
"d:\IDEWORK\lvmen\src\licensedcode\data\rules\false-positive_4861.yml", "YAML", 0, 0, 0, 2, 0, 0, 1, 3
"d:\IDEWORK\lvmen\src\licensedcode\data\rules\false-positive_4862.yml", "YAML", 0, 0, 0, 2, 0, 0, 1, 3
"d:\IDEWORK\lvmen\src\licensedcode\data\rules\false-positive_4863.yml", "YAML", 0, 0, 0, 2, 0, 0, 1, 3
"d:\IDEWORK\lvmen\src\licensedcode\data\rules\false-positive_4864.yml", "YAML", 0, 0, 0, 2, 0, 0, 1, 3
"d:\IDEWORK\lvmen\src\licensedcode\data\rules\false-positive_4865.yml", "YAML", 0, 0, 0, 2, 0, 0, 1, 3
"d:\IDEWORK\lvmen\src\licensedcode\data\rules\false-positive_4866.yml", "YAML", 0, 0, 0, 2, 0, 0, 1, 3
"d:\IDEWORK\lvmen\src\licensedcode\data\rules\false-positive_4867.yml", "YAML", 0, 0, 0, 2, 0, 0, 1, 3
"d:\IDEWORK\lvmen\src\licensedcode\data\rules\false-positive_4868.yml", "YAML", 0, 0, 0, 2, 0, 0, 1, 3
"d:\IDEWORK\lvmen\src\licensedcode\data\rules\false-positive_4869.yml", "YAML", 0, 0, 0, 2, 0, 0, 1, 3
"d:\IDEWORK\lvmen\src\licensedcode\data\rules\false-positive_487.yml", "YAML", 0, 0, 0, 2, 0, 0, 1, 3
"d:\IDEWORK\lvmen\src\licensedcode\data\rules\false-positive_4870.yml", "YAML", 0, 0, 0, 2, 0, 0, 1, 3
"d:\IDEWORK\lvmen\src\licensedcode\data\rules\false-positive_4871.yml", "YAML", 0, 0, 0, 2, 0, 0, 1, 3
"d:\IDEWORK\lvmen\src\licensedcode\data\rules\false-positive_4872.yml", "YAML", 0, 0, 0, 2, 0, 0, 1, 3
"d:\IDEWORK\lvmen\src\licensedcode\data\rules\false-positive_4873.yml", "YAML", 0, 0, 0, 2, 0, 0, 1, 3
"d:\IDEWORK\lvmen\src\licensedcode\data\rules\false-positive_4874.yml", "YAML", 0, 0, 0, 2, 0, 0, 1, 3
"d:\IDEWORK\lvmen\src\licensedcode\data\rules\false-positive_4875.yml", "YAML", 0, 0, 0, 2, 0, 0, 1, 3
"d:\IDEWORK\lvmen\src\licensedcode\data\rules\false-positive_4876.yml", "YAML", 0, 0, 0, 2, 0, 0, 1, 3
"d:\IDEWORK\lvmen\src\licensedcode\data\rules\false-positive_4877.yml", "YAML", 0, 0, 0, 2, 0, 0, 1, 3
"d:\IDEWORK\lvmen\src\licensedcode\data\rules\false-positive_4878.yml", "YAML", 0, 0, 0, 2, 0, 0, 1, 3
"d:\IDEWORK\lvmen\src\licensedcode\data\rules\false-positive_4879.yml", "YAML", 0, 0, 0, 2, 0, 0, 1, 3
"d:\IDEWORK\lvmen\src\licensedcode\data\rules\false-positive_488.yml", "YAML", 0, 0, 0, 2, 0, 0, 1, 3
"d:\IDEWORK\lvmen\src\licensedcode\data\rules\false-positive_4880.yml", "YAML", 0, 0, 0, 2, 0, 0, 1, 3
"d:\IDEWORK\lvmen\src\licensedcode\data\rules\false-positive_4881.yml", "YAML", 0, 0, 0, 2, 0, 0, 1, 3
"d:\IDEWORK\lvmen\src\licensedcode\data\rules\false-positive_4882.yml", "YAML", 0, 0, 0, 2, 0, 0, 1, 3
"d:\IDEWORK\lvmen\src\licensedcode\data\rules\false-positive_4883.yml", "YAML", 0, 0, 0, 2, 0, 0, 1, 3
"d:\IDEWORK\lvmen\src\licensedcode\data\rules\false-positive_4884.yml", "YAML", 0, 0, 0, 2, 0, 0, 1, 3
"d:\IDEWORK\lvmen\src\licensedcode\data\rules\false-positive_4885.yml", "YAML", 0, 0, 0, 2, 0, 0, 1, 3
"d:\IDEWORK\lvmen\src\licensedcode\data\rules\false-positive_4886.yml", "YAML", 0, 0, 0, 2, 0, 0, 1, 3
"d:\IDEWORK\lvmen\src\licensedcode\data\rules\false-positive_4887.yml", "YAML", 0, 0, 0, 2, 0, 0, 1, 3
"d:\IDEWORK\lvmen\src\licensedcode\data\rules\false-positive_4888.yml", "YAML", 0, 0, 0, 2, 0, 0, 1, 3
"d:\IDEWORK\lvmen\src\licensedcode\data\rules\false-positive_4889.yml", "YAML", 0, 0, 0, 2, 0, 0, 1, 3
"d:\IDEWORK\lvmen\src\licensedcode\data\rules\false-positive_489.yml", "YAML", 0, 0, 0, 2, 0, 0, 1, 3
"d:\IDEWORK\lvmen\src\licensedcode\data\rules\false-positive_4890.yml", "YAML", 0, 0, 0, 2, 0, 0, 1, 3
"d:\IDEWORK\lvmen\src\licensedcode\data\rules\false-positive_4891.yml", "YAML", 0, 0, 0, 2, 0, 0, 1, 3
"d:\IDEWORK\lvmen\src\licensedcode\data\rules\false-positive_4892.yml", "YAML", 0, 0, 0, 2, 0, 0, 1, 3
"d:\IDEWORK\lvmen\src\licensedcode\data\rules\false-positive_4893.yml", "YAML", 0, 0, 0, 2, 0, 0, 1, 3
"d:\IDEWORK\lvmen\src\licensedcode\data\rules\false-positive_4894.yml", "YAML", 0, 0, 0, 2, 0, 0, 1, 3
"d:\IDEWORK\lvmen\src\licensedcode\data\rules\false-positive_4895.yml", "YAML", 0, 0, 0, 2, 0, 0, 1, 3
"d:\IDEWORK\lvmen\src\licensedcode\data\rules\false-positive_4896.yml", "YAML", 0, 0, 0, 2, 0, 0, 1, 3
"d:\IDEWORK\lvmen\src\licensedcode\data\rules\false-positive_4897.yml", "YAML", 0, 0, 0, 2, 0, 0, 1, 3
"d:\IDEWORK\lvmen\src\licensedcode\data\rules\false-positive_4898.yml", "YAML", 0, 0, 0, 2, 0, 0, 1, 3
"d:\IDEWORK\lvmen\src\licensedcode\data\rules\false-positive_4899.yml", "YAML", 0, 0, 0, 2, 0, 0, 1, 3
"d:\IDEWORK\lvmen\src\licensedcode\data\rules\false-positive_49.yml", "YAML", 0, 0, 0, 2, 0, 0, 1, 3
"d:\IDEWORK\lvmen\src\licensedcode\data\rules\false-positive_490.yml", "YAML", 0, 0, 0, 3, 0, 0, 1, 4
"d:\IDEWORK\lvmen\src\licensedcode\data\rules\false-positive_4900.yml", "YAML", 0, 0, 0, 2, 0, 0, 1, 3
"d:\IDEWORK\lvmen\src\licensedcode\data\rules\false-positive_4901.yml", "YAML", 0, 0, 0, 2, 0, 0, 1, 3
"d:\IDEWORK\lvmen\src\licensedcode\data\rules\false-positive_4902.yml", "YAML", 0, 0, 0, 2, 0, 0, 1, 3
"d:\IDEWORK\lvmen\src\licensedcode\data\rules\false-positive_4903.yml", "YAML", 0, 0, 0, 2, 0, 0, 1, 3
"d:\IDEWORK\lvmen\src\licensedcode\data\rules\false-positive_4904.yml", "YAML", 0, 0, 0, 2, 0, 0, 1, 3
"d:\IDEWORK\lvmen\src\licensedcode\data\rules\false-positive_4905.yml", "YAML", 0, 0, 0, 2, 0, 0, 1, 3
"d:\IDEWORK\lvmen\src\licensedcode\data\rules\false-positive_4906.yml", "YAML", 0, 0, 0, 2, 0, 0, 1, 3
"d:\IDEWORK\lvmen\src\licensedcode\data\rules\false-positive_4907.yml", "YAML", 0, 0, 0, 2, 0, 0, 1, 3
"d:\IDEWORK\lvmen\src\licensedcode\data\rules\false-positive_4908.yml", "YAML", 0, 0, 0, 2, 0, 0, 1, 3
"d:\IDEWORK\lvmen\src\licensedcode\data\rules\false-positive_4909.yml", "YAML", 0, 0, 0, 2, 0, 0, 1, 3
"d:\IDEWORK\lvmen\src\licensedcode\data\rules\false-positive_491.yml", "YAML", 0, 0, 0, 2, 0, 0, 1, 3
"d:\IDEWORK\lvmen\src\licensedcode\data\rules\false-positive_4910.yml", "YAML", 0, 0, 0, 2, 0, 0, 1, 3
"d:\IDEWORK\lvmen\src\licensedcode\data\rules\false-positive_4911.yml", "YAML", 0, 0, 0, 2, 0, 0, 1, 3
"d:\IDEWORK\lvmen\src\licensedcode\data\rules\false-positive_4912.yml", "YAML", 0, 0, 0, 2, 0, 0, 1, 3
"d:\IDEWORK\lvmen\src\licensedcode\data\rules\false-positive_4913.yml", "YAML", 0, 0, 0, 2, 0, 0, 1, 3
"d:\IDEWORK\lvmen\src\licensedcode\data\rules\false-positive_4914.yml", "YAML", 0, 0, 0, 2, 0, 0, 1, 3
"d:\IDEWORK\lvmen\src\licensedcode\data\rules\false-positive_4915.yml", "YAML", 0, 0, 0, 2, 0, 0, 1, 3
"d:\IDEWORK\lvmen\src\licensedcode\data\rules\false-positive_4916.yml", "YAML", 0, 0, 0, 2, 0, 0, 1, 3
"d:\IDEWORK\lvmen\src\licensedcode\data\rules\false-positive_4917.yml", "YAML", 0, 0, 0, 2, 0, 0, 1, 3
"d:\IDEWORK\lvmen\src\licensedcode\data\rules\false-positive_4918.yml", "YAML", 0, 0, 0, 2, 0, 0, 1, 3
"d:\IDEWORK\lvmen\src\licensedcode\data\rules\false-positive_4919.yml", "YAML", 0, 0, 0, 2, 0, 0, 1, 3
"d:\IDEWORK\lvmen\src\licensedcode\data\rules\false-positive_492.yml", "YAML", 0, 0, 0, 2, 0, 0, 1, 3
"d:\IDEWORK\lvmen\src\licensedcode\data\rules\false-positive_4920.yml", "YAML", 0, 0, 0, 2, 0, 0, 1, 3
"d:\IDEWORK\lvmen\src\licensedcode\data\rules\false-positive_4921.yml", "YAML", 0, 0, 0, 2, 0, 0, 1, 3
"d:\IDEWORK\lvmen\src\licensedcode\data\rules\false-positive_4922.yml", "YAML", 0, 0, 0, 2, 0, 0, 1, 3
"d:\IDEWORK\lvmen\src\licensedcode\data\rules\false-positive_4923.yml", "YAML", 0, 0, 0, 2, 0, 0, 1, 3
"d:\IDEWORK\lvmen\src\licensedcode\data\rules\false-positive_4924.yml", "YAML", 0, 0, 0, 2, 0, 0, 1, 3
"d:\IDEWORK\lvmen\src\licensedcode\data\rules\false-positive_4925.yml", "YAML", 0, 0, 0, 2, 0, 0, 1, 3
"d:\IDEWORK\lvmen\src\licensedcode\data\rules\false-positive_4926.yml", "YAML", 0, 0, 0, 2, 0, 0, 1, 3
"d:\IDEWORK\lvmen\src\licensedcode\data\rules\false-positive_4927.yml", "YAML", 0, 0, 0, 2, 0, 0, 1, 3
"d:\IDEWORK\lvmen\src\licensedcode\data\rules\false-positive_4928.yml", "YAML", 0, 0, 0, 2, 0, 0, 1, 3
"d:\IDEWORK\lvmen\src\licensedcode\data\rules\false-positive_4929.yml", "YAML", 0, 0, 0, 2, 0, 0, 1, 3
"d:\IDEWORK\lvmen\src\licensedcode\data\rules\false-positive_493.yml", "YAML", 0, 0, 0, 2, 0, 0, 1, 3
"d:\IDEWORK\lvmen\src\licensedcode\data\rules\false-positive_4930.yml", "YAML", 0, 0, 0, 2, 0, 0, 1, 3
"d:\IDEWORK\lvmen\src\licensedcode\data\rules\false-positive_4931.yml", "YAML", 0, 0, 0, 2, 0, 0, 1, 3
"d:\IDEWORK\lvmen\src\licensedcode\data\rules\false-positive_4932.yml", "YAML", 0, 0, 0, 2, 0, 0, 1, 3
"d:\IDEWORK\lvmen\src\licensedcode\data\rules\false-positive_4933.yml", "YAML", 0, 0, 0, 2, 0, 0, 1, 3
"d:\IDEWORK\lvmen\src\licensedcode\data\rules\false-positive_4934.yml", "YAML", 0, 0, 0, 2, 0, 0, 1, 3
"d:\IDEWORK\lvmen\src\licensedcode\data\rules\false-positive_4935.yml", "YAML", 0, 0, 0, 2, 0, 0, 1, 3
"d:\IDEWORK\lvmen\src\licensedcode\data\rules\false-positive_4936.yml", "YAML", 0, 0, 0, 2, 0, 0, 1, 3
"d:\IDEWORK\lvmen\src\licensedcode\data\rules\false-positive_4937.yml", "YAML", 0, 0, 0, 2, 0, 0, 1, 3
"d:\IDEWORK\lvmen\src\licensedcode\data\rules\false-positive_4938.yml", "YAML", 0, 0, 0, 2, 0, 0, 1, 3
"d:\IDEWORK\lvmen\src\licensedcode\data\rules\false-positive_4939.yml", "YAML", 0, 0, 0, 2, 0, 0, 1, 3
"d:\IDEWORK\lvmen\src\licensedcode\data\rules\false-positive_494.yml", "YAML", 0, 0, 0, 3, 0, 0, 1, 4
"d:\IDEWORK\lvmen\src\licensedcode\data\rules\false-positive_4940.yml", "YAML", 0, 0, 0, 2, 0, 0, 1, 3
"d:\IDEWORK\lvmen\src\licensedcode\data\rules\false-positive_4941.yml", "YAML", 0, 0, 0, 2, 0, 0, 1, 3
"d:\IDEWORK\lvmen\src\licensedcode\data\rules\false-positive_4942.yml", "YAML", 0, 0, 0, 2, 0, 0, 1, 3
"d:\IDEWORK\lvmen\src\licensedcode\data\rules\false-positive_4943.yml", "YAML", 0, 0, 0, 2, 0, 0, 1, 3
"d:\IDEWORK\lvmen\src\licensedcode\data\rules\false-positive_4944.yml", "YAML", 0, 0, 0, 2, 0, 0, 1, 3
"d:\IDEWORK\lvmen\src\licensedcode\data\rules\false-positive_4945.yml", "YAML", 0, 0, 0, 2, 0, 0, 1, 3
"d:\IDEWORK\lvmen\src\licensedcode\data\rules\false-positive_4946.yml", "YAML", 0, 0, 0, 2, 0, 0, 1, 3
"d:\IDEWORK\lvmen\src\licensedcode\data\rules\false-positive_4947.yml", "YAML", 0, 0, 0, 2, 0, 0, 1, 3
"d:\IDEWORK\lvmen\src\licensedcode\data\rules\false-positive_4948.yml", "YAML", 0, 0, 0, 2, 0, 0, 1, 3
"d:\IDEWORK\lvmen\src\licensedcode\data\rules\false-positive_4949.yml", "YAML", 0, 0, 0, 2, 0, 0, 1, 3
"d:\IDEWORK\lvmen\src\licensedcode\data\rules\false-positive_495.yml", "YAML", 0, 0, 0, 2, 0, 0, 1, 3
"d:\IDEWORK\lvmen\src\licensedcode\data\rules\false-positive_4950.yml", "YAML", 0, 0, 0, 2, 0, 0, 1, 3
"d:\IDEWORK\lvmen\src\licensedcode\data\rules\false-positive_4951.yml", "YAML", 0, 0, 0, 2, 0, 0, 1, 3
"d:\IDEWORK\lvmen\src\licensedcode\data\rules\false-positive_4952.yml", "YAML", 0, 0, 0, 2, 0, 0, 1, 3
"d:\IDEWORK\lvmen\src\licensedcode\data\rules\false-positive_4953.yml", "YAML", 0, 0, 0, 2, 0, 0, 1, 3
"d:\IDEWORK\lvmen\src\licensedcode\data\rules\false-positive_4954.yml", "YAML", 0, 0, 0, 2, 0, 0, 1, 3
"d:\IDEWORK\lvmen\src\licensedcode\data\rules\false-positive_4955.yml", "YAML", 0, 0, 0, 2, 0, 0, 1, 3
"d:\IDEWORK\lvmen\src\licensedcode\data\rules\false-positive_4956.yml", "YAML", 0, 0, 0, 2, 0, 0, 1, 3
"d:\IDEWORK\lvmen\src\licensedcode\data\rules\false-positive_4957.yml", "YAML", 0, 0, 0, 2, 0, 0, 1, 3
"d:\IDEWORK\lvmen\src\licensedcode\data\rules\false-positive_4958.yml", "YAML", 0, 0, 0, 2, 0, 0, 1, 3
"d:\IDEWORK\lvmen\src\licensedcode\data\rules\false-positive_4959.yml", "YAML", 0, 0, 0, 2, 0, 0, 1, 3
"d:\IDEWORK\lvmen\src\licensedcode\data\rules\false-positive_496.yml", "YAML", 0, 0, 0, 2, 0, 0, 1, 3
"d:\IDEWORK\lvmen\src\licensedcode\data\rules\false-positive_4960.yml", "YAML", 0, 0, 0, 2, 0, 0, 1, 3
"d:\IDEWORK\lvmen\src\licensedcode\data\rules\false-positive_4961.yml", "YAML", 0, 0, 0, 2, 0, 0, 1, 3
"d:\IDEWORK\lvmen\src\licensedcode\data\rules\false-positive_4962.yml", "YAML", 0, 0, 0, 2, 0, 0, 1, 3
"d:\IDEWORK\lvmen\src\licensedcode\data\rules\false-positive_4963.yml", "YAML", 0, 0, 0, 2, 0, 0, 1, 3
"d:\IDEWORK\lvmen\src\licensedcode\data\rules\false-positive_4964.yml", "YAML", 0, 0, 0, 2, 0, 0, 1, 3
"d:\IDEWORK\lvmen\src\licensedcode\data\rules\false-positive_4965.yml", "YAML", 0, 0, 0, 2, 0, 0, 1, 3
"d:\IDEWORK\lvmen\src\licensedcode\data\rules\false-positive_4966.yml", "YAML", 0, 0, 0, 2, 0, 0, 1, 3
"d:\IDEWORK\lvmen\src\licensedcode\data\rules\false-positive_4967.yml", "YAML", 0, 0, 0, 2, 0, 0, 1, 3
"d:\IDEWORK\lvmen\src\licensedcode\data\rules\false-positive_4968.yml", "YAML", 0, 0, 0, 2, 0, 0, 1, 3
"d:\IDEWORK\lvmen\src\licensedcode\data\rules\false-positive_4969.yml", "YAML", 0, 0, 0, 2, 0, 0, 1, 3
"d:\IDEWORK\lvmen\src\licensedcode\data\rules\false-positive_497.yml", "YAML", 0, 0, 0, 2, 0, 0, 1, 3
"d:\IDEWORK\lvmen\src\licensedcode\data\rules\false-positive_4970.yml", "YAML", 0, 0, 0, 2, 0, 0, 1, 3
"d:\IDEWORK\lvmen\src\licensedcode\data\rules\false-positive_4971.yml", "YAML", 0, 0, 0, 2, 0, 0, 1, 3
"d:\IDEWORK\lvmen\src\licensedcode\data\rules\false-positive_4972.yml", "YAML", 0, 0, 0, 2, 0, 0, 1, 3
"d:\IDEWORK\lvmen\src\licensedcode\data\rules\false-positive_4973.yml", "YAML", 0, 0, 0, 2, 0, 0, 1, 3
"d:\IDEWORK\lvmen\src\licensedcode\data\rules\false-positive_4974.yml", "YAML", 0, 0, 0, 2, 0, 0, 1, 3
"d:\IDEWORK\lvmen\src\licensedcode\data\rules\false-positive_4975.yml", "YAML", 0, 0, 0, 2, 0, 0, 1, 3
"d:\IDEWORK\lvmen\src\licensedcode\data\rules\false-positive_4976.yml", "YAML", 0, 0, 0, 2, 0, 0, 1, 3
"d:\IDEWORK\lvmen\src\licensedcode\data\rules\false-positive_4977.yml", "YAML", 0, 0, 0, 2, 0, 0, 1, 3
"d:\IDEWORK\lvmen\src\licensedcode\data\rules\false-positive_4978.yml", "YAML", 0, 0, 0, 2, 0, 0, 1, 3
"d:\IDEWORK\lvmen\src\licensedcode\data\rules\false-positive_4979.yml", "YAML", 0, 0, 0, 2, 0, 0, 1, 3
"d:\IDEWORK\lvmen\src\licensedcode\data\rules\false-positive_498.yml", "YAML", 0, 0, 0, 2, 0, 0, 1, 3
"d:\IDEWORK\lvmen\src\licensedcode\data\rules\false-positive_4980.yml", "YAML", 0, 0, 0, 2, 0, 0, 1, 3
"d:\IDEWORK\lvmen\src\licensedcode\data\rules\false-positive_4981.yml", "YAML", 0, 0, 0, 2, 0, 0, 1, 3
"d:\IDEWORK\lvmen\src\licensedcode\data\rules\false-positive_4982.yml", "YAML", 0, 0, 0, 2, 0, 0, 1, 3
"d:\IDEWORK\lvmen\src\licensedcode\data\rules\false-positive_4983.yml", "YAML", 0, 0, 0, 2, 0, 0, 1, 3
"d:\IDEWORK\lvmen\src\licensedcode\data\rules\false-positive_4984.yml", "YAML", 0, 0, 0, 2, 0, 0, 1, 3
"d:\IDEWORK\lvmen\src\licensedcode\data\rules\false-positive_4985.yml", "YAML", 0, 0, 0, 2, 0, 0, 1, 3
"d:\IDEWORK\lvmen\src\licensedcode\data\rules\false-positive_4986.yml", "YAML", 0, 0, 0, 2, 0, 0, 1, 3
"d:\IDEWORK\lvmen\src\licensedcode\data\rules\false-positive_4987.yml", "YAML", 0, 0, 0, 2, 0, 0, 1, 3
"d:\IDEWORK\lvmen\src\licensedcode\data\rules\false-positive_4988.yml", "YAML", 0, 0, 0, 2, 0, 0, 1, 3
"d:\IDEWORK\lvmen\src\licensedcode\data\rules\false-positive_4989.yml", "YAML", 0, 0, 0, 2, 0, 0, 1, 3
"d:\IDEWORK\lvmen\src\licensedcode\data\rules\false-positive_499.yml", "YAML", 0, 0, 0, 2, 0, 0, 1, 3
"d:\IDEWORK\lvmen\src\licensedcode\data\rules\false-positive_4990.yml", "YAML", 0, 0, 0, 2, 0, 0, 1, 3
"d:\IDEWORK\lvmen\src\licensedcode\data\rules\false-positive_4991.yml", "YAML", 0, 0, 0, 2, 0, 0, 1, 3
"d:\IDEWORK\lvmen\src\licensedcode\data\rules\false-positive_4992.yml", "YAML", 0, 0, 0, 2, 0, 0, 1, 3
"d:\IDEWORK\lvmen\src\licensedcode\data\rules\false-positive_4993.yml", "YAML", 0, 0, 0, 2, 0, 0, 1, 3
"d:\IDEWORK\lvmen\src\licensedcode\data\rules\false-positive_4994.yml", "YAML", 0, 0, 0, 2, 0, 0, 1, 3
"d:\IDEWORK\lvmen\src\licensedcode\data\rules\false-positive_4995.yml", "YAML", 0, 0, 0, 2, 0, 0, 1, 3
"d:\IDEWORK\lvmen\src\licensedcode\data\rules\false-positive_4996.yml", "YAML", 0, 0, 0, 2, 0, 0, 1, 3
"d:\IDEWORK\lvmen\src\licensedcode\data\rules\false-positive_4997.yml", "YAML", 0, 0, 0, 2, 0, 0, 1, 3
"d:\IDEWORK\lvmen\src\licensedcode\data\rules\false-positive_4998.yml", "YAML", 0, 0, 0, 2, 0, 0, 1, 3
"d:\IDEWORK\lvmen\src\licensedcode\data\rules\false-positive_4999.yml", "YAML", 0, 0, 0, 2, 0, 0, 1, 3
"d:\IDEWORK\lvmen\src\licensedcode\data\rules\false-positive_5.yml", "YAML", 0, 0, 0, 2, 0, 0, 1, 3
"d:\IDEWORK\lvmen\src\licensedcode\data\rules\false-positive_50.yml", "YAML", 0, 0, 0, 2, 0, 0, 1, 3
"d:\IDEWORK\lvmen\src\licensedcode\data\rules\false-positive_500.yml", "YAML", 0, 0, 0, 2, 0, 0, 1, 3
"d:\IDEWORK\lvmen\src\licensedcode\data\rules\false-positive_5000.yml", "YAML", 0, 0, 0, 2, 0, 0, 1, 3
"d:\IDEWORK\lvmen\src\licensedcode\data\rules\false-positive_5001.yml", "YAML", 0, 0, 0, 2, 0, 0, 1, 3
"d:\IDEWORK\lvmen\src\licensedcode\data\rules\false-positive_5002.yml", "YAML", 0, 0, 0, 2, 0, 0, 1, 3
"d:\IDEWORK\lvmen\src\licensedcode\data\rules\false-positive_5003.yml", "YAML", 0, 0, 0, 2, 0, 0, 1, 3
"d:\IDEWORK\lvmen\src\licensedcode\data\rules\false-positive_5004.yml", "YAML", 0, 0, 0, 2, 0, 0, 1, 3
"d:\IDEWORK\lvmen\src\licensedcode\data\rules\false-positive_5005.yml", "YAML", 0, 0, 0, 2, 0, 0, 1, 3
"d:\IDEWORK\lvmen\src\licensedcode\data\rules\false-positive_5006.yml", "YAML", 0, 0, 0, 2, 0, 0, 1, 3
"d:\IDEWORK\lvmen\src\licensedcode\data\rules\false-positive_5007.yml", "YAML", 0, 0, 0, 2, 0, 0, 1, 3
"d:\IDEWORK\lvmen\src\licensedcode\data\rules\false-positive_5008.yml", "YAML", 0, 0, 0, 2, 0, 0, 1, 3
"d:\IDEWORK\lvmen\src\licensedcode\data\rules\false-positive_5009.yml", "YAML", 0, 0, 0, 2, 0, 0, 1, 3
"d:\IDEWORK\lvmen\src\licensedcode\data\rules\false-positive_501.yml", "YAML", 0, 0, 0, 3, 0, 0, 1, 4
"d:\IDEWORK\lvmen\src\licensedcode\data\rules\false-positive_5010.yml", "YAML", 0, 0, 0, 2, 0, 0, 1, 3
"d:\IDEWORK\lvmen\src\licensedcode\data\rules\false-positive_5011.yml", "YAML", 0, 0, 0, 2, 0, 0, 1, 3
"d:\IDEWORK\lvmen\src\licensedcode\data\rules\false-positive_5012.yml", "YAML", 0, 0, 0, 2, 0, 0, 1, 3
"d:\IDEWORK\lvmen\src\licensedcode\data\rules\false-positive_5013.yml", "YAML", 0, 0, 0, 2, 0, 0, 1, 3
"d:\IDEWORK\lvmen\src\licensedcode\data\rules\false-positive_5014.yml", "YAML", 0, 0, 0, 2, 0, 0, 1, 3
"d:\IDEWORK\lvmen\src\licensedcode\data\rules\false-positive_5015.yml", "YAML", 0, 0, 0, 2, 0, 0, 1, 3
"d:\IDEWORK\lvmen\src\licensedcode\data\rules\false-positive_5016.yml", "YAML", 0, 0, 0, 2, 0, 0, 1, 3
"d:\IDEWORK\lvmen\src\licensedcode\data\rules\false-positive_5017.yml", "YAML", 0, 0, 0, 2, 0, 0, 1, 3
"d:\IDEWORK\lvmen\src\licensedcode\data\rules\false-positive_5018.yml", "YAML", 0, 0, 0, 2, 0, 0, 1, 3
"d:\IDEWORK\lvmen\src\licensedcode\data\rules\false-positive_5019.yml", "YAML", 0, 0, 0, 2, 0, 0, 1, 3
"d:\IDEWORK\lvmen\src\licensedcode\data\rules\false-positive_502.yml", "YAML", 0, 0, 0, 3, 0, 0, 1, 4
"d:\IDEWORK\lvmen\src\licensedcode\data\rules\false-positive_5020.yml", "YAML", 0, 0, 0, 2, 0, 0, 1, 3
"d:\IDEWORK\lvmen\src\licensedcode\data\rules\false-positive_5021.yml", "YAML", 0, 0, 0, 2, 0, 0, 1, 3
"d:\IDEWORK\lvmen\src\licensedcode\data\rules\false-positive_5022.yml", "YAML", 0, 0, 0, 2, 0, 0, 1, 3
"d:\IDEWORK\lvmen\src\licensedcode\data\rules\false-positive_5023.yml", "YAML", 0, 0, 0, 2, 0, 0, 1, 3
"d:\IDEWORK\lvmen\src\licensedcode\data\rules\false-positive_5024.yml", "YAML", 0, 0, 0, 2, 0, 0, 1, 3
"d:\IDEWORK\lvmen\src\licensedcode\data\rules\false-positive_5025.yml", "YAML", 0, 0, 0, 2, 0, 0, 1, 3
"d:\IDEWORK\lvmen\src\licensedcode\data\rules\false-positive_5026.yml", "YAML", 0, 0, 0, 2, 0, 0, 1, 3
"d:\IDEWORK\lvmen\src\licensedcode\data\rules\false-positive_5027.yml", "YAML", 0, 0, 0, 2, 0, 0, 1, 3
"d:\IDEWORK\lvmen\src\licensedcode\data\rules\false-positive_5028.yml", "YAML", 0, 0, 0, 2, 0, 0, 1, 3
"d:\IDEWORK\lvmen\src\licensedcode\data\rules\false-positive_5029.yml", "YAML", 0, 0, 0, 2, 0, 0, 1, 3
"d:\IDEWORK\lvmen\src\licensedcode\data\rules\false-positive_503.yml", "YAML", 0, 0, 0, 3, 0, 0, 1, 4
"d:\IDEWORK\lvmen\src\licensedcode\data\rules\false-positive_5030.yml", "YAML", 0, 0, 0, 2, 0, 0, 1, 3
"d:\IDEWORK\lvmen\src\licensedcode\data\rules\false-positive_5031.yml", "YAML", 0, 0, 0, 2, 0, 0, 1, 3
"d:\IDEWORK\lvmen\src\licensedcode\data\rules\false-positive_5032.yml", "YAML", 0, 0, 0, 2, 0, 0, 1, 3
"d:\IDEWORK\lvmen\src\licensedcode\data\rules\false-positive_5033.yml", "YAML", 0, 0, 0, 2, 0, 0, 1, 3
"d:\IDEWORK\lvmen\src\licensedcode\data\rules\false-positive_5034.yml", "YAML", 0, 0, 0, 2, 0, 0, 1, 3
"d:\IDEWORK\lvmen\src\licensedcode\data\rules\false-positive_5035.yml", "YAML", 0, 0, 0, 2, 0, 0, 1, 3
"d:\IDEWORK\lvmen\src\licensedcode\data\rules\false-positive_5036.yml", "YAML", 0, 0, 0, 2, 0, 0, 1, 3
"d:\IDEWORK\lvmen\src\licensedcode\data\rules\false-positive_5037.yml", "YAML", 0, 0, 0, 2, 0, 0, 1, 3
"d:\IDEWORK\lvmen\src\licensedcode\data\rules\false-positive_5038.yml", "YAML", 0, 0, 0, 2, 0, 0, 1, 3
"d:\IDEWORK\lvmen\src\licensedcode\data\rules\false-positive_5039.yml", "YAML", 0, 0, 0, 2, 0, 0, 1, 3
"d:\IDEWORK\lvmen\src\licensedcode\data\rules\false-positive_504.yml", "YAML", 0, 0, 0, 2, 0, 0, 1, 3
"d:\IDEWORK\lvmen\src\licensedcode\data\rules\false-positive_5040.yml", "YAML", 0, 0, 0, 2, 0, 0, 1, 3
"d:\IDEWORK\lvmen\src\licensedcode\data\rules\false-positive_5041.yml", "YAML", 0, 0, 0, 2, 0, 0, 1, 3
"d:\IDEWORK\lvmen\src\licensedcode\data\rules\false-positive_5042.yml", "YAML", 0, 0, 0, 2, 0, 0, 1, 3
"d:\IDEWORK\lvmen\src\licensedcode\data\rules\false-positive_5043.yml", "YAML", 0, 0, 0, 2, 0, 0, 1, 3
"d:\IDEWORK\lvmen\src\licensedcode\data\rules\false-positive_5044.yml", "YAML", 0, 0, 0, 2, 0, 0, 1, 3
"d:\IDEWORK\lvmen\src\licensedcode\data\rules\false-positive_5045.yml", "YAML", 0, 0, 0, 2, 0, 0, 1, 3
"d:\IDEWORK\lvmen\src\licensedcode\data\rules\false-positive_5046.yml", "YAML", 0, 0, 0, 2, 0, 0, 1, 3
"d:\IDEWORK\lvmen\src\licensedcode\data\rules\false-positive_5047.yml", "YAML", 0, 0, 0, 2, 0, 0, 1, 3
"d:\IDEWORK\lvmen\src\licensedcode\data\rules\false-positive_5048.yml", "YAML", 0, 0, 0, 2, 0, 0, 1, 3
"d:\IDEWORK\lvmen\src\licensedcode\data\rules\false-positive_5049.yml", "YAML", 0, 0, 0, 2, 0, 0, 1, 3
"d:\IDEWORK\lvmen\src\licensedcode\data\rules\false-positive_505.yml", "YAML", 0, 0, 0, 3, 0, 0, 1, 4
"d:\IDEWORK\lvmen\src\licensedcode\data\rules\false-positive_5050.yml", "YAML", 0, 0, 0, 2, 0, 0, 1, 3
"d:\IDEWORK\lvmen\src\licensedcode\data\rules\false-positive_5051.yml", "YAML", 0, 0, 0, 2, 0, 0, 1, 3
"d:\IDEWORK\lvmen\src\licensedcode\data\rules\false-positive_5052.yml", "YAML", 0, 0, 0, 2, 0, 0, 1, 3
"d:\IDEWORK\lvmen\src\licensedcode\data\rules\false-positive_5053.yml", "YAML", 0, 0, 0, 2, 0, 0, 1, 3
"d:\IDEWORK\lvmen\src\licensedcode\data\rules\false-positive_5054.yml", "YAML", 0, 0, 0, 2, 0, 0, 1, 3
"d:\IDEWORK\lvmen\src\licensedcode\data\rules\false-positive_5055.yml", "YAML", 0, 0, 0, 2, 0, 0, 1, 3
"d:\IDEWORK\lvmen\src\licensedcode\data\rules\false-positive_5056.yml", "YAML", 0, 0, 0, 2, 0, 0, 1, 3
"d:\IDEWORK\lvmen\src\licensedcode\data\rules\false-positive_5057.yml", "YAML", 0, 0, 0, 2, 0, 0, 1, 3
"d:\IDEWORK\lvmen\src\licensedcode\data\rules\false-positive_5058.yml", "YAML", 0, 0, 0, 2, 0, 0, 1, 3
"d:\IDEWORK\lvmen\src\licensedcode\data\rules\false-positive_5059.yml", "YAML", 0, 0, 0, 2, 0, 0, 1, 3
"d:\IDEWORK\lvmen\src\licensedcode\data\rules\false-positive_506.yml", "YAML", 0, 0, 0, 2, 0, 0, 1, 3
"d:\IDEWORK\lvmen\src\licensedcode\data\rules\false-positive_5060.yml", "YAML", 0, 0, 0, 2, 0, 0, 1, 3
"d:\IDEWORK\lvmen\src\licensedcode\data\rules\false-positive_5061.yml", "YAML", 0, 0, 0, 2, 0, 0, 1, 3
"d:\IDEWORK\lvmen\src\licensedcode\data\rules\false-positive_5062.yml", "YAML", 0, 0, 0, 2, 0, 0, 1, 3
"d:\IDEWORK\lvmen\src\licensedcode\data\rules\false-positive_5063.yml", "YAML", 0, 0, 0, 2, 0, 0, 1, 3
"d:\IDEWORK\lvmen\src\licensedcode\data\rules\false-positive_5064.yml", "YAML", 0, 0, 0, 2, 0, 0, 1, 3
"d:\IDEWORK\lvmen\src\licensedcode\data\rules\false-positive_5065.yml", "YAML", 0, 0, 0, 2, 0, 0, 1, 3
"d:\IDEWORK\lvmen\src\licensedcode\data\rules\false-positive_5066.yml", "YAML", 0, 0, 0, 2, 0, 0, 1, 3
"d:\IDEWORK\lvmen\src\licensedcode\data\rules\false-positive_5067.yml", "YAML", 0, 0, 0, 2, 0, 0, 1, 3
"d:\IDEWORK\lvmen\src\licensedcode\data\rules\false-positive_5068.yml", "YAML", 0, 0, 0, 2, 0, 0, 1, 3
"d:\IDEWORK\lvmen\src\licensedcode\data\rules\false-positive_5069.yml", "YAML", 0, 0, 0, 2, 0, 0, 1, 3
"d:\IDEWORK\lvmen\src\licensedcode\data\rules\false-positive_507.yml", "YAML", 0, 0, 0, 2, 0, 0, 1, 3
"d:\IDEWORK\lvmen\src\licensedcode\data\rules\false-positive_5070.yml", "YAML", 0, 0, 0, 2, 0, 0, 1, 3
"d:\IDEWORK\lvmen\src\licensedcode\data\rules\false-positive_5071.yml", "YAML", 0, 0, 0, 2, 0, 0, 1, 3
"d:\IDEWORK\lvmen\src\licensedcode\data\rules\false-positive_5072.yml", "YAML", 0, 0, 0, 2, 0, 0, 1, 3
"d:\IDEWORK\lvmen\src\licensedcode\data\rules\false-positive_5073.yml", "YAML", 0, 0, 0, 2, 0, 0, 1, 3
"d:\IDEWORK\lvmen\src\licensedcode\data\rules\false-positive_5074.yml", "YAML", 0, 0, 0, 2, 0, 0, 1, 3
"d:\IDEWORK\lvmen\src\licensedcode\data\rules\false-positive_5075.yml", "YAML", 0, 0, 0, 2, 0, 0, 1, 3
"d:\IDEWORK\lvmen\src\licensedcode\data\rules\false-positive_5076.yml", "YAML", 0, 0, 0, 2, 0, 0, 1, 3
"d:\IDEWORK\lvmen\src\licensedcode\data\rules\false-positive_5077.yml", "YAML", 0, 0, 0, 2, 0, 0, 1, 3
"d:\IDEWORK\lvmen\src\licensedcode\data\rules\false-positive_5078.yml", "YAML", 0, 0, 0, 2, 0, 0, 1, 3
"d:\IDEWORK\lvmen\src\licensedcode\data\rules\false-positive_5079.yml", "YAML", 0, 0, 0, 2, 0, 0, 1, 3
"d:\IDEWORK\lvmen\src\licensedcode\data\rules\false-positive_508.yml", "YAML", 0, 0, 0, 2, 0, 0, 1, 3
"d:\IDEWORK\lvmen\src\licensedcode\data\rules\false-positive_5080.yml", "YAML", 0, 0, 0, 2, 0, 0, 1, 3
"d:\IDEWORK\lvmen\src\licensedcode\data\rules\false-positive_5081.yml", "YAML", 0, 0, 0, 2, 0, 0, 1, 3
"d:\IDEWORK\lvmen\src\licensedcode\data\rules\false-positive_5082.yml", "YAML", 0, 0, 0, 2, 0, 0, 1, 3
"d:\IDEWORK\lvmen\src\licensedcode\data\rules\false-positive_5083.yml", "YAML", 0, 0, 0, 2, 0, 0, 1, 3
"d:\IDEWORK\lvmen\src\licensedcode\data\rules\false-positive_5084.yml", "YAML", 0, 0, 0, 2, 0, 0, 1, 3
"d:\IDEWORK\lvmen\src\licensedcode\data\rules\false-positive_5085.yml", "YAML", 0, 0, 0, 2, 0, 0, 1, 3
"d:\IDEWORK\lvmen\src\licensedcode\data\rules\false-positive_5086.yml", "YAML", 0, 0, 0, 2, 0, 0, 1, 3
"d:\IDEWORK\lvmen\src\licensedcode\data\rules\false-positive_5087.yml", "YAML", 0, 0, 0, 2, 0, 0, 1, 3
"d:\IDEWORK\lvmen\src\licensedcode\data\rules\false-positive_5088.yml", "YAML", 0, 0, 0, 2, 0, 0, 1, 3
"d:\IDEWORK\lvmen\src\licensedcode\data\rules\false-positive_5089.yml", "YAML", 0, 0, 0, 2, 0, 0, 1, 3
"d:\IDEWORK\lvmen\src\licensedcode\data\rules\false-positive_509.yml", "YAML", 0, 0, 0, 2, 0, 0, 1, 3
"d:\IDEWORK\lvmen\src\licensedcode\data\rules\false-positive_5090.yml", "YAML", 0, 0, 0, 2, 0, 0, 1, 3
"d:\IDEWORK\lvmen\src\licensedcode\data\rules\false-positive_5091.yml", "YAML", 0, 0, 0, 2, 0, 0, 1, 3
"d:\IDEWORK\lvmen\src\licensedcode\data\rules\false-positive_5092.yml", "YAML", 0, 0, 0, 2, 0, 0, 1, 3
"d:\IDEWORK\lvmen\src\licensedcode\data\rules\false-positive_5093.yml", "YAML", 0, 0, 0, 2, 0, 0, 1, 3
"d:\IDEWORK\lvmen\src\licensedcode\data\rules\false-positive_5094.yml", "YAML", 0, 0, 0, 2, 0, 0, 1, 3
"d:\IDEWORK\lvmen\src\licensedcode\data\rules\false-positive_5095.yml", "YAML", 0, 0, 0, 2, 0, 0, 1, 3
"d:\IDEWORK\lvmen\src\licensedcode\data\rules\false-positive_5096.yml", "YAML", 0, 0, 0, 2, 0, 0, 1, 3
"d:\IDEWORK\lvmen\src\licensedcode\data\rules\false-positive_5097.yml", "YAML", 0, 0, 0, 2, 0, 0, 1, 3
"d:\IDEWORK\lvmen\src\licensedcode\data\rules\false-positive_5098.yml", "YAML", 0, 0, 0, 2, 0, 0, 1, 3
"d:\IDEWORK\lvmen\src\licensedcode\data\rules\false-positive_5099.yml", "YAML", 0, 0, 0, 2, 0, 0, 1, 3
"d:\IDEWORK\lvmen\src\licensedcode\data\rules\false-positive_51.yml", "YAML", 0, 0, 0, 3, 0, 0, 1, 4
"d:\IDEWORK\lvmen\src\licensedcode\data\rules\false-positive_510.yml", "YAML", 0, 0, 0, 2, 0, 0, 1, 3
"d:\IDEWORK\lvmen\src\licensedcode\data\rules\false-positive_5100.yml", "YAML", 0, 0, 0, 2, 0, 0, 1, 3
"d:\IDEWORK\lvmen\src\licensedcode\data\rules\false-positive_5101.yml", "YAML", 0, 0, 0, 2, 0, 0, 1, 3
"d:\IDEWORK\lvmen\src\licensedcode\data\rules\false-positive_5102.yml", "YAML", 0, 0, 0, 2, 0, 0, 1, 3
"d:\IDEWORK\lvmen\src\licensedcode\data\rules\false-positive_5103.yml", "YAML", 0, 0, 0, 2, 0, 0, 1, 3
"d:\IDEWORK\lvmen\src\licensedcode\data\rules\false-positive_5104.yml", "YAML", 0, 0, 0, 2, 0, 0, 1, 3
"d:\IDEWORK\lvmen\src\licensedcode\data\rules\false-positive_5105.yml", "YAML", 0, 0, 0, 2, 0, 0, 1, 3
"d:\IDEWORK\lvmen\src\licensedcode\data\rules\false-positive_5106.yml", "YAML", 0, 0, 0, 2, 0, 0, 1, 3
"d:\IDEWORK\lvmen\src\licensedcode\data\rules\false-positive_5107.yml", "YAML", 0, 0, 0, 2, 0, 0, 1, 3
"d:\IDEWORK\lvmen\src\licensedcode\data\rules\false-positive_5108.yml", "YAML", 0, 0, 0, 2, 0, 0, 1, 3
"d:\IDEWORK\lvmen\src\licensedcode\data\rules\false-positive_5109.yml", "YAML", 0, 0, 0, 2, 0, 0, 1, 3
"d:\IDEWORK\lvmen\src\licensedcode\data\rules\false-positive_511.yml", "YAML", 0, 0, 0, 3, 0, 0, 1, 4
"d:\IDEWORK\lvmen\src\licensedcode\data\rules\false-positive_5110.yml", "YAML", 0, 0, 0, 2, 0, 0, 1, 3
"d:\IDEWORK\lvmen\src\licensedcode\data\rules\false-positive_5111.yml", "YAML", 0, 0, 0, 2, 0, 0, 1, 3
"d:\IDEWORK\lvmen\src\licensedcode\data\rules\false-positive_5112.yml", "YAML", 0, 0, 0, 2, 0, 0, 1, 3
"d:\IDEWORK\lvmen\src\licensedcode\data\rules\false-positive_5113.yml", "YAML", 0, 0, 0, 2, 0, 0, 1, 3
"d:\IDEWORK\lvmen\src\licensedcode\data\rules\false-positive_5114.yml", "YAML", 0, 0, 0, 2, 0, 0, 1, 3
"d:\IDEWORK\lvmen\src\licensedcode\data\rules\false-positive_5115.yml", "YAML", 0, 0, 0, 2, 0, 0, 1, 3
"d:\IDEWORK\lvmen\src\licensedcode\data\rules\false-positive_5116.yml", "YAML", 0, 0, 0, 2, 0, 0, 1, 3
"d:\IDEWORK\lvmen\src\licensedcode\data\rules\false-positive_5117.yml", "YAML", 0, 0, 0, 2, 0, 0, 1, 3
"d:\IDEWORK\lvmen\src\licensedcode\data\rules\false-positive_5118.yml", "YAML", 0, 0, 0, 2, 0, 0, 1, 3
"d:\IDEWORK\lvmen\src\licensedcode\data\rules\false-positive_5119.yml", "YAML", 0, 0, 0, 2, 0, 0, 1, 3
"d:\IDEWORK\lvmen\src\licensedcode\data\rules\false-positive_512.yml", "YAML", 0, 0, 0, 2, 0, 0, 1, 3
"d:\IDEWORK\lvmen\src\licensedcode\data\rules\false-positive_5120.yml", "YAML", 0, 0, 0, 2, 0, 0, 1, 3
"d:\IDEWORK\lvmen\src\licensedcode\data\rules\false-positive_5121.yml", "YAML", 0, 0, 0, 2, 0, 0, 1, 3
"d:\IDEWORK\lvmen\src\licensedcode\data\rules\false-positive_5122.yml", "YAML", 0, 0, 0, 2, 0, 0, 1, 3
"d:\IDEWORK\lvmen\src\licensedcode\data\rules\false-positive_5123.yml", "YAML", 0, 0, 0, 2, 0, 0, 1, 3
"d:\IDEWORK\lvmen\src\licensedcode\data\rules\false-positive_5124.yml", "YAML", 0, 0, 0, 2, 0, 0, 1, 3
"d:\IDEWORK\lvmen\src\licensedcode\data\rules\false-positive_5125.yml", "YAML", 0, 0, 0, 2, 0, 0, 1, 3
"d:\IDEWORK\lvmen\src\licensedcode\data\rules\false-positive_5126.yml", "YAML", 0, 0, 0, 2, 0, 0, 1, 3
"d:\IDEWORK\lvmen\src\licensedcode\data\rules\false-positive_5127.yml", "YAML", 0, 0, 0, 2, 0, 0, 1, 3
"d:\IDEWORK\lvmen\src\licensedcode\data\rules\false-positive_5128.yml", "YAML", 0, 0, 0, 2, 0, 0, 1, 3
"d:\IDEWORK\lvmen\src\licensedcode\data\rules\false-positive_5129.yml", "YAML", 0, 0, 0, 2, 0, 0, 1, 3
"d:\IDEWORK\lvmen\src\licensedcode\data\rules\false-positive_513.yml", "YAML", 0, 0, 0, 2, 0, 0, 1, 3
"d:\IDEWORK\lvmen\src\licensedcode\data\rules\false-positive_5130.yml", "YAML", 0, 0, 0, 2, 0, 0, 1, 3
"d:\IDEWORK\lvmen\src\licensedcode\data\rules\false-positive_5131.yml", "YAML", 0, 0, 0, 2, 0, 0, 1, 3
"d:\IDEWORK\lvmen\src\licensedcode\data\rules\false-positive_5132.yml", "YAML", 0, 0, 0, 2, 0, 0, 1, 3
"d:\IDEWORK\lvmen\src\licensedcode\data\rules\false-positive_5133.yml", "YAML", 0, 0, 0, 2, 0, 0, 1, 3
"d:\IDEWORK\lvmen\src\licensedcode\data\rules\false-positive_5134.yml", "YAML", 0, 0, 0, 2, 0, 0, 1, 3
"d:\IDEWORK\lvmen\src\licensedcode\data\rules\false-positive_5135.yml", "YAML", 0, 0, 0, 2, 0, 0, 1, 3
"d:\IDEWORK\lvmen\src\licensedcode\data\rules\false-positive_5136.yml", "YAML", 0, 0, 0, 2, 0, 0, 1, 3
"d:\IDEWORK\lvmen\src\licensedcode\data\rules\false-positive_5137.yml", "YAML", 0, 0, 0, 2, 0, 0, 1, 3
"d:\IDEWORK\lvmen\src\licensedcode\data\rules\false-positive_5138.yml", "YAML", 0, 0, 0, 2, 0, 0, 1, 3
"d:\IDEWORK\lvmen\src\licensedcode\data\rules\false-positive_5139.yml", "YAML", 0, 0, 0, 2, 0, 0, 1, 3
"d:\IDEWORK\lvmen\src\licensedcode\data\rules\false-positive_514.yml", "YAML", 0, 0, 0, 2, 0, 0, 1, 3
"d:\IDEWORK\lvmen\src\licensedcode\data\rules\false-positive_5140.yml", "YAML", 0, 0, 0, 2, 0, 0, 1, 3
"d:\IDEWORK\lvmen\src\licensedcode\data\rules\false-positive_5141.yml", "YAML", 0, 0, 0, 2, 0, 0, 1, 3
"d:\IDEWORK\lvmen\src\licensedcode\data\rules\false-positive_5142.yml", "YAML", 0, 0, 0, 2, 0, 0, 1, 3
"d:\IDEWORK\lvmen\src\licensedcode\data\rules\false-positive_5143.yml", "YAML", 0, 0, 0, 2, 0, 0, 1, 3
"d:\IDEWORK\lvmen\src\licensedcode\data\rules\false-positive_5144.yml", "YAML", 0, 0, 0, 2, 0, 0, 1, 3
"d:\IDEWORK\lvmen\src\licensedcode\data\rules\false-positive_5145.yml", "YAML", 0, 0, 0, 2, 0, 0, 1, 3
"d:\IDEWORK\lvmen\src\licensedcode\data\rules\false-positive_5146.yml", "YAML", 0, 0, 0, 2, 0, 0, 1, 3
"d:\IDEWORK\lvmen\src\licensedcode\data\rules\false-positive_5147.yml", "YAML", 0, 0, 0, 2, 0, 0, 1, 3
"d:\IDEWORK\lvmen\src\licensedcode\data\rules\false-positive_5148.yml", "YAML", 0, 0, 0, 2, 0, 0, 1, 3
"d:\IDEWORK\lvmen\src\licensedcode\data\rules\false-positive_5149.yml", "YAML", 0, 0, 0, 2, 0, 0, 1, 3
"d:\IDEWORK\lvmen\src\licensedcode\data\rules\false-positive_515.yml", "YAML", 0, 0, 0, 2, 0, 0, 1, 3
"d:\IDEWORK\lvmen\src\licensedcode\data\rules\false-positive_5150.yml", "YAML", 0, 0, 0, 2, 0, 0, 1, 3
"d:\IDEWORK\lvmen\src\licensedcode\data\rules\false-positive_5151.yml", "YAML", 0, 0, 0, 2, 0, 0, 1, 3
"d:\IDEWORK\lvmen\src\licensedcode\data\rules\false-positive_5152.yml", "YAML", 0, 0, 0, 2, 0, 0, 1, 3
"d:\IDEWORK\lvmen\src\licensedcode\data\rules\false-positive_5153.yml", "YAML", 0, 0, 0, 2, 0, 0, 1, 3
"d:\IDEWORK\lvmen\src\licensedcode\data\rules\false-positive_5154.yml", "YAML", 0, 0, 0, 2, 0, 0, 1, 3
"d:\IDEWORK\lvmen\src\licensedcode\data\rules\false-positive_5155.yml", "YAML", 0, 0, 0, 2, 0, 0, 1, 3
"d:\IDEWORK\lvmen\src\licensedcode\data\rules\false-positive_5156.yml", "YAML", 0, 0, 0, 2, 0, 0, 1, 3
"d:\IDEWORK\lvmen\src\licensedcode\data\rules\false-positive_5157.yml", "YAML", 0, 0, 0, 2, 0, 0, 1, 3
"d:\IDEWORK\lvmen\src\licensedcode\data\rules\false-positive_5158.yml", "YAML", 0, 0, 0, 2, 0, 0, 1, 3
"d:\IDEWORK\lvmen\src\licensedcode\data\rules\false-positive_5159.yml", "YAML", 0, 0, 0, 2, 0, 0, 1, 3
"d:\IDEWORK\lvmen\src\licensedcode\data\rules\false-positive_516.yml", "YAML", 0, 0, 0, 2, 0, 0, 1, 3
"d:\IDEWORK\lvmen\src\licensedcode\data\rules\false-positive_5160.yml", "YAML", 0, 0, 0, 2, 0, 0, 1, 3
"d:\IDEWORK\lvmen\src\licensedcode\data\rules\false-positive_5161.yml", "YAML", 0, 0, 0, 2, 0, 0, 1, 3
"d:\IDEWORK\lvmen\src\licensedcode\data\rules\false-positive_5162.yml", "YAML", 0, 0, 0, 2, 0, 0, 1, 3
"d:\IDEWORK\lvmen\src\licensedcode\data\rules\false-positive_5163.yml", "YAML", 0, 0, 0, 2, 0, 0, 1, 3
"d:\IDEWORK\lvmen\src\licensedcode\data\rules\false-positive_5164.yml", "YAML", 0, 0, 0, 2, 0, 0, 1, 3
"d:\IDEWORK\lvmen\src\licensedcode\data\rules\false-positive_5165.yml", "YAML", 0, 0, 0, 2, 0, 0, 1, 3
"d:\IDEWORK\lvmen\src\licensedcode\data\rules\false-positive_5166.yml", "YAML", 0, 0, 0, 2, 0, 0, 1, 3
"d:\IDEWORK\lvmen\src\licensedcode\data\rules\false-positive_5167.yml", "YAML", 0, 0, 0, 2, 0, 0, 1, 3
"d:\IDEWORK\lvmen\src\licensedcode\data\rules\false-positive_5168.yml", "YAML", 0, 0, 0, 2, 0, 0, 1, 3
"d:\IDEWORK\lvmen\src\licensedcode\data\rules\false-positive_5169.yml", "YAML", 0, 0, 0, 2, 0, 0, 1, 3
"d:\IDEWORK\lvmen\src\licensedcode\data\rules\false-positive_517.yml", "YAML", 0, 0, 0, 2, 0, 0, 1, 3
"d:\IDEWORK\lvmen\src\licensedcode\data\rules\false-positive_5170.yml", "YAML", 0, 0, 0, 2, 0, 0, 1, 3
"d:\IDEWORK\lvmen\src\licensedcode\data\rules\false-positive_5171.yml", "YAML", 0, 0, 0, 2, 0, 0, 1, 3
"d:\IDEWORK\lvmen\src\licensedcode\data\rules\false-positive_5172.yml", "YAML", 0, 0, 0, 2, 0, 0, 1, 3
"d:\IDEWORK\lvmen\src\licensedcode\data\rules\false-positive_5173.yml", "YAML", 0, 0, 0, 2, 0, 0, 1, 3
"d:\IDEWORK\lvmen\src\licensedcode\data\rules\false-positive_5174.yml", "YAML", 0, 0, 0, 2, 0, 0, 1, 3
"d:\IDEWORK\lvmen\src\licensedcode\data\rules\false-positive_5175.yml", "YAML", 0, 0, 0, 2, 0, 0, 1, 3
"d:\IDEWORK\lvmen\src\licensedcode\data\rules\false-positive_5176.yml", "YAML", 0, 0, 0, 2, 0, 0, 1, 3
"d:\IDEWORK\lvmen\src\licensedcode\data\rules\false-positive_5177.yml", "YAML", 0, 0, 0, 2, 0, 0, 1, 3
"d:\IDEWORK\lvmen\src\licensedcode\data\rules\false-positive_5178.yml", "YAML", 0, 0, 0, 2, 0, 0, 1, 3
"d:\IDEWORK\lvmen\src\licensedcode\data\rules\false-positive_5179.yml", "YAML", 0, 0, 0, 2, 0, 0, 1, 3
"d:\IDEWORK\lvmen\src\licensedcode\data\rules\false-positive_518.yml", "YAML", 0, 0, 0, 3, 0, 0, 1, 4
"d:\IDEWORK\lvmen\src\licensedcode\data\rules\false-positive_5180.yml", "YAML", 0, 0, 0, 2, 0, 0, 1, 3
"d:\IDEWORK\lvmen\src\licensedcode\data\rules\false-positive_5181.yml", "YAML", 0, 0, 0, 2, 0, 0, 1, 3
"d:\IDEWORK\lvmen\src\licensedcode\data\rules\false-positive_5182.yml", "YAML", 0, 0, 0, 2, 0, 0, 1, 3
"d:\IDEWORK\lvmen\src\licensedcode\data\rules\false-positive_5183.yml", "YAML", 0, 0, 0, 2, 0, 0, 1, 3
"d:\IDEWORK\lvmen\src\licensedcode\data\rules\false-positive_5184.yml", "YAML", 0, 0, 0, 2, 0, 0, 1, 3
"d:\IDEWORK\lvmen\src\licensedcode\data\rules\false-positive_5185.yml", "YAML", 0, 0, 0, 2, 0, 0, 1, 3
"d:\IDEWORK\lvmen\src\licensedcode\data\rules\false-positive_5186.yml", "YAML", 0, 0, 0, 2, 0, 0, 1, 3
"d:\IDEWORK\lvmen\src\licensedcode\data\rules\false-positive_5187.yml", "YAML", 0, 0, 0, 2, 0, 0, 1, 3
"d:\IDEWORK\lvmen\src\licensedcode\data\rules\false-positive_5188.yml", "YAML", 0, 0, 0, 2, 0, 0, 1, 3
"d:\IDEWORK\lvmen\src\licensedcode\data\rules\false-positive_5189.yml", "YAML", 0, 0, 0, 2, 0, 0, 1, 3
"d:\IDEWORK\lvmen\src\licensedcode\data\rules\false-positive_519.yml", "YAML", 0, 0, 0, 2, 0, 0, 1, 3
"d:\IDEWORK\lvmen\src\licensedcode\data\rules\false-positive_5190.yml", "YAML", 0, 0, 0, 2, 0, 0, 1, 3
"d:\IDEWORK\lvmen\src\licensedcode\data\rules\false-positive_5191.yml", "YAML", 0, 0, 0, 2, 0, 0, 1, 3
"d:\IDEWORK\lvmen\src\licensedcode\data\rules\false-positive_5192.yml", "YAML", 0, 0, 0, 2, 0, 0, 1, 3
"d:\IDEWORK\lvmen\src\licensedcode\data\rules\false-positive_5193.yml", "YAML", 0, 0, 0, 2, 0, 0, 1, 3
"d:\IDEWORK\lvmen\src\licensedcode\data\rules\false-positive_5194.yml", "YAML", 0, 0, 0, 2, 0, 0, 1, 3
"d:\IDEWORK\lvmen\src\licensedcode\data\rules\false-positive_5195.yml", "YAML", 0, 0, 0, 2, 0, 0, 1, 3
"d:\IDEWORK\lvmen\src\licensedcode\data\rules\false-positive_5196.yml", "YAML", 0, 0, 0, 2, 0, 0, 1, 3
"d:\IDEWORK\lvmen\src\licensedcode\data\rules\false-positive_5197.yml", "YAML", 0, 0, 0, 2, 0, 0, 1, 3
"d:\IDEWORK\lvmen\src\licensedcode\data\rules\false-positive_5198.yml", "YAML", 0, 0, 0, 2, 0, 0, 1, 3
"d:\IDEWORK\lvmen\src\licensedcode\data\rules\false-positive_5199.yml", "YAML", 0, 0, 0, 2, 0, 0, 1, 3
"d:\IDEWORK\lvmen\src\licensedcode\data\rules\false-positive_52.yml", "YAML", 0, 0, 0, 2, 0, 0, 1, 3
"d:\IDEWORK\lvmen\src\licensedcode\data\rules\false-positive_520.yml", "YAML", 0, 0, 0, 2, 0, 0, 1, 3
"d:\IDEWORK\lvmen\src\licensedcode\data\rules\false-positive_5200.yml", "YAML", 0, 0, 0, 2, 0, 0, 1, 3
"d:\IDEWORK\lvmen\src\licensedcode\data\rules\false-positive_5201.yml", "YAML", 0, 0, 0, 2, 0, 0, 1, 3
"d:\IDEWORK\lvmen\src\licensedcode\data\rules\false-positive_5202.yml", "YAML", 0, 0, 0, 2, 0, 0, 1, 3
"d:\IDEWORK\lvmen\src\licensedcode\data\rules\false-positive_5203.yml", "YAML", 0, 0, 0, 2, 0, 0, 1, 3
"d:\IDEWORK\lvmen\src\licensedcode\data\rules\false-positive_5204.yml", "YAML", 0, 0, 0, 2, 0, 0, 1, 3
"d:\IDEWORK\lvmen\src\licensedcode\data\rules\false-positive_5205.yml", "YAML", 0, 0, 0, 2, 0, 0, 1, 3
"d:\IDEWORK\lvmen\src\licensedcode\data\rules\false-positive_5206.yml", "YAML", 0, 0, 0, 2, 0, 0, 1, 3
"d:\IDEWORK\lvmen\src\licensedcode\data\rules\false-positive_5207.yml", "YAML", 0, 0, 0, 2, 0, 0, 1, 3
"d:\IDEWORK\lvmen\src\licensedcode\data\rules\false-positive_5208.yml", "YAML", 0, 0, 0, 2, 0, 0, 1, 3
"d:\IDEWORK\lvmen\src\licensedcode\data\rules\false-positive_5209.yml", "YAML", 0, 0, 0, 2, 0, 0, 1, 3
"d:\IDEWORK\lvmen\src\licensedcode\data\rules\false-positive_521.yml", "YAML", 0, 0, 0, 2, 0, 0, 1, 3
"d:\IDEWORK\lvmen\src\licensedcode\data\rules\false-positive_5210.yml", "YAML", 0, 0, 0, 2, 0, 0, 1, 3
"d:\IDEWORK\lvmen\src\licensedcode\data\rules\false-positive_5211.yml", "YAML", 0, 0, 0, 2, 0, 0, 1, 3
"d:\IDEWORK\lvmen\src\licensedcode\data\rules\false-positive_5212.yml", "YAML", 0, 0, 0, 2, 0, 0, 1, 3
"d:\IDEWORK\lvmen\src\licensedcode\data\rules\false-positive_5213.yml", "YAML", 0, 0, 0, 2, 0, 0, 1, 3
"d:\IDEWORK\lvmen\src\licensedcode\data\rules\false-positive_5214.yml", "YAML", 0, 0, 0, 2, 0, 0, 1, 3
"d:\IDEWORK\lvmen\src\licensedcode\data\rules\false-positive_5215.yml", "YAML", 0, 0, 0, 2, 0, 0, 1, 3
"d:\IDEWORK\lvmen\src\licensedcode\data\rules\false-positive_5216.yml", "YAML", 0, 0, 0, 2, 0, 0, 1, 3
"d:\IDEWORK\lvmen\src\licensedcode\data\rules\false-positive_5217.yml", "YAML", 0, 0, 0, 2, 0, 0, 1, 3
"d:\IDEWORK\lvmen\src\licensedcode\data\rules\false-positive_5218.yml", "YAML", 0, 0, 0, 2, 0, 0, 1, 3
"d:\IDEWORK\lvmen\src\licensedcode\data\rules\false-positive_5219.yml", "YAML", 0, 0, 0, 2, 0, 0, 1, 3
"d:\IDEWORK\lvmen\src\licensedcode\data\rules\false-positive_522.yml", "YAML", 0, 0, 0, 2, 0, 0, 1, 3
"d:\IDEWORK\lvmen\src\licensedcode\data\rules\false-positive_5220.yml", "YAML", 0, 0, 0, 2, 0, 0, 1, 3
"d:\IDEWORK\lvmen\src\licensedcode\data\rules\false-positive_5221.yml", "YAML", 0, 0, 0, 2, 0, 0, 1, 3
"d:\IDEWORK\lvmen\src\licensedcode\data\rules\false-positive_5222.yml", "YAML", 0, 0, 0, 2, 0, 0, 1, 3
"d:\IDEWORK\lvmen\src\licensedcode\data\rules\false-positive_5223.yml", "YAML", 0, 0, 0, 2, 0, 0, 1, 3
"d:\IDEWORK\lvmen\src\licensedcode\data\rules\false-positive_5224.yml", "YAML", 0, 0, 0, 2, 0, 0, 1, 3
"d:\IDEWORK\lvmen\src\licensedcode\data\rules\false-positive_5225.yml", "YAML", 0, 0, 0, 2, 0, 0, 1, 3
"d:\IDEWORK\lvmen\src\licensedcode\data\rules\false-positive_5226.yml", "YAML", 0, 0, 0, 2, 0, 0, 1, 3
"d:\IDEWORK\lvmen\src\licensedcode\data\rules\false-positive_5227.yml", "YAML", 0, 0, 0, 2, 0, 0, 1, 3
"d:\IDEWORK\lvmen\src\licensedcode\data\rules\false-positive_5228.yml", "YAML", 0, 0, 0, 2, 0, 0, 1, 3
"d:\IDEWORK\lvmen\src\licensedcode\data\rules\false-positive_5229.yml", "YAML", 0, 0, 0, 2, 0, 0, 1, 3
"d:\IDEWORK\lvmen\src\licensedcode\data\rules\false-positive_523.yml", "YAML", 0, 0, 0, 2, 0, 0, 1, 3
"d:\IDEWORK\lvmen\src\licensedcode\data\rules\false-positive_5230.yml", "YAML", 0, 0, 0, 2, 0, 0, 1, 3
"d:\IDEWORK\lvmen\src\licensedcode\data\rules\false-positive_5231.yml", "YAML", 0, 0, 0, 2, 0, 0, 1, 3
"d:\IDEWORK\lvmen\src\licensedcode\data\rules\false-positive_5232.yml", "YAML", 0, 0, 0, 2, 0, 0, 1, 3
"d:\IDEWORK\lvmen\src\licensedcode\data\rules\false-positive_5233.yml", "YAML", 0, 0, 0, 2, 0, 0, 1, 3
"d:\IDEWORK\lvmen\src\licensedcode\data\rules\false-positive_5234.yml", "YAML", 0, 0, 0, 2, 0, 0, 1, 3
"d:\IDEWORK\lvmen\src\licensedcode\data\rules\false-positive_5235.yml", "YAML", 0, 0, 0, 2, 0, 0, 1, 3
"d:\IDEWORK\lvmen\src\licensedcode\data\rules\false-positive_5236.yml", "YAML", 0, 0, 0, 2, 0, 0, 1, 3
"d:\IDEWORK\lvmen\src\licensedcode\data\rules\false-positive_5237.yml", "YAML", 0, 0, 0, 2, 0, 0, 1, 3
"d:\IDEWORK\lvmen\src\licensedcode\data\rules\false-positive_5238.yml", "YAML", 0, 0, 0, 2, 0, 0, 1, 3
"d:\IDEWORK\lvmen\src\licensedcode\data\rules\false-positive_5239.yml", "YAML", 0, 0, 0, 2, 0, 0, 1, 3
"d:\IDEWORK\lvmen\src\licensedcode\data\rules\false-positive_524.yml", "YAML", 0, 0, 0, 2, 0, 0, 1, 3
"d:\IDEWORK\lvmen\src\licensedcode\data\rules\false-positive_5240.yml", "YAML", 0, 0, 0, 2, 0, 0, 1, 3
"d:\IDEWORK\lvmen\src\licensedcode\data\rules\false-positive_5241.yml", "YAML", 0, 0, 0, 2, 0, 0, 1, 3
"d:\IDEWORK\lvmen\src\licensedcode\data\rules\false-positive_5242.yml", "YAML", 0, 0, 0, 2, 0, 0, 1, 3
"d:\IDEWORK\lvmen\src\licensedcode\data\rules\false-positive_5243.yml", "YAML", 0, 0, 0, 2, 0, 0, 1, 3
"d:\IDEWORK\lvmen\src\licensedcode\data\rules\false-positive_5244.yml", "YAML", 0, 0, 0, 2, 0, 0, 1, 3
"d:\IDEWORK\lvmen\src\licensedcode\data\rules\false-positive_5245.yml", "YAML", 0, 0, 0, 2, 0, 0, 1, 3
"d:\IDEWORK\lvmen\src\licensedcode\data\rules\false-positive_5246.yml", "YAML", 0, 0, 0, 2, 0, 0, 1, 3
"d:\IDEWORK\lvmen\src\licensedcode\data\rules\false-positive_5247.yml", "YAML", 0, 0, 0, 2, 0, 0, 1, 3
"d:\IDEWORK\lvmen\src\licensedcode\data\rules\false-positive_5248.yml", "YAML", 0, 0, 0, 2, 0, 0, 1, 3
"d:\IDEWORK\lvmen\src\licensedcode\data\rules\false-positive_5249.yml", "YAML", 0, 0, 0, 2, 0, 0, 1, 3
"d:\IDEWORK\lvmen\src\licensedcode\data\rules\false-positive_525.yml", "YAML", 0, 0, 0, 2, 0, 0, 1, 3
"d:\IDEWORK\lvmen\src\licensedcode\data\rules\false-positive_5250.yml", "YAML", 0, 0, 0, 2, 0, 0, 1, 3
"d:\IDEWORK\lvmen\src\licensedcode\data\rules\false-positive_5251.yml", "YAML", 0, 0, 0, 2, 0, 0, 1, 3
"d:\IDEWORK\lvmen\src\licensedcode\data\rules\false-positive_5252.yml", "YAML", 0, 0, 0, 2, 0, 0, 1, 3
"d:\IDEWORK\lvmen\src\licensedcode\data\rules\false-positive_5253.yml", "YAML", 0, 0, 0, 2, 0, 0, 1, 3
"d:\IDEWORK\lvmen\src\licensedcode\data\rules\false-positive_5254.yml", "YAML", 0, 0, 0, 2, 0, 0, 1, 3
"d:\IDEWORK\lvmen\src\licensedcode\data\rules\false-positive_5255.yml", "YAML", 0, 0, 0, 2, 0, 0, 1, 3
"d:\IDEWORK\lvmen\src\licensedcode\data\rules\false-positive_5256.yml", "YAML", 0, 0, 0, 2, 0, 0, 1, 3
"d:\IDEWORK\lvmen\src\licensedcode\data\rules\false-positive_5257.yml", "YAML", 0, 0, 0, 2, 0, 0, 1, 3
"d:\IDEWORK\lvmen\src\licensedcode\data\rules\false-positive_5258.yml", "YAML", 0, 0, 0, 2, 0, 0, 1, 3
"d:\IDEWORK\lvmen\src\licensedcode\data\rules\false-positive_5259.yml", "YAML", 0, 0, 0, 2, 0, 0, 1, 3
"d:\IDEWORK\lvmen\src\licensedcode\data\rules\false-positive_526.yml", "YAML", 0, 0, 0, 2, 0, 0, 1, 3
"d:\IDEWORK\lvmen\src\licensedcode\data\rules\false-positive_5260.yml", "YAML", 0, 0, 0, 2, 0, 0, 1, 3
"d:\IDEWORK\lvmen\src\licensedcode\data\rules\false-positive_5261.yml", "YAML", 0, 0, 0, 2, 0, 0, 1, 3
"d:\IDEWORK\lvmen\src\licensedcode\data\rules\false-positive_5262.yml", "YAML", 0, 0, 0, 2, 0, 0, 1, 3
"d:\IDEWORK\lvmen\src\licensedcode\data\rules\false-positive_5263.yml", "YAML", 0, 0, 0, 2, 0, 0, 1, 3
"d:\IDEWORK\lvmen\src\licensedcode\data\rules\false-positive_5264.yml", "YAML", 0, 0, 0, 2, 0, 0, 1, 3
"d:\IDEWORK\lvmen\src\licensedcode\data\rules\false-positive_5265.yml", "YAML", 0, 0, 0, 2, 0, 0, 1, 3
"d:\IDEWORK\lvmen\src\licensedcode\data\rules\false-positive_5266.yml", "YAML", 0, 0, 0, 2, 0, 0, 1, 3
"d:\IDEWORK\lvmen\src\licensedcode\data\rules\false-positive_5267.yml", "YAML", 0, 0, 0, 2, 0, 0, 1, 3
"d:\IDEWORK\lvmen\src\licensedcode\data\rules\false-positive_5268.yml", "YAML", 0, 0, 0, 2, 0, 0, 1, 3
"d:\IDEWORK\lvmen\src\licensedcode\data\rules\false-positive_5269.yml", "YAML", 0, 0, 0, 2, 0, 0, 1, 3
"d:\IDEWORK\lvmen\src\licensedcode\data\rules\false-positive_527.yml", "YAML", 0, 0, 0, 2, 0, 0, 1, 3
"d:\IDEWORK\lvmen\src\licensedcode\data\rules\false-positive_5270.yml", "YAML", 0, 0, 0, 2, 0, 0, 1, 3
"d:\IDEWORK\lvmen\src\licensedcode\data\rules\false-positive_5271.yml", "YAML", 0, 0, 0, 2, 0, 0, 1, 3
"d:\IDEWORK\lvmen\src\licensedcode\data\rules\false-positive_5272.yml", "YAML", 0, 0, 0, 2, 0, 0, 1, 3
"d:\IDEWORK\lvmen\src\licensedcode\data\rules\false-positive_5273.yml", "YAML", 0, 0, 0, 2, 0, 0, 1, 3
"d:\IDEWORK\lvmen\src\licensedcode\data\rules\false-positive_5274.yml", "YAML", 0, 0, 0, 2, 0, 0, 1, 3
"d:\IDEWORK\lvmen\src\licensedcode\data\rules\false-positive_5275.yml", "YAML", 0, 0, 0, 2, 0, 0, 1, 3
"d:\IDEWORK\lvmen\src\licensedcode\data\rules\false-positive_5276.yml", "YAML", 0, 0, 0, 2, 0, 0, 1, 3
"d:\IDEWORK\lvmen\src\licensedcode\data\rules\false-positive_5277.yml", "YAML", 0, 0, 0, 2, 0, 0, 1, 3
"d:\IDEWORK\lvmen\src\licensedcode\data\rules\false-positive_5278.yml", "YAML", 0, 0, 0, 2, 0, 0, 1, 3
"d:\IDEWORK\lvmen\src\licensedcode\data\rules\false-positive_5279.yml", "YAML", 0, 0, 0, 2, 0, 0, 1, 3
"d:\IDEWORK\lvmen\src\licensedcode\data\rules\false-positive_528.yml", "YAML", 0, 0, 0, 2, 0, 0, 1, 3
"d:\IDEWORK\lvmen\src\licensedcode\data\rules\false-positive_5280.yml", "YAML", 0, 0, 0, 2, 0, 0, 1, 3
"d:\IDEWORK\lvmen\src\licensedcode\data\rules\false-positive_5281.yml", "YAML", 0, 0, 0, 2, 0, 0, 1, 3
"d:\IDEWORK\lvmen\src\licensedcode\data\rules\false-positive_5282.yml", "YAML", 0, 0, 0, 2, 0, 0, 1, 3
"d:\IDEWORK\lvmen\src\licensedcode\data\rules\false-positive_5283.yml", "YAML", 0, 0, 0, 2, 0, 0, 1, 3
"d:\IDEWORK\lvmen\src\licensedcode\data\rules\false-positive_5284.yml", "YAML", 0, 0, 0, 2, 0, 0, 1, 3
"d:\IDEWORK\lvmen\src\licensedcode\data\rules\false-positive_5285.yml", "YAML", 0, 0, 0, 2, 0, 0, 1, 3
"d:\IDEWORK\lvmen\src\licensedcode\data\rules\false-positive_5286.yml", "YAML", 0, 0, 0, 2, 0, 0, 1, 3
"d:\IDEWORK\lvmen\src\licensedcode\data\rules\false-positive_5287.yml", "YAML", 0, 0, 0, 2, 0, 0, 1, 3
"d:\IDEWORK\lvmen\src\licensedcode\data\rules\false-positive_5288.yml", "YAML", 0, 0, 0, 2, 0, 0, 1, 3
"d:\IDEWORK\lvmen\src\licensedcode\data\rules\false-positive_5289.yml", "YAML", 0, 0, 0, 2, 0, 0, 1, 3
"d:\IDEWORK\lvmen\src\licensedcode\data\rules\false-positive_529.yml", "YAML", 0, 0, 0, 2, 0, 0, 1, 3
"d:\IDEWORK\lvmen\src\licensedcode\data\rules\false-positive_5290.yml", "YAML", 0, 0, 0, 2, 0, 0, 1, 3
"d:\IDEWORK\lvmen\src\licensedcode\data\rules\false-positive_5291.yml", "YAML", 0, 0, 0, 2, 0, 0, 1, 3
"d:\IDEWORK\lvmen\src\licensedcode\data\rules\false-positive_5292.yml", "YAML", 0, 0, 0, 2, 0, 0, 1, 3
"d:\IDEWORK\lvmen\src\licensedcode\data\rules\false-positive_5293.yml", "YAML", 0, 0, 0, 2, 0, 0, 1, 3
"d:\IDEWORK\lvmen\src\licensedcode\data\rules\false-positive_5294.yml", "YAML", 0, 0, 0, 2, 0, 0, 1, 3
"d:\IDEWORK\lvmen\src\licensedcode\data\rules\false-positive_5295.yml", "YAML", 0, 0, 0, 2, 0, 0, 1, 3
"d:\IDEWORK\lvmen\src\licensedcode\data\rules\false-positive_5296.yml", "YAML", 0, 0, 0, 2, 0, 0, 1, 3
"d:\IDEWORK\lvmen\src\licensedcode\data\rules\false-positive_5297.yml", "YAML", 0, 0, 0, 2, 0, 0, 1, 3
"d:\IDEWORK\lvmen\src\licensedcode\data\rules\false-positive_5298.yml", "YAML", 0, 0, 0, 2, 0, 0, 1, 3
"d:\IDEWORK\lvmen\src\licensedcode\data\rules\false-positive_5299.yml", "YAML", 0, 0, 0, 2, 0, 0, 1, 3
"d:\IDEWORK\lvmen\src\licensedcode\data\rules\false-positive_53.yml", "YAML", 0, 0, 0, 2, 0, 0, 1, 3
"d:\IDEWORK\lvmen\src\licensedcode\data\rules\false-positive_530.yml", "YAML", 0, 0, 0, 2, 0, 0, 1, 3
"d:\IDEWORK\lvmen\src\licensedcode\data\rules\false-positive_5300.yml", "YAML", 0, 0, 0, 2, 0, 0, 1, 3
"d:\IDEWORK\lvmen\src\licensedcode\data\rules\false-positive_5301.yml", "YAML", 0, 0, 0, 2, 0, 0, 1, 3
"d:\IDEWORK\lvmen\src\licensedcode\data\rules\false-positive_5302.yml", "YAML", 0, 0, 0, 2, 0, 0, 1, 3
"d:\IDEWORK\lvmen\src\licensedcode\data\rules\false-positive_5303.yml", "YAML", 0, 0, 0, 2, 0, 0, 1, 3
"d:\IDEWORK\lvmen\src\licensedcode\data\rules\false-positive_5304.yml", "YAML", 0, 0, 0, 2, 0, 0, 1, 3
"d:\IDEWORK\lvmen\src\licensedcode\data\rules\false-positive_5305.yml", "YAML", 0, 0, 0, 2, 0, 0, 1, 3
"d:\IDEWORK\lvmen\src\licensedcode\data\rules\false-positive_5306.yml", "YAML", 0, 0, 0, 2, 0, 0, 1, 3
"d:\IDEWORK\lvmen\src\licensedcode\data\rules\false-positive_5307.yml", "YAML", 0, 0, 0, 2, 0, 0, 1, 3
"d:\IDEWORK\lvmen\src\licensedcode\data\rules\false-positive_5308.yml", "YAML", 0, 0, 0, 2, 0, 0, 1, 3
"d:\IDEWORK\lvmen\src\licensedcode\data\rules\false-positive_5309.yml", "YAML", 0, 0, 0, 2, 0, 0, 1, 3
"d:\IDEWORK\lvmen\src\licensedcode\data\rules\false-positive_531.yml", "YAML", 0, 0, 0, 2, 0, 0, 1, 3
"d:\IDEWORK\lvmen\src\licensedcode\data\rules\false-positive_5310.yml", "YAML", 0, 0, 0, 2, 0, 0, 1, 3
"d:\IDEWORK\lvmen\src\licensedcode\data\rules\false-positive_5311.yml", "YAML", 0, 0, 0, 2, 0, 0, 1, 3
"d:\IDEWORK\lvmen\src\licensedcode\data\rules\false-positive_5312.yml", "YAML", 0, 0, 0, 2, 0, 0, 1, 3
"d:\IDEWORK\lvmen\src\licensedcode\data\rules\false-positive_5313.yml", "YAML", 0, 0, 0, 2, 0, 0, 1, 3
"d:\IDEWORK\lvmen\src\licensedcode\data\rules\false-positive_5314.yml", "YAML", 0, 0, 0, 2, 0, 0, 1, 3
"d:\IDEWORK\lvmen\src\licensedcode\data\rules\false-positive_5315.yml", "YAML", 0, 0, 0, 2, 0, 0, 1, 3
"d:\IDEWORK\lvmen\src\licensedcode\data\rules\false-positive_5316.yml", "YAML", 0, 0, 0, 2, 0, 0, 1, 3
"d:\IDEWORK\lvmen\src\licensedcode\data\rules\false-positive_5317.yml", "YAML", 0, 0, 0, 2, 0, 0, 1, 3
"d:\IDEWORK\lvmen\src\licensedcode\data\rules\false-positive_5318.yml", "YAML", 0, 0, 0, 2, 0, 0, 1, 3
"d:\IDEWORK\lvmen\src\licensedcode\data\rules\false-positive_5319.yml", "YAML", 0, 0, 0, 2, 0, 0, 1, 3
"d:\IDEWORK\lvmen\src\licensedcode\data\rules\false-positive_532.yml", "YAML", 0, 0, 0, 2, 0, 0, 1, 3
"d:\IDEWORK\lvmen\src\licensedcode\data\rules\false-positive_5320.yml", "YAML", 0, 0, 0, 2, 0, 0, 1, 3
"d:\IDEWORK\lvmen\src\licensedcode\data\rules\false-positive_5321.yml", "YAML", 0, 0, 0, 2, 0, 0, 1, 3
"d:\IDEWORK\lvmen\src\licensedcode\data\rules\false-positive_5322.yml", "YAML", 0, 0, 0, 2, 0, 0, 1, 3
"d:\IDEWORK\lvmen\src\licensedcode\data\rules\false-positive_5323.yml", "YAML", 0, 0, 0, 2, 0, 0, 1, 3
"d:\IDEWORK\lvmen\src\licensedcode\data\rules\false-positive_5324.yml", "YAML", 0, 0, 0, 2, 0, 0, 1, 3
"d:\IDEWORK\lvmen\src\licensedcode\data\rules\false-positive_5325.yml", "YAML", 0, 0, 0, 2, 0, 0, 1, 3
"d:\IDEWORK\lvmen\src\licensedcode\data\rules\false-positive_5326.yml", "YAML", 0, 0, 0, 2, 0, 0, 1, 3
"d:\IDEWORK\lvmen\src\licensedcode\data\rules\false-positive_5327.yml", "YAML", 0, 0, 0, 2, 0, 0, 1, 3
"d:\IDEWORK\lvmen\src\licensedcode\data\rules\false-positive_5328.yml", "YAML", 0, 0, 0, 2, 0, 0, 1, 3
"d:\IDEWORK\lvmen\src\licensedcode\data\rules\false-positive_5329.yml", "YAML", 0, 0, 0, 2, 0, 0, 1, 3
"d:\IDEWORK\lvmen\src\licensedcode\data\rules\false-positive_533.yml", "YAML", 0, 0, 0, 2, 0, 0, 1, 3
"d:\IDEWORK\lvmen\src\licensedcode\data\rules\false-positive_5330.yml", "YAML", 0, 0, 0, 2, 0, 0, 1, 3
"d:\IDEWORK\lvmen\src\licensedcode\data\rules\false-positive_5331.yml", "YAML", 0, 0, 0, 2, 0, 0, 1, 3
"d:\IDEWORK\lvmen\src\licensedcode\data\rules\false-positive_5332.yml", "YAML", 0, 0, 0, 2, 0, 0, 1, 3
"d:\IDEWORK\lvmen\src\licensedcode\data\rules\false-positive_5333.yml", "YAML", 0, 0, 0, 2, 0, 0, 1, 3
"d:\IDEWORK\lvmen\src\licensedcode\data\rules\false-positive_5334.yml", "YAML", 0, 0, 0, 2, 0, 0, 1, 3
"d:\IDEWORK\lvmen\src\licensedcode\data\rules\false-positive_5335.yml", "YAML", 0, 0, 0, 2, 0, 0, 1, 3
"d:\IDEWORK\lvmen\src\licensedcode\data\rules\false-positive_5336.yml", "YAML", 0, 0, 0, 2, 0, 0, 1, 3
"d:\IDEWORK\lvmen\src\licensedcode\data\rules\false-positive_5337.yml", "YAML", 0, 0, 0, 2, 0, 0, 1, 3
"d:\IDEWORK\lvmen\src\licensedcode\data\rules\false-positive_5338.yml", "YAML", 0, 0, 0, 2, 0, 0, 1, 3
"d:\IDEWORK\lvmen\src\licensedcode\data\rules\false-positive_5339.yml", "YAML", 0, 0, 0, 2, 0, 0, 1, 3
"d:\IDEWORK\lvmen\src\licensedcode\data\rules\false-positive_534.yml", "YAML", 0, 0, 0, 2, 0, 0, 1, 3
"d:\IDEWORK\lvmen\src\licensedcode\data\rules\false-positive_5340.yml", "YAML", 0, 0, 0, 2, 0, 0, 1, 3
"d:\IDEWORK\lvmen\src\licensedcode\data\rules\false-positive_5341.yml", "YAML", 0, 0, 0, 2, 0, 0, 1, 3
"d:\IDEWORK\lvmen\src\licensedcode\data\rules\false-positive_5342.yml", "YAML", 0, 0, 0, 2, 0, 0, 1, 3
"d:\IDEWORK\lvmen\src\licensedcode\data\rules\false-positive_5343.yml", "YAML", 0, 0, 0, 2, 0, 0, 1, 3
"d:\IDEWORK\lvmen\src\licensedcode\data\rules\false-positive_5344.yml", "YAML", 0, 0, 0, 2, 0, 0, 1, 3
"d:\IDEWORK\lvmen\src\licensedcode\data\rules\false-positive_5345.yml", "YAML", 0, 0, 0, 2, 0, 0, 1, 3
"d:\IDEWORK\lvmen\src\licensedcode\data\rules\false-positive_5346.yml", "YAML", 0, 0, 0, 2, 0, 0, 1, 3
"d:\IDEWORK\lvmen\src\licensedcode\data\rules\false-positive_5347.yml", "YAML", 0, 0, 0, 2, 0, 0, 1, 3
"d:\IDEWORK\lvmen\src\licensedcode\data\rules\false-positive_5348.yml", "YAML", 0, 0, 0, 2, 0, 0, 1, 3
"d:\IDEWORK\lvmen\src\licensedcode\data\rules\false-positive_5349.yml", "YAML", 0, 0, 0, 2, 0, 0, 1, 3
"d:\IDEWORK\lvmen\src\licensedcode\data\rules\false-positive_535.yml", "YAML", 0, 0, 0, 2, 0, 0, 1, 3
"d:\IDEWORK\lvmen\src\licensedcode\data\rules\false-positive_5350.yml", "YAML", 0, 0, 0, 2, 0, 0, 1, 3
"d:\IDEWORK\lvmen\src\licensedcode\data\rules\false-positive_5351.yml", "YAML", 0, 0, 0, 2, 0, 0, 1, 3
"d:\IDEWORK\lvmen\src\licensedcode\data\rules\false-positive_5352.yml", "YAML", 0, 0, 0, 2, 0, 0, 1, 3
"d:\IDEWORK\lvmen\src\licensedcode\data\rules\false-positive_5353.yml", "YAML", 0, 0, 0, 2, 0, 0, 1, 3
"d:\IDEWORK\lvmen\src\licensedcode\data\rules\false-positive_5354.yml", "YAML", 0, 0, 0, 2, 0, 0, 1, 3
"d:\IDEWORK\lvmen\src\licensedcode\data\rules\false-positive_5355.yml", "YAML", 0, 0, 0, 2, 0, 0, 1, 3
"d:\IDEWORK\lvmen\src\licensedcode\data\rules\false-positive_5356.yml", "YAML", 0, 0, 0, 2, 0, 0, 1, 3
"d:\IDEWORK\lvmen\src\licensedcode\data\rules\false-positive_5357.yml", "YAML", 0, 0, 0, 2, 0, 0, 1, 3
"d:\IDEWORK\lvmen\src\licensedcode\data\rules\false-positive_5358.yml", "YAML", 0, 0, 0, 2, 0, 0, 1, 3
"d:\IDEWORK\lvmen\src\licensedcode\data\rules\false-positive_5359.yml", "YAML", 0, 0, 0, 2, 0, 0, 1, 3
"d:\IDEWORK\lvmen\src\licensedcode\data\rules\false-positive_536.yml", "YAML", 0, 0, 0, 2, 0, 0, 1, 3
"d:\IDEWORK\lvmen\src\licensedcode\data\rules\false-positive_5360.yml", "YAML", 0, 0, 0, 2, 0, 0, 1, 3
"d:\IDEWORK\lvmen\src\licensedcode\data\rules\false-positive_5361.yml", "YAML", 0, 0, 0, 2, 0, 0, 1, 3
"d:\IDEWORK\lvmen\src\licensedcode\data\rules\false-positive_5362.yml", "YAML", 0, 0, 0, 2, 0, 0, 1, 3
"d:\IDEWORK\lvmen\src\licensedcode\data\rules\false-positive_5363.yml", "YAML", 0, 0, 0, 2, 0, 0, 1, 3
"d:\IDEWORK\lvmen\src\licensedcode\data\rules\false-positive_5364.yml", "YAML", 0, 0, 0, 2, 0, 0, 1, 3
"d:\IDEWORK\lvmen\src\licensedcode\data\rules\false-positive_5365.yml", "YAML", 0, 0, 0, 2, 0, 0, 1, 3
"d:\IDEWORK\lvmen\src\licensedcode\data\rules\false-positive_5366.yml", "YAML", 0, 0, 0, 2, 0, 0, 1, 3
"d:\IDEWORK\lvmen\src\licensedcode\data\rules\false-positive_5367.yml", "YAML", 0, 0, 0, 2, 0, 0, 1, 3
"d:\IDEWORK\lvmen\src\licensedcode\data\rules\false-positive_5368.yml", "YAML", 0, 0, 0, 2, 0, 0, 1, 3
"d:\IDEWORK\lvmen\src\licensedcode\data\rules\false-positive_5369.yml", "YAML", 0, 0, 0, 2, 0, 0, 1, 3
"d:\IDEWORK\lvmen\src\licensedcode\data\rules\false-positive_537.yml", "YAML", 0, 0, 0, 2, 0, 0, 1, 3
"d:\IDEWORK\lvmen\src\licensedcode\data\rules\false-positive_5370.yml", "YAML", 0, 0, 0, 2, 0, 0, 1, 3
"d:\IDEWORK\lvmen\src\licensedcode\data\rules\false-positive_5371.yml", "YAML", 0, 0, 0, 2, 0, 0, 1, 3
"d:\IDEWORK\lvmen\src\licensedcode\data\rules\false-positive_5372.yml", "YAML", 0, 0, 0, 2, 0, 0, 1, 3
"d:\IDEWORK\lvmen\src\licensedcode\data\rules\false-positive_5373.yml", "YAML", 0, 0, 0, 2, 0, 0, 1, 3
"d:\IDEWORK\lvmen\src\licensedcode\data\rules\false-positive_5374.yml", "YAML", 0, 0, 0, 2, 0, 0, 1, 3
"d:\IDEWORK\lvmen\src\licensedcode\data\rules\false-positive_5375.yml", "YAML", 0, 0, 0, 2, 0, 0, 1, 3
"d:\IDEWORK\lvmen\src\licensedcode\data\rules\false-positive_5376.yml", "YAML", 0, 0, 0, 2, 0, 0, 1, 3
"d:\IDEWORK\lvmen\src\licensedcode\data\rules\false-positive_5377.yml", "YAML", 0, 0, 0, 2, 0, 0, 1, 3
"d:\IDEWORK\lvmen\src\licensedcode\data\rules\false-positive_5378.yml", "YAML", 0, 0, 0, 2, 0, 0, 1, 3
"d:\IDEWORK\lvmen\src\licensedcode\data\rules\false-positive_5379.yml", "YAML", 0, 0, 0, 2, 0, 0, 1, 3
"d:\IDEWORK\lvmen\src\licensedcode\data\rules\false-positive_538.yml", "YAML", 0, 0, 0, 2, 0, 0, 1, 3
"d:\IDEWORK\lvmen\src\licensedcode\data\rules\false-positive_5380.yml", "YAML", 0, 0, 0, 2, 0, 0, 1, 3
"d:\IDEWORK\lvmen\src\licensedcode\data\rules\false-positive_5381.yml", "YAML", 0, 0, 0, 2, 0, 0, 1, 3
"d:\IDEWORK\lvmen\src\licensedcode\data\rules\false-positive_5382.yml", "YAML", 0, 0, 0, 2, 0, 0, 1, 3
"d:\IDEWORK\lvmen\src\licensedcode\data\rules\false-positive_5383.yml", "YAML", 0, 0, 0, 2, 0, 0, 1, 3
"d:\IDEWORK\lvmen\src\licensedcode\data\rules\false-positive_5384.yml", "YAML", 0, 0, 0, 2, 0, 0, 1, 3
"d:\IDEWORK\lvmen\src\licensedcode\data\rules\false-positive_5385.yml", "YAML", 0, 0, 0, 2, 0, 0, 1, 3
"d:\IDEWORK\lvmen\src\licensedcode\data\rules\false-positive_5386.yml", "YAML", 0, 0, 0, 2, 0, 0, 1, 3
"d:\IDEWORK\lvmen\src\licensedcode\data\rules\false-positive_5387.yml", "YAML", 0, 0, 0, 2, 0, 0, 1, 3
"d:\IDEWORK\lvmen\src\licensedcode\data\rules\false-positive_5388.yml", "YAML", 0, 0, 0, 2, 0, 0, 1, 3
"d:\IDEWORK\lvmen\src\licensedcode\data\rules\false-positive_5389.yml", "YAML", 0, 0, 0, 2, 0, 0, 1, 3
"d:\IDEWORK\lvmen\src\licensedcode\data\rules\false-positive_539.yml", "YAML", 0, 0, 0, 2, 0, 0, 1, 3
"d:\IDEWORK\lvmen\src\licensedcode\data\rules\false-positive_5390.yml", "YAML", 0, 0, 0, 2, 0, 0, 1, 3
"d:\IDEWORK\lvmen\src\licensedcode\data\rules\false-positive_5391.yml", "YAML", 0, 0, 0, 2, 0, 0, 1, 3
"d:\IDEWORK\lvmen\src\licensedcode\data\rules\false-positive_5392.yml", "YAML", 0, 0, 0, 2, 0, 0, 1, 3
"d:\IDEWORK\lvmen\src\licensedcode\data\rules\false-positive_5393.yml", "YAML", 0, 0, 0, 2, 0, 0, 1, 3
"d:\IDEWORK\lvmen\src\licensedcode\data\rules\false-positive_5394.yml", "YAML", 0, 0, 0, 2, 0, 0, 1, 3
"d:\IDEWORK\lvmen\src\licensedcode\data\rules\false-positive_5395.yml", "YAML", 0, 0, 0, 2, 0, 0, 1, 3
"d:\IDEWORK\lvmen\src\licensedcode\data\rules\false-positive_5396.yml", "YAML", 0, 0, 0, 2, 0, 0, 1, 3
"d:\IDEWORK\lvmen\src\licensedcode\data\rules\false-positive_5397.yml", "YAML", 0, 0, 0, 2, 0, 0, 1, 3
"d:\IDEWORK\lvmen\src\licensedcode\data\rules\false-positive_5398.yml", "YAML", 0, 0, 0, 2, 0, 0, 1, 3
"d:\IDEWORK\lvmen\src\licensedcode\data\rules\false-positive_5399.yml", "YAML", 0, 0, 0, 2, 0, 0, 1, 3
"d:\IDEWORK\lvmen\src\licensedcode\data\rules\false-positive_54.yml", "YAML", 0, 0, 0, 3, 0, 0, 1, 4
"d:\IDEWORK\lvmen\src\licensedcode\data\rules\false-positive_540.yml", "YAML", 0, 0, 0, 2, 0, 0, 1, 3
"d:\IDEWORK\lvmen\src\licensedcode\data\rules\false-positive_5400.yml", "YAML", 0, 0, 0, 2, 0, 0, 1, 3
"d:\IDEWORK\lvmen\src\licensedcode\data\rules\false-positive_5401.yml", "YAML", 0, 0, 0, 2, 0, 0, 1, 3
"d:\IDEWORK\lvmen\src\licensedcode\data\rules\false-positive_5402.yml", "YAML", 0, 0, 0, 2, 0, 0, 1, 3
"d:\IDEWORK\lvmen\src\licensedcode\data\rules\false-positive_5403.yml", "YAML", 0, 0, 0, 2, 0, 0, 1, 3
"d:\IDEWORK\lvmen\src\licensedcode\data\rules\false-positive_5404.yml", "YAML", 0, 0, 0, 2, 0, 0, 1, 3
"d:\IDEWORK\lvmen\src\licensedcode\data\rules\false-positive_5405.yml", "YAML", 0, 0, 0, 2, 0, 0, 1, 3
"d:\IDEWORK\lvmen\src\licensedcode\data\rules\false-positive_5406.yml", "YAML", 0, 0, 0, 2, 0, 0, 1, 3
"d:\IDEWORK\lvmen\src\licensedcode\data\rules\false-positive_5407.yml", "YAML", 0, 0, 0, 2, 0, 0, 1, 3
"d:\IDEWORK\lvmen\src\licensedcode\data\rules\false-positive_5408.yml", "YAML", 0, 0, 0, 2, 0, 0, 1, 3
"d:\IDEWORK\lvmen\src\licensedcode\data\rules\false-positive_5409.yml", "YAML", 0, 0, 0, 2, 0, 0, 1, 3
"d:\IDEWORK\lvmen\src\licensedcode\data\rules\false-positive_541.yml", "YAML", 0, 0, 0, 2, 0, 0, 1, 3
"d:\IDEWORK\lvmen\src\licensedcode\data\rules\false-positive_5410.yml", "YAML", 0, 0, 0, 2, 0, 0, 1, 3
"d:\IDEWORK\lvmen\src\licensedcode\data\rules\false-positive_5411.yml", "YAML", 0, 0, 0, 2, 0, 0, 1, 3
"d:\IDEWORK\lvmen\src\licensedcode\data\rules\false-positive_5412.yml", "YAML", 0, 0, 0, 2, 0, 0, 1, 3
"d:\IDEWORK\lvmen\src\licensedcode\data\rules\false-positive_5413.yml", "YAML", 0, 0, 0, 2, 0, 0, 1, 3
"d:\IDEWORK\lvmen\src\licensedcode\data\rules\false-positive_5414.yml", "YAML", 0, 0, 0, 2, 0, 0, 1, 3
"d:\IDEWORK\lvmen\src\licensedcode\data\rules\false-positive_5415.yml", "YAML", 0, 0, 0, 2, 0, 0, 1, 3
"d:\IDEWORK\lvmen\src\licensedcode\data\rules\false-positive_5416.yml", "YAML", 0, 0, 0, 2, 0, 0, 1, 3
"d:\IDEWORK\lvmen\src\licensedcode\data\rules\false-positive_5417.yml", "YAML", 0, 0, 0, 2, 0, 0, 1, 3
"d:\IDEWORK\lvmen\src\licensedcode\data\rules\false-positive_5418.yml", "YAML", 0, 0, 0, 2, 0, 0, 1, 3
"d:\IDEWORK\lvmen\src\licensedcode\data\rules\false-positive_5419.yml", "YAML", 0, 0, 0, 2, 0, 0, 1, 3
"d:\IDEWORK\lvmen\src\licensedcode\data\rules\false-positive_542.yml", "YAML", 0, 0, 0, 2, 0, 0, 1, 3
"d:\IDEWORK\lvmen\src\licensedcode\data\rules\false-positive_5420.yml", "YAML", 0, 0, 0, 2, 0, 0, 1, 3
"d:\IDEWORK\lvmen\src\licensedcode\data\rules\false-positive_5421.yml", "YAML", 0, 0, 0, 2, 0, 0, 1, 3
"d:\IDEWORK\lvmen\src\licensedcode\data\rules\false-positive_5422.yml", "YAML", 0, 0, 0, 2, 0, 0, 1, 3
"d:\IDEWORK\lvmen\src\licensedcode\data\rules\false-positive_5423.yml", "YAML", 0, 0, 0, 2, 0, 0, 1, 3
"d:\IDEWORK\lvmen\src\licensedcode\data\rules\false-positive_5424.yml", "YAML", 0, 0, 0, 2, 0, 0, 1, 3
"d:\IDEWORK\lvmen\src\licensedcode\data\rules\false-positive_5425.yml", "YAML", 0, 0, 0, 2, 0, 0, 1, 3
"d:\IDEWORK\lvmen\src\licensedcode\data\rules\false-positive_5426.yml", "YAML", 0, 0, 0, 2, 0, 0, 1, 3
"d:\IDEWORK\lvmen\src\licensedcode\data\rules\false-positive_5427.yml", "YAML", 0, 0, 0, 2, 0, 0, 1, 3
"d:\IDEWORK\lvmen\src\licensedcode\data\rules\false-positive_5428.yml", "YAML", 0, 0, 0, 2, 0, 0, 1, 3
"d:\IDEWORK\lvmen\src\licensedcode\data\rules\false-positive_5429.yml", "YAML", 0, 0, 0, 2, 0, 0, 1, 3
"d:\IDEWORK\lvmen\src\licensedcode\data\rules\false-positive_543.yml", "YAML", 0, 0, 0, 2, 0, 0, 1, 3
"d:\IDEWORK\lvmen\src\licensedcode\data\rules\false-positive_5430.yml", "YAML", 0, 0, 0, 2, 0, 0, 1, 3
"d:\IDEWORK\lvmen\src\licensedcode\data\rules\false-positive_5431.yml", "YAML", 0, 0, 0, 2, 0, 0, 1, 3
"d:\IDEWORK\lvmen\src\licensedcode\data\rules\false-positive_5432.yml", "YAML", 0, 0, 0, 2, 0, 0, 1, 3
"d:\IDEWORK\lvmen\src\licensedcode\data\rules\false-positive_5433.yml", "YAML", 0, 0, 0, 2, 0, 0, 1, 3
"d:\IDEWORK\lvmen\src\licensedcode\data\rules\false-positive_5434.yml", "YAML", 0, 0, 0, 2, 0, 0, 1, 3
"d:\IDEWORK\lvmen\src\licensedcode\data\rules\false-positive_5435.yml", "YAML", 0, 0, 0, 2, 0, 0, 1, 3
"d:\IDEWORK\lvmen\src\licensedcode\data\rules\false-positive_5436.yml", "YAML", 0, 0, 0, 2, 0, 0, 1, 3
"d:\IDEWORK\lvmen\src\licensedcode\data\rules\false-positive_5437.yml", "YAML", 0, 0, 0, 2, 0, 0, 1, 3
"d:\IDEWORK\lvmen\src\licensedcode\data\rules\false-positive_5438.yml", "YAML", 0, 0, 0, 2, 0, 0, 1, 3
"d:\IDEWORK\lvmen\src\licensedcode\data\rules\false-positive_5439.yml", "YAML", 0, 0, 0, 2, 0, 0, 1, 3
"d:\IDEWORK\lvmen\src\licensedcode\data\rules\false-positive_544.yml", "YAML", 0, 0, 0, 2, 0, 0, 1, 3
"d:\IDEWORK\lvmen\src\licensedcode\data\rules\false-positive_5440.yml", "YAML", 0, 0, 0, 2, 0, 0, 1, 3
"d:\IDEWORK\lvmen\src\licensedcode\data\rules\false-positive_5441.yml", "YAML", 0, 0, 0, 2, 0, 0, 1, 3
"d:\IDEWORK\lvmen\src\licensedcode\data\rules\false-positive_5442.yml", "YAML", 0, 0, 0, 2, 0, 0, 1, 3
"d:\IDEWORK\lvmen\src\licensedcode\data\rules\false-positive_5443.yml", "YAML", 0, 0, 0, 2, 0, 0, 1, 3
"d:\IDEWORK\lvmen\src\licensedcode\data\rules\false-positive_5444.yml", "YAML", 0, 0, 0, 2, 0, 0, 1, 3
"d:\IDEWORK\lvmen\src\licensedcode\data\rules\false-positive_5445.yml", "YAML", 0, 0, 0, 2, 0, 0, 1, 3
"d:\IDEWORK\lvmen\src\licensedcode\data\rules\false-positive_5446.yml", "YAML", 0, 0, 0, 2, 0, 0, 1, 3
"d:\IDEWORK\lvmen\src\licensedcode\data\rules\false-positive_5447.yml", "YAML", 0, 0, 0, 2, 0, 0, 1, 3
"d:\IDEWORK\lvmen\src\licensedcode\data\rules\false-positive_5448.yml", "YAML", 0, 0, 0, 2, 0, 0, 1, 3
"d:\IDEWORK\lvmen\src\licensedcode\data\rules\false-positive_5449.yml", "YAML", 0, 0, 0, 2, 0, 0, 1, 3
"d:\IDEWORK\lvmen\src\licensedcode\data\rules\false-positive_545.yml", "YAML", 0, 0, 0, 2, 0, 0, 1, 3
"d:\IDEWORK\lvmen\src\licensedcode\data\rules\false-positive_5450.yml", "YAML", 0, 0, 0, 2, 0, 0, 1, 3
"d:\IDEWORK\lvmen\src\licensedcode\data\rules\false-positive_5451.yml", "YAML", 0, 0, 0, 2, 0, 0, 1, 3
"d:\IDEWORK\lvmen\src\licensedcode\data\rules\false-positive_5452.yml", "YAML", 0, 0, 0, 2, 0, 0, 1, 3
"d:\IDEWORK\lvmen\src\licensedcode\data\rules\false-positive_5453.yml", "YAML", 0, 0, 0, 2, 0, 0, 1, 3
"d:\IDEWORK\lvmen\src\licensedcode\data\rules\false-positive_5454.yml", "YAML", 0, 0, 0, 2, 0, 0, 1, 3
"d:\IDEWORK\lvmen\src\licensedcode\data\rules\false-positive_5455.yml", "YAML", 0, 0, 0, 2, 0, 0, 1, 3
"d:\IDEWORK\lvmen\src\licensedcode\data\rules\false-positive_5456.yml", "YAML", 0, 0, 0, 2, 0, 0, 1, 3
"d:\IDEWORK\lvmen\src\licensedcode\data\rules\false-positive_5457.yml", "YAML", 0, 0, 0, 2, 0, 0, 1, 3
"d:\IDEWORK\lvmen\src\licensedcode\data\rules\false-positive_5458.yml", "YAML", 0, 0, 0, 2, 0, 0, 1, 3
"d:\IDEWORK\lvmen\src\licensedcode\data\rules\false-positive_5459.yml", "YAML", 0, 0, 0, 2, 0, 0, 1, 3
"d:\IDEWORK\lvmen\src\licensedcode\data\rules\false-positive_546.yml", "YAML", 0, 0, 0, 2, 0, 0, 1, 3
"d:\IDEWORK\lvmen\src\licensedcode\data\rules\false-positive_5460.yml", "YAML", 0, 0, 0, 2, 0, 0, 1, 3
"d:\IDEWORK\lvmen\src\licensedcode\data\rules\false-positive_5461.yml", "YAML", 0, 0, 0, 2, 0, 0, 1, 3
"d:\IDEWORK\lvmen\src\licensedcode\data\rules\false-positive_5462.yml", "YAML", 0, 0, 0, 2, 0, 0, 1, 3
"d:\IDEWORK\lvmen\src\licensedcode\data\rules\false-positive_5463.yml", "YAML", 0, 0, 0, 2, 0, 0, 1, 3
"d:\IDEWORK\lvmen\src\licensedcode\data\rules\false-positive_5464.yml", "YAML", 0, 0, 0, 2, 0, 0, 1, 3
"d:\IDEWORK\lvmen\src\licensedcode\data\rules\false-positive_5465.yml", "YAML", 0, 0, 0, 2, 0, 0, 1, 3
"d:\IDEWORK\lvmen\src\licensedcode\data\rules\false-positive_5466.yml", "YAML", 0, 0, 0, 2, 0, 0, 1, 3
"d:\IDEWORK\lvmen\src\licensedcode\data\rules\false-positive_5467.yml", "YAML", 0, 0, 0, 2, 0, 0, 1, 3
"d:\IDEWORK\lvmen\src\licensedcode\data\rules\false-positive_5468.yml", "YAML", 0, 0, 0, 2, 0, 0, 1, 3
"d:\IDEWORK\lvmen\src\licensedcode\data\rules\false-positive_5469.yml", "YAML", 0, 0, 0, 2, 0, 0, 1, 3
"d:\IDEWORK\lvmen\src\licensedcode\data\rules\false-positive_547.yml", "YAML", 0, 0, 0, 2, 0, 0, 1, 3
"d:\IDEWORK\lvmen\src\licensedcode\data\rules\false-positive_5470.yml", "YAML", 0, 0, 0, 2, 0, 0, 1, 3
"d:\IDEWORK\lvmen\src\licensedcode\data\rules\false-positive_5471.yml", "YAML", 0, 0, 0, 2, 0, 0, 1, 3
"d:\IDEWORK\lvmen\src\licensedcode\data\rules\false-positive_5472.yml", "YAML", 0, 0, 0, 2, 0, 0, 1, 3
"d:\IDEWORK\lvmen\src\licensedcode\data\rules\false-positive_5473.yml", "YAML", 0, 0, 0, 2, 0, 0, 1, 3
"d:\IDEWORK\lvmen\src\licensedcode\data\rules\false-positive_5474.yml", "YAML", 0, 0, 0, 2, 0, 0, 1, 3
"d:\IDEWORK\lvmen\src\licensedcode\data\rules\false-positive_5475.yml", "YAML", 0, 0, 0, 2, 0, 0, 1, 3
"d:\IDEWORK\lvmen\src\licensedcode\data\rules\false-positive_5476.yml", "YAML", 0, 0, 0, 2, 0, 0, 1, 3
"d:\IDEWORK\lvmen\src\licensedcode\data\rules\false-positive_5477.yml", "YAML", 0, 0, 0, 2, 0, 0, 1, 3
"d:\IDEWORK\lvmen\src\licensedcode\data\rules\false-positive_5478.yml", "YAML", 0, 0, 0, 2, 0, 0, 1, 3
"d:\IDEWORK\lvmen\src\licensedcode\data\rules\false-positive_5479.yml", "YAML", 0, 0, 0, 2, 0, 0, 1, 3
"d:\IDEWORK\lvmen\src\licensedcode\data\rules\false-positive_548.yml", "YAML", 0, 0, 0, 2, 0, 0, 1, 3
"d:\IDEWORK\lvmen\src\licensedcode\data\rules\false-positive_5480.yml", "YAML", 0, 0, 0, 2, 0, 0, 1, 3
"d:\IDEWORK\lvmen\src\licensedcode\data\rules\false-positive_5481.yml", "YAML", 0, 0, 0, 2, 0, 0, 1, 3
"d:\IDEWORK\lvmen\src\licensedcode\data\rules\false-positive_5482.yml", "YAML", 0, 0, 0, 2, 0, 0, 1, 3
"d:\IDEWORK\lvmen\src\licensedcode\data\rules\false-positive_5483.yml", "YAML", 0, 0, 0, 2, 0, 0, 1, 3
"d:\IDEWORK\lvmen\src\licensedcode\data\rules\false-positive_5484.yml", "YAML", 0, 0, 0, 2, 0, 0, 1, 3
"d:\IDEWORK\lvmen\src\licensedcode\data\rules\false-positive_5485.yml", "YAML", 0, 0, 0, 2, 0, 0, 1, 3
"d:\IDEWORK\lvmen\src\licensedcode\data\rules\false-positive_5486.yml", "YAML", 0, 0, 0, 2, 0, 0, 1, 3
"d:\IDEWORK\lvmen\src\licensedcode\data\rules\false-positive_5487.yml", "YAML", 0, 0, 0, 2, 0, 0, 1, 3
"d:\IDEWORK\lvmen\src\licensedcode\data\rules\false-positive_5488.yml", "YAML", 0, 0, 0, 2, 0, 0, 1, 3
"d:\IDEWORK\lvmen\src\licensedcode\data\rules\false-positive_5489.yml", "YAML", 0, 0, 0, 2, 0, 0, 1, 3
"d:\IDEWORK\lvmen\src\licensedcode\data\rules\false-positive_549.yml", "YAML", 0, 0, 0, 2, 0, 0, 1, 3
"d:\IDEWORK\lvmen\src\licensedcode\data\rules\false-positive_5490.yml", "YAML", 0, 0, 0, 2, 0, 0, 1, 3
"d:\IDEWORK\lvmen\src\licensedcode\data\rules\false-positive_5491.yml", "YAML", 0, 0, 0, 2, 0, 0, 1, 3
"d:\IDEWORK\lvmen\src\licensedcode\data\rules\false-positive_5492.yml", "YAML", 0, 0, 0, 2, 0, 0, 1, 3
"d:\IDEWORK\lvmen\src\licensedcode\data\rules\false-positive_5493.yml", "YAML", 0, 0, 0, 2, 0, 0, 1, 3
"d:\IDEWORK\lvmen\src\licensedcode\data\rules\false-positive_5494.yml", "YAML", 0, 0, 0, 2, 0, 0, 1, 3
"d:\IDEWORK\lvmen\src\licensedcode\data\rules\false-positive_5495.yml", "YAML", 0, 0, 0, 2, 0, 0, 1, 3
"d:\IDEWORK\lvmen\src\licensedcode\data\rules\false-positive_5496.yml", "YAML", 0, 0, 0, 2, 0, 0, 1, 3
"d:\IDEWORK\lvmen\src\licensedcode\data\rules\false-positive_5497.yml", "YAML", 0, 0, 0, 2, 0, 0, 1, 3
"d:\IDEWORK\lvmen\src\licensedcode\data\rules\false-positive_5498.yml", "YAML", 0, 0, 0, 2, 0, 0, 1, 3
"d:\IDEWORK\lvmen\src\licensedcode\data\rules\false-positive_5499.yml", "YAML", 0, 0, 0, 2, 0, 0, 1, 3
"d:\IDEWORK\lvmen\src\licensedcode\data\rules\false-positive_55.yml", "YAML", 0, 0, 0, 2, 0, 0, 1, 3
"d:\IDEWORK\lvmen\src\licensedcode\data\rules\false-positive_550.yml", "YAML", 0, 0, 0, 2, 0, 0, 1, 3
"d:\IDEWORK\lvmen\src\licensedcode\data\rules\false-positive_5500.yml", "YAML", 0, 0, 0, 2, 0, 0, 1, 3
"d:\IDEWORK\lvmen\src\licensedcode\data\rules\false-positive_5501.yml", "YAML", 0, 0, 0, 2, 0, 0, 1, 3
"d:\IDEWORK\lvmen\src\licensedcode\data\rules\false-positive_5502.yml", "YAML", 0, 0, 0, 2, 0, 0, 1, 3
"d:\IDEWORK\lvmen\src\licensedcode\data\rules\false-positive_5503.yml", "YAML", 0, 0, 0, 2, 0, 0, 1, 3
"d:\IDEWORK\lvmen\src\licensedcode\data\rules\false-positive_5504.yml", "YAML", 0, 0, 0, 2, 0, 0, 1, 3
"d:\IDEWORK\lvmen\src\licensedcode\data\rules\false-positive_5505.yml", "YAML", 0, 0, 0, 2, 0, 0, 1, 3
"d:\IDEWORK\lvmen\src\licensedcode\data\rules\false-positive_5506.yml", "YAML", 0, 0, 0, 2, 0, 0, 1, 3
"d:\IDEWORK\lvmen\src\licensedcode\data\rules\false-positive_5507.yml", "YAML", 0, 0, 0, 2, 0, 0, 1, 3
"d:\IDEWORK\lvmen\src\licensedcode\data\rules\false-positive_5508.yml", "YAML", 0, 0, 0, 2, 0, 0, 1, 3
"d:\IDEWORK\lvmen\src\licensedcode\data\rules\false-positive_5509.yml", "YAML", 0, 0, 0, 2, 0, 0, 1, 3
"d:\IDEWORK\lvmen\src\licensedcode\data\rules\false-positive_551.yml", "YAML", 0, 0, 0, 2, 0, 0, 1, 3
"d:\IDEWORK\lvmen\src\licensedcode\data\rules\false-positive_5510.yml", "YAML", 0, 0, 0, 2, 0, 0, 1, 3
"d:\IDEWORK\lvmen\src\licensedcode\data\rules\false-positive_5511.yml", "YAML", 0, 0, 0, 2, 0, 0, 1, 3
"d:\IDEWORK\lvmen\src\licensedcode\data\rules\false-positive_5512.yml", "YAML", 0, 0, 0, 2, 0, 0, 1, 3
"d:\IDEWORK\lvmen\src\licensedcode\data\rules\false-positive_5513.yml", "YAML", 0, 0, 0, 2, 0, 0, 1, 3
"d:\IDEWORK\lvmen\src\licensedcode\data\rules\false-positive_5514.yml", "YAML", 0, 0, 0, 2, 0, 0, 1, 3
"d:\IDEWORK\lvmen\src\licensedcode\data\rules\false-positive_5515.yml", "YAML", 0, 0, 0, 2, 0, 0, 1, 3
"d:\IDEWORK\lvmen\src\licensedcode\data\rules\false-positive_5516.yml", "YAML", 0, 0, 0, 2, 0, 0, 1, 3
"d:\IDEWORK\lvmen\src\licensedcode\data\rules\false-positive_5517.yml", "YAML", 0, 0, 0, 2, 0, 0, 1, 3
"d:\IDEWORK\lvmen\src\licensedcode\data\rules\false-positive_5518.yml", "YAML", 0, 0, 0, 2, 0, 0, 1, 3
"d:\IDEWORK\lvmen\src\licensedcode\data\rules\false-positive_5519.yml", "YAML", 0, 0, 0, 2, 0, 0, 1, 3
"d:\IDEWORK\lvmen\src\licensedcode\data\rules\false-positive_552.yml", "YAML", 0, 0, 0, 2, 0, 0, 1, 3
"d:\IDEWORK\lvmen\src\licensedcode\data\rules\false-positive_5520.yml", "YAML", 0, 0, 0, 2, 0, 0, 1, 3
"d:\IDEWORK\lvmen\src\licensedcode\data\rules\false-positive_5521.yml", "YAML", 0, 0, 0, 2, 0, 0, 1, 3
"d:\IDEWORK\lvmen\src\licensedcode\data\rules\false-positive_5522.yml", "YAML", 0, 0, 0, 2, 0, 0, 1, 3
"d:\IDEWORK\lvmen\src\licensedcode\data\rules\false-positive_5523.yml", "YAML", 0, 0, 0, 2, 0, 0, 1, 3
"d:\IDEWORK\lvmen\src\licensedcode\data\rules\false-positive_5524.yml", "YAML", 0, 0, 0, 2, 0, 0, 1, 3
"d:\IDEWORK\lvmen\src\licensedcode\data\rules\false-positive_5525.yml", "YAML", 0, 0, 0, 2, 0, 0, 1, 3
"d:\IDEWORK\lvmen\src\licensedcode\data\rules\false-positive_5526.yml", "YAML", 0, 0, 0, 2, 0, 0, 1, 3
"d:\IDEWORK\lvmen\src\licensedcode\data\rules\false-positive_5527.yml", "YAML", 0, 0, 0, 2, 0, 0, 1, 3
"d:\IDEWORK\lvmen\src\licensedcode\data\rules\false-positive_5528.yml", "YAML", 0, 0, 0, 2, 0, 0, 1, 3
"d:\IDEWORK\lvmen\src\licensedcode\data\rules\false-positive_5529.yml", "YAML", 0, 0, 0, 2, 0, 0, 1, 3
"d:\IDEWORK\lvmen\src\licensedcode\data\rules\false-positive_553.yml", "YAML", 0, 0, 0, 2, 0, 0, 1, 3
"d:\IDEWORK\lvmen\src\licensedcode\data\rules\false-positive_5530.yml", "YAML", 0, 0, 0, 2, 0, 0, 1, 3
"d:\IDEWORK\lvmen\src\licensedcode\data\rules\false-positive_5531.yml", "YAML", 0, 0, 0, 2, 0, 0, 1, 3
"d:\IDEWORK\lvmen\src\licensedcode\data\rules\false-positive_5532.yml", "YAML", 0, 0, 0, 2, 0, 0, 1, 3
"d:\IDEWORK\lvmen\src\licensedcode\data\rules\false-positive_5533.yml", "YAML", 0, 0, 0, 2, 0, 0, 1, 3
"d:\IDEWORK\lvmen\src\licensedcode\data\rules\false-positive_5534.yml", "YAML", 0, 0, 0, 2, 0, 0, 1, 3
"d:\IDEWORK\lvmen\src\licensedcode\data\rules\false-positive_5535.yml", "YAML", 0, 0, 0, 2, 0, 0, 1, 3
"d:\IDEWORK\lvmen\src\licensedcode\data\rules\false-positive_5536.yml", "YAML", 0, 0, 0, 2, 0, 0, 1, 3
"d:\IDEWORK\lvmen\src\licensedcode\data\rules\false-positive_5537.yml", "YAML", 0, 0, 0, 2, 0, 0, 1, 3
"d:\IDEWORK\lvmen\src\licensedcode\data\rules\false-positive_5538.yml", "YAML", 0, 0, 0, 2, 0, 0, 1, 3
"d:\IDEWORK\lvmen\src\licensedcode\data\rules\false-positive_5539.yml", "YAML", 0, 0, 0, 2, 0, 0, 1, 3
"d:\IDEWORK\lvmen\src\licensedcode\data\rules\false-positive_554.yml", "YAML", 0, 0, 0, 2, 0, 0, 1, 3
"d:\IDEWORK\lvmen\src\licensedcode\data\rules\false-positive_5540.yml", "YAML", 0, 0, 0, 2, 0, 0, 1, 3
"d:\IDEWORK\lvmen\src\licensedcode\data\rules\false-positive_5541.yml", "YAML", 0, 0, 0, 2, 0, 0, 1, 3
"d:\IDEWORK\lvmen\src\licensedcode\data\rules\false-positive_5542.yml", "YAML", 0, 0, 0, 2, 0, 0, 1, 3
"d:\IDEWORK\lvmen\src\licensedcode\data\rules\false-positive_5543.yml", "YAML", 0, 0, 0, 2, 0, 0, 1, 3
"d:\IDEWORK\lvmen\src\licensedcode\data\rules\false-positive_5544.yml", "YAML", 0, 0, 0, 2, 0, 0, 1, 3
"d:\IDEWORK\lvmen\src\licensedcode\data\rules\false-positive_5545.yml", "YAML", 0, 0, 0, 2, 0, 0, 1, 3
"d:\IDEWORK\lvmen\src\licensedcode\data\rules\false-positive_5546.yml", "YAML", 0, 0, 0, 2, 0, 0, 1, 3
"d:\IDEWORK\lvmen\src\licensedcode\data\rules\false-positive_5547.yml", "YAML", 0, 0, 0, 2, 0, 0, 1, 3
"d:\IDEWORK\lvmen\src\licensedcode\data\rules\false-positive_5548.yml", "YAML", 0, 0, 0, 2, 0, 0, 1, 3
"d:\IDEWORK\lvmen\src\licensedcode\data\rules\false-positive_5549.yml", "YAML", 0, 0, 0, 2, 0, 0, 1, 3
"d:\IDEWORK\lvmen\src\licensedcode\data\rules\false-positive_555.yml", "YAML", 0, 0, 0, 2, 0, 0, 1, 3
"d:\IDEWORK\lvmen\src\licensedcode\data\rules\false-positive_5550.yml", "YAML", 0, 0, 0, 2, 0, 0, 1, 3
"d:\IDEWORK\lvmen\src\licensedcode\data\rules\false-positive_5551.yml", "YAML", 0, 0, 0, 2, 0, 0, 1, 3
"d:\IDEWORK\lvmen\src\licensedcode\data\rules\false-positive_5552.yml", "YAML", 0, 0, 0, 2, 0, 0, 1, 3
"d:\IDEWORK\lvmen\src\licensedcode\data\rules\false-positive_5553.yml", "YAML", 0, 0, 0, 2, 0, 0, 1, 3
"d:\IDEWORK\lvmen\src\licensedcode\data\rules\false-positive_5554.yml", "YAML", 0, 0, 0, 2, 0, 0, 1, 3
"d:\IDEWORK\lvmen\src\licensedcode\data\rules\false-positive_5555.yml", "YAML", 0, 0, 0, 2, 0, 0, 1, 3
"d:\IDEWORK\lvmen\src\licensedcode\data\rules\false-positive_5556.yml", "YAML", 0, 0, 0, 2, 0, 0, 1, 3
"d:\IDEWORK\lvmen\src\licensedcode\data\rules\false-positive_5557.yml", "YAML", 0, 0, 0, 2, 0, 0, 1, 3
"d:\IDEWORK\lvmen\src\licensedcode\data\rules\false-positive_5558.yml", "YAML", 0, 0, 0, 2, 0, 0, 1, 3
"d:\IDEWORK\lvmen\src\licensedcode\data\rules\false-positive_5559.yml", "YAML", 0, 0, 0, 2, 0, 0, 1, 3
"d:\IDEWORK\lvmen\src\licensedcode\data\rules\false-positive_556.yml", "YAML", 0, 0, 0, 2, 0, 0, 1, 3
"d:\IDEWORK\lvmen\src\licensedcode\data\rules\false-positive_5560.yml", "YAML", 0, 0, 0, 2, 0, 0, 1, 3
"d:\IDEWORK\lvmen\src\licensedcode\data\rules\false-positive_5561.yml", "YAML", 0, 0, 0, 2, 0, 0, 1, 3
"d:\IDEWORK\lvmen\src\licensedcode\data\rules\false-positive_5562.yml", "YAML", 0, 0, 0, 2, 0, 0, 1, 3
"d:\IDEWORK\lvmen\src\licensedcode\data\rules\false-positive_5563.yml", "YAML", 0, 0, 0, 2, 0, 0, 1, 3
"d:\IDEWORK\lvmen\src\licensedcode\data\rules\false-positive_5564.yml", "YAML", 0, 0, 0, 2, 0, 0, 1, 3
"d:\IDEWORK\lvmen\src\licensedcode\data\rules\false-positive_5565.yml", "YAML", 0, 0, 0, 2, 0, 0, 1, 3
"d:\IDEWORK\lvmen\src\licensedcode\data\rules\false-positive_5566.yml", "YAML", 0, 0, 0, 2, 0, 0, 1, 3
"d:\IDEWORK\lvmen\src\licensedcode\data\rules\false-positive_5567.yml", "YAML", 0, 0, 0, 2, 0, 0, 1, 3
"d:\IDEWORK\lvmen\src\licensedcode\data\rules\false-positive_5568.yml", "YAML", 0, 0, 0, 2, 0, 0, 1, 3
"d:\IDEWORK\lvmen\src\licensedcode\data\rules\false-positive_5569.yml", "YAML", 0, 0, 0, 2, 0, 0, 1, 3
"d:\IDEWORK\lvmen\src\licensedcode\data\rules\false-positive_557.yml", "YAML", 0, 0, 0, 2, 0, 0, 1, 3
"d:\IDEWORK\lvmen\src\licensedcode\data\rules\false-positive_5570.yml", "YAML", 0, 0, 0, 2, 0, 0, 1, 3
"d:\IDEWORK\lvmen\src\licensedcode\data\rules\false-positive_5571.yml", "YAML", 0, 0, 0, 2, 0, 0, 1, 3
"d:\IDEWORK\lvmen\src\licensedcode\data\rules\false-positive_5572.yml", "YAML", 0, 0, 0, 2, 0, 0, 1, 3
"d:\IDEWORK\lvmen\src\licensedcode\data\rules\false-positive_5573.yml", "YAML", 0, 0, 0, 2, 0, 0, 1, 3
"d:\IDEWORK\lvmen\src\licensedcode\data\rules\false-positive_5574.yml", "YAML", 0, 0, 0, 2, 0, 0, 1, 3
"d:\IDEWORK\lvmen\src\licensedcode\data\rules\false-positive_5575.yml", "YAML", 0, 0, 0, 2, 0, 0, 1, 3
"d:\IDEWORK\lvmen\src\licensedcode\data\rules\false-positive_5576.yml", "YAML", 0, 0, 0, 2, 0, 0, 1, 3
"d:\IDEWORK\lvmen\src\licensedcode\data\rules\false-positive_5577.yml", "YAML", 0, 0, 0, 2, 0, 0, 1, 3
"d:\IDEWORK\lvmen\src\licensedcode\data\rules\false-positive_5578.yml", "YAML", 0, 0, 0, 2, 0, 0, 1, 3
"d:\IDEWORK\lvmen\src\licensedcode\data\rules\false-positive_5579.yml", "YAML", 0, 0, 0, 2, 0, 0, 1, 3
"d:\IDEWORK\lvmen\src\licensedcode\data\rules\false-positive_558.yml", "YAML", 0, 0, 0, 2, 0, 0, 1, 3
"d:\IDEWORK\lvmen\src\licensedcode\data\rules\false-positive_5580.yml", "YAML", 0, 0, 0, 2, 0, 0, 1, 3
"d:\IDEWORK\lvmen\src\licensedcode\data\rules\false-positive_5581.yml", "YAML", 0, 0, 0, 2, 0, 0, 1, 3
"d:\IDEWORK\lvmen\src\licensedcode\data\rules\false-positive_5582.yml", "YAML", 0, 0, 0, 2, 0, 0, 1, 3
"d:\IDEWORK\lvmen\src\licensedcode\data\rules\false-positive_5583.yml", "YAML", 0, 0, 0, 2, 0, 0, 1, 3
"d:\IDEWORK\lvmen\src\licensedcode\data\rules\false-positive_5584.yml", "YAML", 0, 0, 0, 2, 0, 0, 1, 3
"d:\IDEWORK\lvmen\src\licensedcode\data\rules\false-positive_5585.yml", "YAML", 0, 0, 0, 2, 0, 0, 1, 3
"d:\IDEWORK\lvmen\src\licensedcode\data\rules\false-positive_5586.yml", "YAML", 0, 0, 0, 2, 0, 0, 1, 3
"d:\IDEWORK\lvmen\src\licensedcode\data\rules\false-positive_5587.yml", "YAML", 0, 0, 0, 2, 0, 0, 1, 3
"d:\IDEWORK\lvmen\src\licensedcode\data\rules\false-positive_5588.yml", "YAML", 0, 0, 0, 2, 0, 0, 1, 3
"d:\IDEWORK\lvmen\src\licensedcode\data\rules\false-positive_5589.yml", "YAML", 0, 0, 0, 2, 0, 0, 1, 3
"d:\IDEWORK\lvmen\src\licensedcode\data\rules\false-positive_559.yml", "YAML", 0, 0, 0, 2, 0, 0, 1, 3
"d:\IDEWORK\lvmen\src\licensedcode\data\rules\false-positive_5590.yml", "YAML", 0, 0, 0, 2, 0, 0, 1, 3
"d:\IDEWORK\lvmen\src\licensedcode\data\rules\false-positive_5591.yml", "YAML", 0, 0, 0, 2, 0, 0, 1, 3
"d:\IDEWORK\lvmen\src\licensedcode\data\rules\false-positive_5592.yml", "YAML", 0, 0, 0, 2, 0, 0, 1, 3
"d:\IDEWORK\lvmen\src\licensedcode\data\rules\false-positive_5593.yml", "YAML", 0, 0, 0, 2, 0, 0, 1, 3
"d:\IDEWORK\lvmen\src\licensedcode\data\rules\false-positive_5594.yml", "YAML", 0, 0, 0, 2, 0, 0, 1, 3
"d:\IDEWORK\lvmen\src\licensedcode\data\rules\false-positive_5595.yml", "YAML", 0, 0, 0, 2, 0, 0, 1, 3
"d:\IDEWORK\lvmen\src\licensedcode\data\rules\false-positive_5596.yml", "YAML", 0, 0, 0, 2, 0, 0, 1, 3
"d:\IDEWORK\lvmen\src\licensedcode\data\rules\false-positive_5597.yml", "YAML", 0, 0, 0, 2, 0, 0, 1, 3
"d:\IDEWORK\lvmen\src\licensedcode\data\rules\false-positive_5598.yml", "YAML", 0, 0, 0, 2, 0, 0, 1, 3
"d:\IDEWORK\lvmen\src\licensedcode\data\rules\false-positive_5599.yml", "YAML", 0, 0, 0, 2, 0, 0, 1, 3
"d:\IDEWORK\lvmen\src\licensedcode\data\rules\false-positive_56.yml", "YAML", 0, 0, 0, 2, 0, 0, 1, 3
"d:\IDEWORK\lvmen\src\licensedcode\data\rules\false-positive_560.yml", "YAML", 0, 0, 0, 2, 0, 0, 1, 3
"d:\IDEWORK\lvmen\src\licensedcode\data\rules\false-positive_5600.yml", "YAML", 0, 0, 0, 2, 0, 0, 1, 3
"d:\IDEWORK\lvmen\src\licensedcode\data\rules\false-positive_5601.yml", "YAML", 0, 0, 0, 2, 0, 0, 1, 3
"d:\IDEWORK\lvmen\src\licensedcode\data\rules\false-positive_5602.yml", "YAML", 0, 0, 0, 2, 0, 0, 1, 3
"d:\IDEWORK\lvmen\src\licensedcode\data\rules\false-positive_5603.yml", "YAML", 0, 0, 0, 2, 0, 0, 1, 3
"d:\IDEWORK\lvmen\src\licensedcode\data\rules\false-positive_5604.yml", "YAML", 0, 0, 0, 2, 0, 0, 1, 3
"d:\IDEWORK\lvmen\src\licensedcode\data\rules\false-positive_5605.yml", "YAML", 0, 0, 0, 2, 0, 0, 1, 3
"d:\IDEWORK\lvmen\src\licensedcode\data\rules\false-positive_5606.yml", "YAML", 0, 0, 0, 2, 0, 0, 1, 3
"d:\IDEWORK\lvmen\src\licensedcode\data\rules\false-positive_5607.yml", "YAML", 0, 0, 0, 2, 0, 0, 1, 3
"d:\IDEWORK\lvmen\src\licensedcode\data\rules\false-positive_5608.yml", "YAML", 0, 0, 0, 2, 0, 0, 1, 3
"d:\IDEWORK\lvmen\src\licensedcode\data\rules\false-positive_5609.yml", "YAML", 0, 0, 0, 2, 0, 0, 1, 3
"d:\IDEWORK\lvmen\src\licensedcode\data\rules\false-positive_561.yml", "YAML", 0, 0, 0, 2, 0, 0, 1, 3
"d:\IDEWORK\lvmen\src\licensedcode\data\rules\false-positive_5610.yml", "YAML", 0, 0, 0, 2, 0, 0, 1, 3
"d:\IDEWORK\lvmen\src\licensedcode\data\rules\false-positive_5611.yml", "YAML", 0, 0, 0, 2, 0, 0, 1, 3
"d:\IDEWORK\lvmen\src\licensedcode\data\rules\false-positive_5612.yml", "YAML", 0, 0, 0, 2, 0, 0, 1, 3
"d:\IDEWORK\lvmen\src\licensedcode\data\rules\false-positive_5613.yml", "YAML", 0, 0, 0, 2, 0, 0, 1, 3
"d:\IDEWORK\lvmen\src\licensedcode\data\rules\false-positive_5614.yml", "YAML", 0, 0, 0, 2, 0, 0, 1, 3
"d:\IDEWORK\lvmen\src\licensedcode\data\rules\false-positive_5615.yml", "YAML", 0, 0, 0, 2, 0, 0, 1, 3
"d:\IDEWORK\lvmen\src\licensedcode\data\rules\false-positive_5616.yml", "YAML", 0, 0, 0, 2, 0, 0, 1, 3
"d:\IDEWORK\lvmen\src\licensedcode\data\rules\false-positive_5617.yml", "YAML", 0, 0, 0, 2, 0, 0, 1, 3
"d:\IDEWORK\lvmen\src\licensedcode\data\rules\false-positive_5618.yml", "YAML", 0, 0, 0, 2, 0, 0, 1, 3
"d:\IDEWORK\lvmen\src\licensedcode\data\rules\false-positive_5619.yml", "YAML", 0, 0, 0, 2, 0, 0, 1, 3
"d:\IDEWORK\lvmen\src\licensedcode\data\rules\false-positive_562.yml", "YAML", 0, 0, 0, 2, 0, 0, 1, 3
"d:\IDEWORK\lvmen\src\licensedcode\data\rules\false-positive_5620.yml", "YAML", 0, 0, 0, 2, 0, 0, 1, 3
"d:\IDEWORK\lvmen\src\licensedcode\data\rules\false-positive_5621.yml", "YAML", 0, 0, 0, 2, 0, 0, 1, 3
"d:\IDEWORK\lvmen\src\licensedcode\data\rules\false-positive_5622.yml", "YAML", 0, 0, 0, 2, 0, 0, 1, 3
"d:\IDEWORK\lvmen\src\licensedcode\data\rules\false-positive_5623.yml", "YAML", 0, 0, 0, 2, 0, 0, 1, 3
"d:\IDEWORK\lvmen\src\licensedcode\data\rules\false-positive_5624.yml", "YAML", 0, 0, 0, 2, 0, 0, 1, 3
"d:\IDEWORK\lvmen\src\licensedcode\data\rules\false-positive_5625.yml", "YAML", 0, 0, 0, 2, 0, 0, 1, 3
"d:\IDEWORK\lvmen\src\licensedcode\data\rules\false-positive_5626.yml", "YAML", 0, 0, 0, 2, 0, 0, 1, 3
"d:\IDEWORK\lvmen\src\licensedcode\data\rules\false-positive_5627.yml", "YAML", 0, 0, 0, 2, 0, 0, 1, 3
"d:\IDEWORK\lvmen\src\licensedcode\data\rules\false-positive_5628.yml", "YAML", 0, 0, 0, 2, 0, 0, 1, 3
"d:\IDEWORK\lvmen\src\licensedcode\data\rules\false-positive_5629.yml", "YAML", 0, 0, 0, 2, 0, 0, 1, 3
"d:\IDEWORK\lvmen\src\licensedcode\data\rules\false-positive_563.yml", "YAML", 0, 0, 0, 2, 0, 0, 1, 3
"d:\IDEWORK\lvmen\src\licensedcode\data\rules\false-positive_5630.yml", "YAML", 0, 0, 0, 2, 0, 0, 1, 3
"d:\IDEWORK\lvmen\src\licensedcode\data\rules\false-positive_5631.yml", "YAML", 0, 0, 0, 2, 0, 0, 1, 3
"d:\IDEWORK\lvmen\src\licensedcode\data\rules\false-positive_5632.yml", "YAML", 0, 0, 0, 2, 0, 0, 1, 3
"d:\IDEWORK\lvmen\src\licensedcode\data\rules\false-positive_5633.yml", "YAML", 0, 0, 0, 2, 0, 0, 1, 3
"d:\IDEWORK\lvmen\src\licensedcode\data\rules\false-positive_5634.yml", "YAML", 0, 0, 0, 2, 0, 0, 1, 3
"d:\IDEWORK\lvmen\src\licensedcode\data\rules\false-positive_5635.yml", "YAML", 0, 0, 0, 2, 0, 0, 1, 3
"d:\IDEWORK\lvmen\src\licensedcode\data\rules\false-positive_5636.yml", "YAML", 0, 0, 0, 2, 0, 0, 1, 3
"d:\IDEWORK\lvmen\src\licensedcode\data\rules\false-positive_5637.yml", "YAML", 0, 0, 0, 2, 0, 0, 1, 3
"d:\IDEWORK\lvmen\src\licensedcode\data\rules\false-positive_5638.yml", "YAML", 0, 0, 0, 2, 0, 0, 1, 3
"d:\IDEWORK\lvmen\src\licensedcode\data\rules\false-positive_5639.yml", "YAML", 0, 0, 0, 2, 0, 0, 1, 3
"d:\IDEWORK\lvmen\src\licensedcode\data\rules\false-positive_564.yml", "YAML", 0, 0, 0, 2, 0, 0, 1, 3
"d:\IDEWORK\lvmen\src\licensedcode\data\rules\false-positive_5640.yml", "YAML", 0, 0, 0, 2, 0, 0, 1, 3
"d:\IDEWORK\lvmen\src\licensedcode\data\rules\false-positive_5641.yml", "YAML", 0, 0, 0, 2, 0, 0, 1, 3
"d:\IDEWORK\lvmen\src\licensedcode\data\rules\false-positive_5642.yml", "YAML", 0, 0, 0, 2, 0, 0, 1, 3
"d:\IDEWORK\lvmen\src\licensedcode\data\rules\false-positive_5643.yml", "YAML", 0, 0, 0, 2, 0, 0, 1, 3
"d:\IDEWORK\lvmen\src\licensedcode\data\rules\false-positive_5644.yml", "YAML", 0, 0, 0, 2, 0, 0, 1, 3
"d:\IDEWORK\lvmen\src\licensedcode\data\rules\false-positive_5645.yml", "YAML", 0, 0, 0, 2, 0, 0, 1, 3
"d:\IDEWORK\lvmen\src\licensedcode\data\rules\false-positive_5646.yml", "YAML", 0, 0, 0, 2, 0, 0, 1, 3
"d:\IDEWORK\lvmen\src\licensedcode\data\rules\false-positive_5647.yml", "YAML", 0, 0, 0, 2, 0, 0, 1, 3
"d:\IDEWORK\lvmen\src\licensedcode\data\rules\false-positive_5648.yml", "YAML", 0, 0, 0, 2, 0, 0, 1, 3
"d:\IDEWORK\lvmen\src\licensedcode\data\rules\false-positive_5649.yml", "YAML", 0, 0, 0, 2, 0, 0, 1, 3
"d:\IDEWORK\lvmen\src\licensedcode\data\rules\false-positive_565.yml", "YAML", 0, 0, 0, 2, 0, 0, 1, 3
"d:\IDEWORK\lvmen\src\licensedcode\data\rules\false-positive_5650.yml", "YAML", 0, 0, 0, 2, 0, 0, 1, 3
"d:\IDEWORK\lvmen\src\licensedcode\data\rules\false-positive_5651.yml", "YAML", 0, 0, 0, 2, 0, 0, 1, 3
"d:\IDEWORK\lvmen\src\licensedcode\data\rules\false-positive_5652.yml", "YAML", 0, 0, 0, 2, 0, 0, 1, 3
"d:\IDEWORK\lvmen\src\licensedcode\data\rules\false-positive_5653.yml", "YAML", 0, 0, 0, 2, 0, 0, 1, 3
"d:\IDEWORK\lvmen\src\licensedcode\data\rules\false-positive_5654.yml", "YAML", 0, 0, 0, 2, 0, 0, 1, 3
"d:\IDEWORK\lvmen\src\licensedcode\data\rules\false-positive_5655.yml", "YAML", 0, 0, 0, 2, 0, 0, 1, 3
"d:\IDEWORK\lvmen\src\licensedcode\data\rules\false-positive_5656.yml", "YAML", 0, 0, 0, 2, 0, 0, 1, 3
"d:\IDEWORK\lvmen\src\licensedcode\data\rules\false-positive_5657.yml", "YAML", 0, 0, 0, 2, 0, 0, 1, 3
"d:\IDEWORK\lvmen\src\licensedcode\data\rules\false-positive_5658.yml", "YAML", 0, 0, 0, 2, 0, 0, 1, 3
"d:\IDEWORK\lvmen\src\licensedcode\data\rules\false-positive_5659.yml", "YAML", 0, 0, 0, 2, 0, 0, 1, 3
"d:\IDEWORK\lvmen\src\licensedcode\data\rules\false-positive_566.yml", "YAML", 0, 0, 0, 2, 0, 0, 1, 3
"d:\IDEWORK\lvmen\src\licensedcode\data\rules\false-positive_5660.yml", "YAML", 0, 0, 0, 2, 0, 0, 1, 3
"d:\IDEWORK\lvmen\src\licensedcode\data\rules\false-positive_5661.yml", "YAML", 0, 0, 0, 2, 0, 0, 1, 3
"d:\IDEWORK\lvmen\src\licensedcode\data\rules\false-positive_5662.yml", "YAML", 0, 0, 0, 2, 0, 0, 1, 3
"d:\IDEWORK\lvmen\src\licensedcode\data\rules\false-positive_5663.yml", "YAML", 0, 0, 0, 2, 0, 0, 1, 3
"d:\IDEWORK\lvmen\src\licensedcode\data\rules\false-positive_5664.yml", "YAML", 0, 0, 0, 2, 0, 0, 1, 3
"d:\IDEWORK\lvmen\src\licensedcode\data\rules\false-positive_5665.yml", "YAML", 0, 0, 0, 2, 0, 0, 1, 3
"d:\IDEWORK\lvmen\src\licensedcode\data\rules\false-positive_5666.yml", "YAML", 0, 0, 0, 2, 0, 0, 1, 3
"d:\IDEWORK\lvmen\src\licensedcode\data\rules\false-positive_5667.yml", "YAML", 0, 0, 0, 2, 0, 0, 1, 3
"d:\IDEWORK\lvmen\src\licensedcode\data\rules\false-positive_5668.yml", "YAML", 0, 0, 0, 2, 0, 0, 1, 3
"d:\IDEWORK\lvmen\src\licensedcode\data\rules\false-positive_5669.yml", "YAML", 0, 0, 0, 2, 0, 0, 1, 3
"d:\IDEWORK\lvmen\src\licensedcode\data\rules\false-positive_567.yml", "YAML", 0, 0, 0, 2, 0, 0, 1, 3
"d:\IDEWORK\lvmen\src\licensedcode\data\rules\false-positive_5670.yml", "YAML", 0, 0, 0, 2, 0, 0, 1, 3
"d:\IDEWORK\lvmen\src\licensedcode\data\rules\false-positive_5671.yml", "YAML", 0, 0, 0, 2, 0, 0, 1, 3
"d:\IDEWORK\lvmen\src\licensedcode\data\rules\false-positive_5672.yml", "YAML", 0, 0, 0, 2, 0, 0, 1, 3
"d:\IDEWORK\lvmen\src\licensedcode\data\rules\false-positive_5673.yml", "YAML", 0, 0, 0, 2, 0, 0, 1, 3
"d:\IDEWORK\lvmen\src\licensedcode\data\rules\false-positive_5674.yml", "YAML", 0, 0, 0, 2, 0, 0, 1, 3
"d:\IDEWORK\lvmen\src\licensedcode\data\rules\false-positive_5675.yml", "YAML", 0, 0, 0, 2, 0, 0, 1, 3
"d:\IDEWORK\lvmen\src\licensedcode\data\rules\false-positive_5676.yml", "YAML", 0, 0, 0, 2, 0, 0, 1, 3
"d:\IDEWORK\lvmen\src\licensedcode\data\rules\false-positive_5677.yml", "YAML", 0, 0, 0, 2, 0, 0, 1, 3
"d:\IDEWORK\lvmen\src\licensedcode\data\rules\false-positive_5678.yml", "YAML", 0, 0, 0, 2, 0, 0, 1, 3
"d:\IDEWORK\lvmen\src\licensedcode\data\rules\false-positive_5679.yml", "YAML", 0, 0, 0, 2, 0, 0, 1, 3
"d:\IDEWORK\lvmen\src\licensedcode\data\rules\false-positive_568.yml", "YAML", 0, 0, 0, 2, 0, 0, 1, 3
"d:\IDEWORK\lvmen\src\licensedcode\data\rules\false-positive_5680.yml", "YAML", 0, 0, 0, 2, 0, 0, 1, 3
"d:\IDEWORK\lvmen\src\licensedcode\data\rules\false-positive_5681.yml", "YAML", 0, 0, 0, 2, 0, 0, 1, 3
"d:\IDEWORK\lvmen\src\licensedcode\data\rules\false-positive_5682.yml", "YAML", 0, 0, 0, 2, 0, 0, 1, 3
"d:\IDEWORK\lvmen\src\licensedcode\data\rules\false-positive_5683.yml", "YAML", 0, 0, 0, 2, 0, 0, 1, 3
"d:\IDEWORK\lvmen\src\licensedcode\data\rules\false-positive_5684.yml", "YAML", 0, 0, 0, 2, 0, 0, 1, 3
"d:\IDEWORK\lvmen\src\licensedcode\data\rules\false-positive_5685.yml", "YAML", 0, 0, 0, 2, 0, 0, 1, 3
"d:\IDEWORK\lvmen\src\licensedcode\data\rules\false-positive_5686.yml", "YAML", 0, 0, 0, 2, 0, 0, 1, 3
"d:\IDEWORK\lvmen\src\licensedcode\data\rules\false-positive_5687.yml", "YAML", 0, 0, 0, 2, 0, 0, 1, 3
"d:\IDEWORK\lvmen\src\licensedcode\data\rules\false-positive_5688.yml", "YAML", 0, 0, 0, 2, 0, 0, 1, 3
"d:\IDEWORK\lvmen\src\licensedcode\data\rules\false-positive_5689.yml", "YAML", 0, 0, 0, 2, 0, 0, 1, 3
"d:\IDEWORK\lvmen\src\licensedcode\data\rules\false-positive_569.yml", "YAML", 0, 0, 0, 2, 0, 0, 1, 3
"d:\IDEWORK\lvmen\src\licensedcode\data\rules\false-positive_5690.yml", "YAML", 0, 0, 0, 2, 0, 0, 1, 3
"d:\IDEWORK\lvmen\src\licensedcode\data\rules\false-positive_5691.yml", "YAML", 0, 0, 0, 2, 0, 0, 1, 3
"d:\IDEWORK\lvmen\src\licensedcode\data\rules\false-positive_5692.yml", "YAML", 0, 0, 0, 2, 0, 0, 1, 3
"d:\IDEWORK\lvmen\src\licensedcode\data\rules\false-positive_5693.yml", "YAML", 0, 0, 0, 2, 0, 0, 1, 3
"d:\IDEWORK\lvmen\src\licensedcode\data\rules\false-positive_5694.yml", "YAML", 0, 0, 0, 2, 0, 0, 1, 3
"d:\IDEWORK\lvmen\src\licensedcode\data\rules\false-positive_5695.yml", "YAML", 0, 0, 0, 2, 0, 0, 1, 3
"d:\IDEWORK\lvmen\src\licensedcode\data\rules\false-positive_5696.yml", "YAML", 0, 0, 0, 2, 0, 0, 1, 3
"d:\IDEWORK\lvmen\src\licensedcode\data\rules\false-positive_5697.yml", "YAML", 0, 0, 0, 2, 0, 0, 1, 3
"d:\IDEWORK\lvmen\src\licensedcode\data\rules\false-positive_5698.yml", "YAML", 0, 0, 0, 2, 0, 0, 1, 3
"d:\IDEWORK\lvmen\src\licensedcode\data\rules\false-positive_5699.yml", "YAML", 0, 0, 0, 2, 0, 0, 1, 3
"d:\IDEWORK\lvmen\src\licensedcode\data\rules\false-positive_57.yml", "YAML", 0, 0, 0, 2, 0, 0, 1, 3
"d:\IDEWORK\lvmen\src\licensedcode\data\rules\false-positive_570.yml", "YAML", 0, 0, 0, 2, 0, 0, 1, 3
"d:\IDEWORK\lvmen\src\licensedcode\data\rules\false-positive_5700.yml", "YAML", 0, 0, 0, 2, 0, 0, 1, 3
"d:\IDEWORK\lvmen\src\licensedcode\data\rules\false-positive_5701.yml", "YAML", 0, 0, 0, 2, 0, 0, 1, 3
"d:\IDEWORK\lvmen\src\licensedcode\data\rules\false-positive_5702.yml", "YAML", 0, 0, 0, 2, 0, 0, 1, 3
"d:\IDEWORK\lvmen\src\licensedcode\data\rules\false-positive_5703.yml", "YAML", 0, 0, 0, 2, 0, 0, 1, 3
"d:\IDEWORK\lvmen\src\licensedcode\data\rules\false-positive_5704.yml", "YAML", 0, 0, 0, 2, 0, 0, 1, 3
"d:\IDEWORK\lvmen\src\licensedcode\data\rules\false-positive_5705.yml", "YAML", 0, 0, 0, 2, 0, 0, 1, 3
"d:\IDEWORK\lvmen\src\licensedcode\data\rules\false-positive_5706.yml", "YAML", 0, 0, 0, 2, 0, 0, 1, 3
"d:\IDEWORK\lvmen\src\licensedcode\data\rules\false-positive_5707.yml", "YAML", 0, 0, 0, 2, 0, 0, 1, 3
"d:\IDEWORK\lvmen\src\licensedcode\data\rules\false-positive_5708.yml", "YAML", 0, 0, 0, 2, 0, 0, 1, 3
"d:\IDEWORK\lvmen\src\licensedcode\data\rules\false-positive_5709.yml", "YAML", 0, 0, 0, 2, 0, 0, 1, 3
"d:\IDEWORK\lvmen\src\licensedcode\data\rules\false-positive_571.yml", "YAML", 0, 0, 0, 2, 0, 0, 1, 3
"d:\IDEWORK\lvmen\src\licensedcode\data\rules\false-positive_5710.yml", "YAML", 0, 0, 0, 2, 0, 0, 1, 3
"d:\IDEWORK\lvmen\src\licensedcode\data\rules\false-positive_5711.yml", "YAML", 0, 0, 0, 2, 0, 0, 1, 3
"d:\IDEWORK\lvmen\src\licensedcode\data\rules\false-positive_5712.yml", "YAML", 0, 0, 0, 2, 0, 0, 1, 3
"d:\IDEWORK\lvmen\src\licensedcode\data\rules\false-positive_5713.yml", "YAML", 0, 0, 0, 2, 0, 0, 1, 3
"d:\IDEWORK\lvmen\src\licensedcode\data\rules\false-positive_5714.yml", "YAML", 0, 0, 0, 2, 0, 0, 1, 3
"d:\IDEWORK\lvmen\src\licensedcode\data\rules\false-positive_5715.yml", "YAML", 0, 0, 0, 2, 0, 0, 1, 3
"d:\IDEWORK\lvmen\src\licensedcode\data\rules\false-positive_5716.yml", "YAML", 0, 0, 0, 2, 0, 0, 1, 3
"d:\IDEWORK\lvmen\src\licensedcode\data\rules\false-positive_5717.yml", "YAML", 0, 0, 0, 2, 0, 0, 1, 3
"d:\IDEWORK\lvmen\src\licensedcode\data\rules\false-positive_5718.yml", "YAML", 0, 0, 0, 2, 0, 0, 1, 3
"d:\IDEWORK\lvmen\src\licensedcode\data\rules\false-positive_5719.yml", "YAML", 0, 0, 0, 2, 0, 0, 1, 3
"d:\IDEWORK\lvmen\src\licensedcode\data\rules\false-positive_572.yml", "YAML", 0, 0, 0, 2, 0, 0, 1, 3
"d:\IDEWORK\lvmen\src\licensedcode\data\rules\false-positive_5720.yml", "YAML", 0, 0, 0, 2, 0, 0, 1, 3
"d:\IDEWORK\lvmen\src\licensedcode\data\rules\false-positive_5721.yml", "YAML", 0, 0, 0, 2, 0, 0, 1, 3
"d:\IDEWORK\lvmen\src\licensedcode\data\rules\false-positive_5722.yml", "YAML", 0, 0, 0, 2, 0, 0, 1, 3
"d:\IDEWORK\lvmen\src\licensedcode\data\rules\false-positive_5723.yml", "YAML", 0, 0, 0, 2, 0, 0, 1, 3
"d:\IDEWORK\lvmen\src\licensedcode\data\rules\false-positive_5724.yml", "YAML", 0, 0, 0, 2, 0, 0, 1, 3
"d:\IDEWORK\lvmen\src\licensedcode\data\rules\false-positive_5725.yml", "YAML", 0, 0, 0, 2, 0, 0, 1, 3
"d:\IDEWORK\lvmen\src\licensedcode\data\rules\false-positive_5726.yml", "YAML", 0, 0, 0, 2, 0, 0, 1, 3
"d:\IDEWORK\lvmen\src\licensedcode\data\rules\false-positive_5727.yml", "YAML", 0, 0, 0, 2, 0, 0, 1, 3
"d:\IDEWORK\lvmen\src\licensedcode\data\rules\false-positive_5728.yml", "YAML", 0, 0, 0, 2, 0, 0, 1, 3
"d:\IDEWORK\lvmen\src\licensedcode\data\rules\false-positive_5729.yml", "YAML", 0, 0, 0, 2, 0, 0, 1, 3
"d:\IDEWORK\lvmen\src\licensedcode\data\rules\false-positive_573.yml", "YAML", 0, 0, 0, 2, 0, 0, 1, 3
"d:\IDEWORK\lvmen\src\licensedcode\data\rules\false-positive_5730.yml", "YAML", 0, 0, 0, 2, 0, 0, 1, 3
"d:\IDEWORK\lvmen\src\licensedcode\data\rules\false-positive_5731.yml", "YAML", 0, 0, 0, 2, 0, 0, 1, 3
"d:\IDEWORK\lvmen\src\licensedcode\data\rules\false-positive_5732.yml", "YAML", 0, 0, 0, 2, 0, 0, 1, 3
"d:\IDEWORK\lvmen\src\licensedcode\data\rules\false-positive_5733.yml", "YAML", 0, 0, 0, 2, 0, 0, 1, 3
"d:\IDEWORK\lvmen\src\licensedcode\data\rules\false-positive_5734.yml", "YAML", 0, 0, 0, 2, 0, 0, 1, 3
"d:\IDEWORK\lvmen\src\licensedcode\data\rules\false-positive_5735.yml", "YAML", 0, 0, 0, 2, 0, 0, 1, 3
"d:\IDEWORK\lvmen\src\licensedcode\data\rules\false-positive_5736.yml", "YAML", 0, 0, 0, 2, 0, 0, 1, 3
"d:\IDEWORK\lvmen\src\licensedcode\data\rules\false-positive_5737.yml", "YAML", 0, 0, 0, 2, 0, 0, 1, 3
"d:\IDEWORK\lvmen\src\licensedcode\data\rules\false-positive_5738.yml", "YAML", 0, 0, 0, 2, 0, 0, 1, 3
"d:\IDEWORK\lvmen\src\licensedcode\data\rules\false-positive_5739.yml", "YAML", 0, 0, 0, 2, 0, 0, 1, 3
"d:\IDEWORK\lvmen\src\licensedcode\data\rules\false-positive_574.yml", "YAML", 0, 0, 0, 2, 0, 0, 1, 3
"d:\IDEWORK\lvmen\src\licensedcode\data\rules\false-positive_5740.yml", "YAML", 0, 0, 0, 2, 0, 0, 1, 3
"d:\IDEWORK\lvmen\src\licensedcode\data\rules\false-positive_5741.yml", "YAML", 0, 0, 0, 2, 0, 0, 1, 3
"d:\IDEWORK\lvmen\src\licensedcode\data\rules\false-positive_5742.yml", "YAML", 0, 0, 0, 2, 0, 0, 1, 3
"d:\IDEWORK\lvmen\src\licensedcode\data\rules\false-positive_5743.yml", "YAML", 0, 0, 0, 2, 0, 0, 1, 3
"d:\IDEWORK\lvmen\src\licensedcode\data\rules\false-positive_5744.yml", "YAML", 0, 0, 0, 2, 0, 0, 1, 3
"d:\IDEWORK\lvmen\src\licensedcode\data\rules\false-positive_5745.yml", "YAML", 0, 0, 0, 2, 0, 0, 1, 3
"d:\IDEWORK\lvmen\src\licensedcode\data\rules\false-positive_5746.yml", "YAML", 0, 0, 0, 2, 0, 0, 1, 3
"d:\IDEWORK\lvmen\src\licensedcode\data\rules\false-positive_5747.yml", "YAML", 0, 0, 0, 2, 0, 0, 1, 3
"d:\IDEWORK\lvmen\src\licensedcode\data\rules\false-positive_5748.yml", "YAML", 0, 0, 0, 2, 0, 0, 1, 3
"d:\IDEWORK\lvmen\src\licensedcode\data\rules\false-positive_5749.yml", "YAML", 0, 0, 0, 2, 0, 0, 1, 3
"d:\IDEWORK\lvmen\src\licensedcode\data\rules\false-positive_575.yml", "YAML", 0, 0, 0, 2, 0, 0, 1, 3
"d:\IDEWORK\lvmen\src\licensedcode\data\rules\false-positive_5750.yml", "YAML", 0, 0, 0, 2, 0, 0, 1, 3
"d:\IDEWORK\lvmen\src\licensedcode\data\rules\false-positive_5751.yml", "YAML", 0, 0, 0, 2, 0, 0, 1, 3
"d:\IDEWORK\lvmen\src\licensedcode\data\rules\false-positive_5752.yml", "YAML", 0, 0, 0, 2, 0, 0, 1, 3
"d:\IDEWORK\lvmen\src\licensedcode\data\rules\false-positive_5753.yml", "YAML", 0, 0, 0, 2, 0, 0, 1, 3
"d:\IDEWORK\lvmen\src\licensedcode\data\rules\false-positive_5754.yml", "YAML", 0, 0, 0, 2, 0, 0, 1, 3
"d:\IDEWORK\lvmen\src\licensedcode\data\rules\false-positive_5755.yml", "YAML", 0, 0, 0, 2, 0, 0, 1, 3
"d:\IDEWORK\lvmen\src\licensedcode\data\rules\false-positive_5756.yml", "YAML", 0, 0, 0, 2, 0, 0, 1, 3
"d:\IDEWORK\lvmen\src\licensedcode\data\rules\false-positive_5757.yml", "YAML", 0, 0, 0, 2, 0, 0, 1, 3
"d:\IDEWORK\lvmen\src\licensedcode\data\rules\false-positive_5758.yml", "YAML", 0, 0, 0, 2, 0, 0, 1, 3
"d:\IDEWORK\lvmen\src\licensedcode\data\rules\false-positive_5759.yml", "YAML", 0, 0, 0, 2, 0, 0, 1, 3
"d:\IDEWORK\lvmen\src\licensedcode\data\rules\false-positive_576.yml", "YAML", 0, 0, 0, 2, 0, 0, 1, 3
"d:\IDEWORK\lvmen\src\licensedcode\data\rules\false-positive_5760.yml", "YAML", 0, 0, 0, 2, 0, 0, 1, 3
"d:\IDEWORK\lvmen\src\licensedcode\data\rules\false-positive_5761.yml", "YAML", 0, 0, 0, 2, 0, 0, 1, 3
"d:\IDEWORK\lvmen\src\licensedcode\data\rules\false-positive_5762.yml", "YAML", 0, 0, 0, 2, 0, 0, 1, 3
"d:\IDEWORK\lvmen\src\licensedcode\data\rules\false-positive_5763.yml", "YAML", 0, 0, 0, 2, 0, 0, 1, 3
"d:\IDEWORK\lvmen\src\licensedcode\data\rules\false-positive_5764.yml", "YAML", 0, 0, 0, 2, 0, 0, 1, 3
"d:\IDEWORK\lvmen\src\licensedcode\data\rules\false-positive_5765.yml", "YAML", 0, 0, 0, 2, 0, 0, 1, 3
"d:\IDEWORK\lvmen\src\licensedcode\data\rules\false-positive_5766.yml", "YAML", 0, 0, 0, 2, 0, 0, 1, 3
"d:\IDEWORK\lvmen\src\licensedcode\data\rules\false-positive_5767.yml", "YAML", 0, 0, 0, 2, 0, 0, 1, 3
"d:\IDEWORK\lvmen\src\licensedcode\data\rules\false-positive_5768.yml", "YAML", 0, 0, 0, 2, 0, 0, 1, 3
"d:\IDEWORK\lvmen\src\licensedcode\data\rules\false-positive_5769.yml", "YAML", 0, 0, 0, 2, 0, 0, 1, 3
"d:\IDEWORK\lvmen\src\licensedcode\data\rules\false-positive_577.yml", "YAML", 0, 0, 0, 2, 0, 0, 1, 3
"d:\IDEWORK\lvmen\src\licensedcode\data\rules\false-positive_5770.yml", "YAML", 0, 0, 0, 2, 0, 0, 1, 3
"d:\IDEWORK\lvmen\src\licensedcode\data\rules\false-positive_5771.yml", "YAML", 0, 0, 0, 2, 0, 0, 1, 3
"d:\IDEWORK\lvmen\src\licensedcode\data\rules\false-positive_5772.yml", "YAML", 0, 0, 0, 2, 0, 0, 1, 3
"d:\IDEWORK\lvmen\src\licensedcode\data\rules\false-positive_5773.yml", "YAML", 0, 0, 0, 2, 0, 0, 1, 3
"d:\IDEWORK\lvmen\src\licensedcode\data\rules\false-positive_5774.yml", "YAML", 0, 0, 0, 2, 0, 0, 1, 3
"d:\IDEWORK\lvmen\src\licensedcode\data\rules\false-positive_5775.yml", "YAML", 0, 0, 0, 2, 0, 0, 1, 3
"d:\IDEWORK\lvmen\src\licensedcode\data\rules\false-positive_5776.yml", "YAML", 0, 0, 0, 2, 0, 0, 1, 3
"d:\IDEWORK\lvmen\src\licensedcode\data\rules\false-positive_5777.yml", "YAML", 0, 0, 0, 2, 0, 0, 1, 3
"d:\IDEWORK\lvmen\src\licensedcode\data\rules\false-positive_5778.yml", "YAML", 0, 0, 0, 2, 0, 0, 1, 3
"d:\IDEWORK\lvmen\src\licensedcode\data\rules\false-positive_5779.yml", "YAML", 0, 0, 0, 2, 0, 0, 1, 3
"d:\IDEWORK\lvmen\src\licensedcode\data\rules\false-positive_578.yml", "YAML", 0, 0, 0, 2, 0, 0, 1, 3
"d:\IDEWORK\lvmen\src\licensedcode\data\rules\false-positive_5780.yml", "YAML", 0, 0, 0, 2, 0, 0, 1, 3
"d:\IDEWORK\lvmen\src\licensedcode\data\rules\false-positive_5781.yml", "YAML", 0, 0, 0, 2, 0, 0, 1, 3
"d:\IDEWORK\lvmen\src\licensedcode\data\rules\false-positive_5782.yml", "YAML", 0, 0, 0, 2, 0, 0, 1, 3
"d:\IDEWORK\lvmen\src\licensedcode\data\rules\false-positive_5783.yml", "YAML", 0, 0, 0, 2, 0, 0, 1, 3
"d:\IDEWORK\lvmen\src\licensedcode\data\rules\false-positive_5784.yml", "YAML", 0, 0, 0, 2, 0, 0, 1, 3
"d:\IDEWORK\lvmen\src\licensedcode\data\rules\false-positive_5785.yml", "YAML", 0, 0, 0, 2, 0, 0, 1, 3
"d:\IDEWORK\lvmen\src\licensedcode\data\rules\false-positive_5786.yml", "YAML", 0, 0, 0, 2, 0, 0, 1, 3
"d:\IDEWORK\lvmen\src\licensedcode\data\rules\false-positive_5787.yml", "YAML", 0, 0, 0, 2, 0, 0, 1, 3
"d:\IDEWORK\lvmen\src\licensedcode\data\rules\false-positive_5788.yml", "YAML", 0, 0, 0, 2, 0, 0, 1, 3
"d:\IDEWORK\lvmen\src\licensedcode\data\rules\false-positive_5789.yml", "YAML", 0, 0, 0, 2, 0, 0, 1, 3
"d:\IDEWORK\lvmen\src\licensedcode\data\rules\false-positive_579.yml", "YAML", 0, 0, 0, 2, 0, 0, 1, 3
"d:\IDEWORK\lvmen\src\licensedcode\data\rules\false-positive_5790.yml", "YAML", 0, 0, 0, 2, 0, 0, 1, 3
"d:\IDEWORK\lvmen\src\licensedcode\data\rules\false-positive_5791.yml", "YAML", 0, 0, 0, 2, 0, 0, 1, 3
"d:\IDEWORK\lvmen\src\licensedcode\data\rules\false-positive_5792.yml", "YAML", 0, 0, 0, 2, 0, 0, 1, 3
"d:\IDEWORK\lvmen\src\licensedcode\data\rules\false-positive_5793.yml", "YAML", 0, 0, 0, 2, 0, 0, 1, 3
"d:\IDEWORK\lvmen\src\licensedcode\data\rules\false-positive_5794.yml", "YAML", 0, 0, 0, 2, 0, 0, 1, 3
"d:\IDEWORK\lvmen\src\licensedcode\data\rules\false-positive_5795.yml", "YAML", 0, 0, 0, 2, 0, 0, 1, 3
"d:\IDEWORK\lvmen\src\licensedcode\data\rules\false-positive_5796.yml", "YAML", 0, 0, 0, 2, 0, 0, 1, 3
"d:\IDEWORK\lvmen\src\licensedcode\data\rules\false-positive_5797.yml", "YAML", 0, 0, 0, 2, 0, 0, 1, 3
"d:\IDEWORK\lvmen\src\licensedcode\data\rules\false-positive_5798.yml", "YAML", 0, 0, 0, 2, 0, 0, 1, 3
"d:\IDEWORK\lvmen\src\licensedcode\data\rules\false-positive_5799.yml", "YAML", 0, 0, 0, 2, 0, 0, 1, 3
"d:\IDEWORK\lvmen\src\licensedcode\data\rules\false-positive_58.yml", "YAML", 0, 0, 0, 2, 0, 0, 1, 3
"d:\IDEWORK\lvmen\src\licensedcode\data\rules\false-positive_580.yml", "YAML", 0, 0, 0, 2, 0, 0, 1, 3
"d:\IDEWORK\lvmen\src\licensedcode\data\rules\false-positive_5800.yml", "YAML", 0, 0, 0, 2, 0, 0, 1, 3
"d:\IDEWORK\lvmen\src\licensedcode\data\rules\false-positive_5801.yml", "YAML", 0, 0, 0, 2, 0, 0, 1, 3
"d:\IDEWORK\lvmen\src\licensedcode\data\rules\false-positive_5802.yml", "YAML", 0, 0, 0, 2, 0, 0, 1, 3
"d:\IDEWORK\lvmen\src\licensedcode\data\rules\false-positive_5803.yml", "YAML", 0, 0, 0, 2, 0, 0, 1, 3
"d:\IDEWORK\lvmen\src\licensedcode\data\rules\false-positive_5804.yml", "YAML", 0, 0, 0, 2, 0, 0, 1, 3
"d:\IDEWORK\lvmen\src\licensedcode\data\rules\false-positive_5805.yml", "YAML", 0, 0, 0, 2, 0, 0, 1, 3
"d:\IDEWORK\lvmen\src\licensedcode\data\rules\false-positive_5806.yml", "YAML", 0, 0, 0, 2, 0, 0, 1, 3
"d:\IDEWORK\lvmen\src\licensedcode\data\rules\false-positive_5807.yml", "YAML", 0, 0, 0, 2, 0, 0, 1, 3
"d:\IDEWORK\lvmen\src\licensedcode\data\rules\false-positive_5808.yml", "YAML", 0, 0, 0, 2, 0, 0, 1, 3
"d:\IDEWORK\lvmen\src\licensedcode\data\rules\false-positive_5809.yml", "YAML", 0, 0, 0, 2, 0, 0, 1, 3
"d:\IDEWORK\lvmen\src\licensedcode\data\rules\false-positive_581.yml", "YAML", 0, 0, 0, 2, 0, 0, 1, 3
"d:\IDEWORK\lvmen\src\licensedcode\data\rules\false-positive_5810.yml", "YAML", 0, 0, 0, 2, 0, 0, 1, 3
"d:\IDEWORK\lvmen\src\licensedcode\data\rules\false-positive_5811.yml", "YAML", 0, 0, 0, 2, 0, 0, 1, 3
"d:\IDEWORK\lvmen\src\licensedcode\data\rules\false-positive_5812.yml", "YAML", 0, 0, 0, 2, 0, 0, 1, 3
"d:\IDEWORK\lvmen\src\licensedcode\data\rules\false-positive_5813.yml", "YAML", 0, 0, 0, 2, 0, 0, 1, 3
"d:\IDEWORK\lvmen\src\licensedcode\data\rules\false-positive_5814.yml", "YAML", 0, 0, 0, 2, 0, 0, 1, 3
"d:\IDEWORK\lvmen\src\licensedcode\data\rules\false-positive_5815.yml", "YAML", 0, 0, 0, 2, 0, 0, 1, 3
"d:\IDEWORK\lvmen\src\licensedcode\data\rules\false-positive_5816.yml", "YAML", 0, 0, 0, 2, 0, 0, 1, 3
"d:\IDEWORK\lvmen\src\licensedcode\data\rules\false-positive_5817.yml", "YAML", 0, 0, 0, 2, 0, 0, 1, 3
"d:\IDEWORK\lvmen\src\licensedcode\data\rules\false-positive_5818.yml", "YAML", 0, 0, 0, 2, 0, 0, 1, 3
"d:\IDEWORK\lvmen\src\licensedcode\data\rules\false-positive_5819.yml", "YAML", 0, 0, 0, 2, 0, 0, 1, 3
"d:\IDEWORK\lvmen\src\licensedcode\data\rules\false-positive_582.yml", "YAML", 0, 0, 0, 2, 0, 0, 1, 3
"d:\IDEWORK\lvmen\src\licensedcode\data\rules\false-positive_5820.yml", "YAML", 0, 0, 0, 2, 0, 0, 1, 3
"d:\IDEWORK\lvmen\src\licensedcode\data\rules\false-positive_5821.yml", "YAML", 0, 0, 0, 2, 0, 0, 1, 3
"d:\IDEWORK\lvmen\src\licensedcode\data\rules\false-positive_5822.yml", "YAML", 0, 0, 0, 2, 0, 0, 1, 3
"d:\IDEWORK\lvmen\src\licensedcode\data\rules\false-positive_5823.yml", "YAML", 0, 0, 0, 2, 0, 0, 1, 3
"d:\IDEWORK\lvmen\src\licensedcode\data\rules\false-positive_5824.yml", "YAML", 0, 0, 0, 2, 0, 0, 1, 3
"d:\IDEWORK\lvmen\src\licensedcode\data\rules\false-positive_5825.yml", "YAML", 0, 0, 0, 2, 0, 0, 1, 3
"d:\IDEWORK\lvmen\src\licensedcode\data\rules\false-positive_5826.yml", "YAML", 0, 0, 0, 2, 0, 0, 1, 3
"d:\IDEWORK\lvmen\src\licensedcode\data\rules\false-positive_5827.yml", "YAML", 0, 0, 0, 2, 0, 0, 1, 3
"d:\IDEWORK\lvmen\src\licensedcode\data\rules\false-positive_5828.yml", "YAML", 0, 0, 0, 2, 0, 0, 1, 3
"d:\IDEWORK\lvmen\src\licensedcode\data\rules\false-positive_5829.yml", "YAML", 0, 0, 0, 2, 0, 0, 1, 3
"d:\IDEWORK\lvmen\src\licensedcode\data\rules\false-positive_583.yml", "YAML", 0, 0, 0, 2, 0, 0, 1, 3
"d:\IDEWORK\lvmen\src\licensedcode\data\rules\false-positive_5830.yml", "YAML", 0, 0, 0, 2, 0, 0, 1, 3
"d:\IDEWORK\lvmen\src\licensedcode\data\rules\false-positive_5831.yml", "YAML", 0, 0, 0, 2, 0, 0, 1, 3
"d:\IDEWORK\lvmen\src\licensedcode\data\rules\false-positive_5832.yml", "YAML", 0, 0, 0, 2, 0, 0, 1, 3
"d:\IDEWORK\lvmen\src\licensedcode\data\rules\false-positive_5833.yml", "YAML", 0, 0, 0, 2, 0, 0, 1, 3
"d:\IDEWORK\lvmen\src\licensedcode\data\rules\false-positive_5834.yml", "YAML", 0, 0, 0, 2, 0, 0, 1, 3
"d:\IDEWORK\lvmen\src\licensedcode\data\rules\false-positive_5835.yml", "YAML", 0, 0, 0, 2, 0, 0, 1, 3
"d:\IDEWORK\lvmen\src\licensedcode\data\rules\false-positive_5836.yml", "YAML", 0, 0, 0, 2, 0, 0, 1, 3
"d:\IDEWORK\lvmen\src\licensedcode\data\rules\false-positive_5837.yml", "YAML", 0, 0, 0, 2, 0, 0, 1, 3
"d:\IDEWORK\lvmen\src\licensedcode\data\rules\false-positive_5838.yml", "YAML", 0, 0, 0, 2, 0, 0, 1, 3
"d:\IDEWORK\lvmen\src\licensedcode\data\rules\false-positive_5839.yml", "YAML", 0, 0, 0, 2, 0, 0, 1, 3
"d:\IDEWORK\lvmen\src\licensedcode\data\rules\false-positive_584.yml", "YAML", 0, 0, 0, 2, 0, 0, 1, 3
"d:\IDEWORK\lvmen\src\licensedcode\data\rules\false-positive_5840.yml", "YAML", 0, 0, 0, 2, 0, 0, 1, 3
"d:\IDEWORK\lvmen\src\licensedcode\data\rules\false-positive_5841.yml", "YAML", 0, 0, 0, 2, 0, 0, 1, 3
"d:\IDEWORK\lvmen\src\licensedcode\data\rules\false-positive_5842.yml", "YAML", 0, 0, 0, 2, 0, 0, 1, 3
"d:\IDEWORK\lvmen\src\licensedcode\data\rules\false-positive_5843.yml", "YAML", 0, 0, 0, 2, 0, 0, 1, 3
"d:\IDEWORK\lvmen\src\licensedcode\data\rules\false-positive_5844.yml", "YAML", 0, 0, 0, 2, 0, 0, 1, 3
"d:\IDEWORK\lvmen\src\licensedcode\data\rules\false-positive_5845.yml", "YAML", 0, 0, 0, 2, 0, 0, 1, 3
"d:\IDEWORK\lvmen\src\licensedcode\data\rules\false-positive_5846.yml", "YAML", 0, 0, 0, 2, 0, 0, 1, 3
"d:\IDEWORK\lvmen\src\licensedcode\data\rules\false-positive_5847.yml", "YAML", 0, 0, 0, 2, 0, 0, 1, 3
"d:\IDEWORK\lvmen\src\licensedcode\data\rules\false-positive_5848.yml", "YAML", 0, 0, 0, 2, 0, 0, 1, 3
"d:\IDEWORK\lvmen\src\licensedcode\data\rules\false-positive_5849.yml", "YAML", 0, 0, 0, 2, 0, 0, 1, 3
"d:\IDEWORK\lvmen\src\licensedcode\data\rules\false-positive_585.yml", "YAML", 0, 0, 0, 2, 0, 0, 1, 3
"d:\IDEWORK\lvmen\src\licensedcode\data\rules\false-positive_5850.yml", "YAML", 0, 0, 0, 2, 0, 0, 1, 3
"d:\IDEWORK\lvmen\src\licensedcode\data\rules\false-positive_5851.yml", "YAML", 0, 0, 0, 2, 0, 0, 1, 3
"d:\IDEWORK\lvmen\src\licensedcode\data\rules\false-positive_5852.yml", "YAML", 0, 0, 0, 2, 0, 0, 1, 3
"d:\IDEWORK\lvmen\src\licensedcode\data\rules\false-positive_5853.yml", "YAML", 0, 0, 0, 2, 0, 0, 1, 3
"d:\IDEWORK\lvmen\src\licensedcode\data\rules\false-positive_5854.yml", "YAML", 0, 0, 0, 2, 0, 0, 1, 3
"d:\IDEWORK\lvmen\src\licensedcode\data\rules\false-positive_5855.yml", "YAML", 0, 0, 0, 2, 0, 0, 1, 3
"d:\IDEWORK\lvmen\src\licensedcode\data\rules\false-positive_5856.yml", "YAML", 0, 0, 0, 2, 0, 0, 1, 3
"d:\IDEWORK\lvmen\src\licensedcode\data\rules\false-positive_5857.yml", "YAML", 0, 0, 0, 2, 0, 0, 1, 3
"d:\IDEWORK\lvmen\src\licensedcode\data\rules\false-positive_5858.yml", "YAML", 0, 0, 0, 2, 0, 0, 1, 3
"d:\IDEWORK\lvmen\src\licensedcode\data\rules\false-positive_5859.yml", "YAML", 0, 0, 0, 2, 0, 0, 1, 3
"d:\IDEWORK\lvmen\src\licensedcode\data\rules\false-positive_586.yml", "YAML", 0, 0, 0, 2, 0, 0, 1, 3
"d:\IDEWORK\lvmen\src\licensedcode\data\rules\false-positive_5860.yml", "YAML", 0, 0, 0, 2, 0, 0, 1, 3
"d:\IDEWORK\lvmen\src\licensedcode\data\rules\false-positive_5861.yml", "YAML", 0, 0, 0, 2, 0, 0, 1, 3
"d:\IDEWORK\lvmen\src\licensedcode\data\rules\false-positive_5862.yml", "YAML", 0, 0, 0, 2, 0, 0, 1, 3
"d:\IDEWORK\lvmen\src\licensedcode\data\rules\false-positive_5863.yml", "YAML", 0, 0, 0, 2, 0, 0, 1, 3
"d:\IDEWORK\lvmen\src\licensedcode\data\rules\false-positive_5864.yml", "YAML", 0, 0, 0, 2, 0, 0, 1, 3
"d:\IDEWORK\lvmen\src\licensedcode\data\rules\false-positive_5865.yml", "YAML", 0, 0, 0, 2, 0, 0, 1, 3
"d:\IDEWORK\lvmen\src\licensedcode\data\rules\false-positive_5866.yml", "YAML", 0, 0, 0, 2, 0, 0, 1, 3
"d:\IDEWORK\lvmen\src\licensedcode\data\rules\false-positive_5867.yml", "YAML", 0, 0, 0, 2, 0, 0, 1, 3
"d:\IDEWORK\lvmen\src\licensedcode\data\rules\false-positive_5868.yml", "YAML", 0, 0, 0, 2, 0, 0, 1, 3
"d:\IDEWORK\lvmen\src\licensedcode\data\rules\false-positive_5869.yml", "YAML", 0, 0, 0, 2, 0, 0, 1, 3
"d:\IDEWORK\lvmen\src\licensedcode\data\rules\false-positive_587.yml", "YAML", 0, 0, 0, 2, 0, 0, 1, 3
"d:\IDEWORK\lvmen\src\licensedcode\data\rules\false-positive_5870.yml", "YAML", 0, 0, 0, 2, 0, 0, 1, 3
"d:\IDEWORK\lvmen\src\licensedcode\data\rules\false-positive_5871.yml", "YAML", 0, 0, 0, 2, 0, 0, 1, 3
"d:\IDEWORK\lvmen\src\licensedcode\data\rules\false-positive_5872.yml", "YAML", 0, 0, 0, 2, 0, 0, 1, 3
"d:\IDEWORK\lvmen\src\licensedcode\data\rules\false-positive_5873.yml", "YAML", 0, 0, 0, 2, 0, 0, 1, 3
"d:\IDEWORK\lvmen\src\licensedcode\data\rules\false-positive_5874.yml", "YAML", 0, 0, 0, 2, 0, 0, 1, 3
"d:\IDEWORK\lvmen\src\licensedcode\data\rules\false-positive_5875.yml", "YAML", 0, 0, 0, 2, 0, 0, 1, 3
"d:\IDEWORK\lvmen\src\licensedcode\data\rules\false-positive_5876.yml", "YAML", 0, 0, 0, 2, 0, 0, 1, 3
"d:\IDEWORK\lvmen\src\licensedcode\data\rules\false-positive_5877.yml", "YAML", 0, 0, 0, 2, 0, 0, 1, 3
"d:\IDEWORK\lvmen\src\licensedcode\data\rules\false-positive_5878.yml", "YAML", 0, 0, 0, 2, 0, 0, 1, 3
"d:\IDEWORK\lvmen\src\licensedcode\data\rules\false-positive_5879.yml", "YAML", 0, 0, 0, 2, 0, 0, 1, 3
"d:\IDEWORK\lvmen\src\licensedcode\data\rules\false-positive_588.yml", "YAML", 0, 0, 0, 2, 0, 0, 1, 3
"d:\IDEWORK\lvmen\src\licensedcode\data\rules\false-positive_5880.yml", "YAML", 0, 0, 0, 2, 0, 0, 1, 3
"d:\IDEWORK\lvmen\src\licensedcode\data\rules\false-positive_5881.yml", "YAML", 0, 0, 0, 2, 0, 0, 1, 3
"d:\IDEWORK\lvmen\src\licensedcode\data\rules\false-positive_5882.yml", "YAML", 0, 0, 0, 2, 0, 0, 1, 3
"d:\IDEWORK\lvmen\src\licensedcode\data\rules\false-positive_5883.yml", "YAML", 0, 0, 0, 2, 0, 0, 1, 3
"d:\IDEWORK\lvmen\src\licensedcode\data\rules\false-positive_5884.yml", "YAML", 0, 0, 0, 2, 0, 0, 1, 3
"d:\IDEWORK\lvmen\src\licensedcode\data\rules\false-positive_5885.yml", "YAML", 0, 0, 0, 2, 0, 0, 1, 3
"d:\IDEWORK\lvmen\src\licensedcode\data\rules\false-positive_5886.yml", "YAML", 0, 0, 0, 2, 0, 0, 1, 3
"d:\IDEWORK\lvmen\src\licensedcode\data\rules\false-positive_5887.yml", "YAML", 0, 0, 0, 2, 0, 0, 1, 3
"d:\IDEWORK\lvmen\src\licensedcode\data\rules\false-positive_5888.yml", "YAML", 0, 0, 0, 2, 0, 0, 1, 3
"d:\IDEWORK\lvmen\src\licensedcode\data\rules\false-positive_5889.yml", "YAML", 0, 0, 0, 2, 0, 0, 1, 3
"d:\IDEWORK\lvmen\src\licensedcode\data\rules\false-positive_589.yml", "YAML", 0, 0, 0, 2, 0, 0, 1, 3
"d:\IDEWORK\lvmen\src\licensedcode\data\rules\false-positive_5890.yml", "YAML", 0, 0, 0, 2, 0, 0, 1, 3
"d:\IDEWORK\lvmen\src\licensedcode\data\rules\false-positive_5891.yml", "YAML", 0, 0, 0, 2, 0, 0, 1, 3
"d:\IDEWORK\lvmen\src\licensedcode\data\rules\false-positive_5892.yml", "YAML", 0, 0, 0, 2, 0, 0, 1, 3
"d:\IDEWORK\lvmen\src\licensedcode\data\rules\false-positive_5893.yml", "YAML", 0, 0, 0, 2, 0, 0, 1, 3
"d:\IDEWORK\lvmen\src\licensedcode\data\rules\false-positive_5894.yml", "YAML", 0, 0, 0, 2, 0, 0, 1, 3
"d:\IDEWORK\lvmen\src\licensedcode\data\rules\false-positive_5895.yml", "YAML", 0, 0, 0, 2, 0, 0, 1, 3
"d:\IDEWORK\lvmen\src\licensedcode\data\rules\false-positive_5896.yml", "YAML", 0, 0, 0, 2, 0, 0, 1, 3
"d:\IDEWORK\lvmen\src\licensedcode\data\rules\false-positive_5897.yml", "YAML", 0, 0, 0, 2, 0, 0, 1, 3
"d:\IDEWORK\lvmen\src\licensedcode\data\rules\false-positive_5898.yml", "YAML", 0, 0, 0, 2, 0, 0, 1, 3
"d:\IDEWORK\lvmen\src\licensedcode\data\rules\false-positive_5899.yml", "YAML", 0, 0, 0, 2, 0, 0, 1, 3
"d:\IDEWORK\lvmen\src\licensedcode\data\rules\false-positive_59.yml", "YAML", 0, 0, 0, 2, 0, 0, 1, 3
"d:\IDEWORK\lvmen\src\licensedcode\data\rules\false-positive_590.yml", "YAML", 0, 0, 0, 2, 0, 0, 1, 3
"d:\IDEWORK\lvmen\src\licensedcode\data\rules\false-positive_5900.yml", "YAML", 0, 0, 0, 2, 0, 0, 1, 3
"d:\IDEWORK\lvmen\src\licensedcode\data\rules\false-positive_5901.yml", "YAML", 0, 0, 0, 2, 0, 0, 1, 3
"d:\IDEWORK\lvmen\src\licensedcode\data\rules\false-positive_5902.yml", "YAML", 0, 0, 0, 2, 0, 0, 1, 3
"d:\IDEWORK\lvmen\src\licensedcode\data\rules\false-positive_5903.yml", "YAML", 0, 0, 0, 2, 0, 0, 1, 3
"d:\IDEWORK\lvmen\src\licensedcode\data\rules\false-positive_5904.yml", "YAML", 0, 0, 0, 2, 0, 0, 1, 3
"d:\IDEWORK\lvmen\src\licensedcode\data\rules\false-positive_5905.yml", "YAML", 0, 0, 0, 2, 0, 0, 1, 3
"d:\IDEWORK\lvmen\src\licensedcode\data\rules\false-positive_5906.yml", "YAML", 0, 0, 0, 2, 0, 0, 1, 3
"d:\IDEWORK\lvmen\src\licensedcode\data\rules\false-positive_5907.yml", "YAML", 0, 0, 0, 2, 0, 0, 1, 3
"d:\IDEWORK\lvmen\src\licensedcode\data\rules\false-positive_5908.yml", "YAML", 0, 0, 0, 2, 0, 0, 1, 3
"d:\IDEWORK\lvmen\src\licensedcode\data\rules\false-positive_5909.yml", "YAML", 0, 0, 0, 2, 0, 0, 1, 3
"d:\IDEWORK\lvmen\src\licensedcode\data\rules\false-positive_591.yml", "YAML", 0, 0, 0, 2, 0, 0, 1, 3
"d:\IDEWORK\lvmen\src\licensedcode\data\rules\false-positive_5910.yml", "YAML", 0, 0, 0, 2, 0, 0, 1, 3
"d:\IDEWORK\lvmen\src\licensedcode\data\rules\false-positive_5911.yml", "YAML", 0, 0, 0, 2, 0, 0, 1, 3
"d:\IDEWORK\lvmen\src\licensedcode\data\rules\false-positive_5912.yml", "YAML", 0, 0, 0, 2, 0, 0, 1, 3
"d:\IDEWORK\lvmen\src\licensedcode\data\rules\false-positive_5913.yml", "YAML", 0, 0, 0, 2, 0, 0, 1, 3
"d:\IDEWORK\lvmen\src\licensedcode\data\rules\false-positive_5914.yml", "YAML", 0, 0, 0, 2, 0, 0, 1, 3
"d:\IDEWORK\lvmen\src\licensedcode\data\rules\false-positive_5915.yml", "YAML", 0, 0, 0, 2, 0, 0, 1, 3
"d:\IDEWORK\lvmen\src\licensedcode\data\rules\false-positive_5916.yml", "YAML", 0, 0, 0, 2, 0, 0, 1, 3
"d:\IDEWORK\lvmen\src\licensedcode\data\rules\false-positive_5917.yml", "YAML", 0, 0, 0, 2, 0, 0, 1, 3
"d:\IDEWORK\lvmen\src\licensedcode\data\rules\false-positive_5918.yml", "YAML", 0, 0, 0, 2, 0, 0, 1, 3
"d:\IDEWORK\lvmen\src\licensedcode\data\rules\false-positive_5919.yml", "YAML", 0, 0, 0, 2, 0, 0, 1, 3
"d:\IDEWORK\lvmen\src\licensedcode\data\rules\false-positive_592.yml", "YAML", 0, 0, 0, 2, 0, 0, 1, 3
"d:\IDEWORK\lvmen\src\licensedcode\data\rules\false-positive_5920.yml", "YAML", 0, 0, 0, 2, 0, 0, 1, 3
"d:\IDEWORK\lvmen\src\licensedcode\data\rules\false-positive_5921.yml", "YAML", 0, 0, 0, 2, 0, 0, 1, 3
"d:\IDEWORK\lvmen\src\licensedcode\data\rules\false-positive_5922.yml", "YAML", 0, 0, 0, 2, 0, 0, 1, 3
"d:\IDEWORK\lvmen\src\licensedcode\data\rules\false-positive_5923.yml", "YAML", 0, 0, 0, 2, 0, 0, 1, 3
"d:\IDEWORK\lvmen\src\licensedcode\data\rules\false-positive_5924.yml", "YAML", 0, 0, 0, 2, 0, 0, 1, 3
"d:\IDEWORK\lvmen\src\licensedcode\data\rules\false-positive_5925.yml", "YAML", 0, 0, 0, 2, 0, 0, 1, 3
"d:\IDEWORK\lvmen\src\licensedcode\data\rules\false-positive_5926.yml", "YAML", 0, 0, 0, 2, 0, 0, 1, 3
"d:\IDEWORK\lvmen\src\licensedcode\data\rules\false-positive_5927.yml", "YAML", 0, 0, 0, 2, 0, 0, 1, 3
"d:\IDEWORK\lvmen\src\licensedcode\data\rules\false-positive_5928.yml", "YAML", 0, 0, 0, 2, 0, 0, 1, 3
"d:\IDEWORK\lvmen\src\licensedcode\data\rules\false-positive_5929.yml", "YAML", 0, 0, 0, 2, 0, 0, 1, 3
"d:\IDEWORK\lvmen\src\licensedcode\data\rules\false-positive_593.yml", "YAML", 0, 0, 0, 2, 0, 0, 1, 3
"d:\IDEWORK\lvmen\src\licensedcode\data\rules\false-positive_5930.yml", "YAML", 0, 0, 0, 2, 0, 0, 1, 3
"d:\IDEWORK\lvmen\src\licensedcode\data\rules\false-positive_5931.yml", "YAML", 0, 0, 0, 2, 0, 0, 1, 3
"d:\IDEWORK\lvmen\src\licensedcode\data\rules\false-positive_5932.yml", "YAML", 0, 0, 0, 2, 0, 0, 1, 3
"d:\IDEWORK\lvmen\src\licensedcode\data\rules\false-positive_5933.yml", "YAML", 0, 0, 0, 2, 0, 0, 1, 3
"d:\IDEWORK\lvmen\src\licensedcode\data\rules\false-positive_5934.yml", "YAML", 0, 0, 0, 2, 0, 0, 1, 3
"d:\IDEWORK\lvmen\src\licensedcode\data\rules\false-positive_5935.yml", "YAML", 0, 0, 0, 2, 0, 0, 1, 3
"d:\IDEWORK\lvmen\src\licensedcode\data\rules\false-positive_5936.yml", "YAML", 0, 0, 0, 2, 0, 0, 1, 3
"d:\IDEWORK\lvmen\src\licensedcode\data\rules\false-positive_5937.yml", "YAML", 0, 0, 0, 2, 0, 0, 1, 3
"d:\IDEWORK\lvmen\src\licensedcode\data\rules\false-positive_5938.yml", "YAML", 0, 0, 0, 2, 0, 0, 1, 3
"d:\IDEWORK\lvmen\src\licensedcode\data\rules\false-positive_5939.yml", "YAML", 0, 0, 0, 2, 0, 0, 1, 3
"d:\IDEWORK\lvmen\src\licensedcode\data\rules\false-positive_594.yml", "YAML", 0, 0, 0, 2, 0, 0, 1, 3
"d:\IDEWORK\lvmen\src\licensedcode\data\rules\false-positive_5940.yml", "YAML", 0, 0, 0, 2, 0, 0, 1, 3
"d:\IDEWORK\lvmen\src\licensedcode\data\rules\false-positive_5941.yml", "YAML", 0, 0, 0, 2, 0, 0, 1, 3
"d:\IDEWORK\lvmen\src\licensedcode\data\rules\false-positive_5942.yml", "YAML", 0, 0, 0, 2, 0, 0, 1, 3
"d:\IDEWORK\lvmen\src\licensedcode\data\rules\false-positive_5943.yml", "YAML", 0, 0, 0, 2, 0, 0, 1, 3
"d:\IDEWORK\lvmen\src\licensedcode\data\rules\false-positive_5944.yml", "YAML", 0, 0, 0, 2, 0, 0, 1, 3
"d:\IDEWORK\lvmen\src\licensedcode\data\rules\false-positive_5945.yml", "YAML", 0, 0, 0, 2, 0, 0, 1, 3
"d:\IDEWORK\lvmen\src\licensedcode\data\rules\false-positive_5946.yml", "YAML", 0, 0, 0, 2, 0, 0, 1, 3
"d:\IDEWORK\lvmen\src\licensedcode\data\rules\false-positive_5947.yml", "YAML", 0, 0, 0, 2, 0, 0, 1, 3
"d:\IDEWORK\lvmen\src\licensedcode\data\rules\false-positive_5948.yml", "YAML", 0, 0, 0, 2, 0, 0, 1, 3
"d:\IDEWORK\lvmen\src\licensedcode\data\rules\false-positive_5949.yml", "YAML", 0, 0, 0, 2, 0, 0, 1, 3
"d:\IDEWORK\lvmen\src\licensedcode\data\rules\false-positive_595.yml", "YAML", 0, 0, 0, 2, 0, 0, 1, 3
"d:\IDEWORK\lvmen\src\licensedcode\data\rules\false-positive_5950.yml", "YAML", 0, 0, 0, 2, 0, 0, 1, 3
"d:\IDEWORK\lvmen\src\licensedcode\data\rules\false-positive_5951.yml", "YAML", 0, 0, 0, 2, 0, 0, 1, 3
"d:\IDEWORK\lvmen\src\licensedcode\data\rules\false-positive_5952.yml", "YAML", 0, 0, 0, 2, 0, 0, 1, 3
"d:\IDEWORK\lvmen\src\licensedcode\data\rules\false-positive_5953.yml", "YAML", 0, 0, 0, 2, 0, 0, 1, 3
"d:\IDEWORK\lvmen\src\licensedcode\data\rules\false-positive_5954.yml", "YAML", 0, 0, 0, 2, 0, 0, 1, 3
"d:\IDEWORK\lvmen\src\licensedcode\data\rules\false-positive_5955.yml", "YAML", 0, 0, 0, 2, 0, 0, 1, 3
"d:\IDEWORK\lvmen\src\licensedcode\data\rules\false-positive_5956.yml", "YAML", 0, 0, 0, 2, 0, 0, 1, 3
"d:\IDEWORK\lvmen\src\licensedcode\data\rules\false-positive_5957.yml", "YAML", 0, 0, 0, 2, 0, 0, 1, 3
"d:\IDEWORK\lvmen\src\licensedcode\data\rules\false-positive_5958.yml", "YAML", 0, 0, 0, 2, 0, 0, 1, 3
"d:\IDEWORK\lvmen\src\licensedcode\data\rules\false-positive_5959.yml", "YAML", 0, 0, 0, 2, 0, 0, 1, 3
"d:\IDEWORK\lvmen\src\licensedcode\data\rules\false-positive_596.yml", "YAML", 0, 0, 0, 2, 0, 0, 1, 3
"d:\IDEWORK\lvmen\src\licensedcode\data\rules\false-positive_5960.yml", "YAML", 0, 0, 0, 2, 0, 0, 1, 3
"d:\IDEWORK\lvmen\src\licensedcode\data\rules\false-positive_5961.yml", "YAML", 0, 0, 0, 2, 0, 0, 1, 3
"d:\IDEWORK\lvmen\src\licensedcode\data\rules\false-positive_5962.yml", "YAML", 0, 0, 0, 2, 0, 0, 1, 3
"d:\IDEWORK\lvmen\src\licensedcode\data\rules\false-positive_5963.yml", "YAML", 0, 0, 0, 2, 0, 0, 1, 3
"d:\IDEWORK\lvmen\src\licensedcode\data\rules\false-positive_5964.yml", "YAML", 0, 0, 0, 2, 0, 0, 1, 3
"d:\IDEWORK\lvmen\src\licensedcode\data\rules\false-positive_5965.yml", "YAML", 0, 0, 0, 2, 0, 0, 1, 3
"d:\IDEWORK\lvmen\src\licensedcode\data\rules\false-positive_5966.yml", "YAML", 0, 0, 0, 2, 0, 0, 1, 3
"d:\IDEWORK\lvmen\src\licensedcode\data\rules\false-positive_5967.yml", "YAML", 0, 0, 0, 2, 0, 0, 1, 3
"d:\IDEWORK\lvmen\src\licensedcode\data\rules\false-positive_5968.yml", "YAML", 0, 0, 0, 2, 0, 0, 1, 3
"d:\IDEWORK\lvmen\src\licensedcode\data\rules\false-positive_5969.yml", "YAML", 0, 0, 0, 2, 0, 0, 1, 3
"d:\IDEWORK\lvmen\src\licensedcode\data\rules\false-positive_597.yml", "YAML", 0, 0, 0, 2, 0, 0, 1, 3
"d:\IDEWORK\lvmen\src\licensedcode\data\rules\false-positive_5970.yml", "YAML", 0, 0, 0, 2, 0, 0, 1, 3
"d:\IDEWORK\lvmen\src\licensedcode\data\rules\false-positive_5971.yml", "YAML", 0, 0, 0, 2, 0, 0, 1, 3
"d:\IDEWORK\lvmen\src\licensedcode\data\rules\false-positive_5972.yml", "YAML", 0, 0, 0, 2, 0, 0, 1, 3
"d:\IDEWORK\lvmen\src\licensedcode\data\rules\false-positive_5973.yml", "YAML", 0, 0, 0, 2, 0, 0, 1, 3
"d:\IDEWORK\lvmen\src\licensedcode\data\rules\false-positive_5974.yml", "YAML", 0, 0, 0, 2, 0, 0, 1, 3
"d:\IDEWORK\lvmen\src\licensedcode\data\rules\false-positive_5975.yml", "YAML", 0, 0, 0, 2, 0, 0, 1, 3
"d:\IDEWORK\lvmen\src\licensedcode\data\rules\false-positive_5976.yml", "YAML", 0, 0, 0, 2, 0, 0, 1, 3
"d:\IDEWORK\lvmen\src\licensedcode\data\rules\false-positive_5977.yml", "YAML", 0, 0, 0, 2, 0, 0, 1, 3
"d:\IDEWORK\lvmen\src\licensedcode\data\rules\false-positive_5978.yml", "YAML", 0, 0, 0, 2, 0, 0, 1, 3
"d:\IDEWORK\lvmen\src\licensedcode\data\rules\false-positive_5979.yml", "YAML", 0, 0, 0, 2, 0, 0, 1, 3
"d:\IDEWORK\lvmen\src\licensedcode\data\rules\false-positive_598.yml", "YAML", 0, 0, 0, 2, 0, 0, 1, 3
"d:\IDEWORK\lvmen\src\licensedcode\data\rules\false-positive_5980.yml", "YAML", 0, 0, 0, 2, 0, 0, 1, 3
"d:\IDEWORK\lvmen\src\licensedcode\data\rules\false-positive_5981.yml", "YAML", 0, 0, 0, 2, 0, 0, 1, 3
"d:\IDEWORK\lvmen\src\licensedcode\data\rules\false-positive_5982.yml", "YAML", 0, 0, 0, 2, 0, 0, 1, 3
"d:\IDEWORK\lvmen\src\licensedcode\data\rules\false-positive_5983.yml", "YAML", 0, 0, 0, 2, 0, 0, 1, 3
"d:\IDEWORK\lvmen\src\licensedcode\data\rules\false-positive_5984.yml", "YAML", 0, 0, 0, 2, 0, 0, 1, 3
"d:\IDEWORK\lvmen\src\licensedcode\data\rules\false-positive_5985.yml", "YAML", 0, 0, 0, 2, 0, 0, 1, 3
"d:\IDEWORK\lvmen\src\licensedcode\data\rules\false-positive_5986.yml", "YAML", 0, 0, 0, 2, 0, 0, 1, 3
"d:\IDEWORK\lvmen\src\licensedcode\data\rules\false-positive_5987.yml", "YAML", 0, 0, 0, 2, 0, 0, 1, 3
"d:\IDEWORK\lvmen\src\licensedcode\data\rules\false-positive_5988.yml", "YAML", 0, 0, 0, 2, 0, 0, 1, 3
"d:\IDEWORK\lvmen\src\licensedcode\data\rules\false-positive_5989.yml", "YAML", 0, 0, 0, 2, 0, 0, 1, 3
"d:\IDEWORK\lvmen\src\licensedcode\data\rules\false-positive_599.yml", "YAML", 0, 0, 0, 2, 0, 0, 1, 3
"d:\IDEWORK\lvmen\src\licensedcode\data\rules\false-positive_5990.yml", "YAML", 0, 0, 0, 2, 0, 0, 1, 3
"d:\IDEWORK\lvmen\src\licensedcode\data\rules\false-positive_5991.yml", "YAML", 0, 0, 0, 2, 0, 0, 1, 3
"d:\IDEWORK\lvmen\src\licensedcode\data\rules\false-positive_5992.yml", "YAML", 0, 0, 0, 2, 0, 0, 1, 3
"d:\IDEWORK\lvmen\src\licensedcode\data\rules\false-positive_5993.yml", "YAML", 0, 0, 0, 2, 0, 0, 1, 3
"d:\IDEWORK\lvmen\src\licensedcode\data\rules\false-positive_5994.yml", "YAML", 0, 0, 0, 2, 0, 0, 1, 3
"d:\IDEWORK\lvmen\src\licensedcode\data\rules\false-positive_5995.yml", "YAML", 0, 0, 0, 2, 0, 0, 1, 3
"d:\IDEWORK\lvmen\src\licensedcode\data\rules\false-positive_5996.yml", "YAML", 0, 0, 0, 2, 0, 0, 1, 3
"d:\IDEWORK\lvmen\src\licensedcode\data\rules\false-positive_5997.yml", "YAML", 0, 0, 0, 2, 0, 0, 1, 3
"d:\IDEWORK\lvmen\src\licensedcode\data\rules\false-positive_5998.yml", "YAML", 0, 0, 0, 2, 0, 0, 1, 3
"d:\IDEWORK\lvmen\src\licensedcode\data\rules\false-positive_5999.yml", "YAML", 0, 0, 0, 2, 0, 0, 1, 3
"d:\IDEWORK\lvmen\src\licensedcode\data\rules\false-positive_6.yml", "YAML", 0, 0, 0, 2, 0, 0, 1, 3
"d:\IDEWORK\lvmen\src\licensedcode\data\rules\false-positive_60.yml", "YAML", 0, 0, 0, 2, 0, 0, 1, 3
"d:\IDEWORK\lvmen\src\licensedcode\data\rules\false-positive_600.yml", "YAML", 0, 0, 0, 2, 0, 0, 1, 3
"d:\IDEWORK\lvmen\src\licensedcode\data\rules\false-positive_6000.yml", "YAML", 0, 0, 0, 2, 0, 0, 1, 3
"d:\IDEWORK\lvmen\src\licensedcode\data\rules\false-positive_6001.yml", "YAML", 0, 0, 0, 2, 0, 0, 1, 3
"d:\IDEWORK\lvmen\src\licensedcode\data\rules\false-positive_6002.yml", "YAML", 0, 0, 0, 2, 0, 0, 1, 3
"d:\IDEWORK\lvmen\src\licensedcode\data\rules\false-positive_6003.yml", "YAML", 0, 0, 0, 2, 0, 0, 1, 3
"d:\IDEWORK\lvmen\src\licensedcode\data\rules\false-positive_6004.yml", "YAML", 0, 0, 0, 2, 0, 0, 1, 3
"d:\IDEWORK\lvmen\src\licensedcode\data\rules\false-positive_6005.yml", "YAML", 0, 0, 0, 2, 0, 0, 1, 3
"d:\IDEWORK\lvmen\src\licensedcode\data\rules\false-positive_6006.yml", "YAML", 0, 0, 0, 2, 0, 0, 1, 3
"d:\IDEWORK\lvmen\src\licensedcode\data\rules\false-positive_6007.yml", "YAML", 0, 0, 0, 2, 0, 0, 1, 3
"d:\IDEWORK\lvmen\src\licensedcode\data\rules\false-positive_6008.yml", "YAML", 0, 0, 0, 2, 0, 0, 1, 3
"d:\IDEWORK\lvmen\src\licensedcode\data\rules\false-positive_6009.yml", "YAML", 0, 0, 0, 2, 0, 0, 1, 3
"d:\IDEWORK\lvmen\src\licensedcode\data\rules\false-positive_601.yml", "YAML", 0, 0, 0, 2, 0, 0, 1, 3
"d:\IDEWORK\lvmen\src\licensedcode\data\rules\false-positive_6010.yml", "YAML", 0, 0, 0, 2, 0, 0, 1, 3
"d:\IDEWORK\lvmen\src\licensedcode\data\rules\false-positive_6011.yml", "YAML", 0, 0, 0, 2, 0, 0, 1, 3
"d:\IDEWORK\lvmen\src\licensedcode\data\rules\false-positive_6012.yml", "YAML", 0, 0, 0, 2, 0, 0, 1, 3
"d:\IDEWORK\lvmen\src\licensedcode\data\rules\false-positive_6013.yml", "YAML", 0, 0, 0, 2, 0, 0, 1, 3
"d:\IDEWORK\lvmen\src\licensedcode\data\rules\false-positive_6014.yml", "YAML", 0, 0, 0, 2, 0, 0, 1, 3
"d:\IDEWORK\lvmen\src\licensedcode\data\rules\false-positive_6015.yml", "YAML", 0, 0, 0, 2, 0, 0, 1, 3
"d:\IDEWORK\lvmen\src\licensedcode\data\rules\false-positive_6016.yml", "YAML", 0, 0, 0, 2, 0, 0, 1, 3
"d:\IDEWORK\lvmen\src\licensedcode\data\rules\false-positive_6017.yml", "YAML", 0, 0, 0, 2, 0, 0, 1, 3
"d:\IDEWORK\lvmen\src\licensedcode\data\rules\false-positive_6018.yml", "YAML", 0, 0, 0, 2, 0, 0, 1, 3
"d:\IDEWORK\lvmen\src\licensedcode\data\rules\false-positive_6019.yml", "YAML", 0, 0, 0, 2, 0, 0, 1, 3
"d:\IDEWORK\lvmen\src\licensedcode\data\rules\false-positive_602.yml", "YAML", 0, 0, 0, 2, 0, 0, 1, 3
"d:\IDEWORK\lvmen\src\licensedcode\data\rules\false-positive_6020.yml", "YAML", 0, 0, 0, 2, 0, 0, 1, 3
"d:\IDEWORK\lvmen\src\licensedcode\data\rules\false-positive_6021.yml", "YAML", 0, 0, 0, 2, 0, 0, 1, 3
"d:\IDEWORK\lvmen\src\licensedcode\data\rules\false-positive_6022.yml", "YAML", 0, 0, 0, 2, 0, 0, 1, 3
"d:\IDEWORK\lvmen\src\licensedcode\data\rules\false-positive_6023.yml", "YAML", 0, 0, 0, 2, 0, 0, 1, 3
"d:\IDEWORK\lvmen\src\licensedcode\data\rules\false-positive_6024.yml", "YAML", 0, 0, 0, 2, 0, 0, 1, 3
"d:\IDEWORK\lvmen\src\licensedcode\data\rules\false-positive_6025.yml", "YAML", 0, 0, 0, 2, 0, 0, 1, 3
"d:\IDEWORK\lvmen\src\licensedcode\data\rules\false-positive_6026.yml", "YAML", 0, 0, 0, 2, 0, 0, 1, 3
"d:\IDEWORK\lvmen\src\licensedcode\data\rules\false-positive_6027.yml", "YAML", 0, 0, 0, 2, 0, 0, 1, 3
"d:\IDEWORK\lvmen\src\licensedcode\data\rules\false-positive_6028.yml", "YAML", 0, 0, 0, 2, 0, 0, 1, 3
"d:\IDEWORK\lvmen\src\licensedcode\data\rules\false-positive_6029.yml", "YAML", 0, 0, 0, 2, 0, 0, 1, 3
"d:\IDEWORK\lvmen\src\licensedcode\data\rules\false-positive_603.yml", "YAML", 0, 0, 0, 2, 0, 0, 1, 3
"d:\IDEWORK\lvmen\src\licensedcode\data\rules\false-positive_6030.yml", "YAML", 0, 0, 0, 2, 0, 0, 1, 3
"d:\IDEWORK\lvmen\src\licensedcode\data\rules\false-positive_6031.yml", "YAML", 0, 0, 0, 2, 0, 0, 1, 3
"d:\IDEWORK\lvmen\src\licensedcode\data\rules\false-positive_6032.yml", "YAML", 0, 0, 0, 2, 0, 0, 1, 3
"d:\IDEWORK\lvmen\src\licensedcode\data\rules\false-positive_6033.yml", "YAML", 0, 0, 0, 2, 0, 0, 1, 3
"d:\IDEWORK\lvmen\src\licensedcode\data\rules\false-positive_6034.yml", "YAML", 0, 0, 0, 2, 0, 0, 1, 3
"d:\IDEWORK\lvmen\src\licensedcode\data\rules\false-positive_6035.yml", "YAML", 0, 0, 0, 2, 0, 0, 1, 3
"d:\IDEWORK\lvmen\src\licensedcode\data\rules\false-positive_6036.yml", "YAML", 0, 0, 0, 2, 0, 0, 1, 3
"d:\IDEWORK\lvmen\src\licensedcode\data\rules\false-positive_6037.yml", "YAML", 0, 0, 0, 2, 0, 0, 1, 3
"d:\IDEWORK\lvmen\src\licensedcode\data\rules\false-positive_6038.yml", "YAML", 0, 0, 0, 2, 0, 0, 1, 3
"d:\IDEWORK\lvmen\src\licensedcode\data\rules\false-positive_6039.yml", "YAML", 0, 0, 0, 2, 0, 0, 1, 3
"d:\IDEWORK\lvmen\src\licensedcode\data\rules\false-positive_604.yml", "YAML", 0, 0, 0, 2, 0, 0, 1, 3
"d:\IDEWORK\lvmen\src\licensedcode\data\rules\false-positive_6040.yml", "YAML", 0, 0, 0, 2, 0, 0, 1, 3
"d:\IDEWORK\lvmen\src\licensedcode\data\rules\false-positive_6041.yml", "YAML", 0, 0, 0, 2, 0, 0, 1, 3
"d:\IDEWORK\lvmen\src\licensedcode\data\rules\false-positive_6042.yml", "YAML", 0, 0, 0, 2, 0, 0, 1, 3
"d:\IDEWORK\lvmen\src\licensedcode\data\rules\false-positive_6043.yml", "YAML", 0, 0, 0, 2, 0, 0, 1, 3
"d:\IDEWORK\lvmen\src\licensedcode\data\rules\false-positive_6044.yml", "YAML", 0, 0, 0, 2, 0, 0, 1, 3
"d:\IDEWORK\lvmen\src\licensedcode\data\rules\false-positive_6045.yml", "YAML", 0, 0, 0, 2, 0, 0, 1, 3
"d:\IDEWORK\lvmen\src\licensedcode\data\rules\false-positive_6046.yml", "YAML", 0, 0, 0, 2, 0, 0, 1, 3
"d:\IDEWORK\lvmen\src\licensedcode\data\rules\false-positive_6047.yml", "YAML", 0, 0, 0, 2, 0, 0, 1, 3
"d:\IDEWORK\lvmen\src\licensedcode\data\rules\false-positive_6048.yml", "YAML", 0, 0, 0, 2, 0, 0, 1, 3
"d:\IDEWORK\lvmen\src\licensedcode\data\rules\false-positive_6049.yml", "YAML", 0, 0, 0, 2, 0, 0, 1, 3
"d:\IDEWORK\lvmen\src\licensedcode\data\rules\false-positive_605.yml", "YAML", 0, 0, 0, 2, 0, 0, 1, 3
"d:\IDEWORK\lvmen\src\licensedcode\data\rules\false-positive_6050.yml", "YAML", 0, 0, 0, 2, 0, 0, 1, 3
"d:\IDEWORK\lvmen\src\licensedcode\data\rules\false-positive_6051.yml", "YAML", 0, 0, 0, 2, 0, 0, 1, 3
"d:\IDEWORK\lvmen\src\licensedcode\data\rules\false-positive_6052.yml", "YAML", 0, 0, 0, 2, 0, 0, 1, 3
"d:\IDEWORK\lvmen\src\licensedcode\data\rules\false-positive_6053.yml", "YAML", 0, 0, 0, 2, 0, 0, 1, 3
"d:\IDEWORK\lvmen\src\licensedcode\data\rules\false-positive_6054.yml", "YAML", 0, 0, 0, 2, 0, 0, 1, 3
"d:\IDEWORK\lvmen\src\licensedcode\data\rules\false-positive_6055.yml", "YAML", 0, 0, 0, 2, 0, 0, 1, 3
"d:\IDEWORK\lvmen\src\licensedcode\data\rules\false-positive_6056.yml", "YAML", 0, 0, 0, 2, 0, 0, 1, 3
"d:\IDEWORK\lvmen\src\licensedcode\data\rules\false-positive_6057.yml", "YAML", 0, 0, 0, 2, 0, 0, 1, 3
"d:\IDEWORK\lvmen\src\licensedcode\data\rules\false-positive_6058.yml", "YAML", 0, 0, 0, 2, 0, 0, 1, 3
"d:\IDEWORK\lvmen\src\licensedcode\data\rules\false-positive_6059.yml", "YAML", 0, 0, 0, 2, 0, 0, 1, 3
"d:\IDEWORK\lvmen\src\licensedcode\data\rules\false-positive_606.yml", "YAML", 0, 0, 0, 2, 0, 0, 1, 3
"d:\IDEWORK\lvmen\src\licensedcode\data\rules\false-positive_6060.yml", "YAML", 0, 0, 0, 2, 0, 0, 1, 3
"d:\IDEWORK\lvmen\src\licensedcode\data\rules\false-positive_6061.yml", "YAML", 0, 0, 0, 2, 0, 0, 1, 3
"d:\IDEWORK\lvmen\src\licensedcode\data\rules\false-positive_6062.yml", "YAML", 0, 0, 0, 2, 0, 0, 1, 3
"d:\IDEWORK\lvmen\src\licensedcode\data\rules\false-positive_6063.yml", "YAML", 0, 0, 0, 2, 0, 0, 1, 3
"d:\IDEWORK\lvmen\src\licensedcode\data\rules\false-positive_6064.yml", "YAML", 0, 0, 0, 2, 0, 0, 1, 3
"d:\IDEWORK\lvmen\src\licensedcode\data\rules\false-positive_6065.yml", "YAML", 0, 0, 0, 2, 0, 0, 1, 3
"d:\IDEWORK\lvmen\src\licensedcode\data\rules\false-positive_6066.yml", "YAML", 0, 0, 0, 2, 0, 0, 1, 3
"d:\IDEWORK\lvmen\src\licensedcode\data\rules\false-positive_6067.yml", "YAML", 0, 0, 0, 2, 0, 0, 1, 3
"d:\IDEWORK\lvmen\src\licensedcode\data\rules\false-positive_6068.yml", "YAML", 0, 0, 0, 2, 0, 0, 1, 3
"d:\IDEWORK\lvmen\src\licensedcode\data\rules\false-positive_6069.yml", "YAML", 0, 0, 0, 2, 0, 0, 1, 3
"d:\IDEWORK\lvmen\src\licensedcode\data\rules\false-positive_607.yml", "YAML", 0, 0, 0, 2, 0, 0, 1, 3
"d:\IDEWORK\lvmen\src\licensedcode\data\rules\false-positive_6070.yml", "YAML", 0, 0, 0, 2, 0, 0, 1, 3
"d:\IDEWORK\lvmen\src\licensedcode\data\rules\false-positive_6071.yml", "YAML", 0, 0, 0, 2, 0, 0, 1, 3
"d:\IDEWORK\lvmen\src\licensedcode\data\rules\false-positive_6072.yml", "YAML", 0, 0, 0, 2, 0, 0, 1, 3
"d:\IDEWORK\lvmen\src\licensedcode\data\rules\false-positive_6073.yml", "YAML", 0, 0, 0, 2, 0, 0, 1, 3
"d:\IDEWORK\lvmen\src\licensedcode\data\rules\false-positive_6074.yml", "YAML", 0, 0, 0, 2, 0, 0, 1, 3
"d:\IDEWORK\lvmen\src\licensedcode\data\rules\false-positive_6075.yml", "YAML", 0, 0, 0, 2, 0, 0, 1, 3
"d:\IDEWORK\lvmen\src\licensedcode\data\rules\false-positive_6076.yml", "YAML", 0, 0, 0, 2, 0, 0, 1, 3
"d:\IDEWORK\lvmen\src\licensedcode\data\rules\false-positive_6077.yml", "YAML", 0, 0, 0, 2, 0, 0, 1, 3
"d:\IDEWORK\lvmen\src\licensedcode\data\rules\false-positive_6078.yml", "YAML", 0, 0, 0, 2, 0, 0, 1, 3
"d:\IDEWORK\lvmen\src\licensedcode\data\rules\false-positive_6079.yml", "YAML", 0, 0, 0, 2, 0, 0, 1, 3
"d:\IDEWORK\lvmen\src\licensedcode\data\rules\false-positive_608.yml", "YAML", 0, 0, 0, 2, 0, 0, 1, 3
"d:\IDEWORK\lvmen\src\licensedcode\data\rules\false-positive_6080.yml", "YAML", 0, 0, 0, 2, 0, 0, 1, 3
"d:\IDEWORK\lvmen\src\licensedcode\data\rules\false-positive_6081.yml", "YAML", 0, 0, 0, 2, 0, 0, 1, 3
"d:\IDEWORK\lvmen\src\licensedcode\data\rules\false-positive_6082.yml", "YAML", 0, 0, 0, 2, 0, 0, 1, 3
"d:\IDEWORK\lvmen\src\licensedcode\data\rules\false-positive_6083.yml", "YAML", 0, 0, 0, 2, 0, 0, 1, 3
"d:\IDEWORK\lvmen\src\licensedcode\data\rules\false-positive_6084.yml", "YAML", 0, 0, 0, 2, 0, 0, 1, 3
"d:\IDEWORK\lvmen\src\licensedcode\data\rules\false-positive_6085.yml", "YAML", 0, 0, 0, 2, 0, 0, 1, 3
"d:\IDEWORK\lvmen\src\licensedcode\data\rules\false-positive_6086.yml", "YAML", 0, 0, 0, 2, 0, 0, 1, 3
"d:\IDEWORK\lvmen\src\licensedcode\data\rules\false-positive_6087.yml", "YAML", 0, 0, 0, 2, 0, 0, 1, 3
"d:\IDEWORK\lvmen\src\licensedcode\data\rules\false-positive_6088.yml", "YAML", 0, 0, 0, 2, 0, 0, 1, 3
"d:\IDEWORK\lvmen\src\licensedcode\data\rules\false-positive_6089.yml", "YAML", 0, 0, 0, 2, 0, 0, 1, 3
"d:\IDEWORK\lvmen\src\licensedcode\data\rules\false-positive_609.yml", "YAML", 0, 0, 0, 2, 0, 0, 1, 3
"d:\IDEWORK\lvmen\src\licensedcode\data\rules\false-positive_6090.yml", "YAML", 0, 0, 0, 2, 0, 0, 1, 3
"d:\IDEWORK\lvmen\src\licensedcode\data\rules\false-positive_6091.yml", "YAML", 0, 0, 0, 2, 0, 0, 1, 3
"d:\IDEWORK\lvmen\src\licensedcode\data\rules\false-positive_6092.yml", "YAML", 0, 0, 0, 2, 0, 0, 1, 3
"d:\IDEWORK\lvmen\src\licensedcode\data\rules\false-positive_6093.yml", "YAML", 0, 0, 0, 2, 0, 0, 1, 3
"d:\IDEWORK\lvmen\src\licensedcode\data\rules\false-positive_6094.yml", "YAML", 0, 0, 0, 2, 0, 0, 1, 3
"d:\IDEWORK\lvmen\src\licensedcode\data\rules\false-positive_6095.yml", "YAML", 0, 0, 0, 2, 0, 0, 1, 3
"d:\IDEWORK\lvmen\src\licensedcode\data\rules\false-positive_6096.yml", "YAML", 0, 0, 0, 2, 0, 0, 1, 3
"d:\IDEWORK\lvmen\src\licensedcode\data\rules\false-positive_6097.yml", "YAML", 0, 0, 0, 2, 0, 0, 1, 3
"d:\IDEWORK\lvmen\src\licensedcode\data\rules\false-positive_6098.yml", "YAML", 0, 0, 0, 2, 0, 0, 1, 3
"d:\IDEWORK\lvmen\src\licensedcode\data\rules\false-positive_6099.yml", "YAML", 0, 0, 0, 2, 0, 0, 1, 3
"d:\IDEWORK\lvmen\src\licensedcode\data\rules\false-positive_61.yml", "YAML", 0, 0, 0, 3, 0, 0, 1, 4
"d:\IDEWORK\lvmen\src\licensedcode\data\rules\false-positive_610.yml", "YAML", 0, 0, 0, 2, 0, 0, 1, 3
"d:\IDEWORK\lvmen\src\licensedcode\data\rules\false-positive_6100.yml", "YAML", 0, 0, 0, 2, 0, 0, 1, 3
"d:\IDEWORK\lvmen\src\licensedcode\data\rules\false-positive_6101.yml", "YAML", 0, 0, 0, 2, 0, 0, 1, 3
"d:\IDEWORK\lvmen\src\licensedcode\data\rules\false-positive_6102.yml", "YAML", 0, 0, 0, 2, 0, 0, 1, 3
"d:\IDEWORK\lvmen\src\licensedcode\data\rules\false-positive_6103.yml", "YAML", 0, 0, 0, 2, 0, 0, 1, 3
"d:\IDEWORK\lvmen\src\licensedcode\data\rules\false-positive_6104.yml", "YAML", 0, 0, 0, 2, 0, 0, 1, 3
"d:\IDEWORK\lvmen\src\licensedcode\data\rules\false-positive_6105.yml", "YAML", 0, 0, 0, 2, 0, 0, 1, 3
"d:\IDEWORK\lvmen\src\licensedcode\data\rules\false-positive_6106.yml", "YAML", 0, 0, 0, 2, 0, 0, 1, 3
"d:\IDEWORK\lvmen\src\licensedcode\data\rules\false-positive_6107.yml", "YAML", 0, 0, 0, 2, 0, 0, 1, 3
"d:\IDEWORK\lvmen\src\licensedcode\data\rules\false-positive_6108.yml", "YAML", 0, 0, 0, 2, 0, 0, 1, 3
"d:\IDEWORK\lvmen\src\licensedcode\data\rules\false-positive_6109.yml", "YAML", 0, 0, 0, 2, 0, 0, 1, 3
"d:\IDEWORK\lvmen\src\licensedcode\data\rules\false-positive_611.yml", "YAML", 0, 0, 0, 2, 0, 0, 1, 3
"d:\IDEWORK\lvmen\src\licensedcode\data\rules\false-positive_6110.yml", "YAML", 0, 0, 0, 2, 0, 0, 1, 3
"d:\IDEWORK\lvmen\src\licensedcode\data\rules\false-positive_6111.yml", "YAML", 0, 0, 0, 2, 0, 0, 1, 3
"d:\IDEWORK\lvmen\src\licensedcode\data\rules\false-positive_6112.yml", "YAML", 0, 0, 0, 2, 0, 0, 1, 3
"d:\IDEWORK\lvmen\src\licensedcode\data\rules\false-positive_6113.yml", "YAML", 0, 0, 0, 2, 0, 0, 1, 3
"d:\IDEWORK\lvmen\src\licensedcode\data\rules\false-positive_6114.yml", "YAML", 0, 0, 0, 2, 0, 0, 1, 3
"d:\IDEWORK\lvmen\src\licensedcode\data\rules\false-positive_6115.yml", "YAML", 0, 0, 0, 2, 0, 0, 1, 3
"d:\IDEWORK\lvmen\src\licensedcode\data\rules\false-positive_6116.yml", "YAML", 0, 0, 0, 2, 0, 0, 1, 3
"d:\IDEWORK\lvmen\src\licensedcode\data\rules\false-positive_6117.yml", "YAML", 0, 0, 0, 2, 0, 0, 1, 3
"d:\IDEWORK\lvmen\src\licensedcode\data\rules\false-positive_6118.yml", "YAML", 0, 0, 0, 2, 0, 0, 1, 3
"d:\IDEWORK\lvmen\src\licensedcode\data\rules\false-positive_6119.yml", "YAML", 0, 0, 0, 2, 0, 0, 1, 3
"d:\IDEWORK\lvmen\src\licensedcode\data\rules\false-positive_612.yml", "YAML", 0, 0, 0, 2, 0, 0, 1, 3
"d:\IDEWORK\lvmen\src\licensedcode\data\rules\false-positive_6120.yml", "YAML", 0, 0, 0, 2, 0, 0, 1, 3
"d:\IDEWORK\lvmen\src\licensedcode\data\rules\false-positive_6121.yml", "YAML", 0, 0, 0, 2, 0, 0, 1, 3
"d:\IDEWORK\lvmen\src\licensedcode\data\rules\false-positive_6122.yml", "YAML", 0, 0, 0, 2, 0, 0, 1, 3
"d:\IDEWORK\lvmen\src\licensedcode\data\rules\false-positive_6123.yml", "YAML", 0, 0, 0, 2, 0, 0, 1, 3
"d:\IDEWORK\lvmen\src\licensedcode\data\rules\false-positive_6124.yml", "YAML", 0, 0, 0, 2, 0, 0, 1, 3
"d:\IDEWORK\lvmen\src\licensedcode\data\rules\false-positive_6125.yml", "YAML", 0, 0, 0, 2, 0, 0, 1, 3
"d:\IDEWORK\lvmen\src\licensedcode\data\rules\false-positive_6126.yml", "YAML", 0, 0, 0, 2, 0, 0, 1, 3
"d:\IDEWORK\lvmen\src\licensedcode\data\rules\false-positive_6127.yml", "YAML", 0, 0, 0, 2, 0, 0, 1, 3
"d:\IDEWORK\lvmen\src\licensedcode\data\rules\false-positive_6128.yml", "YAML", 0, 0, 0, 2, 0, 0, 1, 3
"d:\IDEWORK\lvmen\src\licensedcode\data\rules\false-positive_6129.yml", "YAML", 0, 0, 0, 2, 0, 0, 1, 3
"d:\IDEWORK\lvmen\src\licensedcode\data\rules\false-positive_613.yml", "YAML", 0, 0, 0, 2, 0, 0, 1, 3
"d:\IDEWORK\lvmen\src\licensedcode\data\rules\false-positive_6130.yml", "YAML", 0, 0, 0, 2, 0, 0, 1, 3
"d:\IDEWORK\lvmen\src\licensedcode\data\rules\false-positive_6131.yml", "YAML", 0, 0, 0, 2, 0, 0, 1, 3
"d:\IDEWORK\lvmen\src\licensedcode\data\rules\false-positive_6132.yml", "YAML", 0, 0, 0, 2, 0, 0, 1, 3
"d:\IDEWORK\lvmen\src\licensedcode\data\rules\false-positive_6133.yml", "YAML", 0, 0, 0, 2, 0, 0, 1, 3
"d:\IDEWORK\lvmen\src\licensedcode\data\rules\false-positive_6134.yml", "YAML", 0, 0, 0, 2, 0, 0, 1, 3
"d:\IDEWORK\lvmen\src\licensedcode\data\rules\false-positive_6135.yml", "YAML", 0, 0, 0, 2, 0, 0, 1, 3
"d:\IDEWORK\lvmen\src\licensedcode\data\rules\false-positive_6136.yml", "YAML", 0, 0, 0, 2, 0, 0, 1, 3
"d:\IDEWORK\lvmen\src\licensedcode\data\rules\false-positive_6137.yml", "YAML", 0, 0, 0, 2, 0, 0, 1, 3
"d:\IDEWORK\lvmen\src\licensedcode\data\rules\false-positive_6138.yml", "YAML", 0, 0, 0, 2, 0, 0, 1, 3
"d:\IDEWORK\lvmen\src\licensedcode\data\rules\false-positive_6139.yml", "YAML", 0, 0, 0, 2, 0, 0, 1, 3
"d:\IDEWORK\lvmen\src\licensedcode\data\rules\false-positive_614.yml", "YAML", 0, 0, 0, 2, 0, 0, 1, 3
"d:\IDEWORK\lvmen\src\licensedcode\data\rules\false-positive_6140.yml", "YAML", 0, 0, 0, 2, 0, 0, 1, 3
"d:\IDEWORK\lvmen\src\licensedcode\data\rules\false-positive_6141.yml", "YAML", 0, 0, 0, 2, 0, 0, 1, 3
"d:\IDEWORK\lvmen\src\licensedcode\data\rules\false-positive_6142.yml", "YAML", 0, 0, 0, 2, 0, 0, 1, 3
"d:\IDEWORK\lvmen\src\licensedcode\data\rules\false-positive_6143.yml", "YAML", 0, 0, 0, 2, 0, 0, 1, 3
"d:\IDEWORK\lvmen\src\licensedcode\data\rules\false-positive_6144.yml", "YAML", 0, 0, 0, 2, 0, 0, 1, 3
"d:\IDEWORK\lvmen\src\licensedcode\data\rules\false-positive_6145.yml", "YAML", 0, 0, 0, 2, 0, 0, 1, 3
"d:\IDEWORK\lvmen\src\licensedcode\data\rules\false-positive_6146.yml", "YAML", 0, 0, 0, 2, 0, 0, 1, 3
"d:\IDEWORK\lvmen\src\licensedcode\data\rules\false-positive_6147.yml", "YAML", 0, 0, 0, 2, 0, 0, 1, 3
"d:\IDEWORK\lvmen\src\licensedcode\data\rules\false-positive_6148.yml", "YAML", 0, 0, 0, 2, 0, 0, 1, 3
"d:\IDEWORK\lvmen\src\licensedcode\data\rules\false-positive_6149.yml", "YAML", 0, 0, 0, 2, 0, 0, 1, 3
"d:\IDEWORK\lvmen\src\licensedcode\data\rules\false-positive_615.yml", "YAML", 0, 0, 0, 2, 0, 0, 1, 3
"d:\IDEWORK\lvmen\src\licensedcode\data\rules\false-positive_6150.yml", "YAML", 0, 0, 0, 2, 0, 0, 1, 3
"d:\IDEWORK\lvmen\src\licensedcode\data\rules\false-positive_6151.yml", "YAML", 0, 0, 0, 2, 0, 0, 1, 3
"d:\IDEWORK\lvmen\src\licensedcode\data\rules\false-positive_6152.yml", "YAML", 0, 0, 0, 2, 0, 0, 1, 3
"d:\IDEWORK\lvmen\src\licensedcode\data\rules\false-positive_6153.yml", "YAML", 0, 0, 0, 2, 0, 0, 1, 3
"d:\IDEWORK\lvmen\src\licensedcode\data\rules\false-positive_6154.yml", "YAML", 0, 0, 0, 2, 0, 0, 1, 3
"d:\IDEWORK\lvmen\src\licensedcode\data\rules\false-positive_6155.yml", "YAML", 0, 0, 0, 2, 0, 0, 1, 3
"d:\IDEWORK\lvmen\src\licensedcode\data\rules\false-positive_6156.yml", "YAML", 0, 0, 0, 2, 0, 0, 1, 3
"d:\IDEWORK\lvmen\src\licensedcode\data\rules\false-positive_6157.yml", "YAML", 0, 0, 0, 2, 0, 0, 1, 3
"d:\IDEWORK\lvmen\src\licensedcode\data\rules\false-positive_6158.yml", "YAML", 0, 0, 0, 2, 0, 0, 1, 3
"d:\IDEWORK\lvmen\src\licensedcode\data\rules\false-positive_6159.yml", "YAML", 0, 0, 0, 2, 0, 0, 1, 3
"d:\IDEWORK\lvmen\src\licensedcode\data\rules\false-positive_616.yml", "YAML", 0, 0, 0, 2, 0, 0, 1, 3
"d:\IDEWORK\lvmen\src\licensedcode\data\rules\false-positive_6160.yml", "YAML", 0, 0, 0, 2, 0, 0, 1, 3
"d:\IDEWORK\lvmen\src\licensedcode\data\rules\false-positive_6161.yml", "YAML", 0, 0, 0, 2, 0, 0, 1, 3
"d:\IDEWORK\lvmen\src\licensedcode\data\rules\false-positive_6162.yml", "YAML", 0, 0, 0, 2, 0, 0, 1, 3
"d:\IDEWORK\lvmen\src\licensedcode\data\rules\false-positive_6163.yml", "YAML", 0, 0, 0, 2, 0, 0, 1, 3
"d:\IDEWORK\lvmen\src\licensedcode\data\rules\false-positive_6164.yml", "YAML", 0, 0, 0, 2, 0, 0, 1, 3
"d:\IDEWORK\lvmen\src\licensedcode\data\rules\false-positive_6165.yml", "YAML", 0, 0, 0, 2, 0, 0, 1, 3
"d:\IDEWORK\lvmen\src\licensedcode\data\rules\false-positive_6166.yml", "YAML", 0, 0, 0, 2, 0, 0, 1, 3
"d:\IDEWORK\lvmen\src\licensedcode\data\rules\false-positive_6167.yml", "YAML", 0, 0, 0, 2, 0, 0, 1, 3
"d:\IDEWORK\lvmen\src\licensedcode\data\rules\false-positive_6168.yml", "YAML", 0, 0, 0, 2, 0, 0, 1, 3
"d:\IDEWORK\lvmen\src\licensedcode\data\rules\false-positive_6169.yml", "YAML", 0, 0, 0, 2, 0, 0, 1, 3
"d:\IDEWORK\lvmen\src\licensedcode\data\rules\false-positive_617.yml", "YAML", 0, 0, 0, 2, 0, 0, 1, 3
"d:\IDEWORK\lvmen\src\licensedcode\data\rules\false-positive_6170.yml", "YAML", 0, 0, 0, 2, 0, 0, 1, 3
"d:\IDEWORK\lvmen\src\licensedcode\data\rules\false-positive_6171.yml", "YAML", 0, 0, 0, 2, 0, 0, 1, 3
"d:\IDEWORK\lvmen\src\licensedcode\data\rules\false-positive_6172.yml", "YAML", 0, 0, 0, 2, 0, 0, 1, 3
"d:\IDEWORK\lvmen\src\licensedcode\data\rules\false-positive_6173.yml", "YAML", 0, 0, 0, 2, 0, 0, 1, 3
"d:\IDEWORK\lvmen\src\licensedcode\data\rules\false-positive_6174.yml", "YAML", 0, 0, 0, 2, 0, 0, 1, 3
"d:\IDEWORK\lvmen\src\licensedcode\data\rules\false-positive_6175.yml", "YAML", 0, 0, 0, 2, 0, 0, 1, 3
"d:\IDEWORK\lvmen\src\licensedcode\data\rules\false-positive_6176.yml", "YAML", 0, 0, 0, 2, 0, 0, 1, 3
"d:\IDEWORK\lvmen\src\licensedcode\data\rules\false-positive_6177.yml", "YAML", 0, 0, 0, 2, 0, 0, 1, 3
"d:\IDEWORK\lvmen\src\licensedcode\data\rules\false-positive_6178.yml", "YAML", 0, 0, 0, 2, 0, 0, 1, 3
"d:\IDEWORK\lvmen\src\licensedcode\data\rules\false-positive_6179.yml", "YAML", 0, 0, 0, 2, 0, 0, 1, 3
"d:\IDEWORK\lvmen\src\licensedcode\data\rules\false-positive_618.yml", "YAML", 0, 0, 0, 2, 0, 0, 1, 3
"d:\IDEWORK\lvmen\src\licensedcode\data\rules\false-positive_6180.yml", "YAML", 0, 0, 0, 2, 0, 0, 1, 3
"d:\IDEWORK\lvmen\src\licensedcode\data\rules\false-positive_6181.yml", "YAML", 0, 0, 0, 2, 0, 0, 1, 3
"d:\IDEWORK\lvmen\src\licensedcode\data\rules\false-positive_6182.yml", "YAML", 0, 0, 0, 2, 0, 0, 1, 3
"d:\IDEWORK\lvmen\src\licensedcode\data\rules\false-positive_6183.yml", "YAML", 0, 0, 0, 2, 0, 0, 1, 3
"d:\IDEWORK\lvmen\src\licensedcode\data\rules\false-positive_6184.yml", "YAML", 0, 0, 0, 2, 0, 0, 1, 3
"d:\IDEWORK\lvmen\src\licensedcode\data\rules\false-positive_6185.yml", "YAML", 0, 0, 0, 2, 0, 0, 1, 3
"d:\IDEWORK\lvmen\src\licensedcode\data\rules\false-positive_6186.yml", "YAML", 0, 0, 0, 2, 0, 0, 1, 3
"d:\IDEWORK\lvmen\src\licensedcode\data\rules\false-positive_6187.yml", "YAML", 0, 0, 0, 2, 0, 0, 1, 3
"d:\IDEWORK\lvmen\src\licensedcode\data\rules\false-positive_6188.yml", "YAML", 0, 0, 0, 2, 0, 0, 1, 3
"d:\IDEWORK\lvmen\src\licensedcode\data\rules\false-positive_6189.yml", "YAML", 0, 0, 0, 2, 0, 0, 1, 3
"d:\IDEWORK\lvmen\src\licensedcode\data\rules\false-positive_619.yml", "YAML", 0, 0, 0, 2, 0, 0, 1, 3
"d:\IDEWORK\lvmen\src\licensedcode\data\rules\false-positive_6190.yml", "YAML", 0, 0, 0, 2, 0, 0, 1, 3
"d:\IDEWORK\lvmen\src\licensedcode\data\rules\false-positive_6191.yml", "YAML", 0, 0, 0, 2, 0, 0, 1, 3
"d:\IDEWORK\lvmen\src\licensedcode\data\rules\false-positive_6192.yml", "YAML", 0, 0, 0, 2, 0, 0, 1, 3
"d:\IDEWORK\lvmen\src\licensedcode\data\rules\false-positive_6193.yml", "YAML", 0, 0, 0, 2, 0, 0, 1, 3
"d:\IDEWORK\lvmen\src\licensedcode\data\rules\false-positive_6194.yml", "YAML", 0, 0, 0, 2, 0, 0, 1, 3
"d:\IDEWORK\lvmen\src\licensedcode\data\rules\false-positive_6195.yml", "YAML", 0, 0, 0, 2, 0, 0, 1, 3
"d:\IDEWORK\lvmen\src\licensedcode\data\rules\false-positive_6196.yml", "YAML", 0, 0, 0, 2, 0, 0, 1, 3
"d:\IDEWORK\lvmen\src\licensedcode\data\rules\false-positive_6197.yml", "YAML", 0, 0, 0, 2, 0, 0, 1, 3
"d:\IDEWORK\lvmen\src\licensedcode\data\rules\false-positive_6198.yml", "YAML", 0, 0, 0, 2, 0, 0, 1, 3
"d:\IDEWORK\lvmen\src\licensedcode\data\rules\false-positive_6199.yml", "YAML", 0, 0, 0, 2, 0, 0, 1, 3
"d:\IDEWORK\lvmen\src\licensedcode\data\rules\false-positive_62.yml", "YAML", 0, 0, 0, 3, 0, 0, 1, 4
"d:\IDEWORK\lvmen\src\licensedcode\data\rules\false-positive_620.yml", "YAML", 0, 0, 0, 2, 0, 0, 1, 3
"d:\IDEWORK\lvmen\src\licensedcode\data\rules\false-positive_6200.yml", "YAML", 0, 0, 0, 2, 0, 0, 1, 3
"d:\IDEWORK\lvmen\src\licensedcode\data\rules\false-positive_6201.yml", "YAML", 0, 0, 0, 2, 0, 0, 1, 3
"d:\IDEWORK\lvmen\src\licensedcode\data\rules\false-positive_6202.yml", "YAML", 0, 0, 0, 2, 0, 0, 1, 3
"d:\IDEWORK\lvmen\src\licensedcode\data\rules\false-positive_6203.yml", "YAML", 0, 0, 0, 2, 0, 0, 1, 3
"d:\IDEWORK\lvmen\src\licensedcode\data\rules\false-positive_6204.yml", "YAML", 0, 0, 0, 2, 0, 0, 1, 3
"d:\IDEWORK\lvmen\src\licensedcode\data\rules\false-positive_6205.yml", "YAML", 0, 0, 0, 2, 0, 0, 1, 3
"d:\IDEWORK\lvmen\src\licensedcode\data\rules\false-positive_6206.yml", "YAML", 0, 0, 0, 2, 0, 0, 1, 3
"d:\IDEWORK\lvmen\src\licensedcode\data\rules\false-positive_6207.yml", "YAML", 0, 0, 0, 2, 0, 0, 1, 3
"d:\IDEWORK\lvmen\src\licensedcode\data\rules\false-positive_6208.yml", "YAML", 0, 0, 0, 2, 0, 0, 1, 3
"d:\IDEWORK\lvmen\src\licensedcode\data\rules\false-positive_6209.yml", "YAML", 0, 0, 0, 2, 0, 0, 1, 3
"d:\IDEWORK\lvmen\src\licensedcode\data\rules\false-positive_621.yml", "YAML", 0, 0, 0, 2, 0, 0, 1, 3
"d:\IDEWORK\lvmen\src\licensedcode\data\rules\false-positive_6210.yml", "YAML", 0, 0, 0, 2, 0, 0, 1, 3
"d:\IDEWORK\lvmen\src\licensedcode\data\rules\false-positive_6211.yml", "YAML", 0, 0, 0, 2, 0, 0, 1, 3
"d:\IDEWORK\lvmen\src\licensedcode\data\rules\false-positive_6212.yml", "YAML", 0, 0, 0, 2, 0, 0, 1, 3
"d:\IDEWORK\lvmen\src\licensedcode\data\rules\false-positive_6213.yml", "YAML", 0, 0, 0, 2, 0, 0, 1, 3
"d:\IDEWORK\lvmen\src\licensedcode\data\rules\false-positive_6214.yml", "YAML", 0, 0, 0, 2, 0, 0, 1, 3
"d:\IDEWORK\lvmen\src\licensedcode\data\rules\false-positive_6215.yml", "YAML", 0, 0, 0, 2, 0, 0, 1, 3
"d:\IDEWORK\lvmen\src\licensedcode\data\rules\false-positive_6216.yml", "YAML", 0, 0, 0, 2, 0, 0, 1, 3
"d:\IDEWORK\lvmen\src\licensedcode\data\rules\false-positive_6217.yml", "YAML", 0, 0, 0, 2, 0, 0, 1, 3
"d:\IDEWORK\lvmen\src\licensedcode\data\rules\false-positive_6218.yml", "YAML", 0, 0, 0, 2, 0, 0, 1, 3
"d:\IDEWORK\lvmen\src\licensedcode\data\rules\false-positive_6219.yml", "YAML", 0, 0, 0, 2, 0, 0, 1, 3
"d:\IDEWORK\lvmen\src\licensedcode\data\rules\false-positive_622.yml", "YAML", 0, 0, 0, 2, 0, 0, 1, 3
"d:\IDEWORK\lvmen\src\licensedcode\data\rules\false-positive_6220.yml", "YAML", 0, 0, 0, 2, 0, 0, 1, 3
"d:\IDEWORK\lvmen\src\licensedcode\data\rules\false-positive_6221.yml", "YAML", 0, 0, 0, 2, 0, 0, 1, 3
"d:\IDEWORK\lvmen\src\licensedcode\data\rules\false-positive_6222.yml", "YAML", 0, 0, 0, 2, 0, 0, 1, 3
"d:\IDEWORK\lvmen\src\licensedcode\data\rules\false-positive_6223.yml", "YAML", 0, 0, 0, 2, 0, 0, 1, 3
"d:\IDEWORK\lvmen\src\licensedcode\data\rules\false-positive_6224.yml", "YAML", 0, 0, 0, 2, 0, 0, 1, 3
"d:\IDEWORK\lvmen\src\licensedcode\data\rules\false-positive_6225.yml", "YAML", 0, 0, 0, 2, 0, 0, 1, 3
"d:\IDEWORK\lvmen\src\licensedcode\data\rules\false-positive_6226.yml", "YAML", 0, 0, 0, 2, 0, 0, 1, 3
"d:\IDEWORK\lvmen\src\licensedcode\data\rules\false-positive_6227.yml", "YAML", 0, 0, 0, 2, 0, 0, 1, 3
"d:\IDEWORK\lvmen\src\licensedcode\data\rules\false-positive_6228.yml", "YAML", 0, 0, 0, 2, 0, 0, 1, 3
"d:\IDEWORK\lvmen\src\licensedcode\data\rules\false-positive_6229.yml", "YAML", 0, 0, 0, 2, 0, 0, 1, 3
"d:\IDEWORK\lvmen\src\licensedcode\data\rules\false-positive_623.yml", "YAML", 0, 0, 0, 2, 0, 0, 1, 3
"d:\IDEWORK\lvmen\src\licensedcode\data\rules\false-positive_6230.yml", "YAML", 0, 0, 0, 2, 0, 0, 1, 3
"d:\IDEWORK\lvmen\src\licensedcode\data\rules\false-positive_6231.yml", "YAML", 0, 0, 0, 2, 0, 0, 1, 3
"d:\IDEWORK\lvmen\src\licensedcode\data\rules\false-positive_6232.yml", "YAML", 0, 0, 0, 2, 0, 0, 1, 3
"d:\IDEWORK\lvmen\src\licensedcode\data\rules\false-positive_6233.yml", "YAML", 0, 0, 0, 2, 0, 0, 1, 3
"d:\IDEWORK\lvmen\src\licensedcode\data\rules\false-positive_6234.yml", "YAML", 0, 0, 0, 2, 0, 0, 1, 3
"d:\IDEWORK\lvmen\src\licensedcode\data\rules\false-positive_6235.yml", "YAML", 0, 0, 0, 2, 0, 0, 1, 3
"d:\IDEWORK\lvmen\src\licensedcode\data\rules\false-positive_6236.yml", "YAML", 0, 0, 0, 2, 0, 0, 1, 3
"d:\IDEWORK\lvmen\src\licensedcode\data\rules\false-positive_6237.yml", "YAML", 0, 0, 0, 2, 0, 0, 1, 3
"d:\IDEWORK\lvmen\src\licensedcode\data\rules\false-positive_6238.yml", "YAML", 0, 0, 0, 2, 0, 0, 1, 3
"d:\IDEWORK\lvmen\src\licensedcode\data\rules\false-positive_6239.yml", "YAML", 0, 0, 0, 2, 0, 0, 1, 3
"d:\IDEWORK\lvmen\src\licensedcode\data\rules\false-positive_624.yml", "YAML", 0, 0, 0, 2, 0, 0, 1, 3
"d:\IDEWORK\lvmen\src\licensedcode\data\rules\false-positive_6240.yml", "YAML", 0, 0, 0, 2, 0, 0, 1, 3
"d:\IDEWORK\lvmen\src\licensedcode\data\rules\false-positive_6241.yml", "YAML", 0, 0, 0, 2, 0, 0, 1, 3
"d:\IDEWORK\lvmen\src\licensedcode\data\rules\false-positive_6242.yml", "YAML", 0, 0, 0, 2, 0, 0, 1, 3
"d:\IDEWORK\lvmen\src\licensedcode\data\rules\false-positive_6243.yml", "YAML", 0, 0, 0, 2, 0, 0, 1, 3
"d:\IDEWORK\lvmen\src\licensedcode\data\rules\false-positive_6244.yml", "YAML", 0, 0, 0, 2, 0, 0, 1, 3
"d:\IDEWORK\lvmen\src\licensedcode\data\rules\false-positive_6245.yml", "YAML", 0, 0, 0, 2, 0, 0, 1, 3
"d:\IDEWORK\lvmen\src\licensedcode\data\rules\false-positive_6246.yml", "YAML", 0, 0, 0, 2, 0, 0, 1, 3
"d:\IDEWORK\lvmen\src\licensedcode\data\rules\false-positive_6247.yml", "YAML", 0, 0, 0, 2, 0, 0, 1, 3
"d:\IDEWORK\lvmen\src\licensedcode\data\rules\false-positive_6248.yml", "YAML", 0, 0, 0, 2, 0, 0, 1, 3
"d:\IDEWORK\lvmen\src\licensedcode\data\rules\false-positive_6249.yml", "YAML", 0, 0, 0, 2, 0, 0, 1, 3
"d:\IDEWORK\lvmen\src\licensedcode\data\rules\false-positive_625.yml", "YAML", 0, 0, 0, 2, 0, 0, 1, 3
"d:\IDEWORK\lvmen\src\licensedcode\data\rules\false-positive_6250.yml", "YAML", 0, 0, 0, 2, 0, 0, 1, 3
"d:\IDEWORK\lvmen\src\licensedcode\data\rules\false-positive_6251.yml", "YAML", 0, 0, 0, 2, 0, 0, 1, 3
"d:\IDEWORK\lvmen\src\licensedcode\data\rules\false-positive_6252.yml", "YAML", 0, 0, 0, 2, 0, 0, 1, 3
"d:\IDEWORK\lvmen\src\licensedcode\data\rules\false-positive_6253.yml", "YAML", 0, 0, 0, 2, 0, 0, 1, 3
"d:\IDEWORK\lvmen\src\licensedcode\data\rules\false-positive_6254.yml", "YAML", 0, 0, 0, 2, 0, 0, 1, 3
"d:\IDEWORK\lvmen\src\licensedcode\data\rules\false-positive_6255.yml", "YAML", 0, 0, 0, 2, 0, 0, 1, 3
"d:\IDEWORK\lvmen\src\licensedcode\data\rules\false-positive_6256.yml", "YAML", 0, 0, 0, 2, 0, 0, 1, 3
"d:\IDEWORK\lvmen\src\licensedcode\data\rules\false-positive_6257.yml", "YAML", 0, 0, 0, 2, 0, 0, 1, 3
"d:\IDEWORK\lvmen\src\licensedcode\data\rules\false-positive_6258.yml", "YAML", 0, 0, 0, 2, 0, 0, 1, 3
"d:\IDEWORK\lvmen\src\licensedcode\data\rules\false-positive_6259.yml", "YAML", 0, 0, 0, 2, 0, 0, 1, 3
"d:\IDEWORK\lvmen\src\licensedcode\data\rules\false-positive_626.yml", "YAML", 0, 0, 0, 2, 0, 0, 1, 3
"d:\IDEWORK\lvmen\src\licensedcode\data\rules\false-positive_6260.yml", "YAML", 0, 0, 0, 2, 0, 0, 1, 3
"d:\IDEWORK\lvmen\src\licensedcode\data\rules\false-positive_6261.yml", "YAML", 0, 0, 0, 2, 0, 0, 1, 3
"d:\IDEWORK\lvmen\src\licensedcode\data\rules\false-positive_6262.yml", "YAML", 0, 0, 0, 2, 0, 0, 1, 3
"d:\IDEWORK\lvmen\src\licensedcode\data\rules\false-positive_6263.yml", "YAML", 0, 0, 0, 2, 0, 0, 1, 3
"d:\IDEWORK\lvmen\src\licensedcode\data\rules\false-positive_6264.yml", "YAML", 0, 0, 0, 2, 0, 0, 1, 3
"d:\IDEWORK\lvmen\src\licensedcode\data\rules\false-positive_6265.yml", "YAML", 0, 0, 0, 2, 0, 0, 1, 3
"d:\IDEWORK\lvmen\src\licensedcode\data\rules\false-positive_6266.yml", "YAML", 0, 0, 0, 2, 0, 0, 1, 3
"d:\IDEWORK\lvmen\src\licensedcode\data\rules\false-positive_6267.yml", "YAML", 0, 0, 0, 2, 0, 0, 1, 3
"d:\IDEWORK\lvmen\src\licensedcode\data\rules\false-positive_6268.yml", "YAML", 0, 0, 0, 2, 0, 0, 1, 3
"d:\IDEWORK\lvmen\src\licensedcode\data\rules\false-positive_6269.yml", "YAML", 0, 0, 0, 2, 0, 0, 1, 3
"d:\IDEWORK\lvmen\src\licensedcode\data\rules\false-positive_627.yml", "YAML", 0, 0, 0, 2, 0, 0, 1, 3
"d:\IDEWORK\lvmen\src\licensedcode\data\rules\false-positive_6270.yml", "YAML", 0, 0, 0, 2, 0, 0, 1, 3
"d:\IDEWORK\lvmen\src\licensedcode\data\rules\false-positive_6271.yml", "YAML", 0, 0, 0, 2, 0, 0, 1, 3
"d:\IDEWORK\lvmen\src\licensedcode\data\rules\false-positive_6272.yml", "YAML", 0, 0, 0, 2, 0, 0, 1, 3
"d:\IDEWORK\lvmen\src\licensedcode\data\rules\false-positive_6273.yml", "YAML", 0, 0, 0, 2, 0, 0, 1, 3
"d:\IDEWORK\lvmen\src\licensedcode\data\rules\false-positive_6274.yml", "YAML", 0, 0, 0, 2, 0, 0, 1, 3
"d:\IDEWORK\lvmen\src\licensedcode\data\rules\false-positive_6275.yml", "YAML", 0, 0, 0, 2, 0, 0, 1, 3
"d:\IDEWORK\lvmen\src\licensedcode\data\rules\false-positive_6276.yml", "YAML", 0, 0, 0, 2, 0, 0, 1, 3
"d:\IDEWORK\lvmen\src\licensedcode\data\rules\false-positive_6277.yml", "YAML", 0, 0, 0, 2, 0, 0, 1, 3
"d:\IDEWORK\lvmen\src\licensedcode\data\rules\false-positive_6278.yml", "YAML", 0, 0, 0, 2, 0, 0, 1, 3
"d:\IDEWORK\lvmen\src\licensedcode\data\rules\false-positive_6279.yml", "YAML", 0, 0, 0, 2, 0, 0, 1, 3
"d:\IDEWORK\lvmen\src\licensedcode\data\rules\false-positive_628.yml", "YAML", 0, 0, 0, 2, 0, 0, 1, 3
"d:\IDEWORK\lvmen\src\licensedcode\data\rules\false-positive_6280.yml", "YAML", 0, 0, 0, 2, 0, 0, 1, 3
"d:\IDEWORK\lvmen\src\licensedcode\data\rules\false-positive_6281.yml", "YAML", 0, 0, 0, 2, 0, 0, 1, 3
"d:\IDEWORK\lvmen\src\licensedcode\data\rules\false-positive_6282.yml", "YAML", 0, 0, 0, 2, 0, 0, 1, 3
"d:\IDEWORK\lvmen\src\licensedcode\data\rules\false-positive_6283.yml", "YAML", 0, 0, 0, 2, 0, 0, 1, 3
"d:\IDEWORK\lvmen\src\licensedcode\data\rules\false-positive_6284.yml", "YAML", 0, 0, 0, 2, 0, 0, 1, 3
"d:\IDEWORK\lvmen\src\licensedcode\data\rules\false-positive_6285.yml", "YAML", 0, 0, 0, 2, 0, 0, 1, 3
"d:\IDEWORK\lvmen\src\licensedcode\data\rules\false-positive_6286.yml", "YAML", 0, 0, 0, 2, 0, 0, 1, 3
"d:\IDEWORK\lvmen\src\licensedcode\data\rules\false-positive_6287.yml", "YAML", 0, 0, 0, 2, 0, 0, 1, 3
"d:\IDEWORK\lvmen\src\licensedcode\data\rules\false-positive_6288.yml", "YAML", 0, 0, 0, 2, 0, 0, 1, 3
"d:\IDEWORK\lvmen\src\licensedcode\data\rules\false-positive_6289.yml", "YAML", 0, 0, 0, 2, 0, 0, 1, 3
"d:\IDEWORK\lvmen\src\licensedcode\data\rules\false-positive_629.yml", "YAML", 0, 0, 0, 2, 0, 0, 1, 3
"d:\IDEWORK\lvmen\src\licensedcode\data\rules\false-positive_6290.yml", "YAML", 0, 0, 0, 2, 0, 0, 1, 3
"d:\IDEWORK\lvmen\src\licensedcode\data\rules\false-positive_6291.yml", "YAML", 0, 0, 0, 2, 0, 0, 1, 3
"d:\IDEWORK\lvmen\src\licensedcode\data\rules\false-positive_6292.yml", "YAML", 0, 0, 0, 2, 0, 0, 1, 3
"d:\IDEWORK\lvmen\src\licensedcode\data\rules\false-positive_6293.yml", "YAML", 0, 0, 0, 2, 0, 0, 1, 3
"d:\IDEWORK\lvmen\src\licensedcode\data\rules\false-positive_6294.yml", "YAML", 0, 0, 0, 2, 0, 0, 1, 3
"d:\IDEWORK\lvmen\src\licensedcode\data\rules\false-positive_6295.yml", "YAML", 0, 0, 0, 2, 0, 0, 1, 3
"d:\IDEWORK\lvmen\src\licensedcode\data\rules\false-positive_6296.yml", "YAML", 0, 0, 0, 2, 0, 0, 1, 3
"d:\IDEWORK\lvmen\src\licensedcode\data\rules\false-positive_6297.yml", "YAML", 0, 0, 0, 2, 0, 0, 1, 3
"d:\IDEWORK\lvmen\src\licensedcode\data\rules\false-positive_6298.yml", "YAML", 0, 0, 0, 2, 0, 0, 1, 3
"d:\IDEWORK\lvmen\src\licensedcode\data\rules\false-positive_6299.yml", "YAML", 0, 0, 0, 2, 0, 0, 1, 3
"d:\IDEWORK\lvmen\src\licensedcode\data\rules\false-positive_63.yml", "YAML", 0, 0, 0, 2, 0, 0, 1, 3
"d:\IDEWORK\lvmen\src\licensedcode\data\rules\false-positive_630.yml", "YAML", 0, 0, 0, 2, 0, 0, 1, 3
"d:\IDEWORK\lvmen\src\licensedcode\data\rules\false-positive_6300.yml", "YAML", 0, 0, 0, 2, 0, 0, 1, 3
"d:\IDEWORK\lvmen\src\licensedcode\data\rules\false-positive_6301.yml", "YAML", 0, 0, 0, 2, 0, 0, 1, 3
"d:\IDEWORK\lvmen\src\licensedcode\data\rules\false-positive_6302.yml", "YAML", 0, 0, 0, 2, 0, 0, 1, 3
"d:\IDEWORK\lvmen\src\licensedcode\data\rules\false-positive_6303.yml", "YAML", 0, 0, 0, 2, 0, 0, 1, 3
"d:\IDEWORK\lvmen\src\licensedcode\data\rules\false-positive_6304.yml", "YAML", 0, 0, 0, 2, 0, 0, 1, 3
"d:\IDEWORK\lvmen\src\licensedcode\data\rules\false-positive_6305.yml", "YAML", 0, 0, 0, 2, 0, 0, 1, 3
"d:\IDEWORK\lvmen\src\licensedcode\data\rules\false-positive_6306.yml", "YAML", 0, 0, 0, 2, 0, 0, 1, 3
"d:\IDEWORK\lvmen\src\licensedcode\data\rules\false-positive_6307.yml", "YAML", 0, 0, 0, 2, 0, 0, 1, 3
"d:\IDEWORK\lvmen\src\licensedcode\data\rules\false-positive_6308.yml", "YAML", 0, 0, 0, 2, 0, 0, 1, 3
"d:\IDEWORK\lvmen\src\licensedcode\data\rules\false-positive_6309.yml", "YAML", 0, 0, 0, 2, 0, 0, 1, 3
"d:\IDEWORK\lvmen\src\licensedcode\data\rules\false-positive_631.yml", "YAML", 0, 0, 0, 2, 0, 0, 1, 3
"d:\IDEWORK\lvmen\src\licensedcode\data\rules\false-positive_6310.yml", "YAML", 0, 0, 0, 2, 0, 0, 1, 3
"d:\IDEWORK\lvmen\src\licensedcode\data\rules\false-positive_6311.yml", "YAML", 0, 0, 0, 2, 0, 0, 1, 3
"d:\IDEWORK\lvmen\src\licensedcode\data\rules\false-positive_6312.yml", "YAML", 0, 0, 0, 2, 0, 0, 1, 3
"d:\IDEWORK\lvmen\src\licensedcode\data\rules\false-positive_6313.yml", "YAML", 0, 0, 0, 2, 0, 0, 1, 3
"d:\IDEWORK\lvmen\src\licensedcode\data\rules\false-positive_6314.yml", "YAML", 0, 0, 0, 2, 0, 0, 1, 3
"d:\IDEWORK\lvmen\src\licensedcode\data\rules\false-positive_6315.yml", "YAML", 0, 0, 0, 2, 0, 0, 1, 3
"d:\IDEWORK\lvmen\src\licensedcode\data\rules\false-positive_6316.yml", "YAML", 0, 0, 0, 2, 0, 0, 1, 3
"d:\IDEWORK\lvmen\src\licensedcode\data\rules\false-positive_6317.yml", "YAML", 0, 0, 0, 2, 0, 0, 1, 3
"d:\IDEWORK\lvmen\src\licensedcode\data\rules\false-positive_6318.yml", "YAML", 0, 0, 0, 2, 0, 0, 1, 3
"d:\IDEWORK\lvmen\src\licensedcode\data\rules\false-positive_6319.yml", "YAML", 0, 0, 0, 2, 0, 0, 1, 3
"d:\IDEWORK\lvmen\src\licensedcode\data\rules\false-positive_632.yml", "YAML", 0, 0, 0, 2, 0, 0, 1, 3
"d:\IDEWORK\lvmen\src\licensedcode\data\rules\false-positive_6320.yml", "YAML", 0, 0, 0, 2, 0, 0, 1, 3
"d:\IDEWORK\lvmen\src\licensedcode\data\rules\false-positive_6321.yml", "YAML", 0, 0, 0, 2, 0, 0, 1, 3
"d:\IDEWORK\lvmen\src\licensedcode\data\rules\false-positive_6322.yml", "YAML", 0, 0, 0, 2, 0, 0, 1, 3
"d:\IDEWORK\lvmen\src\licensedcode\data\rules\false-positive_6323.yml", "YAML", 0, 0, 0, 2, 0, 0, 1, 3
"d:\IDEWORK\lvmen\src\licensedcode\data\rules\false-positive_6324.yml", "YAML", 0, 0, 0, 2, 0, 0, 1, 3
"d:\IDEWORK\lvmen\src\licensedcode\data\rules\false-positive_6325.yml", "YAML", 0, 0, 0, 2, 0, 0, 1, 3
"d:\IDEWORK\lvmen\src\licensedcode\data\rules\false-positive_6326.yml", "YAML", 0, 0, 0, 2, 0, 0, 1, 3
"d:\IDEWORK\lvmen\src\licensedcode\data\rules\false-positive_6327.yml", "YAML", 0, 0, 0, 2, 0, 0, 1, 3
"d:\IDEWORK\lvmen\src\licensedcode\data\rules\false-positive_6328.yml", "YAML", 0, 0, 0, 2, 0, 0, 1, 3
"d:\IDEWORK\lvmen\src\licensedcode\data\rules\false-positive_6329.yml", "YAML", 0, 0, 0, 2, 0, 0, 1, 3
"d:\IDEWORK\lvmen\src\licensedcode\data\rules\false-positive_633.yml", "YAML", 0, 0, 0, 2, 0, 0, 1, 3
"d:\IDEWORK\lvmen\src\licensedcode\data\rules\false-positive_6330.yml", "YAML", 0, 0, 0, 2, 0, 0, 1, 3
"d:\IDEWORK\lvmen\src\licensedcode\data\rules\false-positive_6331.yml", "YAML", 0, 0, 0, 2, 0, 0, 1, 3
"d:\IDEWORK\lvmen\src\licensedcode\data\rules\false-positive_6332.yml", "YAML", 0, 0, 0, 2, 0, 0, 1, 3
"d:\IDEWORK\lvmen\src\licensedcode\data\rules\false-positive_6333.yml", "YAML", 0, 0, 0, 2, 0, 0, 1, 3
"d:\IDEWORK\lvmen\src\licensedcode\data\rules\false-positive_6334.yml", "YAML", 0, 0, 0, 2, 0, 0, 1, 3
"d:\IDEWORK\lvmen\src\licensedcode\data\rules\false-positive_6335.yml", "YAML", 0, 0, 0, 2, 0, 0, 1, 3
"d:\IDEWORK\lvmen\src\licensedcode\data\rules\false-positive_6336.yml", "YAML", 0, 0, 0, 2, 0, 0, 1, 3
"d:\IDEWORK\lvmen\src\licensedcode\data\rules\false-positive_6337.yml", "YAML", 0, 0, 0, 2, 0, 0, 1, 3
"d:\IDEWORK\lvmen\src\licensedcode\data\rules\false-positive_6338.yml", "YAML", 0, 0, 0, 2, 0, 0, 1, 3
"d:\IDEWORK\lvmen\src\licensedcode\data\rules\false-positive_6339.yml", "YAML", 0, 0, 0, 2, 0, 0, 1, 3
"d:\IDEWORK\lvmen\src\licensedcode\data\rules\false-positive_634.yml", "YAML", 0, 0, 0, 2, 0, 0, 1, 3
"d:\IDEWORK\lvmen\src\licensedcode\data\rules\false-positive_6340.yml", "YAML", 0, 0, 0, 2, 0, 0, 1, 3
"d:\IDEWORK\lvmen\src\licensedcode\data\rules\false-positive_6341.yml", "YAML", 0, 0, 0, 2, 0, 0, 1, 3
"d:\IDEWORK\lvmen\src\licensedcode\data\rules\false-positive_6342.yml", "YAML", 0, 0, 0, 2, 0, 0, 1, 3
"d:\IDEWORK\lvmen\src\licensedcode\data\rules\false-positive_6343.yml", "YAML", 0, 0, 0, 2, 0, 0, 1, 3
"d:\IDEWORK\lvmen\src\licensedcode\data\rules\false-positive_6344.yml", "YAML", 0, 0, 0, 2, 0, 0, 1, 3
"d:\IDEWORK\lvmen\src\licensedcode\data\rules\false-positive_6345.yml", "YAML", 0, 0, 0, 2, 0, 0, 1, 3
"d:\IDEWORK\lvmen\src\licensedcode\data\rules\false-positive_6346.yml", "YAML", 0, 0, 0, 2, 0, 0, 1, 3
"d:\IDEWORK\lvmen\src\licensedcode\data\rules\false-positive_6347.yml", "YAML", 0, 0, 0, 2, 0, 0, 1, 3
"d:\IDEWORK\lvmen\src\licensedcode\data\rules\false-positive_6348.yml", "YAML", 0, 0, 0, 2, 0, 0, 1, 3
"d:\IDEWORK\lvmen\src\licensedcode\data\rules\false-positive_6349.yml", "YAML", 0, 0, 0, 2, 0, 0, 1, 3
"d:\IDEWORK\lvmen\src\licensedcode\data\rules\false-positive_635.yml", "YAML", 0, 0, 0, 2, 0, 0, 1, 3
"d:\IDEWORK\lvmen\src\licensedcode\data\rules\false-positive_6350.yml", "YAML", 0, 0, 0, 2, 0, 0, 1, 3
"d:\IDEWORK\lvmen\src\licensedcode\data\rules\false-positive_6351.yml", "YAML", 0, 0, 0, 2, 0, 0, 1, 3
"d:\IDEWORK\lvmen\src\licensedcode\data\rules\false-positive_6352.yml", "YAML", 0, 0, 0, 2, 0, 0, 1, 3
"d:\IDEWORK\lvmen\src\licensedcode\data\rules\false-positive_6353.yml", "YAML", 0, 0, 0, 2, 0, 0, 1, 3
"d:\IDEWORK\lvmen\src\licensedcode\data\rules\false-positive_6354.yml", "YAML", 0, 0, 0, 2, 0, 0, 1, 3
"d:\IDEWORK\lvmen\src\licensedcode\data\rules\false-positive_6355.yml", "YAML", 0, 0, 0, 2, 0, 0, 1, 3
"d:\IDEWORK\lvmen\src\licensedcode\data\rules\false-positive_6356.yml", "YAML", 0, 0, 0, 2, 0, 0, 1, 3
"d:\IDEWORK\lvmen\src\licensedcode\data\rules\false-positive_6357.yml", "YAML", 0, 0, 0, 2, 0, 0, 1, 3
"d:\IDEWORK\lvmen\src\licensedcode\data\rules\false-positive_6358.yml", "YAML", 0, 0, 0, 2, 0, 0, 1, 3
"d:\IDEWORK\lvmen\src\licensedcode\data\rules\false-positive_6359.yml", "YAML", 0, 0, 0, 2, 0, 0, 1, 3
"d:\IDEWORK\lvmen\src\licensedcode\data\rules\false-positive_636.yml", "YAML", 0, 0, 0, 2, 0, 0, 1, 3
"d:\IDEWORK\lvmen\src\licensedcode\data\rules\false-positive_6360.yml", "YAML", 0, 0, 0, 2, 0, 0, 1, 3
"d:\IDEWORK\lvmen\src\licensedcode\data\rules\false-positive_6361.yml", "YAML", 0, 0, 0, 2, 0, 0, 1, 3
"d:\IDEWORK\lvmen\src\licensedcode\data\rules\false-positive_6362.yml", "YAML", 0, 0, 0, 2, 0, 0, 1, 3
"d:\IDEWORK\lvmen\src\licensedcode\data\rules\false-positive_6363.yml", "YAML", 0, 0, 0, 2, 0, 0, 1, 3
"d:\IDEWORK\lvmen\src\licensedcode\data\rules\false-positive_6364.yml", "YAML", 0, 0, 0, 2, 0, 0, 1, 3
"d:\IDEWORK\lvmen\src\licensedcode\data\rules\false-positive_6365.yml", "YAML", 0, 0, 0, 2, 0, 0, 1, 3
"d:\IDEWORK\lvmen\src\licensedcode\data\rules\false-positive_6366.yml", "YAML", 0, 0, 0, 2, 0, 0, 1, 3
"d:\IDEWORK\lvmen\src\licensedcode\data\rules\false-positive_6367.yml", "YAML", 0, 0, 0, 2, 0, 0, 1, 3
"d:\IDEWORK\lvmen\src\licensedcode\data\rules\false-positive_6368.yml", "YAML", 0, 0, 0, 2, 0, 0, 1, 3
"d:\IDEWORK\lvmen\src\licensedcode\data\rules\false-positive_6369.yml", "YAML", 0, 0, 0, 2, 0, 0, 1, 3
"d:\IDEWORK\lvmen\src\licensedcode\data\rules\false-positive_637.yml", "YAML", 0, 0, 0, 2, 0, 0, 1, 3
"d:\IDEWORK\lvmen\src\licensedcode\data\rules\false-positive_6370.yml", "YAML", 0, 0, 0, 2, 0, 0, 1, 3
"d:\IDEWORK\lvmen\src\licensedcode\data\rules\false-positive_6371.yml", "YAML", 0, 0, 0, 2, 0, 0, 1, 3
"d:\IDEWORK\lvmen\src\licensedcode\data\rules\false-positive_6372.yml", "YAML", 0, 0, 0, 2, 0, 0, 1, 3
"d:\IDEWORK\lvmen\src\licensedcode\data\rules\false-positive_6373.yml", "YAML", 0, 0, 0, 2, 0, 0, 1, 3
"d:\IDEWORK\lvmen\src\licensedcode\data\rules\false-positive_6374.yml", "YAML", 0, 0, 0, 2, 0, 0, 1, 3
"d:\IDEWORK\lvmen\src\licensedcode\data\rules\false-positive_6375.yml", "YAML", 0, 0, 0, 2, 0, 0, 1, 3
"d:\IDEWORK\lvmen\src\licensedcode\data\rules\false-positive_6376.yml", "YAML", 0, 0, 0, 2, 0, 0, 1, 3
"d:\IDEWORK\lvmen\src\licensedcode\data\rules\false-positive_6377.yml", "YAML", 0, 0, 0, 2, 0, 0, 1, 3
"d:\IDEWORK\lvmen\src\licensedcode\data\rules\false-positive_6378.yml", "YAML", 0, 0, 0, 2, 0, 0, 1, 3
"d:\IDEWORK\lvmen\src\licensedcode\data\rules\false-positive_6379.yml", "YAML", 0, 0, 0, 2, 0, 0, 1, 3
"d:\IDEWORK\lvmen\src\licensedcode\data\rules\false-positive_638.yml", "YAML", 0, 0, 0, 2, 0, 0, 1, 3
"d:\IDEWORK\lvmen\src\licensedcode\data\rules\false-positive_6380.yml", "YAML", 0, 0, 0, 2, 0, 0, 1, 3
"d:\IDEWORK\lvmen\src\licensedcode\data\rules\false-positive_6381.yml", "YAML", 0, 0, 0, 2, 0, 0, 1, 3
"d:\IDEWORK\lvmen\src\licensedcode\data\rules\false-positive_6382.yml", "YAML", 0, 0, 0, 2, 0, 0, 1, 3
"d:\IDEWORK\lvmen\src\licensedcode\data\rules\false-positive_6383.yml", "YAML", 0, 0, 0, 2, 0, 0, 1, 3
"d:\IDEWORK\lvmen\src\licensedcode\data\rules\false-positive_6384.yml", "YAML", 0, 0, 0, 2, 0, 0, 1, 3
"d:\IDEWORK\lvmen\src\licensedcode\data\rules\false-positive_6385.yml", "YAML", 0, 0, 0, 2, 0, 0, 1, 3
"d:\IDEWORK\lvmen\src\licensedcode\data\rules\false-positive_6386.yml", "YAML", 0, 0, 0, 2, 0, 0, 1, 3
"d:\IDEWORK\lvmen\src\licensedcode\data\rules\false-positive_6387.yml", "YAML", 0, 0, 0, 2, 0, 0, 1, 3
"d:\IDEWORK\lvmen\src\licensedcode\data\rules\false-positive_6388.yml", "YAML", 0, 0, 0, 2, 0, 0, 1, 3
"d:\IDEWORK\lvmen\src\licensedcode\data\rules\false-positive_6389.yml", "YAML", 0, 0, 0, 2, 0, 0, 1, 3
"d:\IDEWORK\lvmen\src\licensedcode\data\rules\false-positive_639.yml", "YAML", 0, 0, 0, 2, 0, 0, 1, 3
"d:\IDEWORK\lvmen\src\licensedcode\data\rules\false-positive_6390.yml", "YAML", 0, 0, 0, 2, 0, 0, 1, 3
"d:\IDEWORK\lvmen\src\licensedcode\data\rules\false-positive_6391.yml", "YAML", 0, 0, 0, 2, 0, 0, 1, 3
"d:\IDEWORK\lvmen\src\licensedcode\data\rules\false-positive_6392.yml", "YAML", 0, 0, 0, 2, 0, 0, 1, 3
"d:\IDEWORK\lvmen\src\licensedcode\data\rules\false-positive_6393.yml", "YAML", 0, 0, 0, 2, 0, 0, 1, 3
"d:\IDEWORK\lvmen\src\licensedcode\data\rules\false-positive_6394.yml", "YAML", 0, 0, 0, 2, 0, 0, 1, 3
"d:\IDEWORK\lvmen\src\licensedcode\data\rules\false-positive_6395.yml", "YAML", 0, 0, 0, 2, 0, 0, 1, 3
"d:\IDEWORK\lvmen\src\licensedcode\data\rules\false-positive_6396.yml", "YAML", 0, 0, 0, 2, 0, 0, 1, 3
"d:\IDEWORK\lvmen\src\licensedcode\data\rules\false-positive_6397.yml", "YAML", 0, 0, 0, 2, 0, 0, 1, 3
"d:\IDEWORK\lvmen\src\licensedcode\data\rules\false-positive_6398.yml", "YAML", 0, 0, 0, 2, 0, 0, 1, 3
"d:\IDEWORK\lvmen\src\licensedcode\data\rules\false-positive_6399.yml", "YAML", 0, 0, 0, 2, 0, 0, 1, 3
"d:\IDEWORK\lvmen\src\licensedcode\data\rules\false-positive_64.yml", "YAML", 0, 0, 0, 2, 0, 0, 1, 3
"d:\IDEWORK\lvmen\src\licensedcode\data\rules\false-positive_640.yml", "YAML", 0, 0, 0, 2, 0, 0, 1, 3
"d:\IDEWORK\lvmen\src\licensedcode\data\rules\false-positive_6400.yml", "YAML", 0, 0, 0, 2, 0, 0, 1, 3
"d:\IDEWORK\lvmen\src\licensedcode\data\rules\false-positive_6401.yml", "YAML", 0, 0, 0, 2, 0, 0, 1, 3
"d:\IDEWORK\lvmen\src\licensedcode\data\rules\false-positive_6402.yml", "YAML", 0, 0, 0, 2, 0, 0, 1, 3
"d:\IDEWORK\lvmen\src\licensedcode\data\rules\false-positive_6403.yml", "YAML", 0, 0, 0, 2, 0, 0, 1, 3
"d:\IDEWORK\lvmen\src\licensedcode\data\rules\false-positive_6404.yml", "YAML", 0, 0, 0, 2, 0, 0, 1, 3
"d:\IDEWORK\lvmen\src\licensedcode\data\rules\false-positive_6405.yml", "YAML", 0, 0, 0, 2, 0, 0, 1, 3
"d:\IDEWORK\lvmen\src\licensedcode\data\rules\false-positive_6406.yml", "YAML", 0, 0, 0, 2, 0, 0, 1, 3
"d:\IDEWORK\lvmen\src\licensedcode\data\rules\false-positive_6407.yml", "YAML", 0, 0, 0, 2, 0, 0, 1, 3
"d:\IDEWORK\lvmen\src\licensedcode\data\rules\false-positive_6408.yml", "YAML", 0, 0, 0, 2, 0, 0, 1, 3
"d:\IDEWORK\lvmen\src\licensedcode\data\rules\false-positive_6409.yml", "YAML", 0, 0, 0, 2, 0, 0, 1, 3
"d:\IDEWORK\lvmen\src\licensedcode\data\rules\false-positive_641.yml", "YAML", 0, 0, 0, 2, 0, 0, 1, 3
"d:\IDEWORK\lvmen\src\licensedcode\data\rules\false-positive_6410.yml", "YAML", 0, 0, 0, 2, 0, 0, 1, 3
"d:\IDEWORK\lvmen\src\licensedcode\data\rules\false-positive_6411.yml", "YAML", 0, 0, 0, 2, 0, 0, 1, 3
"d:\IDEWORK\lvmen\src\licensedcode\data\rules\false-positive_6412.yml", "YAML", 0, 0, 0, 2, 0, 0, 1, 3
"d:\IDEWORK\lvmen\src\licensedcode\data\rules\false-positive_6413.yml", "YAML", 0, 0, 0, 2, 0, 0, 1, 3
"d:\IDEWORK\lvmen\src\licensedcode\data\rules\false-positive_6414.yml", "YAML", 0, 0, 0, 2, 0, 0, 1, 3
"d:\IDEWORK\lvmen\src\licensedcode\data\rules\false-positive_6415.yml", "YAML", 0, 0, 0, 2, 0, 0, 1, 3
"d:\IDEWORK\lvmen\src\licensedcode\data\rules\false-positive_6416.yml", "YAML", 0, 0, 0, 2, 0, 0, 1, 3
"d:\IDEWORK\lvmen\src\licensedcode\data\rules\false-positive_6417.yml", "YAML", 0, 0, 0, 2, 0, 0, 1, 3
"d:\IDEWORK\lvmen\src\licensedcode\data\rules\false-positive_6418.yml", "YAML", 0, 0, 0, 2, 0, 0, 1, 3
"d:\IDEWORK\lvmen\src\licensedcode\data\rules\false-positive_6419.yml", "YAML", 0, 0, 0, 2, 0, 0, 1, 3
"d:\IDEWORK\lvmen\src\licensedcode\data\rules\false-positive_642.yml", "YAML", 0, 0, 0, 2, 0, 0, 1, 3
"d:\IDEWORK\lvmen\src\licensedcode\data\rules\false-positive_6420.yml", "YAML", 0, 0, 0, 2, 0, 0, 1, 3
"d:\IDEWORK\lvmen\src\licensedcode\data\rules\false-positive_6421.yml", "YAML", 0, 0, 0, 2, 0, 0, 1, 3
"d:\IDEWORK\lvmen\src\licensedcode\data\rules\false-positive_6422.yml", "YAML", 0, 0, 0, 2, 0, 0, 1, 3
"d:\IDEWORK\lvmen\src\licensedcode\data\rules\false-positive_6423.yml", "YAML", 0, 0, 0, 2, 0, 0, 1, 3
"d:\IDEWORK\lvmen\src\licensedcode\data\rules\false-positive_6424.yml", "YAML", 0, 0, 0, 2, 0, 0, 1, 3
"d:\IDEWORK\lvmen\src\licensedcode\data\rules\false-positive_6425.yml", "YAML", 0, 0, 0, 2, 0, 0, 1, 3
"d:\IDEWORK\lvmen\src\licensedcode\data\rules\false-positive_6426.yml", "YAML", 0, 0, 0, 2, 0, 0, 1, 3
"d:\IDEWORK\lvmen\src\licensedcode\data\rules\false-positive_6427.yml", "YAML", 0, 0, 0, 2, 0, 0, 1, 3
"d:\IDEWORK\lvmen\src\licensedcode\data\rules\false-positive_6428.yml", "YAML", 0, 0, 0, 2, 0, 0, 1, 3
"d:\IDEWORK\lvmen\src\licensedcode\data\rules\false-positive_6429.yml", "YAML", 0, 0, 0, 2, 0, 0, 1, 3
"d:\IDEWORK\lvmen\src\licensedcode\data\rules\false-positive_643.yml", "YAML", 0, 0, 0, 2, 0, 0, 1, 3
"d:\IDEWORK\lvmen\src\licensedcode\data\rules\false-positive_6430.yml", "YAML", 0, 0, 0, 2, 0, 0, 1, 3
"d:\IDEWORK\lvmen\src\licensedcode\data\rules\false-positive_6431.yml", "YAML", 0, 0, 0, 2, 0, 0, 1, 3
"d:\IDEWORK\lvmen\src\licensedcode\data\rules\false-positive_6432.yml", "YAML", 0, 0, 0, 2, 0, 0, 1, 3
"d:\IDEWORK\lvmen\src\licensedcode\data\rules\false-positive_6433.yml", "YAML", 0, 0, 0, 2, 0, 0, 1, 3
"d:\IDEWORK\lvmen\src\licensedcode\data\rules\false-positive_6434.yml", "YAML", 0, 0, 0, 2, 0, 0, 1, 3
"d:\IDEWORK\lvmen\src\licensedcode\data\rules\false-positive_6435.yml", "YAML", 0, 0, 0, 2, 0, 0, 1, 3
"d:\IDEWORK\lvmen\src\licensedcode\data\rules\false-positive_6436.yml", "YAML", 0, 0, 0, 2, 0, 0, 1, 3
"d:\IDEWORK\lvmen\src\licensedcode\data\rules\false-positive_6437.yml", "YAML", 0, 0, 0, 2, 0, 0, 1, 3
"d:\IDEWORK\lvmen\src\licensedcode\data\rules\false-positive_6438.yml", "YAML", 0, 0, 0, 2, 0, 0, 1, 3
"d:\IDEWORK\lvmen\src\licensedcode\data\rules\false-positive_6439.yml", "YAML", 0, 0, 0, 2, 0, 0, 1, 3
"d:\IDEWORK\lvmen\src\licensedcode\data\rules\false-positive_644.yml", "YAML", 0, 0, 0, 2, 0, 0, 1, 3
"d:\IDEWORK\lvmen\src\licensedcode\data\rules\false-positive_6440.yml", "YAML", 0, 0, 0, 2, 0, 0, 1, 3
"d:\IDEWORK\lvmen\src\licensedcode\data\rules\false-positive_6441.yml", "YAML", 0, 0, 0, 2, 0, 0, 1, 3
"d:\IDEWORK\lvmen\src\licensedcode\data\rules\false-positive_6442.yml", "YAML", 0, 0, 0, 2, 0, 0, 1, 3
"d:\IDEWORK\lvmen\src\licensedcode\data\rules\false-positive_6443.yml", "YAML", 0, 0, 0, 2, 0, 0, 1, 3
"d:\IDEWORK\lvmen\src\licensedcode\data\rules\false-positive_6444.yml", "YAML", 0, 0, 0, 2, 0, 0, 1, 3
"d:\IDEWORK\lvmen\src\licensedcode\data\rules\false-positive_6445.yml", "YAML", 0, 0, 0, 2, 0, 0, 1, 3
"d:\IDEWORK\lvmen\src\licensedcode\data\rules\false-positive_6446.yml", "YAML", 0, 0, 0, 2, 0, 0, 1, 3
"d:\IDEWORK\lvmen\src\licensedcode\data\rules\false-positive_6447.yml", "YAML", 0, 0, 0, 2, 0, 0, 1, 3
"d:\IDEWORK\lvmen\src\licensedcode\data\rules\false-positive_6448.yml", "YAML", 0, 0, 0, 2, 0, 0, 1, 3
"d:\IDEWORK\lvmen\src\licensedcode\data\rules\false-positive_6449.yml", "YAML", 0, 0, 0, 2, 0, 0, 1, 3
"d:\IDEWORK\lvmen\src\licensedcode\data\rules\false-positive_645.yml", "YAML", 0, 0, 0, 2, 0, 0, 1, 3
"d:\IDEWORK\lvmen\src\licensedcode\data\rules\false-positive_6450.yml", "YAML", 0, 0, 0, 2, 0, 0, 1, 3
"d:\IDEWORK\lvmen\src\licensedcode\data\rules\false-positive_6451.yml", "YAML", 0, 0, 0, 2, 0, 0, 1, 3
"d:\IDEWORK\lvmen\src\licensedcode\data\rules\false-positive_6452.yml", "YAML", 0, 0, 0, 2, 0, 0, 1, 3
"d:\IDEWORK\lvmen\src\licensedcode\data\rules\false-positive_6453.yml", "YAML", 0, 0, 0, 2, 0, 0, 1, 3
"d:\IDEWORK\lvmen\src\licensedcode\data\rules\false-positive_6454.yml", "YAML", 0, 0, 0, 2, 0, 0, 1, 3
"d:\IDEWORK\lvmen\src\licensedcode\data\rules\false-positive_6455.yml", "YAML", 0, 0, 0, 2, 0, 0, 1, 3
"d:\IDEWORK\lvmen\src\licensedcode\data\rules\false-positive_6456.yml", "YAML", 0, 0, 0, 2, 0, 0, 1, 3
"d:\IDEWORK\lvmen\src\licensedcode\data\rules\false-positive_6457.yml", "YAML", 0, 0, 0, 2, 0, 0, 1, 3
"d:\IDEWORK\lvmen\src\licensedcode\data\rules\false-positive_6458.yml", "YAML", 0, 0, 0, 2, 0, 0, 1, 3
"d:\IDEWORK\lvmen\src\licensedcode\data\rules\false-positive_6459.yml", "YAML", 0, 0, 0, 2, 0, 0, 1, 3
"d:\IDEWORK\lvmen\src\licensedcode\data\rules\false-positive_646.yml", "YAML", 0, 0, 0, 2, 0, 0, 1, 3
"d:\IDEWORK\lvmen\src\licensedcode\data\rules\false-positive_6460.yml", "YAML", 0, 0, 0, 2, 0, 0, 1, 3
"d:\IDEWORK\lvmen\src\licensedcode\data\rules\false-positive_6461.yml", "YAML", 0, 0, 0, 2, 0, 0, 1, 3
"d:\IDEWORK\lvmen\src\licensedcode\data\rules\false-positive_6462.yml", "YAML", 0, 0, 0, 2, 0, 0, 1, 3
"d:\IDEWORK\lvmen\src\licensedcode\data\rules\false-positive_6463.yml", "YAML", 0, 0, 0, 2, 0, 0, 1, 3
"d:\IDEWORK\lvmen\src\licensedcode\data\rules\false-positive_6464.yml", "YAML", 0, 0, 0, 2, 0, 0, 1, 3
"d:\IDEWORK\lvmen\src\licensedcode\data\rules\false-positive_6465.yml", "YAML", 0, 0, 0, 2, 0, 0, 1, 3
"d:\IDEWORK\lvmen\src\licensedcode\data\rules\false-positive_6466.yml", "YAML", 0, 0, 0, 2, 0, 0, 1, 3
"d:\IDEWORK\lvmen\src\licensedcode\data\rules\false-positive_6467.yml", "YAML", 0, 0, 0, 2, 0, 0, 1, 3
"d:\IDEWORK\lvmen\src\licensedcode\data\rules\false-positive_6468.yml", "YAML", 0, 0, 0, 2, 0, 0, 1, 3
"d:\IDEWORK\lvmen\src\licensedcode\data\rules\false-positive_6469.yml", "YAML", 0, 0, 0, 2, 0, 0, 1, 3
"d:\IDEWORK\lvmen\src\licensedcode\data\rules\false-positive_647.yml", "YAML", 0, 0, 0, 2, 0, 0, 1, 3
"d:\IDEWORK\lvmen\src\licensedcode\data\rules\false-positive_6470.yml", "YAML", 0, 0, 0, 2, 0, 0, 1, 3
"d:\IDEWORK\lvmen\src\licensedcode\data\rules\false-positive_6471.yml", "YAML", 0, 0, 0, 2, 0, 0, 1, 3
"d:\IDEWORK\lvmen\src\licensedcode\data\rules\false-positive_6472.yml", "YAML", 0, 0, 0, 2, 0, 0, 1, 3
"d:\IDEWORK\lvmen\src\licensedcode\data\rules\false-positive_6473.yml", "YAML", 0, 0, 0, 2, 0, 0, 1, 3
"d:\IDEWORK\lvmen\src\licensedcode\data\rules\false-positive_6474.yml", "YAML", 0, 0, 0, 2, 0, 0, 1, 3
"d:\IDEWORK\lvmen\src\licensedcode\data\rules\false-positive_6475.yml", "YAML", 0, 0, 0, 2, 0, 0, 1, 3
"d:\IDEWORK\lvmen\src\licensedcode\data\rules\false-positive_6476.yml", "YAML", 0, 0, 0, 2, 0, 0, 1, 3
"d:\IDEWORK\lvmen\src\licensedcode\data\rules\false-positive_6477.yml", "YAML", 0, 0, 0, 2, 0, 0, 1, 3
"d:\IDEWORK\lvmen\src\licensedcode\data\rules\false-positive_6478.yml", "YAML", 0, 0, 0, 2, 0, 0, 1, 3
"d:\IDEWORK\lvmen\src\licensedcode\data\rules\false-positive_6479.yml", "YAML", 0, 0, 0, 2, 0, 0, 1, 3
"d:\IDEWORK\lvmen\src\licensedcode\data\rules\false-positive_648.yml", "YAML", 0, 0, 0, 2, 0, 0, 1, 3
"d:\IDEWORK\lvmen\src\licensedcode\data\rules\false-positive_6480.yml", "YAML", 0, 0, 0, 2, 0, 0, 1, 3
"d:\IDEWORK\lvmen\src\licensedcode\data\rules\false-positive_6481.yml", "YAML", 0, 0, 0, 2, 0, 0, 1, 3
"d:\IDEWORK\lvmen\src\licensedcode\data\rules\false-positive_6482.yml", "YAML", 0, 0, 0, 2, 0, 0, 1, 3
"d:\IDEWORK\lvmen\src\licensedcode\data\rules\false-positive_6483.yml", "YAML", 0, 0, 0, 2, 0, 0, 1, 3
"d:\IDEWORK\lvmen\src\licensedcode\data\rules\false-positive_6484.yml", "YAML", 0, 0, 0, 2, 0, 0, 1, 3
"d:\IDEWORK\lvmen\src\licensedcode\data\rules\false-positive_6485.yml", "YAML", 0, 0, 0, 2, 0, 0, 1, 3
"d:\IDEWORK\lvmen\src\licensedcode\data\rules\false-positive_6486.yml", "YAML", 0, 0, 0, 2, 0, 0, 1, 3
"d:\IDEWORK\lvmen\src\licensedcode\data\rules\false-positive_6487.yml", "YAML", 0, 0, 0, 2, 0, 0, 1, 3
"d:\IDEWORK\lvmen\src\licensedcode\data\rules\false-positive_6488.yml", "YAML", 0, 0, 0, 2, 0, 0, 1, 3
"d:\IDEWORK\lvmen\src\licensedcode\data\rules\false-positive_6489.yml", "YAML", 0, 0, 0, 2, 0, 0, 1, 3
"d:\IDEWORK\lvmen\src\licensedcode\data\rules\false-positive_649.yml", "YAML", 0, 0, 0, 2, 0, 0, 1, 3
"d:\IDEWORK\lvmen\src\licensedcode\data\rules\false-positive_6490.yml", "YAML", 0, 0, 0, 2, 0, 0, 1, 3
"d:\IDEWORK\lvmen\src\licensedcode\data\rules\false-positive_6491.yml", "YAML", 0, 0, 0, 2, 0, 0, 1, 3
"d:\IDEWORK\lvmen\src\licensedcode\data\rules\false-positive_6492.yml", "YAML", 0, 0, 0, 2, 0, 0, 1, 3
"d:\IDEWORK\lvmen\src\licensedcode\data\rules\false-positive_6493.yml", "YAML", 0, 0, 0, 2, 0, 0, 1, 3
"d:\IDEWORK\lvmen\src\licensedcode\data\rules\false-positive_6494.yml", "YAML", 0, 0, 0, 2, 0, 0, 1, 3
"d:\IDEWORK\lvmen\src\licensedcode\data\rules\false-positive_6495.yml", "YAML", 0, 0, 0, 2, 0, 0, 1, 3
"d:\IDEWORK\lvmen\src\licensedcode\data\rules\false-positive_6496.yml", "YAML", 0, 0, 0, 2, 0, 0, 1, 3
"d:\IDEWORK\lvmen\src\licensedcode\data\rules\false-positive_6497.yml", "YAML", 0, 0, 0, 2, 0, 0, 1, 3
"d:\IDEWORK\lvmen\src\licensedcode\data\rules\false-positive_6498.yml", "YAML", 0, 0, 0, 2, 0, 0, 1, 3
"d:\IDEWORK\lvmen\src\licensedcode\data\rules\false-positive_6499.yml", "YAML", 0, 0, 0, 2, 0, 0, 1, 3
"d:\IDEWORK\lvmen\src\licensedcode\data\rules\false-positive_65.yml", "YAML", 0, 0, 0, 2, 0, 0, 1, 3
"d:\IDEWORK\lvmen\src\licensedcode\data\rules\false-positive_650.yml", "YAML", 0, 0, 0, 2, 0, 0, 1, 3
"d:\IDEWORK\lvmen\src\licensedcode\data\rules\false-positive_6500.yml", "YAML", 0, 0, 0, 2, 0, 0, 1, 3
"d:\IDEWORK\lvmen\src\licensedcode\data\rules\false-positive_6501.yml", "YAML", 0, 0, 0, 2, 0, 0, 1, 3
"d:\IDEWORK\lvmen\src\licensedcode\data\rules\false-positive_6502.yml", "YAML", 0, 0, 0, 2, 0, 0, 1, 3
"d:\IDEWORK\lvmen\src\licensedcode\data\rules\false-positive_6503.yml", "YAML", 0, 0, 0, 2, 0, 0, 1, 3
"d:\IDEWORK\lvmen\src\licensedcode\data\rules\false-positive_6504.yml", "YAML", 0, 0, 0, 2, 0, 0, 1, 3
"d:\IDEWORK\lvmen\src\licensedcode\data\rules\false-positive_6505.yml", "YAML", 0, 0, 0, 2, 0, 0, 1, 3
"d:\IDEWORK\lvmen\src\licensedcode\data\rules\false-positive_6506.yml", "YAML", 0, 0, 0, 2, 0, 0, 1, 3
"d:\IDEWORK\lvmen\src\licensedcode\data\rules\false-positive_6507.yml", "YAML", 0, 0, 0, 2, 0, 0, 1, 3
"d:\IDEWORK\lvmen\src\licensedcode\data\rules\false-positive_6508.yml", "YAML", 0, 0, 0, 2, 0, 0, 1, 3
"d:\IDEWORK\lvmen\src\licensedcode\data\rules\false-positive_6509.yml", "YAML", 0, 0, 0, 2, 0, 0, 1, 3
"d:\IDEWORK\lvmen\src\licensedcode\data\rules\false-positive_651.yml", "YAML", 0, 0, 0, 2, 0, 0, 1, 3
"d:\IDEWORK\lvmen\src\licensedcode\data\rules\false-positive_6510.yml", "YAML", 0, 0, 0, 2, 0, 0, 1, 3
"d:\IDEWORK\lvmen\src\licensedcode\data\rules\false-positive_6511.yml", "YAML", 0, 0, 0, 2, 0, 0, 1, 3
"d:\IDEWORK\lvmen\src\licensedcode\data\rules\false-positive_6512.yml", "YAML", 0, 0, 0, 2, 0, 0, 1, 3
"d:\IDEWORK\lvmen\src\licensedcode\data\rules\false-positive_6513.yml", "YAML", 0, 0, 0, 2, 0, 0, 1, 3
"d:\IDEWORK\lvmen\src\licensedcode\data\rules\false-positive_6514.yml", "YAML", 0, 0, 0, 2, 0, 0, 1, 3
"d:\IDEWORK\lvmen\src\licensedcode\data\rules\false-positive_6515.yml", "YAML", 0, 0, 0, 2, 0, 0, 1, 3
"d:\IDEWORK\lvmen\src\licensedcode\data\rules\false-positive_6516.yml", "YAML", 0, 0, 0, 2, 0, 0, 1, 3
"d:\IDEWORK\lvmen\src\licensedcode\data\rules\false-positive_6517.yml", "YAML", 0, 0, 0, 2, 0, 0, 1, 3
"d:\IDEWORK\lvmen\src\licensedcode\data\rules\false-positive_6518.yml", "YAML", 0, 0, 0, 2, 0, 0, 1, 3
"d:\IDEWORK\lvmen\src\licensedcode\data\rules\false-positive_6519.yml", "YAML", 0, 0, 0, 2, 0, 0, 1, 3
"d:\IDEWORK\lvmen\src\licensedcode\data\rules\false-positive_652.yml", "YAML", 0, 0, 0, 2, 0, 0, 1, 3
"d:\IDEWORK\lvmen\src\licensedcode\data\rules\false-positive_6520.yml", "YAML", 0, 0, 0, 2, 0, 0, 1, 3
"d:\IDEWORK\lvmen\src\licensedcode\data\rules\false-positive_6521.yml", "YAML", 0, 0, 0, 2, 0, 0, 1, 3
"d:\IDEWORK\lvmen\src\licensedcode\data\rules\false-positive_6522.yml", "YAML", 0, 0, 0, 2, 0, 0, 1, 3
"d:\IDEWORK\lvmen\src\licensedcode\data\rules\false-positive_6523.yml", "YAML", 0, 0, 0, 2, 0, 0, 1, 3
"d:\IDEWORK\lvmen\src\licensedcode\data\rules\false-positive_6524.yml", "YAML", 0, 0, 0, 2, 0, 0, 1, 3
"d:\IDEWORK\lvmen\src\licensedcode\data\rules\false-positive_6525.yml", "YAML", 0, 0, 0, 2, 0, 0, 1, 3
"d:\IDEWORK\lvmen\src\licensedcode\data\rules\false-positive_6526.yml", "YAML", 0, 0, 0, 2, 0, 0, 1, 3
"d:\IDEWORK\lvmen\src\licensedcode\data\rules\false-positive_6527.yml", "YAML", 0, 0, 0, 2, 0, 0, 1, 3
"d:\IDEWORK\lvmen\src\licensedcode\data\rules\false-positive_6528.yml", "YAML", 0, 0, 0, 2, 0, 0, 1, 3
"d:\IDEWORK\lvmen\src\licensedcode\data\rules\false-positive_6529.yml", "YAML", 0, 0, 0, 2, 0, 0, 1, 3
"d:\IDEWORK\lvmen\src\licensedcode\data\rules\false-positive_653.yml", "YAML", 0, 0, 0, 2, 0, 0, 1, 3
"d:\IDEWORK\lvmen\src\licensedcode\data\rules\false-positive_6530.yml", "YAML", 0, 0, 0, 2, 0, 0, 1, 3
"d:\IDEWORK\lvmen\src\licensedcode\data\rules\false-positive_6531.yml", "YAML", 0, 0, 0, 2, 0, 0, 1, 3
"d:\IDEWORK\lvmen\src\licensedcode\data\rules\false-positive_6532.yml", "YAML", 0, 0, 0, 2, 0, 0, 1, 3
"d:\IDEWORK\lvmen\src\licensedcode\data\rules\false-positive_6533.yml", "YAML", 0, 0, 0, 2, 0, 0, 1, 3
"d:\IDEWORK\lvmen\src\licensedcode\data\rules\false-positive_6534.yml", "YAML", 0, 0, 0, 2, 0, 0, 1, 3
"d:\IDEWORK\lvmen\src\licensedcode\data\rules\false-positive_6535.yml", "YAML", 0, 0, 0, 2, 0, 0, 1, 3
"d:\IDEWORK\lvmen\src\licensedcode\data\rules\false-positive_6536.yml", "YAML", 0, 0, 0, 2, 0, 0, 1, 3
"d:\IDEWORK\lvmen\src\licensedcode\data\rules\false-positive_6537.yml", "YAML", 0, 0, 0, 2, 0, 0, 1, 3
"d:\IDEWORK\lvmen\src\licensedcode\data\rules\false-positive_6538.yml", "YAML", 0, 0, 0, 2, 0, 0, 1, 3
"d:\IDEWORK\lvmen\src\licensedcode\data\rules\false-positive_6539.yml", "YAML", 0, 0, 0, 2, 0, 0, 1, 3
"d:\IDEWORK\lvmen\src\licensedcode\data\rules\false-positive_654.yml", "YAML", 0, 0, 0, 2, 0, 0, 1, 3
"d:\IDEWORK\lvmen\src\licensedcode\data\rules\false-positive_6540.yml", "YAML", 0, 0, 0, 2, 0, 0, 1, 3
"d:\IDEWORK\lvmen\src\licensedcode\data\rules\false-positive_6541.yml", "YAML", 0, 0, 0, 2, 0, 0, 1, 3
"d:\IDEWORK\lvmen\src\licensedcode\data\rules\false-positive_6542.yml", "YAML", 0, 0, 0, 2, 0, 0, 1, 3
"d:\IDEWORK\lvmen\src\licensedcode\data\rules\false-positive_6543.yml", "YAML", 0, 0, 0, 2, 0, 0, 1, 3
"d:\IDEWORK\lvmen\src\licensedcode\data\rules\false-positive_6544.yml", "YAML", 0, 0, 0, 2, 0, 0, 1, 3
"d:\IDEWORK\lvmen\src\licensedcode\data\rules\false-positive_6545.yml", "YAML", 0, 0, 0, 2, 0, 0, 1, 3
"d:\IDEWORK\lvmen\src\licensedcode\data\rules\false-positive_6546.yml", "YAML", 0, 0, 0, 2, 0, 0, 1, 3
"d:\IDEWORK\lvmen\src\licensedcode\data\rules\false-positive_6547.yml", "YAML", 0, 0, 0, 2, 0, 0, 1, 3
"d:\IDEWORK\lvmen\src\licensedcode\data\rules\false-positive_6548.yml", "YAML", 0, 0, 0, 2, 0, 0, 1, 3
"d:\IDEWORK\lvmen\src\licensedcode\data\rules\false-positive_6549.yml", "YAML", 0, 0, 0, 2, 0, 0, 1, 3
"d:\IDEWORK\lvmen\src\licensedcode\data\rules\false-positive_655.yml", "YAML", 0, 0, 0, 2, 0, 0, 1, 3
"d:\IDEWORK\lvmen\src\licensedcode\data\rules\false-positive_6550.yml", "YAML", 0, 0, 0, 2, 0, 0, 1, 3
"d:\IDEWORK\lvmen\src\licensedcode\data\rules\false-positive_6551.yml", "YAML", 0, 0, 0, 2, 0, 0, 1, 3
"d:\IDEWORK\lvmen\src\licensedcode\data\rules\false-positive_6552.yml", "YAML", 0, 0, 0, 2, 0, 0, 1, 3
"d:\IDEWORK\lvmen\src\licensedcode\data\rules\false-positive_6553.yml", "YAML", 0, 0, 0, 2, 0, 0, 1, 3
"d:\IDEWORK\lvmen\src\licensedcode\data\rules\false-positive_6554.yml", "YAML", 0, 0, 0, 2, 0, 0, 1, 3
"d:\IDEWORK\lvmen\src\licensedcode\data\rules\false-positive_6555.yml", "YAML", 0, 0, 0, 2, 0, 0, 1, 3
"d:\IDEWORK\lvmen\src\licensedcode\data\rules\false-positive_6556.yml", "YAML", 0, 0, 0, 2, 0, 0, 1, 3
"d:\IDEWORK\lvmen\src\licensedcode\data\rules\false-positive_6557.yml", "YAML", 0, 0, 0, 2, 0, 0, 1, 3
"d:\IDEWORK\lvmen\src\licensedcode\data\rules\false-positive_6558.yml", "YAML", 0, 0, 0, 2, 0, 0, 1, 3
"d:\IDEWORK\lvmen\src\licensedcode\data\rules\false-positive_6559.yml", "YAML", 0, 0, 0, 2, 0, 0, 1, 3
"d:\IDEWORK\lvmen\src\licensedcode\data\rules\false-positive_656.yml", "YAML", 0, 0, 0, 2, 0, 0, 1, 3
"d:\IDEWORK\lvmen\src\licensedcode\data\rules\false-positive_6560.yml", "YAML", 0, 0, 0, 2, 0, 0, 1, 3
"d:\IDEWORK\lvmen\src\licensedcode\data\rules\false-positive_6561.yml", "YAML", 0, 0, 0, 2, 0, 0, 1, 3
"d:\IDEWORK\lvmen\src\licensedcode\data\rules\false-positive_6562.yml", "YAML", 0, 0, 0, 2, 0, 0, 1, 3
"d:\IDEWORK\lvmen\src\licensedcode\data\rules\false-positive_6563.yml", "YAML", 0, 0, 0, 2, 0, 0, 1, 3
"d:\IDEWORK\lvmen\src\licensedcode\data\rules\false-positive_6564.yml", "YAML", 0, 0, 0, 2, 0, 0, 1, 3
"d:\IDEWORK\lvmen\src\licensedcode\data\rules\false-positive_6565.yml", "YAML", 0, 0, 0, 2, 0, 0, 1, 3
"d:\IDEWORK\lvmen\src\licensedcode\data\rules\false-positive_6566.yml", "YAML", 0, 0, 0, 2, 0, 0, 1, 3
"d:\IDEWORK\lvmen\src\licensedcode\data\rules\false-positive_6567.yml", "YAML", 0, 0, 0, 2, 0, 0, 1, 3
"d:\IDEWORK\lvmen\src\licensedcode\data\rules\false-positive_6568.yml", "YAML", 0, 0, 0, 2, 0, 0, 1, 3
"d:\IDEWORK\lvmen\src\licensedcode\data\rules\false-positive_6569.yml", "YAML", 0, 0, 0, 2, 0, 0, 1, 3
"d:\IDEWORK\lvmen\src\licensedcode\data\rules\false-positive_657.yml", "YAML", 0, 0, 0, 2, 0, 0, 1, 3
"d:\IDEWORK\lvmen\src\licensedcode\data\rules\false-positive_6570.yml", "YAML", 0, 0, 0, 2, 0, 0, 1, 3
"d:\IDEWORK\lvmen\src\licensedcode\data\rules\false-positive_6571.yml", "YAML", 0, 0, 0, 2, 0, 0, 1, 3
"d:\IDEWORK\lvmen\src\licensedcode\data\rules\false-positive_6572.yml", "YAML", 0, 0, 0, 2, 0, 0, 1, 3
"d:\IDEWORK\lvmen\src\licensedcode\data\rules\false-positive_6573.yml", "YAML", 0, 0, 0, 2, 0, 0, 1, 3
"d:\IDEWORK\lvmen\src\licensedcode\data\rules\false-positive_6574.yml", "YAML", 0, 0, 0, 2, 0, 0, 1, 3
"d:\IDEWORK\lvmen\src\licensedcode\data\rules\false-positive_6575.yml", "YAML", 0, 0, 0, 2, 0, 0, 1, 3
"d:\IDEWORK\lvmen\src\licensedcode\data\rules\false-positive_6576.yml", "YAML", 0, 0, 0, 2, 0, 0, 1, 3
"d:\IDEWORK\lvmen\src\licensedcode\data\rules\false-positive_6577.yml", "YAML", 0, 0, 0, 2, 0, 0, 1, 3
"d:\IDEWORK\lvmen\src\licensedcode\data\rules\false-positive_6578.yml", "YAML", 0, 0, 0, 2, 0, 0, 1, 3
"d:\IDEWORK\lvmen\src\licensedcode\data\rules\false-positive_6579.yml", "YAML", 0, 0, 0, 2, 0, 0, 1, 3
"d:\IDEWORK\lvmen\src\licensedcode\data\rules\false-positive_658.yml", "YAML", 0, 0, 0, 2, 0, 0, 1, 3
"d:\IDEWORK\lvmen\src\licensedcode\data\rules\false-positive_6580.yml", "YAML", 0, 0, 0, 2, 0, 0, 1, 3
"d:\IDEWORK\lvmen\src\licensedcode\data\rules\false-positive_6581.yml", "YAML", 0, 0, 0, 2, 0, 0, 1, 3
"d:\IDEWORK\lvmen\src\licensedcode\data\rules\false-positive_6582.yml", "YAML", 0, 0, 0, 2, 0, 0, 1, 3
"d:\IDEWORK\lvmen\src\licensedcode\data\rules\false-positive_6583.yml", "YAML", 0, 0, 0, 2, 0, 0, 1, 3
"d:\IDEWORK\lvmen\src\licensedcode\data\rules\false-positive_6584.yml", "YAML", 0, 0, 0, 2, 0, 0, 1, 3
"d:\IDEWORK\lvmen\src\licensedcode\data\rules\false-positive_6585.yml", "YAML", 0, 0, 0, 2, 0, 0, 1, 3
"d:\IDEWORK\lvmen\src\licensedcode\data\rules\false-positive_6586.yml", "YAML", 0, 0, 0, 2, 0, 0, 1, 3
"d:\IDEWORK\lvmen\src\licensedcode\data\rules\false-positive_6587.yml", "YAML", 0, 0, 0, 2, 0, 0, 1, 3
"d:\IDEWORK\lvmen\src\licensedcode\data\rules\false-positive_6588.yml", "YAML", 0, 0, 0, 2, 0, 0, 1, 3
"d:\IDEWORK\lvmen\src\licensedcode\data\rules\false-positive_6589.yml", "YAML", 0, 0, 0, 2, 0, 0, 1, 3
"d:\IDEWORK\lvmen\src\licensedcode\data\rules\false-positive_659.yml", "YAML", 0, 0, 0, 3, 0, 0, 1, 4
"d:\IDEWORK\lvmen\src\licensedcode\data\rules\false-positive_6590.yml", "YAML", 0, 0, 0, 2, 0, 0, 1, 3
"d:\IDEWORK\lvmen\src\licensedcode\data\rules\false-positive_6591.yml", "YAML", 0, 0, 0, 2, 0, 0, 1, 3
"d:\IDEWORK\lvmen\src\licensedcode\data\rules\false-positive_6592.yml", "YAML", 0, 0, 0, 2, 0, 0, 1, 3
"d:\IDEWORK\lvmen\src\licensedcode\data\rules\false-positive_6593.yml", "YAML", 0, 0, 0, 2, 0, 0, 1, 3
"d:\IDEWORK\lvmen\src\licensedcode\data\rules\false-positive_6594.yml", "YAML", 0, 0, 0, 2, 0, 0, 1, 3
"d:\IDEWORK\lvmen\src\licensedcode\data\rules\false-positive_6595.yml", "YAML", 0, 0, 0, 2, 0, 0, 1, 3
"d:\IDEWORK\lvmen\src\licensedcode\data\rules\false-positive_6596.yml", "YAML", 0, 0, 0, 2, 0, 0, 1, 3
"d:\IDEWORK\lvmen\src\licensedcode\data\rules\false-positive_6597.yml", "YAML", 0, 0, 0, 2, 0, 0, 1, 3
"d:\IDEWORK\lvmen\src\licensedcode\data\rules\false-positive_6598.yml", "YAML", 0, 0, 0, 2, 0, 0, 1, 3
"d:\IDEWORK\lvmen\src\licensedcode\data\rules\false-positive_6599.yml", "YAML", 0, 0, 0, 2, 0, 0, 1, 3
"d:\IDEWORK\lvmen\src\licensedcode\data\rules\false-positive_66.yml", "YAML", 0, 0, 0, 2, 0, 0, 1, 3
"d:\IDEWORK\lvmen\src\licensedcode\data\rules\false-positive_660.yml", "YAML", 0, 0, 0, 2, 0, 0, 1, 3
"d:\IDEWORK\lvmen\src\licensedcode\data\rules\false-positive_6600.yml", "YAML", 0, 0, 0, 2, 0, 0, 1, 3
"d:\IDEWORK\lvmen\src\licensedcode\data\rules\false-positive_6601.yml", "YAML", 0, 0, 0, 2, 0, 0, 1, 3
"d:\IDEWORK\lvmen\src\licensedcode\data\rules\false-positive_6602.yml", "YAML", 0, 0, 0, 2, 0, 0, 1, 3
"d:\IDEWORK\lvmen\src\licensedcode\data\rules\false-positive_6603.yml", "YAML", 0, 0, 0, 2, 0, 0, 1, 3
"d:\IDEWORK\lvmen\src\licensedcode\data\rules\false-positive_6604.yml", "YAML", 0, 0, 0, 2, 0, 0, 1, 3
"d:\IDEWORK\lvmen\src\licensedcode\data\rules\false-positive_6605.yml", "YAML", 0, 0, 0, 2, 0, 0, 1, 3
"d:\IDEWORK\lvmen\src\licensedcode\data\rules\false-positive_6606.yml", "YAML", 0, 0, 0, 2, 0, 0, 1, 3
"d:\IDEWORK\lvmen\src\licensedcode\data\rules\false-positive_6607.yml", "YAML", 0, 0, 0, 2, 0, 0, 1, 3
"d:\IDEWORK\lvmen\src\licensedcode\data\rules\false-positive_6608.yml", "YAML", 0, 0, 0, 2, 0, 0, 1, 3
"d:\IDEWORK\lvmen\src\licensedcode\data\rules\false-positive_6609.yml", "YAML", 0, 0, 0, 2, 0, 0, 1, 3
"d:\IDEWORK\lvmen\src\licensedcode\data\rules\false-positive_661.yml", "YAML", 0, 0, 0, 2, 0, 0, 1, 3
"d:\IDEWORK\lvmen\src\licensedcode\data\rules\false-positive_6610.yml", "YAML", 0, 0, 0, 2, 0, 0, 1, 3
"d:\IDEWORK\lvmen\src\licensedcode\data\rules\false-positive_6611.yml", "YAML", 0, 0, 0, 2, 0, 0, 1, 3
"d:\IDEWORK\lvmen\src\licensedcode\data\rules\false-positive_6612.yml", "YAML", 0, 0, 0, 2, 0, 0, 1, 3
"d:\IDEWORK\lvmen\src\licensedcode\data\rules\false-positive_6613.yml", "YAML", 0, 0, 0, 2, 0, 0, 1, 3
"d:\IDEWORK\lvmen\src\licensedcode\data\rules\false-positive_6614.yml", "YAML", 0, 0, 0, 2, 0, 0, 1, 3
"d:\IDEWORK\lvmen\src\licensedcode\data\rules\false-positive_6615.yml", "YAML", 0, 0, 0, 2, 0, 0, 1, 3
"d:\IDEWORK\lvmen\src\licensedcode\data\rules\false-positive_6616.yml", "YAML", 0, 0, 0, 2, 0, 0, 1, 3
"d:\IDEWORK\lvmen\src\licensedcode\data\rules\false-positive_6617.yml", "YAML", 0, 0, 0, 2, 0, 0, 1, 3
"d:\IDEWORK\lvmen\src\licensedcode\data\rules\false-positive_6618.yml", "YAML", 0, 0, 0, 2, 0, 0, 1, 3
"d:\IDEWORK\lvmen\src\licensedcode\data\rules\false-positive_6619.yml", "YAML", 0, 0, 0, 2, 0, 0, 1, 3
"d:\IDEWORK\lvmen\src\licensedcode\data\rules\false-positive_662.yml", "YAML", 0, 0, 0, 2, 0, 0, 1, 3
"d:\IDEWORK\lvmen\src\licensedcode\data\rules\false-positive_6620.yml", "YAML", 0, 0, 0, 2, 0, 0, 1, 3
"d:\IDEWORK\lvmen\src\licensedcode\data\rules\false-positive_6621.yml", "YAML", 0, 0, 0, 2, 0, 0, 1, 3
"d:\IDEWORK\lvmen\src\licensedcode\data\rules\false-positive_6622.yml", "YAML", 0, 0, 0, 2, 0, 0, 1, 3
"d:\IDEWORK\lvmen\src\licensedcode\data\rules\false-positive_6623.yml", "YAML", 0, 0, 0, 2, 0, 0, 1, 3
"d:\IDEWORK\lvmen\src\licensedcode\data\rules\false-positive_6624.yml", "YAML", 0, 0, 0, 2, 0, 0, 1, 3
"d:\IDEWORK\lvmen\src\licensedcode\data\rules\false-positive_6625.yml", "YAML", 0, 0, 0, 2, 0, 0, 1, 3
"d:\IDEWORK\lvmen\src\licensedcode\data\rules\false-positive_6626.yml", "YAML", 0, 0, 0, 2, 0, 0, 1, 3
"d:\IDEWORK\lvmen\src\licensedcode\data\rules\false-positive_6627.yml", "YAML", 0, 0, 0, 2, 0, 0, 1, 3
"d:\IDEWORK\lvmen\src\licensedcode\data\rules\false-positive_6628.yml", "YAML", 0, 0, 0, 2, 0, 0, 1, 3
"d:\IDEWORK\lvmen\src\licensedcode\data\rules\false-positive_6629.yml", "YAML", 0, 0, 0, 2, 0, 0, 1, 3
"d:\IDEWORK\lvmen\src\licensedcode\data\rules\false-positive_663.yml", "YAML", 0, 0, 0, 2, 0, 0, 1, 3
"d:\IDEWORK\lvmen\src\licensedcode\data\rules\false-positive_6630.yml", "YAML", 0, 0, 0, 2, 0, 0, 1, 3
"d:\IDEWORK\lvmen\src\licensedcode\data\rules\false-positive_6631.yml", "YAML", 0, 0, 0, 2, 0, 0, 1, 3
"d:\IDEWORK\lvmen\src\licensedcode\data\rules\false-positive_6632.yml", "YAML", 0, 0, 0, 2, 0, 0, 1, 3
"d:\IDEWORK\lvmen\src\licensedcode\data\rules\false-positive_6633.yml", "YAML", 0, 0, 0, 2, 0, 0, 1, 3
"d:\IDEWORK\lvmen\src\licensedcode\data\rules\false-positive_6634.yml", "YAML", 0, 0, 0, 2, 0, 0, 1, 3
"d:\IDEWORK\lvmen\src\licensedcode\data\rules\false-positive_6635.yml", "YAML", 0, 0, 0, 2, 0, 0, 1, 3
"d:\IDEWORK\lvmen\src\licensedcode\data\rules\false-positive_6636.yml", "YAML", 0, 0, 0, 2, 0, 0, 1, 3
"d:\IDEWORK\lvmen\src\licensedcode\data\rules\false-positive_6637.yml", "YAML", 0, 0, 0, 2, 0, 0, 1, 3
"d:\IDEWORK\lvmen\src\licensedcode\data\rules\false-positive_6638.yml", "YAML", 0, 0, 0, 2, 0, 0, 1, 3
"d:\IDEWORK\lvmen\src\licensedcode\data\rules\false-positive_6639.yml", "YAML", 0, 0, 0, 2, 0, 0, 1, 3
"d:\IDEWORK\lvmen\src\licensedcode\data\rules\false-positive_664.yml", "YAML", 0, 0, 0, 2, 0, 0, 1, 3
"d:\IDEWORK\lvmen\src\licensedcode\data\rules\false-positive_6640.yml", "YAML", 0, 0, 0, 2, 0, 0, 1, 3
"d:\IDEWORK\lvmen\src\licensedcode\data\rules\false-positive_6641.yml", "YAML", 0, 0, 0, 2, 0, 0, 1, 3
"d:\IDEWORK\lvmen\src\licensedcode\data\rules\false-positive_6642.yml", "YAML", 0, 0, 0, 2, 0, 0, 1, 3
"d:\IDEWORK\lvmen\src\licensedcode\data\rules\false-positive_6643.yml", "YAML", 0, 0, 0, 2, 0, 0, 1, 3
"d:\IDEWORK\lvmen\src\licensedcode\data\rules\false-positive_6644.yml", "YAML", 0, 0, 0, 2, 0, 0, 1, 3
"d:\IDEWORK\lvmen\src\licensedcode\data\rules\false-positive_6645.yml", "YAML", 0, 0, 0, 2, 0, 0, 1, 3
"d:\IDEWORK\lvmen\src\licensedcode\data\rules\false-positive_6646.yml", "YAML", 0, 0, 0, 2, 0, 0, 1, 3
"d:\IDEWORK\lvmen\src\licensedcode\data\rules\false-positive_6647.yml", "YAML", 0, 0, 0, 2, 0, 0, 1, 3
"d:\IDEWORK\lvmen\src\licensedcode\data\rules\false-positive_6648.yml", "YAML", 0, 0, 0, 2, 0, 0, 1, 3
"d:\IDEWORK\lvmen\src\licensedcode\data\rules\false-positive_6649.yml", "YAML", 0, 0, 0, 2, 0, 0, 1, 3
"d:\IDEWORK\lvmen\src\licensedcode\data\rules\false-positive_665.yml", "YAML", 0, 0, 0, 2, 0, 0, 1, 3
"d:\IDEWORK\lvmen\src\licensedcode\data\rules\false-positive_6650.yml", "YAML", 0, 0, 0, 2, 0, 0, 1, 3
"d:\IDEWORK\lvmen\src\licensedcode\data\rules\false-positive_6651.yml", "YAML", 0, 0, 0, 2, 0, 0, 1, 3
"d:\IDEWORK\lvmen\src\licensedcode\data\rules\false-positive_6652.yml", "YAML", 0, 0, 0, 2, 0, 0, 1, 3
"d:\IDEWORK\lvmen\src\licensedcode\data\rules\false-positive_6653.yml", "YAML", 0, 0, 0, 2, 0, 0, 1, 3
"d:\IDEWORK\lvmen\src\licensedcode\data\rules\false-positive_6654.yml", "YAML", 0, 0, 0, 2, 0, 0, 1, 3
"d:\IDEWORK\lvmen\src\licensedcode\data\rules\false-positive_6655.yml", "YAML", 0, 0, 0, 2, 0, 0, 1, 3
"d:\IDEWORK\lvmen\src\licensedcode\data\rules\false-positive_6656.yml", "YAML", 0, 0, 0, 2, 0, 0, 1, 3
"d:\IDEWORK\lvmen\src\licensedcode\data\rules\false-positive_6657.yml", "YAML", 0, 0, 0, 2, 0, 0, 1, 3
"d:\IDEWORK\lvmen\src\licensedcode\data\rules\false-positive_6658.yml", "YAML", 0, 0, 0, 2, 0, 0, 1, 3
"d:\IDEWORK\lvmen\src\licensedcode\data\rules\false-positive_6659.yml", "YAML", 0, 0, 0, 2, 0, 0, 1, 3
"d:\IDEWORK\lvmen\src\licensedcode\data\rules\false-positive_666.yml", "YAML", 0, 0, 0, 2, 0, 0, 1, 3
"d:\IDEWORK\lvmen\src\licensedcode\data\rules\false-positive_6660.yml", "YAML", 0, 0, 0, 2, 0, 0, 1, 3
"d:\IDEWORK\lvmen\src\licensedcode\data\rules\false-positive_6661.yml", "YAML", 0, 0, 0, 2, 0, 0, 1, 3
"d:\IDEWORK\lvmen\src\licensedcode\data\rules\false-positive_6662.yml", "YAML", 0, 0, 0, 2, 0, 0, 1, 3
"d:\IDEWORK\lvmen\src\licensedcode\data\rules\false-positive_6663.yml", "YAML", 0, 0, 0, 2, 0, 0, 1, 3
"d:\IDEWORK\lvmen\src\licensedcode\data\rules\false-positive_6664.yml", "YAML", 0, 0, 0, 2, 0, 0, 1, 3
"d:\IDEWORK\lvmen\src\licensedcode\data\rules\false-positive_6665.yml", "YAML", 0, 0, 0, 2, 0, 0, 1, 3
"d:\IDEWORK\lvmen\src\licensedcode\data\rules\false-positive_6666.yml", "YAML", 0, 0, 0, 2, 0, 0, 1, 3
"d:\IDEWORK\lvmen\src\licensedcode\data\rules\false-positive_6667.yml", "YAML", 0, 0, 0, 2, 0, 0, 1, 3
"d:\IDEWORK\lvmen\src\licensedcode\data\rules\false-positive_6668.yml", "YAML", 0, 0, 0, 2, 0, 0, 1, 3
"d:\IDEWORK\lvmen\src\licensedcode\data\rules\false-positive_6669.yml", "YAML", 0, 0, 0, 2, 0, 0, 1, 3
"d:\IDEWORK\lvmen\src\licensedcode\data\rules\false-positive_667.yml", "YAML", 0, 0, 0, 2, 0, 0, 1, 3
"d:\IDEWORK\lvmen\src\licensedcode\data\rules\false-positive_6670.yml", "YAML", 0, 0, 0, 2, 0, 0, 1, 3
"d:\IDEWORK\lvmen\src\licensedcode\data\rules\false-positive_6671.yml", "YAML", 0, 0, 0, 2, 0, 0, 1, 3
"d:\IDEWORK\lvmen\src\licensedcode\data\rules\false-positive_6672.yml", "YAML", 0, 0, 0, 2, 0, 0, 1, 3
"d:\IDEWORK\lvmen\src\licensedcode\data\rules\false-positive_6673.yml", "YAML", 0, 0, 0, 2, 0, 0, 1, 3
"d:\IDEWORK\lvmen\src\licensedcode\data\rules\false-positive_6674.yml", "YAML", 0, 0, 0, 2, 0, 0, 1, 3
"d:\IDEWORK\lvmen\src\licensedcode\data\rules\false-positive_6675.yml", "YAML", 0, 0, 0, 2, 0, 0, 1, 3
"d:\IDEWORK\lvmen\src\licensedcode\data\rules\false-positive_6676.yml", "YAML", 0, 0, 0, 2, 0, 0, 1, 3
"d:\IDEWORK\lvmen\src\licensedcode\data\rules\false-positive_6677.yml", "YAML", 0, 0, 0, 2, 0, 0, 1, 3
"d:\IDEWORK\lvmen\src\licensedcode\data\rules\false-positive_6678.yml", "YAML", 0, 0, 0, 2, 0, 0, 1, 3
"d:\IDEWORK\lvmen\src\licensedcode\data\rules\false-positive_6679.yml", "YAML", 0, 0, 0, 2, 0, 0, 1, 3
"d:\IDEWORK\lvmen\src\licensedcode\data\rules\false-positive_668.yml", "YAML", 0, 0, 0, 2, 0, 0, 1, 3
"d:\IDEWORK\lvmen\src\licensedcode\data\rules\false-positive_6680.yml", "YAML", 0, 0, 0, 2, 0, 0, 1, 3
"d:\IDEWORK\lvmen\src\licensedcode\data\rules\false-positive_6681.yml", "YAML", 0, 0, 0, 2, 0, 0, 1, 3
"d:\IDEWORK\lvmen\src\licensedcode\data\rules\false-positive_6682.yml", "YAML", 0, 0, 0, 2, 0, 0, 1, 3
"d:\IDEWORK\lvmen\src\licensedcode\data\rules\false-positive_6683.yml", "YAML", 0, 0, 0, 2, 0, 0, 1, 3
"d:\IDEWORK\lvmen\src\licensedcode\data\rules\false-positive_6684.yml", "YAML", 0, 0, 0, 2, 0, 0, 1, 3
"d:\IDEWORK\lvmen\src\licensedcode\data\rules\false-positive_6685.yml", "YAML", 0, 0, 0, 2, 0, 0, 1, 3
"d:\IDEWORK\lvmen\src\licensedcode\data\rules\false-positive_6686.yml", "YAML", 0, 0, 0, 2, 0, 0, 1, 3
"d:\IDEWORK\lvmen\src\licensedcode\data\rules\false-positive_6687.yml", "YAML", 0, 0, 0, 2, 0, 0, 1, 3
"d:\IDEWORK\lvmen\src\licensedcode\data\rules\false-positive_6688.yml", "YAML", 0, 0, 0, 2, 0, 0, 1, 3
"d:\IDEWORK\lvmen\src\licensedcode\data\rules\false-positive_6689.yml", "YAML", 0, 0, 0, 2, 0, 0, 1, 3
"d:\IDEWORK\lvmen\src\licensedcode\data\rules\false-positive_669.yml", "YAML", 0, 0, 0, 2, 0, 0, 1, 3
"d:\IDEWORK\lvmen\src\licensedcode\data\rules\false-positive_6690.yml", "YAML", 0, 0, 0, 2, 0, 0, 1, 3
"d:\IDEWORK\lvmen\src\licensedcode\data\rules\false-positive_6691.yml", "YAML", 0, 0, 0, 2, 0, 0, 1, 3
"d:\IDEWORK\lvmen\src\licensedcode\data\rules\false-positive_6692.yml", "YAML", 0, 0, 0, 2, 0, 0, 1, 3
"d:\IDEWORK\lvmen\src\licensedcode\data\rules\false-positive_6693.yml", "YAML", 0, 0, 0, 2, 0, 0, 1, 3
"d:\IDEWORK\lvmen\src\licensedcode\data\rules\false-positive_6694.yml", "YAML", 0, 0, 0, 2, 0, 0, 1, 3
"d:\IDEWORK\lvmen\src\licensedcode\data\rules\false-positive_6695.yml", "YAML", 0, 0, 0, 2, 0, 0, 1, 3
"d:\IDEWORK\lvmen\src\licensedcode\data\rules\false-positive_6696.yml", "YAML", 0, 0, 0, 2, 0, 0, 1, 3
"d:\IDEWORK\lvmen\src\licensedcode\data\rules\false-positive_6697.yml", "YAML", 0, 0, 0, 2, 0, 0, 1, 3
"d:\IDEWORK\lvmen\src\licensedcode\data\rules\false-positive_6698.yml", "YAML", 0, 0, 0, 2, 0, 0, 1, 3
"d:\IDEWORK\lvmen\src\licensedcode\data\rules\false-positive_6699.yml", "YAML", 0, 0, 0, 2, 0, 0, 1, 3
"d:\IDEWORK\lvmen\src\licensedcode\data\rules\false-positive_67.yml", "YAML", 0, 0, 0, 2, 0, 0, 1, 3
"d:\IDEWORK\lvmen\src\licensedcode\data\rules\false-positive_670.yml", "YAML", 0, 0, 0, 2, 0, 0, 1, 3
"d:\IDEWORK\lvmen\src\licensedcode\data\rules\false-positive_6700.yml", "YAML", 0, 0, 0, 2, 0, 0, 1, 3
"d:\IDEWORK\lvmen\src\licensedcode\data\rules\false-positive_6701.yml", "YAML", 0, 0, 0, 2, 0, 0, 1, 3
"d:\IDEWORK\lvmen\src\licensedcode\data\rules\false-positive_6702.yml", "YAML", 0, 0, 0, 2, 0, 0, 1, 3
"d:\IDEWORK\lvmen\src\licensedcode\data\rules\false-positive_6703.yml", "YAML", 0, 0, 0, 2, 0, 0, 1, 3
"d:\IDEWORK\lvmen\src\licensedcode\data\rules\false-positive_6704.yml", "YAML", 0, 0, 0, 2, 0, 0, 1, 3
"d:\IDEWORK\lvmen\src\licensedcode\data\rules\false-positive_6705.yml", "YAML", 0, 0, 0, 2, 0, 0, 1, 3
"d:\IDEWORK\lvmen\src\licensedcode\data\rules\false-positive_6706.yml", "YAML", 0, 0, 0, 2, 0, 0, 1, 3
"d:\IDEWORK\lvmen\src\licensedcode\data\rules\false-positive_6707.yml", "YAML", 0, 0, 0, 2, 0, 0, 1, 3
"d:\IDEWORK\lvmen\src\licensedcode\data\rules\false-positive_6708.yml", "YAML", 0, 0, 0, 2, 0, 0, 1, 3
"d:\IDEWORK\lvmen\src\licensedcode\data\rules\false-positive_6709.yml", "YAML", 0, 0, 0, 2, 0, 0, 1, 3
"d:\IDEWORK\lvmen\src\licensedcode\data\rules\false-positive_671.yml", "YAML", 0, 0, 0, 2, 0, 0, 1, 3
"d:\IDEWORK\lvmen\src\licensedcode\data\rules\false-positive_6710.yml", "YAML", 0, 0, 0, 2, 0, 0, 1, 3
"d:\IDEWORK\lvmen\src\licensedcode\data\rules\false-positive_6711.yml", "YAML", 0, 0, 0, 2, 0, 0, 1, 3
"d:\IDEWORK\lvmen\src\licensedcode\data\rules\false-positive_6712.yml", "YAML", 0, 0, 0, 2, 0, 0, 1, 3
"d:\IDEWORK\lvmen\src\licensedcode\data\rules\false-positive_6713.yml", "YAML", 0, 0, 0, 2, 0, 0, 1, 3
"d:\IDEWORK\lvmen\src\licensedcode\data\rules\false-positive_6714.yml", "YAML", 0, 0, 0, 2, 0, 0, 1, 3
"d:\IDEWORK\lvmen\src\licensedcode\data\rules\false-positive_6715.yml", "YAML", 0, 0, 0, 2, 0, 0, 1, 3
"d:\IDEWORK\lvmen\src\licensedcode\data\rules\false-positive_6716.yml", "YAML", 0, 0, 0, 2, 0, 0, 1, 3
"d:\IDEWORK\lvmen\src\licensedcode\data\rules\false-positive_6717.yml", "YAML", 0, 0, 0, 2, 0, 0, 1, 3
"d:\IDEWORK\lvmen\src\licensedcode\data\rules\false-positive_6718.yml", "YAML", 0, 0, 0, 2, 0, 0, 1, 3
"d:\IDEWORK\lvmen\src\licensedcode\data\rules\false-positive_6719.yml", "YAML", 0, 0, 0, 2, 0, 0, 1, 3
"d:\IDEWORK\lvmen\src\licensedcode\data\rules\false-positive_672.yml", "YAML", 0, 0, 0, 2, 0, 0, 1, 3
"d:\IDEWORK\lvmen\src\licensedcode\data\rules\false-positive_6720.yml", "YAML", 0, 0, 0, 2, 0, 0, 1, 3
"d:\IDEWORK\lvmen\src\licensedcode\data\rules\false-positive_6721.yml", "YAML", 0, 0, 0, 2, 0, 0, 1, 3
"d:\IDEWORK\lvmen\src\licensedcode\data\rules\false-positive_6722.yml", "YAML", 0, 0, 0, 2, 0, 0, 1, 3
"d:\IDEWORK\lvmen\src\licensedcode\data\rules\false-positive_6723.yml", "YAML", 0, 0, 0, 2, 0, 0, 1, 3
"d:\IDEWORK\lvmen\src\licensedcode\data\rules\false-positive_6724.yml", "YAML", 0, 0, 0, 2, 0, 0, 1, 3
"d:\IDEWORK\lvmen\src\licensedcode\data\rules\false-positive_6725.yml", "YAML", 0, 0, 0, 2, 0, 0, 1, 3
"d:\IDEWORK\lvmen\src\licensedcode\data\rules\false-positive_6726.yml", "YAML", 0, 0, 0, 2, 0, 0, 1, 3
"d:\IDEWORK\lvmen\src\licensedcode\data\rules\false-positive_6727.yml", "YAML", 0, 0, 0, 2, 0, 0, 1, 3
"d:\IDEWORK\lvmen\src\licensedcode\data\rules\false-positive_6728.yml", "YAML", 0, 0, 0, 2, 0, 0, 1, 3
"d:\IDEWORK\lvmen\src\licensedcode\data\rules\false-positive_6729.yml", "YAML", 0, 0, 0, 2, 0, 0, 1, 3
"d:\IDEWORK\lvmen\src\licensedcode\data\rules\false-positive_673.yml", "YAML", 0, 0, 0, 2, 0, 0, 1, 3
"d:\IDEWORK\lvmen\src\licensedcode\data\rules\false-positive_6730.yml", "YAML", 0, 0, 0, 2, 0, 0, 1, 3
"d:\IDEWORK\lvmen\src\licensedcode\data\rules\false-positive_6731.yml", "YAML", 0, 0, 0, 2, 0, 0, 1, 3
"d:\IDEWORK\lvmen\src\licensedcode\data\rules\false-positive_6732.yml", "YAML", 0, 0, 0, 2, 0, 0, 1, 3
"d:\IDEWORK\lvmen\src\licensedcode\data\rules\false-positive_6733.yml", "YAML", 0, 0, 0, 2, 0, 0, 1, 3
"d:\IDEWORK\lvmen\src\licensedcode\data\rules\false-positive_6734.yml", "YAML", 0, 0, 0, 2, 0, 0, 1, 3
"d:\IDEWORK\lvmen\src\licensedcode\data\rules\false-positive_6735.yml", "YAML", 0, 0, 0, 2, 0, 0, 1, 3
"d:\IDEWORK\lvmen\src\licensedcode\data\rules\false-positive_6736.yml", "YAML", 0, 0, 0, 2, 0, 0, 1, 3
"d:\IDEWORK\lvmen\src\licensedcode\data\rules\false-positive_6737.yml", "YAML", 0, 0, 0, 2, 0, 0, 1, 3
"d:\IDEWORK\lvmen\src\licensedcode\data\rules\false-positive_6738.yml", "YAML", 0, 0, 0, 2, 0, 0, 1, 3
"d:\IDEWORK\lvmen\src\licensedcode\data\rules\false-positive_6739.yml", "YAML", 0, 0, 0, 2, 0, 0, 1, 3
"d:\IDEWORK\lvmen\src\licensedcode\data\rules\false-positive_674.yml", "YAML", 0, 0, 0, 2, 0, 0, 1, 3
"d:\IDEWORK\lvmen\src\licensedcode\data\rules\false-positive_6740.yml", "YAML", 0, 0, 0, 2, 0, 0, 1, 3
"d:\IDEWORK\lvmen\src\licensedcode\data\rules\false-positive_6741.yml", "YAML", 0, 0, 0, 2, 0, 0, 1, 3
"d:\IDEWORK\lvmen\src\licensedcode\data\rules\false-positive_6742.yml", "YAML", 0, 0, 0, 2, 0, 0, 1, 3
"d:\IDEWORK\lvmen\src\licensedcode\data\rules\false-positive_6743.yml", "YAML", 0, 0, 0, 2, 0, 0, 1, 3
"d:\IDEWORK\lvmen\src\licensedcode\data\rules\false-positive_6744.yml", "YAML", 0, 0, 0, 2, 0, 0, 1, 3
"d:\IDEWORK\lvmen\src\licensedcode\data\rules\false-positive_6745.yml", "YAML", 0, 0, 0, 2, 0, 0, 1, 3
"d:\IDEWORK\lvmen\src\licensedcode\data\rules\false-positive_6746.yml", "YAML", 0, 0, 0, 2, 0, 0, 1, 3
"d:\IDEWORK\lvmen\src\licensedcode\data\rules\false-positive_6747.yml", "YAML", 0, 0, 0, 2, 0, 0, 1, 3
"d:\IDEWORK\lvmen\src\licensedcode\data\rules\false-positive_6748.yml", "YAML", 0, 0, 0, 2, 0, 0, 1, 3
"d:\IDEWORK\lvmen\src\licensedcode\data\rules\false-positive_6749.yml", "YAML", 0, 0, 0, 2, 0, 0, 1, 3
"d:\IDEWORK\lvmen\src\licensedcode\data\rules\false-positive_675.yml", "YAML", 0, 0, 0, 2, 0, 0, 1, 3
"d:\IDEWORK\lvmen\src\licensedcode\data\rules\false-positive_6750.yml", "YAML", 0, 0, 0, 2, 0, 0, 1, 3
"d:\IDEWORK\lvmen\src\licensedcode\data\rules\false-positive_6751.yml", "YAML", 0, 0, 0, 2, 0, 0, 1, 3
"d:\IDEWORK\lvmen\src\licensedcode\data\rules\false-positive_6752.yml", "YAML", 0, 0, 0, 2, 0, 0, 1, 3
"d:\IDEWORK\lvmen\src\licensedcode\data\rules\false-positive_6753.yml", "YAML", 0, 0, 0, 2, 0, 0, 1, 3
"d:\IDEWORK\lvmen\src\licensedcode\data\rules\false-positive_6754.yml", "YAML", 0, 0, 0, 2, 0, 0, 1, 3
"d:\IDEWORK\lvmen\src\licensedcode\data\rules\false-positive_6755.yml", "YAML", 0, 0, 0, 2, 0, 0, 1, 3
"d:\IDEWORK\lvmen\src\licensedcode\data\rules\false-positive_6756.yml", "YAML", 0, 0, 0, 2, 0, 0, 1, 3
"d:\IDEWORK\lvmen\src\licensedcode\data\rules\false-positive_6757.yml", "YAML", 0, 0, 0, 2, 0, 0, 1, 3
"d:\IDEWORK\lvmen\src\licensedcode\data\rules\false-positive_6758.yml", "YAML", 0, 0, 0, 2, 0, 0, 1, 3
"d:\IDEWORK\lvmen\src\licensedcode\data\rules\false-positive_6759.yml", "YAML", 0, 0, 0, 2, 0, 0, 1, 3
"d:\IDEWORK\lvmen\src\licensedcode\data\rules\false-positive_676.yml", "YAML", 0, 0, 0, 2, 0, 0, 1, 3
"d:\IDEWORK\lvmen\src\licensedcode\data\rules\false-positive_6760.yml", "YAML", 0, 0, 0, 2, 0, 0, 1, 3
"d:\IDEWORK\lvmen\src\licensedcode\data\rules\false-positive_6761.yml", "YAML", 0, 0, 0, 2, 0, 0, 1, 3
"d:\IDEWORK\lvmen\src\licensedcode\data\rules\false-positive_6762.yml", "YAML", 0, 0, 0, 2, 0, 0, 1, 3
"d:\IDEWORK\lvmen\src\licensedcode\data\rules\false-positive_6763.yml", "YAML", 0, 0, 0, 2, 0, 0, 1, 3
"d:\IDEWORK\lvmen\src\licensedcode\data\rules\false-positive_6764.yml", "YAML", 0, 0, 0, 2, 0, 0, 1, 3
"d:\IDEWORK\lvmen\src\licensedcode\data\rules\false-positive_6765.yml", "YAML", 0, 0, 0, 2, 0, 0, 1, 3
"d:\IDEWORK\lvmen\src\licensedcode\data\rules\false-positive_6766.yml", "YAML", 0, 0, 0, 2, 0, 0, 1, 3
"d:\IDEWORK\lvmen\src\licensedcode\data\rules\false-positive_6767.yml", "YAML", 0, 0, 0, 2, 0, 0, 1, 3
"d:\IDEWORK\lvmen\src\licensedcode\data\rules\false-positive_6768.yml", "YAML", 0, 0, 0, 2, 0, 0, 1, 3
"d:\IDEWORK\lvmen\src\licensedcode\data\rules\false-positive_6769.yml", "YAML", 0, 0, 0, 2, 0, 0, 1, 3
"d:\IDEWORK\lvmen\src\licensedcode\data\rules\false-positive_677.yml", "YAML", 0, 0, 0, 2, 0, 0, 1, 3
"d:\IDEWORK\lvmen\src\licensedcode\data\rules\false-positive_6770.yml", "YAML", 0, 0, 0, 2, 0, 0, 1, 3
"d:\IDEWORK\lvmen\src\licensedcode\data\rules\false-positive_6771.yml", "YAML", 0, 0, 0, 2, 0, 0, 1, 3
"d:\IDEWORK\lvmen\src\licensedcode\data\rules\false-positive_6772.yml", "YAML", 0, 0, 0, 2, 0, 0, 1, 3
"d:\IDEWORK\lvmen\src\licensedcode\data\rules\false-positive_6773.yml", "YAML", 0, 0, 0, 2, 0, 0, 1, 3
"d:\IDEWORK\lvmen\src\licensedcode\data\rules\false-positive_6774.yml", "YAML", 0, 0, 0, 2, 0, 0, 1, 3
"d:\IDEWORK\lvmen\src\licensedcode\data\rules\false-positive_6775.yml", "YAML", 0, 0, 0, 2, 0, 0, 1, 3
"d:\IDEWORK\lvmen\src\licensedcode\data\rules\false-positive_6776.yml", "YAML", 0, 0, 0, 2, 0, 0, 1, 3
"d:\IDEWORK\lvmen\src\licensedcode\data\rules\false-positive_6777.yml", "YAML", 0, 0, 0, 2, 0, 0, 1, 3
"d:\IDEWORK\lvmen\src\licensedcode\data\rules\false-positive_6778.yml", "YAML", 0, 0, 0, 2, 0, 0, 1, 3
"d:\IDEWORK\lvmen\src\licensedcode\data\rules\false-positive_6779.yml", "YAML", 0, 0, 0, 2, 0, 0, 1, 3
"d:\IDEWORK\lvmen\src\licensedcode\data\rules\false-positive_678.yml", "YAML", 0, 0, 0, 2, 0, 0, 1, 3
"d:\IDEWORK\lvmen\src\licensedcode\data\rules\false-positive_6780.yml", "YAML", 0, 0, 0, 2, 0, 0, 1, 3
"d:\IDEWORK\lvmen\src\licensedcode\data\rules\false-positive_6781.yml", "YAML", 0, 0, 0, 2, 0, 0, 1, 3
"d:\IDEWORK\lvmen\src\licensedcode\data\rules\false-positive_6782.yml", "YAML", 0, 0, 0, 2, 0, 0, 1, 3
"d:\IDEWORK\lvmen\src\licensedcode\data\rules\false-positive_6783.yml", "YAML", 0, 0, 0, 2, 0, 0, 1, 3
"d:\IDEWORK\lvmen\src\licensedcode\data\rules\false-positive_6784.yml", "YAML", 0, 0, 0, 2, 0, 0, 1, 3
"d:\IDEWORK\lvmen\src\licensedcode\data\rules\false-positive_6785.yml", "YAML", 0, 0, 0, 2, 0, 0, 1, 3
"d:\IDEWORK\lvmen\src\licensedcode\data\rules\false-positive_6786.yml", "YAML", 0, 0, 0, 2, 0, 0, 1, 3
"d:\IDEWORK\lvmen\src\licensedcode\data\rules\false-positive_6787.yml", "YAML", 0, 0, 0, 2, 0, 0, 1, 3
"d:\IDEWORK\lvmen\src\licensedcode\data\rules\false-positive_6788.yml", "YAML", 0, 0, 0, 2, 0, 0, 1, 3
"d:\IDEWORK\lvmen\src\licensedcode\data\rules\false-positive_6789.yml", "YAML", 0, 0, 0, 2, 0, 0, 1, 3
"d:\IDEWORK\lvmen\src\licensedcode\data\rules\false-positive_679.yml", "YAML", 0, 0, 0, 2, 0, 0, 1, 3
"d:\IDEWORK\lvmen\src\licensedcode\data\rules\false-positive_6790.yml", "YAML", 0, 0, 0, 2, 0, 0, 1, 3
"d:\IDEWORK\lvmen\src\licensedcode\data\rules\false-positive_6791.yml", "YAML", 0, 0, 0, 2, 0, 0, 1, 3
"d:\IDEWORK\lvmen\src\licensedcode\data\rules\false-positive_6792.yml", "YAML", 0, 0, 0, 2, 0, 0, 1, 3
"d:\IDEWORK\lvmen\src\licensedcode\data\rules\false-positive_6793.yml", "YAML", 0, 0, 0, 2, 0, 0, 1, 3
"d:\IDEWORK\lvmen\src\licensedcode\data\rules\false-positive_6794.yml", "YAML", 0, 0, 0, 2, 0, 0, 1, 3
"d:\IDEWORK\lvmen\src\licensedcode\data\rules\false-positive_6795.yml", "YAML", 0, 0, 0, 2, 0, 0, 1, 3
"d:\IDEWORK\lvmen\src\licensedcode\data\rules\false-positive_6796.yml", "YAML", 0, 0, 0, 2, 0, 0, 1, 3
"d:\IDEWORK\lvmen\src\licensedcode\data\rules\false-positive_6797.yml", "YAML", 0, 0, 0, 2, 0, 0, 1, 3
"d:\IDEWORK\lvmen\src\licensedcode\data\rules\false-positive_6798.yml", "YAML", 0, 0, 0, 2, 0, 0, 1, 3
"d:\IDEWORK\lvmen\src\licensedcode\data\rules\false-positive_6799.yml", "YAML", 0, 0, 0, 2, 0, 0, 1, 3
"d:\IDEWORK\lvmen\src\licensedcode\data\rules\false-positive_68.yml", "YAML", 0, 0, 0, 3, 0, 0, 1, 4
"d:\IDEWORK\lvmen\src\licensedcode\data\rules\false-positive_680.yml", "YAML", 0, 0, 0, 2, 0, 0, 1, 3
"d:\IDEWORK\lvmen\src\licensedcode\data\rules\false-positive_6800.yml", "YAML", 0, 0, 0, 2, 0, 0, 1, 3
"d:\IDEWORK\lvmen\src\licensedcode\data\rules\false-positive_6801.yml", "YAML", 0, 0, 0, 2, 0, 0, 1, 3
"d:\IDEWORK\lvmen\src\licensedcode\data\rules\false-positive_6802.yml", "YAML", 0, 0, 0, 2, 0, 0, 1, 3
"d:\IDEWORK\lvmen\src\licensedcode\data\rules\false-positive_6803.yml", "YAML", 0, 0, 0, 2, 0, 0, 1, 3
"d:\IDEWORK\lvmen\src\licensedcode\data\rules\false-positive_6804.yml", "YAML", 0, 0, 0, 2, 0, 0, 1, 3
"d:\IDEWORK\lvmen\src\licensedcode\data\rules\false-positive_6805.yml", "YAML", 0, 0, 0, 2, 0, 0, 1, 3
"d:\IDEWORK\lvmen\src\licensedcode\data\rules\false-positive_6806.yml", "YAML", 0, 0, 0, 2, 0, 0, 1, 3
"d:\IDEWORK\lvmen\src\licensedcode\data\rules\false-positive_6807.yml", "YAML", 0, 0, 0, 2, 0, 0, 1, 3
"d:\IDEWORK\lvmen\src\licensedcode\data\rules\false-positive_6808.yml", "YAML", 0, 0, 0, 2, 0, 0, 1, 3
"d:\IDEWORK\lvmen\src\licensedcode\data\rules\false-positive_6809.yml", "YAML", 0, 0, 0, 2, 0, 0, 1, 3
"d:\IDEWORK\lvmen\src\licensedcode\data\rules\false-positive_681.yml", "YAML", 0, 0, 0, 2, 0, 0, 1, 3
"d:\IDEWORK\lvmen\src\licensedcode\data\rules\false-positive_6810.yml", "YAML", 0, 0, 0, 2, 0, 0, 1, 3
"d:\IDEWORK\lvmen\src\licensedcode\data\rules\false-positive_6811.yml", "YAML", 0, 0, 0, 2, 0, 0, 1, 3
"d:\IDEWORK\lvmen\src\licensedcode\data\rules\false-positive_6812.yml", "YAML", 0, 0, 0, 2, 0, 0, 1, 3
"d:\IDEWORK\lvmen\src\licensedcode\data\rules\false-positive_6813.yml", "YAML", 0, 0, 0, 2, 0, 0, 1, 3
"d:\IDEWORK\lvmen\src\licensedcode\data\rules\false-positive_6814.yml", "YAML", 0, 0, 0, 2, 0, 0, 1, 3
"d:\IDEWORK\lvmen\src\licensedcode\data\rules\false-positive_6815.yml", "YAML", 0, 0, 0, 2, 0, 0, 1, 3
"d:\IDEWORK\lvmen\src\licensedcode\data\rules\false-positive_6816.yml", "YAML", 0, 0, 0, 2, 0, 0, 1, 3
"d:\IDEWORK\lvmen\src\licensedcode\data\rules\false-positive_6817.yml", "YAML", 0, 0, 0, 2, 0, 0, 1, 3
"d:\IDEWORK\lvmen\src\licensedcode\data\rules\false-positive_6818.yml", "YAML", 0, 0, 0, 2, 0, 0, 1, 3
"d:\IDEWORK\lvmen\src\licensedcode\data\rules\false-positive_6819.yml", "YAML", 0, 0, 0, 2, 0, 0, 1, 3
"d:\IDEWORK\lvmen\src\licensedcode\data\rules\false-positive_682.yml", "YAML", 0, 0, 0, 2, 0, 0, 1, 3
"d:\IDEWORK\lvmen\src\licensedcode\data\rules\false-positive_6820.yml", "YAML", 0, 0, 0, 2, 0, 0, 1, 3
"d:\IDEWORK\lvmen\src\licensedcode\data\rules\false-positive_6821.yml", "YAML", 0, 0, 0, 2, 0, 0, 1, 3
"d:\IDEWORK\lvmen\src\licensedcode\data\rules\false-positive_6822.yml", "YAML", 0, 0, 0, 2, 0, 0, 1, 3
"d:\IDEWORK\lvmen\src\licensedcode\data\rules\false-positive_6823.yml", "YAML", 0, 0, 0, 2, 0, 0, 1, 3
"d:\IDEWORK\lvmen\src\licensedcode\data\rules\false-positive_6824.yml", "YAML", 0, 0, 0, 2, 0, 0, 1, 3
"d:\IDEWORK\lvmen\src\licensedcode\data\rules\false-positive_6825.yml", "YAML", 0, 0, 0, 2, 0, 0, 1, 3
"d:\IDEWORK\lvmen\src\licensedcode\data\rules\false-positive_6826.yml", "YAML", 0, 0, 0, 2, 0, 0, 1, 3
"d:\IDEWORK\lvmen\src\licensedcode\data\rules\false-positive_6827.yml", "YAML", 0, 0, 0, 2, 0, 0, 1, 3
"d:\IDEWORK\lvmen\src\licensedcode\data\rules\false-positive_6828.yml", "YAML", 0, 0, 0, 2, 0, 0, 1, 3
"d:\IDEWORK\lvmen\src\licensedcode\data\rules\false-positive_6829.yml", "YAML", 0, 0, 0, 2, 0, 0, 1, 3
"d:\IDEWORK\lvmen\src\licensedcode\data\rules\false-positive_683.yml", "YAML", 0, 0, 0, 2, 0, 0, 1, 3
"d:\IDEWORK\lvmen\src\licensedcode\data\rules\false-positive_6830.yml", "YAML", 0, 0, 0, 2, 0, 0, 1, 3
"d:\IDEWORK\lvmen\src\licensedcode\data\rules\false-positive_6831.yml", "YAML", 0, 0, 0, 2, 0, 0, 1, 3
"d:\IDEWORK\lvmen\src\licensedcode\data\rules\false-positive_6832.yml", "YAML", 0, 0, 0, 2, 0, 0, 1, 3
"d:\IDEWORK\lvmen\src\licensedcode\data\rules\false-positive_6833.yml", "YAML", 0, 0, 0, 2, 0, 0, 1, 3
"d:\IDEWORK\lvmen\src\licensedcode\data\rules\false-positive_6834.yml", "YAML", 0, 0, 0, 2, 0, 0, 1, 3
"d:\IDEWORK\lvmen\src\licensedcode\data\rules\false-positive_6835.yml", "YAML", 0, 0, 0, 2, 0, 0, 1, 3
"d:\IDEWORK\lvmen\src\licensedcode\data\rules\false-positive_6836.yml", "YAML", 0, 0, 0, 2, 0, 0, 1, 3
"d:\IDEWORK\lvmen\src\licensedcode\data\rules\false-positive_6837.yml", "YAML", 0, 0, 0, 2, 0, 0, 1, 3
"d:\IDEWORK\lvmen\src\licensedcode\data\rules\false-positive_6838.yml", "YAML", 0, 0, 0, 2, 0, 0, 1, 3
"d:\IDEWORK\lvmen\src\licensedcode\data\rules\false-positive_6839.yml", "YAML", 0, 0, 0, 2, 0, 0, 1, 3
"d:\IDEWORK\lvmen\src\licensedcode\data\rules\false-positive_684.yml", "YAML", 0, 0, 0, 2, 0, 0, 1, 3
"d:\IDEWORK\lvmen\src\licensedcode\data\rules\false-positive_6840.yml", "YAML", 0, 0, 0, 2, 0, 0, 1, 3
"d:\IDEWORK\lvmen\src\licensedcode\data\rules\false-positive_6841.yml", "YAML", 0, 0, 0, 2, 0, 0, 1, 3
"d:\IDEWORK\lvmen\src\licensedcode\data\rules\false-positive_6842.yml", "YAML", 0, 0, 0, 2, 0, 0, 1, 3
"d:\IDEWORK\lvmen\src\licensedcode\data\rules\false-positive_6843.yml", "YAML", 0, 0, 0, 2, 0, 0, 1, 3
"d:\IDEWORK\lvmen\src\licensedcode\data\rules\false-positive_6844.yml", "YAML", 0, 0, 0, 2, 0, 0, 1, 3
"d:\IDEWORK\lvmen\src\licensedcode\data\rules\false-positive_6845.yml", "YAML", 0, 0, 0, 2, 0, 0, 1, 3
"d:\IDEWORK\lvmen\src\licensedcode\data\rules\false-positive_6846.yml", "YAML", 0, 0, 0, 2, 0, 0, 1, 3
"d:\IDEWORK\lvmen\src\licensedcode\data\rules\false-positive_6847.yml", "YAML", 0, 0, 0, 2, 0, 0, 1, 3
"d:\IDEWORK\lvmen\src\licensedcode\data\rules\false-positive_6848.yml", "YAML", 0, 0, 0, 2, 0, 0, 1, 3
"d:\IDEWORK\lvmen\src\licensedcode\data\rules\false-positive_6849.yml", "YAML", 0, 0, 0, 2, 0, 0, 1, 3
"d:\IDEWORK\lvmen\src\licensedcode\data\rules\false-positive_685.yml", "YAML", 0, 0, 0, 2, 0, 0, 1, 3
"d:\IDEWORK\lvmen\src\licensedcode\data\rules\false-positive_6850.yml", "YAML", 0, 0, 0, 2, 0, 0, 1, 3
"d:\IDEWORK\lvmen\src\licensedcode\data\rules\false-positive_6851.yml", "YAML", 0, 0, 0, 2, 0, 0, 1, 3
"d:\IDEWORK\lvmen\src\licensedcode\data\rules\false-positive_6852.yml", "YAML", 0, 0, 0, 2, 0, 0, 1, 3
"d:\IDEWORK\lvmen\src\licensedcode\data\rules\false-positive_6853.yml", "YAML", 0, 0, 0, 2, 0, 0, 1, 3
"d:\IDEWORK\lvmen\src\licensedcode\data\rules\false-positive_6854.yml", "YAML", 0, 0, 0, 2, 0, 0, 1, 3
"d:\IDEWORK\lvmen\src\licensedcode\data\rules\false-positive_6855.yml", "YAML", 0, 0, 0, 2, 0, 0, 1, 3
"d:\IDEWORK\lvmen\src\licensedcode\data\rules\false-positive_6856.yml", "YAML", 0, 0, 0, 2, 0, 0, 1, 3
"d:\IDEWORK\lvmen\src\licensedcode\data\rules\false-positive_6857.yml", "YAML", 0, 0, 0, 2, 0, 0, 1, 3
"d:\IDEWORK\lvmen\src\licensedcode\data\rules\false-positive_6858.yml", "YAML", 0, 0, 0, 2, 0, 0, 1, 3
"d:\IDEWORK\lvmen\src\licensedcode\data\rules\false-positive_6859.yml", "YAML", 0, 0, 0, 2, 0, 0, 1, 3
"d:\IDEWORK\lvmen\src\licensedcode\data\rules\false-positive_686.yml", "YAML", 0, 0, 0, 2, 0, 0, 1, 3
"d:\IDEWORK\lvmen\src\licensedcode\data\rules\false-positive_6860.yml", "YAML", 0, 0, 0, 2, 0, 0, 1, 3
"d:\IDEWORK\lvmen\src\licensedcode\data\rules\false-positive_6861.yml", "YAML", 0, 0, 0, 2, 0, 0, 1, 3
"d:\IDEWORK\lvmen\src\licensedcode\data\rules\false-positive_6862.yml", "YAML", 0, 0, 0, 2, 0, 0, 1, 3
"d:\IDEWORK\lvmen\src\licensedcode\data\rules\false-positive_6863.yml", "YAML", 0, 0, 0, 2, 0, 0, 1, 3
"d:\IDEWORK\lvmen\src\licensedcode\data\rules\false-positive_6864.yml", "YAML", 0, 0, 0, 2, 0, 0, 1, 3
"d:\IDEWORK\lvmen\src\licensedcode\data\rules\false-positive_6865.yml", "YAML", 0, 0, 0, 2, 0, 0, 1, 3
"d:\IDEWORK\lvmen\src\licensedcode\data\rules\false-positive_6866.yml", "YAML", 0, 0, 0, 2, 0, 0, 1, 3
"d:\IDEWORK\lvmen\src\licensedcode\data\rules\false-positive_6867.yml", "YAML", 0, 0, 0, 2, 0, 0, 1, 3
"d:\IDEWORK\lvmen\src\licensedcode\data\rules\false-positive_6868.yml", "YAML", 0, 0, 0, 2, 0, 0, 1, 3
"d:\IDEWORK\lvmen\src\licensedcode\data\rules\false-positive_6869.yml", "YAML", 0, 0, 0, 2, 0, 0, 1, 3
"d:\IDEWORK\lvmen\src\licensedcode\data\rules\false-positive_687.yml", "YAML", 0, 0, 0, 2, 0, 0, 1, 3
"d:\IDEWORK\lvmen\src\licensedcode\data\rules\false-positive_6870.yml", "YAML", 0, 0, 0, 2, 0, 0, 1, 3
"d:\IDEWORK\lvmen\src\licensedcode\data\rules\false-positive_6871.yml", "YAML", 0, 0, 0, 2, 0, 0, 1, 3
"d:\IDEWORK\lvmen\src\licensedcode\data\rules\false-positive_6872.yml", "YAML", 0, 0, 0, 2, 0, 0, 1, 3
"d:\IDEWORK\lvmen\src\licensedcode\data\rules\false-positive_6873.yml", "YAML", 0, 0, 0, 2, 0, 0, 1, 3
"d:\IDEWORK\lvmen\src\licensedcode\data\rules\false-positive_6874.yml", "YAML", 0, 0, 0, 2, 0, 0, 1, 3
"d:\IDEWORK\lvmen\src\licensedcode\data\rules\false-positive_6875.yml", "YAML", 0, 0, 0, 2, 0, 0, 1, 3
"d:\IDEWORK\lvmen\src\licensedcode\data\rules\false-positive_6876.yml", "YAML", 0, 0, 0, 2, 0, 0, 1, 3
"d:\IDEWORK\lvmen\src\licensedcode\data\rules\false-positive_6877.yml", "YAML", 0, 0, 0, 2, 0, 0, 1, 3
"d:\IDEWORK\lvmen\src\licensedcode\data\rules\false-positive_6878.yml", "YAML", 0, 0, 0, 2, 0, 0, 1, 3
"d:\IDEWORK\lvmen\src\licensedcode\data\rules\false-positive_6879.yml", "YAML", 0, 0, 0, 2, 0, 0, 1, 3
"d:\IDEWORK\lvmen\src\licensedcode\data\rules\false-positive_688.yml", "YAML", 0, 0, 0, 2, 0, 0, 1, 3
"d:\IDEWORK\lvmen\src\licensedcode\data\rules\false-positive_6880.yml", "YAML", 0, 0, 0, 2, 0, 0, 1, 3
"d:\IDEWORK\lvmen\src\licensedcode\data\rules\false-positive_6881.yml", "YAML", 0, 0, 0, 2, 0, 0, 1, 3
"d:\IDEWORK\lvmen\src\licensedcode\data\rules\false-positive_6882.yml", "YAML", 0, 0, 0, 2, 0, 0, 1, 3
"d:\IDEWORK\lvmen\src\licensedcode\data\rules\false-positive_6883.yml", "YAML", 0, 0, 0, 2, 0, 0, 1, 3
"d:\IDEWORK\lvmen\src\licensedcode\data\rules\false-positive_6884.yml", "YAML", 0, 0, 0, 2, 0, 0, 1, 3
"d:\IDEWORK\lvmen\src\licensedcode\data\rules\false-positive_6885.yml", "YAML", 0, 0, 0, 2, 0, 0, 1, 3
"d:\IDEWORK\lvmen\src\licensedcode\data\rules\false-positive_6886.yml", "YAML", 0, 0, 0, 2, 0, 0, 1, 3
"d:\IDEWORK\lvmen\src\licensedcode\data\rules\false-positive_6887.yml", "YAML", 0, 0, 0, 2, 0, 0, 1, 3
"d:\IDEWORK\lvmen\src\licensedcode\data\rules\false-positive_6888.yml", "YAML", 0, 0, 0, 2, 0, 0, 1, 3
"d:\IDEWORK\lvmen\src\licensedcode\data\rules\false-positive_6889.yml", "YAML", 0, 0, 0, 2, 0, 0, 1, 3
"d:\IDEWORK\lvmen\src\licensedcode\data\rules\false-positive_689.yml", "YAML", 0, 0, 0, 2, 0, 0, 1, 3
"d:\IDEWORK\lvmen\src\licensedcode\data\rules\false-positive_6890.yml", "YAML", 0, 0, 0, 2, 0, 0, 1, 3
"d:\IDEWORK\lvmen\src\licensedcode\data\rules\false-positive_6891.yml", "YAML", 0, 0, 0, 2, 0, 0, 1, 3
"d:\IDEWORK\lvmen\src\licensedcode\data\rules\false-positive_6892.yml", "YAML", 0, 0, 0, 2, 0, 0, 1, 3
"d:\IDEWORK\lvmen\src\licensedcode\data\rules\false-positive_6893.yml", "YAML", 0, 0, 0, 2, 0, 0, 1, 3
"d:\IDEWORK\lvmen\src\licensedcode\data\rules\false-positive_6894.yml", "YAML", 0, 0, 0, 2, 0, 0, 1, 3
"d:\IDEWORK\lvmen\src\licensedcode\data\rules\false-positive_6895.yml", "YAML", 0, 0, 0, 2, 0, 0, 1, 3
"d:\IDEWORK\lvmen\src\licensedcode\data\rules\false-positive_6896.yml", "YAML", 0, 0, 0, 2, 0, 0, 1, 3
"d:\IDEWORK\lvmen\src\licensedcode\data\rules\false-positive_6897.yml", "YAML", 0, 0, 0, 2, 0, 0, 1, 3
"d:\IDEWORK\lvmen\src\licensedcode\data\rules\false-positive_6898.yml", "YAML", 0, 0, 0, 2, 0, 0, 1, 3
"d:\IDEWORK\lvmen\src\licensedcode\data\rules\false-positive_6899.yml", "YAML", 0, 0, 0, 2, 0, 0, 1, 3
"d:\IDEWORK\lvmen\src\licensedcode\data\rules\false-positive_69.yml", "YAML", 0, 0, 0, 2, 0, 0, 1, 3
"d:\IDEWORK\lvmen\src\licensedcode\data\rules\false-positive_690.yml", "YAML", 0, 0, 0, 2, 0, 0, 1, 3
"d:\IDEWORK\lvmen\src\licensedcode\data\rules\false-positive_6900.yml", "YAML", 0, 0, 0, 2, 0, 0, 1, 3
"d:\IDEWORK\lvmen\src\licensedcode\data\rules\false-positive_6901.yml", "YAML", 0, 0, 0, 2, 0, 0, 1, 3
"d:\IDEWORK\lvmen\src\licensedcode\data\rules\false-positive_6902.yml", "YAML", 0, 0, 0, 2, 0, 0, 1, 3
"d:\IDEWORK\lvmen\src\licensedcode\data\rules\false-positive_6903.yml", "YAML", 0, 0, 0, 2, 0, 0, 1, 3
"d:\IDEWORK\lvmen\src\licensedcode\data\rules\false-positive_6904.yml", "YAML", 0, 0, 0, 2, 0, 0, 1, 3
"d:\IDEWORK\lvmen\src\licensedcode\data\rules\false-positive_6905.yml", "YAML", 0, 0, 0, 2, 0, 0, 1, 3
"d:\IDEWORK\lvmen\src\licensedcode\data\rules\false-positive_6906.yml", "YAML", 0, 0, 0, 2, 0, 0, 1, 3
"d:\IDEWORK\lvmen\src\licensedcode\data\rules\false-positive_6907.yml", "YAML", 0, 0, 0, 2, 0, 0, 1, 3
"d:\IDEWORK\lvmen\src\licensedcode\data\rules\false-positive_6908.yml", "YAML", 0, 0, 0, 2, 0, 0, 1, 3
"d:\IDEWORK\lvmen\src\licensedcode\data\rules\false-positive_6909.yml", "YAML", 0, 0, 0, 2, 0, 0, 1, 3
"d:\IDEWORK\lvmen\src\licensedcode\data\rules\false-positive_691.yml", "YAML", 0, 0, 0, 2, 0, 0, 1, 3
"d:\IDEWORK\lvmen\src\licensedcode\data\rules\false-positive_6910.yml", "YAML", 0, 0, 0, 2, 0, 0, 1, 3
"d:\IDEWORK\lvmen\src\licensedcode\data\rules\false-positive_6911.yml", "YAML", 0, 0, 0, 2, 0, 0, 1, 3
"d:\IDEWORK\lvmen\src\licensedcode\data\rules\false-positive_6912.yml", "YAML", 0, 0, 0, 2, 0, 0, 1, 3
"d:\IDEWORK\lvmen\src\licensedcode\data\rules\false-positive_6913.yml", "YAML", 0, 0, 0, 2, 0, 0, 1, 3
"d:\IDEWORK\lvmen\src\licensedcode\data\rules\false-positive_6914.yml", "YAML", 0, 0, 0, 2, 0, 0, 1, 3
"d:\IDEWORK\lvmen\src\licensedcode\data\rules\false-positive_6915.yml", "YAML", 0, 0, 0, 2, 0, 0, 1, 3
"d:\IDEWORK\lvmen\src\licensedcode\data\rules\false-positive_6916.yml", "YAML", 0, 0, 0, 2, 0, 0, 1, 3
"d:\IDEWORK\lvmen\src\licensedcode\data\rules\false-positive_6917.yml", "YAML", 0, 0, 0, 2, 0, 0, 1, 3
"d:\IDEWORK\lvmen\src\licensedcode\data\rules\false-positive_6918.yml", "YAML", 0, 0, 0, 2, 0, 0, 1, 3
"d:\IDEWORK\lvmen\src\licensedcode\data\rules\false-positive_6919.yml", "YAML", 0, 0, 0, 2, 0, 0, 1, 3
"d:\IDEWORK\lvmen\src\licensedcode\data\rules\false-positive_692.yml", "YAML", 0, 0, 0, 2, 0, 0, 1, 3
"d:\IDEWORK\lvmen\src\licensedcode\data\rules\false-positive_6920.yml", "YAML", 0, 0, 0, 2, 0, 0, 1, 3
"d:\IDEWORK\lvmen\src\licensedcode\data\rules\false-positive_6921.yml", "YAML", 0, 0, 0, 2, 0, 0, 1, 3
"d:\IDEWORK\lvmen\src\licensedcode\data\rules\false-positive_6922.yml", "YAML", 0, 0, 0, 2, 0, 0, 1, 3
"d:\IDEWORK\lvmen\src\licensedcode\data\rules\false-positive_6923.yml", "YAML", 0, 0, 0, 2, 0, 0, 1, 3
"d:\IDEWORK\lvmen\src\licensedcode\data\rules\false-positive_6924.yml", "YAML", 0, 0, 0, 2, 0, 0, 1, 3
"d:\IDEWORK\lvmen\src\licensedcode\data\rules\false-positive_6925.yml", "YAML", 0, 0, 0, 2, 0, 0, 1, 3
"d:\IDEWORK\lvmen\src\licensedcode\data\rules\false-positive_6926.yml", "YAML", 0, 0, 0, 2, 0, 0, 1, 3
"d:\IDEWORK\lvmen\src\licensedcode\data\rules\false-positive_6927.yml", "YAML", 0, 0, 0, 2, 0, 0, 1, 3
"d:\IDEWORK\lvmen\src\licensedcode\data\rules\false-positive_6928.yml", "YAML", 0, 0, 0, 2, 0, 0, 1, 3
"d:\IDEWORK\lvmen\src\licensedcode\data\rules\false-positive_6929.yml", "YAML", 0, 0, 0, 2, 0, 0, 1, 3
"d:\IDEWORK\lvmen\src\licensedcode\data\rules\false-positive_693.yml", "YAML", 0, 0, 0, 2, 0, 0, 1, 3
"d:\IDEWORK\lvmen\src\licensedcode\data\rules\false-positive_6930.yml", "YAML", 0, 0, 0, 2, 0, 0, 1, 3
"d:\IDEWORK\lvmen\src\licensedcode\data\rules\false-positive_6931.yml", "YAML", 0, 0, 0, 2, 0, 0, 1, 3
"d:\IDEWORK\lvmen\src\licensedcode\data\rules\false-positive_6932.yml", "YAML", 0, 0, 0, 2, 0, 0, 1, 3
"d:\IDEWORK\lvmen\src\licensedcode\data\rules\false-positive_6933.yml", "YAML", 0, 0, 0, 2, 0, 0, 1, 3
"d:\IDEWORK\lvmen\src\licensedcode\data\rules\false-positive_6934.yml", "YAML", 0, 0, 0, 2, 0, 0, 1, 3
"d:\IDEWORK\lvmen\src\licensedcode\data\rules\false-positive_6935.yml", "YAML", 0, 0, 0, 2, 0, 0, 1, 3
"d:\IDEWORK\lvmen\src\licensedcode\data\rules\false-positive_6936.yml", "YAML", 0, 0, 0, 2, 0, 0, 1, 3
"d:\IDEWORK\lvmen\src\licensedcode\data\rules\false-positive_6937.yml", "YAML", 0, 0, 0, 2, 0, 0, 1, 3
"d:\IDEWORK\lvmen\src\licensedcode\data\rules\false-positive_6938.yml", "YAML", 0, 0, 0, 2, 0, 0, 1, 3
"d:\IDEWORK\lvmen\src\licensedcode\data\rules\false-positive_6939.yml", "YAML", 0, 0, 0, 2, 0, 0, 1, 3
"d:\IDEWORK\lvmen\src\licensedcode\data\rules\false-positive_694.yml", "YAML", 0, 0, 0, 2, 0, 0, 1, 3
"d:\IDEWORK\lvmen\src\licensedcode\data\rules\false-positive_6940.yml", "YAML", 0, 0, 0, 2, 0, 0, 1, 3
"d:\IDEWORK\lvmen\src\licensedcode\data\rules\false-positive_6941.yml", "YAML", 0, 0, 0, 2, 0, 0, 1, 3
"d:\IDEWORK\lvmen\src\licensedcode\data\rules\false-positive_6942.yml", "YAML", 0, 0, 0, 2, 0, 0, 1, 3
"d:\IDEWORK\lvmen\src\licensedcode\data\rules\false-positive_6943.yml", "YAML", 0, 0, 0, 2, 0, 0, 1, 3
"d:\IDEWORK\lvmen\src\licensedcode\data\rules\false-positive_6944.yml", "YAML", 0, 0, 0, 2, 0, 0, 1, 3
"d:\IDEWORK\lvmen\src\licensedcode\data\rules\false-positive_6945.yml", "YAML", 0, 0, 0, 2, 0, 0, 1, 3
"d:\IDEWORK\lvmen\src\licensedcode\data\rules\false-positive_6946.yml", "YAML", 0, 0, 0, 2, 0, 0, 1, 3
"d:\IDEWORK\lvmen\src\licensedcode\data\rules\false-positive_6947.yml", "YAML", 0, 0, 0, 2, 0, 0, 1, 3
"d:\IDEWORK\lvmen\src\licensedcode\data\rules\false-positive_6948.yml", "YAML", 0, 0, 0, 2, 0, 0, 1, 3
"d:\IDEWORK\lvmen\src\licensedcode\data\rules\false-positive_6949.yml", "YAML", 0, 0, 0, 2, 0, 0, 1, 3
"d:\IDEWORK\lvmen\src\licensedcode\data\rules\false-positive_695.yml", "YAML", 0, 0, 0, 2, 0, 0, 1, 3
"d:\IDEWORK\lvmen\src\licensedcode\data\rules\false-positive_6950.yml", "YAML", 0, 0, 0, 2, 0, 0, 1, 3
"d:\IDEWORK\lvmen\src\licensedcode\data\rules\false-positive_6951.yml", "YAML", 0, 0, 0, 2, 0, 0, 1, 3
"d:\IDEWORK\lvmen\src\licensedcode\data\rules\false-positive_6952.yml", "YAML", 0, 0, 0, 2, 0, 0, 1, 3
"d:\IDEWORK\lvmen\src\licensedcode\data\rules\false-positive_6953.yml", "YAML", 0, 0, 0, 2, 0, 0, 1, 3
"d:\IDEWORK\lvmen\src\licensedcode\data\rules\false-positive_6954.yml", "YAML", 0, 0, 0, 2, 0, 0, 1, 3
"d:\IDEWORK\lvmen\src\licensedcode\data\rules\false-positive_6955.yml", "YAML", 0, 0, 0, 2, 0, 0, 1, 3
"d:\IDEWORK\lvmen\src\licensedcode\data\rules\false-positive_6956.yml", "YAML", 0, 0, 0, 2, 0, 0, 1, 3
"d:\IDEWORK\lvmen\src\licensedcode\data\rules\false-positive_6957.yml", "YAML", 0, 0, 0, 2, 0, 0, 1, 3
"d:\IDEWORK\lvmen\src\licensedcode\data\rules\false-positive_6958.yml", "YAML", 0, 0, 0, 2, 0, 0, 1, 3
"d:\IDEWORK\lvmen\src\licensedcode\data\rules\false-positive_6959.yml", "YAML", 0, 0, 0, 2, 0, 0, 1, 3
"d:\IDEWORK\lvmen\src\licensedcode\data\rules\false-positive_696.yml", "YAML", 0, 0, 0, 2, 0, 0, 1, 3
"d:\IDEWORK\lvmen\src\licensedcode\data\rules\false-positive_6960.yml", "YAML", 0, 0, 0, 2, 0, 0, 1, 3
"d:\IDEWORK\lvmen\src\licensedcode\data\rules\false-positive_6961.yml", "YAML", 0, 0, 0, 2, 0, 0, 1, 3
"d:\IDEWORK\lvmen\src\licensedcode\data\rules\false-positive_6962.yml", "YAML", 0, 0, 0, 2, 0, 0, 1, 3
"d:\IDEWORK\lvmen\src\licensedcode\data\rules\false-positive_6963.yml", "YAML", 0, 0, 0, 2, 0, 0, 1, 3
"d:\IDEWORK\lvmen\src\licensedcode\data\rules\false-positive_6964.yml", "YAML", 0, 0, 0, 2, 0, 0, 1, 3
"d:\IDEWORK\lvmen\src\licensedcode\data\rules\false-positive_6965.yml", "YAML", 0, 0, 0, 2, 0, 0, 1, 3
"d:\IDEWORK\lvmen\src\licensedcode\data\rules\false-positive_6966.yml", "YAML", 0, 0, 0, 2, 0, 0, 1, 3
"d:\IDEWORK\lvmen\src\licensedcode\data\rules\false-positive_6967.yml", "YAML", 0, 0, 0, 2, 0, 0, 1, 3
"d:\IDEWORK\lvmen\src\licensedcode\data\rules\false-positive_6968.yml", "YAML", 0, 0, 0, 2, 0, 0, 1, 3
"d:\IDEWORK\lvmen\src\licensedcode\data\rules\false-positive_6969.yml", "YAML", 0, 0, 0, 2, 0, 0, 1, 3
"d:\IDEWORK\lvmen\src\licensedcode\data\rules\false-positive_697.yml", "YAML", 0, 0, 0, 2, 0, 0, 1, 3
"d:\IDEWORK\lvmen\src\licensedcode\data\rules\false-positive_6970.yml", "YAML", 0, 0, 0, 2, 0, 0, 1, 3
"d:\IDEWORK\lvmen\src\licensedcode\data\rules\false-positive_6971.yml", "YAML", 0, 0, 0, 2, 0, 0, 1, 3
"d:\IDEWORK\lvmen\src\licensedcode\data\rules\false-positive_6972.yml", "YAML", 0, 0, 0, 2, 0, 0, 1, 3
"d:\IDEWORK\lvmen\src\licensedcode\data\rules\false-positive_6973.yml", "YAML", 0, 0, 0, 2, 0, 0, 1, 3
"d:\IDEWORK\lvmen\src\licensedcode\data\rules\false-positive_6974.yml", "YAML", 0, 0, 0, 2, 0, 0, 1, 3
"d:\IDEWORK\lvmen\src\licensedcode\data\rules\false-positive_6975.yml", "YAML", 0, 0, 0, 2, 0, 0, 1, 3
"d:\IDEWORK\lvmen\src\licensedcode\data\rules\false-positive_6976.yml", "YAML", 0, 0, 0, 2, 0, 0, 1, 3
"d:\IDEWORK\lvmen\src\licensedcode\data\rules\false-positive_6977.yml", "YAML", 0, 0, 0, 2, 0, 0, 1, 3
"d:\IDEWORK\lvmen\src\licensedcode\data\rules\false-positive_6978.yml", "YAML", 0, 0, 0, 2, 0, 0, 1, 3
"d:\IDEWORK\lvmen\src\licensedcode\data\rules\false-positive_6979.yml", "YAML", 0, 0, 0, 2, 0, 0, 1, 3
"d:\IDEWORK\lvmen\src\licensedcode\data\rules\false-positive_698.yml", "YAML", 0, 0, 0, 2, 0, 0, 1, 3
"d:\IDEWORK\lvmen\src\licensedcode\data\rules\false-positive_6980.yml", "YAML", 0, 0, 0, 2, 0, 0, 1, 3
"d:\IDEWORK\lvmen\src\licensedcode\data\rules\false-positive_6981.yml", "YAML", 0, 0, 0, 2, 0, 0, 1, 3
"d:\IDEWORK\lvmen\src\licensedcode\data\rules\false-positive_6982.yml", "YAML", 0, 0, 0, 2, 0, 0, 1, 3
"d:\IDEWORK\lvmen\src\licensedcode\data\rules\false-positive_6983.yml", "YAML", 0, 0, 0, 2, 0, 0, 1, 3
"d:\IDEWORK\lvmen\src\licensedcode\data\rules\false-positive_6984.yml", "YAML", 0, 0, 0, 2, 0, 0, 1, 3
"d:\IDEWORK\lvmen\src\licensedcode\data\rules\false-positive_6985.yml", "YAML", 0, 0, 0, 2, 0, 0, 1, 3
"d:\IDEWORK\lvmen\src\licensedcode\data\rules\false-positive_6986.yml", "YAML", 0, 0, 0, 2, 0, 0, 1, 3
"d:\IDEWORK\lvmen\src\licensedcode\data\rules\false-positive_6987.yml", "YAML", 0, 0, 0, 2, 0, 0, 1, 3
"d:\IDEWORK\lvmen\src\licensedcode\data\rules\false-positive_6988.yml", "YAML", 0, 0, 0, 2, 0, 0, 1, 3
"d:\IDEWORK\lvmen\src\licensedcode\data\rules\false-positive_6989.yml", "YAML", 0, 0, 0, 2, 0, 0, 1, 3
"d:\IDEWORK\lvmen\src\licensedcode\data\rules\false-positive_699.yml", "YAML", 0, 0, 0, 2, 0, 0, 1, 3
"d:\IDEWORK\lvmen\src\licensedcode\data\rules\false-positive_6990.yml", "YAML", 0, 0, 0, 2, 0, 0, 1, 3
"d:\IDEWORK\lvmen\src\licensedcode\data\rules\false-positive_6991.yml", "YAML", 0, 0, 0, 2, 0, 0, 1, 3
"d:\IDEWORK\lvmen\src\licensedcode\data\rules\false-positive_6992.yml", "YAML", 0, 0, 0, 2, 0, 0, 1, 3
"d:\IDEWORK\lvmen\src\licensedcode\data\rules\false-positive_6993.yml", "YAML", 0, 0, 0, 2, 0, 0, 1, 3
"d:\IDEWORK\lvmen\src\licensedcode\data\rules\false-positive_6994.yml", "YAML", 0, 0, 0, 2, 0, 0, 1, 3
"d:\IDEWORK\lvmen\src\licensedcode\data\rules\false-positive_6995.yml", "YAML", 0, 0, 0, 2, 0, 0, 1, 3
"d:\IDEWORK\lvmen\src\licensedcode\data\rules\false-positive_6996.yml", "YAML", 0, 0, 0, 2, 0, 0, 1, 3
"d:\IDEWORK\lvmen\src\licensedcode\data\rules\false-positive_6997.yml", "YAML", 0, 0, 0, 2, 0, 0, 1, 3
"d:\IDEWORK\lvmen\src\licensedcode\data\rules\false-positive_6998.yml", "YAML", 0, 0, 0, 2, 0, 0, 1, 3
"d:\IDEWORK\lvmen\src\licensedcode\data\rules\false-positive_6999.yml", "YAML", 0, 0, 0, 2, 0, 0, 1, 3
"d:\IDEWORK\lvmen\src\licensedcode\data\rules\false-positive_7.yml", "YAML", 0, 0, 0, 2, 0, 0, 1, 3
"d:\IDEWORK\lvmen\src\licensedcode\data\rules\false-positive_70.yml", "YAML", 0, 0, 0, 2, 0, 0, 1, 3
"d:\IDEWORK\lvmen\src\licensedcode\data\rules\false-positive_700.yml", "YAML", 0, 0, 0, 2, 0, 0, 1, 3
"d:\IDEWORK\lvmen\src\licensedcode\data\rules\false-positive_7000.yml", "YAML", 0, 0, 0, 2, 0, 0, 1, 3
"d:\IDEWORK\lvmen\src\licensedcode\data\rules\false-positive_7001.yml", "YAML", 0, 0, 0, 2, 0, 0, 1, 3
"d:\IDEWORK\lvmen\src\licensedcode\data\rules\false-positive_7002.yml", "YAML", 0, 0, 0, 2, 0, 0, 1, 3
"d:\IDEWORK\lvmen\src\licensedcode\data\rules\false-positive_7003.yml", "YAML", 0, 0, 0, 2, 0, 0, 1, 3
"d:\IDEWORK\lvmen\src\licensedcode\data\rules\false-positive_7004.yml", "YAML", 0, 0, 0, 2, 0, 0, 1, 3
"d:\IDEWORK\lvmen\src\licensedcode\data\rules\false-positive_7005.yml", "YAML", 0, 0, 0, 2, 0, 0, 1, 3
"d:\IDEWORK\lvmen\src\licensedcode\data\rules\false-positive_7006.yml", "YAML", 0, 0, 0, 2, 0, 0, 1, 3
"d:\IDEWORK\lvmen\src\licensedcode\data\rules\false-positive_7007.yml", "YAML", 0, 0, 0, 2, 0, 0, 1, 3
"d:\IDEWORK\lvmen\src\licensedcode\data\rules\false-positive_7008.yml", "YAML", 0, 0, 0, 2, 0, 0, 1, 3
"d:\IDEWORK\lvmen\src\licensedcode\data\rules\false-positive_7009.yml", "YAML", 0, 0, 0, 2, 0, 0, 1, 3
"d:\IDEWORK\lvmen\src\licensedcode\data\rules\false-positive_701.yml", "YAML", 0, 0, 0, 2, 0, 0, 1, 3
"d:\IDEWORK\lvmen\src\licensedcode\data\rules\false-positive_7010.yml", "YAML", 0, 0, 0, 2, 0, 0, 1, 3
"d:\IDEWORK\lvmen\src\licensedcode\data\rules\false-positive_7011.yml", "YAML", 0, 0, 0, 2, 0, 0, 1, 3
"d:\IDEWORK\lvmen\src\licensedcode\data\rules\false-positive_7012.yml", "YAML", 0, 0, 0, 2, 0, 0, 1, 3
"d:\IDEWORK\lvmen\src\licensedcode\data\rules\false-positive_7013.yml", "YAML", 0, 0, 0, 2, 0, 0, 1, 3
"d:\IDEWORK\lvmen\src\licensedcode\data\rules\false-positive_7014.yml", "YAML", 0, 0, 0, 2, 0, 0, 1, 3
"d:\IDEWORK\lvmen\src\licensedcode\data\rules\false-positive_7015.yml", "YAML", 0, 0, 0, 2, 0, 0, 1, 3
"d:\IDEWORK\lvmen\src\licensedcode\data\rules\false-positive_7016.yml", "YAML", 0, 0, 0, 2, 0, 0, 1, 3
"d:\IDEWORK\lvmen\src\licensedcode\data\rules\false-positive_7017.yml", "YAML", 0, 0, 0, 2, 0, 0, 1, 3
"d:\IDEWORK\lvmen\src\licensedcode\data\rules\false-positive_7018.yml", "YAML", 0, 0, 0, 2, 0, 0, 1, 3
"d:\IDEWORK\lvmen\src\licensedcode\data\rules\false-positive_7019.yml", "YAML", 0, 0, 0, 2, 0, 0, 1, 3
"d:\IDEWORK\lvmen\src\licensedcode\data\rules\false-positive_702.yml", "YAML", 0, 0, 0, 2, 0, 0, 1, 3
"d:\IDEWORK\lvmen\src\licensedcode\data\rules\false-positive_7020.yml", "YAML", 0, 0, 0, 2, 0, 0, 1, 3
"d:\IDEWORK\lvmen\src\licensedcode\data\rules\false-positive_7021.yml", "YAML", 0, 0, 0, 2, 0, 0, 1, 3
"d:\IDEWORK\lvmen\src\licensedcode\data\rules\false-positive_7022.yml", "YAML", 0, 0, 0, 2, 0, 0, 1, 3
"d:\IDEWORK\lvmen\src\licensedcode\data\rules\false-positive_7023.yml", "YAML", 0, 0, 0, 2, 0, 0, 1, 3
"d:\IDEWORK\lvmen\src\licensedcode\data\rules\false-positive_7024.yml", "YAML", 0, 0, 0, 2, 0, 0, 1, 3
"d:\IDEWORK\lvmen\src\licensedcode\data\rules\false-positive_7025.yml", "YAML", 0, 0, 0, 2, 0, 0, 1, 3
"d:\IDEWORK\lvmen\src\licensedcode\data\rules\false-positive_7026.yml", "YAML", 0, 0, 0, 2, 0, 0, 1, 3
"d:\IDEWORK\lvmen\src\licensedcode\data\rules\false-positive_7027.yml", "YAML", 0, 0, 0, 2, 0, 0, 1, 3
"d:\IDEWORK\lvmen\src\licensedcode\data\rules\false-positive_7028.yml", "YAML", 0, 0, 0, 2, 0, 0, 1, 3
"d:\IDEWORK\lvmen\src\licensedcode\data\rules\false-positive_7029.yml", "YAML", 0, 0, 0, 2, 0, 0, 1, 3
"d:\IDEWORK\lvmen\src\licensedcode\data\rules\false-positive_703.yml", "YAML", 0, 0, 0, 2, 0, 0, 1, 3
"d:\IDEWORK\lvmen\src\licensedcode\data\rules\false-positive_7030.yml", "YAML", 0, 0, 0, 2, 0, 0, 1, 3
"d:\IDEWORK\lvmen\src\licensedcode\data\rules\false-positive_7031.yml", "YAML", 0, 0, 0, 2, 0, 0, 1, 3
"d:\IDEWORK\lvmen\src\licensedcode\data\rules\false-positive_7032.yml", "YAML", 0, 0, 0, 2, 0, 0, 1, 3
"d:\IDEWORK\lvmen\src\licensedcode\data\rules\false-positive_7033.yml", "YAML", 0, 0, 0, 2, 0, 0, 1, 3
"d:\IDEWORK\lvmen\src\licensedcode\data\rules\false-positive_7034.yml", "YAML", 0, 0, 0, 2, 0, 0, 1, 3
"d:\IDEWORK\lvmen\src\licensedcode\data\rules\false-positive_7035.yml", "YAML", 0, 0, 0, 2, 0, 0, 1, 3
"d:\IDEWORK\lvmen\src\licensedcode\data\rules\false-positive_7036.yml", "YAML", 0, 0, 0, 2, 0, 0, 1, 3
"d:\IDEWORK\lvmen\src\licensedcode\data\rules\false-positive_7037.yml", "YAML", 0, 0, 0, 2, 0, 0, 1, 3
"d:\IDEWORK\lvmen\src\licensedcode\data\rules\false-positive_7038.yml", "YAML", 0, 0, 0, 2, 0, 0, 1, 3
"d:\IDEWORK\lvmen\src\licensedcode\data\rules\false-positive_7039.yml", "YAML", 0, 0, 0, 2, 0, 0, 1, 3
"d:\IDEWORK\lvmen\src\licensedcode\data\rules\false-positive_704.yml", "YAML", 0, 0, 0, 2, 0, 0, 1, 3
"d:\IDEWORK\lvmen\src\licensedcode\data\rules\false-positive_7040.yml", "YAML", 0, 0, 0, 2, 0, 0, 1, 3
"d:\IDEWORK\lvmen\src\licensedcode\data\rules\false-positive_7041.yml", "YAML", 0, 0, 0, 2, 0, 0, 1, 3
"d:\IDEWORK\lvmen\src\licensedcode\data\rules\false-positive_7042.yml", "YAML", 0, 0, 0, 2, 0, 0, 1, 3
"d:\IDEWORK\lvmen\src\licensedcode\data\rules\false-positive_7043.yml", "YAML", 0, 0, 0, 2, 0, 0, 1, 3
"d:\IDEWORK\lvmen\src\licensedcode\data\rules\false-positive_7044.yml", "YAML", 0, 0, 0, 2, 0, 0, 1, 3
"d:\IDEWORK\lvmen\src\licensedcode\data\rules\false-positive_7045.yml", "YAML", 0, 0, 0, 2, 0, 0, 1, 3
"d:\IDEWORK\lvmen\src\licensedcode\data\rules\false-positive_7046.yml", "YAML", 0, 0, 0, 2, 0, 0, 1, 3
"d:\IDEWORK\lvmen\src\licensedcode\data\rules\false-positive_7047.yml", "YAML", 0, 0, 0, 2, 0, 0, 1, 3
"d:\IDEWORK\lvmen\src\licensedcode\data\rules\false-positive_7048.yml", "YAML", 0, 0, 0, 2, 0, 0, 1, 3
"d:\IDEWORK\lvmen\src\licensedcode\data\rules\false-positive_7049.yml", "YAML", 0, 0, 0, 2, 0, 0, 1, 3
"d:\IDEWORK\lvmen\src\licensedcode\data\rules\false-positive_705.yml", "YAML", 0, 0, 0, 2, 0, 0, 1, 3
"d:\IDEWORK\lvmen\src\licensedcode\data\rules\false-positive_7050.yml", "YAML", 0, 0, 0, 2, 0, 0, 1, 3
"d:\IDEWORK\lvmen\src\licensedcode\data\rules\false-positive_7051.yml", "YAML", 0, 0, 0, 2, 0, 0, 1, 3
"d:\IDEWORK\lvmen\src\licensedcode\data\rules\false-positive_7052.yml", "YAML", 0, 0, 0, 2, 0, 0, 1, 3
"d:\IDEWORK\lvmen\src\licensedcode\data\rules\false-positive_7053.yml", "YAML", 0, 0, 0, 2, 0, 0, 1, 3
"d:\IDEWORK\lvmen\src\licensedcode\data\rules\false-positive_7054.yml", "YAML", 0, 0, 0, 2, 0, 0, 1, 3
"d:\IDEWORK\lvmen\src\licensedcode\data\rules\false-positive_7055.yml", "YAML", 0, 0, 0, 2, 0, 0, 1, 3
"d:\IDEWORK\lvmen\src\licensedcode\data\rules\false-positive_7056.yml", "YAML", 0, 0, 0, 2, 0, 0, 1, 3
"d:\IDEWORK\lvmen\src\licensedcode\data\rules\false-positive_7057.yml", "YAML", 0, 0, 0, 2, 0, 0, 1, 3
"d:\IDEWORK\lvmen\src\licensedcode\data\rules\false-positive_7058.yml", "YAML", 0, 0, 0, 2, 0, 0, 1, 3
"d:\IDEWORK\lvmen\src\licensedcode\data\rules\false-positive_7059.yml", "YAML", 0, 0, 0, 2, 0, 0, 1, 3
"d:\IDEWORK\lvmen\src\licensedcode\data\rules\false-positive_706.yml", "YAML", 0, 0, 0, 2, 0, 0, 1, 3
"d:\IDEWORK\lvmen\src\licensedcode\data\rules\false-positive_7060.yml", "YAML", 0, 0, 0, 2, 0, 0, 1, 3
"d:\IDEWORK\lvmen\src\licensedcode\data\rules\false-positive_7061.yml", "YAML", 0, 0, 0, 2, 0, 0, 1, 3
"d:\IDEWORK\lvmen\src\licensedcode\data\rules\false-positive_7062.yml", "YAML", 0, 0, 0, 2, 0, 0, 1, 3
"d:\IDEWORK\lvmen\src\licensedcode\data\rules\false-positive_7063.yml", "YAML", 0, 0, 0, 2, 0, 0, 1, 3
"d:\IDEWORK\lvmen\src\licensedcode\data\rules\false-positive_7064.yml", "YAML", 0, 0, 0, 2, 0, 0, 1, 3
"d:\IDEWORK\lvmen\src\licensedcode\data\rules\false-positive_7065.yml", "YAML", 0, 0, 0, 2, 0, 0, 1, 3
"d:\IDEWORK\lvmen\src\licensedcode\data\rules\false-positive_7066.yml", "YAML", 0, 0, 0, 2, 0, 0, 1, 3
"d:\IDEWORK\lvmen\src\licensedcode\data\rules\false-positive_7067.yml", "YAML", 0, 0, 0, 2, 0, 0, 1, 3
"d:\IDEWORK\lvmen\src\licensedcode\data\rules\false-positive_7068.yml", "YAML", 0, 0, 0, 2, 0, 0, 1, 3
"d:\IDEWORK\lvmen\src\licensedcode\data\rules\false-positive_7069.yml", "YAML", 0, 0, 0, 2, 0, 0, 1, 3
"d:\IDEWORK\lvmen\src\licensedcode\data\rules\false-positive_707.yml", "YAML", 0, 0, 0, 2, 0, 0, 1, 3
"d:\IDEWORK\lvmen\src\licensedcode\data\rules\false-positive_7070.yml", "YAML", 0, 0, 0, 2, 0, 0, 1, 3
"d:\IDEWORK\lvmen\src\licensedcode\data\rules\false-positive_7071.yml", "YAML", 0, 0, 0, 2, 0, 0, 1, 3
"d:\IDEWORK\lvmen\src\licensedcode\data\rules\false-positive_7072.yml", "YAML", 0, 0, 0, 2, 0, 0, 1, 3
"d:\IDEWORK\lvmen\src\licensedcode\data\rules\false-positive_7073.yml", "YAML", 0, 0, 0, 2, 0, 0, 1, 3
"d:\IDEWORK\lvmen\src\licensedcode\data\rules\false-positive_7074.yml", "YAML", 0, 0, 0, 2, 0, 0, 1, 3
"d:\IDEWORK\lvmen\src\licensedcode\data\rules\false-positive_7075.yml", "YAML", 0, 0, 0, 2, 0, 0, 1, 3
"d:\IDEWORK\lvmen\src\licensedcode\data\rules\false-positive_7076.yml", "YAML", 0, 0, 0, 2, 0, 0, 1, 3
"d:\IDEWORK\lvmen\src\licensedcode\data\rules\false-positive_7077.yml", "YAML", 0, 0, 0, 2, 0, 0, 1, 3
"d:\IDEWORK\lvmen\src\licensedcode\data\rules\false-positive_7078.yml", "YAML", 0, 0, 0, 2, 0, 0, 1, 3
"d:\IDEWORK\lvmen\src\licensedcode\data\rules\false-positive_7079.yml", "YAML", 0, 0, 0, 2, 0, 0, 1, 3
"d:\IDEWORK\lvmen\src\licensedcode\data\rules\false-positive_708.yml", "YAML", 0, 0, 0, 2, 0, 0, 1, 3
"d:\IDEWORK\lvmen\src\licensedcode\data\rules\false-positive_7080.yml", "YAML", 0, 0, 0, 2, 0, 0, 1, 3
"d:\IDEWORK\lvmen\src\licensedcode\data\rules\false-positive_7081.yml", "YAML", 0, 0, 0, 2, 0, 0, 1, 3
"d:\IDEWORK\lvmen\src\licensedcode\data\rules\false-positive_7082.yml", "YAML", 0, 0, 0, 2, 0, 0, 1, 3
"d:\IDEWORK\lvmen\src\licensedcode\data\rules\false-positive_7083.yml", "YAML", 0, 0, 0, 2, 0, 0, 1, 3
"d:\IDEWORK\lvmen\src\licensedcode\data\rules\false-positive_7084.yml", "YAML", 0, 0, 0, 2, 0, 0, 1, 3
"d:\IDEWORK\lvmen\src\licensedcode\data\rules\false-positive_7085.yml", "YAML", 0, 0, 0, 2, 0, 0, 1, 3
"d:\IDEWORK\lvmen\src\licensedcode\data\rules\false-positive_7086.yml", "YAML", 0, 0, 0, 2, 0, 0, 1, 3
"d:\IDEWORK\lvmen\src\licensedcode\data\rules\false-positive_7087.yml", "YAML", 0, 0, 0, 2, 0, 0, 1, 3
"d:\IDEWORK\lvmen\src\licensedcode\data\rules\false-positive_7088.yml", "YAML", 0, 0, 0, 2, 0, 0, 1, 3
"d:\IDEWORK\lvmen\src\licensedcode\data\rules\false-positive_7089.yml", "YAML", 0, 0, 0, 2, 0, 0, 1, 3
"d:\IDEWORK\lvmen\src\licensedcode\data\rules\false-positive_709.yml", "YAML", 0, 0, 0, 2, 0, 0, 1, 3
"d:\IDEWORK\lvmen\src\licensedcode\data\rules\false-positive_7090.yml", "YAML", 0, 0, 0, 2, 0, 0, 1, 3
"d:\IDEWORK\lvmen\src\licensedcode\data\rules\false-positive_7091.yml", "YAML", 0, 0, 0, 2, 0, 0, 1, 3
"d:\IDEWORK\lvmen\src\licensedcode\data\rules\false-positive_7092.yml", "YAML", 0, 0, 0, 2, 0, 0, 1, 3
"d:\IDEWORK\lvmen\src\licensedcode\data\rules\false-positive_7093.yml", "YAML", 0, 0, 0, 2, 0, 0, 1, 3
"d:\IDEWORK\lvmen\src\licensedcode\data\rules\false-positive_7094.yml", "YAML", 0, 0, 0, 2, 0, 0, 1, 3
"d:\IDEWORK\lvmen\src\licensedcode\data\rules\false-positive_7095.yml", "YAML", 0, 0, 0, 2, 0, 0, 1, 3
"d:\IDEWORK\lvmen\src\licensedcode\data\rules\false-positive_7096.yml", "YAML", 0, 0, 0, 2, 0, 0, 1, 3
"d:\IDEWORK\lvmen\src\licensedcode\data\rules\false-positive_7097.yml", "YAML", 0, 0, 0, 2, 0, 0, 1, 3
"d:\IDEWORK\lvmen\src\licensedcode\data\rules\false-positive_7098.yml", "YAML", 0, 0, 0, 2, 0, 0, 1, 3
"d:\IDEWORK\lvmen\src\licensedcode\data\rules\false-positive_7099.yml", "YAML", 0, 0, 0, 2, 0, 0, 1, 3
"d:\IDEWORK\lvmen\src\licensedcode\data\rules\false-positive_71.yml", "YAML", 0, 0, 0, 3, 0, 0, 1, 4
"d:\IDEWORK\lvmen\src\licensedcode\data\rules\false-positive_710.yml", "YAML", 0, 0, 0, 2, 0, 0, 1, 3
"d:\IDEWORK\lvmen\src\licensedcode\data\rules\false-positive_7100.yml", "YAML", 0, 0, 0, 2, 0, 0, 1, 3
"d:\IDEWORK\lvmen\src\licensedcode\data\rules\false-positive_7101.yml", "YAML", 0, 0, 0, 2, 0, 0, 1, 3
"d:\IDEWORK\lvmen\src\licensedcode\data\rules\false-positive_7102.yml", "YAML", 0, 0, 0, 2, 0, 0, 1, 3
"d:\IDEWORK\lvmen\src\licensedcode\data\rules\false-positive_7103.yml", "YAML", 0, 0, 0, 2, 0, 0, 1, 3
"d:\IDEWORK\lvmen\src\licensedcode\data\rules\false-positive_7104.yml", "YAML", 0, 0, 0, 2, 0, 0, 1, 3
"d:\IDEWORK\lvmen\src\licensedcode\data\rules\false-positive_7105.yml", "YAML", 0, 0, 0, 2, 0, 0, 1, 3
"d:\IDEWORK\lvmen\src\licensedcode\data\rules\false-positive_7106.yml", "YAML", 0, 0, 0, 2, 0, 0, 1, 3
"d:\IDEWORK\lvmen\src\licensedcode\data\rules\false-positive_7107.yml", "YAML", 0, 0, 0, 2, 0, 0, 1, 3
"d:\IDEWORK\lvmen\src\licensedcode\data\rules\false-positive_7108.yml", "YAML", 0, 0, 0, 2, 0, 0, 1, 3
"d:\IDEWORK\lvmen\src\licensedcode\data\rules\false-positive_7109.yml", "YAML", 0, 0, 0, 2, 0, 0, 1, 3
"d:\IDEWORK\lvmen\src\licensedcode\data\rules\false-positive_711.yml", "YAML", 0, 0, 0, 2, 0, 0, 1, 3
"d:\IDEWORK\lvmen\src\licensedcode\data\rules\false-positive_7110.yml", "YAML", 0, 0, 0, 2, 0, 0, 1, 3
"d:\IDEWORK\lvmen\src\licensedcode\data\rules\false-positive_7111.yml", "YAML", 0, 0, 0, 2, 0, 0, 1, 3
"d:\IDEWORK\lvmen\src\licensedcode\data\rules\false-positive_7112.yml", "YAML", 0, 0, 0, 2, 0, 0, 1, 3
"d:\IDEWORK\lvmen\src\licensedcode\data\rules\false-positive_7113.yml", "YAML", 0, 0, 0, 2, 0, 0, 1, 3
"d:\IDEWORK\lvmen\src\licensedcode\data\rules\false-positive_7114.yml", "YAML", 0, 0, 0, 2, 0, 0, 1, 3
"d:\IDEWORK\lvmen\src\licensedcode\data\rules\false-positive_7115.yml", "YAML", 0, 0, 0, 2, 0, 0, 1, 3
"d:\IDEWORK\lvmen\src\licensedcode\data\rules\false-positive_7116.yml", "YAML", 0, 0, 0, 2, 0, 0, 1, 3
"d:\IDEWORK\lvmen\src\licensedcode\data\rules\false-positive_7117.yml", "YAML", 0, 0, 0, 2, 0, 0, 1, 3
"d:\IDEWORK\lvmen\src\licensedcode\data\rules\false-positive_7118.yml", "YAML", 0, 0, 0, 2, 0, 0, 1, 3
"d:\IDEWORK\lvmen\src\licensedcode\data\rules\false-positive_7119.yml", "YAML", 0, 0, 0, 2, 0, 0, 1, 3
"d:\IDEWORK\lvmen\src\licensedcode\data\rules\false-positive_712.yml", "YAML", 0, 0, 0, 2, 0, 0, 1, 3
"d:\IDEWORK\lvmen\src\licensedcode\data\rules\false-positive_7120.yml", "YAML", 0, 0, 0, 2, 0, 0, 1, 3
"d:\IDEWORK\lvmen\src\licensedcode\data\rules\false-positive_7121.yml", "YAML", 0, 0, 0, 2, 0, 0, 1, 3
"d:\IDEWORK\lvmen\src\licensedcode\data\rules\false-positive_7122.yml", "YAML", 0, 0, 0, 2, 0, 0, 1, 3
"d:\IDEWORK\lvmen\src\licensedcode\data\rules\false-positive_7123.yml", "YAML", 0, 0, 0, 2, 0, 0, 1, 3
"d:\IDEWORK\lvmen\src\licensedcode\data\rules\false-positive_7124.yml", "YAML", 0, 0, 0, 2, 0, 0, 1, 3
"d:\IDEWORK\lvmen\src\licensedcode\data\rules\false-positive_7125.yml", "YAML", 0, 0, 0, 2, 0, 0, 1, 3
"d:\IDEWORK\lvmen\src\licensedcode\data\rules\false-positive_7126.yml", "YAML", 0, 0, 0, 2, 0, 0, 1, 3
"d:\IDEWORK\lvmen\src\licensedcode\data\rules\false-positive_7127.yml", "YAML", 0, 0, 0, 2, 0, 0, 1, 3
"d:\IDEWORK\lvmen\src\licensedcode\data\rules\false-positive_7128.yml", "YAML", 0, 0, 0, 2, 0, 0, 1, 3
"d:\IDEWORK\lvmen\src\licensedcode\data\rules\false-positive_7129.yml", "YAML", 0, 0, 0, 2, 0, 0, 1, 3
"d:\IDEWORK\lvmen\src\licensedcode\data\rules\false-positive_713.yml", "YAML", 0, 0, 0, 2, 0, 0, 1, 3
"d:\IDEWORK\lvmen\src\licensedcode\data\rules\false-positive_7130.yml", "YAML", 0, 0, 0, 2, 0, 0, 1, 3
"d:\IDEWORK\lvmen\src\licensedcode\data\rules\false-positive_7131.yml", "YAML", 0, 0, 0, 2, 0, 0, 1, 3
"d:\IDEWORK\lvmen\src\licensedcode\data\rules\false-positive_7132.yml", "YAML", 0, 0, 0, 2, 0, 0, 1, 3
"d:\IDEWORK\lvmen\src\licensedcode\data\rules\false-positive_7133.yml", "YAML", 0, 0, 0, 2, 0, 0, 1, 3
"d:\IDEWORK\lvmen\src\licensedcode\data\rules\false-positive_7134.yml", "YAML", 0, 0, 0, 2, 0, 0, 1, 3
"d:\IDEWORK\lvmen\src\licensedcode\data\rules\false-positive_7135.yml", "YAML", 0, 0, 0, 2, 0, 0, 1, 3
"d:\IDEWORK\lvmen\src\licensedcode\data\rules\false-positive_7136.yml", "YAML", 0, 0, 0, 2, 0, 0, 1, 3
"d:\IDEWORK\lvmen\src\licensedcode\data\rules\false-positive_7137.yml", "YAML", 0, 0, 0, 2, 0, 0, 1, 3
"d:\IDEWORK\lvmen\src\licensedcode\data\rules\false-positive_7138.yml", "YAML", 0, 0, 0, 2, 0, 0, 1, 3
"d:\IDEWORK\lvmen\src\licensedcode\data\rules\false-positive_7139.yml", "YAML", 0, 0, 0, 2, 0, 0, 1, 3
"d:\IDEWORK\lvmen\src\licensedcode\data\rules\false-positive_714.yml", "YAML", 0, 0, 0, 2, 0, 0, 1, 3
"d:\IDEWORK\lvmen\src\licensedcode\data\rules\false-positive_7140.yml", "YAML", 0, 0, 0, 2, 0, 0, 1, 3
"d:\IDEWORK\lvmen\src\licensedcode\data\rules\false-positive_7141.yml", "YAML", 0, 0, 0, 2, 0, 0, 1, 3
"d:\IDEWORK\lvmen\src\licensedcode\data\rules\false-positive_7142.yml", "YAML", 0, 0, 0, 2, 0, 0, 1, 3
"d:\IDEWORK\lvmen\src\licensedcode\data\rules\false-positive_7143.yml", "YAML", 0, 0, 0, 2, 0, 0, 1, 3
"d:\IDEWORK\lvmen\src\licensedcode\data\rules\false-positive_7144.yml", "YAML", 0, 0, 0, 2, 0, 0, 1, 3
"d:\IDEWORK\lvmen\src\licensedcode\data\rules\false-positive_7145.yml", "YAML", 0, 0, 0, 2, 0, 0, 1, 3
"d:\IDEWORK\lvmen\src\licensedcode\data\rules\false-positive_7146.yml", "YAML", 0, 0, 0, 2, 0, 0, 1, 3
"d:\IDEWORK\lvmen\src\licensedcode\data\rules\false-positive_7147.yml", "YAML", 0, 0, 0, 2, 0, 0, 1, 3
"d:\IDEWORK\lvmen\src\licensedcode\data\rules\false-positive_7148.yml", "YAML", 0, 0, 0, 2, 0, 0, 1, 3
"d:\IDEWORK\lvmen\src\licensedcode\data\rules\false-positive_7149.yml", "YAML", 0, 0, 0, 2, 0, 0, 1, 3
"d:\IDEWORK\lvmen\src\licensedcode\data\rules\false-positive_715.yml", "YAML", 0, 0, 0, 2, 0, 0, 1, 3
"d:\IDEWORK\lvmen\src\licensedcode\data\rules\false-positive_7150.yml", "YAML", 0, 0, 0, 2, 0, 0, 1, 3
"d:\IDEWORK\lvmen\src\licensedcode\data\rules\false-positive_7151.yml", "YAML", 0, 0, 0, 2, 0, 0, 1, 3
"d:\IDEWORK\lvmen\src\licensedcode\data\rules\false-positive_7152.yml", "YAML", 0, 0, 0, 2, 0, 0, 1, 3
"d:\IDEWORK\lvmen\src\licensedcode\data\rules\false-positive_7153.yml", "YAML", 0, 0, 0, 2, 0, 0, 1, 3
"d:\IDEWORK\lvmen\src\licensedcode\data\rules\false-positive_7154.yml", "YAML", 0, 0, 0, 2, 0, 0, 1, 3
"d:\IDEWORK\lvmen\src\licensedcode\data\rules\false-positive_7155.yml", "YAML", 0, 0, 0, 2, 0, 0, 1, 3
"d:\IDEWORK\lvmen\src\licensedcode\data\rules\false-positive_7156.yml", "YAML", 0, 0, 0, 2, 0, 0, 1, 3
"d:\IDEWORK\lvmen\src\licensedcode\data\rules\false-positive_7157.yml", "YAML", 0, 0, 0, 2, 0, 0, 1, 3
"d:\IDEWORK\lvmen\src\licensedcode\data\rules\false-positive_7158.yml", "YAML", 0, 0, 0, 2, 0, 0, 1, 3
"d:\IDEWORK\lvmen\src\licensedcode\data\rules\false-positive_7159.yml", "YAML", 0, 0, 0, 2, 0, 0, 1, 3
"d:\IDEWORK\lvmen\src\licensedcode\data\rules\false-positive_716.yml", "YAML", 0, 0, 0, 2, 0, 0, 1, 3
"d:\IDEWORK\lvmen\src\licensedcode\data\rules\false-positive_7160.yml", "YAML", 0, 0, 0, 2, 0, 0, 1, 3
"d:\IDEWORK\lvmen\src\licensedcode\data\rules\false-positive_7161.yml", "YAML", 0, 0, 0, 2, 0, 0, 1, 3
"d:\IDEWORK\lvmen\src\licensedcode\data\rules\false-positive_7162.yml", "YAML", 0, 0, 0, 2, 0, 0, 1, 3
"d:\IDEWORK\lvmen\src\licensedcode\data\rules\false-positive_7163.yml", "YAML", 0, 0, 0, 2, 0, 0, 1, 3
"d:\IDEWORK\lvmen\src\licensedcode\data\rules\false-positive_7164.yml", "YAML", 0, 0, 0, 2, 0, 0, 1, 3
"d:\IDEWORK\lvmen\src\licensedcode\data\rules\false-positive_7165.yml", "YAML", 0, 0, 0, 2, 0, 0, 1, 3
"d:\IDEWORK\lvmen\src\licensedcode\data\rules\false-positive_7166.yml", "YAML", 0, 0, 0, 2, 0, 0, 1, 3
"d:\IDEWORK\lvmen\src\licensedcode\data\rules\false-positive_7167.yml", "YAML", 0, 0, 0, 2, 0, 0, 1, 3
"d:\IDEWORK\lvmen\src\licensedcode\data\rules\false-positive_7168.yml", "YAML", 0, 0, 0, 2, 0, 0, 1, 3
"d:\IDEWORK\lvmen\src\licensedcode\data\rules\false-positive_7169.yml", "YAML", 0, 0, 0, 2, 0, 0, 1, 3
"d:\IDEWORK\lvmen\src\licensedcode\data\rules\false-positive_717.yml", "YAML", 0, 0, 0, 2, 0, 0, 1, 3
"d:\IDEWORK\lvmen\src\licensedcode\data\rules\false-positive_7170.yml", "YAML", 0, 0, 0, 2, 0, 0, 1, 3
"d:\IDEWORK\lvmen\src\licensedcode\data\rules\false-positive_7171.yml", "YAML", 0, 0, 0, 2, 0, 0, 1, 3
"d:\IDEWORK\lvmen\src\licensedcode\data\rules\false-positive_7172.yml", "YAML", 0, 0, 0, 2, 0, 0, 1, 3
"d:\IDEWORK\lvmen\src\licensedcode\data\rules\false-positive_7173.yml", "YAML", 0, 0, 0, 2, 0, 0, 1, 3
"d:\IDEWORK\lvmen\src\licensedcode\data\rules\false-positive_7174.yml", "YAML", 0, 0, 0, 2, 0, 0, 1, 3
"d:\IDEWORK\lvmen\src\licensedcode\data\rules\false-positive_7175.yml", "YAML", 0, 0, 0, 2, 0, 0, 1, 3
"d:\IDEWORK\lvmen\src\licensedcode\data\rules\false-positive_7176.yml", "YAML", 0, 0, 0, 2, 0, 0, 1, 3
"d:\IDEWORK\lvmen\src\licensedcode\data\rules\false-positive_7177.yml", "YAML", 0, 0, 0, 2, 0, 0, 1, 3
"d:\IDEWORK\lvmen\src\licensedcode\data\rules\false-positive_7178.yml", "YAML", 0, 0, 0, 2, 0, 0, 1, 3
"d:\IDEWORK\lvmen\src\licensedcode\data\rules\false-positive_7179.yml", "YAML", 0, 0, 0, 2, 0, 0, 1, 3
"d:\IDEWORK\lvmen\src\licensedcode\data\rules\false-positive_718.yml", "YAML", 0, 0, 0, 2, 0, 0, 1, 3
"d:\IDEWORK\lvmen\src\licensedcode\data\rules\false-positive_7180.yml", "YAML", 0, 0, 0, 2, 0, 0, 1, 3
"d:\IDEWORK\lvmen\src\licensedcode\data\rules\false-positive_7181.yml", "YAML", 0, 0, 0, 2, 0, 0, 1, 3
"d:\IDEWORK\lvmen\src\licensedcode\data\rules\false-positive_7182.yml", "YAML", 0, 0, 0, 2, 0, 0, 1, 3
"d:\IDEWORK\lvmen\src\licensedcode\data\rules\false-positive_7183.yml", "YAML", 0, 0, 0, 2, 0, 0, 1, 3
"d:\IDEWORK\lvmen\src\licensedcode\data\rules\false-positive_7184.yml", "YAML", 0, 0, 0, 2, 0, 0, 1, 3
"d:\IDEWORK\lvmen\src\licensedcode\data\rules\false-positive_7185.yml", "YAML", 0, 0, 0, 2, 0, 0, 1, 3
"d:\IDEWORK\lvmen\src\licensedcode\data\rules\false-positive_7186.yml", "YAML", 0, 0, 0, 2, 0, 0, 1, 3
"d:\IDEWORK\lvmen\src\licensedcode\data\rules\false-positive_7187.yml", "YAML", 0, 0, 0, 2, 0, 0, 1, 3
"d:\IDEWORK\lvmen\src\licensedcode\data\rules\false-positive_7188.yml", "YAML", 0, 0, 0, 2, 0, 0, 1, 3
"d:\IDEWORK\lvmen\src\licensedcode\data\rules\false-positive_7189.yml", "YAML", 0, 0, 0, 2, 0, 0, 1, 3
"d:\IDEWORK\lvmen\src\licensedcode\data\rules\false-positive_719.yml", "YAML", 0, 0, 0, 2, 0, 0, 1, 3
"d:\IDEWORK\lvmen\src\licensedcode\data\rules\false-positive_7190.yml", "YAML", 0, 0, 0, 2, 0, 0, 1, 3
"d:\IDEWORK\lvmen\src\licensedcode\data\rules\false-positive_7191.yml", "YAML", 0, 0, 0, 2, 0, 0, 1, 3
"d:\IDEWORK\lvmen\src\licensedcode\data\rules\false-positive_7192.yml", "YAML", 0, 0, 0, 2, 0, 0, 1, 3
"d:\IDEWORK\lvmen\src\licensedcode\data\rules\false-positive_7193.yml", "YAML", 0, 0, 0, 2, 0, 0, 1, 3
"d:\IDEWORK\lvmen\src\licensedcode\data\rules\false-positive_7194.yml", "YAML", 0, 0, 0, 2, 0, 0, 1, 3
"d:\IDEWORK\lvmen\src\licensedcode\data\rules\false-positive_7195.yml", "YAML", 0, 0, 0, 2, 0, 0, 1, 3
"d:\IDEWORK\lvmen\src\licensedcode\data\rules\false-positive_7196.yml", "YAML", 0, 0, 0, 2, 0, 0, 1, 3
"d:\IDEWORK\lvmen\src\licensedcode\data\rules\false-positive_7197.yml", "YAML", 0, 0, 0, 2, 0, 0, 1, 3
"d:\IDEWORK\lvmen\src\licensedcode\data\rules\false-positive_7198.yml", "YAML", 0, 0, 0, 2, 0, 0, 1, 3
"d:\IDEWORK\lvmen\src\licensedcode\data\rules\false-positive_7199.yml", "YAML", 0, 0, 0, 2, 0, 0, 1, 3
"d:\IDEWORK\lvmen\src\licensedcode\data\rules\false-positive_72.yml", "YAML", 0, 0, 0, 3, 0, 0, 1, 4
"d:\IDEWORK\lvmen\src\licensedcode\data\rules\false-positive_720.yml", "YAML", 0, 0, 0, 2, 0, 0, 1, 3
"d:\IDEWORK\lvmen\src\licensedcode\data\rules\false-positive_7200.yml", "YAML", 0, 0, 0, 2, 0, 0, 1, 3
"d:\IDEWORK\lvmen\src\licensedcode\data\rules\false-positive_7201.yml", "YAML", 0, 0, 0, 2, 0, 0, 1, 3
"d:\IDEWORK\lvmen\src\licensedcode\data\rules\false-positive_7202.yml", "YAML", 0, 0, 0, 2, 0, 0, 1, 3
"d:\IDEWORK\lvmen\src\licensedcode\data\rules\false-positive_7203.yml", "YAML", 0, 0, 0, 2, 0, 0, 1, 3
"d:\IDEWORK\lvmen\src\licensedcode\data\rules\false-positive_7204.yml", "YAML", 0, 0, 0, 2, 0, 0, 1, 3
"d:\IDEWORK\lvmen\src\licensedcode\data\rules\false-positive_7205.yml", "YAML", 0, 0, 0, 2, 0, 0, 1, 3
"d:\IDEWORK\lvmen\src\licensedcode\data\rules\false-positive_7206.yml", "YAML", 0, 0, 0, 2, 0, 0, 1, 3
"d:\IDEWORK\lvmen\src\licensedcode\data\rules\false-positive_7207.yml", "YAML", 0, 0, 0, 2, 0, 0, 1, 3
"d:\IDEWORK\lvmen\src\licensedcode\data\rules\false-positive_7208.yml", "YAML", 0, 0, 0, 2, 0, 0, 1, 3
"d:\IDEWORK\lvmen\src\licensedcode\data\rules\false-positive_7209.yml", "YAML", 0, 0, 0, 2, 0, 0, 1, 3
"d:\IDEWORK\lvmen\src\licensedcode\data\rules\false-positive_721.yml", "YAML", 0, 0, 0, 2, 0, 0, 1, 3
"d:\IDEWORK\lvmen\src\licensedcode\data\rules\false-positive_7210.yml", "YAML", 0, 0, 0, 2, 0, 0, 1, 3
"d:\IDEWORK\lvmen\src\licensedcode\data\rules\false-positive_7211.yml", "YAML", 0, 0, 0, 2, 0, 0, 1, 3
"d:\IDEWORK\lvmen\src\licensedcode\data\rules\false-positive_7212.yml", "YAML", 0, 0, 0, 2, 0, 0, 1, 3
"d:\IDEWORK\lvmen\src\licensedcode\data\rules\false-positive_7213.yml", "YAML", 0, 0, 0, 2, 0, 0, 1, 3
"d:\IDEWORK\lvmen\src\licensedcode\data\rules\false-positive_7214.yml", "YAML", 0, 0, 0, 2, 0, 0, 1, 3
"d:\IDEWORK\lvmen\src\licensedcode\data\rules\false-positive_7215.yml", "YAML", 0, 0, 0, 2, 0, 0, 1, 3
"d:\IDEWORK\lvmen\src\licensedcode\data\rules\false-positive_7216.yml", "YAML", 0, 0, 0, 2, 0, 0, 1, 3
"d:\IDEWORK\lvmen\src\licensedcode\data\rules\false-positive_7217.yml", "YAML", 0, 0, 0, 2, 0, 0, 1, 3
"d:\IDEWORK\lvmen\src\licensedcode\data\rules\false-positive_7218.yml", "YAML", 0, 0, 0, 2, 0, 0, 1, 3
"d:\IDEWORK\lvmen\src\licensedcode\data\rules\false-positive_7219.yml", "YAML", 0, 0, 0, 2, 0, 0, 1, 3
"d:\IDEWORK\lvmen\src\licensedcode\data\rules\false-positive_722.yml", "YAML", 0, 0, 0, 2, 0, 0, 1, 3
"d:\IDEWORK\lvmen\src\licensedcode\data\rules\false-positive_7220.yml", "YAML", 0, 0, 0, 2, 0, 0, 1, 3
"d:\IDEWORK\lvmen\src\licensedcode\data\rules\false-positive_7221.yml", "YAML", 0, 0, 0, 2, 0, 0, 1, 3
"d:\IDEWORK\lvmen\src\licensedcode\data\rules\false-positive_7222.yml", "YAML", 0, 0, 0, 2, 0, 0, 1, 3
"d:\IDEWORK\lvmen\src\licensedcode\data\rules\false-positive_7223.yml", "YAML", 0, 0, 0, 2, 0, 0, 1, 3
"d:\IDEWORK\lvmen\src\licensedcode\data\rules\false-positive_7224.yml", "YAML", 0, 0, 0, 2, 0, 0, 1, 3
"d:\IDEWORK\lvmen\src\licensedcode\data\rules\false-positive_7225.yml", "YAML", 0, 0, 0, 2, 0, 0, 1, 3
"d:\IDEWORK\lvmen\src\licensedcode\data\rules\false-positive_7226.yml", "YAML", 0, 0, 0, 2, 0, 0, 1, 3
"d:\IDEWORK\lvmen\src\licensedcode\data\rules\false-positive_7227.yml", "YAML", 0, 0, 0, 2, 0, 0, 1, 3
"d:\IDEWORK\lvmen\src\licensedcode\data\rules\false-positive_7228.yml", "YAML", 0, 0, 0, 2, 0, 0, 1, 3
"d:\IDEWORK\lvmen\src\licensedcode\data\rules\false-positive_7229.yml", "YAML", 0, 0, 0, 2, 0, 0, 1, 3
"d:\IDEWORK\lvmen\src\licensedcode\data\rules\false-positive_723.yml", "YAML", 0, 0, 0, 2, 0, 0, 1, 3
"d:\IDEWORK\lvmen\src\licensedcode\data\rules\false-positive_7230.yml", "YAML", 0, 0, 0, 2, 0, 0, 1, 3
"d:\IDEWORK\lvmen\src\licensedcode\data\rules\false-positive_7231.yml", "YAML", 0, 0, 0, 2, 0, 0, 1, 3
"d:\IDEWORK\lvmen\src\licensedcode\data\rules\false-positive_7232.yml", "YAML", 0, 0, 0, 2, 0, 0, 1, 3
"d:\IDEWORK\lvmen\src\licensedcode\data\rules\false-positive_7233.yml", "YAML", 0, 0, 0, 2, 0, 0, 1, 3
"d:\IDEWORK\lvmen\src\licensedcode\data\rules\false-positive_7234.yml", "YAML", 0, 0, 0, 2, 0, 0, 1, 3
"d:\IDEWORK\lvmen\src\licensedcode\data\rules\false-positive_7235.yml", "YAML", 0, 0, 0, 2, 0, 0, 1, 3
"d:\IDEWORK\lvmen\src\licensedcode\data\rules\false-positive_7236.yml", "YAML", 0, 0, 0, 2, 0, 0, 1, 3
"d:\IDEWORK\lvmen\src\licensedcode\data\rules\false-positive_7237.yml", "YAML", 0, 0, 0, 2, 0, 0, 1, 3
"d:\IDEWORK\lvmen\src\licensedcode\data\rules\false-positive_7238.yml", "YAML", 0, 0, 0, 2, 0, 0, 1, 3
"d:\IDEWORK\lvmen\src\licensedcode\data\rules\false-positive_7239.yml", "YAML", 0, 0, 0, 2, 0, 0, 1, 3
"d:\IDEWORK\lvmen\src\licensedcode\data\rules\false-positive_724.yml", "YAML", 0, 0, 0, 2, 0, 0, 1, 3
"d:\IDEWORK\lvmen\src\licensedcode\data\rules\false-positive_7240.yml", "YAML", 0, 0, 0, 2, 0, 0, 1, 3
"d:\IDEWORK\lvmen\src\licensedcode\data\rules\false-positive_7241.yml", "YAML", 0, 0, 0, 2, 0, 0, 1, 3
"d:\IDEWORK\lvmen\src\licensedcode\data\rules\false-positive_7242.yml", "YAML", 0, 0, 0, 2, 0, 0, 1, 3
"d:\IDEWORK\lvmen\src\licensedcode\data\rules\false-positive_7243.yml", "YAML", 0, 0, 0, 2, 0, 0, 1, 3
"d:\IDEWORK\lvmen\src\licensedcode\data\rules\false-positive_7244.yml", "YAML", 0, 0, 0, 2, 0, 0, 1, 3
"d:\IDEWORK\lvmen\src\licensedcode\data\rules\false-positive_7245.yml", "YAML", 0, 0, 0, 2, 0, 0, 1, 3
"d:\IDEWORK\lvmen\src\licensedcode\data\rules\false-positive_7246.yml", "YAML", 0, 0, 0, 2, 0, 0, 1, 3
"d:\IDEWORK\lvmen\src\licensedcode\data\rules\false-positive_7247.yml", "YAML", 0, 0, 0, 2, 0, 0, 1, 3
"d:\IDEWORK\lvmen\src\licensedcode\data\rules\false-positive_7248.yml", "YAML", 0, 0, 0, 2, 0, 0, 1, 3
"d:\IDEWORK\lvmen\src\licensedcode\data\rules\false-positive_7249.yml", "YAML", 0, 0, 0, 2, 0, 0, 1, 3
"d:\IDEWORK\lvmen\src\licensedcode\data\rules\false-positive_725.yml", "YAML", 0, 0, 0, 2, 0, 0, 1, 3
"d:\IDEWORK\lvmen\src\licensedcode\data\rules\false-positive_7250.yml", "YAML", 0, 0, 0, 2, 0, 0, 1, 3
"d:\IDEWORK\lvmen\src\licensedcode\data\rules\false-positive_7251.yml", "YAML", 0, 0, 0, 2, 0, 0, 1, 3
"d:\IDEWORK\lvmen\src\licensedcode\data\rules\false-positive_7252.yml", "YAML", 0, 0, 0, 2, 0, 0, 1, 3
"d:\IDEWORK\lvmen\src\licensedcode\data\rules\false-positive_7253.yml", "YAML", 0, 0, 0, 2, 0, 0, 1, 3
"d:\IDEWORK\lvmen\src\licensedcode\data\rules\false-positive_7254.yml", "YAML", 0, 0, 0, 2, 0, 0, 1, 3
"d:\IDEWORK\lvmen\src\licensedcode\data\rules\false-positive_7255.yml", "YAML", 0, 0, 0, 2, 0, 0, 1, 3
"d:\IDEWORK\lvmen\src\licensedcode\data\rules\false-positive_7256.yml", "YAML", 0, 0, 0, 2, 0, 0, 1, 3
"d:\IDEWORK\lvmen\src\licensedcode\data\rules\false-positive_7257.yml", "YAML", 0, 0, 0, 2, 0, 0, 1, 3
"d:\IDEWORK\lvmen\src\licensedcode\data\rules\false-positive_7258.yml", "YAML", 0, 0, 0, 2, 0, 0, 1, 3
"d:\IDEWORK\lvmen\src\licensedcode\data\rules\false-positive_7259.yml", "YAML", 0, 0, 0, 2, 0, 0, 1, 3
"d:\IDEWORK\lvmen\src\licensedcode\data\rules\false-positive_726.yml", "YAML", 0, 0, 0, 2, 0, 0, 1, 3
"d:\IDEWORK\lvmen\src\licensedcode\data\rules\false-positive_7260.yml", "YAML", 0, 0, 0, 2, 0, 0, 1, 3
"d:\IDEWORK\lvmen\src\licensedcode\data\rules\false-positive_7261.yml", "YAML", 0, 0, 0, 2, 0, 0, 1, 3
"d:\IDEWORK\lvmen\src\licensedcode\data\rules\false-positive_7262.yml", "YAML", 0, 0, 0, 2, 0, 0, 1, 3
"d:\IDEWORK\lvmen\src\licensedcode\data\rules\false-positive_7263.yml", "YAML", 0, 0, 0, 2, 0, 0, 1, 3
"d:\IDEWORK\lvmen\src\licensedcode\data\rules\false-positive_7264.yml", "YAML", 0, 0, 0, 2, 0, 0, 1, 3
"d:\IDEWORK\lvmen\src\licensedcode\data\rules\false-positive_7265.yml", "YAML", 0, 0, 0, 2, 0, 0, 1, 3
"d:\IDEWORK\lvmen\src\licensedcode\data\rules\false-positive_7266.yml", "YAML", 0, 0, 0, 2, 0, 0, 1, 3
"d:\IDEWORK\lvmen\src\licensedcode\data\rules\false-positive_7267.yml", "YAML", 0, 0, 0, 2, 0, 0, 1, 3
"d:\IDEWORK\lvmen\src\licensedcode\data\rules\false-positive_7268.yml", "YAML", 0, 0, 0, 2, 0, 0, 1, 3
"d:\IDEWORK\lvmen\src\licensedcode\data\rules\false-positive_7269.yml", "YAML", 0, 0, 0, 2, 0, 0, 1, 3
"d:\IDEWORK\lvmen\src\licensedcode\data\rules\false-positive_727.yml", "YAML", 0, 0, 0, 2, 0, 0, 1, 3
"d:\IDEWORK\lvmen\src\licensedcode\data\rules\false-positive_7270.yml", "YAML", 0, 0, 0, 2, 0, 0, 1, 3
"d:\IDEWORK\lvmen\src\licensedcode\data\rules\false-positive_7271.yml", "YAML", 0, 0, 0, 2, 0, 0, 1, 3
"d:\IDEWORK\lvmen\src\licensedcode\data\rules\false-positive_7272.yml", "YAML", 0, 0, 0, 2, 0, 0, 1, 3
"d:\IDEWORK\lvmen\src\licensedcode\data\rules\false-positive_7273.yml", "YAML", 0, 0, 0, 2, 0, 0, 1, 3
"d:\IDEWORK\lvmen\src\licensedcode\data\rules\false-positive_7274.yml", "YAML", 0, 0, 0, 2, 0, 0, 1, 3
"d:\IDEWORK\lvmen\src\licensedcode\data\rules\false-positive_7275.yml", "YAML", 0, 0, 0, 2, 0, 0, 1, 3
"d:\IDEWORK\lvmen\src\licensedcode\data\rules\false-positive_7276.yml", "YAML", 0, 0, 0, 2, 0, 0, 1, 3
"d:\IDEWORK\lvmen\src\licensedcode\data\rules\false-positive_7277.yml", "YAML", 0, 0, 0, 2, 0, 0, 1, 3
"d:\IDEWORK\lvmen\src\licensedcode\data\rules\false-positive_7278.yml", "YAML", 0, 0, 0, 2, 0, 0, 1, 3
"d:\IDEWORK\lvmen\src\licensedcode\data\rules\false-positive_7279.yml", "YAML", 0, 0, 0, 2, 0, 0, 1, 3
"d:\IDEWORK\lvmen\src\licensedcode\data\rules\false-positive_728.yml", "YAML", 0, 0, 0, 2, 0, 0, 1, 3
"d:\IDEWORK\lvmen\src\licensedcode\data\rules\false-positive_7280.yml", "YAML", 0, 0, 0, 2, 0, 0, 1, 3
"d:\IDEWORK\lvmen\src\licensedcode\data\rules\false-positive_7281.yml", "YAML", 0, 0, 0, 2, 0, 0, 1, 3
"d:\IDEWORK\lvmen\src\licensedcode\data\rules\false-positive_7282.yml", "YAML", 0, 0, 0, 2, 0, 0, 1, 3
"d:\IDEWORK\lvmen\src\licensedcode\data\rules\false-positive_7283.yml", "YAML", 0, 0, 0, 2, 0, 0, 1, 3
"d:\IDEWORK\lvmen\src\licensedcode\data\rules\false-positive_7284.yml", "YAML", 0, 0, 0, 2, 0, 0, 1, 3
"d:\IDEWORK\lvmen\src\licensedcode\data\rules\false-positive_7285.yml", "YAML", 0, 0, 0, 2, 0, 0, 1, 3
"d:\IDEWORK\lvmen\src\licensedcode\data\rules\false-positive_7286.yml", "YAML", 0, 0, 0, 2, 0, 0, 1, 3
"d:\IDEWORK\lvmen\src\licensedcode\data\rules\false-positive_7287.yml", "YAML", 0, 0, 0, 2, 0, 0, 1, 3
"d:\IDEWORK\lvmen\src\licensedcode\data\rules\false-positive_7288.yml", "YAML", 0, 0, 0, 2, 0, 0, 1, 3
"d:\IDEWORK\lvmen\src\licensedcode\data\rules\false-positive_7289.yml", "YAML", 0, 0, 0, 2, 0, 0, 1, 3
"d:\IDEWORK\lvmen\src\licensedcode\data\rules\false-positive_729.yml", "YAML", 0, 0, 0, 2, 0, 0, 1, 3
"d:\IDEWORK\lvmen\src\licensedcode\data\rules\false-positive_7290.yml", "YAML", 0, 0, 0, 2, 0, 0, 1, 3
"d:\IDEWORK\lvmen\src\licensedcode\data\rules\false-positive_7291.yml", "YAML", 0, 0, 0, 2, 0, 0, 1, 3
"d:\IDEWORK\lvmen\src\licensedcode\data\rules\false-positive_7292.yml", "YAML", 0, 0, 0, 2, 0, 0, 1, 3
"d:\IDEWORK\lvmen\src\licensedcode\data\rules\false-positive_7293.yml", "YAML", 0, 0, 0, 2, 0, 0, 1, 3
"d:\IDEWORK\lvmen\src\licensedcode\data\rules\false-positive_7294.yml", "YAML", 0, 0, 0, 2, 0, 0, 1, 3
"d:\IDEWORK\lvmen\src\licensedcode\data\rules\false-positive_7295.yml", "YAML", 0, 0, 0, 2, 0, 0, 1, 3
"d:\IDEWORK\lvmen\src\licensedcode\data\rules\false-positive_7296.yml", "YAML", 0, 0, 0, 2, 0, 0, 1, 3
"d:\IDEWORK\lvmen\src\licensedcode\data\rules\false-positive_7297.yml", "YAML", 0, 0, 0, 2, 0, 0, 1, 3
"d:\IDEWORK\lvmen\src\licensedcode\data\rules\false-positive_7298.yml", "YAML", 0, 0, 0, 2, 0, 0, 1, 3
"d:\IDEWORK\lvmen\src\licensedcode\data\rules\false-positive_7299.yml", "YAML", 0, 0, 0, 2, 0, 0, 1, 3
"d:\IDEWORK\lvmen\src\licensedcode\data\rules\false-positive_73.yml", "YAML", 0, 0, 0, 3, 0, 0, 1, 4
"d:\IDEWORK\lvmen\src\licensedcode\data\rules\false-positive_730.yml", "YAML", 0, 0, 0, 2, 0, 0, 1, 3
"d:\IDEWORK\lvmen\src\licensedcode\data\rules\false-positive_7300.yml", "YAML", 0, 0, 0, 2, 0, 0, 1, 3
"d:\IDEWORK\lvmen\src\licensedcode\data\rules\false-positive_7301.yml", "YAML", 0, 0, 0, 2, 0, 0, 1, 3
"d:\IDEWORK\lvmen\src\licensedcode\data\rules\false-positive_7302.yml", "YAML", 0, 0, 0, 2, 0, 0, 1, 3
"d:\IDEWORK\lvmen\src\licensedcode\data\rules\false-positive_7303.yml", "YAML", 0, 0, 0, 2, 0, 0, 1, 3
"d:\IDEWORK\lvmen\src\licensedcode\data\rules\false-positive_7304.yml", "YAML", 0, 0, 0, 2, 0, 0, 1, 3
"d:\IDEWORK\lvmen\src\licensedcode\data\rules\false-positive_7305.yml", "YAML", 0, 0, 0, 2, 0, 0, 1, 3
"d:\IDEWORK\lvmen\src\licensedcode\data\rules\false-positive_7306.yml", "YAML", 0, 0, 0, 2, 0, 0, 1, 3
"d:\IDEWORK\lvmen\src\licensedcode\data\rules\false-positive_7307.yml", "YAML", 0, 0, 0, 2, 0, 0, 1, 3
"d:\IDEWORK\lvmen\src\licensedcode\data\rules\false-positive_7308.yml", "YAML", 0, 0, 0, 2, 0, 0, 1, 3
"d:\IDEWORK\lvmen\src\licensedcode\data\rules\false-positive_7309.yml", "YAML", 0, 0, 0, 2, 0, 0, 1, 3
"d:\IDEWORK\lvmen\src\licensedcode\data\rules\false-positive_731.yml", "YAML", 0, 0, 0, 2, 0, 0, 1, 3
"d:\IDEWORK\lvmen\src\licensedcode\data\rules\false-positive_7310.yml", "YAML", 0, 0, 0, 2, 0, 0, 1, 3
"d:\IDEWORK\lvmen\src\licensedcode\data\rules\false-positive_7311.yml", "YAML", 0, 0, 0, 2, 0, 0, 1, 3
"d:\IDEWORK\lvmen\src\licensedcode\data\rules\false-positive_7312.yml", "YAML", 0, 0, 0, 2, 0, 0, 1, 3
"d:\IDEWORK\lvmen\src\licensedcode\data\rules\false-positive_7313.yml", "YAML", 0, 0, 0, 2, 0, 0, 1, 3
"d:\IDEWORK\lvmen\src\licensedcode\data\rules\false-positive_7314.yml", "YAML", 0, 0, 0, 2, 0, 0, 1, 3
"d:\IDEWORK\lvmen\src\licensedcode\data\rules\false-positive_7315.yml", "YAML", 0, 0, 0, 2, 0, 0, 1, 3
"d:\IDEWORK\lvmen\src\licensedcode\data\rules\false-positive_7316.yml", "YAML", 0, 0, 0, 2, 0, 0, 1, 3
"d:\IDEWORK\lvmen\src\licensedcode\data\rules\false-positive_7317.yml", "YAML", 0, 0, 0, 2, 0, 0, 1, 3
"d:\IDEWORK\lvmen\src\licensedcode\data\rules\false-positive_7318.yml", "YAML", 0, 0, 0, 2, 0, 0, 1, 3
"d:\IDEWORK\lvmen\src\licensedcode\data\rules\false-positive_7319.yml", "YAML", 0, 0, 0, 2, 0, 0, 1, 3
"d:\IDEWORK\lvmen\src\licensedcode\data\rules\false-positive_732.yml", "YAML", 0, 0, 0, 2, 0, 0, 1, 3
"d:\IDEWORK\lvmen\src\licensedcode\data\rules\false-positive_7320.yml", "YAML", 0, 0, 0, 2, 0, 0, 1, 3
"d:\IDEWORK\lvmen\src\licensedcode\data\rules\false-positive_7321.yml", "YAML", 0, 0, 0, 2, 0, 0, 1, 3
"d:\IDEWORK\lvmen\src\licensedcode\data\rules\false-positive_7322.yml", "YAML", 0, 0, 0, 2, 0, 0, 1, 3
"d:\IDEWORK\lvmen\src\licensedcode\data\rules\false-positive_7323.yml", "YAML", 0, 0, 0, 2, 0, 0, 1, 3
"d:\IDEWORK\lvmen\src\licensedcode\data\rules\false-positive_7324.yml", "YAML", 0, 0, 0, 2, 0, 0, 1, 3
"d:\IDEWORK\lvmen\src\licensedcode\data\rules\false-positive_7325.yml", "YAML", 0, 0, 0, 2, 0, 0, 1, 3
"d:\IDEWORK\lvmen\src\licensedcode\data\rules\false-positive_7326.yml", "YAML", 0, 0, 0, 2, 0, 0, 1, 3
"d:\IDEWORK\lvmen\src\licensedcode\data\rules\false-positive_7327.yml", "YAML", 0, 0, 0, 2, 0, 0, 1, 3
"d:\IDEWORK\lvmen\src\licensedcode\data\rules\false-positive_7328.yml", "YAML", 0, 0, 0, 2, 0, 0, 1, 3
"d:\IDEWORK\lvmen\src\licensedcode\data\rules\false-positive_7329.yml", "YAML", 0, 0, 0, 2, 0, 0, 1, 3
"d:\IDEWORK\lvmen\src\licensedcode\data\rules\false-positive_733.yml", "YAML", 0, 0, 0, 2, 0, 0, 1, 3
"d:\IDEWORK\lvmen\src\licensedcode\data\rules\false-positive_7330.yml", "YAML", 0, 0, 0, 2, 0, 0, 1, 3
"d:\IDEWORK\lvmen\src\licensedcode\data\rules\false-positive_7331.yml", "YAML", 0, 0, 0, 2, 0, 0, 1, 3
"d:\IDEWORK\lvmen\src\licensedcode\data\rules\false-positive_7332.yml", "YAML", 0, 0, 0, 2, 0, 0, 1, 3
"d:\IDEWORK\lvmen\src\licensedcode\data\rules\false-positive_7333.yml", "YAML", 0, 0, 0, 2, 0, 0, 1, 3
"d:\IDEWORK\lvmen\src\licensedcode\data\rules\false-positive_7334.yml", "YAML", 0, 0, 0, 2, 0, 0, 1, 3
"d:\IDEWORK\lvmen\src\licensedcode\data\rules\false-positive_7335.yml", "YAML", 0, 0, 0, 2, 0, 0, 1, 3
"d:\IDEWORK\lvmen\src\licensedcode\data\rules\false-positive_7336.yml", "YAML", 0, 0, 0, 2, 0, 0, 1, 3
"d:\IDEWORK\lvmen\src\licensedcode\data\rules\false-positive_7337.yml", "YAML", 0, 0, 0, 2, 0, 0, 1, 3
"d:\IDEWORK\lvmen\src\licensedcode\data\rules\false-positive_7338.yml", "YAML", 0, 0, 0, 2, 0, 0, 1, 3
"d:\IDEWORK\lvmen\src\licensedcode\data\rules\false-positive_7339.yml", "YAML", 0, 0, 0, 2, 0, 0, 1, 3
"d:\IDEWORK\lvmen\src\licensedcode\data\rules\false-positive_734.yml", "YAML", 0, 0, 0, 2, 0, 0, 1, 3
"d:\IDEWORK\lvmen\src\licensedcode\data\rules\false-positive_7340.yml", "YAML", 0, 0, 0, 2, 0, 0, 1, 3
"d:\IDEWORK\lvmen\src\licensedcode\data\rules\false-positive_7341.yml", "YAML", 0, 0, 0, 2, 0, 0, 1, 3
"d:\IDEWORK\lvmen\src\licensedcode\data\rules\false-positive_7342.yml", "YAML", 0, 0, 0, 2, 0, 0, 1, 3
"d:\IDEWORK\lvmen\src\licensedcode\data\rules\false-positive_7343.yml", "YAML", 0, 0, 0, 2, 0, 0, 1, 3
"d:\IDEWORK\lvmen\src\licensedcode\data\rules\false-positive_7344.yml", "YAML", 0, 0, 0, 2, 0, 0, 1, 3
"d:\IDEWORK\lvmen\src\licensedcode\data\rules\false-positive_7345.yml", "YAML", 0, 0, 0, 2, 0, 0, 1, 3
"d:\IDEWORK\lvmen\src\licensedcode\data\rules\false-positive_7346.yml", "YAML", 0, 0, 0, 2, 0, 0, 1, 3
"d:\IDEWORK\lvmen\src\licensedcode\data\rules\false-positive_7347.yml", "YAML", 0, 0, 0, 2, 0, 0, 1, 3
"d:\IDEWORK\lvmen\src\licensedcode\data\rules\false-positive_7348.yml", "YAML", 0, 0, 0, 2, 0, 0, 1, 3
"d:\IDEWORK\lvmen\src\licensedcode\data\rules\false-positive_7349.yml", "YAML", 0, 0, 0, 2, 0, 0, 1, 3
"d:\IDEWORK\lvmen\src\licensedcode\data\rules\false-positive_735.yml", "YAML", 0, 0, 0, 2, 0, 0, 1, 3
"d:\IDEWORK\lvmen\src\licensedcode\data\rules\false-positive_7350.yml", "YAML", 0, 0, 0, 2, 0, 0, 1, 3
"d:\IDEWORK\lvmen\src\licensedcode\data\rules\false-positive_7351.yml", "YAML", 0, 0, 0, 2, 0, 0, 1, 3
"d:\IDEWORK\lvmen\src\licensedcode\data\rules\false-positive_7352.yml", "YAML", 0, 0, 0, 2, 0, 0, 1, 3
"d:\IDEWORK\lvmen\src\licensedcode\data\rules\false-positive_7353.yml", "YAML", 0, 0, 0, 2, 0, 0, 1, 3
"d:\IDEWORK\lvmen\src\licensedcode\data\rules\false-positive_7354.yml", "YAML", 0, 0, 0, 2, 0, 0, 1, 3
"d:\IDEWORK\lvmen\src\licensedcode\data\rules\false-positive_7355.yml", "YAML", 0, 0, 0, 2, 0, 0, 1, 3
"d:\IDEWORK\lvmen\src\licensedcode\data\rules\false-positive_7356.yml", "YAML", 0, 0, 0, 2, 0, 0, 1, 3
"d:\IDEWORK\lvmen\src\licensedcode\data\rules\false-positive_7357.yml", "YAML", 0, 0, 0, 2, 0, 0, 1, 3
"d:\IDEWORK\lvmen\src\licensedcode\data\rules\false-positive_7358.yml", "YAML", 0, 0, 0, 2, 0, 0, 1, 3
"d:\IDEWORK\lvmen\src\licensedcode\data\rules\false-positive_7359.yml", "YAML", 0, 0, 0, 2, 0, 0, 1, 3
"d:\IDEWORK\lvmen\src\licensedcode\data\rules\false-positive_736.yml", "YAML", 0, 0, 0, 2, 0, 0, 1, 3
"d:\IDEWORK\lvmen\src\licensedcode\data\rules\false-positive_7360.yml", "YAML", 0, 0, 0, 2, 0, 0, 1, 3
"d:\IDEWORK\lvmen\src\licensedcode\data\rules\false-positive_7361.yml", "YAML", 0, 0, 0, 2, 0, 0, 1, 3
"d:\IDEWORK\lvmen\src\licensedcode\data\rules\false-positive_7362.yml", "YAML", 0, 0, 0, 2, 0, 0, 1, 3
"d:\IDEWORK\lvmen\src\licensedcode\data\rules\false-positive_7363.yml", "YAML", 0, 0, 0, 2, 0, 0, 1, 3
"d:\IDEWORK\lvmen\src\licensedcode\data\rules\false-positive_7364.yml", "YAML", 0, 0, 0, 2, 0, 0, 1, 3
"d:\IDEWORK\lvmen\src\licensedcode\data\rules\false-positive_7365.yml", "YAML", 0, 0, 0, 2, 0, 0, 1, 3
"d:\IDEWORK\lvmen\src\licensedcode\data\rules\false-positive_7366.yml", "YAML", 0, 0, 0, 2, 0, 0, 1, 3
"d:\IDEWORK\lvmen\src\licensedcode\data\rules\false-positive_7367.yml", "YAML", 0, 0, 0, 2, 0, 0, 1, 3
"d:\IDEWORK\lvmen\src\licensedcode\data\rules\false-positive_7368.yml", "YAML", 0, 0, 0, 2, 0, 0, 1, 3
"d:\IDEWORK\lvmen\src\licensedcode\data\rules\false-positive_7369.yml", "YAML", 0, 0, 0, 2, 0, 0, 1, 3
"d:\IDEWORK\lvmen\src\licensedcode\data\rules\false-positive_737.yml", "YAML", 0, 0, 0, 2, 0, 0, 1, 3
"d:\IDEWORK\lvmen\src\licensedcode\data\rules\false-positive_7370.yml", "YAML", 0, 0, 0, 2, 0, 0, 1, 3
"d:\IDEWORK\lvmen\src\licensedcode\data\rules\false-positive_7371.yml", "YAML", 0, 0, 0, 2, 0, 0, 1, 3
"d:\IDEWORK\lvmen\src\licensedcode\data\rules\false-positive_7372.yml", "YAML", 0, 0, 0, 2, 0, 0, 1, 3
"d:\IDEWORK\lvmen\src\licensedcode\data\rules\false-positive_7373.yml", "YAML", 0, 0, 0, 2, 0, 0, 1, 3
"d:\IDEWORK\lvmen\src\licensedcode\data\rules\false-positive_7374.yml", "YAML", 0, 0, 0, 2, 0, 0, 1, 3
"d:\IDEWORK\lvmen\src\licensedcode\data\rules\false-positive_7375.yml", "YAML", 0, 0, 0, 2, 0, 0, 1, 3
"d:\IDEWORK\lvmen\src\licensedcode\data\rules\false-positive_7376.yml", "YAML", 0, 0, 0, 2, 0, 0, 1, 3
"d:\IDEWORK\lvmen\src\licensedcode\data\rules\false-positive_7377.yml", "YAML", 0, 0, 0, 2, 0, 0, 1, 3
"d:\IDEWORK\lvmen\src\licensedcode\data\rules\false-positive_7378.yml", "YAML", 0, 0, 0, 2, 0, 0, 1, 3
"d:\IDEWORK\lvmen\src\licensedcode\data\rules\false-positive_7379.yml", "YAML", 0, 0, 0, 2, 0, 0, 1, 3
"d:\IDEWORK\lvmen\src\licensedcode\data\rules\false-positive_738.yml", "YAML", 0, 0, 0, 2, 0, 0, 1, 3
"d:\IDEWORK\lvmen\src\licensedcode\data\rules\false-positive_7380.yml", "YAML", 0, 0, 0, 2, 0, 0, 1, 3
"d:\IDEWORK\lvmen\src\licensedcode\data\rules\false-positive_7381.yml", "YAML", 0, 0, 0, 2, 0, 0, 1, 3
"d:\IDEWORK\lvmen\src\licensedcode\data\rules\false-positive_7382.yml", "YAML", 0, 0, 0, 2, 0, 0, 1, 3
"d:\IDEWORK\lvmen\src\licensedcode\data\rules\false-positive_7383.yml", "YAML", 0, 0, 0, 2, 0, 0, 1, 3
"d:\IDEWORK\lvmen\src\licensedcode\data\rules\false-positive_7384.yml", "YAML", 0, 0, 0, 2, 0, 0, 1, 3
"d:\IDEWORK\lvmen\src\licensedcode\data\rules\false-positive_7385.yml", "YAML", 0, 0, 0, 2, 0, 0, 1, 3
"d:\IDEWORK\lvmen\src\licensedcode\data\rules\false-positive_7386.yml", "YAML", 0, 0, 0, 2, 0, 0, 1, 3
"d:\IDEWORK\lvmen\src\licensedcode\data\rules\false-positive_7387.yml", "YAML", 0, 0, 0, 2, 0, 0, 1, 3
"d:\IDEWORK\lvmen\src\licensedcode\data\rules\false-positive_7388.yml", "YAML", 0, 0, 0, 2, 0, 0, 1, 3
"d:\IDEWORK\lvmen\src\licensedcode\data\rules\false-positive_7389.yml", "YAML", 0, 0, 0, 2, 0, 0, 1, 3
"d:\IDEWORK\lvmen\src\licensedcode\data\rules\false-positive_739.yml", "YAML", 0, 0, 0, 2, 0, 0, 1, 3
"d:\IDEWORK\lvmen\src\licensedcode\data\rules\false-positive_7390.yml", "YAML", 0, 0, 0, 2, 0, 0, 1, 3
"d:\IDEWORK\lvmen\src\licensedcode\data\rules\false-positive_7391.yml", "YAML", 0, 0, 0, 2, 0, 0, 1, 3
"d:\IDEWORK\lvmen\src\licensedcode\data\rules\false-positive_74.yml", "YAML", 0, 0, 0, 2, 0, 0, 1, 3
"d:\IDEWORK\lvmen\src\licensedcode\data\rules\false-positive_740.yml", "YAML", 0, 0, 0, 2, 0, 0, 1, 3
"d:\IDEWORK\lvmen\src\licensedcode\data\rules\false-positive_741.yml", "YAML", 0, 0, 0, 2, 0, 0, 1, 3
"d:\IDEWORK\lvmen\src\licensedcode\data\rules\false-positive_742.yml", "YAML", 0, 0, 0, 2, 0, 0, 1, 3
"d:\IDEWORK\lvmen\src\licensedcode\data\rules\false-positive_743.yml", "YAML", 0, 0, 0, 2, 0, 0, 1, 3
"d:\IDEWORK\lvmen\src\licensedcode\data\rules\false-positive_744.yml", "YAML", 0, 0, 0, 2, 0, 0, 1, 3
"d:\IDEWORK\lvmen\src\licensedcode\data\rules\false-positive_745.yml", "YAML", 0, 0, 0, 2, 0, 0, 1, 3
"d:\IDEWORK\lvmen\src\licensedcode\data\rules\false-positive_746.yml", "YAML", 0, 0, 0, 2, 0, 0, 1, 3
"d:\IDEWORK\lvmen\src\licensedcode\data\rules\false-positive_747.yml", "YAML", 0, 0, 0, 2, 0, 0, 1, 3
"d:\IDEWORK\lvmen\src\licensedcode\data\rules\false-positive_748.yml", "YAML", 0, 0, 0, 2, 0, 0, 1, 3
"d:\IDEWORK\lvmen\src\licensedcode\data\rules\false-positive_749.yml", "YAML", 0, 0, 0, 2, 0, 0, 1, 3
"d:\IDEWORK\lvmen\src\licensedcode\data\rules\false-positive_75.yml", "YAML", 0, 0, 0, 3, 0, 0, 1, 4
"d:\IDEWORK\lvmen\src\licensedcode\data\rules\false-positive_750.yml", "YAML", 0, 0, 0, 2, 0, 0, 1, 3
"d:\IDEWORK\lvmen\src\licensedcode\data\rules\false-positive_751.yml", "YAML", 0, 0, 0, 2, 0, 0, 1, 3
"d:\IDEWORK\lvmen\src\licensedcode\data\rules\false-positive_752.yml", "YAML", 0, 0, 0, 2, 0, 0, 1, 3
"d:\IDEWORK\lvmen\src\licensedcode\data\rules\false-positive_753.yml", "YAML", 0, 0, 0, 2, 0, 0, 1, 3
"d:\IDEWORK\lvmen\src\licensedcode\data\rules\false-positive_754.yml", "YAML", 0, 0, 0, 2, 0, 0, 1, 3
"d:\IDEWORK\lvmen\src\licensedcode\data\rules\false-positive_755.yml", "YAML", 0, 0, 0, 2, 0, 0, 1, 3
"d:\IDEWORK\lvmen\src\licensedcode\data\rules\false-positive_756.yml", "YAML", 0, 0, 0, 2, 0, 0, 1, 3
"d:\IDEWORK\lvmen\src\licensedcode\data\rules\false-positive_757.yml", "YAML", 0, 0, 0, 2, 0, 0, 1, 3
"d:\IDEWORK\lvmen\src\licensedcode\data\rules\false-positive_758.yml", "YAML", 0, 0, 0, 2, 0, 0, 1, 3
"d:\IDEWORK\lvmen\src\licensedcode\data\rules\false-positive_759.yml", "YAML", 0, 0, 0, 2, 0, 0, 1, 3
"d:\IDEWORK\lvmen\src\licensedcode\data\rules\false-positive_76.yml", "YAML", 0, 0, 0, 2, 0, 0, 1, 3
"d:\IDEWORK\lvmen\src\licensedcode\data\rules\false-positive_760.yml", "YAML", 0, 0, 0, 2, 0, 0, 1, 3
"d:\IDEWORK\lvmen\src\licensedcode\data\rules\false-positive_761.yml", "YAML", 0, 0, 0, 2, 0, 0, 1, 3
"d:\IDEWORK\lvmen\src\licensedcode\data\rules\false-positive_762.yml", "YAML", 0, 0, 0, 2, 0, 0, 1, 3
"d:\IDEWORK\lvmen\src\licensedcode\data\rules\false-positive_763.yml", "YAML", 0, 0, 0, 2, 0, 0, 1, 3
"d:\IDEWORK\lvmen\src\licensedcode\data\rules\false-positive_764.yml", "YAML", 0, 0, 0, 2, 0, 0, 1, 3
"d:\IDEWORK\lvmen\src\licensedcode\data\rules\false-positive_765.yml", "YAML", 0, 0, 0, 2, 0, 0, 1, 3
"d:\IDEWORK\lvmen\src\licensedcode\data\rules\false-positive_766.yml", "YAML", 0, 0, 0, 2, 0, 0, 1, 3
"d:\IDEWORK\lvmen\src\licensedcode\data\rules\false-positive_767.yml", "YAML", 0, 0, 0, 2, 0, 0, 1, 3
"d:\IDEWORK\lvmen\src\licensedcode\data\rules\false-positive_768.yml", "YAML", 0, 0, 0, 2, 0, 0, 1, 3
"d:\IDEWORK\lvmen\src\licensedcode\data\rules\false-positive_769.yml", "YAML", 0, 0, 0, 2, 0, 0, 1, 3
"d:\IDEWORK\lvmen\src\licensedcode\data\rules\false-positive_77.yml", "YAML", 0, 0, 0, 2, 0, 0, 1, 3
"d:\IDEWORK\lvmen\src\licensedcode\data\rules\false-positive_770.yml", "YAML", 0, 0, 0, 2, 0, 0, 1, 3
"d:\IDEWORK\lvmen\src\licensedcode\data\rules\false-positive_771.yml", "YAML", 0, 0, 0, 2, 0, 0, 1, 3
"d:\IDEWORK\lvmen\src\licensedcode\data\rules\false-positive_772.yml", "YAML", 0, 0, 0, 2, 0, 0, 1, 3
"d:\IDEWORK\lvmen\src\licensedcode\data\rules\false-positive_773.yml", "YAML", 0, 0, 0, 2, 0, 0, 1, 3
"d:\IDEWORK\lvmen\src\licensedcode\data\rules\false-positive_774.yml", "YAML", 0, 0, 0, 2, 0, 0, 1, 3
"d:\IDEWORK\lvmen\src\licensedcode\data\rules\false-positive_775.yml", "YAML", 0, 0, 0, 2, 0, 0, 1, 3
"d:\IDEWORK\lvmen\src\licensedcode\data\rules\false-positive_776.yml", "YAML", 0, 0, 0, 2, 0, 0, 1, 3
"d:\IDEWORK\lvmen\src\licensedcode\data\rules\false-positive_777.yml", "YAML", 0, 0, 0, 2, 0, 0, 1, 3
"d:\IDEWORK\lvmen\src\licensedcode\data\rules\false-positive_778.yml", "YAML", 0, 0, 0, 2, 0, 0, 1, 3
"d:\IDEWORK\lvmen\src\licensedcode\data\rules\false-positive_779.yml", "YAML", 0, 0, 0, 2, 0, 0, 1, 3
"d:\IDEWORK\lvmen\src\licensedcode\data\rules\false-positive_78.yml", "YAML", 0, 0, 0, 2, 0, 0, 1, 3
"d:\IDEWORK\lvmen\src\licensedcode\data\rules\false-positive_780.yml", "YAML", 0, 0, 0, 2, 0, 0, 1, 3
"d:\IDEWORK\lvmen\src\licensedcode\data\rules\false-positive_781.yml", "YAML", 0, 0, 0, 2, 0, 0, 1, 3
"d:\IDEWORK\lvmen\src\licensedcode\data\rules\false-positive_782.yml", "YAML", 0, 0, 0, 2, 0, 0, 1, 3
"d:\IDEWORK\lvmen\src\licensedcode\data\rules\false-positive_783.yml", "YAML", 0, 0, 0, 2, 0, 0, 1, 3
"d:\IDEWORK\lvmen\src\licensedcode\data\rules\false-positive_784.yml", "YAML", 0, 0, 0, 2, 0, 0, 1, 3
"d:\IDEWORK\lvmen\src\licensedcode\data\rules\false-positive_785.yml", "YAML", 0, 0, 0, 2, 0, 0, 1, 3
"d:\IDEWORK\lvmen\src\licensedcode\data\rules\false-positive_786.yml", "YAML", 0, 0, 0, 2, 0, 0, 1, 3
"d:\IDEWORK\lvmen\src\licensedcode\data\rules\false-positive_787.yml", "YAML", 0, 0, 0, 2, 0, 0, 1, 3
"d:\IDEWORK\lvmen\src\licensedcode\data\rules\false-positive_788.yml", "YAML", 0, 0, 0, 2, 0, 0, 1, 3
"d:\IDEWORK\lvmen\src\licensedcode\data\rules\false-positive_789.yml", "YAML", 0, 0, 0, 2, 0, 0, 1, 3
"d:\IDEWORK\lvmen\src\licensedcode\data\rules\false-positive_79.yml", "YAML", 0, 0, 0, 2, 0, 0, 1, 3
"d:\IDEWORK\lvmen\src\licensedcode\data\rules\false-positive_790.yml", "YAML", 0, 0, 0, 2, 0, 0, 1, 3
"d:\IDEWORK\lvmen\src\licensedcode\data\rules\false-positive_791.yml", "YAML", 0, 0, 0, 2, 0, 0, 1, 3
"d:\IDEWORK\lvmen\src\licensedcode\data\rules\false-positive_792.yml", "YAML", 0, 0, 0, 2, 0, 0, 1, 3
"d:\IDEWORK\lvmen\src\licensedcode\data\rules\false-positive_793.yml", "YAML", 0, 0, 0, 2, 0, 0, 1, 3
"d:\IDEWORK\lvmen\src\licensedcode\data\rules\false-positive_794.yml", "YAML", 0, 0, 0, 2, 0, 0, 1, 3
"d:\IDEWORK\lvmen\src\licensedcode\data\rules\false-positive_795.yml", "YAML", 0, 0, 0, 2, 0, 0, 1, 3
"d:\IDEWORK\lvmen\src\licensedcode\data\rules\false-positive_796.yml", "YAML", 0, 0, 0, 2, 0, 0, 1, 3
"d:\IDEWORK\lvmen\src\licensedcode\data\rules\false-positive_797.yml", "YAML", 0, 0, 0, 2, 0, 0, 1, 3
"d:\IDEWORK\lvmen\src\licensedcode\data\rules\false-positive_798.yml", "YAML", 0, 0, 0, 2, 0, 0, 1, 3
"d:\IDEWORK\lvmen\src\licensedcode\data\rules\false-positive_799.yml", "YAML", 0, 0, 0, 2, 0, 0, 1, 3
"d:\IDEWORK\lvmen\src\licensedcode\data\rules\false-positive_8.yml", "YAML", 0, 0, 0, 2, 0, 0, 1, 3
"d:\IDEWORK\lvmen\src\licensedcode\data\rules\false-positive_80.yml", "YAML", 0, 0, 0, 2, 0, 0, 1, 3
"d:\IDEWORK\lvmen\src\licensedcode\data\rules\false-positive_800.yml", "YAML", 0, 0, 0, 2, 0, 0, 1, 3
"d:\IDEWORK\lvmen\src\licensedcode\data\rules\false-positive_801.yml", "YAML", 0, 0, 0, 2, 0, 0, 1, 3
"d:\IDEWORK\lvmen\src\licensedcode\data\rules\false-positive_802.yml", "YAML", 0, 0, 0, 2, 0, 0, 1, 3
"d:\IDEWORK\lvmen\src\licensedcode\data\rules\false-positive_803.yml", "YAML", 0, 0, 0, 2, 0, 0, 1, 3
"d:\IDEWORK\lvmen\src\licensedcode\data\rules\false-positive_804.yml", "YAML", 0, 0, 0, 2, 0, 0, 1, 3
"d:\IDEWORK\lvmen\src\licensedcode\data\rules\false-positive_805.yml", "YAML", 0, 0, 0, 2, 0, 0, 1, 3
"d:\IDEWORK\lvmen\src\licensedcode\data\rules\false-positive_806.yml", "YAML", 0, 0, 0, 2, 0, 0, 1, 3
"d:\IDEWORK\lvmen\src\licensedcode\data\rules\false-positive_807.yml", "YAML", 0, 0, 0, 2, 0, 0, 1, 3
"d:\IDEWORK\lvmen\src\licensedcode\data\rules\false-positive_808.yml", "YAML", 0, 0, 0, 2, 0, 0, 1, 3
"d:\IDEWORK\lvmen\src\licensedcode\data\rules\false-positive_809.yml", "YAML", 0, 0, 0, 2, 0, 0, 1, 3
"d:\IDEWORK\lvmen\src\licensedcode\data\rules\false-positive_81.yml", "YAML", 0, 0, 0, 3, 0, 0, 1, 4
"d:\IDEWORK\lvmen\src\licensedcode\data\rules\false-positive_810.yml", "YAML", 0, 0, 0, 2, 0, 0, 1, 3
"d:\IDEWORK\lvmen\src\licensedcode\data\rules\false-positive_811.yml", "YAML", 0, 0, 0, 2, 0, 0, 1, 3
"d:\IDEWORK\lvmen\src\licensedcode\data\rules\false-positive_812.yml", "YAML", 0, 0, 0, 2, 0, 0, 1, 3
"d:\IDEWORK\lvmen\src\licensedcode\data\rules\false-positive_813.yml", "YAML", 0, 0, 0, 2, 0, 0, 1, 3
"d:\IDEWORK\lvmen\src\licensedcode\data\rules\false-positive_814.yml", "YAML", 0, 0, 0, 2, 0, 0, 1, 3
"d:\IDEWORK\lvmen\src\licensedcode\data\rules\false-positive_815.yml", "YAML", 0, 0, 0, 2, 0, 0, 1, 3
"d:\IDEWORK\lvmen\src\licensedcode\data\rules\false-positive_816.yml", "YAML", 0, 0, 0, 2, 0, 0, 1, 3
"d:\IDEWORK\lvmen\src\licensedcode\data\rules\false-positive_817.yml", "YAML", 0, 0, 0, 2, 0, 0, 1, 3
"d:\IDEWORK\lvmen\src\licensedcode\data\rules\false-positive_818.yml", "YAML", 0, 0, 0, 2, 0, 0, 1, 3
"d:\IDEWORK\lvmen\src\licensedcode\data\rules\false-positive_819.yml", "YAML", 0, 0, 0, 2, 0, 0, 1, 3
"d:\IDEWORK\lvmen\src\licensedcode\data\rules\false-positive_82.yml", "YAML", 0, 0, 0, 2, 0, 0, 1, 3
"d:\IDEWORK\lvmen\src\licensedcode\data\rules\false-positive_820.yml", "YAML", 0, 0, 0, 2, 0, 0, 1, 3
"d:\IDEWORK\lvmen\src\licensedcode\data\rules\false-positive_821.yml", "YAML", 0, 0, 0, 2, 0, 0, 1, 3
"d:\IDEWORK\lvmen\src\licensedcode\data\rules\false-positive_822.yml", "YAML", 0, 0, 0, 2, 0, 0, 1, 3
"d:\IDEWORK\lvmen\src\licensedcode\data\rules\false-positive_823.yml", "YAML", 0, 0, 0, 2, 0, 0, 1, 3
"d:\IDEWORK\lvmen\src\licensedcode\data\rules\false-positive_824.yml", "YAML", 0, 0, 0, 2, 0, 0, 1, 3
"d:\IDEWORK\lvmen\src\licensedcode\data\rules\false-positive_825.yml", "YAML", 0, 0, 0, 2, 0, 0, 1, 3
"d:\IDEWORK\lvmen\src\licensedcode\data\rules\false-positive_826.yml", "YAML", 0, 0, 0, 2, 0, 0, 1, 3
"d:\IDEWORK\lvmen\src\licensedcode\data\rules\false-positive_827.yml", "YAML", 0, 0, 0, 2, 0, 0, 1, 3
"d:\IDEWORK\lvmen\src\licensedcode\data\rules\false-positive_828.yml", "YAML", 0, 0, 0, 2, 0, 0, 1, 3
"d:\IDEWORK\lvmen\src\licensedcode\data\rules\false-positive_829.yml", "YAML", 0, 0, 0, 2, 0, 0, 1, 3
"d:\IDEWORK\lvmen\src\licensedcode\data\rules\false-positive_83.yml", "YAML", 0, 0, 0, 2, 0, 0, 1, 3
"d:\IDEWORK\lvmen\src\licensedcode\data\rules\false-positive_830.yml", "YAML", 0, 0, 0, 2, 0, 0, 1, 3
"d:\IDEWORK\lvmen\src\licensedcode\data\rules\false-positive_831.yml", "YAML", 0, 0, 0, 2, 0, 0, 1, 3
"d:\IDEWORK\lvmen\src\licensedcode\data\rules\false-positive_832.yml", "YAML", 0, 0, 0, 2, 0, 0, 1, 3
"d:\IDEWORK\lvmen\src\licensedcode\data\rules\false-positive_833.yml", "YAML", 0, 0, 0, 2, 0, 0, 1, 3
"d:\IDEWORK\lvmen\src\licensedcode\data\rules\false-positive_834.yml", "YAML", 0, 0, 0, 2, 0, 0, 1, 3
"d:\IDEWORK\lvmen\src\licensedcode\data\rules\false-positive_835.yml", "YAML", 0, 0, 0, 2, 0, 0, 1, 3
"d:\IDEWORK\lvmen\src\licensedcode\data\rules\false-positive_836.yml", "YAML", 0, 0, 0, 2, 0, 0, 1, 3
"d:\IDEWORK\lvmen\src\licensedcode\data\rules\false-positive_837.yml", "YAML", 0, 0, 0, 2, 0, 0, 1, 3
"d:\IDEWORK\lvmen\src\licensedcode\data\rules\false-positive_838.yml", "YAML", 0, 0, 0, 2, 0, 0, 1, 3
"d:\IDEWORK\lvmen\src\licensedcode\data\rules\false-positive_839.yml", "YAML", 0, 0, 0, 2, 0, 0, 1, 3
"d:\IDEWORK\lvmen\src\licensedcode\data\rules\false-positive_84.yml", "YAML", 0, 0, 0, 3, 0, 0, 1, 4
"d:\IDEWORK\lvmen\src\licensedcode\data\rules\false-positive_840.yml", "YAML", 0, 0, 0, 2, 0, 0, 1, 3
"d:\IDEWORK\lvmen\src\licensedcode\data\rules\false-positive_841.yml", "YAML", 0, 0, 0, 2, 0, 0, 1, 3
"d:\IDEWORK\lvmen\src\licensedcode\data\rules\false-positive_842.yml", "YAML", 0, 0, 0, 2, 0, 0, 1, 3
"d:\IDEWORK\lvmen\src\licensedcode\data\rules\false-positive_843.yml", "YAML", 0, 0, 0, 2, 0, 0, 1, 3
"d:\IDEWORK\lvmen\src\licensedcode\data\rules\false-positive_844.yml", "YAML", 0, 0, 0, 2, 0, 0, 1, 3
"d:\IDEWORK\lvmen\src\licensedcode\data\rules\false-positive_845.yml", "YAML", 0, 0, 0, 2, 0, 0, 1, 3
"d:\IDEWORK\lvmen\src\licensedcode\data\rules\false-positive_846.yml", "YAML", 0, 0, 0, 2, 0, 0, 1, 3
"d:\IDEWORK\lvmen\src\licensedcode\data\rules\false-positive_847.yml", "YAML", 0, 0, 0, 2, 0, 0, 1, 3
"d:\IDEWORK\lvmen\src\licensedcode\data\rules\false-positive_848.yml", "YAML", 0, 0, 0, 2, 0, 0, 1, 3
"d:\IDEWORK\lvmen\src\licensedcode\data\rules\false-positive_849.yml", "YAML", 0, 0, 0, 2, 0, 0, 1, 3
"d:\IDEWORK\lvmen\src\licensedcode\data\rules\false-positive_85.yml", "YAML", 0, 0, 0, 2, 0, 0, 1, 3
"d:\IDEWORK\lvmen\src\licensedcode\data\rules\false-positive_850.yml", "YAML", 0, 0, 0, 2, 0, 0, 1, 3
"d:\IDEWORK\lvmen\src\licensedcode\data\rules\false-positive_851.yml", "YAML", 0, 0, 0, 2, 0, 0, 1, 3
"d:\IDEWORK\lvmen\src\licensedcode\data\rules\false-positive_852.yml", "YAML", 0, 0, 0, 2, 0, 0, 1, 3
"d:\IDEWORK\lvmen\src\licensedcode\data\rules\false-positive_853.yml", "YAML", 0, 0, 0, 2, 0, 0, 1, 3
"d:\IDEWORK\lvmen\src\licensedcode\data\rules\false-positive_854.yml", "YAML", 0, 0, 0, 2, 0, 0, 1, 3
"d:\IDEWORK\lvmen\src\licensedcode\data\rules\false-positive_855.yml", "YAML", 0, 0, 0, 2, 0, 0, 1, 3
"d:\IDEWORK\lvmen\src\licensedcode\data\rules\false-positive_856.yml", "YAML", 0, 0, 0, 2, 0, 0, 1, 3
"d:\IDEWORK\lvmen\src\licensedcode\data\rules\false-positive_857.yml", "YAML", 0, 0, 0, 2, 0, 0, 1, 3
"d:\IDEWORK\lvmen\src\licensedcode\data\rules\false-positive_858.yml", "YAML", 0, 0, 0, 2, 0, 0, 1, 3
"d:\IDEWORK\lvmen\src\licensedcode\data\rules\false-positive_859.yml", "YAML", 0, 0, 0, 2, 0, 0, 1, 3
"d:\IDEWORK\lvmen\src\licensedcode\data\rules\false-positive_86.yml", "YAML", 0, 0, 0, 2, 0, 0, 1, 3
"d:\IDEWORK\lvmen\src\licensedcode\data\rules\false-positive_860.yml", "YAML", 0, 0, 0, 2, 0, 0, 1, 3
"d:\IDEWORK\lvmen\src\licensedcode\data\rules\false-positive_861.yml", "YAML", 0, 0, 0, 2, 0, 0, 1, 3
"d:\IDEWORK\lvmen\src\licensedcode\data\rules\false-positive_862.yml", "YAML", 0, 0, 0, 2, 0, 0, 1, 3
"d:\IDEWORK\lvmen\src\licensedcode\data\rules\false-positive_863.yml", "YAML", 0, 0, 0, 2, 0, 0, 1, 3
"d:\IDEWORK\lvmen\src\licensedcode\data\rules\false-positive_864.yml", "YAML", 0, 0, 0, 2, 0, 0, 1, 3
"d:\IDEWORK\lvmen\src\licensedcode\data\rules\false-positive_865.yml", "YAML", 0, 0, 0, 2, 0, 0, 1, 3
"d:\IDEWORK\lvmen\src\licensedcode\data\rules\false-positive_866.yml", "YAML", 0, 0, 0, 2, 0, 0, 1, 3
"d:\IDEWORK\lvmen\src\licensedcode\data\rules\false-positive_867.yml", "YAML", 0, 0, 0, 2, 0, 0, 1, 3
"d:\IDEWORK\lvmen\src\licensedcode\data\rules\false-positive_868.yml", "YAML", 0, 0, 0, 2, 0, 0, 1, 3
"d:\IDEWORK\lvmen\src\licensedcode\data\rules\false-positive_869.yml", "YAML", 0, 0, 0, 2, 0, 0, 1, 3
"d:\IDEWORK\lvmen\src\licensedcode\data\rules\false-positive_87.yml", "YAML", 0, 0, 0, 2, 0, 0, 1, 3
"d:\IDEWORK\lvmen\src\licensedcode\data\rules\false-positive_870.yml", "YAML", 0, 0, 0, 2, 0, 0, 1, 3
"d:\IDEWORK\lvmen\src\licensedcode\data\rules\false-positive_871.yml", "YAML", 0, 0, 0, 2, 0, 0, 1, 3
"d:\IDEWORK\lvmen\src\licensedcode\data\rules\false-positive_872.yml", "YAML", 0, 0, 0, 2, 0, 0, 1, 3
"d:\IDEWORK\lvmen\src\licensedcode\data\rules\false-positive_873.yml", "YAML", 0, 0, 0, 2, 0, 0, 1, 3
"d:\IDEWORK\lvmen\src\licensedcode\data\rules\false-positive_874.yml", "YAML", 0, 0, 0, 2, 0, 0, 1, 3
"d:\IDEWORK\lvmen\src\licensedcode\data\rules\false-positive_875.yml", "YAML", 0, 0, 0, 2, 0, 0, 1, 3
"d:\IDEWORK\lvmen\src\licensedcode\data\rules\false-positive_876.yml", "YAML", 0, 0, 0, 2, 0, 0, 1, 3
"d:\IDEWORK\lvmen\src\licensedcode\data\rules\false-positive_877.yml", "YAML", 0, 0, 0, 2, 0, 0, 1, 3
"d:\IDEWORK\lvmen\src\licensedcode\data\rules\false-positive_878.yml", "YAML", 0, 0, 0, 2, 0, 0, 1, 3
"d:\IDEWORK\lvmen\src\licensedcode\data\rules\false-positive_879.yml", "YAML", 0, 0, 0, 2, 0, 0, 1, 3
"d:\IDEWORK\lvmen\src\licensedcode\data\rules\false-positive_88.yml", "YAML", 0, 0, 0, 2, 0, 0, 1, 3
"d:\IDEWORK\lvmen\src\licensedcode\data\rules\false-positive_880.yml", "YAML", 0, 0, 0, 2, 0, 0, 1, 3
"d:\IDEWORK\lvmen\src\licensedcode\data\rules\false-positive_881.yml", "YAML", 0, 0, 0, 2, 0, 0, 1, 3
"d:\IDEWORK\lvmen\src\licensedcode\data\rules\false-positive_882.yml", "YAML", 0, 0, 0, 2, 0, 0, 1, 3
"d:\IDEWORK\lvmen\src\licensedcode\data\rules\false-positive_883.yml", "YAML", 0, 0, 0, 2, 0, 0, 1, 3
"d:\IDEWORK\lvmen\src\licensedcode\data\rules\false-positive_884.yml", "YAML", 0, 0, 0, 2, 0, 0, 1, 3
"d:\IDEWORK\lvmen\src\licensedcode\data\rules\false-positive_885.yml", "YAML", 0, 0, 0, 2, 0, 0, 1, 3
"d:\IDEWORK\lvmen\src\licensedcode\data\rules\false-positive_886.yml", "YAML", 0, 0, 0, 2, 0, 0, 1, 3
"d:\IDEWORK\lvmen\src\licensedcode\data\rules\false-positive_887.yml", "YAML", 0, 0, 0, 2, 0, 0, 1, 3
"d:\IDEWORK\lvmen\src\licensedcode\data\rules\false-positive_888.yml", "YAML", 0, 0, 0, 2, 0, 0, 1, 3
"d:\IDEWORK\lvmen\src\licensedcode\data\rules\false-positive_889.yml", "YAML", 0, 0, 0, 2, 0, 0, 1, 3
"d:\IDEWORK\lvmen\src\licensedcode\data\rules\false-positive_89.yml", "YAML", 0, 0, 0, 2, 0, 0, 1, 3
"d:\IDEWORK\lvmen\src\licensedcode\data\rules\false-positive_890.yml", "YAML", 0, 0, 0, 2, 0, 0, 1, 3
"d:\IDEWORK\lvmen\src\licensedcode\data\rules\false-positive_891.yml", "YAML", 0, 0, 0, 2, 0, 0, 1, 3
"d:\IDEWORK\lvmen\src\licensedcode\data\rules\false-positive_892.yml", "YAML", 0, 0, 0, 2, 0, 0, 1, 3
"d:\IDEWORK\lvmen\src\licensedcode\data\rules\false-positive_893.yml", "YAML", 0, 0, 0, 2, 0, 0, 1, 3
"d:\IDEWORK\lvmen\src\licensedcode\data\rules\false-positive_894.yml", "YAML", 0, 0, 0, 2, 0, 0, 1, 3
"d:\IDEWORK\lvmen\src\licensedcode\data\rules\false-positive_895.yml", "YAML", 0, 0, 0, 2, 0, 0, 1, 3
"d:\IDEWORK\lvmen\src\licensedcode\data\rules\false-positive_896.yml", "YAML", 0, 0, 0, 2, 0, 0, 1, 3
"d:\IDEWORK\lvmen\src\licensedcode\data\rules\false-positive_897.yml", "YAML", 0, 0, 0, 2, 0, 0, 1, 3
"d:\IDEWORK\lvmen\src\licensedcode\data\rules\false-positive_898.yml", "YAML", 0, 0, 0, 2, 0, 0, 1, 3
"d:\IDEWORK\lvmen\src\licensedcode\data\rules\false-positive_899.yml", "YAML", 0, 0, 0, 2, 0, 0, 1, 3
"d:\IDEWORK\lvmen\src\licensedcode\data\rules\false-positive_9.yml", "YAML", 0, 0, 0, 2, 0, 0, 1, 3
"d:\IDEWORK\lvmen\src\licensedcode\data\rules\false-positive_90.yml", "YAML", 0, 0, 0, 2, 0, 0, 1, 3
"d:\IDEWORK\lvmen\src\licensedcode\data\rules\false-positive_900.yml", "YAML", 0, 0, 0, 2, 0, 0, 1, 3
"d:\IDEWORK\lvmen\src\licensedcode\data\rules\false-positive_901.yml", "YAML", 0, 0, 0, 2, 0, 0, 1, 3
"d:\IDEWORK\lvmen\src\licensedcode\data\rules\false-positive_902.yml", "YAML", 0, 0, 0, 2, 0, 0, 1, 3
"d:\IDEWORK\lvmen\src\licensedcode\data\rules\false-positive_903.yml", "YAML", 0, 0, 0, 2, 0, 0, 1, 3
"d:\IDEWORK\lvmen\src\licensedcode\data\rules\false-positive_904.yml", "YAML", 0, 0, 0, 2, 0, 0, 1, 3
"d:\IDEWORK\lvmen\src\licensedcode\data\rules\false-positive_905.yml", "YAML", 0, 0, 0, 2, 0, 0, 1, 3
"d:\IDEWORK\lvmen\src\licensedcode\data\rules\false-positive_906.yml", "YAML", 0, 0, 0, 2, 0, 0, 1, 3
"d:\IDEWORK\lvmen\src\licensedcode\data\rules\false-positive_907.yml", "YAML", 0, 0, 0, 2, 0, 0, 1, 3
"d:\IDEWORK\lvmen\src\licensedcode\data\rules\false-positive_908.yml", "YAML", 0, 0, 0, 2, 0, 0, 1, 3
"d:\IDEWORK\lvmen\src\licensedcode\data\rules\false-positive_909.yml", "YAML", 0, 0, 0, 2, 0, 0, 1, 3
"d:\IDEWORK\lvmen\src\licensedcode\data\rules\false-positive_91.yml", "YAML", 0, 0, 0, 2, 0, 0, 1, 3
"d:\IDEWORK\lvmen\src\licensedcode\data\rules\false-positive_910.yml", "YAML", 0, 0, 0, 2, 0, 0, 1, 3
"d:\IDEWORK\lvmen\src\licensedcode\data\rules\false-positive_911.yml", "YAML", 0, 0, 0, 2, 0, 0, 1, 3
"d:\IDEWORK\lvmen\src\licensedcode\data\rules\false-positive_912.yml", "YAML", 0, 0, 0, 2, 0, 0, 1, 3
"d:\IDEWORK\lvmen\src\licensedcode\data\rules\false-positive_913.yml", "YAML", 0, 0, 0, 2, 0, 0, 1, 3
"d:\IDEWORK\lvmen\src\licensedcode\data\rules\false-positive_914.yml", "YAML", 0, 0, 0, 2, 0, 0, 1, 3
"d:\IDEWORK\lvmen\src\licensedcode\data\rules\false-positive_915.yml", "YAML", 0, 0, 0, 2, 0, 0, 1, 3
"d:\IDEWORK\lvmen\src\licensedcode\data\rules\false-positive_916.yml", "YAML", 0, 0, 0, 2, 0, 0, 1, 3
"d:\IDEWORK\lvmen\src\licensedcode\data\rules\false-positive_917.yml", "YAML", 0, 0, 0, 2, 0, 0, 1, 3
"d:\IDEWORK\lvmen\src\licensedcode\data\rules\false-positive_918.yml", "YAML", 0, 0, 0, 2, 0, 0, 1, 3
"d:\IDEWORK\lvmen\src\licensedcode\data\rules\false-positive_919.yml", "YAML", 0, 0, 0, 2, 0, 0, 1, 3
"d:\IDEWORK\lvmen\src\licensedcode\data\rules\false-positive_92.yml", "YAML", 0, 0, 0, 2, 0, 0, 1, 3
"d:\IDEWORK\lvmen\src\licensedcode\data\rules\false-positive_920.yml", "YAML", 0, 0, 0, 2, 0, 0, 1, 3
"d:\IDEWORK\lvmen\src\licensedcode\data\rules\false-positive_921.yml", "YAML", 0, 0, 0, 2, 0, 0, 1, 3
"d:\IDEWORK\lvmen\src\licensedcode\data\rules\false-positive_922.yml", "YAML", 0, 0, 0, 2, 0, 0, 1, 3
"d:\IDEWORK\lvmen\src\licensedcode\data\rules\false-positive_923.yml", "YAML", 0, 0, 0, 2, 0, 0, 1, 3
"d:\IDEWORK\lvmen\src\licensedcode\data\rules\false-positive_924.yml", "YAML", 0, 0, 0, 2, 0, 0, 1, 3
"d:\IDEWORK\lvmen\src\licensedcode\data\rules\false-positive_925.yml", "YAML", 0, 0, 0, 2, 0, 0, 1, 3
"d:\IDEWORK\lvmen\src\licensedcode\data\rules\false-positive_926.yml", "YAML", 0, 0, 0, 2, 0, 0, 1, 3
"d:\IDEWORK\lvmen\src\licensedcode\data\rules\false-positive_927.yml", "YAML", 0, 0, 0, 2, 0, 0, 1, 3
"d:\IDEWORK\lvmen\src\licensedcode\data\rules\false-positive_928.yml", "YAML", 0, 0, 0, 2, 0, 0, 1, 3
"d:\IDEWORK\lvmen\src\licensedcode\data\rules\false-positive_929.yml", "YAML", 0, 0, 0, 2, 0, 0, 1, 3
"d:\IDEWORK\lvmen\src\licensedcode\data\rules\false-positive_93.yml", "YAML", 0, 0, 0, 2, 0, 0, 1, 3
"d:\IDEWORK\lvmen\src\licensedcode\data\rules\false-positive_930.yml", "YAML", 0, 0, 0, 2, 0, 0, 1, 3
"d:\IDEWORK\lvmen\src\licensedcode\data\rules\false-positive_931.yml", "YAML", 0, 0, 0, 2, 0, 0, 1, 3
"d:\IDEWORK\lvmen\src\licensedcode\data\rules\false-positive_932.yml", "YAML", 0, 0, 0, 2, 0, 0, 1, 3
"d:\IDEWORK\lvmen\src\licensedcode\data\rules\false-positive_933.yml", "YAML", 0, 0, 0, 2, 0, 0, 1, 3
"d:\IDEWORK\lvmen\src\licensedcode\data\rules\false-positive_934.yml", "YAML", 0, 0, 0, 2, 0, 0, 1, 3
"d:\IDEWORK\lvmen\src\licensedcode\data\rules\false-positive_935.yml", "YAML", 0, 0, 0, 2, 0, 0, 1, 3
"d:\IDEWORK\lvmen\src\licensedcode\data\rules\false-positive_936.yml", "YAML", 0, 0, 0, 2, 0, 0, 1, 3
"d:\IDEWORK\lvmen\src\licensedcode\data\rules\false-positive_937.yml", "YAML", 0, 0, 0, 2, 0, 0, 1, 3
"d:\IDEWORK\lvmen\src\licensedcode\data\rules\false-positive_938.yml", "YAML", 0, 0, 0, 2, 0, 0, 1, 3
"d:\IDEWORK\lvmen\src\licensedcode\data\rules\false-positive_939.yml", "YAML", 0, 0, 0, 2, 0, 0, 1, 3
"d:\IDEWORK\lvmen\src\licensedcode\data\rules\false-positive_94.yml", "YAML", 0, 0, 0, 2, 0, 0, 1, 3
"d:\IDEWORK\lvmen\src\licensedcode\data\rules\false-positive_940.yml", "YAML", 0, 0, 0, 2, 0, 0, 1, 3
"d:\IDEWORK\lvmen\src\licensedcode\data\rules\false-positive_941.yml", "YAML", 0, 0, 0, 2, 0, 0, 1, 3
"d:\IDEWORK\lvmen\src\licensedcode\data\rules\false-positive_942.yml", "YAML", 0, 0, 0, 2, 0, 0, 1, 3
"d:\IDEWORK\lvmen\src\licensedcode\data\rules\false-positive_943.yml", "YAML", 0, 0, 0, 2, 0, 0, 1, 3
"d:\IDEWORK\lvmen\src\licensedcode\data\rules\false-positive_944.yml", "YAML", 0, 0, 0, 2, 0, 0, 1, 3
"d:\IDEWORK\lvmen\src\licensedcode\data\rules\false-positive_945.yml", "YAML", 0, 0, 0, 2, 0, 0, 1, 3
"d:\IDEWORK\lvmen\src\licensedcode\data\rules\false-positive_946.yml", "YAML", 0, 0, 0, 2, 0, 0, 1, 3
"d:\IDEWORK\lvmen\src\licensedcode\data\rules\false-positive_947.yml", "YAML", 0, 0, 0, 2, 0, 0, 1, 3
"d:\IDEWORK\lvmen\src\licensedcode\data\rules\false-positive_948.yml", "YAML", 0, 0, 0, 2, 0, 0, 1, 3
"d:\IDEWORK\lvmen\src\licensedcode\data\rules\false-positive_949.yml", "YAML", 0, 0, 0, 2, 0, 0, 1, 3
"d:\IDEWORK\lvmen\src\licensedcode\data\rules\false-positive_95.yml", "YAML", 0, 0, 0, 3, 0, 0, 1, 4
"d:\IDEWORK\lvmen\src\licensedcode\data\rules\false-positive_950.yml", "YAML", 0, 0, 0, 2, 0, 0, 1, 3
"d:\IDEWORK\lvmen\src\licensedcode\data\rules\false-positive_951.yml", "YAML", 0, 0, 0, 2, 0, 0, 1, 3
"d:\IDEWORK\lvmen\src\licensedcode\data\rules\false-positive_952.yml", "YAML", 0, 0, 0, 2, 0, 0, 1, 3
"d:\IDEWORK\lvmen\src\licensedcode\data\rules\false-positive_953.yml", "YAML", 0, 0, 0, 2, 0, 0, 1, 3
"d:\IDEWORK\lvmen\src\licensedcode\data\rules\false-positive_954.yml", "YAML", 0, 0, 0, 2, 0, 0, 1, 3
"d:\IDEWORK\lvmen\src\licensedcode\data\rules\false-positive_955.yml", "YAML", 0, 0, 0, 2, 0, 0, 1, 3
"d:\IDEWORK\lvmen\src\licensedcode\data\rules\false-positive_956.yml", "YAML", 0, 0, 0, 2, 0, 0, 1, 3
"d:\IDEWORK\lvmen\src\licensedcode\data\rules\false-positive_957.yml", "YAML", 0, 0, 0, 2, 0, 0, 1, 3
"d:\IDEWORK\lvmen\src\licensedcode\data\rules\false-positive_958.yml", "YAML", 0, 0, 0, 2, 0, 0, 1, 3
"d:\IDEWORK\lvmen\src\licensedcode\data\rules\false-positive_959.yml", "YAML", 0, 0, 0, 2, 0, 0, 1, 3
"d:\IDEWORK\lvmen\src\licensedcode\data\rules\false-positive_96.yml", "YAML", 0, 0, 0, 2, 0, 0, 1, 3
"d:\IDEWORK\lvmen\src\licensedcode\data\rules\false-positive_960.yml", "YAML", 0, 0, 0, 2, 0, 0, 1, 3
"d:\IDEWORK\lvmen\src\licensedcode\data\rules\false-positive_961.yml", "YAML", 0, 0, 0, 2, 0, 0, 1, 3
"d:\IDEWORK\lvmen\src\licensedcode\data\rules\false-positive_962.yml", "YAML", 0, 0, 0, 2, 0, 0, 1, 3
"d:\IDEWORK\lvmen\src\licensedcode\data\rules\false-positive_963.yml", "YAML", 0, 0, 0, 2, 0, 0, 1, 3
"d:\IDEWORK\lvmen\src\licensedcode\data\rules\false-positive_964.yml", "YAML", 0, 0, 0, 2, 0, 0, 1, 3
"d:\IDEWORK\lvmen\src\licensedcode\data\rules\false-positive_965.yml", "YAML", 0, 0, 0, 2, 0, 0, 1, 3
"d:\IDEWORK\lvmen\src\licensedcode\data\rules\false-positive_966.yml", "YAML", 0, 0, 0, 2, 0, 0, 1, 3
"d:\IDEWORK\lvmen\src\licensedcode\data\rules\false-positive_967.yml", "YAML", 0, 0, 0, 2, 0, 0, 1, 3
"d:\IDEWORK\lvmen\src\licensedcode\data\rules\false-positive_968.yml", "YAML", 0, 0, 0, 2, 0, 0, 1, 3
"d:\IDEWORK\lvmen\src\licensedcode\data\rules\false-positive_969.yml", "YAML", 0, 0, 0, 2, 0, 0, 1, 3
"d:\IDEWORK\lvmen\src\licensedcode\data\rules\false-positive_97.yml", "YAML", 0, 0, 0, 2, 0, 0, 1, 3
"d:\IDEWORK\lvmen\src\licensedcode\data\rules\false-positive_970.yml", "YAML", 0, 0, 0, 2, 0, 0, 1, 3
"d:\IDEWORK\lvmen\src\licensedcode\data\rules\false-positive_971.yml", "YAML", 0, 0, 0, 2, 0, 0, 1, 3
"d:\IDEWORK\lvmen\src\licensedcode\data\rules\false-positive_972.yml", "YAML", 0, 0, 0, 2, 0, 0, 1, 3
"d:\IDEWORK\lvmen\src\licensedcode\data\rules\false-positive_973.yml", "YAML", 0, 0, 0, 2, 0, 0, 1, 3
"d:\IDEWORK\lvmen\src\licensedcode\data\rules\false-positive_974.yml", "YAML", 0, 0, 0, 2, 0, 0, 1, 3
"d:\IDEWORK\lvmen\src\licensedcode\data\rules\false-positive_975.yml", "YAML", 0, 0, 0, 2, 0, 0, 1, 3
"d:\IDEWORK\lvmen\src\licensedcode\data\rules\false-positive_976.yml", "YAML", 0, 0, 0, 2, 0, 0, 1, 3
"d:\IDEWORK\lvmen\src\licensedcode\data\rules\false-positive_977.yml", "YAML", 0, 0, 0, 2, 0, 0, 1, 3
"d:\IDEWORK\lvmen\src\licensedcode\data\rules\false-positive_978.yml", "YAML", 0, 0, 0, 2, 0, 0, 1, 3
"d:\IDEWORK\lvmen\src\licensedcode\data\rules\false-positive_979.yml", "YAML", 0, 0, 0, 2, 0, 0, 1, 3
"d:\IDEWORK\lvmen\src\licensedcode\data\rules\false-positive_98.yml", "YAML", 0, 0, 0, 3, 0, 0, 1, 4
"d:\IDEWORK\lvmen\src\licensedcode\data\rules\false-positive_980.yml", "YAML", 0, 0, 0, 2, 0, 0, 1, 3
"d:\IDEWORK\lvmen\src\licensedcode\data\rules\false-positive_981.yml", "YAML", 0, 0, 0, 2, 0, 0, 1, 3
"d:\IDEWORK\lvmen\src\licensedcode\data\rules\false-positive_982.yml", "YAML", 0, 0, 0, 2, 0, 0, 1, 3
"d:\IDEWORK\lvmen\src\licensedcode\data\rules\false-positive_983.yml", "YAML", 0, 0, 0, 2, 0, 0, 1, 3
"d:\IDEWORK\lvmen\src\licensedcode\data\rules\false-positive_984.yml", "YAML", 0, 0, 0, 2, 0, 0, 1, 3
"d:\IDEWORK\lvmen\src\licensedcode\data\rules\false-positive_985.yml", "YAML", 0, 0, 0, 2, 0, 0, 1, 3
"d:\IDEWORK\lvmen\src\licensedcode\data\rules\false-positive_986.yml", "YAML", 0, 0, 0, 2, 0, 0, 1, 3
"d:\IDEWORK\lvmen\src\licensedcode\data\rules\false-positive_987.yml", "YAML", 0, 0, 0, 2, 0, 0, 1, 3
"d:\IDEWORK\lvmen\src\licensedcode\data\rules\false-positive_988.yml", "YAML", 0, 0, 0, 2, 0, 0, 1, 3
"d:\IDEWORK\lvmen\src\licensedcode\data\rules\false-positive_989.yml", "YAML", 0, 0, 0, 2, 0, 0, 1, 3
"d:\IDEWORK\lvmen\src\licensedcode\data\rules\false-positive_99.yml", "YAML", 0, 0, 0, 2, 0, 0, 1, 3
"d:\IDEWORK\lvmen\src\licensedcode\data\rules\false-positive_990.yml", "YAML", 0, 0, 0, 2, 0, 0, 1, 3
"d:\IDEWORK\lvmen\src\licensedcode\data\rules\false-positive_991.yml", "YAML", 0, 0, 0, 2, 0, 0, 1, 3
"d:\IDEWORK\lvmen\src\licensedcode\data\rules\false-positive_992.yml", "YAML", 0, 0, 0, 2, 0, 0, 1, 3
"d:\IDEWORK\lvmen\src\licensedcode\data\rules\false-positive_993.yml", "YAML", 0, 0, 0, 2, 0, 0, 1, 3
"d:\IDEWORK\lvmen\src\licensedcode\data\rules\false-positive_994.yml", "YAML", 0, 0, 0, 2, 0, 0, 1, 3
"d:\IDEWORK\lvmen\src\licensedcode\data\rules\false-positive_995.yml", "YAML", 0, 0, 0, 2, 0, 0, 1, 3
"d:\IDEWORK\lvmen\src\licensedcode\data\rules\false-positive_996.yml", "YAML", 0, 0, 0, 2, 0, 0, 1, 3
"d:\IDEWORK\lvmen\src\licensedcode\data\rules\false-positive_997.yml", "YAML", 0, 0, 0, 2, 0, 0, 1, 3
"d:\IDEWORK\lvmen\src\licensedcode\data\rules\false-positive_998.yml", "YAML", 0, 0, 0, 2, 0, 0, 1, 3
"d:\IDEWORK\lvmen\src\licensedcode\data\rules\false-positive_999.yml", "YAML", 0, 0, 0, 2, 0, 0, 1, 3
"d:\IDEWORK\lvmen\src\licensedcode\data\rules\false-positive_afl-1._1.yml", "YAML", 0, 0, 0, 2, 0, 0, 1, 3
"d:\IDEWORK\lvmen\src\licensedcode\data\rules\false-positive_afpl-9.0_or_gpl-1.0-plus_1.yml", "YAML", 0, 0, 0, 2, 0, 0, 1, 3
"d:\IDEWORK\lvmen\src\licensedcode\data\rules\false-positive_ansible_1.yml", "YAML", 0, 0, 0, 2, 0, 0, 1, 3
"d:\IDEWORK\lvmen\src\licensedcode\data\rules\false-positive_ansible_2.yml", "YAML", 0, 0, 0, 2, 0, 0, 1, 3
"d:\IDEWORK\lvmen\src\licensedcode\data\rules\false-positive_apache-1._1.yml", "YAML", 0, 0, 0, 3, 0, 0, 1, 4
"d:\IDEWORK\lvmen\src\licensedcode\data\rules\false-positive_apache-2.0_1.yml", "YAML", 0, 0, 0, 3, 0, 0, 1, 4
"d:\IDEWORK\lvmen\src\licensedcode\data\rules\false-positive_boost_1.yml", "YAML", 0, 0, 0, 2, 0, 0, 1, 3
"d:\IDEWORK\lvmen\src\licensedcode\data\rules\false-positive_boost_2.yml", "YAML", 0, 0, 0, 2, 0, 0, 1, 3
"d:\IDEWORK\lvmen\src\licensedcode\data\rules\false-positive_bsd-2-clause-freebsd_1.yml", "YAML", 0, 0, 0, 2, 0, 0, 1, 3
"d:\IDEWORK\lvmen\src\licensedcode\data\rules\false-positive_bsd_1.yml", "YAML", 0, 0, 0, 3, 0, 0, 1, 4
"d:\IDEWORK\lvmen\src\licensedcode\data\rules\false-positive_bsd_2.yml", "YAML", 0, 0, 0, 2, 0, 0, 1, 3
"d:\IDEWORK\lvmen\src\licensedcode\data\rules\false-positive_busybox_1.yml", "YAML", 0, 0, 0, 2, 0, 0, 1, 3
"d:\IDEWORK\lvmen\src\licensedcode\data\rules\false-positive_busybox_2.yml", "YAML", 0, 0, 0, 3, 0, 0, 1, 4
"d:\IDEWORK\lvmen\src\licensedcode\data\rules\false-positive_cc-by-3.0_1.yml", "YAML", 0, 0, 0, 2, 0, 0, 1, 3
"d:\IDEWORK\lvmen\src\licensedcode\data\rules\false-positive_clish_1.yml", "YAML", 0, 0, 0, 2, 0, 0, 1, 3
"d:\IDEWORK\lvmen\src\licensedcode\data\rules\false-positive_copying_files_1.yml", "YAML", 0, 0, 0, 3, 0, 0, 1, 4
"d:\IDEWORK\lvmen\src\licensedcode\data\rules\false-positive_copying_files_2.yml", "YAML", 0, 0, 0, 2, 0, 0, 1, 3
"d:\IDEWORK\lvmen\src\licensedcode\data\rules\false-positive_copying_files_3.yml", "YAML", 0, 0, 0, 2, 0, 0, 1, 3
"d:\IDEWORK\lvmen\src\licensedcode\data\rules\false-positive_copying_files_4.yml", "YAML", 0, 0, 0, 3, 0, 0, 1, 4
"d:\IDEWORK\lvmen\src\licensedcode\data\rules\false-positive_copying_files_5.yml", "YAML", 0, 0, 0, 2, 0, 0, 1, 3
"d:\IDEWORK\lvmen\src\licensedcode\data\rules\false-positive_credits_1.yml", "YAML", 0, 0, 0, 2, 0, 0, 1, 3
"d:\IDEWORK\lvmen\src\licensedcode\data\rules\false-positive_data-license-list_1.yml", "YAML", 0, 0, 0, 2, 0, 0, 1, 3
"d:\IDEWORK\lvmen\src\licensedcode\data\rules\false-positive_data-license-list_10.yml", "YAML", 0, 0, 0, 2, 0, 0, 1, 3
"d:\IDEWORK\lvmen\src\licensedcode\data\rules\false-positive_data-license-list_11.yml", "YAML", 0, 0, 0, 2, 0, 0, 1, 3
"d:\IDEWORK\lvmen\src\licensedcode\data\rules\false-positive_data-license-list_12.yml", "YAML", 0, 0, 0, 2, 0, 0, 1, 3
"d:\IDEWORK\lvmen\src\licensedcode\data\rules\false-positive_data-license-list_13.yml", "YAML", 0, 0, 0, 2, 0, 0, 1, 3
"d:\IDEWORK\lvmen\src\licensedcode\data\rules\false-positive_data-license-list_14.yml", "YAML", 0, 0, 0, 2, 0, 0, 1, 3
"d:\IDEWORK\lvmen\src\licensedcode\data\rules\false-positive_data-license-list_15.yml", "YAML", 0, 0, 0, 2, 0, 0, 1, 3
"d:\IDEWORK\lvmen\src\licensedcode\data\rules\false-positive_data-license-list_2.yml", "YAML", 0, 0, 0, 2, 0, 0, 1, 3
"d:\IDEWORK\lvmen\src\licensedcode\data\rules\false-positive_data-license-list_3.yml", "YAML", 0, 0, 0, 2, 0, 0, 1, 3
"d:\IDEWORK\lvmen\src\licensedcode\data\rules\false-positive_data-license-list_4.yml", "YAML", 0, 0, 0, 2, 0, 0, 1, 3
"d:\IDEWORK\lvmen\src\licensedcode\data\rules\false-positive_data-license-list_5.yml", "YAML", 0, 0, 0, 2, 0, 0, 1, 3
"d:\IDEWORK\lvmen\src\licensedcode\data\rules\false-positive_data-license-list_6.yml", "YAML", 0, 0, 0, 2, 0, 0, 1, 3
"d:\IDEWORK\lvmen\src\licensedcode\data\rules\false-positive_data-license-list_7.yml", "YAML", 0, 0, 0, 2, 0, 0, 1, 3
"d:\IDEWORK\lvmen\src\licensedcode\data\rules\false-positive_data-license-list_8.yml", "YAML", 0, 0, 0, 2, 0, 0, 1, 3
"d:\IDEWORK\lvmen\src\licensedcode\data\rules\false-positive_data-license-list_9.yml", "YAML", 0, 0, 0, 2, 0, 0, 1, 3
"d:\IDEWORK\lvmen\src\licensedcode\data\rules\false-positive_dmalloc_1.yml", "YAML", 0, 0, 0, 2, 0, 0, 1, 3
"d:\IDEWORK\lvmen\src\licensedcode\data\rules\false-positive_ecos_1.yml", "YAML", 0, 0, 0, 2, 0, 0, 1, 3
"d:\IDEWORK\lvmen\src\licensedcode\data\rules\false-positive_ecos_2.yml", "YAML", 0, 0, 0, 2, 0, 0, 1, 3
"d:\IDEWORK\lvmen\src\licensedcode\data\rules\false-positive_ecos_3.yml", "YAML", 0, 0, 0, 2, 0, 0, 1, 3
"d:\IDEWORK\lvmen\src\licensedcode\data\rules\false-positive_ecos_4.yml", "YAML", 0, 0, 0, 2, 0, 0, 1, 3
"d:\IDEWORK\lvmen\src\licensedcode\data\rules\false-positive_ecos_5.yml", "YAML", 0, 0, 0, 2, 0, 0, 1, 3
"d:\IDEWORK\lvmen\src\licensedcode\data\rules\false-positive_ecos_6.yml", "YAML", 0, 0, 0, 2, 0, 0, 1, 3
"d:\IDEWORK\lvmen\src\licensedcode\data\rules\false-positive_ecos_7.yml", "YAML", 0, 0, 0, 2, 0, 0, 1, 3
"d:\IDEWORK\lvmen\src\licensedcode\data\rules\false-positive_eigen_1.yml", "YAML", 0, 0, 0, 2, 0, 0, 1, 3
"d:\IDEWORK\lvmen\src\licensedcode\data\rules\false-positive_eigen_2.yml", "YAML", 0, 0, 0, 2, 0, 0, 1, 3
"d:\IDEWORK\lvmen\src\licensedcode\data\rules\false-positive_eigen_3.yml", "YAML", 0, 0, 0, 2, 0, 0, 1, 3
"d:\IDEWORK\lvmen\src\licensedcode\data\rules\false-positive_eigen_4.yml", "YAML", 0, 0, 0, 2, 0, 0, 1, 3
"d:\IDEWORK\lvmen\src\licensedcode\data\rules\false-positive_eigen_5.yml", "YAML", 0, 0, 0, 2, 0, 0, 1, 3
"d:\IDEWORK\lvmen\src\licensedcode\data\rules\false-positive_gif_1.yml", "YAML", 0, 0, 0, 2, 0, 0, 1, 3
"d:\IDEWORK\lvmen\src\licensedcode\data\rules\false-positive_gif_2.yml", "YAML", 0, 0, 0, 2, 0, 0, 1, 3
"d:\IDEWORK\lvmen\src\licensedcode\data\rules\false-positive_gpl-1.0-plus_1.yml", "YAML", 0, 0, 0, 2, 0, 0, 1, 3
"d:\IDEWORK\lvmen\src\licensedcode\data\rules\false-positive_gpl-1.0-plus_2.yml", "YAML", 0, 0, 0, 2, 0, 0, 1, 3
"d:\IDEWORK\lvmen\src\licensedcode\data\rules\false-positive_gpl-1.0-plus_and_artistic-1.0_1.yml", "YAML", 0, 0, 0, 2, 0, 0, 1, 3
"d:\IDEWORK\lvmen\src\licensedcode\data\rules\false-positive_gpl-1.0-plus_historical_note_1.yml", "YAML", 0, 0, 0, 4, 0, 0, 1, 5
"d:\IDEWORK\lvmen\src\licensedcode\data\rules\false-positive_gpl-2._1.yml", "YAML", 0, 0, 0, 2, 0, 0, 1, 3
"d:\IDEWORK\lvmen\src\licensedcode\data\rules\false-positive_gpl-mention-in-doc_1.yml", "YAML", 0, 0, 0, 2, 0, 0, 1, 3
"d:\IDEWORK\lvmen\src\licensedcode\data\rules\false-positive_gpl_1.yml", "YAML", 0, 0, 0, 2, 0, 0, 1, 3
"d:\IDEWORK\lvmen\src\licensedcode\data\rules\false-positive_gpl_file_include_1.yml", "YAML", 0, 0, 0, 2, 0, 0, 1, 3
"d:\IDEWORK\lvmen\src\licensedcode\data\rules\false-positive_gpl_file_name_1.yml", "YAML", 0, 0, 0, 2, 0, 0, 1, 3
"d:\IDEWORK\lvmen\src\licensedcode\data\rules\false-positive_gpl_file_name_2.yml", "YAML", 0, 0, 0, 2, 0, 0, 1, 3
"d:\IDEWORK\lvmen\src\licensedcode\data\rules\false-positive_gpl_in_apache_comment_1.yml", "YAML", 0, 0, 0, 2, 0, 0, 1, 3
"d:\IDEWORK\lvmen\src\licensedcode\data\rules\false-positive_gpl_kernel_sym_1.yml", "YAML", 0, 0, 0, 2, 0, 0, 1, 3
"d:\IDEWORK\lvmen\src\licensedcode\data\rules\false-positive_gpl_kernel_sym_10.yml", "YAML", 0, 0, 0, 2, 0, 0, 1, 3
"d:\IDEWORK\lvmen\src\licensedcode\data\rules\false-positive_gpl_kernel_sym_100.yml", "YAML", 0, 0, 0, 2, 0, 0, 1, 3
"d:\IDEWORK\lvmen\src\licensedcode\data\rules\false-positive_gpl_kernel_sym_101.yml", "YAML", 0, 0, 0, 2, 0, 0, 1, 3
"d:\IDEWORK\lvmen\src\licensedcode\data\rules\false-positive_gpl_kernel_sym_102.yml", "YAML", 0, 0, 0, 2, 0, 0, 1, 3
"d:\IDEWORK\lvmen\src\licensedcode\data\rules\false-positive_gpl_kernel_sym_103.yml", "YAML", 0, 0, 0, 2, 0, 0, 1, 3
"d:\IDEWORK\lvmen\src\licensedcode\data\rules\false-positive_gpl_kernel_sym_104.yml", "YAML", 0, 0, 0, 2, 0, 0, 1, 3
"d:\IDEWORK\lvmen\src\licensedcode\data\rules\false-positive_gpl_kernel_sym_105.yml", "YAML", 0, 0, 0, 2, 0, 0, 1, 3
"d:\IDEWORK\lvmen\src\licensedcode\data\rules\false-positive_gpl_kernel_sym_106.yml", "YAML", 0, 0, 0, 2, 0, 0, 1, 3
"d:\IDEWORK\lvmen\src\licensedcode\data\rules\false-positive_gpl_kernel_sym_107.yml", "YAML", 0, 0, 0, 2, 0, 0, 1, 3
"d:\IDEWORK\lvmen\src\licensedcode\data\rules\false-positive_gpl_kernel_sym_108.yml", "YAML", 0, 0, 0, 2, 0, 0, 1, 3
"d:\IDEWORK\lvmen\src\licensedcode\data\rules\false-positive_gpl_kernel_sym_109.yml", "YAML", 0, 0, 0, 2, 0, 0, 1, 3
"d:\IDEWORK\lvmen\src\licensedcode\data\rules\false-positive_gpl_kernel_sym_11.yml", "YAML", 0, 0, 0, 2, 0, 0, 1, 3
"d:\IDEWORK\lvmen\src\licensedcode\data\rules\false-positive_gpl_kernel_sym_110.yml", "YAML", 0, 0, 0, 2, 0, 0, 1, 3
"d:\IDEWORK\lvmen\src\licensedcode\data\rules\false-positive_gpl_kernel_sym_111.yml", "YAML", 0, 0, 0, 2, 0, 0, 1, 3
"d:\IDEWORK\lvmen\src\licensedcode\data\rules\false-positive_gpl_kernel_sym_112.yml", "YAML", 0, 0, 0, 2, 0, 0, 1, 3
"d:\IDEWORK\lvmen\src\licensedcode\data\rules\false-positive_gpl_kernel_sym_113.yml", "YAML", 0, 0, 0, 2, 0, 0, 1, 3
"d:\IDEWORK\lvmen\src\licensedcode\data\rules\false-positive_gpl_kernel_sym_114.yml", "YAML", 0, 0, 0, 2, 0, 0, 1, 3
"d:\IDEWORK\lvmen\src\licensedcode\data\rules\false-positive_gpl_kernel_sym_115.yml", "YAML", 0, 0, 0, 2, 0, 0, 1, 3
"d:\IDEWORK\lvmen\src\licensedcode\data\rules\false-positive_gpl_kernel_sym_116.yml", "YAML", 0, 0, 0, 2, 0, 0, 1, 3
"d:\IDEWORK\lvmen\src\licensedcode\data\rules\false-positive_gpl_kernel_sym_117.yml", "YAML", 0, 0, 0, 2, 0, 0, 1, 3
"d:\IDEWORK\lvmen\src\licensedcode\data\rules\false-positive_gpl_kernel_sym_118.yml", "YAML", 0, 0, 0, 2, 0, 0, 1, 3
"d:\IDEWORK\lvmen\src\licensedcode\data\rules\false-positive_gpl_kernel_sym_119.yml", "YAML", 0, 0, 0, 2, 0, 0, 1, 3
"d:\IDEWORK\lvmen\src\licensedcode\data\rules\false-positive_gpl_kernel_sym_12.yml", "YAML", 0, 0, 0, 2, 0, 0, 1, 3
"d:\IDEWORK\lvmen\src\licensedcode\data\rules\false-positive_gpl_kernel_sym_120.yml", "YAML", 0, 0, 0, 2, 0, 0, 1, 3
"d:\IDEWORK\lvmen\src\licensedcode\data\rules\false-positive_gpl_kernel_sym_121.yml", "YAML", 0, 0, 0, 2, 0, 0, 1, 3
"d:\IDEWORK\lvmen\src\licensedcode\data\rules\false-positive_gpl_kernel_sym_122.yml", "YAML", 0, 0, 0, 2, 0, 0, 1, 3
"d:\IDEWORK\lvmen\src\licensedcode\data\rules\false-positive_gpl_kernel_sym_123.yml", "YAML", 0, 0, 0, 2, 0, 0, 1, 3
"d:\IDEWORK\lvmen\src\licensedcode\data\rules\false-positive_gpl_kernel_sym_124.yml", "YAML", 0, 0, 0, 2, 0, 0, 1, 3
"d:\IDEWORK\lvmen\src\licensedcode\data\rules\false-positive_gpl_kernel_sym_125.yml", "YAML", 0, 0, 0, 2, 0, 0, 1, 3
"d:\IDEWORK\lvmen\src\licensedcode\data\rules\false-positive_gpl_kernel_sym_126.yml", "YAML", 0, 0, 0, 2, 0, 0, 1, 3
"d:\IDEWORK\lvmen\src\licensedcode\data\rules\false-positive_gpl_kernel_sym_127.yml", "YAML", 0, 0, 0, 2, 0, 0, 1, 3
"d:\IDEWORK\lvmen\src\licensedcode\data\rules\false-positive_gpl_kernel_sym_128.yml", "YAML", 0, 0, 0, 2, 0, 0, 1, 3
"d:\IDEWORK\lvmen\src\licensedcode\data\rules\false-positive_gpl_kernel_sym_129.yml", "YAML", 0, 0, 0, 2, 0, 0, 1, 3
"d:\IDEWORK\lvmen\src\licensedcode\data\rules\false-positive_gpl_kernel_sym_13.yml", "YAML", 0, 0, 0, 2, 0, 0, 1, 3
"d:\IDEWORK\lvmen\src\licensedcode\data\rules\false-positive_gpl_kernel_sym_130.yml", "YAML", 0, 0, 0, 2, 0, 0, 1, 3
"d:\IDEWORK\lvmen\src\licensedcode\data\rules\false-positive_gpl_kernel_sym_131.yml", "YAML", 0, 0, 0, 2, 0, 0, 1, 3
"d:\IDEWORK\lvmen\src\licensedcode\data\rules\false-positive_gpl_kernel_sym_132.yml", "YAML", 0, 0, 0, 2, 0, 0, 1, 3
"d:\IDEWORK\lvmen\src\licensedcode\data\rules\false-positive_gpl_kernel_sym_133.yml", "YAML", 0, 0, 0, 2, 0, 0, 1, 3
"d:\IDEWORK\lvmen\src\licensedcode\data\rules\false-positive_gpl_kernel_sym_134.yml", "YAML", 0, 0, 0, 2, 0, 0, 1, 3
"d:\IDEWORK\lvmen\src\licensedcode\data\rules\false-positive_gpl_kernel_sym_135.yml", "YAML", 0, 0, 0, 2, 0, 0, 1, 3
"d:\IDEWORK\lvmen\src\licensedcode\data\rules\false-positive_gpl_kernel_sym_136.yml", "YAML", 0, 0, 0, 2, 0, 0, 1, 3
"d:\IDEWORK\lvmen\src\licensedcode\data\rules\false-positive_gpl_kernel_sym_137.yml", "YAML", 0, 0, 0, 2, 0, 0, 1, 3
"d:\IDEWORK\lvmen\src\licensedcode\data\rules\false-positive_gpl_kernel_sym_138.yml", "YAML", 0, 0, 0, 2, 0, 0, 1, 3
"d:\IDEWORK\lvmen\src\licensedcode\data\rules\false-positive_gpl_kernel_sym_139.yml", "YAML", 0, 0, 0, 2, 0, 0, 1, 3
"d:\IDEWORK\lvmen\src\licensedcode\data\rules\false-positive_gpl_kernel_sym_14.yml", "YAML", 0, 0, 0, 2, 0, 0, 1, 3
"d:\IDEWORK\lvmen\src\licensedcode\data\rules\false-positive_gpl_kernel_sym_140.yml", "YAML", 0, 0, 0, 2, 0, 0, 1, 3
"d:\IDEWORK\lvmen\src\licensedcode\data\rules\false-positive_gpl_kernel_sym_141.yml", "YAML", 0, 0, 0, 2, 0, 0, 1, 3
"d:\IDEWORK\lvmen\src\licensedcode\data\rules\false-positive_gpl_kernel_sym_142.yml", "YAML", 0, 0, 0, 2, 0, 0, 1, 3
"d:\IDEWORK\lvmen\src\licensedcode\data\rules\false-positive_gpl_kernel_sym_143.yml", "YAML", 0, 0, 0, 2, 0, 0, 1, 3
"d:\IDEWORK\lvmen\src\licensedcode\data\rules\false-positive_gpl_kernel_sym_144.yml", "YAML", 0, 0, 0, 2, 0, 0, 1, 3
"d:\IDEWORK\lvmen\src\licensedcode\data\rules\false-positive_gpl_kernel_sym_145.yml", "YAML", 0, 0, 0, 2, 0, 0, 1, 3
"d:\IDEWORK\lvmen\src\licensedcode\data\rules\false-positive_gpl_kernel_sym_146.yml", "YAML", 0, 0, 0, 2, 0, 0, 1, 3
"d:\IDEWORK\lvmen\src\licensedcode\data\rules\false-positive_gpl_kernel_sym_147.yml", "YAML", 0, 0, 0, 2, 0, 0, 1, 3
"d:\IDEWORK\lvmen\src\licensedcode\data\rules\false-positive_gpl_kernel_sym_148.yml", "YAML", 0, 0, 0, 2, 0, 0, 1, 3
"d:\IDEWORK\lvmen\src\licensedcode\data\rules\false-positive_gpl_kernel_sym_149.yml", "YAML", 0, 0, 0, 2, 0, 0, 1, 3
"d:\IDEWORK\lvmen\src\licensedcode\data\rules\false-positive_gpl_kernel_sym_15.yml", "YAML", 0, 0, 0, 2, 0, 0, 1, 3
"d:\IDEWORK\lvmen\src\licensedcode\data\rules\false-positive_gpl_kernel_sym_150.yml", "YAML", 0, 0, 0, 2, 0, 0, 1, 3
"d:\IDEWORK\lvmen\src\licensedcode\data\rules\false-positive_gpl_kernel_sym_151.yml", "YAML", 0, 0, 0, 2, 0, 0, 1, 3
"d:\IDEWORK\lvmen\src\licensedcode\data\rules\false-positive_gpl_kernel_sym_152.yml", "YAML", 0, 0, 0, 2, 0, 0, 1, 3
"d:\IDEWORK\lvmen\src\licensedcode\data\rules\false-positive_gpl_kernel_sym_153.yml", "YAML", 0, 0, 0, 2, 0, 0, 1, 3
"d:\IDEWORK\lvmen\src\licensedcode\data\rules\false-positive_gpl_kernel_sym_154.yml", "YAML", 0, 0, 0, 2, 0, 0, 1, 3
"d:\IDEWORK\lvmen\src\licensedcode\data\rules\false-positive_gpl_kernel_sym_155.yml", "YAML", 0, 0, 0, 2, 0, 0, 1, 3
"d:\IDEWORK\lvmen\src\licensedcode\data\rules\false-positive_gpl_kernel_sym_156.yml", "YAML", 0, 0, 0, 2, 0, 0, 1, 3
"d:\IDEWORK\lvmen\src\licensedcode\data\rules\false-positive_gpl_kernel_sym_157.yml", "YAML", 0, 0, 0, 3, 0, 0, 1, 4
"d:\IDEWORK\lvmen\src\licensedcode\data\rules\false-positive_gpl_kernel_sym_158.yml", "YAML", 0, 0, 0, 2, 0, 0, 1, 3
"d:\IDEWORK\lvmen\src\licensedcode\data\rules\false-positive_gpl_kernel_sym_159.yml", "YAML", 0, 0, 0, 2, 0, 0, 1, 3
"d:\IDEWORK\lvmen\src\licensedcode\data\rules\false-positive_gpl_kernel_sym_16.yml", "YAML", 0, 0, 0, 2, 0, 0, 1, 3
"d:\IDEWORK\lvmen\src\licensedcode\data\rules\false-positive_gpl_kernel_sym_160.yml", "YAML", 0, 0, 0, 2, 0, 0, 1, 3
"d:\IDEWORK\lvmen\src\licensedcode\data\rules\false-positive_gpl_kernel_sym_161.yml", "YAML", 0, 0, 0, 2, 0, 0, 1, 3
"d:\IDEWORK\lvmen\src\licensedcode\data\rules\false-positive_gpl_kernel_sym_162.yml", "YAML", 0, 0, 0, 2, 0, 0, 1, 3
"d:\IDEWORK\lvmen\src\licensedcode\data\rules\false-positive_gpl_kernel_sym_163.yml", "YAML", 0, 0, 0, 2, 0, 0, 1, 3
"d:\IDEWORK\lvmen\src\licensedcode\data\rules\false-positive_gpl_kernel_sym_164.yml", "YAML", 0, 0, 0, 2, 0, 0, 1, 3
"d:\IDEWORK\lvmen\src\licensedcode\data\rules\false-positive_gpl_kernel_sym_165.yml", "YAML", 0, 0, 0, 2, 0, 0, 1, 3
"d:\IDEWORK\lvmen\src\licensedcode\data\rules\false-positive_gpl_kernel_sym_166.yml", "YAML", 0, 0, 0, 2, 0, 0, 1, 3
"d:\IDEWORK\lvmen\src\licensedcode\data\rules\false-positive_gpl_kernel_sym_167.yml", "YAML", 0, 0, 0, 2, 0, 0, 1, 3
"d:\IDEWORK\lvmen\src\licensedcode\data\rules\false-positive_gpl_kernel_sym_168.yml", "YAML", 0, 0, 0, 2, 0, 0, 1, 3
"d:\IDEWORK\lvmen\src\licensedcode\data\rules\false-positive_gpl_kernel_sym_169.yml", "YAML", 0, 0, 0, 2, 0, 0, 1, 3
"d:\IDEWORK\lvmen\src\licensedcode\data\rules\false-positive_gpl_kernel_sym_17.yml", "YAML", 0, 0, 0, 2, 0, 0, 1, 3
"d:\IDEWORK\lvmen\src\licensedcode\data\rules\false-positive_gpl_kernel_sym_170.yml", "YAML", 0, 0, 0, 2, 0, 0, 1, 3
"d:\IDEWORK\lvmen\src\licensedcode\data\rules\false-positive_gpl_kernel_sym_171.yml", "YAML", 0, 0, 0, 2, 0, 0, 1, 3
"d:\IDEWORK\lvmen\src\licensedcode\data\rules\false-positive_gpl_kernel_sym_172.yml", "YAML", 0, 0, 0, 2, 0, 0, 1, 3
"d:\IDEWORK\lvmen\src\licensedcode\data\rules\false-positive_gpl_kernel_sym_173.yml", "YAML", 0, 0, 0, 2, 0, 0, 1, 3
"d:\IDEWORK\lvmen\src\licensedcode\data\rules\false-positive_gpl_kernel_sym_174.yml", "YAML", 0, 0, 0, 2, 0, 0, 1, 3
"d:\IDEWORK\lvmen\src\licensedcode\data\rules\false-positive_gpl_kernel_sym_175.yml", "YAML", 0, 0, 0, 2, 0, 0, 1, 3
"d:\IDEWORK\lvmen\src\licensedcode\data\rules\false-positive_gpl_kernel_sym_176.yml", "YAML", 0, 0, 0, 2, 0, 0, 1, 3
"d:\IDEWORK\lvmen\src\licensedcode\data\rules\false-positive_gpl_kernel_sym_177.yml", "YAML", 0, 0, 0, 2, 0, 0, 1, 3
"d:\IDEWORK\lvmen\src\licensedcode\data\rules\false-positive_gpl_kernel_sym_178.yml", "YAML", 0, 0, 0, 2, 0, 0, 1, 3
"d:\IDEWORK\lvmen\src\licensedcode\data\rules\false-positive_gpl_kernel_sym_179.yml", "YAML", 0, 0, 0, 2, 0, 0, 1, 3
"d:\IDEWORK\lvmen\src\licensedcode\data\rules\false-positive_gpl_kernel_sym_18.yml", "YAML", 0, 0, 0, 2, 0, 0, 1, 3
"d:\IDEWORK\lvmen\src\licensedcode\data\rules\false-positive_gpl_kernel_sym_180.yml", "YAML", 0, 0, 0, 2, 0, 0, 1, 3
"d:\IDEWORK\lvmen\src\licensedcode\data\rules\false-positive_gpl_kernel_sym_181.yml", "YAML", 0, 0, 0, 2, 0, 0, 1, 3
"d:\IDEWORK\lvmen\src\licensedcode\data\rules\false-positive_gpl_kernel_sym_182.yml", "YAML", 0, 0, 0, 2, 0, 0, 1, 3
"d:\IDEWORK\lvmen\src\licensedcode\data\rules\false-positive_gpl_kernel_sym_183.yml", "YAML", 0, 0, 0, 2, 0, 0, 1, 3
"d:\IDEWORK\lvmen\src\licensedcode\data\rules\false-positive_gpl_kernel_sym_184.yml", "YAML", 0, 0, 0, 2, 0, 0, 1, 3
"d:\IDEWORK\lvmen\src\licensedcode\data\rules\false-positive_gpl_kernel_sym_185.yml", "YAML", 0, 0, 0, 2, 0, 0, 1, 3
"d:\IDEWORK\lvmen\src\licensedcode\data\rules\false-positive_gpl_kernel_sym_186.yml", "YAML", 0, 0, 0, 2, 0, 0, 1, 3
"d:\IDEWORK\lvmen\src\licensedcode\data\rules\false-positive_gpl_kernel_sym_187.yml", "YAML", 0, 0, 0, 2, 0, 0, 1, 3
"d:\IDEWORK\lvmen\src\licensedcode\data\rules\false-positive_gpl_kernel_sym_188.yml", "YAML", 0, 0, 0, 2, 0, 0, 1, 3
"d:\IDEWORK\lvmen\src\licensedcode\data\rules\false-positive_gpl_kernel_sym_189.yml", "YAML", 0, 0, 0, 2, 0, 0, 1, 3
"d:\IDEWORK\lvmen\src\licensedcode\data\rules\false-positive_gpl_kernel_sym_19.yml", "YAML", 0, 0, 0, 2, 0, 0, 1, 3
"d:\IDEWORK\lvmen\src\licensedcode\data\rules\false-positive_gpl_kernel_sym_190.yml", "YAML", 0, 0, 0, 2, 0, 0, 1, 3
"d:\IDEWORK\lvmen\src\licensedcode\data\rules\false-positive_gpl_kernel_sym_191.yml", "YAML", 0, 0, 0, 2, 0, 0, 1, 3
"d:\IDEWORK\lvmen\src\licensedcode\data\rules\false-positive_gpl_kernel_sym_192.yml", "YAML", 0, 0, 0, 2, 0, 0, 1, 3
"d:\IDEWORK\lvmen\src\licensedcode\data\rules\false-positive_gpl_kernel_sym_193.yml", "YAML", 0, 0, 0, 2, 0, 0, 1, 3
"d:\IDEWORK\lvmen\src\licensedcode\data\rules\false-positive_gpl_kernel_sym_194.yml", "YAML", 0, 0, 0, 2, 0, 0, 1, 3
"d:\IDEWORK\lvmen\src\licensedcode\data\rules\false-positive_gpl_kernel_sym_195.yml", "YAML", 0, 0, 0, 2, 0, 0, 1, 3
"d:\IDEWORK\lvmen\src\licensedcode\data\rules\false-positive_gpl_kernel_sym_196.yml", "YAML", 0, 0, 0, 2, 0, 0, 1, 3
"d:\IDEWORK\lvmen\src\licensedcode\data\rules\false-positive_gpl_kernel_sym_197.yml", "YAML", 0, 0, 0, 2, 0, 0, 1, 3
"d:\IDEWORK\lvmen\src\licensedcode\data\rules\false-positive_gpl_kernel_sym_198.yml", "YAML", 0, 0, 0, 2, 0, 0, 1, 3
"d:\IDEWORK\lvmen\src\licensedcode\data\rules\false-positive_gpl_kernel_sym_199.yml", "YAML", 0, 0, 0, 2, 0, 0, 1, 3
"d:\IDEWORK\lvmen\src\licensedcode\data\rules\false-positive_gpl_kernel_sym_2.yml", "YAML", 0, 0, 0, 2, 0, 0, 1, 3
"d:\IDEWORK\lvmen\src\licensedcode\data\rules\false-positive_gpl_kernel_sym_20.yml", "YAML", 0, 0, 0, 2, 0, 0, 1, 3
"d:\IDEWORK\lvmen\src\licensedcode\data\rules\false-positive_gpl_kernel_sym_200.yml", "YAML", 0, 0, 0, 2, 0, 0, 1, 3
"d:\IDEWORK\lvmen\src\licensedcode\data\rules\false-positive_gpl_kernel_sym_201.yml", "YAML", 0, 0, 0, 2, 0, 0, 1, 3
"d:\IDEWORK\lvmen\src\licensedcode\data\rules\false-positive_gpl_kernel_sym_202.yml", "YAML", 0, 0, 0, 2, 0, 0, 1, 3
"d:\IDEWORK\lvmen\src\licensedcode\data\rules\false-positive_gpl_kernel_sym_203.yml", "YAML", 0, 0, 0, 2, 0, 0, 1, 3
"d:\IDEWORK\lvmen\src\licensedcode\data\rules\false-positive_gpl_kernel_sym_204.yml", "YAML", 0, 0, 0, 2, 0, 0, 1, 3
"d:\IDEWORK\lvmen\src\licensedcode\data\rules\false-positive_gpl_kernel_sym_205.yml", "YAML", 0, 0, 0, 2, 0, 0, 1, 3
"d:\IDEWORK\lvmen\src\licensedcode\data\rules\false-positive_gpl_kernel_sym_206.yml", "YAML", 0, 0, 0, 2, 0, 0, 1, 3
"d:\IDEWORK\lvmen\src\licensedcode\data\rules\false-positive_gpl_kernel_sym_207.yml", "YAML", 0, 0, 0, 2, 0, 0, 1, 3
"d:\IDEWORK\lvmen\src\licensedcode\data\rules\false-positive_gpl_kernel_sym_208.yml", "YAML", 0, 0, 0, 2, 0, 0, 1, 3
"d:\IDEWORK\lvmen\src\licensedcode\data\rules\false-positive_gpl_kernel_sym_209.yml", "YAML", 0, 0, 0, 2, 0, 0, 1, 3
"d:\IDEWORK\lvmen\src\licensedcode\data\rules\false-positive_gpl_kernel_sym_21.yml", "YAML", 0, 0, 0, 2, 0, 0, 1, 3
"d:\IDEWORK\lvmen\src\licensedcode\data\rules\false-positive_gpl_kernel_sym_210.yml", "YAML", 0, 0, 0, 2, 0, 0, 1, 3
"d:\IDEWORK\lvmen\src\licensedcode\data\rules\false-positive_gpl_kernel_sym_211.yml", "YAML", 0, 0, 0, 2, 0, 0, 1, 3
"d:\IDEWORK\lvmen\src\licensedcode\data\rules\false-positive_gpl_kernel_sym_212.yml", "YAML", 0, 0, 0, 2, 0, 0, 1, 3
"d:\IDEWORK\lvmen\src\licensedcode\data\rules\false-positive_gpl_kernel_sym_213.yml", "YAML", 0, 0, 0, 2, 0, 0, 1, 3
"d:\IDEWORK\lvmen\src\licensedcode\data\rules\false-positive_gpl_kernel_sym_214.yml", "YAML", 0, 0, 0, 2, 0, 0, 1, 3
"d:\IDEWORK\lvmen\src\licensedcode\data\rules\false-positive_gpl_kernel_sym_215.yml", "YAML", 0, 0, 0, 2, 0, 0, 1, 3
"d:\IDEWORK\lvmen\src\licensedcode\data\rules\false-positive_gpl_kernel_sym_216.yml", "YAML", 0, 0, 0, 2, 0, 0, 1, 3
"d:\IDEWORK\lvmen\src\licensedcode\data\rules\false-positive_gpl_kernel_sym_217.yml", "YAML", 0, 0, 0, 2, 0, 0, 1, 3
"d:\IDEWORK\lvmen\src\licensedcode\data\rules\false-positive_gpl_kernel_sym_218.yml", "YAML", 0, 0, 0, 2, 0, 0, 1, 3
"d:\IDEWORK\lvmen\src\licensedcode\data\rules\false-positive_gpl_kernel_sym_219.yml", "YAML", 0, 0, 0, 2, 0, 0, 1, 3
"d:\IDEWORK\lvmen\src\licensedcode\data\rules\false-positive_gpl_kernel_sym_22.yml", "YAML", 0, 0, 0, 2, 0, 0, 1, 3
"d:\IDEWORK\lvmen\src\licensedcode\data\rules\false-positive_gpl_kernel_sym_220.yml", "YAML", 0, 0, 0, 2, 0, 0, 1, 3
"d:\IDEWORK\lvmen\src\licensedcode\data\rules\false-positive_gpl_kernel_sym_221.yml", "YAML", 0, 0, 0, 2, 0, 0, 1, 3
"d:\IDEWORK\lvmen\src\licensedcode\data\rules\false-positive_gpl_kernel_sym_222.yml", "YAML", 0, 0, 0, 2, 0, 0, 1, 3
"d:\IDEWORK\lvmen\src\licensedcode\data\rules\false-positive_gpl_kernel_sym_23.yml", "YAML", 0, 0, 0, 2, 0, 0, 1, 3
"d:\IDEWORK\lvmen\src\licensedcode\data\rules\false-positive_gpl_kernel_sym_24.yml", "YAML", 0, 0, 0, 2, 0, 0, 1, 3
"d:\IDEWORK\lvmen\src\licensedcode\data\rules\false-positive_gpl_kernel_sym_25.yml", "YAML", 0, 0, 0, 2, 0, 0, 1, 3
"d:\IDEWORK\lvmen\src\licensedcode\data\rules\false-positive_gpl_kernel_sym_26.yml", "YAML", 0, 0, 0, 2, 0, 0, 1, 3
"d:\IDEWORK\lvmen\src\licensedcode\data\rules\false-positive_gpl_kernel_sym_27.yml", "YAML", 0, 0, 0, 2, 0, 0, 1, 3
"d:\IDEWORK\lvmen\src\licensedcode\data\rules\false-positive_gpl_kernel_sym_28.yml", "YAML", 0, 0, 0, 2, 0, 0, 1, 3
"d:\IDEWORK\lvmen\src\licensedcode\data\rules\false-positive_gpl_kernel_sym_29.yml", "YAML", 0, 0, 0, 2, 0, 0, 1, 3
"d:\IDEWORK\lvmen\src\licensedcode\data\rules\false-positive_gpl_kernel_sym_3.yml", "YAML", 0, 0, 0, 2, 0, 0, 1, 3
"d:\IDEWORK\lvmen\src\licensedcode\data\rules\false-positive_gpl_kernel_sym_30.yml", "YAML", 0, 0, 0, 2, 0, 0, 1, 3
"d:\IDEWORK\lvmen\src\licensedcode\data\rules\false-positive_gpl_kernel_sym_31.yml", "YAML", 0, 0, 0, 2, 0, 0, 1, 3
"d:\IDEWORK\lvmen\src\licensedcode\data\rules\false-positive_gpl_kernel_sym_32.yml", "YAML", 0, 0, 0, 2, 0, 0, 1, 3
"d:\IDEWORK\lvmen\src\licensedcode\data\rules\false-positive_gpl_kernel_sym_33.yml", "YAML", 0, 0, 0, 2, 0, 0, 1, 3
"d:\IDEWORK\lvmen\src\licensedcode\data\rules\false-positive_gpl_kernel_sym_34.yml", "YAML", 0, 0, 0, 2, 0, 0, 1, 3
"d:\IDEWORK\lvmen\src\licensedcode\data\rules\false-positive_gpl_kernel_sym_35.yml", "YAML", 0, 0, 0, 2, 0, 0, 1, 3
"d:\IDEWORK\lvmen\src\licensedcode\data\rules\false-positive_gpl_kernel_sym_36.yml", "YAML", 0, 0, 0, 2, 0, 0, 1, 3
"d:\IDEWORK\lvmen\src\licensedcode\data\rules\false-positive_gpl_kernel_sym_37.yml", "YAML", 0, 0, 0, 2, 0, 0, 1, 3
"d:\IDEWORK\lvmen\src\licensedcode\data\rules\false-positive_gpl_kernel_sym_38.yml", "YAML", 0, 0, 0, 2, 0, 0, 1, 3
"d:\IDEWORK\lvmen\src\licensedcode\data\rules\false-positive_gpl_kernel_sym_39.yml", "YAML", 0, 0, 0, 2, 0, 0, 1, 3
"d:\IDEWORK\lvmen\src\licensedcode\data\rules\false-positive_gpl_kernel_sym_4.yml", "YAML", 0, 0, 0, 2, 0, 0, 1, 3
"d:\IDEWORK\lvmen\src\licensedcode\data\rules\false-positive_gpl_kernel_sym_40.yml", "YAML", 0, 0, 0, 2, 0, 0, 1, 3
"d:\IDEWORK\lvmen\src\licensedcode\data\rules\false-positive_gpl_kernel_sym_41.yml", "YAML", 0, 0, 0, 2, 0, 0, 1, 3
"d:\IDEWORK\lvmen\src\licensedcode\data\rules\false-positive_gpl_kernel_sym_42.yml", "YAML", 0, 0, 0, 2, 0, 0, 1, 3
"d:\IDEWORK\lvmen\src\licensedcode\data\rules\false-positive_gpl_kernel_sym_43.yml", "YAML", 0, 0, 0, 2, 0, 0, 1, 3
"d:\IDEWORK\lvmen\src\licensedcode\data\rules\false-positive_gpl_kernel_sym_44.yml", "YAML", 0, 0, 0, 2, 0, 0, 1, 3
"d:\IDEWORK\lvmen\src\licensedcode\data\rules\false-positive_gpl_kernel_sym_45.yml", "YAML", 0, 0, 0, 2, 0, 0, 1, 3
"d:\IDEWORK\lvmen\src\licensedcode\data\rules\false-positive_gpl_kernel_sym_46.yml", "YAML", 0, 0, 0, 2, 0, 0, 1, 3
"d:\IDEWORK\lvmen\src\licensedcode\data\rules\false-positive_gpl_kernel_sym_47.yml", "YAML", 0, 0, 0, 2, 0, 0, 1, 3
"d:\IDEWORK\lvmen\src\licensedcode\data\rules\false-positive_gpl_kernel_sym_48.yml", "YAML", 0, 0, 0, 2, 0, 0, 1, 3
"d:\IDEWORK\lvmen\src\licensedcode\data\rules\false-positive_gpl_kernel_sym_49.yml", "YAML", 0, 0, 0, 2, 0, 0, 1, 3
"d:\IDEWORK\lvmen\src\licensedcode\data\rules\false-positive_gpl_kernel_sym_5.yml", "YAML", 0, 0, 0, 2, 0, 0, 1, 3
"d:\IDEWORK\lvmen\src\licensedcode\data\rules\false-positive_gpl_kernel_sym_50.yml", "YAML", 0, 0, 0, 2, 0, 0, 1, 3
"d:\IDEWORK\lvmen\src\licensedcode\data\rules\false-positive_gpl_kernel_sym_51.yml", "YAML", 0, 0, 0, 2, 0, 0, 1, 3
"d:\IDEWORK\lvmen\src\licensedcode\data\rules\false-positive_gpl_kernel_sym_52.yml", "YAML", 0, 0, 0, 2, 0, 0, 1, 3
"d:\IDEWORK\lvmen\src\licensedcode\data\rules\false-positive_gpl_kernel_sym_53.yml", "YAML", 0, 0, 0, 2, 0, 0, 1, 3
"d:\IDEWORK\lvmen\src\licensedcode\data\rules\false-positive_gpl_kernel_sym_54.yml", "YAML", 0, 0, 0, 2, 0, 0, 1, 3
"d:\IDEWORK\lvmen\src\licensedcode\data\rules\false-positive_gpl_kernel_sym_55.yml", "YAML", 0, 0, 0, 2, 0, 0, 1, 3
"d:\IDEWORK\lvmen\src\licensedcode\data\rules\false-positive_gpl_kernel_sym_56.yml", "YAML", 0, 0, 0, 2, 0, 0, 1, 3
"d:\IDEWORK\lvmen\src\licensedcode\data\rules\false-positive_gpl_kernel_sym_57.yml", "YAML", 0, 0, 0, 2, 0, 0, 1, 3
"d:\IDEWORK\lvmen\src\licensedcode\data\rules\false-positive_gpl_kernel_sym_58.yml", "YAML", 0, 0, 0, 2, 0, 0, 1, 3
"d:\IDEWORK\lvmen\src\licensedcode\data\rules\false-positive_gpl_kernel_sym_59.yml", "YAML", 0, 0, 0, 2, 0, 0, 1, 3
"d:\IDEWORK\lvmen\src\licensedcode\data\rules\false-positive_gpl_kernel_sym_6.yml", "YAML", 0, 0, 0, 2, 0, 0, 1, 3
"d:\IDEWORK\lvmen\src\licensedcode\data\rules\false-positive_gpl_kernel_sym_60.yml", "YAML", 0, 0, 0, 2, 0, 0, 1, 3
"d:\IDEWORK\lvmen\src\licensedcode\data\rules\false-positive_gpl_kernel_sym_61.yml", "YAML", 0, 0, 0, 2, 0, 0, 1, 3
"d:\IDEWORK\lvmen\src\licensedcode\data\rules\false-positive_gpl_kernel_sym_62.yml", "YAML", 0, 0, 0, 2, 0, 0, 1, 3
"d:\IDEWORK\lvmen\src\licensedcode\data\rules\false-positive_gpl_kernel_sym_63.yml", "YAML", 0, 0, 0, 2, 0, 0, 1, 3
"d:\IDEWORK\lvmen\src\licensedcode\data\rules\false-positive_gpl_kernel_sym_64.yml", "YAML", 0, 0, 0, 2, 0, 0, 1, 3
"d:\IDEWORK\lvmen\src\licensedcode\data\rules\false-positive_gpl_kernel_sym_65.yml", "YAML", 0, 0, 0, 2, 0, 0, 1, 3
"d:\IDEWORK\lvmen\src\licensedcode\data\rules\false-positive_gpl_kernel_sym_66.yml", "YAML", 0, 0, 0, 2, 0, 0, 1, 3
"d:\IDEWORK\lvmen\src\licensedcode\data\rules\false-positive_gpl_kernel_sym_67.yml", "YAML", 0, 0, 0, 2, 0, 0, 1, 3
"d:\IDEWORK\lvmen\src\licensedcode\data\rules\false-positive_gpl_kernel_sym_68.yml", "YAML", 0, 0, 0, 2, 0, 0, 1, 3
"d:\IDEWORK\lvmen\src\licensedcode\data\rules\false-positive_gpl_kernel_sym_69.yml", "YAML", 0, 0, 0, 2, 0, 0, 1, 3
"d:\IDEWORK\lvmen\src\licensedcode\data\rules\false-positive_gpl_kernel_sym_7.yml", "YAML", 0, 0, 0, 2, 0, 0, 1, 3
"d:\IDEWORK\lvmen\src\licensedcode\data\rules\false-positive_gpl_kernel_sym_70.yml", "YAML", 0, 0, 0, 2, 0, 0, 1, 3
"d:\IDEWORK\lvmen\src\licensedcode\data\rules\false-positive_gpl_kernel_sym_71.yml", "YAML", 0, 0, 0, 2, 0, 0, 1, 3
"d:\IDEWORK\lvmen\src\licensedcode\data\rules\false-positive_gpl_kernel_sym_72.yml", "YAML", 0, 0, 0, 2, 0, 0, 1, 3
"d:\IDEWORK\lvmen\src\licensedcode\data\rules\false-positive_gpl_kernel_sym_73.yml", "YAML", 0, 0, 0, 2, 0, 0, 1, 3
"d:\IDEWORK\lvmen\src\licensedcode\data\rules\false-positive_gpl_kernel_sym_74.yml", "YAML", 0, 0, 0, 2, 0, 0, 1, 3
"d:\IDEWORK\lvmen\src\licensedcode\data\rules\false-positive_gpl_kernel_sym_75.yml", "YAML", 0, 0, 0, 2, 0, 0, 1, 3
"d:\IDEWORK\lvmen\src\licensedcode\data\rules\false-positive_gpl_kernel_sym_76.yml", "YAML", 0, 0, 0, 2, 0, 0, 1, 3
"d:\IDEWORK\lvmen\src\licensedcode\data\rules\false-positive_gpl_kernel_sym_77.yml", "YAML", 0, 0, 0, 2, 0, 0, 1, 3
"d:\IDEWORK\lvmen\src\licensedcode\data\rules\false-positive_gpl_kernel_sym_78.yml", "YAML", 0, 0, 0, 2, 0, 0, 1, 3
"d:\IDEWORK\lvmen\src\licensedcode\data\rules\false-positive_gpl_kernel_sym_79.yml", "YAML", 0, 0, 0, 2, 0, 0, 1, 3
"d:\IDEWORK\lvmen\src\licensedcode\data\rules\false-positive_gpl_kernel_sym_8.yml", "YAML", 0, 0, 0, 2, 0, 0, 1, 3
"d:\IDEWORK\lvmen\src\licensedcode\data\rules\false-positive_gpl_kernel_sym_80.yml", "YAML", 0, 0, 0, 2, 0, 0, 1, 3
"d:\IDEWORK\lvmen\src\licensedcode\data\rules\false-positive_gpl_kernel_sym_81.yml", "YAML", 0, 0, 0, 2, 0, 0, 1, 3
"d:\IDEWORK\lvmen\src\licensedcode\data\rules\false-positive_gpl_kernel_sym_82.yml", "YAML", 0, 0, 0, 2, 0, 0, 1, 3
"d:\IDEWORK\lvmen\src\licensedcode\data\rules\false-positive_gpl_kernel_sym_83.yml", "YAML", 0, 0, 0, 2, 0, 0, 1, 3
"d:\IDEWORK\lvmen\src\licensedcode\data\rules\false-positive_gpl_kernel_sym_84.yml", "YAML", 0, 0, 0, 2, 0, 0, 1, 3
"d:\IDEWORK\lvmen\src\licensedcode\data\rules\false-positive_gpl_kernel_sym_85.yml", "YAML", 0, 0, 0, 2, 0, 0, 1, 3
"d:\IDEWORK\lvmen\src\licensedcode\data\rules\false-positive_gpl_kernel_sym_86.yml", "YAML", 0, 0, 0, 2, 0, 0, 1, 3
"d:\IDEWORK\lvmen\src\licensedcode\data\rules\false-positive_gpl_kernel_sym_87.yml", "YAML", 0, 0, 0, 2, 0, 0, 1, 3
"d:\IDEWORK\lvmen\src\licensedcode\data\rules\false-positive_gpl_kernel_sym_88.yml", "YAML", 0, 0, 0, 2, 0, 0, 1, 3
"d:\IDEWORK\lvmen\src\licensedcode\data\rules\false-positive_gpl_kernel_sym_89.yml", "YAML", 0, 0, 0, 2, 0, 0, 1, 3
"d:\IDEWORK\lvmen\src\licensedcode\data\rules\false-positive_gpl_kernel_sym_9.yml", "YAML", 0, 0, 0, 2, 0, 0, 1, 3
"d:\IDEWORK\lvmen\src\licensedcode\data\rules\false-positive_gpl_kernel_sym_90.yml", "YAML", 0, 0, 0, 2, 0, 0, 1, 3
"d:\IDEWORK\lvmen\src\licensedcode\data\rules\false-positive_gpl_kernel_sym_91.yml", "YAML", 0, 0, 0, 2, 0, 0, 1, 3
"d:\IDEWORK\lvmen\src\licensedcode\data\rules\false-positive_gpl_kernel_sym_92.yml", "YAML", 0, 0, 0, 2, 0, 0, 1, 3
"d:\IDEWORK\lvmen\src\licensedcode\data\rules\false-positive_gpl_kernel_sym_93.yml", "YAML", 0, 0, 0, 2, 0, 0, 1, 3
"d:\IDEWORK\lvmen\src\licensedcode\data\rules\false-positive_gpl_kernel_sym_94.yml", "YAML", 0, 0, 0, 2, 0, 0, 1, 3
"d:\IDEWORK\lvmen\src\licensedcode\data\rules\false-positive_gpl_kernel_sym_95.yml", "YAML", 0, 0, 0, 2, 0, 0, 1, 3
"d:\IDEWORK\lvmen\src\licensedcode\data\rules\false-positive_gpl_kernel_sym_96.yml", "YAML", 0, 0, 0, 2, 0, 0, 1, 3
"d:\IDEWORK\lvmen\src\licensedcode\data\rules\false-positive_gpl_kernel_sym_97.yml", "YAML", 0, 0, 0, 2, 0, 0, 1, 3
"d:\IDEWORK\lvmen\src\licensedcode\data\rules\false-positive_gpl_kernel_sym_98.yml", "YAML", 0, 0, 0, 2, 0, 0, 1, 3
"d:\IDEWORK\lvmen\src\licensedcode\data\rules\false-positive_gpl_kernel_sym_99.yml", "YAML", 0, 0, 0, 2, 0, 0, 1, 3
"d:\IDEWORK\lvmen\src\licensedcode\data\rules\false-positive_gpl_linux_1.yml", "YAML", 0, 0, 0, 2, 0, 0, 1, 3
"d:\IDEWORK\lvmen\src\licensedcode\data\rules\false-positive_gpl_linux_10.yml", "YAML", 0, 0, 0, 2, 0, 0, 1, 3
"d:\IDEWORK\lvmen\src\licensedcode\data\rules\false-positive_gpl_linux_11.yml", "YAML", 0, 0, 0, 2, 0, 0, 1, 3
"d:\IDEWORK\lvmen\src\licensedcode\data\rules\false-positive_gpl_linux_12.yml", "YAML", 0, 0, 0, 2, 0, 0, 1, 3
"d:\IDEWORK\lvmen\src\licensedcode\data\rules\false-positive_gpl_linux_13.yml", "YAML", 0, 0, 0, 2, 0, 0, 1, 3
"d:\IDEWORK\lvmen\src\licensedcode\data\rules\false-positive_gpl_linux_2.yml", "YAML", 0, 0, 0, 2, 0, 0, 1, 3
"d:\IDEWORK\lvmen\src\licensedcode\data\rules\false-positive_gpl_linux_3.yml", "YAML", 0, 0, 0, 2, 0, 0, 1, 3
"d:\IDEWORK\lvmen\src\licensedcode\data\rules\false-positive_gpl_linux_4.yml", "YAML", 0, 0, 0, 2, 0, 0, 1, 3
"d:\IDEWORK\lvmen\src\licensedcode\data\rules\false-positive_gpl_linux_5.yml", "YAML", 0, 0, 0, 2, 0, 0, 1, 3
"d:\IDEWORK\lvmen\src\licensedcode\data\rules\false-positive_gpl_linux_6.yml", "YAML", 0, 0, 0, 2, 0, 0, 1, 3
"d:\IDEWORK\lvmen\src\licensedcode\data\rules\false-positive_gpl_linux_7.yml", "YAML", 0, 0, 0, 2, 0, 0, 1, 3
"d:\IDEWORK\lvmen\src\licensedcode\data\rules\false-positive_gpl_linux_8.yml", "YAML", 0, 0, 0, 2, 0, 0, 1, 3
"d:\IDEWORK\lvmen\src\licensedcode\data\rules\false-positive_gpl_linux_9.yml", "YAML", 0, 0, 0, 2, 0, 0, 1, 3
"d:\IDEWORK\lvmen\src\licensedcode\data\rules\false-positive_gpl_plugin_1.yml", "YAML", 0, 0, 0, 2, 0, 0, 1, 3
"d:\IDEWORK\lvmen\src\licensedcode\data\rules\false-positive_gpl_uboot_1.yml", "YAML", 0, 0, 0, 2, 0, 0, 1, 3
"d:\IDEWORK\lvmen\src\licensedcode\data\rules\false-positive_gpl_uboot_2.yml", "YAML", 0, 0, 0, 2, 0, 0, 1, 3
"d:\IDEWORK\lvmen\src\licensedcode\data\rules\false-positive_gpl_uboot_3.yml", "YAML", 0, 0, 0, 2, 0, 0, 1, 3
"d:\IDEWORK\lvmen\src\licensedcode\data\rules\false-positive_gpl_uboot_4.yml", "YAML", 0, 0, 0, 2, 0, 0, 1, 3
"d:\IDEWORK\lvmen\src\licensedcode\data\rules\false-positive_gpl_uboot_5.yml", "YAML", 0, 0, 0, 2, 0, 0, 1, 3
"d:\IDEWORK\lvmen\src\licensedcode\data\rules\false-positive_gpl_uboot_6.yml", "YAML", 0, 0, 0, 2, 0, 0, 1, 3
"d:\IDEWORK\lvmen\src\licensedcode\data\rules\false-positive_hildon_1.yml", "YAML", 0, 0, 0, 2, 0, 0, 1, 3
"d:\IDEWORK\lvmen\src\licensedcode\data\rules\false-positive_jdk_1.yml", "YAML", 0, 0, 0, 2, 0, 0, 1, 3
"d:\IDEWORK\lvmen\src\licensedcode\data\rules\false-positive_jdk_2.yml", "YAML", 0, 0, 0, 2, 0, 0, 1, 3
"d:\IDEWORK\lvmen\src\licensedcode\data\rules\false-positive_jdk_3.yml", "YAML", 0, 0, 0, 2, 0, 0, 1, 3
"d:\IDEWORK\lvmen\src\licensedcode\data\rules\false-positive_jdk_4.yml", "YAML", 0, 0, 0, 2, 0, 0, 1, 3
"d:\IDEWORK\lvmen\src\licensedcode\data\rules\false-positive_kernel_1.yml", "YAML", 0, 0, 0, 2, 0, 0, 1, 3
"d:\IDEWORK\lvmen\src\licensedcode\data\rules\false-positive_lgpl-2.0-plus_1.yml", "YAML", 0, 0, 0, 2, 0, 0, 1, 3
"d:\IDEWORK\lvmen\src\licensedcode\data\rules\false-positive_lgpl-2.1_and_gpl-2.0_and_other-copyleft_1.yml", "YAML", 0, 0, 0, 2, 0, 0, 1, 3
"d:\IDEWORK\lvmen\src\licensedcode\data\rules\false-positive_lgpl_include_1.yml", "YAML", 0, 0, 0, 2, 0, 0, 1, 3
"d:\IDEWORK\lvmen\src\licensedcode\data\rules\false-positive_llvm_1.yml", "YAML", 0, 0, 0, 2, 0, 0, 1, 3
"d:\IDEWORK\lvmen\src\licensedcode\data\rules\false-positive_llvm_2.yml", "YAML", 0, 0, 0, 2, 0, 0, 1, 3
"d:\IDEWORK\lvmen\src\licensedcode\data\rules\false-positive_llvm_3.yml", "YAML", 0, 0, 0, 2, 0, 0, 1, 3
"d:\IDEWORK\lvmen\src\licensedcode\data\rules\false-positive_llvm_4.yml", "YAML", 0, 0, 0, 2, 0, 0, 1, 3
"d:\IDEWORK\lvmen\src\licensedcode\data\rules\false-positive_llvm_5.yml", "YAML", 0, 0, 0, 2, 0, 0, 1, 3
"d:\IDEWORK\lvmen\src\licensedcode\data\rules\false-positive_magic_1.yml", "YAML", 0, 0, 0, 2, 0, 0, 1, 3
"d:\IDEWORK\lvmen\src\licensedcode\data\rules\false-positive_magic_2.yml", "YAML", 0, 0, 0, 2, 0, 0, 1, 3
"d:\IDEWORK\lvmen\src\licensedcode\data\rules\false-positive_magic_3.yml", "YAML", 0, 0, 0, 2, 0, 0, 1, 3
"d:\IDEWORK\lvmen\src\licensedcode\data\rules\false-positive_magic_4.yml", "YAML", 0, 0, 0, 2, 0, 0, 1, 3
"d:\IDEWORK\lvmen\src\licensedcode\data\rules\false-positive_many_contribs_1.yml", "YAML", 0, 0, 0, 3, 0, 0, 1, 4
"d:\IDEWORK\lvmen\src\licensedcode\data\rules\false-positive_mit_lgpl_1.yml", "YAML", 0, 0, 0, 2, 0, 0, 1, 3
"d:\IDEWORK\lvmen\src\licensedcode\data\rules\false-positive_mpl-1.1_or_lgpl-2.1-plus_or_apache-2._1.yml", "YAML", 0, 0, 0, 2, 0, 0, 1, 3
"d:\IDEWORK\lvmen\src\licensedcode\data\rules\false-positive_mpl-1.1_or_lgpl-2.1-plus_or_apache-2._2.yml", "YAML", 0, 0, 0, 2, 0, 0, 1, 3
"d:\IDEWORK\lvmen\src\licensedcode\data\rules\false-positive_mpl_1.yml", "YAML", 0, 0, 0, 2, 0, 0, 1, 3
"d:\IDEWORK\lvmen\src\licensedcode\data\rules\false-positive_not_python.yml", "YAML", 0, 0, 0, 4, 0, 0, 2, 6
"d:\IDEWORK\lvmen\src\licensedcode\data\rules\false-positive_ofl_faq_1.yml", "YAML", 0, 0, 0, 2, 0, 0, 1, 3
"d:\IDEWORK\lvmen\src\licensedcode\data\rules\false-positive_openjdk_1.yml", "YAML", 0, 0, 0, 2, 0, 0, 1, 3
"d:\IDEWORK\lvmen\src\licensedcode\data\rules\false-positive_openjdk_2.yml", "YAML", 0, 0, 0, 2, 0, 0, 1, 3
"d:\IDEWORK\lvmen\src\licensedcode\data\rules\false-positive_other-copyleft_and_other-permissive_1.yml", "YAML", 0, 0, 0, 2, 0, 0, 1, 3
"d:\IDEWORK\lvmen\src\licensedcode\data\rules\false-positive_partial_disclaimer_1.yml", "YAML", 0, 0, 0, 2, 0, 0, 1, 3
"d:\IDEWORK\lvmen\src\licensedcode\data\rules\false-positive_partial_disclaimer_2.yml", "YAML", 0, 0, 0, 2, 0, 0, 1, 3
"d:\IDEWORK\lvmen\src\licensedcode\data\rules\false-positive_pd_1.yml", "YAML", 0, 0, 0, 2, 0, 0, 1, 3
"d:\IDEWORK\lvmen\src\licensedcode\data\rules\false-positive_pd_2.yml", "YAML", 0, 0, 0, 2, 0, 0, 1, 3
"d:\IDEWORK\lvmen\src\licensedcode\data\rules\false-positive_pd_3.yml", "YAML", 0, 0, 0, 2, 0, 0, 1, 3
"d:\IDEWORK\lvmen\src\licensedcode\data\rules\false-positive_proprietary-license_1.yml", "YAML", 0, 0, 0, 2, 0, 0, 1, 3
"d:\IDEWORK\lvmen\src\licensedcode\data\rules\false-positive_public-domain_1.yml", "YAML", 0, 0, 0, 2, 0, 0, 1, 3
"d:\IDEWORK\lvmen\src\licensedcode\data\rules\false-positive_public-domain_10.yml", "YAML", 0, 0, 0, 2, 0, 0, 1, 3
"d:\IDEWORK\lvmen\src\licensedcode\data\rules\false-positive_public-domain_11.yml", "YAML", 0, 0, 0, 2, 0, 0, 1, 3
"d:\IDEWORK\lvmen\src\licensedcode\data\rules\false-positive_public-domain_12.yml", "YAML", 0, 0, 0, 2, 0, 0, 1, 3
"d:\IDEWORK\lvmen\src\licensedcode\data\rules\false-positive_public-domain_13.yml", "YAML", 0, 0, 0, 2, 0, 0, 1, 3
"d:\IDEWORK\lvmen\src\licensedcode\data\rules\false-positive_public-domain_2.yml", "YAML", 0, 0, 0, 2, 0, 0, 1, 3
"d:\IDEWORK\lvmen\src\licensedcode\data\rules\false-positive_public-domain_3.yml", "YAML", 0, 0, 0, 2, 0, 0, 1, 3
"d:\IDEWORK\lvmen\src\licensedcode\data\rules\false-positive_public-domain_4.yml", "YAML", 0, 0, 0, 2, 0, 0, 1, 3
"d:\IDEWORK\lvmen\src\licensedcode\data\rules\false-positive_public-domain_5.yml", "YAML", 0, 0, 0, 2, 0, 0, 1, 3
"d:\IDEWORK\lvmen\src\licensedcode\data\rules\false-positive_public-domain_6.yml", "YAML", 0, 0, 0, 2, 0, 0, 1, 3
"d:\IDEWORK\lvmen\src\licensedcode\data\rules\false-positive_public-domain_7.yml", "YAML", 0, 0, 0, 2, 0, 0, 1, 3
"d:\IDEWORK\lvmen\src\licensedcode\data\rules\false-positive_public-domain_8.yml", "YAML", 0, 0, 0, 2, 0, 0, 1, 3
"d:\IDEWORK\lvmen\src\licensedcode\data\rules\false-positive_public-domain_9.yml", "YAML", 0, 0, 0, 2, 0, 0, 1, 3
"d:\IDEWORK\lvmen\src\licensedcode\data\rules\false-positive_public-domain_in_cs_1.yml", "YAML", 0, 0, 0, 2, 0, 0, 1, 3
"d:\IDEWORK\lvmen\src\licensedcode\data\rules\false-positive_public-domain_in_vb_1.yml", "YAML", 0, 0, 0, 2, 0, 0, 1, 3
"d:\IDEWORK\lvmen\src\licensedcode\data\rules\false-positive_python_1.yml", "YAML", 0, 0, 0, 3, 0, 0, 1, 4
"d:\IDEWORK\lvmen\src\licensedcode\data\rules\false-positive_rcu_1.yml", "YAML", 0, 0, 0, 2, 0, 0, 1, 3
"d:\IDEWORK\lvmen\src\licensedcode\data\rules\false-positive_systemtap_1.yml", "YAML", 0, 0, 0, 2, 0, 0, 1, 3
"d:\IDEWORK\lvmen\src\licensedcode\data\rules\false-positive_systemtap_10.yml", "YAML", 0, 0, 0, 2, 0, 0, 1, 3
"d:\IDEWORK\lvmen\src\licensedcode\data\rules\false-positive_systemtap_11.yml", "YAML", 0, 0, 0, 2, 0, 0, 1, 3
"d:\IDEWORK\lvmen\src\licensedcode\data\rules\false-positive_systemtap_2.yml", "YAML", 0, 0, 0, 2, 0, 0, 1, 3
"d:\IDEWORK\lvmen\src\licensedcode\data\rules\false-positive_systemtap_3.yml", "YAML", 0, 0, 0, 2, 0, 0, 1, 3
"d:\IDEWORK\lvmen\src\licensedcode\data\rules\false-positive_systemtap_4.yml", "YAML", 0, 0, 0, 2, 0, 0, 1, 3
"d:\IDEWORK\lvmen\src\licensedcode\data\rules\false-positive_systemtap_5.yml", "YAML", 0, 0, 0, 2, 0, 0, 1, 3
"d:\IDEWORK\lvmen\src\licensedcode\data\rules\false-positive_systemtap_6.yml", "YAML", 0, 0, 0, 2, 0, 0, 1, 3
"d:\IDEWORK\lvmen\src\licensedcode\data\rules\false-positive_systemtap_7.yml", "YAML", 0, 0, 0, 2, 0, 0, 1, 3
"d:\IDEWORK\lvmen\src\licensedcode\data\rules\false-positive_systemtap_8.yml", "YAML", 0, 0, 0, 2, 0, 0, 1, 3
"d:\IDEWORK\lvmen\src\licensedcode\data\rules\false-positive_systemtap_9.yml", "YAML", 0, 0, 0, 2, 0, 0, 1, 3
"d:\IDEWORK\lvmen\src\licensedcode\data\rules\false-positive_uboot_1.yml", "YAML", 0, 0, 0, 2, 0, 0, 1, 3
"d:\IDEWORK\lvmen\src\licensedcode\data\rules\false-positive_uboot_2.yml", "YAML", 0, 0, 0, 2, 0, 0, 1, 3
"d:\IDEWORK\lvmen\src\licensedcode\data\rules\false-positive_uboot_3.yml", "YAML", 0, 0, 0, 2, 0, 0, 1, 3
"d:\IDEWORK\lvmen\src\licensedcode\data\rules\false-positive_uboot_4.yml", "YAML", 0, 0, 0, 2, 0, 0, 1, 3
"d:\IDEWORK\lvmen\src\licensedcode\data\rules\false-positive_uboot_5.yml", "YAML", 0, 0, 0, 2, 0, 0, 1, 3
"d:\IDEWORK\lvmen\src\licensedcode\data\rules\false-positive_unknown-license-reference_1.yml", "YAML", 0, 0, 0, 2, 0, 0, 1, 3
"d:\IDEWORK\lvmen\src\licensedcode\data\rules\false-positive_unknown-license-reference_2.yml", "YAML", 0, 0, 0, 2, 0, 0, 1, 3
"d:\IDEWORK\lvmen\src\licensedcode\data\rules\false-positive_unknown-license-reference_3.yml", "YAML", 0, 0, 0, 2, 0, 0, 1, 3
"d:\IDEWORK\lvmen\src\licensedcode\data\rules\false-positive_unknown-license-reference_4.yml", "YAML", 0, 0, 0, 2, 0, 0, 1, 3
"d:\IDEWORK\lvmen\src\licensedcode\data\rules\false-positive_unknown-license-reference_5.yml", "YAML", 0, 0, 0, 2, 0, 0, 1, 3
"d:\IDEWORK\lvmen\src\licensedcode\data\rules\false-positive_unknown-license-reference_6.yml", "YAML", 0, 0, 0, 2, 0, 0, 1, 3
"d:\IDEWORK\lvmen\src\licensedcode\data\rules\false-positive_unknown_1.yml", "YAML", 0, 0, 0, 2, 0, 0, 1, 3
"d:\IDEWORK\lvmen\src\licensedcode\data\rules\false-positive_unknown_2.yml", "YAML", 0, 0, 0, 2, 0, 0, 1, 3
"d:\IDEWORK\lvmen\src\licensedcode\data\rules\false-positive_unknown_3.yml", "YAML", 0, 0, 0, 2, 0, 0, 1, 3
"d:\IDEWORK\lvmen\src\licensedcode\data\rules\false-positive_wxpy_1.yml", "YAML", 0, 0, 0, 2, 0, 0, 1, 3
"d:\IDEWORK\lvmen\src\licensedcode\data\rules\fastcgi-devkit_url_1.yml", "YAML", 0, 0, 0, 5, 0, 0, 1, 6
"d:\IDEWORK\lvmen\src\licensedcode\data\rules\fastcgi-devkit_url_2.yml", "YAML", 0, 0, 0, 5, 0, 0, 1, 6
"d:\IDEWORK\lvmen\src\licensedcode\data\rules\fawkes-runtime-exception_url_1.yml", "YAML", 0, 0, 0, 5, 0, 0, 1, 6
"d:\IDEWORK\lvmen\src\licensedcode\data\rules\fawkes-runtime-exception_url_2.yml", "YAML", 0, 0, 0, 5, 0, 0, 1, 6
"d:\IDEWORK\lvmen\src\licensedcode\data\rules\fdl-1.1_prep.ai.mit.edu.yml", "YAML", 0, 0, 0, 8, 0, 0, 1, 9
"d:\IDEWORK\lvmen\src\licensedcode\data\rules\fdl-1.2_prep.ai.mit.edu.yml", "YAML", 0, 0, 0, 8, 0, 0, 1, 9
"d:\IDEWORK\lvmen\src\licensedcode\data\rules\fdl-1.3_prep.ai.mit.edu.yml", "YAML", 0, 0, 0, 9, 0, 0, 1, 10
"d:\IDEWORK\lvmen\src\licensedcode\data\rules\fedora-red-hat-exception-2.0_1.yml", "YAML", 0, 0, 0, 4, 0, 0, 1, 5
"d:\IDEWORK\lvmen\src\licensedcode\data\rules\fftpack-2004_1.yml", "YAML", 0, 0, 0, 12, 0, 0, 1, 13
"d:\IDEWORK\lvmen\src\licensedcode\data\rules\flex-2.5.yml", "YAML", 0, 0, 0, 4, 0, 0, 1, 5
"d:\IDEWORK\lvmen\src\licensedcode\data\rules\flex-2.5_1.yml", "YAML", 0, 0, 0, 6, 0, 0, 1, 7
"d:\IDEWORK\lvmen\src\licensedcode\data\rules\flex-2.5_10.yml", "YAML", 0, 0, 0, 4, 0, 0, 1, 5
"d:\IDEWORK\lvmen\src\licensedcode\data\rules\flex-2.5_2.yml", "YAML", 0, 0, 0, 6, 0, 0, 1, 7
"d:\IDEWORK\lvmen\src\licensedcode\data\rules\flex-2.5_3.yml", "YAML", 0, 0, 0, 4, 0, 0, 1, 5
"d:\IDEWORK\lvmen\src\licensedcode\data\rules\flex-2.5_4.yml", "YAML", 0, 0, 0, 4, 0, 0, 1, 5
"d:\IDEWORK\lvmen\src\licensedcode\data\rules\flex-2.5_5.yml", "YAML", 0, 0, 0, 4, 0, 0, 1, 5
"d:\IDEWORK\lvmen\src\licensedcode\data\rules\flex-2.5_6.yml", "YAML", 0, 0, 0, 7, 0, 0, 1, 8
"d:\IDEWORK\lvmen\src\licensedcode\data\rules\flex-2.5_7.yml", "YAML", 0, 0, 0, 4, 0, 0, 1, 5
"d:\IDEWORK\lvmen\src\licensedcode\data\rules\flex-2.5_8.yml", "YAML", 0, 0, 0, 4, 0, 0, 1, 5
"d:\IDEWORK\lvmen\src\licensedcode\data\rules\flex-2.5_9.yml", "YAML", 0, 0, 0, 4, 0, 0, 1, 5
"d:\IDEWORK\lvmen\src\licensedcode\data\rules\flex-2.5_not_gpl.yml", "YAML", 0, 0, 0, 3, 0, 0, 1, 4
"d:\IDEWORK\lvmen\src\licensedcode\data\rules\flex2sdk.yml", "YAML", 0, 0, 0, 5, 0, 0, 1, 6
"d:\IDEWORK\lvmen\src\licensedcode\data\rules\flora-1.1_1.yml", "YAML", 0, 0, 0, 5, 0, 0, 1, 6
"d:\IDEWORK\lvmen\src\licensedcode\data\rules\fltk-exception-lgpl-2.0_1.yml", "YAML", 0, 0, 0, 7, 0, 0, 1, 8
"d:\IDEWORK\lvmen\src\licensedcode\data\rules\fltk-exception-lgpl-2.0_url_1.yml", "YAML", 0, 0, 0, 5, 0, 0, 1, 6
"d:\IDEWORK\lvmen\src\licensedcode\data\rules\fltk-exception-lgpl-2.0_url_2.yml", "YAML", 0, 0, 0, 5, 0, 0, 1, 6
"d:\IDEWORK\lvmen\src\licensedcode\data\rules\font-exception-2.0_2.yml", "YAML", 0, 0, 0, 4, 0, 0, 1, 5
"d:\IDEWORK\lvmen\src\licensedcode\data\rules\font-exception-3.0_1.yml", "YAML", 0, 0, 0, 2, 0, 0, 1, 3
"d:\IDEWORK\lvmen\src\licensedcode\data\rules\font-exception-gpl_1.yml", "YAML", 0, 0, 0, 3, 0, 0, 1, 4
"d:\IDEWORK\lvmen\src\licensedcode\data\rules\font-exception-gpl_2.yml", "YAML", 0, 0, 0, 5, 0, 0, 1, 6
"d:\IDEWORK\lvmen\src\licensedcode\data\rules\font-exception-gpl_url_1.yml", "YAML", 0, 0, 0, 5, 0, 0, 1, 6
"d:\IDEWORK\lvmen\src\licensedcode\data\rules\font-exception-gpl_url_2.yml", "YAML", 0, 0, 0, 5, 0, 0, 1, 6
"d:\IDEWORK\lvmen\src\licensedcode\data\rules\frameworx-1.0.yml", "YAML", 0, 0, 0, 5, 0, 0, 1, 6
"d:\IDEWORK\lvmen\src\licensedcode\data\rules\frameworx-1.0_1.yml", "YAML", 0, 0, 0, 5, 0, 0, 1, 6
"d:\IDEWORK\lvmen\src\licensedcode\data\rules\frameworx-1.0_2.yml", "YAML", 0, 0, 0, 3, 0, 0, 1, 4
"d:\IDEWORK\lvmen\src\licensedcode\data\rules\frameworx-1.0_url_1.yml", "YAML", 0, 0, 0, 5, 0, 0, 1, 6
"d:\IDEWORK\lvmen\src\licensedcode\data\rules\frameworx-1.0_url_2.yml", "YAML", 0, 0, 0, 5, 0, 0, 1, 6
"d:\IDEWORK\lvmen\src\licensedcode\data\rules\frameworx-1.0_url_glc_164.yml", "YAML", 0, 0, 0, 5, 0, 0, 1, 6
"d:\IDEWORK\lvmen\src\licensedcode\data\rules\frameworx-1.0_url_glc_165.yml", "YAML", 0, 0, 0, 5, 0, 0, 1, 6
"d:\IDEWORK\lvmen\src\licensedcode\data\rules\fraunhofer-fdk-aac-codec_1.yml", "YAML", 0, 0, 0, 5, 0, 0, 1, 6
"d:\IDEWORK\lvmen\src\licensedcode\data\rules\free-art-1.3.yml", "YAML", 0, 0, 0, 5, 0, 0, 1, 6
"d:\IDEWORK\lvmen\src\licensedcode\data\rules\free-unknown_0.yml", "YAML", 0, 0, 0, 3, 0, 0, 1, 4
"d:\IDEWORK\lvmen\src\licensedcode\data\rules\free-unknown_1.yml", "YAML", 0, 0, 0, 3, 0, 0, 1, 4
"d:\IDEWORK\lvmen\src\licensedcode\data\rules\free-unknown_10.yml", "YAML", 0, 0, 0, 6, 0, 0, 1, 7
"d:\IDEWORK\lvmen\src\licensedcode\data\rules\free-unknown_100.yml", "YAML", 0, 0, 0, 3, 0, 0, 1, 4
"d:\IDEWORK\lvmen\src\licensedcode\data\rules\free-unknown_101.yml", "YAML", 0, 0, 0, 3, 0, 0, 1, 4
"d:\IDEWORK\lvmen\src\licensedcode\data\rules\free-unknown_102.yml", "YAML", 0, 0, 0, 3, 0, 0, 1, 4
"d:\IDEWORK\lvmen\src\licensedcode\data\rules\free-unknown_103.yml", "YAML", 0, 0, 0, 3, 0, 0, 1, 4
"d:\IDEWORK\lvmen\src\licensedcode\data\rules\free-unknown_104.yml", "YAML", 0, 0, 0, 3, 0, 0, 1, 4
"d:\IDEWORK\lvmen\src\licensedcode\data\rules\free-unknown_105.yml", "YAML", 0, 0, 0, 3, 0, 0, 1, 4
"d:\IDEWORK\lvmen\src\licensedcode\data\rules\free-unknown_106.yml", "YAML", 0, 0, 0, 5, 0, 0, 1, 6
"d:\IDEWORK\lvmen\src\licensedcode\data\rules\free-unknown_107.yml", "YAML", 0, 0, 0, 3, 0, 0, 1, 4
"d:\IDEWORK\lvmen\src\licensedcode\data\rules\free-unknown_108.yml", "YAML", 0, 0, 0, 3, 0, 0, 1, 4
"d:\IDEWORK\lvmen\src\licensedcode\data\rules\free-unknown_109.yml", "YAML", 0, 0, 0, 5, 0, 0, 1, 6
"d:\IDEWORK\lvmen\src\licensedcode\data\rules\free-unknown_11.yml", "YAML", 0, 0, 0, 6, 0, 0, 1, 7
"d:\IDEWORK\lvmen\src\licensedcode\data\rules\free-unknown_110.yml", "YAML", 0, 0, 0, 3, 0, 0, 1, 4
"d:\IDEWORK\lvmen\src\licensedcode\data\rules\free-unknown_111.yml", "YAML", 0, 0, 0, 5, 0, 0, 1, 6
"d:\IDEWORK\lvmen\src\licensedcode\data\rules\free-unknown_112.yml", "YAML", 0, 0, 0, 3, 0, 0, 1, 4
"d:\IDEWORK\lvmen\src\licensedcode\data\rules\free-unknown_113.yml", "YAML", 0, 0, 0, 6, 0, 0, 1, 7
"d:\IDEWORK\lvmen\src\licensedcode\data\rules\free-unknown_114.yml", "YAML", 0, 0, 0, 3, 0, 0, 1, 4
"d:\IDEWORK\lvmen\src\licensedcode\data\rules\free-unknown_115.yml", "YAML", 0, 0, 0, 3, 0, 0, 1, 4
"d:\IDEWORK\lvmen\src\licensedcode\data\rules\free-unknown_116.yml", "YAML", 0, 0, 0, 3, 0, 0, 1, 4
"d:\IDEWORK\lvmen\src\licensedcode\data\rules\free-unknown_117.yml", "YAML", 0, 0, 0, 9, 0, 0, 1, 10
"d:\IDEWORK\lvmen\src\licensedcode\data\rules\free-unknown_118.yml", "YAML", 0, 0, 0, 3, 0, 0, 1, 4
"d:\IDEWORK\lvmen\src\licensedcode\data\rules\free-unknown_119.yml", "YAML", 0, 0, 0, 3, 0, 0, 1, 4
"d:\IDEWORK\lvmen\src\licensedcode\data\rules\free-unknown_12.yml", "YAML", 0, 0, 0, 4, 0, 0, 1, 5
"d:\IDEWORK\lvmen\src\licensedcode\data\rules\free-unknown_120.yml", "YAML", 0, 0, 0, 2, 0, 0, 1, 3
"d:\IDEWORK\lvmen\src\licensedcode\data\rules\free-unknown_127.yml", "YAML", 0, 0, 0, 4, 0, 0, 1, 5
"d:\IDEWORK\lvmen\src\licensedcode\data\rules\free-unknown_13.yml", "YAML", 0, 0, 0, 4, 0, 0, 1, 5
"d:\IDEWORK\lvmen\src\licensedcode\data\rules\free-unknown_14.yml", "YAML", 0, 0, 0, 4, 0, 0, 1, 5
"d:\IDEWORK\lvmen\src\licensedcode\data\rules\free-unknown_15.yml", "YAML", 0, 0, 0, 4, 0, 0, 1, 5
"d:\IDEWORK\lvmen\src\licensedcode\data\rules\free-unknown_16.yml", "YAML", 0, 0, 0, 4, 0, 0, 1, 5
"d:\IDEWORK\lvmen\src\licensedcode\data\rules\free-unknown_17.yml", "YAML", 0, 0, 0, 6, 0, 0, 1, 7
"d:\IDEWORK\lvmen\src\licensedcode\data\rules\free-unknown_18.yml", "YAML", 0, 0, 0, 6, 0, 0, 1, 7
"d:\IDEWORK\lvmen\src\licensedcode\data\rules\free-unknown_19.yml", "YAML", 0, 0, 0, 7, 0, 0, 1, 8
"d:\IDEWORK\lvmen\src\licensedcode\data\rules\free-unknown_2.yml", "YAML", 0, 0, 0, 3, 0, 0, 1, 4
"d:\IDEWORK\lvmen\src\licensedcode\data\rules\free-unknown_20.yml", "YAML", 0, 0, 0, 4, 0, 0, 1, 5
"d:\IDEWORK\lvmen\src\licensedcode\data\rules\free-unknown_21.yml", "YAML", 0, 0, 0, 4, 0, 0, 1, 5
"d:\IDEWORK\lvmen\src\licensedcode\data\rules\free-unknown_22.yml", "YAML", 0, 0, 0, 4, 0, 0, 1, 5
"d:\IDEWORK\lvmen\src\licensedcode\data\rules\free-unknown_23.yml", "YAML", 0, 0, 0, 3, 0, 0, 1, 4
"d:\IDEWORK\lvmen\src\licensedcode\data\rules\free-unknown_24.yml", "YAML", 0, 0, 0, 3, 0, 0, 1, 4
"d:\IDEWORK\lvmen\src\licensedcode\data\rules\free-unknown_25.yml", "YAML", 0, 0, 0, 3, 0, 0, 1, 4
"d:\IDEWORK\lvmen\src\licensedcode\data\rules\free-unknown_26.yml", "YAML", 0, 0, 0, 2, 0, 0, 1, 3
"d:\IDEWORK\lvmen\src\licensedcode\data\rules\free-unknown_27.yml", "YAML", 0, 0, 0, 6, 0, 0, 1, 7
"d:\IDEWORK\lvmen\src\licensedcode\data\rules\free-unknown_28.yml", "YAML", 0, 0, 0, 6, 0, 0, 1, 7
"d:\IDEWORK\lvmen\src\licensedcode\data\rules\free-unknown_29.yml", "YAML", 0, 0, 0, 3, 0, 0, 1, 4
"d:\IDEWORK\lvmen\src\licensedcode\data\rules\free-unknown_3.yml", "YAML", 0, 0, 0, 3, 0, 0, 1, 4
"d:\IDEWORK\lvmen\src\licensedcode\data\rules\free-unknown_30.yml", "YAML", 0, 0, 0, 3, 0, 0, 1, 4
"d:\IDEWORK\lvmen\src\licensedcode\data\rules\free-unknown_31.yml", "YAML", 0, 0, 0, 3, 0, 0, 1, 4
"d:\IDEWORK\lvmen\src\licensedcode\data\rules\free-unknown_32.yml", "YAML", 0, 0, 0, 3, 0, 0, 1, 4
"d:\IDEWORK\lvmen\src\licensedcode\data\rules\free-unknown_33.yml", "YAML", 0, 0, 0, 3, 0, 0, 1, 4
"d:\IDEWORK\lvmen\src\licensedcode\data\rules\free-unknown_34.yml", "YAML", 0, 0, 0, 3, 0, 0, 1, 4
"d:\IDEWORK\lvmen\src\licensedcode\data\rules\free-unknown_35.yml", "YAML", 0, 0, 0, 3, 0, 0, 1, 4
"d:\IDEWORK\lvmen\src\licensedcode\data\rules\free-unknown_36.yml", "YAML", 0, 0, 0, 2, 0, 0, 1, 3
"d:\IDEWORK\lvmen\src\licensedcode\data\rules\free-unknown_37.yml", "YAML", 0, 0, 0, 2, 0, 0, 1, 3
"d:\IDEWORK\lvmen\src\licensedcode\data\rules\free-unknown_38.yml", "YAML", 0, 0, 0, 2, 0, 0, 1, 3
"d:\IDEWORK\lvmen\src\licensedcode\data\rules\free-unknown_39.yml", "YAML", 0, 0, 0, 2, 0, 0, 1, 3
"d:\IDEWORK\lvmen\src\licensedcode\data\rules\free-unknown_4.yml", "YAML", 0, 0, 0, 4, 0, 0, 1, 5
"d:\IDEWORK\lvmen\src\licensedcode\data\rules\free-unknown_40.yml", "YAML", 0, 0, 0, 2, 0, 0, 1, 3
"d:\IDEWORK\lvmen\src\licensedcode\data\rules\free-unknown_41.yml", "YAML", 0, 0, 0, 3, 0, 0, 1, 4
"d:\IDEWORK\lvmen\src\licensedcode\data\rules\free-unknown_42.yml", "YAML", 0, 0, 0, 3, 0, 0, 1, 4
"d:\IDEWORK\lvmen\src\licensedcode\data\rules\free-unknown_44.yml", "YAML", 0, 0, 0, 2, 0, 0, 1, 3
"d:\IDEWORK\lvmen\src\licensedcode\data\rules\free-unknown_45.yml", "YAML", 0, 0, 0, 2, 0, 0, 1, 3
"d:\IDEWORK\lvmen\src\licensedcode\data\rules\free-unknown_46.yml", "YAML", 0, 0, 0, 6, 0, 0, 1, 7
"d:\IDEWORK\lvmen\src\licensedcode\data\rules\free-unknown_47.yml", "YAML", 0, 0, 0, 3, 0, 0, 1, 4
"d:\IDEWORK\lvmen\src\licensedcode\data\rules\free-unknown_48.yml", "YAML", 0, 0, 0, 4, 0, 0, 1, 5
"d:\IDEWORK\lvmen\src\licensedcode\data\rules\free-unknown_49.yml", "YAML", 0, 0, 0, 3, 0, 0, 1, 4
"d:\IDEWORK\lvmen\src\licensedcode\data\rules\free-unknown_5.yml", "YAML", 0, 0, 0, 4, 0, 0, 1, 5
"d:\IDEWORK\lvmen\src\licensedcode\data\rules\free-unknown_50.yml", "YAML", 0, 0, 0, 3, 0, 0, 1, 4
"d:\IDEWORK\lvmen\src\licensedcode\data\rules\free-unknown_51.yml", "YAML", 0, 0, 0, 4, 0, 0, 1, 5
"d:\IDEWORK\lvmen\src\licensedcode\data\rules\free-unknown_52.yml", "YAML", 0, 0, 0, 2, 0, 0, 1, 3
"d:\IDEWORK\lvmen\src\licensedcode\data\rules\free-unknown_53.yml", "YAML", 0, 0, 0, 4, 0, 0, 1, 5
"d:\IDEWORK\lvmen\src\licensedcode\data\rules\free-unknown_54.yml", "YAML", 0, 0, 0, 3, 0, 0, 1, 4
"d:\IDEWORK\lvmen\src\licensedcode\data\rules\free-unknown_55.yml", "YAML", 0, 0, 0, 3, 0, 0, 1, 4
"d:\IDEWORK\lvmen\src\licensedcode\data\rules\free-unknown_56.yml", "YAML", 0, 0, 0, 5, 0, 0, 1, 6
"d:\IDEWORK\lvmen\src\licensedcode\data\rules\free-unknown_57.yml", "YAML", 0, 0, 0, 3, 0, 0, 1, 4
"d:\IDEWORK\lvmen\src\licensedcode\data\rules\free-unknown_58.yml", "YAML", 0, 0, 0, 5, 0, 0, 1, 6
"d:\IDEWORK\lvmen\src\licensedcode\data\rules\free-unknown_59.yml", "YAML", 0, 0, 0, 5, 0, 0, 1, 6
"d:\IDEWORK\lvmen\src\licensedcode\data\rules\free-unknown_6.yml", "YAML", 0, 0, 0, 5, 0, 0, 1, 6
"d:\IDEWORK\lvmen\src\licensedcode\data\rules\free-unknown_60.yml", "YAML", 0, 0, 0, 8, 0, 0, 1, 9
"d:\IDEWORK\lvmen\src\licensedcode\data\rules\free-unknown_61.yml", "YAML", 0, 0, 0, 5, 0, 0, 1, 6
"d:\IDEWORK\lvmen\src\licensedcode\data\rules\free-unknown_62.yml", "YAML", 0, 0, 0, 5, 0, 0, 1, 6
"d:\IDEWORK\lvmen\src\licensedcode\data\rules\free-unknown_63.yml", "YAML", 0, 0, 0, 2, 0, 0, 1, 3
"d:\IDEWORK\lvmen\src\licensedcode\data\rules\free-unknown_64.yml", "YAML", 0, 0, 0, 3, 0, 0, 1, 4
"d:\IDEWORK\lvmen\src\licensedcode\data\rules\free-unknown_65.yml", "YAML", 0, 0, 0, 3, 0, 0, 1, 4
"d:\IDEWORK\lvmen\src\licensedcode\data\rules\free-unknown_66.yml", "YAML", 0, 0, 0, 2, 0, 0, 1, 3
"d:\IDEWORK\lvmen\src\licensedcode\data\rules\free-unknown_67.yml", "YAML", 0, 0, 0, 3, 0, 0, 1, 4
"d:\IDEWORK\lvmen\src\licensedcode\data\rules\free-unknown_68.yml", "YAML", 0, 0, 0, 9, 0, 0, 1, 10
"d:\IDEWORK\lvmen\src\licensedcode\data\rules\free-unknown_69.yml", "YAML", 0, 0, 0, 9, 0, 0, 1, 10
"d:\IDEWORK\lvmen\src\licensedcode\data\rules\free-unknown_7.yml", "YAML", 0, 0, 0, 4, 0, 0, 1, 5
"d:\IDEWORK\lvmen\src\licensedcode\data\rules\free-unknown_70.yml", "YAML", 0, 0, 0, 8, 0, 0, 1, 9
"d:\IDEWORK\lvmen\src\licensedcode\data\rules\free-unknown_71.yml", "YAML", 0, 0, 0, 6, 0, 0, 1, 7
"d:\IDEWORK\lvmen\src\licensedcode\data\rules\free-unknown_72.yml", "YAML", 0, 0, 0, 3, 0, 0, 1, 4
"d:\IDEWORK\lvmen\src\licensedcode\data\rules\free-unknown_73.yml", "YAML", 0, 0, 0, 3, 0, 0, 1, 4
"d:\IDEWORK\lvmen\src\licensedcode\data\rules\free-unknown_74.yml", "YAML", 0, 0, 0, 3, 0, 0, 1, 4
"d:\IDEWORK\lvmen\src\licensedcode\data\rules\free-unknown_75.yml", "YAML", 0, 0, 0, 3, 0, 0, 1, 4
"d:\IDEWORK\lvmen\src\licensedcode\data\rules\free-unknown_76.yml", "YAML", 0, 0, 0, 3, 0, 0, 1, 4
"d:\IDEWORK\lvmen\src\licensedcode\data\rules\free-unknown_77.yml", "YAML", 0, 0, 0, 4, 0, 0, 1, 5
"d:\IDEWORK\lvmen\src\licensedcode\data\rules\free-unknown_78.yml", "YAML", 0, 0, 0, 6, 0, 0, 1, 7
"d:\IDEWORK\lvmen\src\licensedcode\data\rules\free-unknown_79.yml", "YAML", 0, 0, 0, 4, 0, 0, 1, 5
"d:\IDEWORK\lvmen\src\licensedcode\data\rules\free-unknown_8.yml", "YAML", 0, 0, 0, 6, 0, 0, 1, 7
"d:\IDEWORK\lvmen\src\licensedcode\data\rules\free-unknown_80.yml", "YAML", 0, 0, 0, 4, 0, 0, 1, 5
"d:\IDEWORK\lvmen\src\licensedcode\data\rules\free-unknown_81.yml", "YAML", 0, 0, 0, 4, 0, 0, 1, 5
"d:\IDEWORK\lvmen\src\licensedcode\data\rules\free-unknown_82.yml", "YAML", 0, 0, 0, 4, 0, 0, 1, 5
"d:\IDEWORK\lvmen\src\licensedcode\data\rules\free-unknown_83.yml", "YAML", 0, 0, 0, 3, 0, 0, 1, 4
"d:\IDEWORK\lvmen\src\licensedcode\data\rules\free-unknown_84.yml", "YAML", 0, 0, 0, 4, 0, 0, 1, 5
"d:\IDEWORK\lvmen\src\licensedcode\data\rules\free-unknown_85.yml", "YAML", 0, 0, 0, 3, 0, 0, 1, 4
"d:\IDEWORK\lvmen\src\licensedcode\data\rules\free-unknown_86.yml", "YAML", 0, 0, 0, 7, 0, 0, 1, 8
"d:\IDEWORK\lvmen\src\licensedcode\data\rules\free-unknown_87.yml", "YAML", 0, 0, 0, 4, 0, 0, 1, 5
"d:\IDEWORK\lvmen\src\licensedcode\data\rules\free-unknown_88.yml", "YAML", 0, 0, 0, 3, 0, 0, 1, 4
"d:\IDEWORK\lvmen\src\licensedcode\data\rules\free-unknown_89.yml", "YAML", 0, 0, 0, 3, 0, 0, 1, 4
"d:\IDEWORK\lvmen\src\licensedcode\data\rules\free-unknown_9.yml", "YAML", 0, 0, 0, 3, 0, 0, 1, 4
"d:\IDEWORK\lvmen\src\licensedcode\data\rules\free-unknown_90.yml", "YAML", 0, 0, 0, 4, 0, 0, 1, 5
"d:\IDEWORK\lvmen\src\licensedcode\data\rules\free-unknown_91.yml", "YAML", 0, 0, 0, 3, 0, 0, 1, 4
"d:\IDEWORK\lvmen\src\licensedcode\data\rules\free-unknown_92.yml", "YAML", 0, 0, 0, 3, 0, 0, 1, 4
"d:\IDEWORK\lvmen\src\licensedcode\data\rules\free-unknown_93.yml", "YAML", 0, 0, 0, 5, 0, 0, 1, 6
"d:\IDEWORK\lvmen\src\licensedcode\data\rules\free-unknown_94.yml", "YAML", 0, 0, 0, 5, 0, 0, 1, 6
"d:\IDEWORK\lvmen\src\licensedcode\data\rules\free-unknown_95.yml", "YAML", 0, 0, 0, 5, 0, 0, 1, 6
"d:\IDEWORK\lvmen\src\licensedcode\data\rules\free-unknown_96.yml", "YAML", 0, 0, 0, 5, 0, 0, 1, 6
"d:\IDEWORK\lvmen\src\licensedcode\data\rules\free-unknown_97.yml", "YAML", 0, 0, 0, 3, 0, 0, 1, 4
"d:\IDEWORK\lvmen\src\licensedcode\data\rules\free-unknown_98.yml", "YAML", 0, 0, 0, 3, 0, 0, 1, 4
"d:\IDEWORK\lvmen\src\licensedcode\data\rules\free-unknown_99.yml", "YAML", 0, 0, 0, 3, 0, 0, 1, 4
"d:\IDEWORK\lvmen\src\licensedcode\data\rules\free-unknown_and_apache-2.0_with_generic-exception_1.yml", "YAML", 0, 0, 0, 9, 0, 0, 1, 10
"d:\IDEWORK\lvmen\src\licensedcode\data\rules\free-unknown_and_apache-2.0_with_generic-exception_2.yml", "YAML", 0, 0, 0, 10, 0, 0, 1, 11
"d:\IDEWORK\lvmen\src\licensedcode\data\rules\free-unknown_and_apache-2.0_with_generic-exception_3.yml", "YAML", 0, 0, 0, 10, 0, 0, 1, 11
"d:\IDEWORK\lvmen\src\licensedcode\data\rules\free-unknown_rare.yml", "YAML", 0, 0, 0, 2, 0, 0, 1, 3
"d:\IDEWORK\lvmen\src\licensedcode\data\rules\free-unknown_uoi-ncsa-like.yml", "YAML", 0, 0, 0, 6, 0, 0, 1, 7
"d:\IDEWORK\lvmen\src\licensedcode\data\rules\free-unknown_zulip.yml", "YAML", 0, 0, 0, 2, 0, 0, 1, 3
"d:\IDEWORK\lvmen\src\licensedcode\data\rules\freebsd-boot_2.yml", "YAML", 0, 0, 0, 5, 0, 0, 1, 6
"d:\IDEWORK\lvmen\src\licensedcode\data\rules\freebsd-boot_3.yml", "YAML", 0, 0, 0, 5, 0, 0, 1, 6
"d:\IDEWORK\lvmen\src\licensedcode\data\rules\freebsd-doc_1.yml", "YAML", 0, 0, 0, 2, 0, 0, 1, 3
"d:\IDEWORK\lvmen\src\licensedcode\data\rules\freebsd-doc_2.yml", "YAML", 0, 0, 0, 2, 0, 0, 1, 3
"d:\IDEWORK\lvmen\src\licensedcode\data\rules\freebsd-doc_3.yml", "YAML", 0, 0, 0, 2, 0, 0, 1, 3
"d:\IDEWORK\lvmen\src\licensedcode\data\rules\freebsd-doc_4.yml", "YAML", 0, 0, 0, 2, 0, 0, 1, 3
"d:\IDEWORK\lvmen\src\licensedcode\data\rules\freebsd-doc_5.yml", "YAML", 0, 0, 0, 3, 0, 0, 1, 4
"d:\IDEWORK\lvmen\src\licensedcode\data\rules\freebsd-doc_6.yml", "YAML", 0, 0, 0, 4, 0, 0, 1, 5
"d:\IDEWORK\lvmen\src\licensedcode\data\rules\freebsd-doc_7.yml", "YAML", 0, 0, 0, 11, 0, 0, 1, 12
"d:\IDEWORK\lvmen\src\licensedcode\data\rules\freeimage-1.0_1.yml", "YAML", 0, 0, 0, 5, 0, 0, 1, 6
"d:\IDEWORK\lvmen\src\licensedcode\data\rules\freeimage-1.0_2.yml", "YAML", 0, 0, 0, 5, 0, 0, 1, 6
"d:\IDEWORK\lvmen\src\licensedcode\data\rules\freeimage-1.0_url_1.yml", "YAML", 0, 0, 0, 5, 0, 0, 1, 6
"d:\IDEWORK\lvmen\src\licensedcode\data\rules\freeimage-1.0_url_2.yml", "YAML", 0, 0, 0, 5, 0, 0, 1, 6
"d:\IDEWORK\lvmen\src\licensedcode\data\rules\freemarker.yml", "YAML", 0, 0, 0, 5, 0, 0, 1, 6
"d:\IDEWORK\lvmen\src\licensedcode\data\rules\freemarker_1.yml", "YAML", 0, 0, 0, 5, 0, 0, 1, 6
"d:\IDEWORK\lvmen\src\licensedcode\data\rules\freemarker_2.yml", "YAML", 0, 0, 0, 8, 0, 0, 1, 9
"d:\IDEWORK\lvmen\src\licensedcode\data\rules\freemarker_3.yml", "YAML", 0, 0, 0, 9, 0, 0, 1, 10
"d:\IDEWORK\lvmen\src\licensedcode\data\rules\freemarker_4.yml", "YAML", 0, 0, 0, 3, 0, 0, 1, 4
"d:\IDEWORK\lvmen\src\licensedcode\data\rules\freertos-exception-2.0_1.yml", "YAML", 0, 0, 0, 4, 0, 0, 1, 5
"d:\IDEWORK\lvmen\src\licensedcode\data\rules\freertos-exception-2.0_2.yml", "YAML", 0, 0, 0, 3, 0, 0, 1, 4
"d:\IDEWORK\lvmen\src\licensedcode\data\rules\freertos-exception-2.0_3.yml", "YAML", 0, 0, 0, 3, 0, 0, 1, 4
"d:\IDEWORK\lvmen\src\licensedcode\data\rules\freertos-exception-2.0_4.yml", "YAML", 0, 0, 0, 2, 0, 0, 1, 3
"d:\IDEWORK\lvmen\src\licensedcode\data\rules\freertos-exception-2.0_5.yml", "YAML", 0, 0, 0, 2, 0, 0, 1, 3
"d:\IDEWORK\lvmen\src\licensedcode\data\rules\freertos-exception-2.0_6.yml", "YAML", 0, 0, 0, 2, 0, 0, 1, 3
"d:\IDEWORK\lvmen\src\licensedcode\data\rules\freertos-exception-2.0_7.yml", "YAML", 0, 0, 0, 3, 0, 0, 1, 4
"d:\IDEWORK\lvmen\src\licensedcode\data\rules\freertos-exception-2.0_url_1.yml", "YAML", 0, 0, 0, 5, 0, 0, 1, 6
"d:\IDEWORK\lvmen\src\licensedcode\data\rules\freertos-exception-2.0_url_2.yml", "YAML", 0, 0, 0, 5, 0, 0, 1, 6
"d:\IDEWORK\lvmen\src\licensedcode\data\rules\freetts.yml", "YAML", 0, 0, 0, 5, 0, 0, 1, 6
"d:\IDEWORK\lvmen\src\licensedcode\data\rules\freetts_1.yml", "YAML", 0, 0, 0, 3, 0, 0, 1, 4
"d:\IDEWORK\lvmen\src\licensedcode\data\rules\freetts_2.yml", "YAML", 0, 0, 0, 5, 0, 0, 1, 6
"d:\IDEWORK\lvmen\src\licensedcode\data\rules\freetype_1.yml", "YAML", 0, 0, 0, 5, 0, 0, 1, 6
"d:\IDEWORK\lvmen\src\licensedcode\data\rules\freetype_10.yml", "YAML", 0, 0, 0, 3, 0, 0, 1, 4
"d:\IDEWORK\lvmen\src\licensedcode\data\rules\freetype_11.yml", "YAML", 0, 0, 0, 16, 0, 0, 1, 17
"d:\IDEWORK\lvmen\src\licensedcode\data\rules\freetype_12.yml", "YAML", 0, 0, 0, 3, 0, 0, 1, 4
"d:\IDEWORK\lvmen\src\licensedcode\data\rules\freetype_13.yml", "YAML", 0, 0, 0, 15, 0, 0, 1, 16
"d:\IDEWORK\lvmen\src\licensedcode\data\rules\freetype_2.yml", "YAML", 0, 0, 0, 5, 0, 0, 1, 6
"d:\IDEWORK\lvmen\src\licensedcode\data\rules\freetype_3.yml", "YAML", 0, 0, 0, 11, 0, 0, 1, 12
"d:\IDEWORK\lvmen\src\licensedcode\data\rules\freetype_4.yml", "YAML", 0, 0, 0, 4, 0, 0, 1, 5
"d:\IDEWORK\lvmen\src\licensedcode\data\rules\freetype_5.yml", "YAML", 0, 0, 0, 4, 0, 0, 1, 5
"d:\IDEWORK\lvmen\src\licensedcode\data\rules\freetype_6.yml", "YAML", 0, 0, 0, 3, 0, 0, 1, 4
"d:\IDEWORK\lvmen\src\licensedcode\data\rules\freetype_7.yml", "YAML", 0, 0, 0, 5, 0, 0, 1, 6
"d:\IDEWORK\lvmen\src\licensedcode\data\rules\freetype_8.yml", "YAML", 0, 0, 0, 5, 0, 0, 1, 6
"d:\IDEWORK\lvmen\src\licensedcode\data\rules\freetype_9.yml", "YAML", 0, 0, 0, 3, 0, 0, 1, 4
"d:\IDEWORK\lvmen\src\licensedcode\data\rules\freetype_and_freetype-patent_1.yml", "YAML", 0, 0, 0, 4, 0, 0, 1, 5
"d:\IDEWORK\lvmen\src\licensedcode\data\rules\freetype_or_gpl-2.0_1.yml", "YAML", 0, 0, 0, 3, 0, 0, 1, 4
"d:\IDEWORK\lvmen\src\licensedcode\data\rules\freetype_or_gpl-2.0_2.yml", "YAML", 0, 0, 0, 3, 0, 0, 1, 4
"d:\IDEWORK\lvmen\src\licensedcode\data\rules\freetype_or_gpl-2.0_3.yml", "YAML", 0, 0, 0, 3, 0, 0, 1, 4
"d:\IDEWORK\lvmen\src\licensedcode\data\rules\freetype_or_gpl-2.0_4.yml", "YAML", 0, 0, 0, 3, 0, 0, 1, 4
"d:\IDEWORK\lvmen\src\licensedcode\data\rules\freetype_url_1.yml", "YAML", 0, 0, 0, 5, 0, 0, 1, 6
"d:\IDEWORK\lvmen\src\licensedcode\data\rules\freetype_url_2.yml", "YAML", 0, 0, 0, 5, 0, 0, 1, 6
"d:\IDEWORK\lvmen\src\licensedcode\data\rules\freetype_with_autoconf-simple-exception-2.0_1.yml", "YAML", 0, 0, 0, 3, 0, 0, 1, 4
"d:\IDEWORK\lvmen\src\licensedcode\data\rules\freeware_bare_word_only.yml", "YAML", 0, 0, 0, 3, 0, 0, 1, 4
"d:\IDEWORK\lvmen\src\licensedcode\data\rules\frontier-1.0.yml", "YAML", 0, 0, 0, 3, 0, 0, 1, 4
"d:\IDEWORK\lvmen\src\licensedcode\data\rules\frontier-1.0_1.yml", "YAML", 0, 0, 0, 8, 0, 0, 1, 9
"d:\IDEWORK\lvmen\src\licensedcode\data\rules\frontier-1.0_2.yml", "YAML", 0, 0, 0, 2, 0, 0, 1, 3
"d:\IDEWORK\lvmen\src\licensedcode\data\rules\fsf-ap_1.yml", "YAML", 0, 0, 0, 2, 0, 0, 1, 3
"d:\IDEWORK\lvmen\src\licensedcode\data\rules\fsf-ap_2.yml", "YAML", 0, 0, 0, 2, 0, 0, 1, 3
"d:\IDEWORK\lvmen\src\licensedcode\data\rules\fsf-ap_3.yml", "YAML", 0, 0, 0, 2, 0, 0, 1, 3
"d:\IDEWORK\lvmen\src\licensedcode\data\rules\fsf-ap_4.yml", "YAML", 0, 0, 0, 2, 0, 0, 1, 3
"d:\IDEWORK\lvmen\src\licensedcode\data\rules\fsf-ap_5.yml", "YAML", 0, 0, 0, 3, 0, 0, 1, 4
"d:\IDEWORK\lvmen\src\licensedcode\data\rules\fsf-ap_6.yml", "YAML", 0, 0, 0, 3, 0, 0, 1, 4
"d:\IDEWORK\lvmen\src\licensedcode\data\rules\fsf-ap_7.yml", "YAML", 0, 0, 0, 3, 0, 0, 1, 4
"d:\IDEWORK\lvmen\src\licensedcode\data\rules\fsf-ap_url_1.yml", "YAML", 0, 0, 0, 5, 0, 0, 1, 6
"d:\IDEWORK\lvmen\src\licensedcode\data\rules\fsf-ap_url_2.yml", "YAML", 0, 0, 0, 5, 0, 0, 1, 6
"d:\IDEWORK\lvmen\src\licensedcode\data\rules\fsf-ap_url_glc_136.yml", "YAML", 0, 0, 0, 5, 0, 0, 1, 6
"d:\IDEWORK\lvmen\src\licensedcode\data\rules\fsf-ap_url_glc_137.yml", "YAML", 0, 0, 0, 5, 0, 0, 1, 6
"d:\IDEWORK\lvmen\src\licensedcode\data\rules\fsf-free.yml", "YAML", 0, 0, 0, 2, 0, 0, 1, 3
"d:\IDEWORK\lvmen\src\licensedcode\data\rules\fsf-free2.yml", "YAML", 0, 0, 0, 2, 0, 0, 1, 3
"d:\IDEWORK\lvmen\src\licensedcode\data\rules\fsf-free3.yml", "YAML", 0, 0, 0, 2, 0, 0, 1, 3
"d:\IDEWORK\lvmen\src\licensedcode\data\rules\fsf-free4.yml", "YAML", 0, 0, 0, 3, 0, 0, 1, 4
"d:\IDEWORK\lvmen\src\licensedcode\data\rules\fsf-free5.yml", "YAML", 0, 0, 0, 2, 0, 0, 1, 3
"d:\IDEWORK\lvmen\src\licensedcode\data\rules\fsf-free_url_1.yml", "YAML", 0, 0, 0, 5, 0, 0, 1, 6
"d:\IDEWORK\lvmen\src\licensedcode\data\rules\fsf-free_url_2.yml", "YAML", 0, 0, 0, 5, 0, 0, 1, 6
"d:\IDEWORK\lvmen\src\licensedcode\data\rules\fsf-unlimited-no-warranty.yml", "YAML", 0, 0, 0, 3, 0, 0, 1, 4
"d:\IDEWORK\lvmen\src\licensedcode\data\rules\fsf-unlimited-no-warranty_1.yml", "YAML", 0, 0, 0, 3, 0, 0, 1, 4
"d:\IDEWORK\lvmen\src\licensedcode\data\rules\fsf-unlimited-no-warranty_2.yml", "YAML", 0, 0, 0, 3, 0, 0, 1, 4
"d:\IDEWORK\lvmen\src\licensedcode\data\rules\fsf-unlimited-no-warranty_3.yml", "YAML", 0, 0, 0, 2, 0, 0, 1, 3
"d:\IDEWORK\lvmen\src\licensedcode\data\rules\fsf-unlimited-no-warranty_4.yml", "YAML", 0, 0, 0, 3, 0, 0, 1, 4
"d:\IDEWORK\lvmen\src\licensedcode\data\rules\fsf-unlimited-no-warranty_5.yml", "YAML", 0, 0, 0, 2, 0, 0, 1, 3
"d:\IDEWORK\lvmen\src\licensedcode\data\rules\fsf-unlimited-no-warranty_and_other-copyleft_1.yml", "YAML", 0, 0, 0, 5, 0, 0, 1, 6
"d:\IDEWORK\lvmen\src\licensedcode\data\rules\fsf-unlimited_1.yml", "YAML", 0, 0, 0, 3, 0, 0, 1, 4
"d:\IDEWORK\lvmen\src\licensedcode\data\rules\fsf-unlimited_2.yml", "YAML", 0, 0, 0, 3, 0, 0, 1, 4
"d:\IDEWORK\lvmen\src\licensedcode\data\rules\fsf-unlimited_3.yml", "YAML", 0, 0, 0, 3, 0, 0, 1, 4
"d:\IDEWORK\lvmen\src\licensedcode\data\rules\fsf-unlimited_url_1.yml", "YAML", 0, 0, 0, 5, 0, 0, 1, 6
"d:\IDEWORK\lvmen\src\licensedcode\data\rules\fsf-unlimited_url_2.yml", "YAML", 0, 0, 0, 5, 0, 0, 1, 6
"d:\IDEWORK\lvmen\src\licensedcode\data\rules\gcc-exception-3.0_1.yml", "YAML", 0, 0, 0, 5, 0, 0, 1, 6
"d:\IDEWORK\lvmen\src\licensedcode\data\rules\gcc-exception-3.1_1.yml", "YAML", 0, 0, 0, 9, 0, 0, 1, 10
"d:\IDEWORK\lvmen\src\licensedcode\data\rules\gcc-exception-3.1_2.yml", "YAML", 0, 0, 0, 3, 0, 0, 1, 4
"d:\IDEWORK\lvmen\src\licensedcode\data\rules\gcc-exception-3.1_3.yml", "YAML", 0, 0, 0, 3, 0, 0, 1, 4
"d:\IDEWORK\lvmen\src\licensedcode\data\rules\gcc-exception-3.1_4.yml", "YAML", 0, 0, 0, 3, 0, 0, 1, 4
"d:\IDEWORK\lvmen\src\licensedcode\data\rules\gcc-exception-3.1_5.yml", "YAML", 0, 0, 0, 6, 0, 0, 1, 7
"d:\IDEWORK\lvmen\src\licensedcode\data\rules\gcc-exception-3.1_url_1.yml", "YAML", 0, 0, 0, 5, 0, 0, 1, 6
"d:\IDEWORK\lvmen\src\licensedcode\data\rules\gcc-exception-3.1_url_2.yml", "YAML", 0, 0, 0, 5, 0, 0, 1, 6
"d:\IDEWORK\lvmen\src\licensedcode\data\rules\gcc-exception-lgpl-2.0-plus_1.yml", "YAML", 0, 0, 0, 2, 0, 0, 1, 3
"d:\IDEWORK\lvmen\src\licensedcode\data\rules\gcc-exception-lgpl-2.0-plus_2.yml", "YAML", 0, 0, 0, 2, 0, 0, 1, 3
"d:\IDEWORK\lvmen\src\licensedcode\data\rules\gcc-exception-lgpl-2.0-plus_3.yml", "YAML", 0, 0, 0, 4, 0, 0, 1, 5
"d:\IDEWORK\lvmen\src\licensedcode\data\rules\gcc-exception-lgpl-2.0-plus_4.yml", "YAML", 0, 0, 0, 4, 0, 0, 1, 5
"d:\IDEWORK\lvmen\src\licensedcode\data\rules\gcc-exception-lgpl-2.0-plus_5.yml", "YAML", 0, 0, 0, 6, 0, 0, 1, 7
"d:\IDEWORK\lvmen\src\licensedcode\data\rules\gcc-exception_1.yml", "YAML", 0, 0, 0, 4, 0, 0, 1, 5
"d:\IDEWORK\lvmen\src\licensedcode\data\rules\gcc-linking-exception-2.0_1.yml", "YAML", 0, 0, 0, 4, 0, 0, 1, 5
"d:\IDEWORK\lvmen\src\licensedcode\data\rules\gcc-linking-exception-2.0_2.yml", "YAML", 0, 0, 0, 4, 0, 0, 1, 5
"d:\IDEWORK\lvmen\src\licensedcode\data\rules\gcc-linking-exception-2.0_3.yml", "YAML", 0, 0, 0, 2, 0, 0, 1, 3
"d:\IDEWORK\lvmen\src\licensedcode\data\rules\gcc-linking-exception-2.0_4.yml", "YAML", 0, 0, 0, 2, 0, 0, 1, 3
"d:\IDEWORK\lvmen\src\licensedcode\data\rules\gcc-linking-exception-2.0_5.yml", "YAML", 0, 0, 0, 4, 0, 0, 1, 5
"d:\IDEWORK\lvmen\src\licensedcode\data\rules\gcc-linking-exception-2.0_libgit2_1.yml", "YAML", 0, 0, 0, 4, 0, 0, 1, 5
"d:\IDEWORK\lvmen\src\licensedcode\data\rules\gcc-linking-exception-2.0_libgit2_2.yml", "YAML", 0, 0, 0, 4, 0, 0, 1, 5
"d:\IDEWORK\lvmen\src\licensedcode\data\rules\gcc-linking-exception-2.0_libgit2_3.yml", "YAML", 0, 0, 0, 4, 0, 0, 1, 5
"d:\IDEWORK\lvmen\src\licensedcode\data\rules\gcc-linking-exception-2.0_libgit2_4.yml", "YAML", 0, 0, 0, 2, 0, 0, 1, 3
"d:\IDEWORK\lvmen\src\licensedcode\data\rules\gcc-linking-exception-2.0_url_1.yml", "YAML", 0, 0, 0, 5, 0, 0, 1, 6
"d:\IDEWORK\lvmen\src\licensedcode\data\rules\gcc-linking-exception-2.0_url_2.yml", "YAML", 0, 0, 0, 5, 0, 0, 1, 6
"d:\IDEWORK\lvmen\src\licensedcode\data\rules\generic-cla.yml", "YAML", 0, 0, 0, 3, 0, 0, 1, 4
"d:\IDEWORK\lvmen\src\licensedcode\data\rules\generic-cla10.yml", "YAML", 0, 0, 0, 3, 0, 0, 1, 4
"d:\IDEWORK\lvmen\src\licensedcode\data\rules\generic-cla2.yml", "YAML", 0, 0, 0, 5, 0, 0, 1, 6
"d:\IDEWORK\lvmen\src\licensedcode\data\rules\generic-cla3.yml", "YAML", 0, 0, 0, 2, 0, 0, 1, 3
"d:\IDEWORK\lvmen\src\licensedcode\data\rules\generic-cla4.yml", "YAML", 0, 0, 0, 2, 0, 0, 1, 3
"d:\IDEWORK\lvmen\src\licensedcode\data\rules\generic-cla5.yml", "YAML", 0, 0, 0, 4, 0, 0, 1, 5
"d:\IDEWORK\lvmen\src\licensedcode\data\rules\generic-cla6.yml", "YAML", 0, 0, 0, 3, 0, 0, 1, 4
"d:\IDEWORK\lvmen\src\licensedcode\data\rules\generic-cla7.yml", "YAML", 0, 0, 0, 4, 0, 0, 1, 5
"d:\IDEWORK\lvmen\src\licensedcode\data\rules\generic-cla8.yml", "YAML", 0, 0, 0, 4, 0, 0, 1, 5
"d:\IDEWORK\lvmen\src\licensedcode\data\rules\generic-cla9.yml", "YAML", 0, 0, 0, 4, 0, 0, 1, 5
"d:\IDEWORK\lvmen\src\licensedcode\data\rules\generic-cla_1.yml", "YAML", 0, 0, 0, 3, 0, 0, 1, 4
"d:\IDEWORK\lvmen\src\licensedcode\data\rules\generic-cla_10.yml", "YAML", 0, 0, 0, 3, 0, 0, 1, 4
"d:\IDEWORK\lvmen\src\licensedcode\data\rules\generic-cla_11.yml", "YAML", 0, 0, 0, 7, 0, 0, 1, 8
"d:\IDEWORK\lvmen\src\licensedcode\data\rules\generic-cla_12.yml", "YAML", 0, 0, 0, 3, 0, 0, 1, 4
"d:\IDEWORK\lvmen\src\licensedcode\data\rules\generic-cla_13.yml", "YAML", 0, 0, 0, 3, 0, 0, 1, 4
"d:\IDEWORK\lvmen\src\licensedcode\data\rules\generic-cla_14.yml", "YAML", 0, 0, 0, 3, 0, 0, 1, 4
"d:\IDEWORK\lvmen\src\licensedcode\data\rules\generic-cla_15.yml", "YAML", 0, 0, 0, 3, 0, 0, 1, 4
"d:\IDEWORK\lvmen\src\licensedcode\data\rules\generic-cla_16.yml", "YAML", 0, 0, 0, 3, 0, 0, 1, 4
"d:\IDEWORK\lvmen\src\licensedcode\data\rules\generic-cla_17.yml", "YAML", 0, 0, 0, 3, 0, 0, 1, 4
"d:\IDEWORK\lvmen\src\licensedcode\data\rules\generic-cla_2.yml", "YAML", 0, 0, 0, 3, 0, 0, 1, 4
"d:\IDEWORK\lvmen\src\licensedcode\data\rules\generic-cla_3.yml", "YAML", 0, 0, 0, 3, 0, 0, 1, 4
"d:\IDEWORK\lvmen\src\licensedcode\data\rules\generic-cla_4.yml", "YAML", 0, 0, 0, 3, 0, 0, 1, 4
"d:\IDEWORK\lvmen\src\licensedcode\data\rules\generic-cla_5.yml", "YAML", 0, 0, 0, 5, 0, 0, 1, 6
"d:\IDEWORK\lvmen\src\licensedcode\data\rules\generic-cla_6.yml", "YAML", 0, 0, 0, 3, 0, 0, 1, 4
"d:\IDEWORK\lvmen\src\licensedcode\data\rules\generic-cla_7.yml", "YAML", 0, 0, 0, 4, 0, 0, 1, 5
"d:\IDEWORK\lvmen\src\licensedcode\data\rules\generic-cla_8.yml", "YAML", 0, 0, 0, 3, 0, 0, 1, 4
"d:\IDEWORK\lvmen\src\licensedcode\data\rules\generic-cla_9.yml", "YAML", 0, 0, 0, 4, 0, 0, 1, 5
"d:\IDEWORK\lvmen\src\licensedcode\data\rules\generic-cla_and_mit_1.yml", "YAML", 0, 0, 0, 3, 0, 0, 1, 4
"d:\IDEWORK\lvmen\src\licensedcode\data\rules\generic-cla_and_mit_2.yml", "YAML", 0, 0, 0, 3, 0, 0, 1, 4
"d:\IDEWORK\lvmen\src\licensedcode\data\rules\generic-cla_and_mit_3.yml", "YAML", 0, 0, 0, 3, 0, 0, 1, 4
"d:\IDEWORK\lvmen\src\licensedcode\data\rules\generic-cla_and_public-domain_1.yml", "YAML", 0, 0, 0, 3, 0, 0, 1, 4
"d:\IDEWORK\lvmen\src\licensedcode\data\rules\generic-cla_or_hdf5_1.yml", "YAML", 0, 0, 0, 4, 0, 0, 1, 5
"d:\IDEWORK\lvmen\src\licensedcode\data\rules\generic-exception_1.yml", "YAML", 0, 0, 0, 5, 0, 0, 1, 6
"d:\IDEWORK\lvmen\src\licensedcode\data\rules\generic-exception_10.yml", "YAML", 0, 0, 0, 5, 0, 0, 1, 6
"d:\IDEWORK\lvmen\src\licensedcode\data\rules\generic-exception_11.yml", "YAML", 0, 0, 0, 5, 0, 0, 1, 6
"d:\IDEWORK\lvmen\src\licensedcode\data\rules\generic-exception_12.yml", "YAML", 0, 0, 0, 5, 0, 0, 1, 6
"d:\IDEWORK\lvmen\src\licensedcode\data\rules\generic-exception_13.yml", "YAML", 0, 0, 0, 5, 0, 0, 1, 6
"d:\IDEWORK\lvmen\src\licensedcode\data\rules\generic-exception_14.yml", "YAML", 0, 0, 0, 5, 0, 0, 1, 6
"d:\IDEWORK\lvmen\src\licensedcode\data\rules\generic-exception_15.yml", "YAML", 0, 0, 0, 5, 0, 0, 1, 6
"d:\IDEWORK\lvmen\src\licensedcode\data\rules\generic-exception_16.yml", "YAML", 0, 0, 0, 5, 0, 0, 1, 6
"d:\IDEWORK\lvmen\src\licensedcode\data\rules\generic-exception_17.yml", "YAML", 0, 0, 0, 5, 0, 0, 1, 6
"d:\IDEWORK\lvmen\src\licensedcode\data\rules\generic-exception_18.yml", "YAML", 0, 0, 0, 5, 0, 0, 1, 6
"d:\IDEWORK\lvmen\src\licensedcode\data\rules\generic-exception_2.yml", "YAML", 0, 0, 0, 5, 0, 0, 1, 6
"d:\IDEWORK\lvmen\src\licensedcode\data\rules\generic-exception_3.yml", "YAML", 0, 0, 0, 5, 0, 0, 1, 6
"d:\IDEWORK\lvmen\src\licensedcode\data\rules\generic-exception_4.yml", "YAML", 0, 0, 0, 5, 0, 0, 1, 6
"d:\IDEWORK\lvmen\src\licensedcode\data\rules\generic-exception_5.yml", "YAML", 0, 0, 0, 5, 0, 0, 1, 6
"d:\IDEWORK\lvmen\src\licensedcode\data\rules\generic-exception_6.yml", "YAML", 0, 0, 0, 5, 0, 0, 1, 6
"d:\IDEWORK\lvmen\src\licensedcode\data\rules\generic-exception_7.yml", "YAML", 0, 0, 0, 5, 0, 0, 1, 6
"d:\IDEWORK\lvmen\src\licensedcode\data\rules\generic-exception_8.yml", "YAML", 0, 0, 0, 5, 0, 0, 1, 6
"d:\IDEWORK\lvmen\src\licensedcode\data\rules\generic-exception_9.yml", "YAML", 0, 0, 0, 5, 0, 0, 1, 6
"d:\IDEWORK\lvmen\src\licensedcode\data\rules\generic-export-compliance_1.yml", "YAML", 0, 0, 0, 3, 0, 0, 1, 4
"d:\IDEWORK\lvmen\src\licensedcode\data\rules\generic-export-compliance_10.yml", "YAML", 0, 0, 0, 3, 0, 0, 1, 4
"d:\IDEWORK\lvmen\src\licensedcode\data\rules\generic-export-compliance_11.yml", "YAML", 0, 0, 0, 3, 0, 0, 1, 4
"d:\IDEWORK\lvmen\src\licensedcode\data\rules\generic-export-compliance_12.yml", "YAML", 0, 0, 0, 3, 0, 0, 1, 4
"d:\IDEWORK\lvmen\src\licensedcode\data\rules\generic-export-compliance_13.yml", "YAML", 0, 0, 0, 3, 0, 0, 1, 4
"d:\IDEWORK\lvmen\src\licensedcode\data\rules\generic-export-compliance_14.yml", "YAML", 0, 0, 0, 5, 0, 0, 1, 6
"d:\IDEWORK\lvmen\src\licensedcode\data\rules\generic-export-compliance_15.yml", "YAML", 0, 0, 0, 5, 0, 0, 1, 6
"d:\IDEWORK\lvmen\src\licensedcode\data\rules\generic-export-compliance_16.yml", "YAML", 0, 0, 0, 3, 0, 0, 1, 4
"d:\IDEWORK\lvmen\src\licensedcode\data\rules\generic-export-compliance_17.yml", "YAML", 0, 0, 0, 2, 0, 0, 1, 3
"d:\IDEWORK\lvmen\src\licensedcode\data\rules\generic-export-compliance_2.yml", "YAML", 0, 0, 0, 3, 0, 0, 1, 4
"d:\IDEWORK\lvmen\src\licensedcode\data\rules\generic-export-compliance_3.yml", "YAML", 0, 0, 0, 3, 0, 0, 1, 4
"d:\IDEWORK\lvmen\src\licensedcode\data\rules\generic-export-compliance_4.yml", "YAML", 0, 0, 0, 3, 0, 0, 1, 4
"d:\IDEWORK\lvmen\src\licensedcode\data\rules\generic-export-compliance_5.yml", "YAML", 0, 0, 0, 3, 0, 0, 1, 4
"d:\IDEWORK\lvmen\src\licensedcode\data\rules\generic-export-compliance_6.yml", "YAML", 0, 0, 0, 3, 0, 0, 1, 4
"d:\IDEWORK\lvmen\src\licensedcode\data\rules\generic-export-compliance_7.yml", "YAML", 0, 0, 0, 5, 0, 0, 1, 6
"d:\IDEWORK\lvmen\src\licensedcode\data\rules\generic-export-compliance_8.yml", "YAML", 0, 0, 0, 3, 0, 0, 1, 4
"d:\IDEWORK\lvmen\src\licensedcode\data\rules\generic-export-compliance_9.yml", "YAML", 0, 0, 0, 3, 0, 0, 1, 4
"d:\IDEWORK\lvmen\src\licensedcode\data\rules\generic-export-compliance_and_warranty-disclaimer_1.yml", "YAML", 0, 0, 0, 3, 0, 0, 1, 4
"d:\IDEWORK\lvmen\src\licensedcode\data\rules\generic-tos_1.yml", "YAML", 0, 0, 0, 5, 0, 0, 1, 6
"d:\IDEWORK\lvmen\src\licensedcode\data\rules\generic-trademark_1.yml", "YAML", 0, 0, 0, 3, 0, 0, 1, 4
"d:\IDEWORK\lvmen\src\licensedcode\data\rules\generic-trademark_2.yml", "YAML", 0, 0, 0, 4, 0, 0, 1, 5
"d:\IDEWORK\lvmen\src\licensedcode\data\rules\genivia-gsoap.yml", "YAML", 0, 0, 0, 3, 0, 0, 1, 4
"d:\IDEWORK\lvmen\src\licensedcode\data\rules\gfdl-1.1-plus.yml", "YAML", 0, 0, 0, 5, 0, 0, 1, 6
"d:\IDEWORK\lvmen\src\licensedcode\data\rules\gfdl-1.1-plus_1.yml", "YAML", 0, 0, 0, 2, 0, 0, 1, 3
"d:\IDEWORK\lvmen\src\licensedcode\data\rules\gfdl-1.1-plus_10.yml", "YAML", 0, 0, 0, 3, 0, 0, 1, 4
"d:\IDEWORK\lvmen\src\licensedcode\data\rules\gfdl-1.1-plus_11.yml", "YAML", 0, 0, 0, 2, 0, 0, 1, 3
"d:\IDEWORK\lvmen\src\licensedcode\data\rules\gfdl-1.1-plus_12.yml", "YAML", 0, 0, 0, 2, 0, 0, 1, 3
"d:\IDEWORK\lvmen\src\licensedcode\data\rules\gfdl-1.1-plus_13.yml", "YAML", 0, 0, 0, 2, 0, 0, 1, 3
"d:\IDEWORK\lvmen\src\licensedcode\data\rules\gfdl-1.1-plus_14.yml", "YAML", 0, 0, 0, 2, 0, 0, 1, 3
"d:\IDEWORK\lvmen\src\licensedcode\data\rules\gfdl-1.1-plus_15.yml", "YAML", 0, 0, 0, 2, 0, 0, 1, 3
"d:\IDEWORK\lvmen\src\licensedcode\data\rules\gfdl-1.1-plus_16.yml", "YAML", 0, 0, 0, 3, 0, 0, 1, 4
"d:\IDEWORK\lvmen\src\licensedcode\data\rules\gfdl-1.1-plus_17.yml", "YAML", 0, 0, 0, 5, 0, 0, 1, 6
"d:\IDEWORK\lvmen\src\licensedcode\data\rules\gfdl-1.1-plus_18.yml", "YAML", 0, 0, 0, 5, 0, 0, 1, 6
"d:\IDEWORK\lvmen\src\licensedcode\data\rules\gfdl-1.1-plus_19.yml", "YAML", 0, 0, 0, 2, 0, 0, 1, 3
"d:\IDEWORK\lvmen\src\licensedcode\data\rules\gfdl-1.1-plus_2.yml", "YAML", 0, 0, 0, 2, 0, 0, 1, 3
"d:\IDEWORK\lvmen\src\licensedcode\data\rules\gfdl-1.1-plus_20.yml", "YAML", 0, 0, 0, 3, 0, 0, 1, 4
"d:\IDEWORK\lvmen\src\licensedcode\data\rules\gfdl-1.1-plus_21.yml", "YAML", 0, 0, 0, 5, 0, 0, 1, 6
"d:\IDEWORK\lvmen\src\licensedcode\data\rules\gfdl-1.1-plus_22.yml", "YAML", 0, 0, 0, 3, 0, 0, 1, 4
"d:\IDEWORK\lvmen\src\licensedcode\data\rules\gfdl-1.1-plus_23.yml", "YAML", 0, 0, 0, 3, 0, 0, 1, 4
"d:\IDEWORK\lvmen\src\licensedcode\data\rules\gfdl-1.1-plus_24.yml", "YAML", 0, 0, 0, 5, 0, 0, 1, 6
"d:\IDEWORK\lvmen\src\licensedcode\data\rules\gfdl-1.1-plus_25.yml", "YAML", 0, 0, 0, 3, 0, 0, 1, 4
"d:\IDEWORK\lvmen\src\licensedcode\data\rules\gfdl-1.1-plus_26.yml", "YAML", 0, 0, 0, 3, 0, 0, 1, 4
"d:\IDEWORK\lvmen\src\licensedcode\data\rules\gfdl-1.1-plus_27.yml", "YAML", 0, 0, 0, 6, 0, 0, 1, 7
"d:\IDEWORK\lvmen\src\licensedcode\data\rules\gfdl-1.1-plus_28.yml", "YAML", 0, 0, 0, 3, 0, 0, 1, 4
"d:\IDEWORK\lvmen\src\licensedcode\data\rules\gfdl-1.1-plus_29.yml", "YAML", 0, 0, 0, 3, 0, 0, 1, 4
"d:\IDEWORK\lvmen\src\licensedcode\data\rules\gfdl-1.1-plus_3.yml", "YAML", 0, 0, 0, 5, 0, 0, 1, 6
"d:\IDEWORK\lvmen\src\licensedcode\data\rules\gfdl-1.1-plus_30.yml", "YAML", 0, 0, 0, 3, 0, 0, 1, 4
"d:\IDEWORK\lvmen\src\licensedcode\data\rules\gfdl-1.1-plus_31.yml", "YAML", 0, 0, 0, 6, 0, 0, 1, 7
"d:\IDEWORK\lvmen\src\licensedcode\data\rules\gfdl-1.1-plus_32.yml", "YAML", 0, 0, 0, 2, 0, 0, 1, 3
"d:\IDEWORK\lvmen\src\licensedcode\data\rules\gfdl-1.1-plus_33.yml", "YAML", 0, 0, 0, 5, 0, 0, 1, 6
"d:\IDEWORK\lvmen\src\licensedcode\data\rules\gfdl-1.1-plus_34.yml", "YAML", 0, 0, 0, 3, 0, 0, 1, 4
"d:\IDEWORK\lvmen\src\licensedcode\data\rules\gfdl-1.1-plus_35.yml", "YAML", 0, 0, 0, 3, 0, 0, 1, 4
"d:\IDEWORK\lvmen\src\licensedcode\data\rules\gfdl-1.1-plus_36.yml", "YAML", 0, 0, 0, 7, 0, 0, 1, 8
"d:\IDEWORK\lvmen\src\licensedcode\data\rules\gfdl-1.1-plus_37.yml", "YAML", 0, 0, 0, 5, 0, 0, 1, 6
"d:\IDEWORK\lvmen\src\licensedcode\data\rules\gfdl-1.1-plus_38.yml", "YAML", 0, 0, 0, 3, 0, 0, 1, 4
"d:\IDEWORK\lvmen\src\licensedcode\data\rules\gfdl-1.1-plus_39.yml", "YAML", 0, 0, 0, 7, 0, 0, 1, 8
"d:\IDEWORK\lvmen\src\licensedcode\data\rules\gfdl-1.1-plus_4.yml", "YAML", 0, 0, 0, 2, 0, 0, 1, 3
"d:\IDEWORK\lvmen\src\licensedcode\data\rules\gfdl-1.1-plus_5.yml", "YAML", 0, 0, 0, 2, 0, 0, 1, 3
"d:\IDEWORK\lvmen\src\licensedcode\data\rules\gfdl-1.1-plus_6.yml", "YAML", 0, 0, 0, 2, 0, 0, 1, 3
"d:\IDEWORK\lvmen\src\licensedcode\data\rules\gfdl-1.1-plus_7.yml", "YAML", 0, 0, 0, 2, 0, 0, 1, 3
"d:\IDEWORK\lvmen\src\licensedcode\data\rules\gfdl-1.1-plus_8.yml", "YAML", 0, 0, 0, 4, 0, 0, 1, 5
"d:\IDEWORK\lvmen\src\licensedcode\data\rules\gfdl-1.1-plus_9.yml", "YAML", 0, 0, 0, 2, 0, 0, 1, 3
"d:\IDEWORK\lvmen\src\licensedcode\data\rules\gfdl-1.1-plus_debian.yml", "YAML", 0, 0, 0, 3, 0, 0, 1, 4
"d:\IDEWORK\lvmen\src\licensedcode\data\rules\gfdl-1.1-plus_or_cc-by-sa-3.0_1.yml", "YAML", 0, 0, 0, 6, 0, 0, 1, 7
"d:\IDEWORK\lvmen\src\licensedcode\data\rules\gfdl-1.1-plus_or_cc-by-sa-3.0_2.yml", "YAML", 0, 0, 0, 6, 0, 0, 1, 7
"d:\IDEWORK\lvmen\src\licensedcode\data\rules\gfdl-1.1-plus_or_cc-by-sa-3.0_3.yml", "YAML", 0, 0, 0, 6, 0, 0, 1, 7
"d:\IDEWORK\lvmen\src\licensedcode\data\rules\gfdl-1.1-plus_url_1.yml", "YAML", 0, 0, 0, 5, 0, 0, 1, 6
"d:\IDEWORK\lvmen\src\licensedcode\data\rules\gfdl-1.1-plus_url_2.yml", "YAML", 0, 0, 0, 5, 0, 0, 1, 6
"d:\IDEWORK\lvmen\src\licensedcode\data\rules\gfdl-1.1_1.yml", "YAML", 0, 0, 0, 9, 0, 0, 1, 10
"d:\IDEWORK\lvmen\src\licensedcode\data\rules\gfdl-1.1_10.yml", "YAML", 0, 0, 0, 6, 0, 0, 1, 7
"d:\IDEWORK\lvmen\src\licensedcode\data\rules\gfdl-1.1_11.yml", "YAML", 0, 0, 0, 3, 0, 0, 1, 4
"d:\IDEWORK\lvmen\src\licensedcode\data\rules\gfdl-1.1_12.yml", "YAML", 0, 0, 0, 3, 0, 0, 1, 4
"d:\IDEWORK\lvmen\src\licensedcode\data\rules\gfdl-1.1_13.yml", "YAML", 0, 0, 0, 3, 0, 0, 1, 4
"d:\IDEWORK\lvmen\src\licensedcode\data\rules\gfdl-1.1_14.yml", "YAML", 0, 0, 0, 3, 0, 0, 1, 4
"d:\IDEWORK\lvmen\src\licensedcode\data\rules\gfdl-1.1_15.yml", "YAML", 0, 0, 0, 3, 0, 0, 1, 4
"d:\IDEWORK\lvmen\src\licensedcode\data\rules\gfdl-1.1_16.yml", "YAML", 0, 0, 0, 3, 0, 0, 1, 4
"d:\IDEWORK\lvmen\src\licensedcode\data\rules\gfdl-1.1_17.yml", "YAML", 0, 0, 0, 3, 0, 0, 1, 4
"d:\IDEWORK\lvmen\src\licensedcode\data\rules\gfdl-1.1_18.yml", "YAML", 0, 0, 0, 9, 0, 0, 1, 10
"d:\IDEWORK\lvmen\src\licensedcode\data\rules\gfdl-1.1_19.yml", "YAML", 0, 0, 0, 6, 0, 0, 1, 7
"d:\IDEWORK\lvmen\src\licensedcode\data\rules\gfdl-1.1_2.yml", "YAML", 0, 0, 0, 3, 0, 0, 1, 4
"d:\IDEWORK\lvmen\src\licensedcode\data\rules\gfdl-1.1_20.yml", "YAML", 0, 0, 0, 5, 0, 0, 1, 6
"d:\IDEWORK\lvmen\src\licensedcode\data\rules\gfdl-1.1_21.yml", "YAML", 0, 0, 0, 10, 0, 0, 1, 11
"d:\IDEWORK\lvmen\src\licensedcode\data\rules\gfdl-1.1_3.yml", "YAML", 0, 0, 0, 4, 0, 0, 1, 5
"d:\IDEWORK\lvmen\src\licensedcode\data\rules\gfdl-1.1_4.yml", "YAML", 0, 0, 0, 3, 0, 0, 1, 4
"d:\IDEWORK\lvmen\src\licensedcode\data\rules\gfdl-1.1_5.yml", "YAML", 0, 0, 0, 5, 0, 0, 1, 6
"d:\IDEWORK\lvmen\src\licensedcode\data\rules\gfdl-1.1_6.yml", "YAML", 0, 0, 0, 3, 0, 0, 1, 4
"d:\IDEWORK\lvmen\src\licensedcode\data\rules\gfdl-1.1_7.yml", "YAML", 0, 0, 0, 5, 0, 0, 1, 6
"d:\IDEWORK\lvmen\src\licensedcode\data\rules\gfdl-1.1_8.yml", "YAML", 0, 0, 0, 3, 0, 0, 1, 4
"d:\IDEWORK\lvmen\src\licensedcode\data\rules\gfdl-1.1_9.yml", "YAML", 0, 0, 0, 3, 0, 0, 1, 4
"d:\IDEWORK\lvmen\src\licensedcode\data\rules\gfdl-1.1_ft_no_add.yml", "YAML", 0, 0, 0, 8, 0, 0, 1, 9
"d:\IDEWORK\lvmen\src\licensedcode\data\rules\gfdl-1.1_url_1.yml", "YAML", 0, 0, 0, 5, 0, 0, 1, 6
"d:\IDEWORK\lvmen\src\licensedcode\data\rules\gfdl-1.1_url_2.yml", "YAML", 0, 0, 0, 5, 0, 0, 1, 6
"d:\IDEWORK\lvmen\src\licensedcode\data\rules\gfdl-1.1_url_glc_126.yml", "YAML", 0, 0, 0, 5, 0, 0, 1, 6
"d:\IDEWORK\lvmen\src\licensedcode\data\rules\gfdl-1.1_url_glc_127.yml", "YAML", 0, 0, 0, 5, 0, 0, 1, 6
"d:\IDEWORK\lvmen\src\licensedcode\data\rules\gfdl-1.2-plus.yml", "YAML", 0, 0, 0, 2, 0, 0, 1, 3
"d:\IDEWORK\lvmen\src\licensedcode\data\rules\gfdl-1.2-plus_1.yml", "YAML", 0, 0, 0, 2, 0, 0, 1, 3
"d:\IDEWORK\lvmen\src\licensedcode\data\rules\gfdl-1.2-plus_10.yml", "YAML", 0, 0, 0, 2, 0, 0, 1, 3
"d:\IDEWORK\lvmen\src\licensedcode\data\rules\gfdl-1.2-plus_11.yml", "YAML", 0, 0, 0, 3, 0, 0, 1, 4
"d:\IDEWORK\lvmen\src\licensedcode\data\rules\gfdl-1.2-plus_12.yml", "YAML", 0, 0, 0, 3, 0, 0, 1, 4
"d:\IDEWORK\lvmen\src\licensedcode\data\rules\gfdl-1.2-plus_13.yml", "YAML", 0, 0, 0, 2, 0, 0, 1, 3
"d:\IDEWORK\lvmen\src\licensedcode\data\rules\gfdl-1.2-plus_14.yml", "YAML", 0, 0, 0, 2, 0, 0, 1, 3
"d:\IDEWORK\lvmen\src\licensedcode\data\rules\gfdl-1.2-plus_15.yml", "YAML", 0, 0, 0, 2, 0, 0, 1, 3
"d:\IDEWORK\lvmen\src\licensedcode\data\rules\gfdl-1.2-plus_16.yml", "YAML", 0, 0, 0, 3, 0, 0, 1, 4
"d:\IDEWORK\lvmen\src\licensedcode\data\rules\gfdl-1.2-plus_17.yml", "YAML", 0, 0, 0, 3, 0, 0, 1, 4
"d:\IDEWORK\lvmen\src\licensedcode\data\rules\gfdl-1.2-plus_18.yml", "YAML", 0, 0, 0, 3, 0, 0, 1, 4
"d:\IDEWORK\lvmen\src\licensedcode\data\rules\gfdl-1.2-plus_19.yml", "YAML", 0, 0, 0, 3, 0, 0, 1, 4
"d:\IDEWORK\lvmen\src\licensedcode\data\rules\gfdl-1.2-plus_2.yml", "YAML", 0, 0, 0, 3, 0, 0, 1, 4
"d:\IDEWORK\lvmen\src\licensedcode\data\rules\gfdl-1.2-plus_20.yml", "YAML", 0, 0, 0, 3, 0, 0, 1, 4
"d:\IDEWORK\lvmen\src\licensedcode\data\rules\gfdl-1.2-plus_21.yml", "YAML", 0, 0, 0, 4, 0, 0, 1, 5
"d:\IDEWORK\lvmen\src\licensedcode\data\rules\gfdl-1.2-plus_22.yml", "YAML", 0, 0, 0, 4, 0, 0, 2, 6
"d:\IDEWORK\lvmen\src\licensedcode\data\rules\gfdl-1.2-plus_23.yml", "YAML", 0, 0, 0, 4, 0, 0, 2, 6
"d:\IDEWORK\lvmen\src\licensedcode\data\rules\gfdl-1.2-plus_24.yml", "YAML", 0, 0, 0, 5, 0, 0, 1, 6
"d:\IDEWORK\lvmen\src\licensedcode\data\rules\gfdl-1.2-plus_25.yml", "YAML", 0, 0, 0, 5, 0, 0, 1, 6
"d:\IDEWORK\lvmen\src\licensedcode\data\rules\gfdl-1.2-plus_26.yml", "YAML", 0, 0, 0, 5, 0, 0, 1, 6
"d:\IDEWORK\lvmen\src\licensedcode\data\rules\gfdl-1.2-plus_27.yml", "YAML", 0, 0, 0, 6, 0, 0, 1, 7
"d:\IDEWORK\lvmen\src\licensedcode\data\rules\gfdl-1.2-plus_28.yml", "YAML", 0, 0, 0, 5, 0, 0, 1, 6
"d:\IDEWORK\lvmen\src\licensedcode\data\rules\gfdl-1.2-plus_29.yml", "YAML", 0, 0, 0, 5, 0, 0, 1, 6
"d:\IDEWORK\lvmen\src\licensedcode\data\rules\gfdl-1.2-plus_3.yml", "YAML", 0, 0, 0, 3, 0, 0, 1, 4
"d:\IDEWORK\lvmen\src\licensedcode\data\rules\gfdl-1.2-plus_30.yml", "YAML", 0, 0, 0, 5, 0, 0, 1, 6
"d:\IDEWORK\lvmen\src\licensedcode\data\rules\gfdl-1.2-plus_4.yml", "YAML", 0, 0, 0, 4, 0, 0, 1, 5
"d:\IDEWORK\lvmen\src\licensedcode\data\rules\gfdl-1.2-plus_5.yml", "YAML", 0, 0, 0, 4, 0, 0, 1, 5
"d:\IDEWORK\lvmen\src\licensedcode\data\rules\gfdl-1.2-plus_6.yml", "YAML", 0, 0, 0, 4, 0, 0, 1, 5
"d:\IDEWORK\lvmen\src\licensedcode\data\rules\gfdl-1.2-plus_7.yml", "YAML", 0, 0, 0, 4, 0, 0, 1, 5
"d:\IDEWORK\lvmen\src\licensedcode\data\rules\gfdl-1.2-plus_8.yml", "YAML", 0, 0, 0, 4, 0, 0, 1, 5
"d:\IDEWORK\lvmen\src\licensedcode\data\rules\gfdl-1.2-plus_9.yml", "YAML", 0, 0, 0, 5, 0, 0, 1, 6
"d:\IDEWORK\lvmen\src\licensedcode\data\rules\gfdl-1.2-plus_or_gpl-2.0-plus_1.yml", "YAML", 0, 0, 0, 2, 0, 0, 1, 3
"d:\IDEWORK\lvmen\src\licensedcode\data\rules\gfdl-1.2-plus_url_1.yml", "YAML", 0, 0, 0, 5, 0, 0, 1, 6
"d:\IDEWORK\lvmen\src\licensedcode\data\rules\gfdl-1.2-plus_url_2.yml", "YAML", 0, 0, 0, 5, 0, 0, 1, 6
"d:\IDEWORK\lvmen\src\licensedcode\data\rules\gfdl-1.2_1.yml", "YAML", 0, 0, 0, 8, 0, 0, 1, 9
"d:\IDEWORK\lvmen\src\licensedcode\data\rules\gfdl-1.2_10.yml", "YAML", 0, 0, 0, 4, 0, 0, 1, 5
"d:\IDEWORK\lvmen\src\licensedcode\data\rules\gfdl-1.2_11.yml", "YAML", 0, 0, 0, 5, 0, 0, 1, 6
"d:\IDEWORK\lvmen\src\licensedcode\data\rules\gfdl-1.2_12.yml", "YAML", 0, 0, 0, 9, 0, 0, 1, 10
"d:\IDEWORK\lvmen\src\licensedcode\data\rules\gfdl-1.2_13.yml", "YAML", 0, 0, 0, 5, 0, 0, 1, 6
"d:\IDEWORK\lvmen\src\licensedcode\data\rules\gfdl-1.2_2.yml", "YAML", 0, 0, 0, 3, 0, 0, 1, 4
"d:\IDEWORK\lvmen\src\licensedcode\data\rules\gfdl-1.2_3.yml", "YAML", 0, 0, 0, 3, 0, 0, 1, 4
"d:\IDEWORK\lvmen\src\licensedcode\data\rules\gfdl-1.2_4.yml", "YAML", 0, 0, 0, 3, 0, 0, 1, 4
"d:\IDEWORK\lvmen\src\licensedcode\data\rules\gfdl-1.2_5.yml", "YAML", 0, 0, 0, 5, 0, 0, 1, 6
"d:\IDEWORK\lvmen\src\licensedcode\data\rules\gfdl-1.2_6.yml", "YAML", 0, 0, 0, 3, 0, 0, 1, 4
"d:\IDEWORK\lvmen\src\licensedcode\data\rules\gfdl-1.2_7.yml", "YAML", 0, 0, 0, 3, 0, 0, 1, 4
"d:\IDEWORK\lvmen\src\licensedcode\data\rules\gfdl-1.2_8.yml", "YAML", 0, 0, 0, 5, 0, 0, 1, 6
"d:\IDEWORK\lvmen\src\licensedcode\data\rules\gfdl-1.2_9.yml", "YAML", 0, 0, 0, 9, 0, 0, 1, 10
"d:\IDEWORK\lvmen\src\licensedcode\data\rules\gfdl-1.2_ft_no_add.yml", "YAML", 0, 0, 0, 8, 0, 0, 1, 9
"d:\IDEWORK\lvmen\src\licensedcode\data\rules\gfdl-1.2_or_gpl-2.0.yml", "YAML", 0, 0, 0, 3, 0, 0, 1, 4
"d:\IDEWORK\lvmen\src\licensedcode\data\rules\gfdl-1.2_url_1.yml", "YAML", 0, 0, 0, 5, 0, 0, 1, 6
"d:\IDEWORK\lvmen\src\licensedcode\data\rules\gfdl-1.2_url_2.yml", "YAML", 0, 0, 0, 5, 0, 0, 1, 6
"d:\IDEWORK\lvmen\src\licensedcode\data\rules\gfdl-1.3-plus.yml", "YAML", 0, 0, 0, 2, 0, 0, 1, 3
"d:\IDEWORK\lvmen\src\licensedcode\data\rules\gfdl-1.3-plus2.yml", "YAML", 0, 0, 0, 4, 0, 0, 1, 5
"d:\IDEWORK\lvmen\src\licensedcode\data\rules\gfdl-1.3-plus_1.yml", "YAML", 0, 0, 0, 3, 0, 0, 1, 4
"d:\IDEWORK\lvmen\src\licensedcode\data\rules\gfdl-1.3-plus_10.yml", "YAML", 0, 0, 0, 3, 0, 0, 1, 4
"d:\IDEWORK\lvmen\src\licensedcode\data\rules\gfdl-1.3-plus_11.yml", "YAML", 0, 0, 0, 3, 0, 0, 1, 4
"d:\IDEWORK\lvmen\src\licensedcode\data\rules\gfdl-1.3-plus_12.yml", "YAML", 0, 0, 0, 3, 0, 0, 1, 4
"d:\IDEWORK\lvmen\src\licensedcode\data\rules\gfdl-1.3-plus_13.yml", "YAML", 0, 0, 0, 3, 0, 0, 1, 4
"d:\IDEWORK\lvmen\src\licensedcode\data\rules\gfdl-1.3-plus_14.yml", "YAML", 0, 0, 0, 3, 0, 0, 1, 4
"d:\IDEWORK\lvmen\src\licensedcode\data\rules\gfdl-1.3-plus_15.yml", "YAML", 0, 0, 0, 3, 0, 0, 1, 4
"d:\IDEWORK\lvmen\src\licensedcode\data\rules\gfdl-1.3-plus_16.yml", "YAML", 0, 0, 0, 3, 0, 0, 1, 4
"d:\IDEWORK\lvmen\src\licensedcode\data\rules\gfdl-1.3-plus_17.yml", "YAML", 0, 0, 0, 3, 0, 0, 1, 4
"d:\IDEWORK\lvmen\src\licensedcode\data\rules\gfdl-1.3-plus_18.yml", "YAML", 0, 0, 0, 3, 0, 0, 1, 4
"d:\IDEWORK\lvmen\src\licensedcode\data\rules\gfdl-1.3-plus_19.yml", "YAML", 0, 0, 0, 4, 0, 0, 1, 5
"d:\IDEWORK\lvmen\src\licensedcode\data\rules\gfdl-1.3-plus_2.yml", "YAML", 0, 0, 0, 5, 0, 0, 1, 6
"d:\IDEWORK\lvmen\src\licensedcode\data\rules\gfdl-1.3-plus_20.yml", "YAML", 0, 0, 0, 4, 0, 0, 2, 6
"d:\IDEWORK\lvmen\src\licensedcode\data\rules\gfdl-1.3-plus_21.yml", "YAML", 0, 0, 0, 3, 0, 0, 1, 4
"d:\IDEWORK\lvmen\src\licensedcode\data\rules\gfdl-1.3-plus_22.yml", "YAML", 0, 0, 0, 2, 0, 0, 1, 3
"d:\IDEWORK\lvmen\src\licensedcode\data\rules\gfdl-1.3-plus_23.yml", "YAML", 0, 0, 0, 5, 0, 0, 1, 6
"d:\IDEWORK\lvmen\src\licensedcode\data\rules\gfdl-1.3-plus_24.yml", "YAML", 0, 0, 0, 4, 0, 0, 1, 5
"d:\IDEWORK\lvmen\src\licensedcode\data\rules\gfdl-1.3-plus_25.yml", "YAML", 0, 0, 0, 4, 0, 0, 1, 5
"d:\IDEWORK\lvmen\src\licensedcode\data\rules\gfdl-1.3-plus_26.yml", "YAML", 0, 0, 0, 5, 0, 0, 1, 6
"d:\IDEWORK\lvmen\src\licensedcode\data\rules\gfdl-1.3-plus_3.yml", "YAML", 0, 0, 0, 5, 0, 0, 1, 6
"d:\IDEWORK\lvmen\src\licensedcode\data\rules\gfdl-1.3-plus_4.yml", "YAML", 0, 0, 0, 3, 0, 0, 1, 4
"d:\IDEWORK\lvmen\src\licensedcode\data\rules\gfdl-1.3-plus_5.yml", "YAML", 0, 0, 0, 3, 0, 0, 1, 4
"d:\IDEWORK\lvmen\src\licensedcode\data\rules\gfdl-1.3-plus_6.yml", "YAML", 0, 0, 0, 5, 0, 0, 1, 6
"d:\IDEWORK\lvmen\src\licensedcode\data\rules\gfdl-1.3-plus_7.yml", "YAML", 0, 0, 0, 3, 0, 0, 1, 4
"d:\IDEWORK\lvmen\src\licensedcode\data\rules\gfdl-1.3-plus_8.yml", "YAML", 0, 0, 0, 3, 0, 0, 1, 4
"d:\IDEWORK\lvmen\src\licensedcode\data\rules\gfdl-1.3-plus_9.yml", "YAML", 0, 0, 0, 3, 0, 0, 1, 4
"d:\IDEWORK\lvmen\src\licensedcode\data\rules\gfdl-1.3-plus_url_1.yml", "YAML", 0, 0, 0, 5, 0, 0, 1, 6
"d:\IDEWORK\lvmen\src\licensedcode\data\rules\gfdl-1.3-plus_url_2.yml", "YAML", 0, 0, 0, 5, 0, 0, 1, 6
"d:\IDEWORK\lvmen\src\licensedcode\data\rules\gfdl-1.3_1.yml", "YAML", 0, 0, 0, 5, 0, 0, 1, 6
"d:\IDEWORK\lvmen\src\licensedcode\data\rules\gfdl-1.3_10.yml", "YAML", 0, 0, 0, 10, 0, 0, 1, 11
"d:\IDEWORK\lvmen\src\licensedcode\data\rules\gfdl-1.3_11.yml", "YAML", 0, 0, 0, 5, 0, 0, 1, 6
"d:\IDEWORK\lvmen\src\licensedcode\data\rules\gfdl-1.3_12.yml", "YAML", 0, 0, 0, 5, 0, 0, 1, 6
"d:\IDEWORK\lvmen\src\licensedcode\data\rules\gfdl-1.3_2.yml", "YAML", 0, 0, 0, 3, 0, 0, 1, 4
"d:\IDEWORK\lvmen\src\licensedcode\data\rules\gfdl-1.3_3.yml", "YAML", 0, 0, 0, 3, 0, 0, 1, 4
"d:\IDEWORK\lvmen\src\licensedcode\data\rules\gfdl-1.3_4.yml", "YAML", 0, 0, 0, 3, 0, 0, 1, 4
"d:\IDEWORK\lvmen\src\licensedcode\data\rules\gfdl-1.3_5.yml", "YAML", 0, 0, 0, 3, 0, 0, 1, 4
"d:\IDEWORK\lvmen\src\licensedcode\data\rules\gfdl-1.3_6.yml", "YAML", 0, 0, 0, 3, 0, 0, 1, 4
"d:\IDEWORK\lvmen\src\licensedcode\data\rules\gfdl-1.3_7.yml", "YAML", 0, 0, 0, 5, 0, 0, 1, 6
"d:\IDEWORK\lvmen\src\licensedcode\data\rules\gfdl-1.3_8.yml", "YAML", 0, 0, 0, 3, 0, 0, 1, 4
"d:\IDEWORK\lvmen\src\licensedcode\data\rules\gfdl-1.3_9.yml", "YAML", 0, 0, 0, 5, 0, 0, 1, 6
"d:\IDEWORK\lvmen\src\licensedcode\data\rules\gfdl-1.3_ft_no_add.yml", "YAML", 0, 0, 0, 9, 0, 0, 1, 10
"d:\IDEWORK\lvmen\src\licensedcode\data\rules\gfdl-1.3_qt.yml", "YAML", 0, 0, 0, 4, 0, 0, 1, 5
"d:\IDEWORK\lvmen\src\licensedcode\data\rules\gfdl-1.3_url_1.yml", "YAML", 0, 0, 0, 5, 0, 0, 1, 6
"d:\IDEWORK\lvmen\src\licensedcode\data\rules\gfdl-1.3_url_2.yml", "YAML", 0, 0, 0, 5, 0, 0, 1, 6
"d:\IDEWORK\lvmen\src\licensedcode\data\rules\gfdl-1.3_url_badge.yml", "YAML", 0, 0, 0, 5, 0, 0, 1, 6
"d:\IDEWORK\lvmen\src\licensedcode\data\rules\gfdl-1.3_url_glc_121.yml", "YAML", 0, 0, 0, 5, 0, 0, 1, 6
"d:\IDEWORK\lvmen\src\licensedcode\data\rules\ghostscript-1988_1.yml", "YAML", 0, 0, 0, 8, 0, 0, 1, 9
"d:\IDEWORK\lvmen\src\licensedcode\data\rules\ghostscript-1988_2.yml", "YAML", 0, 0, 0, 5, 0, 0, 1, 6
"d:\IDEWORK\lvmen\src\licensedcode\data\rules\ghostscript-1988_3.yml", "YAML", 0, 0, 0, 3, 0, 0, 1, 4
"d:\IDEWORK\lvmen\src\licensedcode\data\rules\ghostscript-1988_4.yml", "YAML", 0, 0, 0, 4, 0, 0, 1, 5
"d:\IDEWORK\lvmen\src\licensedcode\data\rules\gl2ps_1.yml", "YAML", 0, 0, 0, 6, 0, 0, 1, 7
"d:\IDEWORK\lvmen\src\licensedcode\data\rules\gl2ps_url_1.yml", "YAML", 0, 0, 0, 5, 0, 0, 1, 6
"d:\IDEWORK\lvmen\src\licensedcode\data\rules\gl2ps_url_2.yml", "YAML", 0, 0, 0, 5, 0, 0, 1, 6
"d:\IDEWORK\lvmen\src\licensedcode\data\rules\glibc-exception-2.0_1.yml", "YAML", 0, 0, 0, 4, 0, 0, 1, 5
"d:\IDEWORK\lvmen\src\licensedcode\data\rules\glibc-exception-2.0_2.yml", "YAML", 0, 0, 0, 4, 0, 0, 1, 5
"d:\IDEWORK\lvmen\src\licensedcode\data\rules\glibc-exception-2.0_3.yml", "YAML", 0, 0, 0, 4, 0, 0, 1, 5
"d:\IDEWORK\lvmen\src\licensedcode\data\rules\glide.yml", "YAML", 0, 0, 0, 5, 0, 0, 1, 6
"d:\IDEWORK\lvmen\src\licensedcode\data\rules\glide2.yml", "YAML", 0, 0, 0, 3, 0, 0, 1, 4
"d:\IDEWORK\lvmen\src\licensedcode\data\rules\glide3.yml", "YAML", 0, 0, 0, 3, 0, 0, 1, 4
"d:\IDEWORK\lvmen\src\licensedcode\data\rules\glide_url_1.yml", "YAML", 0, 0, 0, 5, 0, 0, 1, 6
"d:\IDEWORK\lvmen\src\licensedcode\data\rules\glide_url_2.yml", "YAML", 0, 0, 0, 5, 0, 0, 1, 6
"d:\IDEWORK\lvmen\src\licensedcode\data\rules\glulxe_url_1.yml", "YAML", 0, 0, 0, 5, 0, 0, 1, 6
"d:\IDEWORK\lvmen\src\licensedcode\data\rules\glulxe_url_2.yml", "YAML", 0, 0, 0, 5, 0, 0, 1, 6
"d:\IDEWORK\lvmen\src\licensedcode\data\rules\gnu-emacs-gpl-1988_1.yml", "YAML", 0, 0, 0, 2, 0, 0, 1, 3
"d:\IDEWORK\lvmen\src\licensedcode\data\rules\gnu-javamail-exception_url_1.yml", "YAML", 0, 0, 0, 5, 0, 0, 1, 6
"d:\IDEWORK\lvmen\src\licensedcode\data\rules\gnu-javamail-exception_url_2.yml", "YAML", 0, 0, 0, 5, 0, 0, 1, 6
"d:\IDEWORK\lvmen\src\licensedcode\data\rules\gnuplot_url_1.yml", "YAML", 0, 0, 0, 5, 0, 0, 1, 6
"d:\IDEWORK\lvmen\src\licensedcode\data\rules\gnuplot_url_2.yml", "YAML", 0, 0, 0, 5, 0, 0, 1, 6
"d:\IDEWORK\lvmen\src\licensedcode\data\rules\google-analytics-tos.yml", "YAML", 0, 0, 0, 7, 0, 0, 1, 8
"d:\IDEWORK\lvmen\src\licensedcode\data\rules\google-analytics-tos_1.yml", "YAML", 0, 0, 0, 7, 0, 0, 1, 8
"d:\IDEWORK\lvmen\src\licensedcode\data\rules\google-patent-license-golang_1.yml", "YAML", 0, 0, 0, 4, 0, 0, 1, 5
"d:\IDEWORK\lvmen\src\licensedcode\data\rules\google-patent-license-golang_2.yml", "YAML", 0, 0, 0, 3, 0, 0, 1, 4
"d:\IDEWORK\lvmen\src\licensedcode\data\rules\google-patent-license-golang_3.yml", "YAML", 0, 0, 0, 3, 0, 0, 1, 4
"d:\IDEWORK\lvmen\src\licensedcode\data\rules\google-patent-license-webm_1.yml", "YAML", 0, 0, 0, 2, 0, 0, 1, 3
"d:\IDEWORK\lvmen\src\licensedcode\data\rules\google-patent-license-webm_3.yml", "YAML", 0, 0, 0, 5, 0, 0, 1, 6
"d:\IDEWORK\lvmen\src\licensedcode\data\rules\gpl-1.0-plus.yml", "YAML", 0, 0, 0, 2, 0, 0, 1, 3
"d:\IDEWORK\lvmen\src\licensedcode\data\rules\gpl-1.0-plus_1.yml", "YAML", 0, 0, 0, 2, 0, 0, 1, 3
"d:\IDEWORK\lvmen\src\licensedcode\data\rules\gpl-1.0-plus_10.yml", "YAML", 0, 0, 0, 2, 0, 0, 1, 3
"d:\IDEWORK\lvmen\src\licensedcode\data\rules\gpl-1.0-plus_100.yml", "YAML", 0, 0, 0, 3, 0, 0, 1, 4
"d:\IDEWORK\lvmen\src\licensedcode\data\rules\gpl-1.0-plus_101.yml", "YAML", 0, 0, 0, 3, 0, 0, 1, 4
"d:\IDEWORK\lvmen\src\licensedcode\data\rules\gpl-1.0-plus_102.yml", "YAML", 0, 0, 0, 3, 0, 0, 1, 4
"d:\IDEWORK\lvmen\src\licensedcode\data\rules\gpl-1.0-plus_103.yml", "YAML", 0, 0, 0, 3, 0, 0, 1, 4
"d:\IDEWORK\lvmen\src\licensedcode\data\rules\gpl-1.0-plus_104.yml", "YAML", 0, 0, 0, 3, 0, 0, 1, 4
"d:\IDEWORK\lvmen\src\licensedcode\data\rules\gpl-1.0-plus_105.yml", "YAML", 0, 0, 0, 3, 0, 0, 1, 4
"d:\IDEWORK\lvmen\src\licensedcode\data\rules\gpl-1.0-plus_106.yml", "YAML", 0, 0, 0, 3, 0, 0, 1, 4
"d:\IDEWORK\lvmen\src\licensedcode\data\rules\gpl-1.0-plus_107.yml", "YAML", 0, 0, 0, 3, 0, 0, 1, 4
"d:\IDEWORK\lvmen\src\licensedcode\data\rules\gpl-1.0-plus_108.yml", "YAML", 0, 0, 0, 3, 0, 0, 1, 4
"d:\IDEWORK\lvmen\src\licensedcode\data\rules\gpl-1.0-plus_109.yml", "YAML", 0, 0, 0, 3, 0, 0, 1, 4
"d:\IDEWORK\lvmen\src\licensedcode\data\rules\gpl-1.0-plus_11.yml", "YAML", 0, 0, 0, 3, 0, 0, 1, 4
"d:\IDEWORK\lvmen\src\licensedcode\data\rules\gpl-1.0-plus_110.yml", "YAML", 0, 0, 0, 3, 0, 0, 1, 4
"d:\IDEWORK\lvmen\src\licensedcode\data\rules\gpl-1.0-plus_111.yml", "YAML", 0, 0, 0, 3, 0, 0, 1, 4
"d:\IDEWORK\lvmen\src\licensedcode\data\rules\gpl-1.0-plus_112.yml", "YAML", 0, 0, 0, 5, 0, 0, 1, 6
"d:\IDEWORK\lvmen\src\licensedcode\data\rules\gpl-1.0-plus_113.yml", "YAML", 0, 0, 0, 5, 0, 0, 1, 6
"d:\IDEWORK\lvmen\src\licensedcode\data\rules\gpl-1.0-plus_114.yml", "YAML", 0, 0, 0, 7, 0, 0, 1, 8
"d:\IDEWORK\lvmen\src\licensedcode\data\rules\gpl-1.0-plus_115.yml", "YAML", 0, 0, 0, 7, 0, 0, 1, 8
"d:\IDEWORK\lvmen\src\licensedcode\data\rules\gpl-1.0-plus_116.yml", "YAML", 0, 0, 0, 7, 0, 0, 1, 8
"d:\IDEWORK\lvmen\src\licensedcode\data\rules\gpl-1.0-plus_117.yml", "YAML", 0, 0, 0, 3, 0, 0, 1, 4
"d:\IDEWORK\lvmen\src\licensedcode\data\rules\gpl-1.0-plus_118.yml", "YAML", 0, 0, 0, 9, 0, 0, 1, 10
"d:\IDEWORK\lvmen\src\licensedcode\data\rules\gpl-1.0-plus_119.yml", "YAML", 0, 0, 0, 9, 0, 0, 1, 10
"d:\IDEWORK\lvmen\src\licensedcode\data\rules\gpl-1.0-plus_12.yml", "YAML", 0, 0, 0, 3, 0, 0, 1, 4
"d:\IDEWORK\lvmen\src\licensedcode\data\rules\gpl-1.0-plus_120.yml", "YAML", 0, 0, 0, 7, 0, 0, 1, 8
"d:\IDEWORK\lvmen\src\licensedcode\data\rules\gpl-1.0-plus_121.yml", "YAML", 0, 0, 0, 7, 0, 0, 1, 8
"d:\IDEWORK\lvmen\src\licensedcode\data\rules\gpl-1.0-plus_122.yml", "YAML", 0, 0, 0, 3, 0, 0, 1, 4
"d:\IDEWORK\lvmen\src\licensedcode\data\rules\gpl-1.0-plus_123.yml", "YAML", 0, 0, 0, 3, 0, 0, 1, 4
"d:\IDEWORK\lvmen\src\licensedcode\data\rules\gpl-1.0-plus_124.yml", "YAML", 0, 0, 0, 3, 0, 0, 1, 4
"d:\IDEWORK\lvmen\src\licensedcode\data\rules\gpl-1.0-plus_125.yml", "YAML", 0, 0, 0, 3, 0, 0, 1, 4
"d:\IDEWORK\lvmen\src\licensedcode\data\rules\gpl-1.0-plus_126.yml", "YAML", 0, 0, 0, 3, 0, 0, 1, 4
"d:\IDEWORK\lvmen\src\licensedcode\data\rules\gpl-1.0-plus_127.yml", "YAML", 0, 0, 0, 3, 0, 0, 1, 4
"d:\IDEWORK\lvmen\src\licensedcode\data\rules\gpl-1.0-plus_128.yml", "YAML", 0, 0, 0, 7, 0, 0, 1, 8
"d:\IDEWORK\lvmen\src\licensedcode\data\rules\gpl-1.0-plus_129.yml", "YAML", 0, 0, 0, 7, 0, 0, 1, 8
"d:\IDEWORK\lvmen\src\licensedcode\data\rules\gpl-1.0-plus_13.yml", "YAML", 0, 0, 0, 2, 0, 0, 1, 3
"d:\IDEWORK\lvmen\src\licensedcode\data\rules\gpl-1.0-plus_130.yml", "YAML", 0, 0, 0, 9, 0, 0, 1, 10
"d:\IDEWORK\lvmen\src\licensedcode\data\rules\gpl-1.0-plus_131.yml", "YAML", 0, 0, 0, 2, 0, 0, 1, 3
"d:\IDEWORK\lvmen\src\licensedcode\data\rules\gpl-1.0-plus_132.yml", "YAML", 0, 0, 0, 2, 0, 0, 1, 3
"d:\IDEWORK\lvmen\src\licensedcode\data\rules\gpl-1.0-plus_133.yml", "YAML", 0, 0, 0, 9, 0, 0, 1, 10
"d:\IDEWORK\lvmen\src\licensedcode\data\rules\gpl-1.0-plus_134.yml", "YAML", 0, 0, 0, 2, 0, 0, 1, 3
"d:\IDEWORK\lvmen\src\licensedcode\data\rules\gpl-1.0-plus_135.yml", "YAML", 0, 0, 0, 3, 0, 0, 1, 4
"d:\IDEWORK\lvmen\src\licensedcode\data\rules\gpl-1.0-plus_136.yml", "YAML", 0, 0, 0, 5, 0, 0, 1, 6
"d:\IDEWORK\lvmen\src\licensedcode\data\rules\gpl-1.0-plus_137.yml", "YAML", 0, 0, 0, 5, 0, 0, 1, 6
"d:\IDEWORK\lvmen\src\licensedcode\data\rules\gpl-1.0-plus_138.yml", "YAML", 0, 0, 0, 3, 0, 0, 1, 4
"d:\IDEWORK\lvmen\src\licensedcode\data\rules\gpl-1.0-plus_139.yml", "YAML", 0, 0, 0, 5, 0, 0, 1, 6
"d:\IDEWORK\lvmen\src\licensedcode\data\rules\gpl-1.0-plus_14.yml", "YAML", 0, 0, 0, 3, 0, 0, 1, 4
"d:\IDEWORK\lvmen\src\licensedcode\data\rules\gpl-1.0-plus_140.yml", "YAML", 0, 0, 0, 3, 0, 0, 1, 4
"d:\IDEWORK\lvmen\src\licensedcode\data\rules\gpl-1.0-plus_141.yml", "YAML", 0, 0, 0, 3, 0, 0, 1, 4
"d:\IDEWORK\lvmen\src\licensedcode\data\rules\gpl-1.0-plus_142.yml", "YAML", 0, 0, 0, 3, 0, 0, 1, 4
"d:\IDEWORK\lvmen\src\licensedcode\data\rules\gpl-1.0-plus_143.yml", "YAML", 0, 0, 0, 5, 0, 0, 1, 6
"d:\IDEWORK\lvmen\src\licensedcode\data\rules\gpl-1.0-plus_144.yml", "YAML", 0, 0, 0, 3, 0, 0, 1, 4
"d:\IDEWORK\lvmen\src\licensedcode\data\rules\gpl-1.0-plus_145.yml", "YAML", 0, 0, 0, 3, 0, 0, 1, 4
"d:\IDEWORK\lvmen\src\licensedcode\data\rules\gpl-1.0-plus_146.yml", "YAML", 0, 0, 0, 3, 0, 0, 1, 4
"d:\IDEWORK\lvmen\src\licensedcode\data\rules\gpl-1.0-plus_147.yml", "YAML", 0, 0, 0, 3, 0, 0, 1, 4
"d:\IDEWORK\lvmen\src\licensedcode\data\rules\gpl-1.0-plus_148.yml", "YAML", 0, 0, 0, 3, 0, 0, 1, 4
"d:\IDEWORK\lvmen\src\licensedcode\data\rules\gpl-1.0-plus_149.yml", "YAML", 0, 0, 0, 3, 0, 0, 1, 4
"d:\IDEWORK\lvmen\src\licensedcode\data\rules\gpl-1.0-plus_15.yml", "YAML", 0, 0, 0, 3, 0, 0, 1, 4
"d:\IDEWORK\lvmen\src\licensedcode\data\rules\gpl-1.0-plus_150.yml", "YAML", 0, 0, 0, 7, 0, 0, 1, 8
"d:\IDEWORK\lvmen\src\licensedcode\data\rules\gpl-1.0-plus_151.yml", "YAML", 0, 0, 0, 5, 0, 0, 1, 6
"d:\IDEWORK\lvmen\src\licensedcode\data\rules\gpl-1.0-plus_152.yml", "YAML", 0, 0, 0, 5, 0, 0, 1, 6
"d:\IDEWORK\lvmen\src\licensedcode\data\rules\gpl-1.0-plus_153.yml", "YAML", 0, 0, 0, 3, 0, 0, 1, 4
"d:\IDEWORK\lvmen\src\licensedcode\data\rules\gpl-1.0-plus_154.yml", "YAML", 0, 0, 0, 3, 0, 0, 1, 4
"d:\IDEWORK\lvmen\src\licensedcode\data\rules\gpl-1.0-plus_155.yml", "YAML", 0, 0, 0, 5, 0, 0, 1, 6
"d:\IDEWORK\lvmen\src\licensedcode\data\rules\gpl-1.0-plus_156.yml", "YAML", 0, 0, 0, 5, 0, 0, 1, 6
"d:\IDEWORK\lvmen\src\licensedcode\data\rules\gpl-1.0-plus_157.yml", "YAML", 0, 0, 0, 5, 0, 0, 1, 6
"d:\IDEWORK\lvmen\src\licensedcode\data\rules\gpl-1.0-plus_158.yml", "YAML", 0, 0, 0, 2, 0, 0, 1, 3
"d:\IDEWORK\lvmen\src\licensedcode\data\rules\gpl-1.0-plus_159.yml", "YAML", 0, 0, 0, 5, 0, 0, 1, 6
"d:\IDEWORK\lvmen\src\licensedcode\data\rules\gpl-1.0-plus_16.yml", "YAML", 0, 0, 0, 3, 0, 0, 1, 4
"d:\IDEWORK\lvmen\src\licensedcode\data\rules\gpl-1.0-plus_160.yml", "YAML", 0, 0, 0, 5, 0, 0, 1, 6
"d:\IDEWORK\lvmen\src\licensedcode\data\rules\gpl-1.0-plus_161.yml", "YAML", 0, 0, 0, 5, 0, 0, 1, 6
"d:\IDEWORK\lvmen\src\licensedcode\data\rules\gpl-1.0-plus_162.yml", "YAML", 0, 0, 0, 5, 0, 0, 1, 6
"d:\IDEWORK\lvmen\src\licensedcode\data\rules\gpl-1.0-plus_163.yml", "YAML", 0, 0, 0, 5, 0, 0, 1, 6
"d:\IDEWORK\lvmen\src\licensedcode\data\rules\gpl-1.0-plus_164.yml", "YAML", 0, 0, 0, 5, 0, 0, 1, 6
"d:\IDEWORK\lvmen\src\licensedcode\data\rules\gpl-1.0-plus_165.yml", "YAML", 0, 0, 0, 5, 0, 0, 1, 6
"d:\IDEWORK\lvmen\src\licensedcode\data\rules\gpl-1.0-plus_166.yml", "YAML", 0, 0, 0, 5, 0, 0, 1, 6
"d:\IDEWORK\lvmen\src\licensedcode\data\rules\gpl-1.0-plus_167.yml", "YAML", 0, 0, 0, 3, 0, 0, 1, 4
"d:\IDEWORK\lvmen\src\licensedcode\data\rules\gpl-1.0-plus_168.yml", "YAML", 0, 0, 0, 5, 0, 0, 1, 6
"d:\IDEWORK\lvmen\src\licensedcode\data\rules\gpl-1.0-plus_169.yml", "YAML", 0, 0, 0, 3, 0, 0, 1, 4
"d:\IDEWORK\lvmen\src\licensedcode\data\rules\gpl-1.0-plus_17.yml", "YAML", 0, 0, 0, 3, 0, 0, 1, 4
"d:\IDEWORK\lvmen\src\licensedcode\data\rules\gpl-1.0-plus_170.yml", "YAML", 0, 0, 0, 5, 0, 0, 1, 6
"d:\IDEWORK\lvmen\src\licensedcode\data\rules\gpl-1.0-plus_171.yml", "YAML", 0, 0, 0, 3, 0, 0, 1, 4
"d:\IDEWORK\lvmen\src\licensedcode\data\rules\gpl-1.0-plus_172.yml", "YAML", 0, 0, 0, 6, 0, 0, 1, 7
"d:\IDEWORK\lvmen\src\licensedcode\data\rules\gpl-1.0-plus_173.yml", "YAML", 0, 0, 0, 3, 0, 0, 1, 4
"d:\IDEWORK\lvmen\src\licensedcode\data\rules\gpl-1.0-plus_174.yml", "YAML", 0, 0, 0, 4, 0, 0, 1, 5
"d:\IDEWORK\lvmen\src\licensedcode\data\rules\gpl-1.0-plus_175.yml", "YAML", 0, 0, 0, 4, 0, 0, 1, 5
"d:\IDEWORK\lvmen\src\licensedcode\data\rules\gpl-1.0-plus_176.yml", "YAML", 0, 0, 0, 5, 0, 0, 1, 6
"d:\IDEWORK\lvmen\src\licensedcode\data\rules\gpl-1.0-plus_177.yml", "YAML", 0, 0, 0, 5, 0, 0, 1, 6
"d:\IDEWORK\lvmen\src\licensedcode\data\rules\gpl-1.0-plus_178.yml", "YAML", 0, 0, 0, 3, 0, 0, 1, 4
"d:\IDEWORK\lvmen\src\licensedcode\data\rules\gpl-1.0-plus_179.yml", "YAML", 0, 0, 0, 3, 0, 0, 1, 4
"d:\IDEWORK\lvmen\src\licensedcode\data\rules\gpl-1.0-plus_18.yml", "YAML", 0, 0, 0, 2, 0, 0, 1, 3
"d:\IDEWORK\lvmen\src\licensedcode\data\rules\gpl-1.0-plus_180.yml", "YAML", 0, 0, 0, 6, 0, 0, 1, 7
"d:\IDEWORK\lvmen\src\licensedcode\data\rules\gpl-1.0-plus_181.yml", "YAML", 0, 0, 0, 5, 0, 0, 1, 6
"d:\IDEWORK\lvmen\src\licensedcode\data\rules\gpl-1.0-plus_182.yml", "YAML", 0, 0, 0, 3, 0, 0, 1, 4
"d:\IDEWORK\lvmen\src\licensedcode\data\rules\gpl-1.0-plus_183.yml", "YAML", 0, 0, 0, 3, 0, 0, 1, 4
"d:\IDEWORK\lvmen\src\licensedcode\data\rules\gpl-1.0-plus_184.yml", "YAML", 0, 0, 0, 3, 0, 0, 1, 4
"d:\IDEWORK\lvmen\src\licensedcode\data\rules\gpl-1.0-plus_185.yml", "YAML", 0, 0, 0, 3, 0, 0, 1, 4
"d:\IDEWORK\lvmen\src\licensedcode\data\rules\gpl-1.0-plus_186.yml", "YAML", 0, 0, 0, 5, 0, 0, 1, 6
"d:\IDEWORK\lvmen\src\licensedcode\data\rules\gpl-1.0-plus_187.yml", "YAML", 0, 0, 0, 3, 0, 0, 1, 4
"d:\IDEWORK\lvmen\src\licensedcode\data\rules\gpl-1.0-plus_188.yml", "YAML", 0, 0, 0, 3, 0, 0, 1, 4
"d:\IDEWORK\lvmen\src\licensedcode\data\rules\gpl-1.0-plus_189.yml", "YAML", 0, 0, 0, 5, 0, 0, 1, 6
"d:\IDEWORK\lvmen\src\licensedcode\data\rules\gpl-1.0-plus_19.yml", "YAML", 0, 0, 0, 2, 0, 0, 1, 3
"d:\IDEWORK\lvmen\src\licensedcode\data\rules\gpl-1.0-plus_190.yml", "YAML", 0, 0, 0, 5, 0, 0, 1, 6
"d:\IDEWORK\lvmen\src\licensedcode\data\rules\gpl-1.0-plus_191.yml", "YAML", 0, 0, 0, 5, 0, 0, 1, 6
"d:\IDEWORK\lvmen\src\licensedcode\data\rules\gpl-1.0-plus_192.yml", "YAML", 0, 0, 0, 3, 0, 0, 1, 4
"d:\IDEWORK\lvmen\src\licensedcode\data\rules\gpl-1.0-plus_193.yml", "YAML", 0, 0, 0, 3, 0, 0, 1, 4
"d:\IDEWORK\lvmen\src\licensedcode\data\rules\gpl-1.0-plus_194.yml", "YAML", 0, 0, 0, 3, 0, 0, 1, 4
"d:\IDEWORK\lvmen\src\licensedcode\data\rules\gpl-1.0-plus_195.yml", "YAML", 0, 0, 0, 3, 0, 0, 1, 4
"d:\IDEWORK\lvmen\src\licensedcode\data\rules\gpl-1.0-plus_196.yml", "YAML", 0, 0, 0, 5, 0, 0, 1, 6
"d:\IDEWORK\lvmen\src\licensedcode\data\rules\gpl-1.0-plus_197.yml", "YAML", 0, 0, 0, 5, 0, 0, 1, 6
"d:\IDEWORK\lvmen\src\licensedcode\data\rules\gpl-1.0-plus_198.yml", "YAML", 0, 0, 0, 3, 0, 0, 1, 4
"d:\IDEWORK\lvmen\src\licensedcode\data\rules\gpl-1.0-plus_199.yml", "YAML", 0, 0, 0, 3, 0, 0, 1, 4
"d:\IDEWORK\lvmen\src\licensedcode\data\rules\gpl-1.0-plus_2.yml", "YAML", 0, 0, 0, 3, 0, 0, 1, 4
"d:\IDEWORK\lvmen\src\licensedcode\data\rules\gpl-1.0-plus_20.yml", "YAML", 0, 0, 0, 3, 0, 0, 1, 4
"d:\IDEWORK\lvmen\src\licensedcode\data\rules\gpl-1.0-plus_200.yml", "YAML", 0, 0, 0, 3, 0, 0, 1, 4
"d:\IDEWORK\lvmen\src\licensedcode\data\rules\gpl-1.0-plus_201.yml", "YAML", 0, 0, 0, 3, 0, 0, 1, 4
"d:\IDEWORK\lvmen\src\licensedcode\data\rules\gpl-1.0-plus_202.yml", "YAML", 0, 0, 0, 3, 0, 0, 1, 4
"d:\IDEWORK\lvmen\src\licensedcode\data\rules\gpl-1.0-plus_203.yml", "YAML", 0, 0, 0, 3, 0, 0, 1, 4
"d:\IDEWORK\lvmen\src\licensedcode\data\rules\gpl-1.0-plus_204.yml", "YAML", 0, 0, 0, 3, 0, 0, 1, 4
"d:\IDEWORK\lvmen\src\licensedcode\data\rules\gpl-1.0-plus_205.yml", "YAML", 0, 0, 0, 3, 0, 0, 1, 4
"d:\IDEWORK\lvmen\src\licensedcode\data\rules\gpl-1.0-plus_206.yml", "YAML", 0, 0, 0, 3, 0, 0, 1, 4
"d:\IDEWORK\lvmen\src\licensedcode\data\rules\gpl-1.0-plus_207.yml", "YAML", 0, 0, 0, 3, 0, 0, 1, 4
"d:\IDEWORK\lvmen\src\licensedcode\data\rules\gpl-1.0-plus_208.yml", "YAML", 0, 0, 0, 3, 0, 0, 1, 4
"d:\IDEWORK\lvmen\src\licensedcode\data\rules\gpl-1.0-plus_209.yml", "YAML", 0, 0, 0, 3, 0, 0, 1, 4
"d:\IDEWORK\lvmen\src\licensedcode\data\rules\gpl-1.0-plus_21.yml", "YAML", 0, 0, 0, 3, 0, 0, 1, 4
"d:\IDEWORK\lvmen\src\licensedcode\data\rules\gpl-1.0-plus_210.yml", "YAML", 0, 0, 0, 3, 0, 0, 1, 4
"d:\IDEWORK\lvmen\src\licensedcode\data\rules\gpl-1.0-plus_211.yml", "YAML", 0, 0, 0, 3, 0, 0, 1, 4
"d:\IDEWORK\lvmen\src\licensedcode\data\rules\gpl-1.0-plus_212.yml", "YAML", 0, 0, 0, 3, 0, 0, 1, 4
"d:\IDEWORK\lvmen\src\licensedcode\data\rules\gpl-1.0-plus_213.yml", "YAML", 0, 0, 0, 3, 0, 0, 1, 4
"d:\IDEWORK\lvmen\src\licensedcode\data\rules\gpl-1.0-plus_214.yml", "YAML", 0, 0, 0, 3, 0, 0, 1, 4
"d:\IDEWORK\lvmen\src\licensedcode\data\rules\gpl-1.0-plus_215.yml", "YAML", 0, 0, 0, 3, 0, 0, 1, 4
"d:\IDEWORK\lvmen\src\licensedcode\data\rules\gpl-1.0-plus_216.yml", "YAML", 0, 0, 0, 3, 0, 0, 1, 4
"d:\IDEWORK\lvmen\src\licensedcode\data\rules\gpl-1.0-plus_217.yml", "YAML", 0, 0, 0, 3, 0, 0, 1, 4
"d:\IDEWORK\lvmen\src\licensedcode\data\rules\gpl-1.0-plus_218.yml", "YAML", 0, 0, 0, 3, 0, 0, 1, 4
"d:\IDEWORK\lvmen\src\licensedcode\data\rules\gpl-1.0-plus_219.yml", "YAML", 0, 0, 0, 3, 0, 0, 1, 4
"d:\IDEWORK\lvmen\src\licensedcode\data\rules\gpl-1.0-plus_22.yml", "YAML", 0, 0, 0, 4, 0, 0, 1, 5
"d:\IDEWORK\lvmen\src\licensedcode\data\rules\gpl-1.0-plus_220.yml", "YAML", 0, 0, 0, 3, 0, 0, 1, 4
"d:\IDEWORK\lvmen\src\licensedcode\data\rules\gpl-1.0-plus_221.yml", "YAML", 0, 0, 0, 3, 0, 0, 1, 4
"d:\IDEWORK\lvmen\src\licensedcode\data\rules\gpl-1.0-plus_222.yml", "YAML", 0, 0, 0, 3, 0, 0, 1, 4
"d:\IDEWORK\lvmen\src\licensedcode\data\rules\gpl-1.0-plus_223.yml", "YAML", 0, 0, 0, 3, 0, 0, 1, 4
"d:\IDEWORK\lvmen\src\licensedcode\data\rules\gpl-1.0-plus_224.yml", "YAML", 0, 0, 0, 3, 0, 0, 1, 4
"d:\IDEWORK\lvmen\src\licensedcode\data\rules\gpl-1.0-plus_225.yml", "YAML", 0, 0, 0, 3, 0, 0, 1, 4
"d:\IDEWORK\lvmen\src\licensedcode\data\rules\gpl-1.0-plus_226.yml", "YAML", 0, 0, 0, 3, 0, 0, 1, 4
"d:\IDEWORK\lvmen\src\licensedcode\data\rules\gpl-1.0-plus_227.yml", "YAML", 0, 0, 0, 3, 0, 0, 1, 4
"d:\IDEWORK\lvmen\src\licensedcode\data\rules\gpl-1.0-plus_228.yml", "YAML", 0, 0, 0, 3, 0, 0, 1, 4
"d:\IDEWORK\lvmen\src\licensedcode\data\rules\gpl-1.0-plus_229.yml", "YAML", 0, 0, 0, 3, 0, 0, 1, 4
"d:\IDEWORK\lvmen\src\licensedcode\data\rules\gpl-1.0-plus_23.yml", "YAML", 0, 0, 0, 6, 0, 0, 1, 7
"d:\IDEWORK\lvmen\src\licensedcode\data\rules\gpl-1.0-plus_230.yml", "YAML", 0, 0, 0, 3, 0, 0, 1, 4
"d:\IDEWORK\lvmen\src\licensedcode\data\rules\gpl-1.0-plus_231.yml", "YAML", 0, 0, 0, 3, 0, 0, 1, 4
"d:\IDEWORK\lvmen\src\licensedcode\data\rules\gpl-1.0-plus_232.yml", "YAML", 0, 0, 0, 3, 0, 0, 1, 4
"d:\IDEWORK\lvmen\src\licensedcode\data\rules\gpl-1.0-plus_233.yml", "YAML", 0, 0, 0, 3, 0, 0, 1, 4
"d:\IDEWORK\lvmen\src\licensedcode\data\rules\gpl-1.0-plus_234.yml", "YAML", 0, 0, 0, 3, 0, 0, 1, 4
"d:\IDEWORK\lvmen\src\licensedcode\data\rules\gpl-1.0-plus_235.yml", "YAML", 0, 0, 0, 3, 0, 0, 1, 4
"d:\IDEWORK\lvmen\src\licensedcode\data\rules\gpl-1.0-plus_236.yml", "YAML", 0, 0, 0, 3, 0, 0, 1, 4
"d:\IDEWORK\lvmen\src\licensedcode\data\rules\gpl-1.0-plus_237.yml", "YAML", 0, 0, 0, 3, 0, 0, 1, 4
"d:\IDEWORK\lvmen\src\licensedcode\data\rules\gpl-1.0-plus_238.yml", "YAML", 0, 0, 0, 3, 0, 0, 1, 4
"d:\IDEWORK\lvmen\src\licensedcode\data\rules\gpl-1.0-plus_239.yml", "YAML", 0, 0, 0, 3, 0, 0, 1, 4
"d:\IDEWORK\lvmen\src\licensedcode\data\rules\gpl-1.0-plus_24.yml", "YAML", 0, 0, 0, 5, 0, 0, 1, 6
"d:\IDEWORK\lvmen\src\licensedcode\data\rules\gpl-1.0-plus_240.yml", "YAML", 0, 0, 0, 3, 0, 0, 1, 4
"d:\IDEWORK\lvmen\src\licensedcode\data\rules\gpl-1.0-plus_241.yml", "YAML", 0, 0, 0, 3, 0, 0, 1, 4
"d:\IDEWORK\lvmen\src\licensedcode\data\rules\gpl-1.0-plus_242.yml", "YAML", 0, 0, 0, 3, 0, 0, 1, 4
"d:\IDEWORK\lvmen\src\licensedcode\data\rules\gpl-1.0-plus_243.yml", "YAML", 0, 0, 0, 3, 0, 0, 1, 4
"d:\IDEWORK\lvmen\src\licensedcode\data\rules\gpl-1.0-plus_244.yml", "YAML", 0, 0, 0, 3, 0, 0, 1, 4
"d:\IDEWORK\lvmen\src\licensedcode\data\rules\gpl-1.0-plus_245.yml", "YAML", 0, 0, 0, 3, 0, 0, 1, 4
"d:\IDEWORK\lvmen\src\licensedcode\data\rules\gpl-1.0-plus_246.yml", "YAML", 0, 0, 0, 3, 0, 0, 1, 4
"d:\IDEWORK\lvmen\src\licensedcode\data\rules\gpl-1.0-plus_247.yml", "YAML", 0, 0, 0, 3, 0, 0, 1, 4
"d:\IDEWORK\lvmen\src\licensedcode\data\rules\gpl-1.0-plus_248.yml", "YAML", 0, 0, 0, 3, 0, 0, 1, 4
"d:\IDEWORK\lvmen\src\licensedcode\data\rules\gpl-1.0-plus_249.yml", "YAML", 0, 0, 0, 3, 0, 0, 1, 4
"d:\IDEWORK\lvmen\src\licensedcode\data\rules\gpl-1.0-plus_25.yml", "YAML", 0, 0, 0, 5, 0, 0, 1, 6
"d:\IDEWORK\lvmen\src\licensedcode\data\rules\gpl-1.0-plus_250.yml", "YAML", 0, 0, 0, 3, 0, 0, 1, 4
"d:\IDEWORK\lvmen\src\licensedcode\data\rules\gpl-1.0-plus_251.yml", "YAML", 0, 0, 0, 3, 0, 0, 1, 4
"d:\IDEWORK\lvmen\src\licensedcode\data\rules\gpl-1.0-plus_252.yml", "YAML", 0, 0, 0, 3, 0, 0, 1, 4
"d:\IDEWORK\lvmen\src\licensedcode\data\rules\gpl-1.0-plus_253.yml", "YAML", 0, 0, 0, 3, 0, 0, 1, 4
"d:\IDEWORK\lvmen\src\licensedcode\data\rules\gpl-1.0-plus_254.yml", "YAML", 0, 0, 0, 3, 0, 0, 1, 4
"d:\IDEWORK\lvmen\src\licensedcode\data\rules\gpl-1.0-plus_255.yml", "YAML", 0, 0, 0, 3, 0, 0, 1, 4
"d:\IDEWORK\lvmen\src\licensedcode\data\rules\gpl-1.0-plus_256.yml", "YAML", 0, 0, 0, 3, 0, 0, 1, 4
"d:\IDEWORK\lvmen\src\licensedcode\data\rules\gpl-1.0-plus_257.yml", "YAML", 0, 0, 0, 3, 0, 0, 1, 4
"d:\IDEWORK\lvmen\src\licensedcode\data\rules\gpl-1.0-plus_258.yml", "YAML", 0, 0, 0, 3, 0, 0, 1, 4
"d:\IDEWORK\lvmen\src\licensedcode\data\rules\gpl-1.0-plus_259.yml", "YAML", 0, 0, 0, 3, 0, 0, 1, 4
"d:\IDEWORK\lvmen\src\licensedcode\data\rules\gpl-1.0-plus_26.yml", "YAML", 0, 0, 0, 4, 0, 0, 1, 5
"d:\IDEWORK\lvmen\src\licensedcode\data\rules\gpl-1.0-plus_260.yml", "YAML", 0, 0, 0, 3, 0, 0, 1, 4
"d:\IDEWORK\lvmen\src\licensedcode\data\rules\gpl-1.0-plus_261.yml", "YAML", 0, 0, 0, 3, 0, 0, 1, 4
"d:\IDEWORK\lvmen\src\licensedcode\data\rules\gpl-1.0-plus_262.yml", "YAML", 0, 0, 0, 3, 0, 0, 1, 4
"d:\IDEWORK\lvmen\src\licensedcode\data\rules\gpl-1.0-plus_263.yml", "YAML", 0, 0, 0, 3, 0, 0, 1, 4
"d:\IDEWORK\lvmen\src\licensedcode\data\rules\gpl-1.0-plus_264.yml", "YAML", 0, 0, 0, 3, 0, 0, 1, 4
"d:\IDEWORK\lvmen\src\licensedcode\data\rules\gpl-1.0-plus_265.yml", "YAML", 0, 0, 0, 3, 0, 0, 1, 4
"d:\IDEWORK\lvmen\src\licensedcode\data\rules\gpl-1.0-plus_266.yml", "YAML", 0, 0, 0, 3, 0, 0, 1, 4
"d:\IDEWORK\lvmen\src\licensedcode\data\rules\gpl-1.0-plus_267.yml", "YAML", 0, 0, 0, 3, 0, 0, 1, 4
"d:\IDEWORK\lvmen\src\licensedcode\data\rules\gpl-1.0-plus_268.yml", "YAML", 0, 0, 0, 3, 0, 0, 1, 4
"d:\IDEWORK\lvmen\src\licensedcode\data\rules\gpl-1.0-plus_269.yml", "YAML", 0, 0, 0, 3, 0, 0, 1, 4
"d:\IDEWORK\lvmen\src\licensedcode\data\rules\gpl-1.0-plus_27.yml", "YAML", 0, 0, 0, 5, 0, 0, 1, 6
"d:\IDEWORK\lvmen\src\licensedcode\data\rules\gpl-1.0-plus_270.yml", "YAML", 0, 0, 0, 3, 0, 0, 1, 4
"d:\IDEWORK\lvmen\src\licensedcode\data\rules\gpl-1.0-plus_271.yml", "YAML", 0, 0, 0, 3, 0, 0, 1, 4
"d:\IDEWORK\lvmen\src\licensedcode\data\rules\gpl-1.0-plus_272.yml", "YAML", 0, 0, 0, 3, 0, 0, 1, 4
"d:\IDEWORK\lvmen\src\licensedcode\data\rules\gpl-1.0-plus_273.yml", "YAML", 0, 0, 0, 3, 0, 0, 1, 4
"d:\IDEWORK\lvmen\src\licensedcode\data\rules\gpl-1.0-plus_274.yml", "YAML", 0, 0, 0, 3, 0, 0, 1, 4
"d:\IDEWORK\lvmen\src\licensedcode\data\rules\gpl-1.0-plus_275.yml", "YAML", 0, 0, 0, 3, 0, 0, 1, 4
"d:\IDEWORK\lvmen\src\licensedcode\data\rules\gpl-1.0-plus_276.yml", "YAML", 0, 0, 0, 3, 0, 0, 1, 4
"d:\IDEWORK\lvmen\src\licensedcode\data\rules\gpl-1.0-plus_277.yml", "YAML", 0, 0, 0, 3, 0, 0, 1, 4
"d:\IDEWORK\lvmen\src\licensedcode\data\rules\gpl-1.0-plus_278.yml", "YAML", 0, 0, 0, 3, 0, 0, 1, 4
"d:\IDEWORK\lvmen\src\licensedcode\data\rules\gpl-1.0-plus_279.yml", "YAML", 0, 0, 0, 3, 0, 0, 1, 4
"d:\IDEWORK\lvmen\src\licensedcode\data\rules\gpl-1.0-plus_28.yml", "YAML", 0, 0, 0, 4, 0, 0, 1, 5
"d:\IDEWORK\lvmen\src\licensedcode\data\rules\gpl-1.0-plus_280.yml", "YAML", 0, 0, 0, 3, 0, 0, 1, 4
"d:\IDEWORK\lvmen\src\licensedcode\data\rules\gpl-1.0-plus_281.yml", "YAML", 0, 0, 0, 3, 0, 0, 1, 4
"d:\IDEWORK\lvmen\src\licensedcode\data\rules\gpl-1.0-plus_282.yml", "YAML", 0, 0, 0, 3, 0, 0, 1, 4
"d:\IDEWORK\lvmen\src\licensedcode\data\rules\gpl-1.0-plus_283.yml", "YAML", 0, 0, 0, 3, 0, 0, 1, 4
"d:\IDEWORK\lvmen\src\licensedcode\data\rules\gpl-1.0-plus_284.yml", "YAML", 0, 0, 0, 3, 0, 0, 1, 4
"d:\IDEWORK\lvmen\src\licensedcode\data\rules\gpl-1.0-plus_285.yml", "YAML", 0, 0, 0, 3, 0, 0, 1, 4
"d:\IDEWORK\lvmen\src\licensedcode\data\rules\gpl-1.0-plus_286.yml", "YAML", 0, 0, 0, 5, 0, 0, 1, 6
"d:\IDEWORK\lvmen\src\licensedcode\data\rules\gpl-1.0-plus_287.yml", "YAML", 0, 0, 0, 5, 0, 0, 1, 6
"d:\IDEWORK\lvmen\src\licensedcode\data\rules\gpl-1.0-plus_288.yml", "YAML", 0, 0, 0, 3, 0, 0, 1, 4
"d:\IDEWORK\lvmen\src\licensedcode\data\rules\gpl-1.0-plus_289.yml", "YAML", 0, 0, 0, 5, 0, 0, 1, 6
"d:\IDEWORK\lvmen\src\licensedcode\data\rules\gpl-1.0-plus_29.yml", "YAML", 0, 0, 0, 3, 0, 0, 1, 4
"d:\IDEWORK\lvmen\src\licensedcode\data\rules\gpl-1.0-plus_290.yml", "YAML", 0, 0, 0, 5, 0, 0, 1, 6
"d:\IDEWORK\lvmen\src\licensedcode\data\rules\gpl-1.0-plus_291.yml", "YAML", 0, 0, 0, 6, 0, 0, 1, 7
"d:\IDEWORK\lvmen\src\licensedcode\data\rules\gpl-1.0-plus_292.yml", "YAML", 0, 0, 0, 3, 0, 0, 1, 4
"d:\IDEWORK\lvmen\src\licensedcode\data\rules\gpl-1.0-plus_293.yml", "YAML", 0, 0, 0, 5, 0, 0, 1, 6
"d:\IDEWORK\lvmen\src\licensedcode\data\rules\gpl-1.0-plus_294.yml", "YAML", 0, 0, 0, 3, 0, 0, 1, 4
"d:\IDEWORK\lvmen\src\licensedcode\data\rules\gpl-1.0-plus_295.yml", "YAML", 0, 0, 0, 5, 0, 0, 1, 6
"d:\IDEWORK\lvmen\src\licensedcode\data\rules\gpl-1.0-plus_296.yml", "YAML", 0, 0, 0, 5, 0, 0, 1, 6
"d:\IDEWORK\lvmen\src\licensedcode\data\rules\gpl-1.0-plus_297.yml", "YAML", 0, 0, 0, 3, 0, 0, 1, 4
"d:\IDEWORK\lvmen\src\licensedcode\data\rules\gpl-1.0-plus_298.yml", "YAML", 0, 0, 0, 3, 0, 0, 1, 4
"d:\IDEWORK\lvmen\src\licensedcode\data\rules\gpl-1.0-plus_299.yml", "YAML", 0, 0, 0, 3, 0, 0, 1, 4
"d:\IDEWORK\lvmen\src\licensedcode\data\rules\gpl-1.0-plus_3.yml", "YAML", 0, 0, 0, 3, 0, 0, 1, 4
"d:\IDEWORK\lvmen\src\licensedcode\data\rules\gpl-1.0-plus_30.yml", "YAML", 0, 0, 0, 3, 0, 0, 1, 4
"d:\IDEWORK\lvmen\src\licensedcode\data\rules\gpl-1.0-plus_300.yml", "YAML", 0, 0, 0, 3, 0, 0, 1, 4
"d:\IDEWORK\lvmen\src\licensedcode\data\rules\gpl-1.0-plus_301.yml", "YAML", 0, 0, 0, 3, 0, 0, 1, 4
"d:\IDEWORK\lvmen\src\licensedcode\data\rules\gpl-1.0-plus_302.yml", "YAML", 0, 0, 0, 3, 0, 0, 1, 4
"d:\IDEWORK\lvmen\src\licensedcode\data\rules\gpl-1.0-plus_303.yml", "YAML", 0, 0, 0, 3, 0, 0, 1, 4
"d:\IDEWORK\lvmen\src\licensedcode\data\rules\gpl-1.0-plus_304.yml", "YAML", 0, 0, 0, 3, 0, 0, 1, 4
"d:\IDEWORK\lvmen\src\licensedcode\data\rules\gpl-1.0-plus_305.yml", "YAML", 0, 0, 0, 3, 0, 0, 1, 4
"d:\IDEWORK\lvmen\src\licensedcode\data\rules\gpl-1.0-plus_306.yml", "YAML", 0, 0, 0, 3, 0, 0, 1, 4
"d:\IDEWORK\lvmen\src\licensedcode\data\rules\gpl-1.0-plus_307.yml", "YAML", 0, 0, 0, 3, 0, 0, 1, 4
"d:\IDEWORK\lvmen\src\licensedcode\data\rules\gpl-1.0-plus_308.yml", "YAML", 0, 0, 0, 3, 0, 0, 1, 4
"d:\IDEWORK\lvmen\src\licensedcode\data\rules\gpl-1.0-plus_309.yml", "YAML", 0, 0, 0, 3, 0, 0, 1, 4
"d:\IDEWORK\lvmen\src\licensedcode\data\rules\gpl-1.0-plus_31.yml", "YAML", 0, 0, 0, 3, 0, 0, 1, 4
"d:\IDEWORK\lvmen\src\licensedcode\data\rules\gpl-1.0-plus_310.yml", "YAML", 0, 0, 0, 3, 0, 0, 1, 4
"d:\IDEWORK\lvmen\src\licensedcode\data\rules\gpl-1.0-plus_311.yml", "YAML", 0, 0, 0, 3, 0, 0, 1, 4
"d:\IDEWORK\lvmen\src\licensedcode\data\rules\gpl-1.0-plus_312.yml", "YAML", 0, 0, 0, 3, 0, 0, 1, 4
"d:\IDEWORK\lvmen\src\licensedcode\data\rules\gpl-1.0-plus_313.yml", "YAML", 0, 0, 0, 3, 0, 0, 1, 4
"d:\IDEWORK\lvmen\src\licensedcode\data\rules\gpl-1.0-plus_314.yml", "YAML", 0, 0, 0, 3, 0, 0, 1, 4
"d:\IDEWORK\lvmen\src\licensedcode\data\rules\gpl-1.0-plus_315.yml", "YAML", 0, 0, 0, 3, 0, 0, 1, 4
"d:\IDEWORK\lvmen\src\licensedcode\data\rules\gpl-1.0-plus_316.yml", "YAML", 0, 0, 0, 3, 0, 0, 1, 4
"d:\IDEWORK\lvmen\src\licensedcode\data\rules\gpl-1.0-plus_317.yml", "YAML", 0, 0, 0, 3, 0, 0, 1, 4
"d:\IDEWORK\lvmen\src\licensedcode\data\rules\gpl-1.0-plus_318.yml", "YAML", 0, 0, 0, 3, 0, 0, 1, 4
"d:\IDEWORK\lvmen\src\licensedcode\data\rules\gpl-1.0-plus_319.yml", "YAML", 0, 0, 0, 3, 0, 0, 1, 4
"d:\IDEWORK\lvmen\src\licensedcode\data\rules\gpl-1.0-plus_32.yml", "YAML", 0, 0, 0, 6, 0, 0, 1, 7
"d:\IDEWORK\lvmen\src\licensedcode\data\rules\gpl-1.0-plus_320.yml", "YAML", 0, 0, 0, 3, 0, 0, 1, 4
"d:\IDEWORK\lvmen\src\licensedcode\data\rules\gpl-1.0-plus_321.yml", "YAML", 0, 0, 0, 3, 0, 0, 1, 4
"d:\IDEWORK\lvmen\src\licensedcode\data\rules\gpl-1.0-plus_322.yml", "YAML", 0, 0, 0, 3, 0, 0, 1, 4
"d:\IDEWORK\lvmen\src\licensedcode\data\rules\gpl-1.0-plus_323.yml", "YAML", 0, 0, 0, 3, 0, 0, 1, 4
"d:\IDEWORK\lvmen\src\licensedcode\data\rules\gpl-1.0-plus_324.yml", "YAML", 0, 0, 0, 3, 0, 0, 1, 4
"d:\IDEWORK\lvmen\src\licensedcode\data\rules\gpl-1.0-plus_325.yml", "YAML", 0, 0, 0, 3, 0, 0, 1, 4
"d:\IDEWORK\lvmen\src\licensedcode\data\rules\gpl-1.0-plus_326.yml", "YAML", 0, 0, 0, 3, 0, 0, 1, 4
"d:\IDEWORK\lvmen\src\licensedcode\data\rules\gpl-1.0-plus_327.yml", "YAML", 0, 0, 0, 3, 0, 0, 1, 4
"d:\IDEWORK\lvmen\src\licensedcode\data\rules\gpl-1.0-plus_328.yml", "YAML", 0, 0, 0, 3, 0, 0, 1, 4
"d:\IDEWORK\lvmen\src\licensedcode\data\rules\gpl-1.0-plus_329.yml", "YAML", 0, 0, 0, 3, 0, 0, 1, 4
"d:\IDEWORK\lvmen\src\licensedcode\data\rules\gpl-1.0-plus_33.yml", "YAML", 0, 0, 0, 3, 0, 0, 1, 4
"d:\IDEWORK\lvmen\src\licensedcode\data\rules\gpl-1.0-plus_330.yml", "YAML", 0, 0, 0, 3, 0, 0, 1, 4
"d:\IDEWORK\lvmen\src\licensedcode\data\rules\gpl-1.0-plus_331.yml", "YAML", 0, 0, 0, 3, 0, 0, 1, 4
"d:\IDEWORK\lvmen\src\licensedcode\data\rules\gpl-1.0-plus_332.yml", "YAML", 0, 0, 0, 3, 0, 0, 1, 4
"d:\IDEWORK\lvmen\src\licensedcode\data\rules\gpl-1.0-plus_333.yml", "YAML", 0, 0, 0, 3, 0, 0, 1, 4
"d:\IDEWORK\lvmen\src\licensedcode\data\rules\gpl-1.0-plus_334.yml", "YAML", 0, 0, 0, 5, 0, 0, 1, 6
"d:\IDEWORK\lvmen\src\licensedcode\data\rules\gpl-1.0-plus_335.yml", "YAML", 0, 0, 0, 5, 0, 0, 1, 6
"d:\IDEWORK\lvmen\src\licensedcode\data\rules\gpl-1.0-plus_336.yml", "YAML", 0, 0, 0, 5, 0, 0, 1, 6
"d:\IDEWORK\lvmen\src\licensedcode\data\rules\gpl-1.0-plus_337.yml", "YAML", 0, 0, 0, 3, 0, 0, 1, 4
"d:\IDEWORK\lvmen\src\licensedcode\data\rules\gpl-1.0-plus_338.yml", "YAML", 0, 0, 0, 3, 0, 0, 1, 4
"d:\IDEWORK\lvmen\src\licensedcode\data\rules\gpl-1.0-plus_339.yml", "YAML", 0, 0, 0, 3, 0, 0, 1, 4
"d:\IDEWORK\lvmen\src\licensedcode\data\rules\gpl-1.0-plus_34.yml", "YAML", 0, 0, 0, 3, 0, 0, 1, 4
"d:\IDEWORK\lvmen\src\licensedcode\data\rules\gpl-1.0-plus_340.yml", "YAML", 0, 0, 0, 3, 0, 0, 1, 4
"d:\IDEWORK\lvmen\src\licensedcode\data\rules\gpl-1.0-plus_341.yml", "YAML", 0, 0, 0, 3, 0, 0, 1, 4
"d:\IDEWORK\lvmen\src\licensedcode\data\rules\gpl-1.0-plus_342.yml", "YAML", 0, 0, 0, 5, 0, 0, 1, 6
"d:\IDEWORK\lvmen\src\licensedcode\data\rules\gpl-1.0-plus_343.yml", "YAML", 0, 0, 0, 4, 0, 0, 1, 5
"d:\IDEWORK\lvmen\src\licensedcode\data\rules\gpl-1.0-plus_344.yml", "YAML", 0, 0, 0, 4, 0, 0, 1, 5
"d:\IDEWORK\lvmen\src\licensedcode\data\rules\gpl-1.0-plus_345.yml", "YAML", 0, 0, 0, 4, 0, 0, 1, 5
"d:\IDEWORK\lvmen\src\licensedcode\data\rules\gpl-1.0-plus_346.yml", "YAML", 0, 0, 0, 4, 0, 0, 1, 5
"d:\IDEWORK\lvmen\src\licensedcode\data\rules\gpl-1.0-plus_347.yml", "YAML", 0, 0, 0, 4, 0, 0, 1, 5
"d:\IDEWORK\lvmen\src\licensedcode\data\rules\gpl-1.0-plus_348.yml", "YAML", 0, 0, 0, 4, 0, 0, 1, 5
"d:\IDEWORK\lvmen\src\licensedcode\data\rules\gpl-1.0-plus_349.yml", "YAML", 0, 0, 0, 3, 0, 0, 1, 4
"d:\IDEWORK\lvmen\src\licensedcode\data\rules\gpl-1.0-plus_35.yml", "YAML", 0, 0, 0, 5, 0, 0, 1, 6
"d:\IDEWORK\lvmen\src\licensedcode\data\rules\gpl-1.0-plus_350.yml", "YAML", 0, 0, 0, 3, 0, 0, 1, 4
"d:\IDEWORK\lvmen\src\licensedcode\data\rules\gpl-1.0-plus_351.yml", "YAML", 0, 0, 0, 3, 0, 0, 1, 4
"d:\IDEWORK\lvmen\src\licensedcode\data\rules\gpl-1.0-plus_352.yml", "YAML", 0, 0, 0, 3, 0, 0, 1, 4
"d:\IDEWORK\lvmen\src\licensedcode\data\rules\gpl-1.0-plus_353.yml", "YAML", 0, 0, 0, 6, 0, 0, 1, 7
"d:\IDEWORK\lvmen\src\licensedcode\data\rules\gpl-1.0-plus_354.yml", "YAML", 0, 0, 0, 3, 0, 0, 1, 4
"d:\IDEWORK\lvmen\src\licensedcode\data\rules\gpl-1.0-plus_355.yml", "YAML", 0, 0, 0, 3, 0, 0, 1, 4
"d:\IDEWORK\lvmen\src\licensedcode\data\rules\gpl-1.0-plus_356.yml", "YAML", 0, 0, 0, 3, 0, 0, 1, 4
"d:\IDEWORK\lvmen\src\licensedcode\data\rules\gpl-1.0-plus_357.yml", "YAML", 0, 0, 0, 3, 0, 0, 1, 4
"d:\IDEWORK\lvmen\src\licensedcode\data\rules\gpl-1.0-plus_358.yml", "YAML", 0, 0, 0, 5, 0, 0, 1, 6
"d:\IDEWORK\lvmen\src\licensedcode\data\rules\gpl-1.0-plus_359.yml", "YAML", 0, 0, 0, 5, 0, 0, 1, 6
"d:\IDEWORK\lvmen\src\licensedcode\data\rules\gpl-1.0-plus_36.yml", "YAML", 0, 0, 0, 5, 0, 0, 1, 6
"d:\IDEWORK\lvmen\src\licensedcode\data\rules\gpl-1.0-plus_360.yml", "YAML", 0, 0, 0, 5, 0, 0, 1, 6
"d:\IDEWORK\lvmen\src\licensedcode\data\rules\gpl-1.0-plus_361.yml", "YAML", 0, 0, 0, 3, 0, 0, 1, 4
"d:\IDEWORK\lvmen\src\licensedcode\data\rules\gpl-1.0-plus_362.yml", "YAML", 0, 0, 0, 5, 0, 0, 1, 6
"d:\IDEWORK\lvmen\src\licensedcode\data\rules\gpl-1.0-plus_363.yml", "YAML", 0, 0, 0, 5, 0, 0, 1, 6
"d:\IDEWORK\lvmen\src\licensedcode\data\rules\gpl-1.0-plus_364.yml", "YAML", 0, 0, 0, 5, 0, 0, 1, 6
"d:\IDEWORK\lvmen\src\licensedcode\data\rules\gpl-1.0-plus_365.yml", "YAML", 0, 0, 0, 5, 0, 0, 1, 6
"d:\IDEWORK\lvmen\src\licensedcode\data\rules\gpl-1.0-plus_366.yml", "YAML", 0, 0, 0, 5, 0, 0, 1, 6
"d:\IDEWORK\lvmen\src\licensedcode\data\rules\gpl-1.0-plus_367.yml", "YAML", 0, 0, 0, 3, 0, 0, 1, 4
"d:\IDEWORK\lvmen\src\licensedcode\data\rules\gpl-1.0-plus_368.yml", "YAML", 0, 0, 0, 4, 0, 0, 1, 5
"d:\IDEWORK\lvmen\src\licensedcode\data\rules\gpl-1.0-plus_369.yml", "YAML", 0, 0, 0, 5, 0, 0, 1, 6
"d:\IDEWORK\lvmen\src\licensedcode\data\rules\gpl-1.0-plus_37.yml", "YAML", 0, 0, 0, 3, 0, 0, 1, 4
"d:\IDEWORK\lvmen\src\licensedcode\data\rules\gpl-1.0-plus_370.yml", "YAML", 0, 0, 0, 5, 0, 0, 1, 6
"d:\IDEWORK\lvmen\src\licensedcode\data\rules\gpl-1.0-plus_371.yml", "YAML", 0, 0, 0, 5, 0, 0, 1, 6
"d:\IDEWORK\lvmen\src\licensedcode\data\rules\gpl-1.0-plus_372.yml", "YAML", 0, 0, 0, 6, 0, 0, 1, 7
"d:\IDEWORK\lvmen\src\licensedcode\data\rules\gpl-1.0-plus_373.yml", "YAML", 0, 0, 0, 5, 0, 0, 1, 6
"d:\IDEWORK\lvmen\src\licensedcode\data\rules\gpl-1.0-plus_374.yml", "YAML", 0, 0, 0, 3, 0, 0, 1, 4
"d:\IDEWORK\lvmen\src\licensedcode\data\rules\gpl-1.0-plus_375.yml", "YAML", 0, 0, 0, 3, 0, 0, 1, 4
"d:\IDEWORK\lvmen\src\licensedcode\data\rules\gpl-1.0-plus_376.yml", "YAML", 0, 0, 0, 3, 0, 0, 1, 4
"d:\IDEWORK\lvmen\src\licensedcode\data\rules\gpl-1.0-plus_377.yml", "YAML", 0, 0, 0, 3, 0, 0, 1, 4
"d:\IDEWORK\lvmen\src\licensedcode\data\rules\gpl-1.0-plus_378.yml", "YAML", 0, 0, 0, 3, 0, 0, 1, 4
"d:\IDEWORK\lvmen\src\licensedcode\data\rules\gpl-1.0-plus_379.yml", "YAML", 0, 0, 0, 3, 0, 0, 1, 4
"d:\IDEWORK\lvmen\src\licensedcode\data\rules\gpl-1.0-plus_38.yml", "YAML", 0, 0, 0, 3, 0, 0, 1, 4
"d:\IDEWORK\lvmen\src\licensedcode\data\rules\gpl-1.0-plus_380.yml", "YAML", 0, 0, 0, 3, 0, 0, 1, 4
"d:\IDEWORK\lvmen\src\licensedcode\data\rules\gpl-1.0-plus_381.yml", "YAML", 0, 0, 0, 5, 0, 0, 1, 6
"d:\IDEWORK\lvmen\src\licensedcode\data\rules\gpl-1.0-plus_382.yml", "YAML", 0, 0, 0, 3, 0, 0, 1, 4
"d:\IDEWORK\lvmen\src\licensedcode\data\rules\gpl-1.0-plus_383.yml", "YAML", 0, 0, 0, 5, 0, 0, 1, 6
"d:\IDEWORK\lvmen\src\licensedcode\data\rules\gpl-1.0-plus_384.yml", "YAML", 0, 0, 0, 3, 0, 0, 1, 4
"d:\IDEWORK\lvmen\src\licensedcode\data\rules\gpl-1.0-plus_385.yml", "YAML", 0, 0, 0, 3, 0, 0, 1, 4
"d:\IDEWORK\lvmen\src\licensedcode\data\rules\gpl-1.0-plus_386.yml", "YAML", 0, 0, 0, 3, 0, 0, 1, 4
"d:\IDEWORK\lvmen\src\licensedcode\data\rules\gpl-1.0-plus_387.yml", "YAML", 0, 0, 0, 3, 0, 0, 1, 4
"d:\IDEWORK\lvmen\src\licensedcode\data\rules\gpl-1.0-plus_388.yml", "YAML", 0, 0, 0, 3, 0, 0, 1, 4
"d:\IDEWORK\lvmen\src\licensedcode\data\rules\gpl-1.0-plus_389.yml", "YAML", 0, 0, 0, 3, 0, 0, 1, 4
"d:\IDEWORK\lvmen\src\licensedcode\data\rules\gpl-1.0-plus_39.yml", "YAML", 0, 0, 0, 3, 0, 0, 1, 4
"d:\IDEWORK\lvmen\src\licensedcode\data\rules\gpl-1.0-plus_390.yml", "YAML", 0, 0, 0, 5, 0, 0, 1, 6
"d:\IDEWORK\lvmen\src\licensedcode\data\rules\gpl-1.0-plus_391.yml", "YAML", 0, 0, 0, 3, 0, 0, 1, 4
"d:\IDEWORK\lvmen\src\licensedcode\data\rules\gpl-1.0-plus_392.yml", "YAML", 0, 0, 0, 3, 0, 0, 1, 4
"d:\IDEWORK\lvmen\src\licensedcode\data\rules\gpl-1.0-plus_393.yml", "YAML", 0, 0, 0, 3, 0, 0, 1, 4
"d:\IDEWORK\lvmen\src\licensedcode\data\rules\gpl-1.0-plus_394.yml", "YAML", 0, 0, 0, 3, 0, 0, 1, 4
"d:\IDEWORK\lvmen\src\licensedcode\data\rules\gpl-1.0-plus_395.yml", "YAML", 0, 0, 0, 3, 0, 0, 1, 4
"d:\IDEWORK\lvmen\src\licensedcode\data\rules\gpl-1.0-plus_396.yml", "YAML", 0, 0, 0, 5, 0, 0, 1, 6
"d:\IDEWORK\lvmen\src\licensedcode\data\rules\gpl-1.0-plus_397.yml", "YAML", 0, 0, 0, 3, 0, 0, 1, 4
"d:\IDEWORK\lvmen\src\licensedcode\data\rules\gpl-1.0-plus_398.yml", "YAML", 0, 0, 0, 3, 0, 0, 1, 4
"d:\IDEWORK\lvmen\src\licensedcode\data\rules\gpl-1.0-plus_399.yml", "YAML", 0, 0, 0, 5, 0, 0, 1, 6
"d:\IDEWORK\lvmen\src\licensedcode\data\rules\gpl-1.0-plus_4.yml", "YAML", 0, 0, 0, 3, 0, 0, 1, 4
"d:\IDEWORK\lvmen\src\licensedcode\data\rules\gpl-1.0-plus_40.yml", "YAML", 0, 0, 0, 4, 0, 0, 1, 5
"d:\IDEWORK\lvmen\src\licensedcode\data\rules\gpl-1.0-plus_400.yml", "YAML", 0, 0, 0, 5, 0, 0, 1, 6
"d:\IDEWORK\lvmen\src\licensedcode\data\rules\gpl-1.0-plus_401.yml", "YAML", 0, 0, 0, 5, 0, 0, 1, 6
"d:\IDEWORK\lvmen\src\licensedcode\data\rules\gpl-1.0-plus_402.yml", "YAML", 0, 0, 0, 3, 0, 0, 1, 4
"d:\IDEWORK\lvmen\src\licensedcode\data\rules\gpl-1.0-plus_403.yml", "YAML", 0, 0, 0, 3, 0, 0, 1, 4
"d:\IDEWORK\lvmen\src\licensedcode\data\rules\gpl-1.0-plus_404.yml", "YAML", 0, 0, 0, 3, 0, 0, 1, 4
"d:\IDEWORK\lvmen\src\licensedcode\data\rules\gpl-1.0-plus_405.yml", "YAML", 0, 0, 0, 3, 0, 0, 1, 4
"d:\IDEWORK\lvmen\src\licensedcode\data\rules\gpl-1.0-plus_406.yml", "YAML", 0, 0, 0, 3, 0, 0, 1, 4
"d:\IDEWORK\lvmen\src\licensedcode\data\rules\gpl-1.0-plus_407.yml", "YAML", 0, 0, 0, 3, 0, 0, 1, 4
"d:\IDEWORK\lvmen\src\licensedcode\data\rules\gpl-1.0-plus_408.yml", "YAML", 0, 0, 0, 3, 0, 0, 1, 4
"d:\IDEWORK\lvmen\src\licensedcode\data\rules\gpl-1.0-plus_409.yml", "YAML", 0, 0, 0, 3, 0, 0, 1, 4
"d:\IDEWORK\lvmen\src\licensedcode\data\rules\gpl-1.0-plus_41.yml", "YAML", 0, 0, 0, 3, 0, 0, 1, 4
"d:\IDEWORK\lvmen\src\licensedcode\data\rules\gpl-1.0-plus_410.yml", "YAML", 0, 0, 0, 3, 0, 0, 1, 4
"d:\IDEWORK\lvmen\src\licensedcode\data\rules\gpl-1.0-plus_411.yml", "YAML", 0, 0, 0, 3, 0, 0, 1, 4
"d:\IDEWORK\lvmen\src\licensedcode\data\rules\gpl-1.0-plus_412.yml", "YAML", 0, 0, 0, 3, 0, 0, 1, 4
"d:\IDEWORK\lvmen\src\licensedcode\data\rules\gpl-1.0-plus_413.yml", "YAML", 0, 0, 0, 3, 0, 0, 1, 4
"d:\IDEWORK\lvmen\src\licensedcode\data\rules\gpl-1.0-plus_414.yml", "YAML", 0, 0, 0, 3, 0, 0, 1, 4
"d:\IDEWORK\lvmen\src\licensedcode\data\rules\gpl-1.0-plus_415.yml", "YAML", 0, 0, 0, 3, 0, 0, 1, 4
"d:\IDEWORK\lvmen\src\licensedcode\data\rules\gpl-1.0-plus_416.yml", "YAML", 0, 0, 0, 3, 0, 0, 1, 4
"d:\IDEWORK\lvmen\src\licensedcode\data\rules\gpl-1.0-plus_417.yml", "YAML", 0, 0, 0, 3, 0, 0, 1, 4
"d:\IDEWORK\lvmen\src\licensedcode\data\rules\gpl-1.0-plus_418.yml", "YAML", 0, 0, 0, 3, 0, 0, 1, 4
"d:\IDEWORK\lvmen\src\licensedcode\data\rules\gpl-1.0-plus_419.yml", "YAML", 0, 0, 0, 3, 0, 0, 1, 4
"d:\IDEWORK\lvmen\src\licensedcode\data\rules\gpl-1.0-plus_42.yml", "YAML", 0, 0, 0, 2, 0, 0, 1, 3
"d:\IDEWORK\lvmen\src\licensedcode\data\rules\gpl-1.0-plus_420.yml", "YAML", 0, 0, 0, 5, 0, 0, 1, 6
"d:\IDEWORK\lvmen\src\licensedcode\data\rules\gpl-1.0-plus_421.yml", "YAML", 0, 0, 0, 3, 0, 0, 1, 4
"d:\IDEWORK\lvmen\src\licensedcode\data\rules\gpl-1.0-plus_422.yml", "YAML", 0, 0, 0, 5, 0, 0, 1, 6
"d:\IDEWORK\lvmen\src\licensedcode\data\rules\gpl-1.0-plus_423.yml", "YAML", 0, 0, 0, 3, 0, 0, 1, 4
"d:\IDEWORK\lvmen\src\licensedcode\data\rules\gpl-1.0-plus_424.yml", "YAML", 0, 0, 0, 5, 0, 0, 1, 6
"d:\IDEWORK\lvmen\src\licensedcode\data\rules\gpl-1.0-plus_425.yml", "YAML", 0, 0, 0, 3, 0, 0, 1, 4
"d:\IDEWORK\lvmen\src\licensedcode\data\rules\gpl-1.0-plus_426.yml", "YAML", 0, 0, 0, 3, 0, 0, 1, 4
"d:\IDEWORK\lvmen\src\licensedcode\data\rules\gpl-1.0-plus_427.yml", "YAML", 0, 0, 0, 8, 0, 0, 1, 9
"d:\IDEWORK\lvmen\src\licensedcode\data\rules\gpl-1.0-plus_428.yml", "YAML", 0, 0, 0, 8, 0, 0, 1, 9
"d:\IDEWORK\lvmen\src\licensedcode\data\rules\gpl-1.0-plus_429.yml", "YAML", 0, 0, 0, 3, 0, 0, 1, 4
"d:\IDEWORK\lvmen\src\licensedcode\data\rules\gpl-1.0-plus_43.yml", "YAML", 0, 0, 0, 3, 0, 0, 1, 4
"d:\IDEWORK\lvmen\src\licensedcode\data\rules\gpl-1.0-plus_430.yml", "YAML", 0, 0, 0, 3, 0, 0, 1, 4
"d:\IDEWORK\lvmen\src\licensedcode\data\rules\gpl-1.0-plus_431.yml", "YAML", 0, 0, 0, 3, 0, 0, 1, 4
"d:\IDEWORK\lvmen\src\licensedcode\data\rules\gpl-1.0-plus_432.yml", "YAML", 0, 0, 0, 5, 0, 0, 1, 6
"d:\IDEWORK\lvmen\src\licensedcode\data\rules\gpl-1.0-plus_433.yml", "YAML", 0, 0, 0, 7, 0, 0, 1, 8
"d:\IDEWORK\lvmen\src\licensedcode\data\rules\gpl-1.0-plus_434.yml", "YAML", 0, 0, 0, 3, 0, 0, 1, 4
"d:\IDEWORK\lvmen\src\licensedcode\data\rules\gpl-1.0-plus_435.yml", "YAML", 0, 0, 0, 3, 0, 0, 1, 4
"d:\IDEWORK\lvmen\src\licensedcode\data\rules\gpl-1.0-plus_436.yml", "YAML", 0, 0, 0, 3, 0, 0, 1, 4
"d:\IDEWORK\lvmen\src\licensedcode\data\rules\gpl-1.0-plus_437.yml", "YAML", 0, 0, 0, 5, 0, 0, 1, 6
"d:\IDEWORK\lvmen\src\licensedcode\data\rules\gpl-1.0-plus_438.yml", "YAML", 0, 0, 0, 3, 0, 0, 1, 4
"d:\IDEWORK\lvmen\src\licensedcode\data\rules\gpl-1.0-plus_439.yml", "YAML", 0, 0, 0, 3, 0, 0, 1, 4
"d:\IDEWORK\lvmen\src\licensedcode\data\rules\gpl-1.0-plus_44.yml", "YAML", 0, 0, 0, 3, 0, 0, 1, 4
"d:\IDEWORK\lvmen\src\licensedcode\data\rules\gpl-1.0-plus_440.yml", "YAML", 0, 0, 0, 3, 0, 0, 1, 4
"d:\IDEWORK\lvmen\src\licensedcode\data\rules\gpl-1.0-plus_441.yml", "YAML", 0, 0, 0, 3, 0, 0, 1, 4
"d:\IDEWORK\lvmen\src\licensedcode\data\rules\gpl-1.0-plus_442.yml", "YAML", 0, 0, 0, 3, 0, 0, 1, 4
"d:\IDEWORK\lvmen\src\licensedcode\data\rules\gpl-1.0-plus_443.yml", "YAML", 0, 0, 0, 3, 0, 0, 1, 4
"d:\IDEWORK\lvmen\src\licensedcode\data\rules\gpl-1.0-plus_444.yml", "YAML", 0, 0, 0, 4, 0, 0, 1, 5
"d:\IDEWORK\lvmen\src\licensedcode\data\rules\gpl-1.0-plus_445.yml", "YAML", 0, 0, 0, 6, 0, 0, 1, 7
"d:\IDEWORK\lvmen\src\licensedcode\data\rules\gpl-1.0-plus_446.yml", "YAML", 0, 0, 0, 5, 0, 0, 1, 6
"d:\IDEWORK\lvmen\src\licensedcode\data\rules\gpl-1.0-plus_447.yml", "YAML", 0, 0, 0, 4, 0, 0, 0, 4
"d:\IDEWORK\lvmen\src\licensedcode\data\rules\gpl-1.0-plus_448.yml", "YAML", 0, 0, 0, 2, 0, 0, 2, 4
"d:\IDEWORK\lvmen\src\licensedcode\data\rules\gpl-1.0-plus_449.yml", "YAML", 0, 0, 0, 6, 0, 0, 1, 7
"d:\IDEWORK\lvmen\src\licensedcode\data\rules\gpl-1.0-plus_45.yml", "YAML", 0, 0, 0, 2, 0, 0, 1, 3
"d:\IDEWORK\lvmen\src\licensedcode\data\rules\gpl-1.0-plus_450.yml", "YAML", 0, 0, 0, 5, 0, 0, 1, 6
"d:\IDEWORK\lvmen\src\licensedcode\data\rules\gpl-1.0-plus_451.yml", "YAML", 0, 0, 0, 4, 0, 0, 1, 5
"d:\IDEWORK\lvmen\src\licensedcode\data\rules\gpl-1.0-plus_452.yml", "YAML", 0, 0, 0, 3, 0, 0, 1, 4
"d:\IDEWORK\lvmen\src\licensedcode\data\rules\gpl-1.0-plus_453.yml", "YAML", 0, 0, 0, 3, 0, 0, 1, 4
"d:\IDEWORK\lvmen\src\licensedcode\data\rules\gpl-1.0-plus_454.yml", "YAML", 0, 0, 0, 3, 0, 0, 1, 4
"d:\IDEWORK\lvmen\src\licensedcode\data\rules\gpl-1.0-plus_455.yml", "YAML", 0, 0, 0, 3, 0, 0, 1, 4
"d:\IDEWORK\lvmen\src\licensedcode\data\rules\gpl-1.0-plus_456.yml", "YAML", 0, 0, 0, 5, 0, 0, 1, 6
"d:\IDEWORK\lvmen\src\licensedcode\data\rules\gpl-1.0-plus_457.yml", "YAML", 0, 0, 0, 3, 0, 0, 1, 4
"d:\IDEWORK\lvmen\src\licensedcode\data\rules\gpl-1.0-plus_458.yml", "YAML", 0, 0, 0, 2, 0, 0, 1, 3
"d:\IDEWORK\lvmen\src\licensedcode\data\rules\gpl-1.0-plus_459.yml", "YAML", 0, 0, 0, 4, 0, 0, 1, 5
"d:\IDEWORK\lvmen\src\licensedcode\data\rules\gpl-1.0-plus_46.yml", "YAML", 0, 0, 0, 5, 0, 0, 1, 6
"d:\IDEWORK\lvmen\src\licensedcode\data\rules\gpl-1.0-plus_460.yml", "YAML", 0, 0, 0, 4, 0, 0, 1, 5
"d:\IDEWORK\lvmen\src\licensedcode\data\rules\gpl-1.0-plus_461.yml", "YAML", 0, 0, 0, 2, 0, 0, 1, 3
"d:\IDEWORK\lvmen\src\licensedcode\data\rules\gpl-1.0-plus_462.yml", "YAML", 0, 0, 0, 3, 0, 0, 1, 4
"d:\IDEWORK\lvmen\src\licensedcode\data\rules\gpl-1.0-plus_463.yml", "YAML", 0, 0, 0, 4, 0, 0, 1, 5
"d:\IDEWORK\lvmen\src\licensedcode\data\rules\gpl-1.0-plus_464.yml", "YAML", 0, 0, 0, 4, 0, 0, 1, 5
"d:\IDEWORK\lvmen\src\licensedcode\data\rules\gpl-1.0-plus_465.yml", "YAML", 0, 0, 0, 4, 0, 0, 1, 5
"d:\IDEWORK\lvmen\src\licensedcode\data\rules\gpl-1.0-plus_466.yml", "YAML", 0, 0, 0, 3, 0, 0, 1, 4
"d:\IDEWORK\lvmen\src\licensedcode\data\rules\gpl-1.0-plus_467.yml", "YAML", 0, 0, 0, 4, 0, 0, 1, 5
"d:\IDEWORK\lvmen\src\licensedcode\data\rules\gpl-1.0-plus_468.yml", "YAML", 0, 0, 0, 3, 0, 0, 1, 4
"d:\IDEWORK\lvmen\src\licensedcode\data\rules\gpl-1.0-plus_469.yml", "YAML", 0, 0, 0, 3, 0, 0, 1, 4
"d:\IDEWORK\lvmen\src\licensedcode\data\rules\gpl-1.0-plus_47.yml", "YAML", 0, 0, 0, 7, 0, 0, 1, 8
"d:\IDEWORK\lvmen\src\licensedcode\data\rules\gpl-1.0-plus_470.yml", "YAML", 0, 0, 0, 3, 0, 0, 1, 4
"d:\IDEWORK\lvmen\src\licensedcode\data\rules\gpl-1.0-plus_471.yml", "YAML", 0, 0, 0, 3, 0, 0, 1, 4
"d:\IDEWORK\lvmen\src\licensedcode\data\rules\gpl-1.0-plus_472.yml", "YAML", 0, 0, 0, 5, 0, 0, 1, 6
"d:\IDEWORK\lvmen\src\licensedcode\data\rules\gpl-1.0-plus_473.yml", "YAML", 0, 0, 0, 4, 0, 0, 1, 5
"d:\IDEWORK\lvmen\src\licensedcode\data\rules\gpl-1.0-plus_474.yml", "YAML", 0, 0, 0, 3, 0, 0, 1, 4
"d:\IDEWORK\lvmen\src\licensedcode\data\rules\gpl-1.0-plus_475.yml", "YAML", 0, 0, 0, 4, 0, 0, 1, 5
"d:\IDEWORK\lvmen\src\licensedcode\data\rules\gpl-1.0-plus_476.yml", "YAML", 0, 0, 0, 3, 0, 0, 1, 4
"d:\IDEWORK\lvmen\src\licensedcode\data\rules\gpl-1.0-plus_477.yml", "YAML", 0, 0, 0, 3, 0, 0, 1, 4
"d:\IDEWORK\lvmen\src\licensedcode\data\rules\gpl-1.0-plus_478.yml", "YAML", 0, 0, 0, 5, 0, 0, 1, 6
"d:\IDEWORK\lvmen\src\licensedcode\data\rules\gpl-1.0-plus_479.yml", "YAML", 0, 0, 0, 4, 0, 0, 1, 5
"d:\IDEWORK\lvmen\src\licensedcode\data\rules\gpl-1.0-plus_48.yml", "YAML", 0, 0, 0, 5, 0, 0, 1, 6
"d:\IDEWORK\lvmen\src\licensedcode\data\rules\gpl-1.0-plus_480.yml", "YAML", 0, 0, 0, 5, 0, 0, 1, 6
"d:\IDEWORK\lvmen\src\licensedcode\data\rules\gpl-1.0-plus_481.yml", "YAML", 0, 0, 0, 3, 0, 0, 1, 4
"d:\IDEWORK\lvmen\src\licensedcode\data\rules\gpl-1.0-plus_482.yml", "YAML", 0, 0, 0, 5, 0, 0, 1, 6
"d:\IDEWORK\lvmen\src\licensedcode\data\rules\gpl-1.0-plus_483.yml", "YAML", 0, 0, 0, 3, 0, 0, 1, 4
"d:\IDEWORK\lvmen\src\licensedcode\data\rules\gpl-1.0-plus_484.yml", "YAML", 0, 0, 0, 3, 0, 0, 1, 4
"d:\IDEWORK\lvmen\src\licensedcode\data\rules\gpl-1.0-plus_485.yml", "YAML", 0, 0, 0, 3, 0, 0, 1, 4
"d:\IDEWORK\lvmen\src\licensedcode\data\rules\gpl-1.0-plus_486.yml", "YAML", 0, 0, 0, 5, 0, 0, 1, 6
"d:\IDEWORK\lvmen\src\licensedcode\data\rules\gpl-1.0-plus_487.yml", "YAML", 0, 0, 0, 9, 0, 0, 1, 10
"d:\IDEWORK\lvmen\src\licensedcode\data\rules\gpl-1.0-plus_488.yml", "YAML", 0, 0, 0, 5, 0, 0, 1, 6
"d:\IDEWORK\lvmen\src\licensedcode\data\rules\gpl-1.0-plus_489.yml", "YAML", 0, 0, 0, 5, 0, 0, 1, 6
"d:\IDEWORK\lvmen\src\licensedcode\data\rules\gpl-1.0-plus_49.yml", "YAML", 0, 0, 0, 3, 0, 0, 1, 4
"d:\IDEWORK\lvmen\src\licensedcode\data\rules\gpl-1.0-plus_490.yml", "YAML", 0, 0, 0, 5, 0, 0, 1, 6
"d:\IDEWORK\lvmen\src\licensedcode\data\rules\gpl-1.0-plus_491.yml", "YAML", 0, 0, 0, 5, 0, 0, 1, 6
"d:\IDEWORK\lvmen\src\licensedcode\data\rules\gpl-1.0-plus_492.yml", "YAML", 0, 0, 0, 9, 0, 0, 1, 10
"d:\IDEWORK\lvmen\src\licensedcode\data\rules\gpl-1.0-plus_493.yml", "YAML", 0, 0, 0, 5, 0, 0, 1, 6
"d:\IDEWORK\lvmen\src\licensedcode\data\rules\gpl-1.0-plus_494.yml", "YAML", 0, 0, 0, 5, 0, 0, 1, 6
"d:\IDEWORK\lvmen\src\licensedcode\data\rules\gpl-1.0-plus_495.yml", "YAML", 0, 0, 0, 5, 0, 0, 1, 6
"d:\IDEWORK\lvmen\src\licensedcode\data\rules\gpl-1.0-plus_496.yml", "YAML", 0, 0, 0, 7, 0, 0, 1, 8
"d:\IDEWORK\lvmen\src\licensedcode\data\rules\gpl-1.0-plus_497.yml", "YAML", 0, 0, 0, 8, 0, 0, 1, 9
"d:\IDEWORK\lvmen\src\licensedcode\data\rules\gpl-1.0-plus_498.yml", "YAML", 0, 0, 0, 6, 0, 0, 1, 7
"d:\IDEWORK\lvmen\src\licensedcode\data\rules\gpl-1.0-plus_499.yml", "YAML", 0, 0, 0, 5, 0, 0, 1, 6
"d:\IDEWORK\lvmen\src\licensedcode\data\rules\gpl-1.0-plus_5.yml", "YAML", 0, 0, 0, 3, 0, 0, 1, 4
"d:\IDEWORK\lvmen\src\licensedcode\data\rules\gpl-1.0-plus_50.yml", "YAML", 0, 0, 0, 3, 0, 0, 1, 4
"d:\IDEWORK\lvmen\src\licensedcode\data\rules\gpl-1.0-plus_500.yml", "YAML", 0, 0, 0, 7, 0, 0, 1, 8
"d:\IDEWORK\lvmen\src\licensedcode\data\rules\gpl-1.0-plus_501.yml", "YAML", 0, 0, 0, 5, 0, 0, 1, 6
"d:\IDEWORK\lvmen\src\licensedcode\data\rules\gpl-1.0-plus_502.yml", "YAML", 0, 0, 0, 8, 0, 0, 1, 9
"d:\IDEWORK\lvmen\src\licensedcode\data\rules\gpl-1.0-plus_503.yml", "YAML", 0, 0, 0, 7, 0, 0, 1, 8
"d:\IDEWORK\lvmen\src\licensedcode\data\rules\gpl-1.0-plus_504.yml", "YAML", 0, 0, 0, 5, 0, 0, 1, 6
"d:\IDEWORK\lvmen\src\licensedcode\data\rules\gpl-1.0-plus_505.yml", "YAML", 0, 0, 0, 5, 0, 0, 1, 6
"d:\IDEWORK\lvmen\src\licensedcode\data\rules\gpl-1.0-plus_506.yml", "YAML", 0, 0, 0, 7, 0, 0, 1, 8
"d:\IDEWORK\lvmen\src\licensedcode\data\rules\gpl-1.0-plus_507.yml", "YAML", 0, 0, 0, 5, 0, 0, 1, 6
"d:\IDEWORK\lvmen\src\licensedcode\data\rules\gpl-1.0-plus_508.yml", "YAML", 0, 0, 0, 5, 0, 0, 1, 6
"d:\IDEWORK\lvmen\src\licensedcode\data\rules\gpl-1.0-plus_509.yml", "YAML", 0, 0, 0, 8, 0, 0, 1, 9
"d:\IDEWORK\lvmen\src\licensedcode\data\rules\gpl-1.0-plus_51.yml", "YAML", 0, 0, 0, 3, 0, 0, 1, 4
"d:\IDEWORK\lvmen\src\licensedcode\data\rules\gpl-1.0-plus_510.yml", "YAML", 0, 0, 0, 6, 0, 0, 1, 7
"d:\IDEWORK\lvmen\src\licensedcode\data\rules\gpl-1.0-plus_511.yml", "YAML", 0, 0, 0, 6, 0, 0, 1, 7
"d:\IDEWORK\lvmen\src\licensedcode\data\rules\gpl-1.0-plus_512.yml", "YAML", 0, 0, 0, 5, 0, 0, 1, 6
"d:\IDEWORK\lvmen\src\licensedcode\data\rules\gpl-1.0-plus_513.yml", "YAML", 0, 0, 0, 9, 0, 0, 1, 10
"d:\IDEWORK\lvmen\src\licensedcode\data\rules\gpl-1.0-plus_514.yml", "YAML", 0, 0, 0, 7, 0, 0, 1, 8
"d:\IDEWORK\lvmen\src\licensedcode\data\rules\gpl-1.0-plus_515.yml", "YAML", 0, 0, 0, 5, 0, 0, 1, 6
"d:\IDEWORK\lvmen\src\licensedcode\data\rules\gpl-1.0-plus_516.yml", "YAML", 0, 0, 0, 5, 0, 0, 1, 6
"d:\IDEWORK\lvmen\src\licensedcode\data\rules\gpl-1.0-plus_517.yml", "YAML", 0, 0, 0, 5, 0, 0, 1, 6
"d:\IDEWORK\lvmen\src\licensedcode\data\rules\gpl-1.0-plus_518.yml", "YAML", 0, 0, 0, 6, 0, 0, 1, 7
"d:\IDEWORK\lvmen\src\licensedcode\data\rules\gpl-1.0-plus_519.yml", "YAML", 0, 0, 0, 5, 0, 0, 1, 6
"d:\IDEWORK\lvmen\src\licensedcode\data\rules\gpl-1.0-plus_52.yml", "YAML", 0, 0, 0, 3, 0, 0, 1, 4
"d:\IDEWORK\lvmen\src\licensedcode\data\rules\gpl-1.0-plus_520.yml", "YAML", 0, 0, 0, 5, 0, 0, 1, 6
"d:\IDEWORK\lvmen\src\licensedcode\data\rules\gpl-1.0-plus_521.yml", "YAML", 0, 0, 0, 5, 0, 0, 1, 6
"d:\IDEWORK\lvmen\src\licensedcode\data\rules\gpl-1.0-plus_521_1.yml", "YAML", 0, 0, 0, 3, 0, 0, 1, 4
"d:\IDEWORK\lvmen\src\licensedcode\data\rules\gpl-1.0-plus_522.yml", "YAML", 0, 0, 0, 5, 0, 0, 1, 6
"d:\IDEWORK\lvmen\src\licensedcode\data\rules\gpl-1.0-plus_523.yml", "YAML", 0, 0, 0, 5, 0, 0, 1, 6
"d:\IDEWORK\lvmen\src\licensedcode\data\rules\gpl-1.0-plus_524.yml", "YAML", 0, 0, 0, 9, 0, 0, 1, 10
"d:\IDEWORK\lvmen\src\licensedcode\data\rules\gpl-1.0-plus_525.yml", "YAML", 0, 0, 0, 7, 0, 0, 1, 8
"d:\IDEWORK\lvmen\src\licensedcode\data\rules\gpl-1.0-plus_526.yml", "YAML", 0, 0, 0, 2, 0, 0, 1, 3
"d:\IDEWORK\lvmen\src\licensedcode\data\rules\gpl-1.0-plus_527.yml", "YAML", 0, 0, 0, 5, 0, 0, 1, 6
"d:\IDEWORK\lvmen\src\licensedcode\data\rules\gpl-1.0-plus_528.yml", "YAML", 0, 0, 0, 5, 0, 0, 1, 6
"d:\IDEWORK\lvmen\src\licensedcode\data\rules\gpl-1.0-plus_529.yml", "YAML", 0, 0, 0, 3, 0, 0, 1, 4
"d:\IDEWORK\lvmen\src\licensedcode\data\rules\gpl-1.0-plus_53.yml", "YAML", 0, 0, 0, 3, 0, 0, 1, 4
"d:\IDEWORK\lvmen\src\licensedcode\data\rules\gpl-1.0-plus_530.yml", "YAML", 0, 0, 0, 6, 0, 0, 1, 7
"d:\IDEWORK\lvmen\src\licensedcode\data\rules\gpl-1.0-plus_531.yml", "YAML", 0, 0, 0, 5, 0, 0, 1, 6
"d:\IDEWORK\lvmen\src\licensedcode\data\rules\gpl-1.0-plus_532.yml", "YAML", 0, 0, 0, 3, 0, 0, 1, 4
"d:\IDEWORK\lvmen\src\licensedcode\data\rules\gpl-1.0-plus_533.yml", "YAML", 0, 0, 0, 3, 0, 0, 1, 4
"d:\IDEWORK\lvmen\src\licensedcode\data\rules\gpl-1.0-plus_534.yml", "YAML", 0, 0, 0, 3, 0, 0, 1, 4
"d:\IDEWORK\lvmen\src\licensedcode\data\rules\gpl-1.0-plus_535.yml", "YAML", 0, 0, 0, 5, 0, 0, 1, 6
"d:\IDEWORK\lvmen\src\licensedcode\data\rules\gpl-1.0-plus_536.yml", "YAML", 0, 0, 0, 3, 0, 0, 1, 4
"d:\IDEWORK\lvmen\src\licensedcode\data\rules\gpl-1.0-plus_537.yml", "YAML", 0, 0, 0, 5, 0, 0, 1, 6
"d:\IDEWORK\lvmen\src\licensedcode\data\rules\gpl-1.0-plus_538.yml", "YAML", 0, 0, 0, 3, 0, 0, 1, 4
"d:\IDEWORK\lvmen\src\licensedcode\data\rules\gpl-1.0-plus_539.yml", "YAML", 0, 0, 0, 5, 0, 0, 1, 6
"d:\IDEWORK\lvmen\src\licensedcode\data\rules\gpl-1.0-plus_54.yml", "YAML", 0, 0, 0, 3, 0, 0, 1, 4
"d:\IDEWORK\lvmen\src\licensedcode\data\rules\gpl-1.0-plus_540.yml", "YAML", 0, 0, 0, 2, 0, 0, 1, 3
"d:\IDEWORK\lvmen\src\licensedcode\data\rules\gpl-1.0-plus_541.yml", "YAML", 0, 0, 0, 3, 0, 0, 1, 4
"d:\IDEWORK\lvmen\src\licensedcode\data\rules\gpl-1.0-plus_542.yml", "YAML", 0, 0, 0, 2, 0, 0, 1, 3
"d:\IDEWORK\lvmen\src\licensedcode\data\rules\gpl-1.0-plus_55.yml", "YAML", 0, 0, 0, 3, 0, 0, 1, 4
"d:\IDEWORK\lvmen\src\licensedcode\data\rules\gpl-1.0-plus_56.yml", "YAML", 0, 0, 0, 3, 0, 0, 1, 4
"d:\IDEWORK\lvmen\src\licensedcode\data\rules\gpl-1.0-plus_57.yml", "YAML", 0, 0, 0, 3, 0, 0, 1, 4
"d:\IDEWORK\lvmen\src\licensedcode\data\rules\gpl-1.0-plus_58.yml", "YAML", 0, 0, 0, 3, 0, 0, 1, 4
"d:\IDEWORK\lvmen\src\licensedcode\data\rules\gpl-1.0-plus_59.yml", "YAML", 0, 0, 0, 3, 0, 0, 1, 4
"d:\IDEWORK\lvmen\src\licensedcode\data\rules\gpl-1.0-plus_6.yml", "YAML", 0, 0, 0, 5, 0, 0, 1, 6
"d:\IDEWORK\lvmen\src\licensedcode\data\rules\gpl-1.0-plus_60.yml", "YAML", 0, 0, 0, 3, 0, 0, 1, 4
"d:\IDEWORK\lvmen\src\licensedcode\data\rules\gpl-1.0-plus_61.yml", "YAML", 0, 0, 0, 3, 0, 0, 1, 4
"d:\IDEWORK\lvmen\src\licensedcode\data\rules\gpl-1.0-plus_62.yml", "YAML", 0, 0, 0, 3, 0, 0, 1, 4
"d:\IDEWORK\lvmen\src\licensedcode\data\rules\gpl-1.0-plus_63.yml", "YAML", 0, 0, 0, 3, 0, 0, 1, 4
"d:\IDEWORK\lvmen\src\licensedcode\data\rules\gpl-1.0-plus_64.yml", "YAML", 0, 0, 0, 3, 0, 0, 1, 4
"d:\IDEWORK\lvmen\src\licensedcode\data\rules\gpl-1.0-plus_65.yml", "YAML", 0, 0, 0, 3, 0, 0, 1, 4
"d:\IDEWORK\lvmen\src\licensedcode\data\rules\gpl-1.0-plus_66.yml", "YAML", 0, 0, 0, 3, 0, 0, 1, 4
"d:\IDEWORK\lvmen\src\licensedcode\data\rules\gpl-1.0-plus_67.yml", "YAML", 0, 0, 0, 3, 0, 0, 1, 4
"d:\IDEWORK\lvmen\src\licensedcode\data\rules\gpl-1.0-plus_68.yml", "YAML", 0, 0, 0, 5, 0, 0, 1, 6
"d:\IDEWORK\lvmen\src\licensedcode\data\rules\gpl-1.0-plus_69.yml", "YAML", 0, 0, 0, 3, 0, 0, 1, 4
"d:\IDEWORK\lvmen\src\licensedcode\data\rules\gpl-1.0-plus_7.yml", "YAML", 0, 0, 0, 4, 0, 0, 1, 5
"d:\IDEWORK\lvmen\src\licensedcode\data\rules\gpl-1.0-plus_70.yml", "YAML", 0, 0, 0, 3, 0, 0, 1, 4
"d:\IDEWORK\lvmen\src\licensedcode\data\rules\gpl-1.0-plus_71.yml", "YAML", 0, 0, 0, 3, 0, 0, 1, 4
"d:\IDEWORK\lvmen\src\licensedcode\data\rules\gpl-1.0-plus_72.yml", "YAML", 0, 0, 0, 3, 0, 0, 1, 4
"d:\IDEWORK\lvmen\src\licensedcode\data\rules\gpl-1.0-plus_73.yml", "YAML", 0, 0, 0, 3, 0, 0, 1, 4
"d:\IDEWORK\lvmen\src\licensedcode\data\rules\gpl-1.0-plus_74.yml", "YAML", 0, 0, 0, 3, 0, 0, 1, 4
"d:\IDEWORK\lvmen\src\licensedcode\data\rules\gpl-1.0-plus_75.yml", "YAML", 0, 0, 0, 3, 0, 0, 1, 4
"d:\IDEWORK\lvmen\src\licensedcode\data\rules\gpl-1.0-plus_76.yml", "YAML", 0, 0, 0, 3, 0, 0, 1, 4
"d:\IDEWORK\lvmen\src\licensedcode\data\rules\gpl-1.0-plus_77.yml", "YAML", 0, 0, 0, 3, 0, 0, 1, 4
"d:\IDEWORK\lvmen\src\licensedcode\data\rules\gpl-1.0-plus_78.yml", "YAML", 0, 0, 0, 3, 0, 0, 1, 4
"d:\IDEWORK\lvmen\src\licensedcode\data\rules\gpl-1.0-plus_79.yml", "YAML", 0, 0, 0, 3, 0, 0, 1, 4
"d:\IDEWORK\lvmen\src\licensedcode\data\rules\gpl-1.0-plus_8.yml", "YAML", 0, 0, 0, 3, 0, 0, 1, 4
"d:\IDEWORK\lvmen\src\licensedcode\data\rules\gpl-1.0-plus_80.yml", "YAML", 0, 0, 0, 3, 0, 0, 1, 4
"d:\IDEWORK\lvmen\src\licensedcode\data\rules\gpl-1.0-plus_81.yml", "YAML", 0, 0, 0, 4, 0, 0, 1, 5
"d:\IDEWORK\lvmen\src\licensedcode\data\rules\gpl-1.0-plus_82.yml", "YAML", 0, 0, 0, 3, 0, 0, 1, 4
"d:\IDEWORK\lvmen\src\licensedcode\data\rules\gpl-1.0-plus_83.yml", "YAML", 0, 0, 0, 3, 0, 0, 1, 4
"d:\IDEWORK\lvmen\src\licensedcode\data\rules\gpl-1.0-plus_84.yml", "YAML", 0, 0, 0, 3, 0, 0, 1, 4
"d:\IDEWORK\lvmen\src\licensedcode\data\rules\gpl-1.0-plus_85.yml", "YAML", 0, 0, 0, 3, 0, 0, 1, 4
"d:\IDEWORK\lvmen\src\licensedcode\data\rules\gpl-1.0-plus_86.yml", "YAML", 0, 0, 0, 3, 0, 0, 1, 4
"d:\IDEWORK\lvmen\src\licensedcode\data\rules\gpl-1.0-plus_87.yml", "YAML", 0, 0, 0, 3, 0, 0, 1, 4
"d:\IDEWORK\lvmen\src\licensedcode\data\rules\gpl-1.0-plus_88.yml", "YAML", 0, 0, 0, 3, 0, 0, 1, 4
"d:\IDEWORK\lvmen\src\licensedcode\data\rules\gpl-1.0-plus_89.yml", "YAML", 0, 0, 0, 3, 0, 0, 1, 4
"d:\IDEWORK\lvmen\src\licensedcode\data\rules\gpl-1.0-plus_9.yml", "YAML", 0, 0, 0, 2, 0, 0, 1, 3
"d:\IDEWORK\lvmen\src\licensedcode\data\rules\gpl-1.0-plus_90.yml", "YAML", 0, 0, 0, 3, 0, 0, 1, 4
"d:\IDEWORK\lvmen\src\licensedcode\data\rules\gpl-1.0-plus_91.yml", "YAML", 0, 0, 0, 5, 0, 0, 1, 6
"d:\IDEWORK\lvmen\src\licensedcode\data\rules\gpl-1.0-plus_92.yml", "YAML", 0, 0, 0, 3, 0, 0, 1, 4
"d:\IDEWORK\lvmen\src\licensedcode\data\rules\gpl-1.0-plus_93.yml", "YAML", 0, 0, 0, 3, 0, 0, 1, 4
"d:\IDEWORK\lvmen\src\licensedcode\data\rules\gpl-1.0-plus_94.yml", "YAML", 0, 0, 0, 3, 0, 0, 1, 4
"d:\IDEWORK\lvmen\src\licensedcode\data\rules\gpl-1.0-plus_95.yml", "YAML", 0, 0, 0, 3, 0, 0, 1, 4
"d:\IDEWORK\lvmen\src\licensedcode\data\rules\gpl-1.0-plus_96.yml", "YAML", 0, 0, 0, 3, 0, 0, 1, 4
"d:\IDEWORK\lvmen\src\licensedcode\data\rules\gpl-1.0-plus_97.yml", "YAML", 0, 0, 0, 3, 0, 0, 1, 4
"d:\IDEWORK\lvmen\src\licensedcode\data\rules\gpl-1.0-plus_98.yml", "YAML", 0, 0, 0, 3, 0, 0, 1, 4
"d:\IDEWORK\lvmen\src\licensedcode\data\rules\gpl-1.0-plus_99.yml", "YAML", 0, 0, 0, 3, 0, 0, 1, 4
"d:\IDEWORK\lvmen\src\licensedcode\data\rules\gpl-1.0-plus_and_bsd-export.yml", "YAML", 0, 0, 0, 12, 0, 0, 1, 13
"d:\IDEWORK\lvmen\src\licensedcode\data\rules\gpl-1.0-plus_and_bsd-new_1.yml", "YAML", 0, 0, 0, 6, 0, 0, 1, 7
"d:\IDEWORK\lvmen\src\licensedcode\data\rules\gpl-1.0-plus_and_bsd-new_2.yml", "YAML", 0, 0, 0, 4, 0, 0, 1, 5
"d:\IDEWORK\lvmen\src\licensedcode\data\rules\gpl-1.0-plus_and_bsd-new_3.yml", "YAML", 0, 0, 0, 6, 0, 0, 1, 7
"d:\IDEWORK\lvmen\src\licensedcode\data\rules\gpl-1.0-plus_and_bsd-new_7.yml", "YAML", 0, 0, 0, 6, 0, 0, 1, 7
"d:\IDEWORK\lvmen\src\licensedcode\data\rules\gpl-1.0-plus_and_epl-2.0_or_gpl-2.0-plus_or_lgpl-2.1-plus_1.yml", "YAML", 0, 0, 0, 5, 0, 0, 1, 6
"d:\IDEWORK\lvmen\src\licensedcode\data\rules\gpl-1.0-plus_and_gpl-2.0-plus_and_lgpl-2.0-plus_and_gfdl-1.1_1.yml", "YAML", 0, 0, 0, 3, 0, 0, 1, 4
"d:\IDEWORK\lvmen\src\licensedcode\data\rules\gpl-1.0-plus_and_gpl-2.0_or_mit_1.yml", "YAML", 0, 0, 0, 4, 0, 0, 1, 5
"d:\IDEWORK\lvmen\src\licensedcode\data\rules\gpl-1.0-plus_and_gpl-2.0_or_mit_2.yml", "YAML", 0, 0, 0, 4, 0, 0, 1, 5
"d:\IDEWORK\lvmen\src\licensedcode\data\rules\gpl-1.0-plus_and_ijg_and_public-domain_1.yml", "YAML", 0, 0, 0, 9, 0, 0, 1, 10
"d:\IDEWORK\lvmen\src\licensedcode\data\rules\gpl-1.0-plus_and_ijg_and_public-domain_2.yml", "YAML", 0, 0, 0, 9, 0, 0, 1, 10
"d:\IDEWORK\lvmen\src\licensedcode\data\rules\gpl-1.0-plus_and_lgpl-2.0-plus_1.yml", "YAML", 0, 0, 0, 3, 0, 0, 1, 4
"d:\IDEWORK\lvmen\src\licensedcode\data\rules\gpl-1.0-plus_and_lgpl-2.0-plus_and_bsd-new_and_public-domain.yml", "YAML", 0, 0, 0, 3, 0, 0, 1, 4
"d:\IDEWORK\lvmen\src\licensedcode\data\rules\gpl-1.0-plus_and_lgpl-2.1-plus_1.yml", "YAML", 0, 0, 0, 4, 0, 0, 1, 5
"d:\IDEWORK\lvmen\src\licensedcode\data\rules\gpl-1.0-plus_and_lgpl-2.1-plus_2.yml", "YAML", 0, 0, 0, 3, 0, 0, 1, 4
"d:\IDEWORK\lvmen\src\licensedcode\data\rules\gpl-1.0-plus_and_lgpl-2.1-plus_3.yml", "YAML", 0, 0, 0, 6, 0, 0, 1, 7
"d:\IDEWORK\lvmen\src\licensedcode\data\rules\gpl-1.0-plus_and_mit_1.yml", "YAML", 0, 0, 0, 3, 0, 0, 1, 4
"d:\IDEWORK\lvmen\src\licensedcode\data\rules\gpl-1.0-plus_and_other-copyleft_1.yml", "YAML", 0, 0, 0, 3, 0, 0, 1, 4
"d:\IDEWORK\lvmen\src\licensedcode\data\rules\gpl-1.0-plus_and_other-copyleft_2.yml", "YAML", 0, 0, 0, 3, 0, 0, 1, 4
"d:\IDEWORK\lvmen\src\licensedcode\data\rules\gpl-1.0-plus_and_other-copyleft_and_free-unknown.yml", "YAML", 0, 0, 0, 3, 0, 0, 1, 4
"d:\IDEWORK\lvmen\src\licensedcode\data\rules\gpl-1.0-plus_and_other-copyleft_and_free-unknown2.yml", "YAML", 0, 0, 0, 2, 0, 0, 1, 3
"d:\IDEWORK\lvmen\src\licensedcode\data\rules\gpl-1.0-plus_and_other-permissive_and_other-copyleft_1.yml", "YAML", 0, 0, 0, 3, 0, 0, 1, 4
"d:\IDEWORK\lvmen\src\licensedcode\data\rules\gpl-1.0-plus_and_proprietary-license_1.yml", "YAML", 0, 0, 0, 3, 0, 0, 1, 4
"d:\IDEWORK\lvmen\src\licensedcode\data\rules\gpl-1.0-plus_and_proprietary-license_2.yml", "YAML", 0, 0, 0, 4, 0, 0, 1, 5
"d:\IDEWORK\lvmen\src\licensedcode\data\rules\gpl-1.0-plus_and_public-domain_and_mit_and_bsd-new_and_free-unknown_1.yml", "YAML", 0, 0, 0, 5, 0, 0, 1, 6
"d:\IDEWORK\lvmen\src\licensedcode\data\rules\gpl-1.0-plus_and_zlib_1.yml", "YAML", 0, 0, 0, 4, 0, 0, 1, 5
"d:\IDEWORK\lvmen\src\licensedcode\data\rules\gpl-1.0-plus_debian3.yml", "YAML", 0, 0, 0, 3, 0, 0, 1, 4
"d:\IDEWORK\lvmen\src\licensedcode\data\rules\gpl-1.0-plus_gcc_1.yml", "YAML", 0, 0, 0, 2, 0, 0, 1, 3
"d:\IDEWORK\lvmen\src\licensedcode\data\rules\gpl-1.0-plus_linux_1.yml", "YAML", 0, 0, 0, 6, 0, 0, 1, 7
"d:\IDEWORK\lvmen\src\licensedcode\data\rules\gpl-1.0-plus_linux_2.yml", "YAML", 0, 0, 0, 6, 0, 0, 1, 7
"d:\IDEWORK\lvmen\src\licensedcode\data\rules\gpl-1.0-plus_no_version_1.yml", "YAML", 0, 0, 0, 3, 0, 0, 1, 4
"d:\IDEWORK\lvmen\src\licensedcode\data\rules\gpl-1.0-plus_no_version_2.yml", "YAML", 0, 0, 0, 2, 0, 0, 1, 3
"d:\IDEWORK\lvmen\src\licensedcode\data\rules\gpl-1.0-plus_no_version_4.yml", "YAML", 0, 0, 0, 4, 0, 0, 1, 5
"d:\IDEWORK\lvmen\src\licensedcode\data\rules\gpl-1.0-plus_no_version_5.yml", "YAML", 0, 0, 0, 2, 0, 0, 1, 3
"d:\IDEWORK\lvmen\src\licensedcode\data\rules\gpl-1.0-plus_no_version_and_warranty-disclaimer_1.yml", "YAML", 0, 0, 0, 2, 0, 0, 1, 3
"d:\IDEWORK\lvmen\src\licensedcode\data\rules\gpl-1.0-plus_only_known_words_1.yml", "YAML", 0, 0, 0, 5, 0, 0, 1, 6
"d:\IDEWORK\lvmen\src\licensedcode\data\rules\gpl-1.0-plus_or_artistic-1.0_1.yml", "YAML", 0, 0, 0, 3, 0, 0, 1, 4
"d:\IDEWORK\lvmen\src\licensedcode\data\rules\gpl-1.0-plus_or_artistic-1.0_2.yml", "YAML", 0, 0, 0, 4, 0, 0, 1, 5
"d:\IDEWORK\lvmen\src\licensedcode\data\rules\gpl-1.0-plus_or_artistic-1.0_3.yml", "YAML", 0, 0, 0, 3, 0, 0, 1, 4
"d:\IDEWORK\lvmen\src\licensedcode\data\rules\gpl-1.0-plus_or_artistic-1.0_4.yml", "YAML", 0, 0, 0, 3, 0, 0, 1, 4
"d:\IDEWORK\lvmen\src\licensedcode\data\rules\gpl-1.0-plus_or_artistic-1.0_5.yml", "YAML", 0, 0, 0, 3, 0, 0, 1, 4
"d:\IDEWORK\lvmen\src\licensedcode\data\rules\gpl-1.0-plus_or_artistic-2.0_1.yml", "YAML", 0, 0, 0, 4, 0, 0, 1, 5
"d:\IDEWORK\lvmen\src\licensedcode\data\rules\gpl-1.0-plus_or_artistic-2.0_2.yml", "YAML", 0, 0, 0, 5, 0, 0, 1, 6
"d:\IDEWORK\lvmen\src\licensedcode\data\rules\gpl-1.0-plus_or_artistic-2.0_3.yml", "YAML", 0, 0, 0, 3, 0, 0, 1, 4
"d:\IDEWORK\lvmen\src\licensedcode\data\rules\gpl-1.0-plus_or_artistic-2.0_4.yml", "YAML", 0, 0, 0, 6, 0, 0, 1, 7
"d:\IDEWORK\lvmen\src\licensedcode\data\rules\gpl-1.0-plus_or_artistic-perl-1.0_1.yml", "YAML", 0, 0, 0, 3, 0, 0, 1, 4
"d:\IDEWORK\lvmen\src\licensedcode\data\rules\gpl-1.0-plus_or_artistic-perl-1.0_10.yml", "YAML", 0, 0, 0, 3, 0, 0, 1, 4
"d:\IDEWORK\lvmen\src\licensedcode\data\rules\gpl-1.0-plus_or_artistic-perl-1.0_11.yml", "YAML", 0, 0, 0, 3, 0, 0, 1, 4
"d:\IDEWORK\lvmen\src\licensedcode\data\rules\gpl-1.0-plus_or_artistic-perl-1.0_12.yml", "YAML", 0, 0, 0, 3, 0, 0, 1, 4
"d:\IDEWORK\lvmen\src\licensedcode\data\rules\gpl-1.0-plus_or_artistic-perl-1.0_13.yml", "YAML", 0, 0, 0, 3, 0, 0, 1, 4
"d:\IDEWORK\lvmen\src\licensedcode\data\rules\gpl-1.0-plus_or_artistic-perl-1.0_14.yml", "YAML", 0, 0, 0, 5, 0, 0, 1, 6
"d:\IDEWORK\lvmen\src\licensedcode\data\rules\gpl-1.0-plus_or_artistic-perl-1.0_15.yml", "YAML", 0, 0, 0, 5, 0, 0, 1, 6
"d:\IDEWORK\lvmen\src\licensedcode\data\rules\gpl-1.0-plus_or_artistic-perl-1.0_16.yml", "YAML", 0, 0, 0, 3, 0, 0, 1, 4
"d:\IDEWORK\lvmen\src\licensedcode\data\rules\gpl-1.0-plus_or_artistic-perl-1.0_17.yml", "YAML", 0, 0, 0, 3, 0, 0, 1, 4
"d:\IDEWORK\lvmen\src\licensedcode\data\rules\gpl-1.0-plus_or_artistic-perl-1.0_18.yml", "YAML", 0, 0, 0, 3, 0, 0, 1, 4
"d:\IDEWORK\lvmen\src\licensedcode\data\rules\gpl-1.0-plus_or_artistic-perl-1.0_19.yml", "YAML", 0, 0, 0, 3, 0, 0, 1, 4
"d:\IDEWORK\lvmen\src\licensedcode\data\rules\gpl-1.0-plus_or_artistic-perl-1.0_2.yml", "YAML", 0, 0, 0, 3, 0, 0, 1, 4
"d:\IDEWORK\lvmen\src\licensedcode\data\rules\gpl-1.0-plus_or_artistic-perl-1.0_20.yml", "YAML", 0, 0, 0, 3, 0, 0, 1, 4
"d:\IDEWORK\lvmen\src\licensedcode\data\rules\gpl-1.0-plus_or_artistic-perl-1.0_21.yml", "YAML", 0, 0, 0, 3, 0, 0, 1, 4
"d:\IDEWORK\lvmen\src\licensedcode\data\rules\gpl-1.0-plus_or_artistic-perl-1.0_22.yml", "YAML", 0, 0, 0, 5, 0, 0, 1, 6
"d:\IDEWORK\lvmen\src\licensedcode\data\rules\gpl-1.0-plus_or_artistic-perl-1.0_23.yml", "YAML", 0, 0, 0, 2, 0, 0, 1, 3
"d:\IDEWORK\lvmen\src\licensedcode\data\rules\gpl-1.0-plus_or_artistic-perl-1.0_24.yml", "YAML", 0, 0, 0, 3, 0, 0, 1, 4
"d:\IDEWORK\lvmen\src\licensedcode\data\rules\gpl-1.0-plus_or_artistic-perl-1.0_25.yml", "YAML", 0, 0, 0, 3, 0, 0, 1, 4
"d:\IDEWORK\lvmen\src\licensedcode\data\rules\gpl-1.0-plus_or_artistic-perl-1.0_26.yml", "YAML", 0, 0, 0, 3, 0, 0, 1, 4
"d:\IDEWORK\lvmen\src\licensedcode\data\rules\gpl-1.0-plus_or_artistic-perl-1.0_27.yml", "YAML", 0, 0, 0, 3, 0, 0, 1, 4
"d:\IDEWORK\lvmen\src\licensedcode\data\rules\gpl-1.0-plus_or_artistic-perl-1.0_28.yml", "YAML", 0, 0, 0, 3, 0, 0, 1, 4
"d:\IDEWORK\lvmen\src\licensedcode\data\rules\gpl-1.0-plus_or_artistic-perl-1.0_29.yml", "YAML", 0, 0, 0, 3, 0, 0, 1, 4
"d:\IDEWORK\lvmen\src\licensedcode\data\rules\gpl-1.0-plus_or_artistic-perl-1.0_3.yml", "YAML", 0, 0, 0, 3, 0, 0, 1, 4
"d:\IDEWORK\lvmen\src\licensedcode\data\rules\gpl-1.0-plus_or_artistic-perl-1.0_30.yml", "YAML", 0, 0, 0, 2, 0, 0, 1, 3
"d:\IDEWORK\lvmen\src\licensedcode\data\rules\gpl-1.0-plus_or_artistic-perl-1.0_31.yml", "YAML", 0, 0, 0, 4, 0, 0, 1, 5
"d:\IDEWORK\lvmen\src\licensedcode\data\rules\gpl-1.0-plus_or_artistic-perl-1.0_32.yml", "YAML", 0, 0, 0, 2, 0, 0, 1, 3
"d:\IDEWORK\lvmen\src\licensedcode\data\rules\gpl-1.0-plus_or_artistic-perl-1.0_33.yml", "YAML", 0, 0, 0, 3, 0, 0, 1, 4
"d:\IDEWORK\lvmen\src\licensedcode\data\rules\gpl-1.0-plus_or_artistic-perl-1.0_34.yml", "YAML", 0, 0, 0, 5, 0, 0, 1, 6
"d:\IDEWORK\lvmen\src\licensedcode\data\rules\gpl-1.0-plus_or_artistic-perl-1.0_35.yml", "YAML", 0, 0, 0, 3, 0, 0, 1, 4
"d:\IDEWORK\lvmen\src\licensedcode\data\rules\gpl-1.0-plus_or_artistic-perl-1.0_36.yml", "YAML", 0, 0, 0, 3, 0, 0, 1, 4
"d:\IDEWORK\lvmen\src\licensedcode\data\rules\gpl-1.0-plus_or_artistic-perl-1.0_37.yml", "YAML", 0, 0, 0, 2, 0, 0, 1, 3
"d:\IDEWORK\lvmen\src\licensedcode\data\rules\gpl-1.0-plus_or_artistic-perl-1.0_38.yml", "YAML", 0, 0, 0, 3, 0, 0, 1, 4
"d:\IDEWORK\lvmen\src\licensedcode\data\rules\gpl-1.0-plus_or_artistic-perl-1.0_39.yml", "YAML", 0, 0, 0, 2, 0, 0, 1, 3
"d:\IDEWORK\lvmen\src\licensedcode\data\rules\gpl-1.0-plus_or_artistic-perl-1.0_4.yml", "YAML", 0, 0, 0, 3, 0, 0, 1, 4
"d:\IDEWORK\lvmen\src\licensedcode\data\rules\gpl-1.0-plus_or_artistic-perl-1.0_40.yml", "YAML", 0, 0, 0, 2, 0, 0, 1, 3
"d:\IDEWORK\lvmen\src\licensedcode\data\rules\gpl-1.0-plus_or_artistic-perl-1.0_41.yml", "YAML", 0, 0, 0, 4, 0, 0, 1, 5
"d:\IDEWORK\lvmen\src\licensedcode\data\rules\gpl-1.0-plus_or_artistic-perl-1.0_42.yml", "YAML", 0, 0, 0, 3, 0, 0, 1, 4
"d:\IDEWORK\lvmen\src\licensedcode\data\rules\gpl-1.0-plus_or_artistic-perl-1.0_43.yml", "YAML", 0, 0, 0, 2, 0, 0, 1, 3
"d:\IDEWORK\lvmen\src\licensedcode\data\rules\gpl-1.0-plus_or_artistic-perl-1.0_44.yml", "YAML", 0, 0, 0, 3, 0, 0, 1, 4
"d:\IDEWORK\lvmen\src\licensedcode\data\rules\gpl-1.0-plus_or_artistic-perl-1.0_5.yml", "YAML", 0, 0, 0, 3, 0, 0, 1, 4
"d:\IDEWORK\lvmen\src\licensedcode\data\rules\gpl-1.0-plus_or_artistic-perl-1.0_6.yml", "YAML", 0, 0, 0, 3, 0, 0, 1, 4
"d:\IDEWORK\lvmen\src\licensedcode\data\rules\gpl-1.0-plus_or_artistic-perl-1.0_7.yml", "YAML", 0, 0, 0, 3, 0, 0, 1, 4
"d:\IDEWORK\lvmen\src\licensedcode\data\rules\gpl-1.0-plus_or_artistic-perl-1.0_8.yml", "YAML", 0, 0, 0, 3, 0, 0, 1, 4
"d:\IDEWORK\lvmen\src\licensedcode\data\rules\gpl-1.0-plus_or_artistic-perl-1.0_9.yml", "YAML", 0, 0, 0, 3, 0, 0, 1, 4
"d:\IDEWORK\lvmen\src\licensedcode\data\rules\gpl-1.0-plus_or_artistic-perl-1.0_and_mit_1.yml", "YAML", 0, 0, 0, 3, 0, 0, 1, 4
"d:\IDEWORK\lvmen\src\licensedcode\data\rules\gpl-1.0-plus_or_bsd-new_1.yml", "YAML", 0, 0, 0, 3, 0, 0, 1, 4
"d:\IDEWORK\lvmen\src\licensedcode\data\rules\gpl-1.0-plus_or_bsd-new_2.yml", "YAML", 0, 0, 0, 3, 0, 0, 1, 4
"d:\IDEWORK\lvmen\src\licensedcode\data\rules\gpl-1.0-plus_or_bsd-new_3.yml", "YAML", 0, 0, 0, 3, 0, 0, 1, 4
"d:\IDEWORK\lvmen\src\licensedcode\data\rules\gpl-1.0-plus_or_bsd-simplified_1.yml", "YAML", 0, 0, 0, 4, 0, 0, 1, 5
"d:\IDEWORK\lvmen\src\licensedcode\data\rules\gpl-1.0-plus_or_cddl-1.0_1.yml", "YAML", 0, 0, 0, 3, 0, 0, 1, 4
"d:\IDEWORK\lvmen\src\licensedcode\data\rules\gpl-1.0-plus_or_commercial-license_1.yml", "YAML", 0, 0, 0, 3, 0, 0, 1, 4
"d:\IDEWORK\lvmen\src\licensedcode\data\rules\gpl-1.0-plus_or_commercial-license_2.yml", "YAML", 0, 0, 0, 3, 0, 0, 1, 4
"d:\IDEWORK\lvmen\src\licensedcode\data\rules\gpl-1.0-plus_or_commercial-license_qt_1.yml", "YAML", 0, 0, 0, 3, 0, 0, 1, 4
"d:\IDEWORK\lvmen\src\licensedcode\data\rules\gpl-1.0-plus_or_cups_1.yml", "YAML", 0, 0, 0, 5, 0, 0, 1, 6
"d:\IDEWORK\lvmen\src\licensedcode\data\rules\gpl-1.0-plus_or_gpl-2.0-plus_or_artistic-1.0_1.yml", "YAML", 0, 0, 0, 5, 0, 0, 1, 6
"d:\IDEWORK\lvmen\src\licensedcode\data\rules\gpl-1.0-plus_or_gpl-2.0-plus_or_artistic-1.0_2.yml", "YAML", 0, 0, 0, 5, 0, 0, 1, 6
"d:\IDEWORK\lvmen\src\licensedcode\data\rules\gpl-1.0-plus_or_lgpl-2.0-plus_1.yml", "YAML", 0, 0, 0, 3, 0, 0, 1, 4
"d:\IDEWORK\lvmen\src\licensedcode\data\rules\gpl-1.0-plus_or_lgpl-2.0-plus_2.yml", "YAML", 0, 0, 0, 2, 0, 0, 1, 3
"d:\IDEWORK\lvmen\src\licensedcode\data\rules\gpl-1.0-plus_or_lgpl-2.0-plus_3.yml", "YAML", 0, 0, 0, 6, 0, 0, 1, 7
"d:\IDEWORK\lvmen\src\licensedcode\data\rules\gpl-1.0-plus_or_lgpl-2.0-plus_4.yml", "YAML", 0, 0, 0, 4, 0, 0, 1, 5
"d:\IDEWORK\lvmen\src\licensedcode\data\rules\gpl-1.0-plus_or_mit_1.yml", "YAML", 0, 0, 0, 2, 0, 0, 1, 3
"d:\IDEWORK\lvmen\src\licensedcode\data\rules\gpl-1.0-plus_or_mit_2.yml", "YAML", 0, 0, 0, 4, 0, 0, 1, 5
"d:\IDEWORK\lvmen\src\licensedcode\data\rules\gpl-1.0-plus_or_mit_3.yml", "YAML", 0, 0, 0, 3, 0, 0, 1, 4
"d:\IDEWORK\lvmen\src\licensedcode\data\rules\gpl-1.0-plus_or_mit_4.yml", "YAML", 0, 0, 0, 2, 0, 0, 1, 3
"d:\IDEWORK\lvmen\src\licensedcode\data\rules\gpl-1.0-plus_or_other-copyleft_1.yml", "YAML", 0, 0, 0, 6, 0, 0, 1, 7
"d:\IDEWORK\lvmen\src\licensedcode\data\rules\gpl-1.0-plus_or_other-copyleft_2.yml", "YAML", 0, 0, 0, 6, 0, 0, 1, 7
"d:\IDEWORK\lvmen\src\licensedcode\data\rules\gpl-1.0-plus_or_proprietary-license_1.yml", "YAML", 0, 0, 0, 3, 0, 0, 1, 4
"d:\IDEWORK\lvmen\src\licensedcode\data\rules\gpl-1.0-plus_or_python.yml", "YAML", 0, 0, 0, 3, 0, 0, 1, 4
"d:\IDEWORK\lvmen\src\licensedcode\data\rules\gpl-1.0-plus_or_ruby.yml", "YAML", 0, 0, 0, 3, 0, 0, 1, 4
"d:\IDEWORK\lvmen\src\licensedcode\data\rules\gpl-1.0-plus_or_ruby2.yml", "YAML", 0, 0, 0, 3, 0, 0, 1, 4
"d:\IDEWORK\lvmen\src\licensedcode\data\rules\gpl-1.0-plus_or_ruby3.yml", "YAML", 0, 0, 0, 3, 0, 0, 1, 4
"d:\IDEWORK\lvmen\src\licensedcode\data\rules\gpl-1.0-plus_or_ruby4.yml", "YAML", 0, 0, 0, 3, 0, 0, 1, 4
"d:\IDEWORK\lvmen\src\licensedcode\data\rules\gpl-1.0-plus_osi_url_1.yml", "YAML", 0, 0, 0, 7, 0, 0, 1, 8
"d:\IDEWORK\lvmen\src\licensedcode\data\rules\gpl-1.0-plus_osi_url_2.yml", "YAML", 0, 0, 0, 7, 0, 0, 1, 8
"d:\IDEWORK\lvmen\src\licensedcode\data\rules\gpl-1.0-plus_terse.yml", "YAML", 0, 0, 0, 3, 0, 0, 1, 4
"d:\IDEWORK\lvmen\src\licensedcode\data\rules\gpl-1.0-plus_terse_3.yml", "YAML", 0, 0, 0, 3, 0, 0, 1, 4
"d:\IDEWORK\lvmen\src\licensedcode\data\rules\gpl-1.0-plus_theme.yml", "YAML", 0, 0, 0, 5, 0, 0, 1, 6
"d:\IDEWORK\lvmen\src\licensedcode\data\rules\gpl-1.0-plus_url_1.yml", "YAML", 0, 0, 0, 5, 0, 0, 1, 6
"d:\IDEWORK\lvmen\src\licensedcode\data\rules\gpl-1.0-plus_url_2.yml", "YAML", 0, 0, 0, 5, 0, 0, 1, 6
"d:\IDEWORK\lvmen\src\licensedcode\data\rules\gpl-1.0-plus_with_autoconf-exception-2.0_1.yml", "YAML", 0, 0, 0, 3, 0, 0, 1, 4
"d:\IDEWORK\lvmen\src\licensedcode\data\rules\gpl-1.0-plus_with_autoconf-macro-exception_1.yml", "YAML", 0, 0, 0, 2, 0, 0, 1, 3
"d:\IDEWORK\lvmen\src\licensedcode\data\rules\gpl-1.0-plus_with_autoconf-macro-exception_2.yml", "YAML", 0, 0, 0, 2, 0, 0, 1, 3
"d:\IDEWORK\lvmen\src\licensedcode\data\rules\gpl-1.0-plus_with_autoconf-simple-exception-2.0_1.yml", "YAML", 0, 0, 0, 2, 0, 0, 1, 3
"d:\IDEWORK\lvmen\src\licensedcode\data\rules\gpl-1.0-plus_with_autoconf-simple-exception-2.0_2.yml", "YAML", 0, 0, 0, 2, 0, 0, 1, 3
"d:\IDEWORK\lvmen\src\licensedcode\data\rules\gpl-1.0-plus_with_autoconf-simple-exception-2.0_3.yml", "YAML", 0, 0, 0, 2, 0, 0, 1, 3
"d:\IDEWORK\lvmen\src\licensedcode\data\rules\gpl-1.0-plus_with_bison-exception-2.0_1.yml", "YAML", 0, 0, 0, 2, 0, 0, 1, 3
"d:\IDEWORK\lvmen\src\licensedcode\data\rules\gpl-1.0-plus_with_classpath-exception-2.0_1.yml", "YAML", 0, 0, 0, 3, 0, 0, 1, 4
"d:\IDEWORK\lvmen\src\licensedcode\data\rules\gpl-1.0-plus_with_classpath-exception-2.0_2.yml", "YAML", 0, 0, 0, 3, 0, 0, 1, 4
"d:\IDEWORK\lvmen\src\licensedcode\data\rules\gpl-1.0-plus_with_gcc-linking-exception-2.0_1.yml", "YAML", 0, 0, 0, 3, 0, 0, 1, 4
"d:\IDEWORK\lvmen\src\licensedcode\data\rules\gpl-1.0-plus_with_generic-exception_1.yml", "YAML", 0, 0, 0, 3, 0, 0, 1, 4
"d:\IDEWORK\lvmen\src\licensedcode\data\rules\gpl-1.0-plus_with_libtool-exception-2.0_1.yml", "YAML", 0, 0, 0, 6, 0, 0, 1, 7
"d:\IDEWORK\lvmen\src\licensedcode\data\rules\gpl-1.0-plus_with_libtool-exception-2.0_2.yml", "YAML", 0, 0, 0, 7, 0, 0, 1, 8
"d:\IDEWORK\lvmen\src\licensedcode\data\rules\gpl-1.0-plus_with_lmbench-exception-2.0_1.yml", "YAML", 0, 0, 0, 5, 0, 0, 1, 6
"d:\IDEWORK\lvmen\src\licensedcode\data\rules\gpl-1.0-plus_with_openssl-exception-gpl-2.0_1.yml", "YAML", 0, 0, 0, 3, 0, 0, 1, 4
"d:\IDEWORK\lvmen\src\licensedcode\data\rules\gpl-1.0-plus_with_openssl-exception-gpl-3.0-plus_and_other-permissive_1.yml", "YAML", 0, 0, 0, 3, 0, 0, 1, 4
"d:\IDEWORK\lvmen\src\licensedcode\data\rules\gpl-1.0-plus_with_ps-or-pdf-font-exception-20170817_1.yml", "YAML", 0, 0, 0, 5, 0, 0, 1, 6
"d:\IDEWORK\lvmen\src\licensedcode\data\rules\gpl-1.0.SPDX.yml", "YAML", 0, 0, 0, 10, 0, 0, 1, 11
"d:\IDEWORK\lvmen\src\licensedcode\data\rules\gpl-1.0.yml", "YAML", 0, 0, 0, 3, 0, 0, 1, 4
"d:\IDEWORK\lvmen\src\licensedcode\data\rules\gpl-1.0_1.yml", "YAML", 0, 0, 0, 2, 0, 0, 1, 3
"d:\IDEWORK\lvmen\src\licensedcode\data\rules\gpl-1.0_10.yml", "YAML", 0, 0, 0, 3, 0, 0, 1, 4
"d:\IDEWORK\lvmen\src\licensedcode\data\rules\gpl-1.0_11.yml", "YAML", 0, 0, 0, 10, 0, 0, 1, 11
"d:\IDEWORK\lvmen\src\licensedcode\data\rules\gpl-1.0_12.yml", "YAML", 0, 0, 0, 3, 0, 0, 1, 4
"d:\IDEWORK\lvmen\src\licensedcode\data\rules\gpl-1.0_13.yml", "YAML", 0, 0, 0, 3, 0, 0, 1, 4
"d:\IDEWORK\lvmen\src\licensedcode\data\rules\gpl-1.0_14.yml", "YAML", 0, 0, 0, 3, 0, 0, 1, 4
"d:\IDEWORK\lvmen\src\licensedcode\data\rules\gpl-1.0_15.yml", "YAML", 0, 0, 0, 4, 0, 0, 1, 5
"d:\IDEWORK\lvmen\src\licensedcode\data\rules\gpl-1.0_16.yml", "YAML", 0, 0, 0, 5, 0, 0, 1, 6
"d:\IDEWORK\lvmen\src\licensedcode\data\rules\gpl-1.0_17.yml", "YAML", 0, 0, 0, 3, 0, 0, 1, 4
"d:\IDEWORK\lvmen\src\licensedcode\data\rules\gpl-1.0_18.yml", "YAML", 0, 0, 0, 3, 0, 0, 1, 4
"d:\IDEWORK\lvmen\src\licensedcode\data\rules\gpl-1.0_19.yml", "YAML", 0, 0, 0, 3, 0, 0, 1, 4
"d:\IDEWORK\lvmen\src\licensedcode\data\rules\gpl-1.0_2.yml", "YAML", 0, 0, 0, 5, 0, 0, 1, 6
"d:\IDEWORK\lvmen\src\licensedcode\data\rules\gpl-1.0_20.yml", "YAML", 0, 0, 0, 3, 0, 0, 1, 4
"d:\IDEWORK\lvmen\src\licensedcode\data\rules\gpl-1.0_21.yml", "YAML", 0, 0, 0, 3, 0, 0, 1, 4
"d:\IDEWORK\lvmen\src\licensedcode\data\rules\gpl-1.0_22.yml", "YAML", 0, 0, 0, 3, 0, 0, 1, 4
"d:\IDEWORK\lvmen\src\licensedcode\data\rules\gpl-1.0_23.yml", "YAML", 0, 0, 0, 3, 0, 0, 1, 4
"d:\IDEWORK\lvmen\src\licensedcode\data\rules\gpl-1.0_24.yml", "YAML", 0, 0, 0, 3, 0, 0, 1, 4
"d:\IDEWORK\lvmen\src\licensedcode\data\rules\gpl-1.0_25.yml", "YAML", 0, 0, 0, 3, 0, 0, 1, 4
"d:\IDEWORK\lvmen\src\licensedcode\data\rules\gpl-1.0_26.yml", "YAML", 0, 0, 0, 3, 0, 0, 1, 4
"d:\IDEWORK\lvmen\src\licensedcode\data\rules\gpl-1.0_27.yml", "YAML", 0, 0, 0, 3, 0, 0, 1, 4
"d:\IDEWORK\lvmen\src\licensedcode\data\rules\gpl-1.0_28.yml", "YAML", 0, 0, 0, 3, 0, 0, 1, 4
"d:\IDEWORK\lvmen\src\licensedcode\data\rules\gpl-1.0_29.yml", "YAML", 0, 0, 0, 3, 0, 0, 1, 4
"d:\IDEWORK\lvmen\src\licensedcode\data\rules\gpl-1.0_3.yml", "YAML", 0, 0, 0, 5, 0, 0, 1, 6
"d:\IDEWORK\lvmen\src\licensedcode\data\rules\gpl-1.0_30.yml", "YAML", 0, 0, 0, 3, 0, 0, 1, 4
"d:\IDEWORK\lvmen\src\licensedcode\data\rules\gpl-1.0_31.yml", "YAML", 0, 0, 0, 3, 0, 0, 1, 4
"d:\IDEWORK\lvmen\src\licensedcode\data\rules\gpl-1.0_32.yml", "YAML", 0, 0, 0, 3, 0, 0, 1, 4
"d:\IDEWORK\lvmen\src\licensedcode\data\rules\gpl-1.0_33.yml", "YAML", 0, 0, 0, 3, 0, 0, 1, 4
"d:\IDEWORK\lvmen\src\licensedcode\data\rules\gpl-1.0_34.yml", "YAML", 0, 0, 0, 3, 0, 0, 1, 4
"d:\IDEWORK\lvmen\src\licensedcode\data\rules\gpl-1.0_35.yml", "YAML", 0, 0, 0, 3, 0, 0, 1, 4
"d:\IDEWORK\lvmen\src\licensedcode\data\rules\gpl-1.0_36.yml", "YAML", 0, 0, 0, 3, 0, 0, 1, 4
"d:\IDEWORK\lvmen\src\licensedcode\data\rules\gpl-1.0_37.yml", "YAML", 0, 0, 0, 3, 0, 0, 1, 4
"d:\IDEWORK\lvmen\src\licensedcode\data\rules\gpl-1.0_38.yml", "YAML", 0, 0, 0, 3, 0, 0, 1, 4
"d:\IDEWORK\lvmen\src\licensedcode\data\rules\gpl-1.0_39.yml", "YAML", 0, 0, 0, 7, 0, 0, 1, 8
"d:\IDEWORK\lvmen\src\licensedcode\data\rules\gpl-1.0_4.yml", "YAML", 0, 0, 0, 5, 0, 0, 1, 6
"d:\IDEWORK\lvmen\src\licensedcode\data\rules\gpl-1.0_40.yml", "YAML", 0, 0, 0, 3, 0, 0, 1, 4
"d:\IDEWORK\lvmen\src\licensedcode\data\rules\gpl-1.0_41.yml", "YAML", 0, 0, 0, 3, 0, 0, 1, 4
"d:\IDEWORK\lvmen\src\licensedcode\data\rules\gpl-1.0_42.yml", "YAML", 0, 0, 0, 3, 0, 0, 1, 4
"d:\IDEWORK\lvmen\src\licensedcode\data\rules\gpl-1.0_43.yml", "YAML", 0, 0, 0, 3, 0, 0, 1, 4
"d:\IDEWORK\lvmen\src\licensedcode\data\rules\gpl-1.0_44.yml", "YAML", 0, 0, 0, 3, 0, 0, 1, 4
"d:\IDEWORK\lvmen\src\licensedcode\data\rules\gpl-1.0_45.yml", "YAML", 0, 0, 0, 3, 0, 0, 1, 4
"d:\IDEWORK\lvmen\src\licensedcode\data\rules\gpl-1.0_46.yml", "YAML", 0, 0, 0, 3, 0, 0, 1, 4
"d:\IDEWORK\lvmen\src\licensedcode\data\rules\gpl-1.0_47.yml", "YAML", 0, 0, 0, 3, 0, 0, 1, 4
"d:\IDEWORK\lvmen\src\licensedcode\data\rules\gpl-1.0_48.yml", "YAML", 0, 0, 0, 3, 0, 0, 1, 4
"d:\IDEWORK\lvmen\src\licensedcode\data\rules\gpl-1.0_49.yml", "YAML", 0, 0, 0, 3, 0, 0, 1, 4
"d:\IDEWORK\lvmen\src\licensedcode\data\rules\gpl-1.0_5.yml", "YAML", 0, 0, 0, 2, 0, 0, 1, 3
"d:\IDEWORK\lvmen\src\licensedcode\data\rules\gpl-1.0_50.yml", "YAML", 0, 0, 0, 3, 0, 0, 1, 4
"d:\IDEWORK\lvmen\src\licensedcode\data\rules\gpl-1.0_51.yml", "YAML", 0, 0, 0, 3, 0, 0, 1, 4
"d:\IDEWORK\lvmen\src\licensedcode\data\rules\gpl-1.0_52.yml", "YAML", 0, 0, 0, 3, 0, 0, 1, 4
"d:\IDEWORK\lvmen\src\licensedcode\data\rules\gpl-1.0_53.yml", "YAML", 0, 0, 0, 3, 0, 0, 1, 4
"d:\IDEWORK\lvmen\src\licensedcode\data\rules\gpl-1.0_54.yml", "YAML", 0, 0, 0, 3, 0, 0, 1, 4
"d:\IDEWORK\lvmen\src\licensedcode\data\rules\gpl-1.0_55.yml", "YAML", 0, 0, 0, 3, 0, 0, 1, 4
"d:\IDEWORK\lvmen\src\licensedcode\data\rules\gpl-1.0_56.yml", "YAML", 0, 0, 0, 3, 0, 0, 1, 4
"d:\IDEWORK\lvmen\src\licensedcode\data\rules\gpl-1.0_57.yml", "YAML", 0, 0, 0, 5, 0, 0, 1, 6
"d:\IDEWORK\lvmen\src\licensedcode\data\rules\gpl-1.0_6.yml", "YAML", 0, 0, 0, 2, 0, 0, 1, 3
"d:\IDEWORK\lvmen\src\licensedcode\data\rules\gpl-1.0_7.yml", "YAML", 0, 0, 0, 3, 0, 0, 1, 4
"d:\IDEWORK\lvmen\src\licensedcode\data\rules\gpl-1.0_8.yml", "YAML", 0, 0, 0, 3, 0, 0, 1, 4
"d:\IDEWORK\lvmen\src\licensedcode\data\rules\gpl-1.0_9.yml", "YAML", 0, 0, 0, 8, 0, 0, 1, 9
"d:\IDEWORK\lvmen\src\licensedcode\data\rules\gpl-1.0_gpl_10_bare_words.yml", "YAML", 0, 0, 0, 4, 0, 0, 2, 6
"d:\IDEWORK\lvmen\src\licensedcode\data\rules\gpl-1.0_only_terse_1.yml", "YAML", 0, 0, 0, 3, 0, 0, 1, 4
"d:\IDEWORK\lvmen\src\licensedcode\data\rules\gpl-1.0_or_gpl-2.0.yml", "YAML", 0, 0, 0, 2, 0, 0, 1, 3
"d:\IDEWORK\lvmen\src\licensedcode\data\rules\gpl-1.0_or_gpl-2.0_or_gpl-3.0_or_commercial-license_1.yml", "YAML", 0, 0, 0, 4, 0, 0, 1, 5
"d:\IDEWORK\lvmen\src\licensedcode\data\rules\gpl-1.0_or_gpl-2.0_or_gpl-3.0_or_commercial-license_2.yml", "YAML", 0, 0, 0, 4, 0, 0, 1, 5
"d:\IDEWORK\lvmen\src\licensedcode\data\rules\gpl-1.0_or_gpl-2.0_or_gpl-3.0_or_commercial-license_3.yml", "YAML", 0, 0, 0, 4, 0, 0, 1, 5
"d:\IDEWORK\lvmen\src\licensedcode\data\rules\gpl-1.0_or_gpl-2.0_or_gpl-3.0_or_commercial-license_4.yml", "YAML", 0, 0, 0, 6, 0, 0, 1, 7
"d:\IDEWORK\lvmen\src\licensedcode\data\rules\gpl-1.0_or_gpl-2.0_or_gpl-3.0_or_commercial-license_5.yml", "YAML", 0, 0, 0, 6, 0, 0, 1, 7
"d:\IDEWORK\lvmen\src\licensedcode\data\rules\gpl-1.0_url_1.yml", "YAML", 0, 0, 0, 5, 0, 0, 1, 6
"d:\IDEWORK\lvmen\src\licensedcode\data\rules\gpl-1.0_url_2.yml", "YAML", 0, 0, 0, 5, 0, 0, 1, 6
"d:\IDEWORK\lvmen\src\licensedcode\data\rules\gpl-1.0_url_glc_129.yml", "YAML", 0, 0, 0, 5, 0, 0, 1, 6
"d:\IDEWORK\lvmen\src\licensedcode\data\rules\gpl-1.0_with_bash-exception-gpl_1.yml", "YAML", 0, 0, 0, 10, 0, 0, 1, 11
"d:\IDEWORK\lvmen\src\licensedcode\data\rules\gpl-2.0-clisp.yml", "YAML", 0, 0, 0, 2, 0, 0, 1, 3
"d:\IDEWORK\lvmen\src\licensedcode\data\rules\gpl-2.0-clisp_1.yml", "YAML", 0, 0, 0, 2, 0, 0, 1, 3
"d:\IDEWORK\lvmen\src\licensedcode\data\rules\gpl-2.0-cygwin_1.yml", "YAML", 0, 0, 0, 5, 0, 0, 1, 6
"d:\IDEWORK\lvmen\src\licensedcode\data\rules\gpl-2.0-font.SPDX.yml", "YAML", 0, 0, 0, 4, 0, 0, 1, 5
"d:\IDEWORK\lvmen\src\licensedcode\data\rules\gpl-2.0-font.yml", "YAML", 0, 0, 0, 5, 0, 0, 1, 6
"d:\IDEWORK\lvmen\src\licensedcode\data\rules\gpl-2.0-freertos.yml", "YAML", 0, 0, 0, 2, 0, 0, 1, 3
"d:\IDEWORK\lvmen\src\licensedcode\data\rules\gpl-2.0-freertos_2.yml", "YAML", 0, 0, 0, 4, 0, 0, 1, 5
"d:\IDEWORK\lvmen\src\licensedcode\data\rules\gpl-2.0-freertos_3.yml", "YAML", 0, 0, 0, 4, 0, 0, 1, 5
"d:\IDEWORK\lvmen\src\licensedcode\data\rules\gpl-2.0-gcc-compiler-exception.yml", "YAML", 0, 0, 0, 2, 0, 0, 1, 3
"d:\IDEWORK\lvmen\src\licensedcode\data\rules\gpl-2.0-gcc-compiler-exception_1.yml", "YAML", 0, 0, 0, 4, 0, 0, 1, 5
"d:\IDEWORK\lvmen\src\licensedcode\data\rules\gpl-2.0-gcc-compiler-exception_2.yml", "YAML", 0, 0, 0, 4, 0, 0, 1, 5
"d:\IDEWORK\lvmen\src\licensedcode\data\rules\gpl-2.0-gcc.SPDX.yml", "YAML", 0, 0, 0, 4, 0, 0, 1, 5
"d:\IDEWORK\lvmen\src\licensedcode\data\rules\gpl-2.0-gcc_1.yml", "YAML", 0, 0, 0, 5, 0, 0, 1, 6
"d:\IDEWORK\lvmen\src\licensedcode\data\rules\gpl-2.0-gcc_2.yml", "YAML", 0, 0, 0, 2, 0, 0, 1, 3
"d:\IDEWORK\lvmen\src\licensedcode\data\rules\gpl-2.0-glibc_3.yml", "YAML", 0, 0, 0, 2, 0, 0, 1, 3
"d:\IDEWORK\lvmen\src\licensedcode\data\rules\gpl-2.0-glibc_4.yml", "YAML", 0, 0, 0, 2, 0, 0, 1, 3
"d:\IDEWORK\lvmen\src\licensedcode\data\rules\gpl-2.0-guile.yml", "YAML", 0, 0, 0, 2, 0, 0, 1, 3
"d:\IDEWORK\lvmen\src\licensedcode\data\rules\gpl-2.0-guile2.yml", "YAML", 0, 0, 0, 3, 0, 0, 1, 4
"d:\IDEWORK\lvmen\src\licensedcode\data\rules\gpl-2.0-guile3.yml", "YAML", 0, 0, 0, 3, 0, 0, 1, 4
"d:\IDEWORK\lvmen\src\licensedcode\data\rules\gpl-2.0-javascript.yml", "YAML", 0, 0, 0, 3, 0, 0, 1, 4
"d:\IDEWORK\lvmen\src\licensedcode\data\rules\gpl-2.0-javascript_1.yml", "YAML", 0, 0, 0, 3, 0, 0, 1, 4
"d:\IDEWORK\lvmen\src\licensedcode\data\rules\gpl-2.0-mysql-connector-odbc.yml", "YAML", 0, 0, 0, 3, 0, 0, 1, 4
"d:\IDEWORK\lvmen\src\licensedcode\data\rules\gpl-2.0-mysql-connector-odbc_1.yml", "YAML", 0, 0, 0, 4, 0, 0, 1, 5
"d:\IDEWORK\lvmen\src\licensedcode\data\rules\gpl-2.0-mysql-connector-odbc_2.yml", "YAML", 0, 0, 0, 3, 0, 0, 1, 4
"d:\IDEWORK\lvmen\src\licensedcode\data\rules\gpl-2.0-mysql-floss.yml", "YAML", 0, 0, 0, 5, 0, 0, 1, 6
"d:\IDEWORK\lvmen\src\licensedcode\data\rules\gpl-2.0-mysql-floss_1.yml", "YAML", 0, 0, 0, 5, 0, 0, 1, 6
"d:\IDEWORK\lvmen\src\licensedcode\data\rules\gpl-2.0-mysql-floss_10.yml", "YAML", 0, 0, 0, 7, 0, 0, 1, 8
"d:\IDEWORK\lvmen\src\licensedcode\data\rules\gpl-2.0-mysql-floss_2.yml", "YAML", 0, 0, 0, 3, 0, 0, 1, 4
"d:\IDEWORK\lvmen\src\licensedcode\data\rules\gpl-2.0-mysql-floss_3.yml", "YAML", 0, 0, 0, 3, 0, 0, 1, 4
"d:\IDEWORK\lvmen\src\licensedcode\data\rules\gpl-2.0-mysql-floss_4.yml", "YAML", 0, 0, 0, 5, 0, 0, 1, 6
"d:\IDEWORK\lvmen\src\licensedcode\data\rules\gpl-2.0-mysql-floss_5.yml", "YAML", 0, 0, 0, 5, 0, 0, 1, 6
"d:\IDEWORK\lvmen\src\licensedcode\data\rules\gpl-2.0-openssl.yml", "YAML", 0, 0, 0, 5, 0, 0, 1, 6
"d:\IDEWORK\lvmen\src\licensedcode\data\rules\gpl-2.0-openssl_2.yml", "YAML", 0, 0, 0, 7, 0, 0, 1, 8
"d:\IDEWORK\lvmen\src\licensedcode\data\rules\gpl-2.0-oracle-mysql-foss_1.yml", "YAML", 0, 0, 0, 6, 0, 0, 1, 7
"d:\IDEWORK\lvmen\src\licensedcode\data\rules\gpl-2.0-plus.yml", "YAML", 0, 0, 0, 2, 0, 0, 1, 3
"d:\IDEWORK\lvmen\src\licensedcode\data\rules\gpl-2.0-plus_0.yml", "YAML", 0, 0, 0, 6, 0, 0, 1, 7
"d:\IDEWORK\lvmen\src\licensedcode\data\rules\gpl-2.0-plus_1.yml", "YAML", 0, 0, 0, 4, 0, 0, 1, 5
"d:\IDEWORK\lvmen\src\licensedcode\data\rules\gpl-2.0-plus_10.yml", "YAML", 0, 0, 0, 5, 0, 0, 1, 6
"d:\IDEWORK\lvmen\src\licensedcode\data\rules\gpl-2.0-plus_100.yml", "YAML", 0, 0, 0, 5, 0, 0, 1, 6
"d:\IDEWORK\lvmen\src\licensedcode\data\rules\gpl-2.0-plus_1000.yml", "YAML", 0, 0, 0, 3, 0, 0, 1, 4
"d:\IDEWORK\lvmen\src\licensedcode\data\rules\gpl-2.0-plus_1001.yml", "YAML", 0, 0, 0, 3, 0, 0, 1, 4
"d:\IDEWORK\lvmen\src\licensedcode\data\rules\gpl-2.0-plus_1002.yml", "YAML", 0, 0, 0, 5, 0, 0, 1, 6
"d:\IDEWORK\lvmen\src\licensedcode\data\rules\gpl-2.0-plus_1003.yml", "YAML", 0, 0, 0, 7, 0, 0, 1, 8
"d:\IDEWORK\lvmen\src\licensedcode\data\rules\gpl-2.0-plus_1004.yml", "YAML", 0, 0, 0, 7, 0, 0, 1, 8
"d:\IDEWORK\lvmen\src\licensedcode\data\rules\gpl-2.0-plus_1005.yml", "YAML", 0, 0, 0, 7, 0, 0, 1, 8
"d:\IDEWORK\lvmen\src\licensedcode\data\rules\gpl-2.0-plus_1006.yml", "YAML", 0, 0, 0, 5, 0, 0, 1, 6
"d:\IDEWORK\lvmen\src\licensedcode\data\rules\gpl-2.0-plus_1007.yml", "YAML", 0, 0, 0, 5, 0, 0, 1, 6
"d:\IDEWORK\lvmen\src\licensedcode\data\rules\gpl-2.0-plus_1008.yml", "YAML", 0, 0, 0, 5, 0, 0, 1, 6
"d:\IDEWORK\lvmen\src\licensedcode\data\rules\gpl-2.0-plus_1009.yml", "YAML", 0, 0, 0, 7, 0, 0, 1, 8
"d:\IDEWORK\lvmen\src\licensedcode\data\rules\gpl-2.0-plus_101.yml", "YAML", 0, 0, 0, 2, 0, 0, 1, 3
"d:\IDEWORK\lvmen\src\licensedcode\data\rules\gpl-2.0-plus_1010.yml", "YAML", 0, 0, 0, 6, 0, 0, 1, 7
"d:\IDEWORK\lvmen\src\licensedcode\data\rules\gpl-2.0-plus_1011.yml", "YAML", 0, 0, 0, 5, 0, 0, 1, 6
"d:\IDEWORK\lvmen\src\licensedcode\data\rules\gpl-2.0-plus_1012.yml", "YAML", 0, 0, 0, 5, 0, 0, 1, 6
"d:\IDEWORK\lvmen\src\licensedcode\data\rules\gpl-2.0-plus_1013.yml", "YAML", 0, 0, 0, 3, 0, 0, 1, 4
"d:\IDEWORK\lvmen\src\licensedcode\data\rules\gpl-2.0-plus_1014.yml", "YAML", 0, 0, 0, 5, 0, 0, 1, 6
"d:\IDEWORK\lvmen\src\licensedcode\data\rules\gpl-2.0-plus_1015.yml", "YAML", 0, 0, 0, 5, 0, 0, 1, 6
"d:\IDEWORK\lvmen\src\licensedcode\data\rules\gpl-2.0-plus_1016.yml", "YAML", 0, 0, 0, 7, 0, 0, 1, 8
"d:\IDEWORK\lvmen\src\licensedcode\data\rules\gpl-2.0-plus_1017.yml", "YAML", 0, 0, 0, 3, 0, 0, 1, 4
"d:\IDEWORK\lvmen\src\licensedcode\data\rules\gpl-2.0-plus_1018.yml", "YAML", 0, 0, 0, 5, 0, 0, 1, 6
"d:\IDEWORK\lvmen\src\licensedcode\data\rules\gpl-2.0-plus_1019.yml", "YAML", 0, 0, 0, 5, 0, 0, 1, 6
"d:\IDEWORK\lvmen\src\licensedcode\data\rules\gpl-2.0-plus_102.yml", "YAML", 0, 0, 0, 6, 0, 0, 1, 7
"d:\IDEWORK\lvmen\src\licensedcode\data\rules\gpl-2.0-plus_1020.yml", "YAML", 0, 0, 0, 6, 0, 0, 1, 7
"d:\IDEWORK\lvmen\src\licensedcode\data\rules\gpl-2.0-plus_1021.yml", "YAML", 0, 0, 0, 4, 0, 0, 1, 5
"d:\IDEWORK\lvmen\src\licensedcode\data\rules\gpl-2.0-plus_1022.yml", "YAML", 0, 0, 0, 3, 0, 0, 1, 4
"d:\IDEWORK\lvmen\src\licensedcode\data\rules\gpl-2.0-plus_1023.yml", "YAML", 0, 0, 0, 4, 0, 0, 1, 5
"d:\IDEWORK\lvmen\src\licensedcode\data\rules\gpl-2.0-plus_1024.yml", "YAML", 0, 0, 0, 3, 0, 0, 1, 4
"d:\IDEWORK\lvmen\src\licensedcode\data\rules\gpl-2.0-plus_1025.yml", "YAML", 0, 0, 0, 4, 0, 0, 1, 5
"d:\IDEWORK\lvmen\src\licensedcode\data\rules\gpl-2.0-plus_1026.yml", "YAML", 0, 0, 0, 7, 0, 0, 1, 8
"d:\IDEWORK\lvmen\src\licensedcode\data\rules\gpl-2.0-plus_1027.yml", "YAML", 0, 0, 0, 4, 0, 0, 1, 5
"d:\IDEWORK\lvmen\src\licensedcode\data\rules\gpl-2.0-plus_1028.yml", "YAML", 0, 0, 0, 4, 0, 0, 1, 5
"d:\IDEWORK\lvmen\src\licensedcode\data\rules\gpl-2.0-plus_1029.yml", "YAML", 0, 0, 0, 5, 0, 0, 1, 6
"d:\IDEWORK\lvmen\src\licensedcode\data\rules\gpl-2.0-plus_103.yml", "YAML", 0, 0, 0, 3, 0, 0, 1, 4
"d:\IDEWORK\lvmen\src\licensedcode\data\rules\gpl-2.0-plus_1030.yml", "YAML", 0, 0, 0, 5, 0, 0, 1, 6
"d:\IDEWORK\lvmen\src\licensedcode\data\rules\gpl-2.0-plus_1031.yml", "YAML", 0, 0, 0, 3, 0, 0, 1, 4
"d:\IDEWORK\lvmen\src\licensedcode\data\rules\gpl-2.0-plus_1032.yml", "YAML", 0, 0, 0, 5, 0, 0, 1, 6
"d:\IDEWORK\lvmen\src\licensedcode\data\rules\gpl-2.0-plus_1033.yml", "YAML", 0, 0, 0, 7, 0, 0, 1, 8
"d:\IDEWORK\lvmen\src\licensedcode\data\rules\gpl-2.0-plus_1034.yml", "YAML", 0, 0, 0, 7, 0, 0, 1, 8
"d:\IDEWORK\lvmen\src\licensedcode\data\rules\gpl-2.0-plus_1035.yml", "YAML", 0, 0, 0, 2, 0, 0, 1, 3
"d:\IDEWORK\lvmen\src\licensedcode\data\rules\gpl-2.0-plus_1036.yml", "YAML", 0, 0, 0, 6, 0, 0, 1, 7
"d:\IDEWORK\lvmen\src\licensedcode\data\rules\gpl-2.0-plus_1037.yml", "YAML", 0, 0, 0, 2, 0, 0, 1, 3
"d:\IDEWORK\lvmen\src\licensedcode\data\rules\gpl-2.0-plus_1038.yml", "YAML", 0, 0, 0, 4, 0, 0, 1, 5
"d:\IDEWORK\lvmen\src\licensedcode\data\rules\gpl-2.0-plus_1039.yml", "YAML", 0, 0, 0, 2, 0, 0, 1, 3
"d:\IDEWORK\lvmen\src\licensedcode\data\rules\gpl-2.0-plus_104.yml", "YAML", 0, 0, 0, 3, 0, 0, 1, 4
"d:\IDEWORK\lvmen\src\licensedcode\data\rules\gpl-2.0-plus_1040.yml", "YAML", 0, 0, 0, 4, 0, 0, 1, 5
"d:\IDEWORK\lvmen\src\licensedcode\data\rules\gpl-2.0-plus_1041.yml", "YAML", 0, 0, 0, 3, 0, 0, 1, 4
"d:\IDEWORK\lvmen\src\licensedcode\data\rules\gpl-2.0-plus_1042.yml", "YAML", 0, 0, 0, 2, 0, 0, 1, 3
"d:\IDEWORK\lvmen\src\licensedcode\data\rules\gpl-2.0-plus_1043.yml", "YAML", 0, 0, 0, 4, 0, 0, 1, 5
"d:\IDEWORK\lvmen\src\licensedcode\data\rules\gpl-2.0-plus_1044.yml", "YAML", 0, 0, 0, 4, 0, 0, 1, 5
"d:\IDEWORK\lvmen\src\licensedcode\data\rules\gpl-2.0-plus_105.yml", "YAML", 0, 0, 0, 3, 0, 0, 1, 4
"d:\IDEWORK\lvmen\src\licensedcode\data\rules\gpl-2.0-plus_106.yml", "YAML", 0, 0, 0, 4, 0, 0, 1, 5
"d:\IDEWORK\lvmen\src\licensedcode\data\rules\gpl-2.0-plus_107.yml", "YAML", 0, 0, 0, 2, 0, 0, 1, 3
"d:\IDEWORK\lvmen\src\licensedcode\data\rules\gpl-2.0-plus_108.yml", "YAML", 0, 0, 0, 2, 0, 0, 1, 3
"d:\IDEWORK\lvmen\src\licensedcode\data\rules\gpl-2.0-plus_109.yml", "YAML", 0, 0, 0, 7, 0, 0, 1, 8
"d:\IDEWORK\lvmen\src\licensedcode\data\rules\gpl-2.0-plus_11.yml", "YAML", 0, 0, 0, 2, 0, 0, 1, 3
"d:\IDEWORK\lvmen\src\licensedcode\data\rules\gpl-2.0-plus_110.yml", "YAML", 0, 0, 0, 3, 0, 0, 1, 4
"d:\IDEWORK\lvmen\src\licensedcode\data\rules\gpl-2.0-plus_111.yml", "YAML", 0, 0, 0, 4, 0, 0, 1, 5
"d:\IDEWORK\lvmen\src\licensedcode\data\rules\gpl-2.0-plus_112.yml", "YAML", 0, 0, 0, 4, 0, 0, 1, 5
"d:\IDEWORK\lvmen\src\licensedcode\data\rules\gpl-2.0-plus_113.yml", "YAML", 0, 0, 0, 6, 0, 0, 1, 7
"d:\IDEWORK\lvmen\src\licensedcode\data\rules\gpl-2.0-plus_114.yml", "YAML", 0, 0, 0, 4, 0, 0, 1, 5
"d:\IDEWORK\lvmen\src\licensedcode\data\rules\gpl-2.0-plus_115.yml", "YAML", 0, 0, 0, 3, 0, 0, 1, 4
"d:\IDEWORK\lvmen\src\licensedcode\data\rules\gpl-2.0-plus_116.yml", "YAML", 0, 0, 0, 2, 0, 0, 1, 3
"d:\IDEWORK\lvmen\src\licensedcode\data\rules\gpl-2.0-plus_117.yml", "YAML", 0, 0, 0, 2, 0, 0, 1, 3
"d:\IDEWORK\lvmen\src\licensedcode\data\rules\gpl-2.0-plus_118.yml", "YAML", 0, 0, 0, 2, 0, 0, 1, 3
"d:\IDEWORK\lvmen\src\licensedcode\data\rules\gpl-2.0-plus_119.yml", "YAML", 0, 0, 0, 4, 0, 0, 1, 5
"d:\IDEWORK\lvmen\src\licensedcode\data\rules\gpl-2.0-plus_12.yml", "YAML", 0, 0, 0, 5, 0, 0, 1, 6
"d:\IDEWORK\lvmen\src\licensedcode\data\rules\gpl-2.0-plus_120.yml", "YAML", 0, 0, 0, 6, 0, 0, 1, 7
"d:\IDEWORK\lvmen\src\licensedcode\data\rules\gpl-2.0-plus_121.yml", "YAML", 0, 0, 0, 7, 0, 0, 1, 8
"d:\IDEWORK\lvmen\src\licensedcode\data\rules\gpl-2.0-plus_121_1.yml", "YAML", 0, 0, 0, 7, 0, 0, 1, 8
"d:\IDEWORK\lvmen\src\licensedcode\data\rules\gpl-2.0-plus_122.yml", "YAML", 0, 0, 0, 4, 0, 0, 1, 5
"d:\IDEWORK\lvmen\src\licensedcode\data\rules\gpl-2.0-plus_123.yml", "YAML", 0, 0, 0, 5, 0, 0, 1, 6
"d:\IDEWORK\lvmen\src\licensedcode\data\rules\gpl-2.0-plus_124.yml", "YAML", 0, 0, 0, 4, 0, 0, 1, 5
"d:\IDEWORK\lvmen\src\licensedcode\data\rules\gpl-2.0-plus_125.yml", "YAML", 0, 0, 0, 4, 0, 0, 1, 5
"d:\IDEWORK\lvmen\src\licensedcode\data\rules\gpl-2.0-plus_126.yml", "YAML", 0, 0, 0, 4, 0, 0, 1, 5
"d:\IDEWORK\lvmen\src\licensedcode\data\rules\gpl-2.0-plus_127.yml", "YAML", 0, 0, 0, 2, 0, 0, 1, 3
"d:\IDEWORK\lvmen\src\licensedcode\data\rules\gpl-2.0-plus_128.yml", "YAML", 0, 0, 0, 3, 0, 0, 1, 4
"d:\IDEWORK\lvmen\src\licensedcode\data\rules\gpl-2.0-plus_129.yml", "YAML", 0, 0, 0, 5, 0, 0, 1, 6
"d:\IDEWORK\lvmen\src\licensedcode\data\rules\gpl-2.0-plus_13.yml", "YAML", 0, 0, 0, 3, 0, 0, 1, 4
"d:\IDEWORK\lvmen\src\licensedcode\data\rules\gpl-2.0-plus_130.yml", "YAML", 0, 0, 0, 2, 0, 0, 1, 3
"d:\IDEWORK\lvmen\src\licensedcode\data\rules\gpl-2.0-plus_131.yml", "YAML", 0, 0, 0, 2, 0, 0, 1, 3
"d:\IDEWORK\lvmen\src\licensedcode\data\rules\gpl-2.0-plus_132.yml", "YAML", 0, 0, 0, 2, 0, 0, 1, 3
"d:\IDEWORK\lvmen\src\licensedcode\data\rules\gpl-2.0-plus_133.yml", "YAML", 0, 0, 0, 2, 0, 0, 1, 3
"d:\IDEWORK\lvmen\src\licensedcode\data\rules\gpl-2.0-plus_134.yml", "YAML", 0, 0, 0, 4, 0, 0, 1, 5
"d:\IDEWORK\lvmen\src\licensedcode\data\rules\gpl-2.0-plus_135.yml", "YAML", 0, 0, 0, 2, 0, 0, 1, 3
"d:\IDEWORK\lvmen\src\licensedcode\data\rules\gpl-2.0-plus_136.yml", "YAML", 0, 0, 0, 3, 0, 0, 1, 4
"d:\IDEWORK\lvmen\src\licensedcode\data\rules\gpl-2.0-plus_137.yml", "YAML", 0, 0, 0, 2, 0, 0, 1, 3
"d:\IDEWORK\lvmen\src\licensedcode\data\rules\gpl-2.0-plus_138.yml", "YAML", 0, 0, 0, 2, 0, 0, 1, 3
"d:\IDEWORK\lvmen\src\licensedcode\data\rules\gpl-2.0-plus_139.yml", "YAML", 0, 0, 0, 2, 0, 0, 1, 3
"d:\IDEWORK\lvmen\src\licensedcode\data\rules\gpl-2.0-plus_14.yml", "YAML", 0, 0, 0, 3, 0, 0, 1, 4
"d:\IDEWORK\lvmen\src\licensedcode\data\rules\gpl-2.0-plus_140.yml", "YAML", 0, 0, 0, 2, 0, 0, 1, 3
"d:\IDEWORK\lvmen\src\licensedcode\data\rules\gpl-2.0-plus_141.yml", "YAML", 0, 0, 0, 4, 0, 0, 1, 5
"d:\IDEWORK\lvmen\src\licensedcode\data\rules\gpl-2.0-plus_142.yml", "YAML", 0, 0, 0, 2, 0, 0, 1, 3
"d:\IDEWORK\lvmen\src\licensedcode\data\rules\gpl-2.0-plus_143.yml", "YAML", 0, 0, 0, 2, 0, 0, 1, 3
"d:\IDEWORK\lvmen\src\licensedcode\data\rules\gpl-2.0-plus_144.yml", "YAML", 0, 0, 0, 2, 0, 0, 1, 3
"d:\IDEWORK\lvmen\src\licensedcode\data\rules\gpl-2.0-plus_145.yml", "YAML", 0, 0, 0, 4, 0, 0, 1, 5
"d:\IDEWORK\lvmen\src\licensedcode\data\rules\gpl-2.0-plus_146.yml", "YAML", 0, 0, 0, 4, 0, 0, 1, 5
"d:\IDEWORK\lvmen\src\licensedcode\data\rules\gpl-2.0-plus_147.yml", "YAML", 0, 0, 0, 2, 0, 0, 1, 3
"d:\IDEWORK\lvmen\src\licensedcode\data\rules\gpl-2.0-plus_148.yml", "YAML", 0, 0, 0, 2, 0, 0, 1, 3
"d:\IDEWORK\lvmen\src\licensedcode\data\rules\gpl-2.0-plus_149.yml", "YAML", 0, 0, 0, 2, 0, 0, 1, 3
"d:\IDEWORK\lvmen\src\licensedcode\data\rules\gpl-2.0-plus_15.yml", "YAML", 0, 0, 0, 4, 0, 0, 1, 5
"d:\IDEWORK\lvmen\src\licensedcode\data\rules\gpl-2.0-plus_150.yml", "YAML", 0, 0, 0, 2, 0, 0, 1, 3
"d:\IDEWORK\lvmen\src\licensedcode\data\rules\gpl-2.0-plus_151.yml", "YAML", 0, 0, 0, 3, 0, 0, 1, 4
"d:\IDEWORK\lvmen\src\licensedcode\data\rules\gpl-2.0-plus_152.yml", "YAML", 0, 0, 0, 2, 0, 0, 1, 3
"d:\IDEWORK\lvmen\src\licensedcode\data\rules\gpl-2.0-plus_153.yml", "YAML", 0, 0, 0, 2, 0, 0, 1, 3
"d:\IDEWORK\lvmen\src\licensedcode\data\rules\gpl-2.0-plus_154.yml", "YAML", 0, 0, 0, 2, 0, 0, 1, 3
"d:\IDEWORK\lvmen\src\licensedcode\data\rules\gpl-2.0-plus_155.yml", "YAML", 0, 0, 0, 4, 0, 0, 1, 5
"d:\IDEWORK\lvmen\src\licensedcode\data\rules\gpl-2.0-plus_156.yml", "YAML", 0, 0, 0, 4, 0, 0, 1, 5
"d:\IDEWORK\lvmen\src\licensedcode\data\rules\gpl-2.0-plus_157.yml", "YAML", 0, 0, 0, 3, 0, 0, 1, 4
"d:\IDEWORK\lvmen\src\licensedcode\data\rules\gpl-2.0-plus_158.yml", "YAML", 0, 0, 0, 3, 0, 0, 1, 4
"d:\IDEWORK\lvmen\src\licensedcode\data\rules\gpl-2.0-plus_159.yml", "YAML", 0, 0, 0, 2, 0, 0, 1, 3
"d:\IDEWORK\lvmen\src\licensedcode\data\rules\gpl-2.0-plus_16.yml", "YAML", 0, 0, 0, 4, 0, 0, 1, 5
"d:\IDEWORK\lvmen\src\licensedcode\data\rules\gpl-2.0-plus_160.yml", "YAML", 0, 0, 0, 2, 0, 0, 1, 3
"d:\IDEWORK\lvmen\src\licensedcode\data\rules\gpl-2.0-plus_161.yml", "YAML", 0, 0, 0, 2, 0, 0, 1, 3
"d:\IDEWORK\lvmen\src\licensedcode\data\rules\gpl-2.0-plus_162.yml", "YAML", 0, 0, 0, 2, 0, 0, 1, 3
"d:\IDEWORK\lvmen\src\licensedcode\data\rules\gpl-2.0-plus_163.yml", "YAML", 0, 0, 0, 2, 0, 0, 1, 3
"d:\IDEWORK\lvmen\src\licensedcode\data\rules\gpl-2.0-plus_164.yml", "YAML", 0, 0, 0, 2, 0, 0, 1, 3
"d:\IDEWORK\lvmen\src\licensedcode\data\rules\gpl-2.0-plus_165.yml", "YAML", 0, 0, 0, 2, 0, 0, 1, 3
"d:\IDEWORK\lvmen\src\licensedcode\data\rules\gpl-2.0-plus_166.yml", "YAML", 0, 0, 0, 2, 0, 0, 1, 3
"d:\IDEWORK\lvmen\src\licensedcode\data\rules\gpl-2.0-plus_167.yml", "YAML", 0, 0, 0, 4, 0, 0, 1, 5
"d:\IDEWORK\lvmen\src\licensedcode\data\rules\gpl-2.0-plus_168.yml", "YAML", 0, 0, 0, 3, 0, 0, 1, 4
"d:\IDEWORK\lvmen\src\licensedcode\data\rules\gpl-2.0-plus_169.yml", "YAML", 0, 0, 0, 2, 0, 0, 1, 3
"d:\IDEWORK\lvmen\src\licensedcode\data\rules\gpl-2.0-plus_17.yml", "YAML", 0, 0, 0, 3, 0, 0, 1, 4
"d:\IDEWORK\lvmen\src\licensedcode\data\rules\gpl-2.0-plus_170.yml", "YAML", 0, 0, 0, 2, 0, 0, 1, 3
"d:\IDEWORK\lvmen\src\licensedcode\data\rules\gpl-2.0-plus_171.yml", "YAML", 0, 0, 0, 2, 0, 0, 1, 3
"d:\IDEWORK\lvmen\src\licensedcode\data\rules\gpl-2.0-plus_172.yml", "YAML", 0, 0, 0, 2, 0, 0, 1, 3
"d:\IDEWORK\lvmen\src\licensedcode\data\rules\gpl-2.0-plus_173.yml", "YAML", 0, 0, 0, 2, 0, 0, 1, 3
"d:\IDEWORK\lvmen\src\licensedcode\data\rules\gpl-2.0-plus_174.yml", "YAML", 0, 0, 0, 4, 0, 0, 1, 5
"d:\IDEWORK\lvmen\src\licensedcode\data\rules\gpl-2.0-plus_175.yml", "YAML", 0, 0, 0, 3, 0, 0, 1, 4
"d:\IDEWORK\lvmen\src\licensedcode\data\rules\gpl-2.0-plus_176.yml", "YAML", 0, 0, 0, 3, 0, 0, 1, 4
"d:\IDEWORK\lvmen\src\licensedcode\data\rules\gpl-2.0-plus_177.yml", "YAML", 0, 0, 0, 3, 0, 0, 1, 4
"d:\IDEWORK\lvmen\src\licensedcode\data\rules\gpl-2.0-plus_178.yml", "YAML", 0, 0, 0, 2, 0, 0, 1, 3
"d:\IDEWORK\lvmen\src\licensedcode\data\rules\gpl-2.0-plus_179.yml", "YAML", 0, 0, 0, 2, 0, 0, 1, 3
"d:\IDEWORK\lvmen\src\licensedcode\data\rules\gpl-2.0-plus_18.yml", "YAML", 0, 0, 0, 5, 0, 0, 1, 6
"d:\IDEWORK\lvmen\src\licensedcode\data\rules\gpl-2.0-plus_180.yml", "YAML", 0, 0, 0, 3, 0, 0, 1, 4
"d:\IDEWORK\lvmen\src\licensedcode\data\rules\gpl-2.0-plus_181.yml", "YAML", 0, 0, 0, 2, 0, 0, 1, 3
"d:\IDEWORK\lvmen\src\licensedcode\data\rules\gpl-2.0-plus_182.yml", "YAML", 0, 0, 0, 4, 0, 0, 1, 5
"d:\IDEWORK\lvmen\src\licensedcode\data\rules\gpl-2.0-plus_183.yml", "YAML", 0, 0, 0, 6, 0, 0, 1, 7
"d:\IDEWORK\lvmen\src\licensedcode\data\rules\gpl-2.0-plus_184.yml", "YAML", 0, 0, 0, 6, 0, 0, 1, 7
"d:\IDEWORK\lvmen\src\licensedcode\data\rules\gpl-2.0-plus_185.yml", "YAML", 0, 0, 0, 5, 0, 0, 1, 6
"d:\IDEWORK\lvmen\src\licensedcode\data\rules\gpl-2.0-plus_186.yml", "YAML", 0, 0, 0, 3, 0, 0, 1, 4
"d:\IDEWORK\lvmen\src\licensedcode\data\rules\gpl-2.0-plus_187.yml", "YAML", 0, 0, 0, 2, 0, 0, 1, 3
"d:\IDEWORK\lvmen\src\licensedcode\data\rules\gpl-2.0-plus_188.yml", "YAML", 0, 0, 0, 3, 0, 0, 1, 4
"d:\IDEWORK\lvmen\src\licensedcode\data\rules\gpl-2.0-plus_189.yml", "YAML", 0, 0, 0, 3, 0, 0, 1, 4
"d:\IDEWORK\lvmen\src\licensedcode\data\rules\gpl-2.0-plus_19.yml", "YAML", 0, 0, 0, 3, 0, 0, 1, 4
"d:\IDEWORK\lvmen\src\licensedcode\data\rules\gpl-2.0-plus_190.yml", "YAML", 0, 0, 0, 3, 0, 0, 1, 4
"d:\IDEWORK\lvmen\src\licensedcode\data\rules\gpl-2.0-plus_191.yml", "YAML", 0, 0, 0, 2, 0, 0, 1, 3
"d:\IDEWORK\lvmen\src\licensedcode\data\rules\gpl-2.0-plus_192.yml", "YAML", 0, 0, 0, 2, 0, 0, 1, 3
"d:\IDEWORK\lvmen\src\licensedcode\data\rules\gpl-2.0-plus_193.yml", "YAML", 0, 0, 0, 3, 0, 0, 1, 4
"d:\IDEWORK\lvmen\src\licensedcode\data\rules\gpl-2.0-plus_194.yml", "YAML", 0, 0, 0, 4, 0, 0, 1, 5
"d:\IDEWORK\lvmen\src\licensedcode\data\rules\gpl-2.0-plus_195.yml", "YAML", 0, 0, 0, 4, 0, 0, 1, 5
"d:\IDEWORK\lvmen\src\licensedcode\data\rules\gpl-2.0-plus_196.yml", "YAML", 0, 0, 0, 4, 0, 0, 1, 5
"d:\IDEWORK\lvmen\src\licensedcode\data\rules\gpl-2.0-plus_197.yml", "YAML", 0, 0, 0, 2, 0, 0, 1, 3
"d:\IDEWORK\lvmen\src\licensedcode\data\rules\gpl-2.0-plus_198.yml", "YAML", 0, 0, 0, 2, 0, 0, 1, 3
"d:\IDEWORK\lvmen\src\licensedcode\data\rules\gpl-2.0-plus_199.yml", "YAML", 0, 0, 0, 2, 0, 0, 1, 3
"d:\IDEWORK\lvmen\src\licensedcode\data\rules\gpl-2.0-plus_2.yml", "YAML", 0, 0, 0, 3, 0, 0, 1, 4
"d:\IDEWORK\lvmen\src\licensedcode\data\rules\gpl-2.0-plus_20.yml", "YAML", 0, 0, 0, 3, 0, 0, 1, 4
"d:\IDEWORK\lvmen\src\licensedcode\data\rules\gpl-2.0-plus_200.yml", "YAML", 0, 0, 0, 2, 0, 0, 1, 3
"d:\IDEWORK\lvmen\src\licensedcode\data\rules\gpl-2.0-plus_201.yml", "YAML", 0, 0, 0, 5, 0, 0, 1, 6
"d:\IDEWORK\lvmen\src\licensedcode\data\rules\gpl-2.0-plus_202.yml", "YAML", 0, 0, 0, 6, 0, 0, 1, 7
"d:\IDEWORK\lvmen\src\licensedcode\data\rules\gpl-2.0-plus_203.yml", "YAML", 0, 0, 0, 2, 0, 0, 1, 3
"d:\IDEWORK\lvmen\src\licensedcode\data\rules\gpl-2.0-plus_204.yml", "YAML", 0, 0, 0, 4, 0, 0, 1, 5
"d:\IDEWORK\lvmen\src\licensedcode\data\rules\gpl-2.0-plus_205.yml", "YAML", 0, 0, 0, 4, 0, 0, 1, 5
"d:\IDEWORK\lvmen\src\licensedcode\data\rules\gpl-2.0-plus_206.yml", "YAML", 0, 0, 0, 3, 0, 0, 1, 4
"d:\IDEWORK\lvmen\src\licensedcode\data\rules\gpl-2.0-plus_207.yml", "YAML", 0, 0, 0, 2, 0, 0, 1, 3
"d:\IDEWORK\lvmen\src\licensedcode\data\rules\gpl-2.0-plus_208.yml", "YAML", 0, 0, 0, 2, 0, 0, 1, 3
"d:\IDEWORK\lvmen\src\licensedcode\data\rules\gpl-2.0-plus_209.yml", "YAML", 0, 0, 0, 4, 0, 0, 1, 5
"d:\IDEWORK\lvmen\src\licensedcode\data\rules\gpl-2.0-plus_21.yml", "YAML", 0, 0, 0, 4, 0, 0, 1, 5
"d:\IDEWORK\lvmen\src\licensedcode\data\rules\gpl-2.0-plus_210.yml", "YAML", 0, 0, 0, 2, 0, 0, 1, 3
"d:\IDEWORK\lvmen\src\licensedcode\data\rules\gpl-2.0-plus_211.yml", "YAML", 0, 0, 0, 2, 0, 0, 1, 3
"d:\IDEWORK\lvmen\src\licensedcode\data\rules\gpl-2.0-plus_212.yml", "YAML", 0, 0, 0, 5, 0, 0, 1, 6
"d:\IDEWORK\lvmen\src\licensedcode\data\rules\gpl-2.0-plus_213.yml", "YAML", 0, 0, 0, 2, 0, 0, 1, 3
"d:\IDEWORK\lvmen\src\licensedcode\data\rules\gpl-2.0-plus_214.yml", "YAML", 0, 0, 0, 2, 0, 0, 1, 3
"d:\IDEWORK\lvmen\src\licensedcode\data\rules\gpl-2.0-plus_215.yml", "YAML", 0, 0, 0, 4, 0, 0, 1, 5
"d:\IDEWORK\lvmen\src\licensedcode\data\rules\gpl-2.0-plus_216.yml", "YAML", 0, 0, 0, 3, 0, 0, 1, 4
"d:\IDEWORK\lvmen\src\licensedcode\data\rules\gpl-2.0-plus_217.yml", "YAML", 0, 0, 0, 2, 0, 0, 1, 3
"d:\IDEWORK\lvmen\src\licensedcode\data\rules\gpl-2.0-plus_218.yml", "YAML", 0, 0, 0, 4, 0, 0, 1, 5
"d:\IDEWORK\lvmen\src\licensedcode\data\rules\gpl-2.0-plus_219.yml", "YAML", 0, 0, 0, 3, 0, 0, 1, 4
"d:\IDEWORK\lvmen\src\licensedcode\data\rules\gpl-2.0-plus_22.yml", "YAML", 0, 0, 0, 3, 0, 0, 1, 4
"d:\IDEWORK\lvmen\src\licensedcode\data\rules\gpl-2.0-plus_220.yml", "YAML", 0, 0, 0, 2, 0, 0, 1, 3
"d:\IDEWORK\lvmen\src\licensedcode\data\rules\gpl-2.0-plus_221.yml", "YAML", 0, 0, 0, 2, 0, 0, 1, 3
"d:\IDEWORK\lvmen\src\licensedcode\data\rules\gpl-2.0-plus_222.yml", "YAML", 0, 0, 0, 2, 0, 0, 1, 3
"d:\IDEWORK\lvmen\src\licensedcode\data\rules\gpl-2.0-plus_223.yml", "YAML", 0, 0, 0, 2, 0, 0, 1, 3
"d:\IDEWORK\lvmen\src\licensedcode\data\rules\gpl-2.0-plus_224.yml", "YAML", 0, 0, 0, 2, 0, 0, 1, 3
"d:\IDEWORK\lvmen\src\licensedcode\data\rules\gpl-2.0-plus_225.yml", "YAML", 0, 0, 0, 3, 0, 0, 1, 4
"d:\IDEWORK\lvmen\src\licensedcode\data\rules\gpl-2.0-plus_226.yml", "YAML", 0, 0, 0, 3, 0, 0, 1, 4
"d:\IDEWORK\lvmen\src\licensedcode\data\rules\gpl-2.0-plus_227.yml", "YAML", 0, 0, 0, 2, 0, 0, 1, 3
"d:\IDEWORK\lvmen\src\licensedcode\data\rules\gpl-2.0-plus_228.yml", "YAML", 0, 0, 0, 3, 0, 0, 1, 4
"d:\IDEWORK\lvmen\src\licensedcode\data\rules\gpl-2.0-plus_229.yml", "YAML", 0, 0, 0, 2, 0, 0, 1, 3
"d:\IDEWORK\lvmen\src\licensedcode\data\rules\gpl-2.0-plus_23.yml", "YAML", 0, 0, 0, 2, 0, 0, 1, 3
"d:\IDEWORK\lvmen\src\licensedcode\data\rules\gpl-2.0-plus_230.yml", "YAML", 0, 0, 0, 6, 0, 0, 1, 7
"d:\IDEWORK\lvmen\src\licensedcode\data\rules\gpl-2.0-plus_231.yml", "YAML", 0, 0, 0, 2, 0, 0, 1, 3
"d:\IDEWORK\lvmen\src\licensedcode\data\rules\gpl-2.0-plus_232.yml", "YAML", 0, 0, 0, 2, 0, 0, 1, 3
"d:\IDEWORK\lvmen\src\licensedcode\data\rules\gpl-2.0-plus_233.yml", "YAML", 0, 0, 0, 2, 0, 0, 1, 3
"d:\IDEWORK\lvmen\src\licensedcode\data\rules\gpl-2.0-plus_234.yml", "YAML", 0, 0, 0, 4, 0, 0, 1, 5
"d:\IDEWORK\lvmen\src\licensedcode\data\rules\gpl-2.0-plus_235.yml", "YAML", 0, 0, 0, 2, 0, 0, 1, 3
"d:\IDEWORK\lvmen\src\licensedcode\data\rules\gpl-2.0-plus_236.yml", "YAML", 0, 0, 0, 4, 0, 0, 1, 5
"d:\IDEWORK\lvmen\src\licensedcode\data\rules\gpl-2.0-plus_237.yml", "YAML", 0, 0, 0, 2, 0, 0, 1, 3
"d:\IDEWORK\lvmen\src\licensedcode\data\rules\gpl-2.0-plus_238.yml", "YAML", 0, 0, 0, 4, 0, 0, 1, 5
"d:\IDEWORK\lvmen\src\licensedcode\data\rules\gpl-2.0-plus_239.yml", "YAML", 0, 0, 0, 4, 0, 0, 1, 5
"d:\IDEWORK\lvmen\src\licensedcode\data\rules\gpl-2.0-plus_24.yml", "YAML", 0, 0, 0, 5, 0, 0, 1, 6
"d:\IDEWORK\lvmen\src\licensedcode\data\rules\gpl-2.0-plus_240.yml", "YAML", 0, 0, 0, 4, 0, 0, 1, 5
"d:\IDEWORK\lvmen\src\licensedcode\data\rules\gpl-2.0-plus_241.yml", "YAML", 0, 0, 0, 4, 0, 0, 1, 5
"d:\IDEWORK\lvmen\src\licensedcode\data\rules\gpl-2.0-plus_242.yml", "YAML", 0, 0, 0, 4, 0, 0, 1, 5
"d:\IDEWORK\lvmen\src\licensedcode\data\rules\gpl-2.0-plus_243.yml", "YAML", 0, 0, 0, 2, 0, 0, 1, 3
"d:\IDEWORK\lvmen\src\licensedcode\data\rules\gpl-2.0-plus_244.yml", "YAML", 0, 0, 0, 2, 0, 0, 1, 3
"d:\IDEWORK\lvmen\src\licensedcode\data\rules\gpl-2.0-plus_245.yml", "YAML", 0, 0, 0, 2, 0, 0, 1, 3
"d:\IDEWORK\lvmen\src\licensedcode\data\rules\gpl-2.0-plus_246.yml", "YAML", 0, 0, 0, 2, 0, 0, 1, 3
"d:\IDEWORK\lvmen\src\licensedcode\data\rules\gpl-2.0-plus_247.yml", "YAML", 0, 0, 0, 2, 0, 0, 1, 3
"d:\IDEWORK\lvmen\src\licensedcode\data\rules\gpl-2.0-plus_248.yml", "YAML", 0, 0, 0, 2, 0, 0, 1, 3
"d:\IDEWORK\lvmen\src\licensedcode\data\rules\gpl-2.0-plus_249.yml", "YAML", 0, 0, 0, 7, 0, 0, 1, 8
"d:\IDEWORK\lvmen\src\licensedcode\data\rules\gpl-2.0-plus_25.yml", "YAML", 0, 0, 0, 3, 0, 0, 1, 4
"d:\IDEWORK\lvmen\src\licensedcode\data\rules\gpl-2.0-plus_250.yml", "YAML", 0, 0, 0, 7, 0, 0, 1, 8
"d:\IDEWORK\lvmen\src\licensedcode\data\rules\gpl-2.0-plus_251.yml", "YAML", 0, 0, 0, 7, 0, 0, 1, 8
"d:\IDEWORK\lvmen\src\licensedcode\data\rules\gpl-2.0-plus_252.yml", "YAML", 0, 0, 0, 2, 0, 0, 1, 3
"d:\IDEWORK\lvmen\src\licensedcode\data\rules\gpl-2.0-plus_253.yml", "YAML", 0, 0, 0, 4, 0, 0, 1, 5
"d:\IDEWORK\lvmen\src\licensedcode\data\rules\gpl-2.0-plus_254.yml", "YAML", 0, 0, 0, 4, 0, 0, 1, 5
"d:\IDEWORK\lvmen\src\licensedcode\data\rules\gpl-2.0-plus_255.yml", "YAML", 0, 0, 0, 2, 0, 0, 1, 3
"d:\IDEWORK\lvmen\src\licensedcode\data\rules\gpl-2.0-plus_256.yml", "YAML", 0, 0, 0, 4, 0, 0, 1, 5
"d:\IDEWORK\lvmen\src\licensedcode\data\rules\gpl-2.0-plus_257.yml", "YAML", 0, 0, 0, 2, 0, 0, 1, 3
"d:\IDEWORK\lvmen\src\licensedcode\data\rules\gpl-2.0-plus_258.yml", "YAML", 0, 0, 0, 2, 0, 0, 1, 3
"d:\IDEWORK\lvmen\src\licensedcode\data\rules\gpl-2.0-plus_259.yml", "YAML", 0, 0, 0, 2, 0, 0, 1, 3
"d:\IDEWORK\lvmen\src\licensedcode\data\rules\gpl-2.0-plus_26.yml", "YAML", 0, 0, 0, 3, 0, 0, 1, 4
"d:\IDEWORK\lvmen\src\licensedcode\data\rules\gpl-2.0-plus_260.yml", "YAML", 0, 0, 0, 4, 0, 0, 1, 5
"d:\IDEWORK\lvmen\src\licensedcode\data\rules\gpl-2.0-plus_261.yml", "YAML", 0, 0, 0, 2, 0, 0, 1, 3
"d:\IDEWORK\lvmen\src\licensedcode\data\rules\gpl-2.0-plus_262.yml", "YAML", 0, 0, 0, 2, 0, 0, 1, 3
"d:\IDEWORK\lvmen\src\licensedcode\data\rules\gpl-2.0-plus_263.yml", "YAML", 0, 0, 0, 2, 0, 0, 1, 3
"d:\IDEWORK\lvmen\src\licensedcode\data\rules\gpl-2.0-plus_264.yml", "YAML", 0, 0, 0, 2, 0, 0, 1, 3
"d:\IDEWORK\lvmen\src\licensedcode\data\rules\gpl-2.0-plus_265.yml", "YAML", 0, 0, 0, 3, 0, 0, 1, 4
"d:\IDEWORK\lvmen\src\licensedcode\data\rules\gpl-2.0-plus_265_1.yml", "YAML", 0, 0, 0, 4, 0, 0, 1, 5
"d:\IDEWORK\lvmen\src\licensedcode\data\rules\gpl-2.0-plus_265_2.yml", "YAML", 0, 0, 0, 5, 0, 0, 1, 6
"d:\IDEWORK\lvmen\src\licensedcode\data\rules\gpl-2.0-plus_266.yml", "YAML", 0, 0, 0, 3, 0, 0, 1, 4
"d:\IDEWORK\lvmen\src\licensedcode\data\rules\gpl-2.0-plus_267.yml", "YAML", 0, 0, 0, 5, 0, 0, 1, 6
"d:\IDEWORK\lvmen\src\licensedcode\data\rules\gpl-2.0-plus_268.yml", "YAML", 0, 0, 0, 3, 0, 0, 1, 4
"d:\IDEWORK\lvmen\src\licensedcode\data\rules\gpl-2.0-plus_269.yml", "YAML", 0, 0, 0, 3, 0, 0, 1, 4
"d:\IDEWORK\lvmen\src\licensedcode\data\rules\gpl-2.0-plus_27.yml", "YAML", 0, 0, 0, 4, 0, 0, 1, 5
"d:\IDEWORK\lvmen\src\licensedcode\data\rules\gpl-2.0-plus_270.yml", "YAML", 0, 0, 0, 3, 0, 0, 1, 4
"d:\IDEWORK\lvmen\src\licensedcode\data\rules\gpl-2.0-plus_271.yml", "YAML", 0, 0, 0, 3, 0, 0, 1, 4
"d:\IDEWORK\lvmen\src\licensedcode\data\rules\gpl-2.0-plus_272.yml", "YAML", 0, 0, 0, 3, 0, 0, 1, 4
"d:\IDEWORK\lvmen\src\licensedcode\data\rules\gpl-2.0-plus_273.yml", "YAML", 0, 0, 0, 5, 0, 0, 1, 6
"d:\IDEWORK\lvmen\src\licensedcode\data\rules\gpl-2.0-plus_274.yml", "YAML", 0, 0, 0, 2, 0, 0, 1, 3
"d:\IDEWORK\lvmen\src\licensedcode\data\rules\gpl-2.0-plus_275.yml", "YAML", 0, 0, 0, 3, 0, 0, 1, 4
"d:\IDEWORK\lvmen\src\licensedcode\data\rules\gpl-2.0-plus_276.yml", "YAML", 0, 0, 0, 4, 0, 0, 1, 5
"d:\IDEWORK\lvmen\src\licensedcode\data\rules\gpl-2.0-plus_277.yml", "YAML", 0, 0, 0, 4, 0, 0, 1, 5
"d:\IDEWORK\lvmen\src\licensedcode\data\rules\gpl-2.0-plus_278.yml", "YAML", 0, 0, 0, 2, 0, 0, 1, 3
"d:\IDEWORK\lvmen\src\licensedcode\data\rules\gpl-2.0-plus_279.yml", "YAML", 0, 0, 0, 2, 0, 0, 1, 3
"d:\IDEWORK\lvmen\src\licensedcode\data\rules\gpl-2.0-plus_28.yml", "YAML", 0, 0, 0, 3, 0, 0, 1, 4
"d:\IDEWORK\lvmen\src\licensedcode\data\rules\gpl-2.0-plus_280.yml", "YAML", 0, 0, 0, 4, 0, 0, 1, 5
"d:\IDEWORK\lvmen\src\licensedcode\data\rules\gpl-2.0-plus_281.yml", "YAML", 0, 0, 0, 2, 0, 0, 1, 3
"d:\IDEWORK\lvmen\src\licensedcode\data\rules\gpl-2.0-plus_282.yml", "YAML", 0, 0, 0, 2, 0, 0, 1, 3
"d:\IDEWORK\lvmen\src\licensedcode\data\rules\gpl-2.0-plus_283.yml", "YAML", 0, 0, 0, 2, 0, 0, 1, 3
"d:\IDEWORK\lvmen\src\licensedcode\data\rules\gpl-2.0-plus_284.yml", "YAML", 0, 0, 0, 4, 0, 0, 1, 5
"d:\IDEWORK\lvmen\src\licensedcode\data\rules\gpl-2.0-plus_285.yml", "YAML", 0, 0, 0, 5, 0, 0, 1, 6
"d:\IDEWORK\lvmen\src\licensedcode\data\rules\gpl-2.0-plus_286.yml", "YAML", 0, 0, 0, 2, 0, 0, 1, 3
"d:\IDEWORK\lvmen\src\licensedcode\data\rules\gpl-2.0-plus_287.yml", "YAML", 0, 0, 0, 3, 0, 0, 1, 4
"d:\IDEWORK\lvmen\src\licensedcode\data\rules\gpl-2.0-plus_288.yml", "YAML", 0, 0, 0, 4, 0, 0, 1, 5
"d:\IDEWORK\lvmen\src\licensedcode\data\rules\gpl-2.0-plus_289.yml", "YAML", 0, 0, 0, 2, 0, 0, 1, 3
"d:\IDEWORK\lvmen\src\licensedcode\data\rules\gpl-2.0-plus_29.yml", "YAML", 0, 0, 0, 5, 0, 0, 1, 6
"d:\IDEWORK\lvmen\src\licensedcode\data\rules\gpl-2.0-plus_290.yml", "YAML", 0, 0, 0, 2, 0, 0, 1, 3
"d:\IDEWORK\lvmen\src\licensedcode\data\rules\gpl-2.0-plus_291.yml", "YAML", 0, 0, 0, 2, 0, 0, 1, 3
"d:\IDEWORK\lvmen\src\licensedcode\data\rules\gpl-2.0-plus_292.yml", "YAML", 0, 0, 0, 3, 0, 0, 1, 4
"d:\IDEWORK\lvmen\src\licensedcode\data\rules\gpl-2.0-plus_293.yml", "YAML", 0, 0, 0, 2, 0, 0, 1, 3
"d:\IDEWORK\lvmen\src\licensedcode\data\rules\gpl-2.0-plus_294.yml", "YAML", 0, 0, 0, 2, 0, 0, 1, 3
"d:\IDEWORK\lvmen\src\licensedcode\data\rules\gpl-2.0-plus_295.yml", "YAML", 0, 0, 0, 6, 0, 0, 1, 7
"d:\IDEWORK\lvmen\src\licensedcode\data\rules\gpl-2.0-plus_296.yml", "YAML", 0, 0, 0, 4, 0, 0, 1, 5
"d:\IDEWORK\lvmen\src\licensedcode\data\rules\gpl-2.0-plus_297.yml", "YAML", 0, 0, 0, 4, 0, 0, 1, 5
"d:\IDEWORK\lvmen\src\licensedcode\data\rules\gpl-2.0-plus_298.yml", "YAML", 0, 0, 0, 5, 0, 0, 1, 6
"d:\IDEWORK\lvmen\src\licensedcode\data\rules\gpl-2.0-plus_299.yml", "YAML", 0, 0, 0, 2, 0, 0, 1, 3
"d:\IDEWORK\lvmen\src\licensedcode\data\rules\gpl-2.0-plus_3.yml", "YAML", 0, 0, 0, 2, 0, 0, 1, 3
"d:\IDEWORK\lvmen\src\licensedcode\data\rules\gpl-2.0-plus_30.yml", "YAML", 0, 0, 0, 2, 0, 0, 1, 3
"d:\IDEWORK\lvmen\src\licensedcode\data\rules\gpl-2.0-plus_300.yml", "YAML", 0, 0, 0, 3, 0, 0, 1, 4
"d:\IDEWORK\lvmen\src\licensedcode\data\rules\gpl-2.0-plus_301.yml", "YAML", 0, 0, 0, 4, 0, 0, 1, 5
"d:\IDEWORK\lvmen\src\licensedcode\data\rules\gpl-2.0-plus_302.yml", "YAML", 0, 0, 0, 2, 0, 0, 1, 3
"d:\IDEWORK\lvmen\src\licensedcode\data\rules\gpl-2.0-plus_303.yml", "YAML", 0, 0, 0, 2, 0, 0, 1, 3
"d:\IDEWORK\lvmen\src\licensedcode\data\rules\gpl-2.0-plus_304.yml", "YAML", 0, 0, 0, 3, 0, 0, 1, 4
"d:\IDEWORK\lvmen\src\licensedcode\data\rules\gpl-2.0-plus_305.yml", "YAML", 0, 0, 0, 3, 0, 0, 1, 4
"d:\IDEWORK\lvmen\src\licensedcode\data\rules\gpl-2.0-plus_306.yml", "YAML", 0, 0, 0, 5, 0, 0, 1, 6
"d:\IDEWORK\lvmen\src\licensedcode\data\rules\gpl-2.0-plus_307.yml", "YAML", 0, 0, 0, 3, 0, 0, 1, 4
"d:\IDEWORK\lvmen\src\licensedcode\data\rules\gpl-2.0-plus_308.yml", "YAML", 0, 0, 0, 3, 0, 0, 1, 4
"d:\IDEWORK\lvmen\src\licensedcode\data\rules\gpl-2.0-plus_309.yml", "YAML", 0, 0, 0, 3, 0, 0, 1, 4
"d:\IDEWORK\lvmen\src\licensedcode\data\rules\gpl-2.0-plus_31.yml", "YAML", 0, 0, 0, 5, 0, 0, 1, 6
"d:\IDEWORK\lvmen\src\licensedcode\data\rules\gpl-2.0-plus_310.yml", "YAML", 0, 0, 0, 5, 0, 0, 1, 6
"d:\IDEWORK\lvmen\src\licensedcode\data\rules\gpl-2.0-plus_311.yml", "YAML", 0, 0, 0, 4, 0, 0, 1, 5
"d:\IDEWORK\lvmen\src\licensedcode\data\rules\gpl-2.0-plus_312.yml", "YAML", 0, 0, 0, 4, 0, 0, 1, 5
"d:\IDEWORK\lvmen\src\licensedcode\data\rules\gpl-2.0-plus_313.yml", "YAML", 0, 0, 0, 2, 0, 0, 1, 3
"d:\IDEWORK\lvmen\src\licensedcode\data\rules\gpl-2.0-plus_314.yml", "YAML", 0, 0, 0, 2, 0, 0, 1, 3
"d:\IDEWORK\lvmen\src\licensedcode\data\rules\gpl-2.0-plus_315.yml", "YAML", 0, 0, 0, 4, 0, 0, 1, 5
"d:\IDEWORK\lvmen\src\licensedcode\data\rules\gpl-2.0-plus_316.yml", "YAML", 0, 0, 0, 2, 0, 0, 1, 3
"d:\IDEWORK\lvmen\src\licensedcode\data\rules\gpl-2.0-plus_317.yml", "YAML", 0, 0, 0, 3, 0, 0, 1, 4
"d:\IDEWORK\lvmen\src\licensedcode\data\rules\gpl-2.0-plus_318.yml", "YAML", 0, 0, 0, 3, 0, 0, 1, 4
"d:\IDEWORK\lvmen\src\licensedcode\data\rules\gpl-2.0-plus_319.yml", "YAML", 0, 0, 0, 3, 0, 0, 1, 4
"d:\IDEWORK\lvmen\src\licensedcode\data\rules\gpl-2.0-plus_32.yml", "YAML", 0, 0, 0, 5, 0, 0, 1, 6
"d:\IDEWORK\lvmen\src\licensedcode\data\rules\gpl-2.0-plus_320.yml", "YAML", 0, 0, 0, 4, 0, 0, 1, 5
"d:\IDEWORK\lvmen\src\licensedcode\data\rules\gpl-2.0-plus_321.yml", "YAML", 0, 0, 0, 4, 0, 0, 1, 5
"d:\IDEWORK\lvmen\src\licensedcode\data\rules\gpl-2.0-plus_322.yml", "YAML", 0, 0, 0, 6, 0, 0, 1, 7
"d:\IDEWORK\lvmen\src\licensedcode\data\rules\gpl-2.0-plus_323.yml", "YAML", 0, 0, 0, 5, 0, 0, 1, 6
"d:\IDEWORK\lvmen\src\licensedcode\data\rules\gpl-2.0-plus_324.yml", "YAML", 0, 0, 0, 2, 0, 0, 1, 3
"d:\IDEWORK\lvmen\src\licensedcode\data\rules\gpl-2.0-plus_325.yml", "YAML", 0, 0, 0, 2, 0, 0, 1, 3
"d:\IDEWORK\lvmen\src\licensedcode\data\rules\gpl-2.0-plus_326.yml", "YAML", 0, 0, 0, 2, 0, 0, 1, 3
"d:\IDEWORK\lvmen\src\licensedcode\data\rules\gpl-2.0-plus_327.yml", "YAML", 0, 0, 0, 3, 0, 0, 1, 4
"d:\IDEWORK\lvmen\src\licensedcode\data\rules\gpl-2.0-plus_328.yml", "YAML", 0, 0, 0, 5, 0, 0, 1, 6
"d:\IDEWORK\lvmen\src\licensedcode\data\rules\gpl-2.0-plus_329.yml", "YAML", 0, 0, 0, 4, 0, 0, 1, 5
"d:\IDEWORK\lvmen\src\licensedcode\data\rules\gpl-2.0-plus_33.yml", "YAML", 0, 0, 0, 4, 0, 0, 1, 5
"d:\IDEWORK\lvmen\src\licensedcode\data\rules\gpl-2.0-plus_330.yml", "YAML", 0, 0, 0, 4, 0, 0, 1, 5
"d:\IDEWORK\lvmen\src\licensedcode\data\rules\gpl-2.0-plus_331.yml", "YAML", 0, 0, 0, 6, 0, 0, 1, 7
"d:\IDEWORK\lvmen\src\licensedcode\data\rules\gpl-2.0-plus_332.yml", "YAML", 0, 0, 0, 5, 0, 0, 1, 6
"d:\IDEWORK\lvmen\src\licensedcode\data\rules\gpl-2.0-plus_333.yml", "YAML", 0, 0, 0, 5, 0, 0, 1, 6
"d:\IDEWORK\lvmen\src\licensedcode\data\rules\gpl-2.0-plus_334.yml", "YAML", 0, 0, 0, 2, 0, 0, 1, 3
"d:\IDEWORK\lvmen\src\licensedcode\data\rules\gpl-2.0-plus_335.yml", "YAML", 0, 0, 0, 4, 0, 0, 1, 5
"d:\IDEWORK\lvmen\src\licensedcode\data\rules\gpl-2.0-plus_336.yml", "YAML", 0, 0, 0, 5, 0, 0, 1, 6
"d:\IDEWORK\lvmen\src\licensedcode\data\rules\gpl-2.0-plus_337.yml", "YAML", 0, 0, 0, 4, 0, 0, 1, 5
"d:\IDEWORK\lvmen\src\licensedcode\data\rules\gpl-2.0-plus_338.yml", "YAML", 0, 0, 0, 4, 0, 0, 1, 5
"d:\IDEWORK\lvmen\src\licensedcode\data\rules\gpl-2.0-plus_339.yml", "YAML", 0, 0, 0, 4, 0, 0, 1, 5
"d:\IDEWORK\lvmen\src\licensedcode\data\rules\gpl-2.0-plus_34.yml", "YAML", 0, 0, 0, 5, 0, 0, 1, 6
"d:\IDEWORK\lvmen\src\licensedcode\data\rules\gpl-2.0-plus_340.yml", "YAML", 0, 0, 0, 4, 0, 0, 1, 5
"d:\IDEWORK\lvmen\src\licensedcode\data\rules\gpl-2.0-plus_341.yml", "YAML", 0, 0, 0, 3, 0, 0, 1, 4
"d:\IDEWORK\lvmen\src\licensedcode\data\rules\gpl-2.0-plus_342.yml", "YAML", 0, 0, 0, 2, 0, 0, 1, 3
"d:\IDEWORK\lvmen\src\licensedcode\data\rules\gpl-2.0-plus_343.yml", "YAML", 0, 0, 0, 4, 0, 0, 1, 5
"d:\IDEWORK\lvmen\src\licensedcode\data\rules\gpl-2.0-plus_344.yml", "YAML", 0, 0, 0, 2, 0, 0, 1, 3
"d:\IDEWORK\lvmen\src\licensedcode\data\rules\gpl-2.0-plus_345.yml", "YAML", 0, 0, 0, 4, 0, 0, 1, 5
"d:\IDEWORK\lvmen\src\licensedcode\data\rules\gpl-2.0-plus_346.yml", "YAML", 0, 0, 0, 3, 0, 0, 1, 4
"d:\IDEWORK\lvmen\src\licensedcode\data\rules\gpl-2.0-plus_347.yml", "YAML", 0, 0, 0, 3, 0, 0, 1, 4
"d:\IDEWORK\lvmen\src\licensedcode\data\rules\gpl-2.0-plus_348.yml", "YAML", 0, 0, 0, 3, 0, 0, 1, 4
"d:\IDEWORK\lvmen\src\licensedcode\data\rules\gpl-2.0-plus_349.yml", "YAML", 0, 0, 0, 4, 0, 0, 1, 5
"d:\IDEWORK\lvmen\src\licensedcode\data\rules\gpl-2.0-plus_35.yml", "YAML", 0, 0, 0, 3, 0, 0, 1, 4
"d:\IDEWORK\lvmen\src\licensedcode\data\rules\gpl-2.0-plus_350.yml", "YAML", 0, 0, 0, 2, 0, 0, 1, 3
"d:\IDEWORK\lvmen\src\licensedcode\data\rules\gpl-2.0-plus_351.yml", "YAML", 0, 0, 0, 3, 0, 0, 1, 4
"d:\IDEWORK\lvmen\src\licensedcode\data\rules\gpl-2.0-plus_352.yml", "YAML", 0, 0, 0, 2, 0, 0, 1, 3
"d:\IDEWORK\lvmen\src\licensedcode\data\rules\gpl-2.0-plus_353.yml", "YAML", 0, 0, 0, 4, 0, 0, 1, 5
"d:\IDEWORK\lvmen\src\licensedcode\data\rules\gpl-2.0-plus_354.yml", "YAML", 0, 0, 0, 2, 0, 0, 1, 3
"d:\IDEWORK\lvmen\src\licensedcode\data\rules\gpl-2.0-plus_355.yml", "YAML", 0, 0, 0, 3, 0, 0, 1, 4
"d:\IDEWORK\lvmen\src\licensedcode\data\rules\gpl-2.0-plus_356.yml", "YAML", 0, 0, 0, 3, 0, 0, 1, 4
"d:\IDEWORK\lvmen\src\licensedcode\data\rules\gpl-2.0-plus_357.yml", "YAML", 0, 0, 0, 3, 0, 0, 1, 4
"d:\IDEWORK\lvmen\src\licensedcode\data\rules\gpl-2.0-plus_358.yml", "YAML", 0, 0, 0, 3, 0, 0, 1, 4
"d:\IDEWORK\lvmen\src\licensedcode\data\rules\gpl-2.0-plus_359.yml", "YAML", 0, 0, 0, 3, 0, 0, 1, 4
"d:\IDEWORK\lvmen\src\licensedcode\data\rules\gpl-2.0-plus_36.yml", "YAML", 0, 0, 0, 4, 0, 0, 1, 5
"d:\IDEWORK\lvmen\src\licensedcode\data\rules\gpl-2.0-plus_360.yml", "YAML", 0, 0, 0, 3, 0, 0, 1, 4
"d:\IDEWORK\lvmen\src\licensedcode\data\rules\gpl-2.0-plus_361.yml", "YAML", 0, 0, 0, 3, 0, 0, 1, 4
"d:\IDEWORK\lvmen\src\licensedcode\data\rules\gpl-2.0-plus_362.yml", "YAML", 0, 0, 0, 3, 0, 0, 1, 4
"d:\IDEWORK\lvmen\src\licensedcode\data\rules\gpl-2.0-plus_363.yml", "YAML", 0, 0, 0, 3, 0, 0, 1, 4
"d:\IDEWORK\lvmen\src\licensedcode\data\rules\gpl-2.0-plus_364.yml", "YAML", 0, 0, 0, 4, 0, 0, 1, 5
"d:\IDEWORK\lvmen\src\licensedcode\data\rules\gpl-2.0-plus_365.yml", "YAML", 0, 0, 0, 3, 0, 0, 1, 4
"d:\IDEWORK\lvmen\src\licensedcode\data\rules\gpl-2.0-plus_366.yml", "YAML", 0, 0, 0, 2, 0, 0, 1, 3
"d:\IDEWORK\lvmen\src\licensedcode\data\rules\gpl-2.0-plus_367.yml", "YAML", 0, 0, 0, 3, 0, 0, 1, 4
"d:\IDEWORK\lvmen\src\licensedcode\data\rules\gpl-2.0-plus_368.yml", "YAML", 0, 0, 0, 3, 0, 0, 1, 4
"d:\IDEWORK\lvmen\src\licensedcode\data\rules\gpl-2.0-plus_369.yml", "YAML", 0, 0, 0, 3, 0, 0, 1, 4
"d:\IDEWORK\lvmen\src\licensedcode\data\rules\gpl-2.0-plus_37.yml", "YAML", 0, 0, 0, 3, 0, 0, 1, 4
"d:\IDEWORK\lvmen\src\licensedcode\data\rules\gpl-2.0-plus_370.yml", "YAML", 0, 0, 0, 3, 0, 0, 1, 4
"d:\IDEWORK\lvmen\src\licensedcode\data\rules\gpl-2.0-plus_371.yml", "YAML", 0, 0, 0, 4, 0, 0, 1, 5
"d:\IDEWORK\lvmen\src\licensedcode\data\rules\gpl-2.0-plus_372.yml", "YAML", 0, 0, 0, 2, 0, 0, 1, 3
"d:\IDEWORK\lvmen\src\licensedcode\data\rules\gpl-2.0-plus_373.yml", "YAML", 0, 0, 0, 5, 0, 0, 1, 6
"d:\IDEWORK\lvmen\src\licensedcode\data\rules\gpl-2.0-plus_374.yml", "YAML", 0, 0, 0, 3, 0, 0, 1, 4
"d:\IDEWORK\lvmen\src\licensedcode\data\rules\gpl-2.0-plus_375.yml", "YAML", 0, 0, 0, 4, 0, 0, 1, 5
"d:\IDEWORK\lvmen\src\licensedcode\data\rules\gpl-2.0-plus_376.yml", "YAML", 0, 0, 0, 2, 0, 0, 1, 3
"d:\IDEWORK\lvmen\src\licensedcode\data\rules\gpl-2.0-plus_377.yml", "YAML", 0, 0, 0, 4, 0, 0, 1, 5
"d:\IDEWORK\lvmen\src\licensedcode\data\rules\gpl-2.0-plus_378.yml", "YAML", 0, 0, 0, 2, 0, 0, 1, 3
"d:\IDEWORK\lvmen\src\licensedcode\data\rules\gpl-2.0-plus_379.yml", "YAML", 0, 0, 0, 2, 0, 0, 1, 3
"d:\IDEWORK\lvmen\src\licensedcode\data\rules\gpl-2.0-plus_38.yml", "YAML", 0, 0, 0, 4, 0, 0, 1, 5
"d:\IDEWORK\lvmen\src\licensedcode\data\rules\gpl-2.0-plus_380.yml", "YAML", 0, 0, 0, 3, 0, 0, 1, 4
"d:\IDEWORK\lvmen\src\licensedcode\data\rules\gpl-2.0-plus_381.yml", "YAML", 0, 0, 0, 5, 0, 0, 1, 6
"d:\IDEWORK\lvmen\src\licensedcode\data\rules\gpl-2.0-plus_382.yml", "YAML", 0, 0, 0, 3, 0, 0, 1, 4
"d:\IDEWORK\lvmen\src\licensedcode\data\rules\gpl-2.0-plus_383.yml", "YAML", 0, 0, 0, 3, 0, 0, 1, 4
"d:\IDEWORK\lvmen\src\licensedcode\data\rules\gpl-2.0-plus_384.yml", "YAML", 0, 0, 0, 2, 0, 0, 1, 3
"d:\IDEWORK\lvmen\src\licensedcode\data\rules\gpl-2.0-plus_385.yml", "YAML", 0, 0, 0, 2, 0, 0, 1, 3
"d:\IDEWORK\lvmen\src\licensedcode\data\rules\gpl-2.0-plus_386.yml", "YAML", 0, 0, 0, 3, 0, 0, 1, 4
"d:\IDEWORK\lvmen\src\licensedcode\data\rules\gpl-2.0-plus_387.yml", "YAML", 0, 0, 0, 3, 0, 0, 1, 4
"d:\IDEWORK\lvmen\src\licensedcode\data\rules\gpl-2.0-plus_388.yml", "YAML", 0, 0, 0, 3, 0, 0, 1, 4
"d:\IDEWORK\lvmen\src\licensedcode\data\rules\gpl-2.0-plus_389.yml", "YAML", 0, 0, 0, 3, 0, 0, 1, 4
"d:\IDEWORK\lvmen\src\licensedcode\data\rules\gpl-2.0-plus_39.yml", "YAML", 0, 0, 0, 3, 0, 0, 1, 4
"d:\IDEWORK\lvmen\src\licensedcode\data\rules\gpl-2.0-plus_390.yml", "YAML", 0, 0, 0, 2, 0, 0, 1, 3
"d:\IDEWORK\lvmen\src\licensedcode\data\rules\gpl-2.0-plus_391.yml", "YAML", 0, 0, 0, 3, 0, 0, 1, 4
"d:\IDEWORK\lvmen\src\licensedcode\data\rules\gpl-2.0-plus_392.yml", "YAML", 0, 0, 0, 3, 0, 0, 1, 4
"d:\IDEWORK\lvmen\src\licensedcode\data\rules\gpl-2.0-plus_393.yml", "YAML", 0, 0, 0, 5, 0, 0, 1, 6
"d:\IDEWORK\lvmen\src\licensedcode\data\rules\gpl-2.0-plus_394.yml", "YAML", 0, 0, 0, 5, 0, 0, 1, 6
"d:\IDEWORK\lvmen\src\licensedcode\data\rules\gpl-2.0-plus_395.yml", "YAML", 0, 0, 0, 5, 0, 0, 1, 6
"d:\IDEWORK\lvmen\src\licensedcode\data\rules\gpl-2.0-plus_396.yml", "YAML", 0, 0, 0, 3, 0, 0, 1, 4
"d:\IDEWORK\lvmen\src\licensedcode\data\rules\gpl-2.0-plus_397.yml", "YAML", 0, 0, 0, 3, 0, 0, 1, 4
"d:\IDEWORK\lvmen\src\licensedcode\data\rules\gpl-2.0-plus_398.yml", "YAML", 0, 0, 0, 3, 0, 0, 1, 4
"d:\IDEWORK\lvmen\src\licensedcode\data\rules\gpl-2.0-plus_399.yml", "YAML", 0, 0, 0, 3, 0, 0, 1, 4
"d:\IDEWORK\lvmen\src\licensedcode\data\rules\gpl-2.0-plus_4.yml", "YAML", 0, 0, 0, 2, 0, 0, 1, 3
"d:\IDEWORK\lvmen\src\licensedcode\data\rules\gpl-2.0-plus_40.yml", "YAML", 0, 0, 0, 2, 0, 0, 1, 3
"d:\IDEWORK\lvmen\src\licensedcode\data\rules\gpl-2.0-plus_400.yml", "YAML", 0, 0, 0, 4, 0, 0, 1, 5
"d:\IDEWORK\lvmen\src\licensedcode\data\rules\gpl-2.0-plus_401.yml", "YAML", 0, 0, 0, 3, 0, 0, 1, 4
"d:\IDEWORK\lvmen\src\licensedcode\data\rules\gpl-2.0-plus_402.yml", "YAML", 0, 0, 0, 5, 0, 0, 1, 6
"d:\IDEWORK\lvmen\src\licensedcode\data\rules\gpl-2.0-plus_403.yml", "YAML", 0, 0, 0, 3, 0, 0, 1, 4
"d:\IDEWORK\lvmen\src\licensedcode\data\rules\gpl-2.0-plus_404.yml", "YAML", 0, 0, 0, 5, 0, 0, 1, 6
"d:\IDEWORK\lvmen\src\licensedcode\data\rules\gpl-2.0-plus_405.yml", "YAML", 0, 0, 0, 7, 0, 0, 1, 8
"d:\IDEWORK\lvmen\src\licensedcode\data\rules\gpl-2.0-plus_406.yml", "YAML", 0, 0, 0, 3, 0, 0, 1, 4
"d:\IDEWORK\lvmen\src\licensedcode\data\rules\gpl-2.0-plus_407.yml", "YAML", 0, 0, 0, 3, 0, 0, 1, 4
"d:\IDEWORK\lvmen\src\licensedcode\data\rules\gpl-2.0-plus_408.yml", "YAML", 0, 0, 0, 3, 0, 0, 1, 4
"d:\IDEWORK\lvmen\src\licensedcode\data\rules\gpl-2.0-plus_409.yml", "YAML", 0, 0, 0, 3, 0, 0, 1, 4
"d:\IDEWORK\lvmen\src\licensedcode\data\rules\gpl-2.0-plus_41.yml", "YAML", 0, 0, 0, 3, 0, 0, 1, 4
"d:\IDEWORK\lvmen\src\licensedcode\data\rules\gpl-2.0-plus_410.yml", "YAML", 0, 0, 0, 3, 0, 0, 1, 4
"d:\IDEWORK\lvmen\src\licensedcode\data\rules\gpl-2.0-plus_411.yml", "YAML", 0, 0, 0, 6, 0, 0, 1, 7
"d:\IDEWORK\lvmen\src\licensedcode\data\rules\gpl-2.0-plus_412.yml", "YAML", 0, 0, 0, 6, 0, 0, 1, 7
"d:\IDEWORK\lvmen\src\licensedcode\data\rules\gpl-2.0-plus_413.yml", "YAML", 0, 0, 0, 5, 0, 0, 1, 6
"d:\IDEWORK\lvmen\src\licensedcode\data\rules\gpl-2.0-plus_414.yml", "YAML", 0, 0, 0, 4, 0, 0, 1, 5
"d:\IDEWORK\lvmen\src\licensedcode\data\rules\gpl-2.0-plus_415.yml", "YAML", 0, 0, 0, 5, 0, 0, 1, 6
"d:\IDEWORK\lvmen\src\licensedcode\data\rules\gpl-2.0-plus_416.yml", "YAML", 0, 0, 0, 3, 0, 0, 1, 4
"d:\IDEWORK\lvmen\src\licensedcode\data\rules\gpl-2.0-plus_417.yml", "YAML", 0, 0, 0, 3, 0, 0, 1, 4
"d:\IDEWORK\lvmen\src\licensedcode\data\rules\gpl-2.0-plus_418.yml", "YAML", 0, 0, 0, 3, 0, 0, 1, 4
"d:\IDEWORK\lvmen\src\licensedcode\data\rules\gpl-2.0-plus_419.yml", "YAML", 0, 0, 0, 3, 0, 0, 1, 4
"d:\IDEWORK\lvmen\src\licensedcode\data\rules\gpl-2.0-plus_42.yml", "YAML", 0, 0, 0, 2, 0, 0, 1, 3
"d:\IDEWORK\lvmen\src\licensedcode\data\rules\gpl-2.0-plus_420.yml", "YAML", 0, 0, 0, 3, 0, 0, 1, 4
"d:\IDEWORK\lvmen\src\licensedcode\data\rules\gpl-2.0-plus_421.yml", "YAML", 0, 0, 0, 3, 0, 0, 1, 4
"d:\IDEWORK\lvmen\src\licensedcode\data\rules\gpl-2.0-plus_422.yml", "YAML", 0, 0, 0, 3, 0, 0, 1, 4
"d:\IDEWORK\lvmen\src\licensedcode\data\rules\gpl-2.0-plus_423.yml", "YAML", 0, 0, 0, 3, 0, 0, 1, 4
"d:\IDEWORK\lvmen\src\licensedcode\data\rules\gpl-2.0-plus_424.yml", "YAML", 0, 0, 0, 3, 0, 0, 1, 4
"d:\IDEWORK\lvmen\src\licensedcode\data\rules\gpl-2.0-plus_425.yml", "YAML", 0, 0, 0, 3, 0, 0, 1, 4
"d:\IDEWORK\lvmen\src\licensedcode\data\rules\gpl-2.0-plus_426.yml", "YAML", 0, 0, 0, 3, 0, 0, 1, 4
"d:\IDEWORK\lvmen\src\licensedcode\data\rules\gpl-2.0-plus_427.yml", "YAML", 0, 0, 0, 5, 0, 0, 1, 6
"d:\IDEWORK\lvmen\src\licensedcode\data\rules\gpl-2.0-plus_428.yml", "YAML", 0, 0, 0, 3, 0, 0, 1, 4
"d:\IDEWORK\lvmen\src\licensedcode\data\rules\gpl-2.0-plus_429.yml", "YAML", 0, 0, 0, 3, 0, 0, 1, 4
"d:\IDEWORK\lvmen\src\licensedcode\data\rules\gpl-2.0-plus_43.yml", "YAML", 0, 0, 0, 2, 0, 0, 1, 3
"d:\IDEWORK\lvmen\src\licensedcode\data\rules\gpl-2.0-plus_430.yml", "YAML", 0, 0, 0, 4, 0, 0, 1, 5
"d:\IDEWORK\lvmen\src\licensedcode\data\rules\gpl-2.0-plus_431.yml", "YAML", 0, 0, 0, 4, 0, 0, 1, 5
"d:\IDEWORK\lvmen\src\licensedcode\data\rules\gpl-2.0-plus_432.yml", "YAML", 0, 0, 0, 4, 0, 0, 1, 5
"d:\IDEWORK\lvmen\src\licensedcode\data\rules\gpl-2.0-plus_433.yml", "YAML", 0, 0, 0, 4, 0, 0, 1, 5
"d:\IDEWORK\lvmen\src\licensedcode\data\rules\gpl-2.0-plus_434.yml", "YAML", 0, 0, 0, 3, 0, 0, 1, 4
"d:\IDEWORK\lvmen\src\licensedcode\data\rules\gpl-2.0-plus_435.yml", "YAML", 0, 0, 0, 3, 0, 0, 1, 4
"d:\IDEWORK\lvmen\src\licensedcode\data\rules\gpl-2.0-plus_436.yml", "YAML", 0, 0, 0, 4, 0, 0, 1, 5
"d:\IDEWORK\lvmen\src\licensedcode\data\rules\gpl-2.0-plus_437.yml", "YAML", 0, 0, 0, 5, 0, 0, 1, 6
"d:\IDEWORK\lvmen\src\licensedcode\data\rules\gpl-2.0-plus_438.yml", "YAML", 0, 0, 0, 6, 0, 0, 1, 7
"d:\IDEWORK\lvmen\src\licensedcode\data\rules\gpl-2.0-plus_439.yml", "YAML", 0, 0, 0, 2, 0, 0, 1, 3
"d:\IDEWORK\lvmen\src\licensedcode\data\rules\gpl-2.0-plus_44.yml", "YAML", 0, 0, 0, 2, 0, 0, 1, 3
"d:\IDEWORK\lvmen\src\licensedcode\data\rules\gpl-2.0-plus_440.yml", "YAML", 0, 0, 0, 2, 0, 0, 1, 3
"d:\IDEWORK\lvmen\src\licensedcode\data\rules\gpl-2.0-plus_441.yml", "YAML", 0, 0, 0, 5, 0, 0, 1, 6
"d:\IDEWORK\lvmen\src\licensedcode\data\rules\gpl-2.0-plus_442.yml", "YAML", 0, 0, 0, 2, 0, 0, 1, 3
"d:\IDEWORK\lvmen\src\licensedcode\data\rules\gpl-2.0-plus_443.yml", "YAML", 0, 0, 0, 4, 0, 0, 1, 5
"d:\IDEWORK\lvmen\src\licensedcode\data\rules\gpl-2.0-plus_444.yml", "YAML", 0, 0, 0, 2, 0, 0, 1, 3
"d:\IDEWORK\lvmen\src\licensedcode\data\rules\gpl-2.0-plus_445.yml", "YAML", 0, 0, 0, 2, 0, 0, 1, 3
"d:\IDEWORK\lvmen\src\licensedcode\data\rules\gpl-2.0-plus_446.yml", "YAML", 0, 0, 0, 2, 0, 0, 1, 3
"d:\IDEWORK\lvmen\src\licensedcode\data\rules\gpl-2.0-plus_447.yml", "YAML", 0, 0, 0, 2, 0, 0, 1, 3
"d:\IDEWORK\lvmen\src\licensedcode\data\rules\gpl-2.0-plus_448.yml", "YAML", 0, 0, 0, 2, 0, 0, 1, 3
"d:\IDEWORK\lvmen\src\licensedcode\data\rules\gpl-2.0-plus_449.yml", "YAML", 0, 0, 0, 2, 0, 0, 1, 3
"d:\IDEWORK\lvmen\src\licensedcode\data\rules\gpl-2.0-plus_45.yml", "YAML", 0, 0, 0, 2, 0, 0, 1, 3
"d:\IDEWORK\lvmen\src\licensedcode\data\rules\gpl-2.0-plus_450.yml", "YAML", 0, 0, 0, 3, 0, 0, 1, 4
"d:\IDEWORK\lvmen\src\licensedcode\data\rules\gpl-2.0-plus_451.yml", "YAML", 0, 0, 0, 3, 0, 0, 1, 4
"d:\IDEWORK\lvmen\src\licensedcode\data\rules\gpl-2.0-plus_452.yml", "YAML", 0, 0, 0, 3, 0, 0, 1, 4
"d:\IDEWORK\lvmen\src\licensedcode\data\rules\gpl-2.0-plus_453.yml", "YAML", 0, 0, 0, 3, 0, 0, 1, 4
"d:\IDEWORK\lvmen\src\licensedcode\data\rules\gpl-2.0-plus_454.yml", "YAML", 0, 0, 0, 3, 0, 0, 1, 4
"d:\IDEWORK\lvmen\src\licensedcode\data\rules\gpl-2.0-plus_455.yml", "YAML", 0, 0, 0, 3, 0, 0, 1, 4
"d:\IDEWORK\lvmen\src\licensedcode\data\rules\gpl-2.0-plus_456.yml", "YAML", 0, 0, 0, 3, 0, 0, 1, 4
"d:\IDEWORK\lvmen\src\licensedcode\data\rules\gpl-2.0-plus_457.yml", "YAML", 0, 0, 0, 3, 0, 0, 1, 4
"d:\IDEWORK\lvmen\src\licensedcode\data\rules\gpl-2.0-plus_458.yml", "YAML", 0, 0, 0, 3, 0, 0, 1, 4
"d:\IDEWORK\lvmen\src\licensedcode\data\rules\gpl-2.0-plus_459.yml", "YAML", 0, 0, 0, 3, 0, 0, 1, 4
"d:\IDEWORK\lvmen\src\licensedcode\data\rules\gpl-2.0-plus_46.yml", "YAML", 0, 0, 0, 5, 0, 0, 1, 6
"d:\IDEWORK\lvmen\src\licensedcode\data\rules\gpl-2.0-plus_460.yml", "YAML", 0, 0, 0, 3, 0, 0, 1, 4
"d:\IDEWORK\lvmen\src\licensedcode\data\rules\gpl-2.0-plus_461.yml", "YAML", 0, 0, 0, 3, 0, 0, 1, 4
"d:\IDEWORK\lvmen\src\licensedcode\data\rules\gpl-2.0-plus_462.yml", "YAML", 0, 0, 0, 3, 0, 0, 1, 4
"d:\IDEWORK\lvmen\src\licensedcode\data\rules\gpl-2.0-plus_463.yml", "YAML", 0, 0, 0, 3, 0, 0, 1, 4
"d:\IDEWORK\lvmen\src\licensedcode\data\rules\gpl-2.0-plus_464.yml", "YAML", 0, 0, 0, 3, 0, 0, 1, 4
"d:\IDEWORK\lvmen\src\licensedcode\data\rules\gpl-2.0-plus_465.yml", "YAML", 0, 0, 0, 3, 0, 0, 1, 4
"d:\IDEWORK\lvmen\src\licensedcode\data\rules\gpl-2.0-plus_466.yml", "YAML", 0, 0, 0, 3, 0, 0, 1, 4
"d:\IDEWORK\lvmen\src\licensedcode\data\rules\gpl-2.0-plus_467.yml", "YAML", 0, 0, 0, 3, 0, 0, 1, 4
"d:\IDEWORK\lvmen\src\licensedcode\data\rules\gpl-2.0-plus_468.yml", "YAML", 0, 0, 0, 3, 0, 0, 1, 4
"d:\IDEWORK\lvmen\src\licensedcode\data\rules\gpl-2.0-plus_469.yml", "YAML", 0, 0, 0, 3, 0, 0, 1, 4
"d:\IDEWORK\lvmen\src\licensedcode\data\rules\gpl-2.0-plus_47.yml", "YAML", 0, 0, 0, 3, 0, 0, 1, 4
"d:\IDEWORK\lvmen\src\licensedcode\data\rules\gpl-2.0-plus_470.yml", "YAML", 0, 0, 0, 3, 0, 0, 1, 4
"d:\IDEWORK\lvmen\src\licensedcode\data\rules\gpl-2.0-plus_471.yml", "YAML", 0, 0, 0, 3, 0, 0, 1, 4
"d:\IDEWORK\lvmen\src\licensedcode\data\rules\gpl-2.0-plus_472.yml", "YAML", 0, 0, 0, 3, 0, 0, 1, 4
"d:\IDEWORK\lvmen\src\licensedcode\data\rules\gpl-2.0-plus_473.yml", "YAML", 0, 0, 0, 3, 0, 0, 1, 4
"d:\IDEWORK\lvmen\src\licensedcode\data\rules\gpl-2.0-plus_474.yml", "YAML", 0, 0, 0, 3, 0, 0, 1, 4
"d:\IDEWORK\lvmen\src\licensedcode\data\rules\gpl-2.0-plus_475.yml", "YAML", 0, 0, 0, 3, 0, 0, 1, 4
"d:\IDEWORK\lvmen\src\licensedcode\data\rules\gpl-2.0-plus_476.yml", "YAML", 0, 0, 0, 3, 0, 0, 1, 4
"d:\IDEWORK\lvmen\src\licensedcode\data\rules\gpl-2.0-plus_477.yml", "YAML", 0, 0, 0, 3, 0, 0, 1, 4
"d:\IDEWORK\lvmen\src\licensedcode\data\rules\gpl-2.0-plus_478.yml", "YAML", 0, 0, 0, 3, 0, 0, 1, 4
"d:\IDEWORK\lvmen\src\licensedcode\data\rules\gpl-2.0-plus_479.yml", "YAML", 0, 0, 0, 3, 0, 0, 1, 4
"d:\IDEWORK\lvmen\src\licensedcode\data\rules\gpl-2.0-plus_48.yml", "YAML", 0, 0, 0, 3, 0, 0, 1, 4
"d:\IDEWORK\lvmen\src\licensedcode\data\rules\gpl-2.0-plus_480.yml", "YAML", 0, 0, 0, 3, 0, 0, 1, 4
"d:\IDEWORK\lvmen\src\licensedcode\data\rules\gpl-2.0-plus_481.yml", "YAML", 0, 0, 0, 3, 0, 0, 1, 4
"d:\IDEWORK\lvmen\src\licensedcode\data\rules\gpl-2.0-plus_482.yml", "YAML", 0, 0, 0, 3, 0, 0, 1, 4
"d:\IDEWORK\lvmen\src\licensedcode\data\rules\gpl-2.0-plus_483.yml", "YAML", 0, 0, 0, 3, 0, 0, 1, 4
"d:\IDEWORK\lvmen\src\licensedcode\data\rules\gpl-2.0-plus_484.yml", "YAML", 0, 0, 0, 3, 0, 0, 1, 4
"d:\IDEWORK\lvmen\src\licensedcode\data\rules\gpl-2.0-plus_485.yml", "YAML", 0, 0, 0, 3, 0, 0, 1, 4
"d:\IDEWORK\lvmen\src\licensedcode\data\rules\gpl-2.0-plus_486.yml", "YAML", 0, 0, 0, 3, 0, 0, 1, 4
"d:\IDEWORK\lvmen\src\licensedcode\data\rules\gpl-2.0-plus_487.yml", "YAML", 0, 0, 0, 3, 0, 0, 1, 4
"d:\IDEWORK\lvmen\src\licensedcode\data\rules\gpl-2.0-plus_488.yml", "YAML", 0, 0, 0, 3, 0, 0, 1, 4
"d:\IDEWORK\lvmen\src\licensedcode\data\rules\gpl-2.0-plus_489.yml", "YAML", 0, 0, 0, 3, 0, 0, 1, 4
"d:\IDEWORK\lvmen\src\licensedcode\data\rules\gpl-2.0-plus_49.yml", "YAML", 0, 0, 0, 2, 0, 0, 1, 3
"d:\IDEWORK\lvmen\src\licensedcode\data\rules\gpl-2.0-plus_490.yml", "YAML", 0, 0, 0, 3, 0, 0, 1, 4
"d:\IDEWORK\lvmen\src\licensedcode\data\rules\gpl-2.0-plus_491.yml", "YAML", 0, 0, 0, 3, 0, 0, 1, 4
"d:\IDEWORK\lvmen\src\licensedcode\data\rules\gpl-2.0-plus_492.yml", "YAML", 0, 0, 0, 3, 0, 0, 1, 4
"d:\IDEWORK\lvmen\src\licensedcode\data\rules\gpl-2.0-plus_493.yml", "YAML", 0, 0, 0, 3, 0, 0, 1, 4
"d:\IDEWORK\lvmen\src\licensedcode\data\rules\gpl-2.0-plus_494.yml", "YAML", 0, 0, 0, 3, 0, 0, 1, 4
"d:\IDEWORK\lvmen\src\licensedcode\data\rules\gpl-2.0-plus_495.yml", "YAML", 0, 0, 0, 3, 0, 0, 1, 4
"d:\IDEWORK\lvmen\src\licensedcode\data\rules\gpl-2.0-plus_496.yml", "YAML", 0, 0, 0, 3, 0, 0, 1, 4
"d:\IDEWORK\lvmen\src\licensedcode\data\rules\gpl-2.0-plus_497.yml", "YAML", 0, 0, 0, 3, 0, 0, 1, 4
"d:\IDEWORK\lvmen\src\licensedcode\data\rules\gpl-2.0-plus_498.yml", "YAML", 0, 0, 0, 3, 0, 0, 1, 4
"d:\IDEWORK\lvmen\src\licensedcode\data\rules\gpl-2.0-plus_499.yml", "YAML", 0, 0, 0, 3, 0, 0, 1, 4
"d:\IDEWORK\lvmen\src\licensedcode\data\rules\gpl-2.0-plus_5.yml", "YAML", 0, 0, 0, 3, 0, 0, 1, 4
"d:\IDEWORK\lvmen\src\licensedcode\data\rules\gpl-2.0-plus_50.yml", "YAML", 0, 0, 0, 3, 0, 0, 1, 4
"d:\IDEWORK\lvmen\src\licensedcode\data\rules\gpl-2.0-plus_500.yml", "YAML", 0, 0, 0, 3, 0, 0, 1, 4
"d:\IDEWORK\lvmen\src\licensedcode\data\rules\gpl-2.0-plus_501.yml", "YAML", 0, 0, 0, 3, 0, 0, 1, 4
"d:\IDEWORK\lvmen\src\licensedcode\data\rules\gpl-2.0-plus_502.yml", "YAML", 0, 0, 0, 3, 0, 0, 1, 4
"d:\IDEWORK\lvmen\src\licensedcode\data\rules\gpl-2.0-plus_503.yml", "YAML", 0, 0, 0, 3, 0, 0, 1, 4
"d:\IDEWORK\lvmen\src\licensedcode\data\rules\gpl-2.0-plus_504.yml", "YAML", 0, 0, 0, 3, 0, 0, 1, 4
"d:\IDEWORK\lvmen\src\licensedcode\data\rules\gpl-2.0-plus_505.yml", "YAML", 0, 0, 0, 3, 0, 0, 1, 4
"d:\IDEWORK\lvmen\src\licensedcode\data\rules\gpl-2.0-plus_506.yml", "YAML", 0, 0, 0, 6, 0, 0, 1, 7
"d:\IDEWORK\lvmen\src\licensedcode\data\rules\gpl-2.0-plus_507.yml", "YAML", 0, 0, 0, 6, 0, 0, 1, 7
"d:\IDEWORK\lvmen\src\licensedcode\data\rules\gpl-2.0-plus_508.yml", "YAML", 0, 0, 0, 6, 0, 0, 1, 7
"d:\IDEWORK\lvmen\src\licensedcode\data\rules\gpl-2.0-plus_509.yml", "YAML", 0, 0, 0, 3, 0, 0, 1, 4
"d:\IDEWORK\lvmen\src\licensedcode\data\rules\gpl-2.0-plus_51.yml", "YAML", 0, 0, 0, 3, 0, 0, 1, 4
"d:\IDEWORK\lvmen\src\licensedcode\data\rules\gpl-2.0-plus_510.yml", "YAML", 0, 0, 0, 3, 0, 0, 1, 4
"d:\IDEWORK\lvmen\src\licensedcode\data\rules\gpl-2.0-plus_511.yml", "YAML", 0, 0, 0, 3, 0, 0, 1, 4
"d:\IDEWORK\lvmen\src\licensedcode\data\rules\gpl-2.0-plus_512.yml", "YAML", 0, 0, 0, 5, 0, 0, 1, 6
"d:\IDEWORK\lvmen\src\licensedcode\data\rules\gpl-2.0-plus_513.yml", "YAML", 0, 0, 0, 5, 0, 0, 1, 6
"d:\IDEWORK\lvmen\src\licensedcode\data\rules\gpl-2.0-plus_514.yml", "YAML", 0, 0, 0, 7, 0, 0, 1, 8
"d:\IDEWORK\lvmen\src\licensedcode\data\rules\gpl-2.0-plus_515.yml", "YAML", 0, 0, 0, 3, 0, 0, 1, 4
"d:\IDEWORK\lvmen\src\licensedcode\data\rules\gpl-2.0-plus_516.yml", "YAML", 0, 0, 0, 6, 0, 0, 1, 7
"d:\IDEWORK\lvmen\src\licensedcode\data\rules\gpl-2.0-plus_517.yml", "YAML", 0, 0, 0, 5, 0, 0, 1, 6
"d:\IDEWORK\lvmen\src\licensedcode\data\rules\gpl-2.0-plus_518.yml", "YAML", 0, 0, 0, 3, 0, 0, 1, 4
"d:\IDEWORK\lvmen\src\licensedcode\data\rules\gpl-2.0-plus_519.yml", "YAML", 0, 0, 0, 3, 0, 0, 1, 4
"d:\IDEWORK\lvmen\src\licensedcode\data\rules\gpl-2.0-plus_52.yml", "YAML", 0, 0, 0, 3, 0, 0, 1, 4
"d:\IDEWORK\lvmen\src\licensedcode\data\rules\gpl-2.0-plus_520.yml", "YAML", 0, 0, 0, 5, 0, 0, 1, 6
"d:\IDEWORK\lvmen\src\licensedcode\data\rules\gpl-2.0-plus_521.yml", "YAML", 0, 0, 0, 5, 0, 0, 1, 6
"d:\IDEWORK\lvmen\src\licensedcode\data\rules\gpl-2.0-plus_522.yml", "YAML", 0, 0, 0, 5, 0, 0, 1, 6
"d:\IDEWORK\lvmen\src\licensedcode\data\rules\gpl-2.0-plus_523.yml", "YAML", 0, 0, 0, 3, 0, 0, 1, 4
"d:\IDEWORK\lvmen\src\licensedcode\data\rules\gpl-2.0-plus_524.yml", "YAML", 0, 0, 0, 5, 0, 0, 1, 6
"d:\IDEWORK\lvmen\src\licensedcode\data\rules\gpl-2.0-plus_525.yml", "YAML", 0, 0, 0, 3, 0, 0, 1, 4
"d:\IDEWORK\lvmen\src\licensedcode\data\rules\gpl-2.0-plus_526.yml", "YAML", 0, 0, 0, 3, 0, 0, 1, 4
"d:\IDEWORK\lvmen\src\licensedcode\data\rules\gpl-2.0-plus_527.yml", "YAML", 0, 0, 0, 3, 0, 0, 1, 4
"d:\IDEWORK\lvmen\src\licensedcode\data\rules\gpl-2.0-plus_528.yml", "YAML", 0, 0, 0, 3, 0, 0, 1, 4
"d:\IDEWORK\lvmen\src\licensedcode\data\rules\gpl-2.0-plus_529.yml", "YAML", 0, 0, 0, 5, 0, 0, 1, 6
"d:\IDEWORK\lvmen\src\licensedcode\data\rules\gpl-2.0-plus_53.yml", "YAML", 0, 0, 0, 3, 0, 0, 1, 4
"d:\IDEWORK\lvmen\src\licensedcode\data\rules\gpl-2.0-plus_530.yml", "YAML", 0, 0, 0, 3, 0, 0, 1, 4
"d:\IDEWORK\lvmen\src\licensedcode\data\rules\gpl-2.0-plus_531.yml", "YAML", 0, 0, 0, 5, 0, 0, 1, 6
"d:\IDEWORK\lvmen\src\licensedcode\data\rules\gpl-2.0-plus_532.yml", "YAML", 0, 0, 0, 3, 0, 0, 1, 4
"d:\IDEWORK\lvmen\src\licensedcode\data\rules\gpl-2.0-plus_533.yml", "YAML", 0, 0, 0, 3, 0, 0, 1, 4
"d:\IDEWORK\lvmen\src\licensedcode\data\rules\gpl-2.0-plus_534.yml", "YAML", 0, 0, 0, 3, 0, 0, 1, 4
"d:\IDEWORK\lvmen\src\licensedcode\data\rules\gpl-2.0-plus_535.yml", "YAML", 0, 0, 0, 3, 0, 0, 1, 4
"d:\IDEWORK\lvmen\src\licensedcode\data\rules\gpl-2.0-plus_536.yml", "YAML", 0, 0, 0, 3, 0, 0, 1, 4
"d:\IDEWORK\lvmen\src\licensedcode\data\rules\gpl-2.0-plus_537.yml", "YAML", 0, 0, 0, 4, 0, 0, 1, 5
"d:\IDEWORK\lvmen\src\licensedcode\data\rules\gpl-2.0-plus_538.yml", "YAML", 0, 0, 0, 3, 0, 0, 1, 4
"d:\IDEWORK\lvmen\src\licensedcode\data\rules\gpl-2.0-plus_539.yml", "YAML", 0, 0, 0, 3, 0, 0, 1, 4
"d:\IDEWORK\lvmen\src\licensedcode\data\rules\gpl-2.0-plus_54.yml", "YAML", 0, 0, 0, 4, 0, 0, 1, 5
"d:\IDEWORK\lvmen\src\licensedcode\data\rules\gpl-2.0-plus_540.yml", "YAML", 0, 0, 0, 3, 0, 0, 1, 4
"d:\IDEWORK\lvmen\src\licensedcode\data\rules\gpl-2.0-plus_541.yml", "YAML", 0, 0, 0, 3, 0, 0, 1, 4
"d:\IDEWORK\lvmen\src\licensedcode\data\rules\gpl-2.0-plus_542.yml", "YAML", 0, 0, 0, 5, 0, 0, 1, 6
"d:\IDEWORK\lvmen\src\licensedcode\data\rules\gpl-2.0-plus_543.yml", "YAML", 0, 0, 0, 3, 0, 0, 1, 4
"d:\IDEWORK\lvmen\src\licensedcode\data\rules\gpl-2.0-plus_544.yml", "YAML", 0, 0, 0, 5, 0, 0, 1, 6
"d:\IDEWORK\lvmen\src\licensedcode\data\rules\gpl-2.0-plus_545.yml", "YAML", 0, 0, 0, 5, 0, 0, 1, 6
"d:\IDEWORK\lvmen\src\licensedcode\data\rules\gpl-2.0-plus_546.yml", "YAML", 0, 0, 0, 3, 0, 0, 1, 4
"d:\IDEWORK\lvmen\src\licensedcode\data\rules\gpl-2.0-plus_547.yml", "YAML", 0, 0, 0, 5, 0, 0, 1, 6
"d:\IDEWORK\lvmen\src\licensedcode\data\rules\gpl-2.0-plus_548.yml", "YAML", 0, 0, 0, 3, 0, 0, 1, 4
"d:\IDEWORK\lvmen\src\licensedcode\data\rules\gpl-2.0-plus_549.yml", "YAML", 0, 0, 0, 3, 0, 0, 1, 4
"d:\IDEWORK\lvmen\src\licensedcode\data\rules\gpl-2.0-plus_55.yml", "YAML", 0, 0, 0, 3, 0, 0, 1, 4
"d:\IDEWORK\lvmen\src\licensedcode\data\rules\gpl-2.0-plus_550.yml", "YAML", 0, 0, 0, 3, 0, 0, 1, 4
"d:\IDEWORK\lvmen\src\licensedcode\data\rules\gpl-2.0-plus_551.yml", "YAML", 0, 0, 0, 3, 0, 0, 1, 4
"d:\IDEWORK\lvmen\src\licensedcode\data\rules\gpl-2.0-plus_552.yml", "YAML", 0, 0, 0, 3, 0, 0, 1, 4
"d:\IDEWORK\lvmen\src\licensedcode\data\rules\gpl-2.0-plus_553.yml", "YAML", 0, 0, 0, 3, 0, 0, 1, 4
"d:\IDEWORK\lvmen\src\licensedcode\data\rules\gpl-2.0-plus_554.yml", "YAML", 0, 0, 0, 3, 0, 0, 1, 4
"d:\IDEWORK\lvmen\src\licensedcode\data\rules\gpl-2.0-plus_555.yml", "YAML", 0, 0, 0, 3, 0, 0, 1, 4
"d:\IDEWORK\lvmen\src\licensedcode\data\rules\gpl-2.0-plus_556.yml", "YAML", 0, 0, 0, 3, 0, 0, 1, 4
"d:\IDEWORK\lvmen\src\licensedcode\data\rules\gpl-2.0-plus_557.yml", "YAML", 0, 0, 0, 3, 0, 0, 1, 4
"d:\IDEWORK\lvmen\src\licensedcode\data\rules\gpl-2.0-plus_558.yml", "YAML", 0, 0, 0, 5, 0, 0, 1, 6
"d:\IDEWORK\lvmen\src\licensedcode\data\rules\gpl-2.0-plus_559.yml", "YAML", 0, 0, 0, 5, 0, 0, 1, 6
"d:\IDEWORK\lvmen\src\licensedcode\data\rules\gpl-2.0-plus_56.yml", "YAML", 0, 0, 0, 3, 0, 0, 1, 4
"d:\IDEWORK\lvmen\src\licensedcode\data\rules\gpl-2.0-plus_560.yml", "YAML", 0, 0, 0, 5, 0, 0, 1, 6
"d:\IDEWORK\lvmen\src\licensedcode\data\rules\gpl-2.0-plus_561.yml", "YAML", 0, 0, 0, 3, 0, 0, 1, 4
"d:\IDEWORK\lvmen\src\licensedcode\data\rules\gpl-2.0-plus_562.yml", "YAML", 0, 0, 0, 5, 0, 0, 1, 6
"d:\IDEWORK\lvmen\src\licensedcode\data\rules\gpl-2.0-plus_563.yml", "YAML", 0, 0, 0, 3, 0, 0, 1, 4
"d:\IDEWORK\lvmen\src\licensedcode\data\rules\gpl-2.0-plus_564.yml", "YAML", 0, 0, 0, 3, 0, 0, 1, 4
"d:\IDEWORK\lvmen\src\licensedcode\data\rules\gpl-2.0-plus_565.yml", "YAML", 0, 0, 0, 3, 0, 0, 1, 4
"d:\IDEWORK\lvmen\src\licensedcode\data\rules\gpl-2.0-plus_566.yml", "YAML", 0, 0, 0, 5, 0, 0, 1, 6
"d:\IDEWORK\lvmen\src\licensedcode\data\rules\gpl-2.0-plus_567.yml", "YAML", 0, 0, 0, 6, 0, 0, 1, 7
"d:\IDEWORK\lvmen\src\licensedcode\data\rules\gpl-2.0-plus_568.yml", "YAML", 0, 0, 0, 5, 0, 0, 1, 6
"d:\IDEWORK\lvmen\src\licensedcode\data\rules\gpl-2.0-plus_569.yml", "YAML", 0, 0, 0, 6, 0, 0, 1, 7
"d:\IDEWORK\lvmen\src\licensedcode\data\rules\gpl-2.0-plus_57.yml", "YAML", 0, 0, 0, 6, 0, 0, 1, 7
"d:\IDEWORK\lvmen\src\licensedcode\data\rules\gpl-2.0-plus_570.yml", "YAML", 0, 0, 0, 6, 0, 0, 1, 7
"d:\IDEWORK\lvmen\src\licensedcode\data\rules\gpl-2.0-plus_571.yml", "YAML", 0, 0, 0, 3, 0, 0, 1, 4
"d:\IDEWORK\lvmen\src\licensedcode\data\rules\gpl-2.0-plus_572.yml", "YAML", 0, 0, 0, 3, 0, 0, 1, 4
"d:\IDEWORK\lvmen\src\licensedcode\data\rules\gpl-2.0-plus_573.yml", "YAML", 0, 0, 0, 3, 0, 0, 1, 4
"d:\IDEWORK\lvmen\src\licensedcode\data\rules\gpl-2.0-plus_574.yml", "YAML", 0, 0, 0, 3, 0, 0, 1, 4
"d:\IDEWORK\lvmen\src\licensedcode\data\rules\gpl-2.0-plus_575.yml", "YAML", 0, 0, 0, 3, 0, 0, 1, 4
"d:\IDEWORK\lvmen\src\licensedcode\data\rules\gpl-2.0-plus_576.yml", "YAML", 0, 0, 0, 3, 0, 0, 1, 4
"d:\IDEWORK\lvmen\src\licensedcode\data\rules\gpl-2.0-plus_577.yml", "YAML", 0, 0, 0, 3, 0, 0, 1, 4
"d:\IDEWORK\lvmen\src\licensedcode\data\rules\gpl-2.0-plus_578.yml", "YAML", 0, 0, 0, 3, 0, 0, 1, 4
"d:\IDEWORK\lvmen\src\licensedcode\data\rules\gpl-2.0-plus_579.yml", "YAML", 0, 0, 0, 3, 0, 0, 1, 4
"d:\IDEWORK\lvmen\src\licensedcode\data\rules\gpl-2.0-plus_58.yml", "YAML", 0, 0, 0, 2, 0, 0, 1, 3
"d:\IDEWORK\lvmen\src\licensedcode\data\rules\gpl-2.0-plus_580.yml", "YAML", 0, 0, 0, 3, 0, 0, 1, 4
"d:\IDEWORK\lvmen\src\licensedcode\data\rules\gpl-2.0-plus_581.yml", "YAML", 0, 0, 0, 3, 0, 0, 1, 4
"d:\IDEWORK\lvmen\src\licensedcode\data\rules\gpl-2.0-plus_582.yml", "YAML", 0, 0, 0, 3, 0, 0, 1, 4
"d:\IDEWORK\lvmen\src\licensedcode\data\rules\gpl-2.0-plus_583.yml", "YAML", 0, 0, 0, 3, 0, 0, 1, 4
"d:\IDEWORK\lvmen\src\licensedcode\data\rules\gpl-2.0-plus_584.yml", "YAML", 0, 0, 0, 3, 0, 0, 1, 4
"d:\IDEWORK\lvmen\src\licensedcode\data\rules\gpl-2.0-plus_585.yml", "YAML", 0, 0, 0, 3, 0, 0, 1, 4
"d:\IDEWORK\lvmen\src\licensedcode\data\rules\gpl-2.0-plus_586.yml", "YAML", 0, 0, 0, 3, 0, 0, 1, 4
"d:\IDEWORK\lvmen\src\licensedcode\data\rules\gpl-2.0-plus_587.yml", "YAML", 0, 0, 0, 4, 0, 0, 1, 5
"d:\IDEWORK\lvmen\src\licensedcode\data\rules\gpl-2.0-plus_588.yml", "YAML", 0, 0, 0, 3, 0, 0, 1, 4
"d:\IDEWORK\lvmen\src\licensedcode\data\rules\gpl-2.0-plus_589.yml", "YAML", 0, 0, 0, 3, 0, 0, 1, 4
"d:\IDEWORK\lvmen\src\licensedcode\data\rules\gpl-2.0-plus_59.yml", "YAML", 0, 0, 0, 2, 0, 0, 1, 3
"d:\IDEWORK\lvmen\src\licensedcode\data\rules\gpl-2.0-plus_590.yml", "YAML", 0, 0, 0, 3, 0, 0, 1, 4
"d:\IDEWORK\lvmen\src\licensedcode\data\rules\gpl-2.0-plus_591.yml", "YAML", 0, 0, 0, 3, 0, 0, 1, 4
"d:\IDEWORK\lvmen\src\licensedcode\data\rules\gpl-2.0-plus_592.yml", "YAML", 0, 0, 0, 3, 0, 0, 1, 4
"d:\IDEWORK\lvmen\src\licensedcode\data\rules\gpl-2.0-plus_593.yml", "YAML", 0, 0, 0, 5, 0, 0, 1, 6
"d:\IDEWORK\lvmen\src\licensedcode\data\rules\gpl-2.0-plus_594.yml", "YAML", 0, 0, 0, 3, 0, 0, 1, 4
"d:\IDEWORK\lvmen\src\licensedcode\data\rules\gpl-2.0-plus_595.yml", "YAML", 0, 0, 0, 3, 0, 0, 1, 4
"d:\IDEWORK\lvmen\src\licensedcode\data\rules\gpl-2.0-plus_596.yml", "YAML", 0, 0, 0, 11, 0, 0, 1, 12
"d:\IDEWORK\lvmen\src\licensedcode\data\rules\gpl-2.0-plus_597.yml", "YAML", 0, 0, 0, 5, 0, 0, 1, 6
"d:\IDEWORK\lvmen\src\licensedcode\data\rules\gpl-2.0-plus_598.yml", "YAML", 0, 0, 0, 5, 0, 0, 1, 6
"d:\IDEWORK\lvmen\src\licensedcode\data\rules\gpl-2.0-plus_599.yml", "YAML", 0, 0, 0, 3, 0, 0, 1, 4
"d:\IDEWORK\lvmen\src\licensedcode\data\rules\gpl-2.0-plus_6.yml", "YAML", 0, 0, 0, 3, 0, 0, 1, 4
"d:\IDEWORK\lvmen\src\licensedcode\data\rules\gpl-2.0-plus_60.yml", "YAML", 0, 0, 0, 4, 0, 0, 1, 5
"d:\IDEWORK\lvmen\src\licensedcode\data\rules\gpl-2.0-plus_600.yml", "YAML", 0, 0, 0, 3, 0, 0, 1, 4
"d:\IDEWORK\lvmen\src\licensedcode\data\rules\gpl-2.0-plus_601.yml", "YAML", 0, 0, 0, 3, 0, 0, 1, 4
"d:\IDEWORK\lvmen\src\licensedcode\data\rules\gpl-2.0-plus_602.yml", "YAML", 0, 0, 0, 3, 0, 0, 1, 4
"d:\IDEWORK\lvmen\src\licensedcode\data\rules\gpl-2.0-plus_603.yml", "YAML", 0, 0, 0, 3, 0, 0, 1, 4
"d:\IDEWORK\lvmen\src\licensedcode\data\rules\gpl-2.0-plus_604.yml", "YAML", 0, 0, 0, 5, 0, 0, 1, 6
"d:\IDEWORK\lvmen\src\licensedcode\data\rules\gpl-2.0-plus_605.yml", "YAML", 0, 0, 0, 8, 0, 0, 1, 9
"d:\IDEWORK\lvmen\src\licensedcode\data\rules\gpl-2.0-plus_606.yml", "YAML", 0, 0, 0, 8, 0, 0, 1, 9
"d:\IDEWORK\lvmen\src\licensedcode\data\rules\gpl-2.0-plus_607.yml", "YAML", 0, 0, 0, 3, 0, 0, 1, 4
"d:\IDEWORK\lvmen\src\licensedcode\data\rules\gpl-2.0-plus_608.yml", "YAML", 0, 0, 0, 3, 0, 0, 1, 4
"d:\IDEWORK\lvmen\src\licensedcode\data\rules\gpl-2.0-plus_609.yml", "YAML", 0, 0, 0, 3, 0, 0, 1, 4
"d:\IDEWORK\lvmen\src\licensedcode\data\rules\gpl-2.0-plus_61.yml", "YAML", 0, 0, 0, 3, 0, 0, 1, 4
"d:\IDEWORK\lvmen\src\licensedcode\data\rules\gpl-2.0-plus_610.yml", "YAML", 0, 0, 0, 4, 0, 0, 1, 5
"d:\IDEWORK\lvmen\src\licensedcode\data\rules\gpl-2.0-plus_611.yml", "YAML", 0, 0, 0, 5, 0, 0, 1, 6
"d:\IDEWORK\lvmen\src\licensedcode\data\rules\gpl-2.0-plus_612.yml", "YAML", 0, 0, 0, 5, 0, 0, 1, 6
"d:\IDEWORK\lvmen\src\licensedcode\data\rules\gpl-2.0-plus_613.yml", "YAML", 0, 0, 0, 3, 0, 0, 1, 4
"d:\IDEWORK\lvmen\src\licensedcode\data\rules\gpl-2.0-plus_614.yml", "YAML", 0, 0, 0, 5, 0, 0, 1, 6
"d:\IDEWORK\lvmen\src\licensedcode\data\rules\gpl-2.0-plus_615.yml", "YAML", 0, 0, 0, 3, 0, 0, 1, 4
"d:\IDEWORK\lvmen\src\licensedcode\data\rules\gpl-2.0-plus_616.yml", "YAML", 0, 0, 0, 3, 0, 0, 1, 4
"d:\IDEWORK\lvmen\src\licensedcode\data\rules\gpl-2.0-plus_617.yml", "YAML", 0, 0, 0, 5, 0, 0, 1, 6
"d:\IDEWORK\lvmen\src\licensedcode\data\rules\gpl-2.0-plus_618.yml", "YAML", 0, 0, 0, 5, 0, 0, 1, 6
"d:\IDEWORK\lvmen\src\licensedcode\data\rules\gpl-2.0-plus_619.yml", "YAML", 0, 0, 0, 5, 0, 0, 1, 6
"d:\IDEWORK\lvmen\src\licensedcode\data\rules\gpl-2.0-plus_62.yml", "YAML", 0, 0, 0, 2, 0, 0, 1, 3
"d:\IDEWORK\lvmen\src\licensedcode\data\rules\gpl-2.0-plus_620.yml", "YAML", 0, 0, 0, 3, 0, 0, 1, 4
"d:\IDEWORK\lvmen\src\licensedcode\data\rules\gpl-2.0-plus_621.yml", "YAML", 0, 0, 0, 3, 0, 0, 1, 4
"d:\IDEWORK\lvmen\src\licensedcode\data\rules\gpl-2.0-plus_622.yml", "YAML", 0, 0, 0, 3, 0, 0, 1, 4
"d:\IDEWORK\lvmen\src\licensedcode\data\rules\gpl-2.0-plus_623.yml", "YAML", 0, 0, 0, 8, 0, 0, 1, 9
"d:\IDEWORK\lvmen\src\licensedcode\data\rules\gpl-2.0-plus_624.yml", "YAML", 0, 0, 0, 3, 0, 0, 1, 4
"d:\IDEWORK\lvmen\src\licensedcode\data\rules\gpl-2.0-plus_625.yml", "YAML", 0, 0, 0, 3, 0, 0, 1, 4
"d:\IDEWORK\lvmen\src\licensedcode\data\rules\gpl-2.0-plus_626.yml", "YAML", 0, 0, 0, 3, 0, 0, 1, 4
"d:\IDEWORK\lvmen\src\licensedcode\data\rules\gpl-2.0-plus_627.yml", "YAML", 0, 0, 0, 3, 0, 0, 1, 4
"d:\IDEWORK\lvmen\src\licensedcode\data\rules\gpl-2.0-plus_628.yml", "YAML", 0, 0, 0, 3, 0, 0, 1, 4
"d:\IDEWORK\lvmen\src\licensedcode\data\rules\gpl-2.0-plus_629.yml", "YAML", 0, 0, 0, 5, 0, 0, 1, 6
"d:\IDEWORK\lvmen\src\licensedcode\data\rules\gpl-2.0-plus_63.yml", "YAML", 0, 0, 0, 4, 0, 0, 1, 5
"d:\IDEWORK\lvmen\src\licensedcode\data\rules\gpl-2.0-plus_630.yml", "YAML", 0, 0, 0, 5, 0, 0, 1, 6
"d:\IDEWORK\lvmen\src\licensedcode\data\rules\gpl-2.0-plus_631.yml", "YAML", 0, 0, 0, 3, 0, 0, 1, 4
"d:\IDEWORK\lvmen\src\licensedcode\data\rules\gpl-2.0-plus_632.yml", "YAML", 0, 0, 0, 3, 0, 0, 1, 4
"d:\IDEWORK\lvmen\src\licensedcode\data\rules\gpl-2.0-plus_633.yml", "YAML", 0, 0, 0, 3, 0, 0, 1, 4
"d:\IDEWORK\lvmen\src\licensedcode\data\rules\gpl-2.0-plus_634.yml", "YAML", 0, 0, 0, 3, 0, 0, 1, 4
"d:\IDEWORK\lvmen\src\licensedcode\data\rules\gpl-2.0-plus_635.yml", "YAML", 0, 0, 0, 3, 0, 0, 1, 4
"d:\IDEWORK\lvmen\src\licensedcode\data\rules\gpl-2.0-plus_636.yml", "YAML", 0, 0, 0, 3, 0, 0, 1, 4
"d:\IDEWORK\lvmen\src\licensedcode\data\rules\gpl-2.0-plus_637.yml", "YAML", 0, 0, 0, 3, 0, 0, 1, 4
"d:\IDEWORK\lvmen\src\licensedcode\data\rules\gpl-2.0-plus_638.yml", "YAML", 0, 0, 0, 5, 0, 0, 1, 6
"d:\IDEWORK\lvmen\src\licensedcode\data\rules\gpl-2.0-plus_639.yml", "YAML", 0, 0, 0, 5, 0, 0, 1, 6
"d:\IDEWORK\lvmen\src\licensedcode\data\rules\gpl-2.0-plus_64.yml", "YAML", 0, 0, 0, 2, 0, 0, 1, 3
"d:\IDEWORK\lvmen\src\licensedcode\data\rules\gpl-2.0-plus_640.yml", "YAML", 0, 0, 0, 3, 0, 0, 1, 4
"d:\IDEWORK\lvmen\src\licensedcode\data\rules\gpl-2.0-plus_641.yml", "YAML", 0, 0, 0, 6, 0, 0, 1, 7
"d:\IDEWORK\lvmen\src\licensedcode\data\rules\gpl-2.0-plus_642.yml", "YAML", 0, 0, 0, 3, 0, 0, 1, 4
"d:\IDEWORK\lvmen\src\licensedcode\data\rules\gpl-2.0-plus_643.yml", "YAML", 0, 0, 0, 3, 0, 0, 1, 4
"d:\IDEWORK\lvmen\src\licensedcode\data\rules\gpl-2.0-plus_644.yml", "YAML", 0, 0, 0, 5, 0, 0, 1, 6
"d:\IDEWORK\lvmen\src\licensedcode\data\rules\gpl-2.0-plus_645.yml", "YAML", 0, 0, 0, 5, 0, 0, 1, 6
"d:\IDEWORK\lvmen\src\licensedcode\data\rules\gpl-2.0-plus_646.yml", "YAML", 0, 0, 0, 5, 0, 0, 1, 6
"d:\IDEWORK\lvmen\src\licensedcode\data\rules\gpl-2.0-plus_647.yml", "YAML", 0, 0, 0, 5, 0, 0, 1, 6
"d:\IDEWORK\lvmen\src\licensedcode\data\rules\gpl-2.0-plus_648.yml", "YAML", 0, 0, 0, 5, 0, 0, 1, 6
"d:\IDEWORK\lvmen\src\licensedcode\data\rules\gpl-2.0-plus_649.yml", "YAML", 0, 0, 0, 5, 0, 0, 1, 6
"d:\IDEWORK\lvmen\src\licensedcode\data\rules\gpl-2.0-plus_65.yml", "YAML", 0, 0, 0, 3, 0, 0, 1, 4
"d:\IDEWORK\lvmen\src\licensedcode\data\rules\gpl-2.0-plus_650.yml", "YAML", 0, 0, 0, 5, 0, 0, 1, 6
"d:\IDEWORK\lvmen\src\licensedcode\data\rules\gpl-2.0-plus_651.yml", "YAML", 0, 0, 0, 5, 0, 0, 1, 6
"d:\IDEWORK\lvmen\src\licensedcode\data\rules\gpl-2.0-plus_652.yml", "YAML", 0, 0, 0, 3, 0, 0, 1, 4
"d:\IDEWORK\lvmen\src\licensedcode\data\rules\gpl-2.0-plus_653.yml", "YAML", 0, 0, 0, 5, 0, 0, 1, 6
"d:\IDEWORK\lvmen\src\licensedcode\data\rules\gpl-2.0-plus_654.yml", "YAML", 0, 0, 0, 3, 0, 0, 1, 4
"d:\IDEWORK\lvmen\src\licensedcode\data\rules\gpl-2.0-plus_655.yml", "YAML", 0, 0, 0, 5, 0, 0, 1, 6
"d:\IDEWORK\lvmen\src\licensedcode\data\rules\gpl-2.0-plus_656.yml", "YAML", 0, 0, 0, 4, 0, 0, 1, 5
"d:\IDEWORK\lvmen\src\licensedcode\data\rules\gpl-2.0-plus_657.yml", "YAML", 0, 0, 0, 3, 0, 0, 1, 4
"d:\IDEWORK\lvmen\src\licensedcode\data\rules\gpl-2.0-plus_658.yml", "YAML", 0, 0, 0, 3, 0, 0, 1, 4
"d:\IDEWORK\lvmen\src\licensedcode\data\rules\gpl-2.0-plus_659.yml", "YAML", 0, 0, 0, 3, 0, 0, 1, 4
"d:\IDEWORK\lvmen\src\licensedcode\data\rules\gpl-2.0-plus_66.yml", "YAML", 0, 0, 0, 2, 0, 0, 1, 3
"d:\IDEWORK\lvmen\src\licensedcode\data\rules\gpl-2.0-plus_660.yml", "YAML", 0, 0, 0, 3, 0, 0, 1, 4
"d:\IDEWORK\lvmen\src\licensedcode\data\rules\gpl-2.0-plus_661.yml", "YAML", 0, 0, 0, 3, 0, 0, 1, 4
"d:\IDEWORK\lvmen\src\licensedcode\data\rules\gpl-2.0-plus_662.yml", "YAML", 0, 0, 0, 4, 0, 0, 1, 5
"d:\IDEWORK\lvmen\src\licensedcode\data\rules\gpl-2.0-plus_663.yml", "YAML", 0, 0, 0, 4, 0, 0, 1, 5
"d:\IDEWORK\lvmen\src\licensedcode\data\rules\gpl-2.0-plus_664.yml", "YAML", 0, 0, 0, 5, 0, 0, 1, 6
"d:\IDEWORK\lvmen\src\licensedcode\data\rules\gpl-2.0-plus_665.yml", "YAML", 0, 0, 0, 5, 0, 0, 1, 6
"d:\IDEWORK\lvmen\src\licensedcode\data\rules\gpl-2.0-plus_666.yml", "YAML", 0, 0, 0, 3, 0, 0, 1, 4
"d:\IDEWORK\lvmen\src\licensedcode\data\rules\gpl-2.0-plus_667.yml", "YAML", 0, 0, 0, 3, 0, 0, 1, 4
"d:\IDEWORK\lvmen\src\licensedcode\data\rules\gpl-2.0-plus_668.yml", "YAML", 0, 0, 0, 5, 0, 0, 1, 6
"d:\IDEWORK\lvmen\src\licensedcode\data\rules\gpl-2.0-plus_669.yml", "YAML", 0, 0, 0, 4, 0, 0, 1, 5
"d:\IDEWORK\lvmen\src\licensedcode\data\rules\gpl-2.0-plus_67.yml", "YAML", 0, 0, 0, 4, 0, 0, 1, 5
"d:\IDEWORK\lvmen\src\licensedcode\data\rules\gpl-2.0-plus_670.yml", "YAML", 0, 0, 0, 3, 0, 0, 1, 4
"d:\IDEWORK\lvmen\src\licensedcode\data\rules\gpl-2.0-plus_671.yml", "YAML", 0, 0, 0, 6, 0, 0, 1, 7
"d:\IDEWORK\lvmen\src\licensedcode\data\rules\gpl-2.0-plus_672.yml", "YAML", 0, 0, 0, 5, 0, 0, 1, 6
"d:\IDEWORK\lvmen\src\licensedcode\data\rules\gpl-2.0-plus_673.yml", "YAML", 0, 0, 0, 5, 0, 0, 1, 6
"d:\IDEWORK\lvmen\src\licensedcode\data\rules\gpl-2.0-plus_674.yml", "YAML", 0, 0, 0, 3, 0, 0, 1, 4
"d:\IDEWORK\lvmen\src\licensedcode\data\rules\gpl-2.0-plus_675.yml", "YAML", 0, 0, 0, 5, 0, 0, 1, 6
"d:\IDEWORK\lvmen\src\licensedcode\data\rules\gpl-2.0-plus_676.yml", "YAML", 0, 0, 0, 5, 0, 0, 1, 6
"d:\IDEWORK\lvmen\src\licensedcode\data\rules\gpl-2.0-plus_677.yml", "YAML", 0, 0, 0, 5, 0, 0, 1, 6
"d:\IDEWORK\lvmen\src\licensedcode\data\rules\gpl-2.0-plus_678.yml", "YAML", 0, 0, 0, 3, 0, 0, 1, 4
"d:\IDEWORK\lvmen\src\licensedcode\data\rules\gpl-2.0-plus_679.yml", "YAML", 0, 0, 0, 2, 0, 0, 1, 3
"d:\IDEWORK\lvmen\src\licensedcode\data\rules\gpl-2.0-plus_68.yml", "YAML", 0, 0, 0, 2, 0, 0, 1, 3
"d:\IDEWORK\lvmen\src\licensedcode\data\rules\gpl-2.0-plus_680.yml", "YAML", 0, 0, 0, 7, 0, 0, 1, 8
"d:\IDEWORK\lvmen\src\licensedcode\data\rules\gpl-2.0-plus_681.yml", "YAML", 0, 0, 0, 7, 0, 0, 1, 8
"d:\IDEWORK\lvmen\src\licensedcode\data\rules\gpl-2.0-plus_682.yml", "YAML", 0, 0, 0, 7, 0, 0, 1, 8
"d:\IDEWORK\lvmen\src\licensedcode\data\rules\gpl-2.0-plus_683.yml", "YAML", 0, 0, 0, 7, 0, 0, 1, 8
"d:\IDEWORK\lvmen\src\licensedcode\data\rules\gpl-2.0-plus_684.yml", "YAML", 0, 0, 0, 4, 0, 0, 1, 5
"d:\IDEWORK\lvmen\src\licensedcode\data\rules\gpl-2.0-plus_685.yml", "YAML", 0, 0, 0, 3, 0, 0, 1, 4
"d:\IDEWORK\lvmen\src\licensedcode\data\rules\gpl-2.0-plus_686.yml", "YAML", 0, 0, 0, 5, 0, 0, 1, 6
"d:\IDEWORK\lvmen\src\licensedcode\data\rules\gpl-2.0-plus_687.yml", "YAML", 0, 0, 0, 3, 0, 0, 1, 4
"d:\IDEWORK\lvmen\src\licensedcode\data\rules\gpl-2.0-plus_688.yml", "YAML", 0, 0, 0, 4, 0, 0, 1, 5
"d:\IDEWORK\lvmen\src\licensedcode\data\rules\gpl-2.0-plus_689.yml", "YAML", 0, 0, 0, 3, 0, 0, 1, 4
"d:\IDEWORK\lvmen\src\licensedcode\data\rules\gpl-2.0-plus_69.yml", "YAML", 0, 0, 0, 2, 0, 0, 1, 3
"d:\IDEWORK\lvmen\src\licensedcode\data\rules\gpl-2.0-plus_690.yml", "YAML", 0, 0, 0, 3, 0, 0, 1, 4
"d:\IDEWORK\lvmen\src\licensedcode\data\rules\gpl-2.0-plus_691.yml", "YAML", 0, 0, 0, 3, 0, 0, 1, 4
"d:\IDEWORK\lvmen\src\licensedcode\data\rules\gpl-2.0-plus_692.yml", "YAML", 0, 0, 0, 3, 0, 0, 1, 4
"d:\IDEWORK\lvmen\src\licensedcode\data\rules\gpl-2.0-plus_693.yml", "YAML", 0, 0, 0, 3, 0, 0, 1, 4
"d:\IDEWORK\lvmen\src\licensedcode\data\rules\gpl-2.0-plus_694.yml", "YAML", 0, 0, 0, 3, 0, 0, 1, 4
"d:\IDEWORK\lvmen\src\licensedcode\data\rules\gpl-2.0-plus_695.yml", "YAML", 0, 0, 0, 3, 0, 0, 1, 4
"d:\IDEWORK\lvmen\src\licensedcode\data\rules\gpl-2.0-plus_696.yml", "YAML", 0, 0, 0, 3, 0, 0, 1, 4
"d:\IDEWORK\lvmen\src\licensedcode\data\rules\gpl-2.0-plus_697.yml", "YAML", 0, 0, 0, 3, 0, 0, 1, 4
"d:\IDEWORK\lvmen\src\licensedcode\data\rules\gpl-2.0-plus_698.yml", "YAML", 0, 0, 0, 3, 0, 0, 1, 4
"d:\IDEWORK\lvmen\src\licensedcode\data\rules\gpl-2.0-plus_699.yml", "YAML", 0, 0, 0, 5, 0, 0, 1, 6
"d:\IDEWORK\lvmen\src\licensedcode\data\rules\gpl-2.0-plus_7.yml", "YAML", 0, 0, 0, 6, 0, 0, 1, 7
"d:\IDEWORK\lvmen\src\licensedcode\data\rules\gpl-2.0-plus_70.yml", "YAML", 0, 0, 0, 3, 0, 0, 1, 4
"d:\IDEWORK\lvmen\src\licensedcode\data\rules\gpl-2.0-plus_700.yml", "YAML", 0, 0, 0, 3, 0, 0, 1, 4
"d:\IDEWORK\lvmen\src\licensedcode\data\rules\gpl-2.0-plus_701.yml", "YAML", 0, 0, 0, 4, 0, 0, 1, 5
"d:\IDEWORK\lvmen\src\licensedcode\data\rules\gpl-2.0-plus_702.yml", "YAML", 0, 0, 0, 4, 0, 0, 1, 5
"d:\IDEWORK\lvmen\src\licensedcode\data\rules\gpl-2.0-plus_703.yml", "YAML", 0, 0, 0, 4, 0, 0, 1, 5
"d:\IDEWORK\lvmen\src\licensedcode\data\rules\gpl-2.0-plus_704.yml", "YAML", 0, 0, 0, 4, 0, 0, 1, 5
"d:\IDEWORK\lvmen\src\licensedcode\data\rules\gpl-2.0-plus_705.yml", "YAML", 0, 0, 0, 4, 0, 0, 1, 5
"d:\IDEWORK\lvmen\src\licensedcode\data\rules\gpl-2.0-plus_706.yml", "YAML", 0, 0, 0, 4, 0, 0, 1, 5
"d:\IDEWORK\lvmen\src\licensedcode\data\rules\gpl-2.0-plus_707.yml", "YAML", 0, 0, 0, 3, 0, 0, 1, 4
"d:\IDEWORK\lvmen\src\licensedcode\data\rules\gpl-2.0-plus_708.yml", "YAML", 0, 0, 0, 3, 0, 0, 1, 4
"d:\IDEWORK\lvmen\src\licensedcode\data\rules\gpl-2.0-plus_709.yml", "YAML", 0, 0, 0, 3, 0, 0, 1, 4
"d:\IDEWORK\lvmen\src\licensedcode\data\rules\gpl-2.0-plus_71.yml", "YAML", 0, 0, 0, 3, 0, 0, 2, 5
"d:\IDEWORK\lvmen\src\licensedcode\data\rules\gpl-2.0-plus_710.yml", "YAML", 0, 0, 0, 3, 0, 0, 1, 4
"d:\IDEWORK\lvmen\src\licensedcode\data\rules\gpl-2.0-plus_711.yml", "YAML", 0, 0, 0, 5, 0, 0, 1, 6
"d:\IDEWORK\lvmen\src\licensedcode\data\rules\gpl-2.0-plus_712.yml", "YAML", 0, 0, 0, 3, 0, 0, 1, 4
"d:\IDEWORK\lvmen\src\licensedcode\data\rules\gpl-2.0-plus_713.yml", "YAML", 0, 0, 0, 5, 0, 0, 1, 6
"d:\IDEWORK\lvmen\src\licensedcode\data\rules\gpl-2.0-plus_714.yml", "YAML", 0, 0, 0, 3, 0, 0, 1, 4
"d:\IDEWORK\lvmen\src\licensedcode\data\rules\gpl-2.0-plus_715.yml", "YAML", 0, 0, 0, 3, 0, 0, 1, 4
"d:\IDEWORK\lvmen\src\licensedcode\data\rules\gpl-2.0-plus_716.yml", "YAML", 0, 0, 0, 3, 0, 0, 1, 4
"d:\IDEWORK\lvmen\src\licensedcode\data\rules\gpl-2.0-plus_717.yml", "YAML", 0, 0, 0, 3, 0, 0, 1, 4
"d:\IDEWORK\lvmen\src\licensedcode\data\rules\gpl-2.0-plus_718.yml", "YAML", 0, 0, 0, 3, 0, 0, 1, 4
"d:\IDEWORK\lvmen\src\licensedcode\data\rules\gpl-2.0-plus_719.yml", "YAML", 0, 0, 0, 3, 0, 0, 1, 4
"d:\IDEWORK\lvmen\src\licensedcode\data\rules\gpl-2.0-plus_72.yml", "YAML", 0, 0, 0, 2, 0, 0, 1, 3
"d:\IDEWORK\lvmen\src\licensedcode\data\rules\gpl-2.0-plus_720.yml", "YAML", 0, 0, 0, 3, 0, 0, 1, 4
"d:\IDEWORK\lvmen\src\licensedcode\data\rules\gpl-2.0-plus_721.yml", "YAML", 0, 0, 0, 5, 0, 0, 1, 6
"d:\IDEWORK\lvmen\src\licensedcode\data\rules\gpl-2.0-plus_722.yml", "YAML", 0, 0, 0, 3, 0, 0, 1, 4
"d:\IDEWORK\lvmen\src\licensedcode\data\rules\gpl-2.0-plus_723.yml", "YAML", 0, 0, 0, 3, 0, 0, 1, 4
"d:\IDEWORK\lvmen\src\licensedcode\data\rules\gpl-2.0-plus_724.yml", "YAML", 0, 0, 0, 5, 0, 0, 1, 6
"d:\IDEWORK\lvmen\src\licensedcode\data\rules\gpl-2.0-plus_725.yml", "YAML", 0, 0, 0, 5, 0, 0, 1, 6
"d:\IDEWORK\lvmen\src\licensedcode\data\rules\gpl-2.0-plus_726.yml", "YAML", 0, 0, 0, 5, 0, 0, 1, 6
"d:\IDEWORK\lvmen\src\licensedcode\data\rules\gpl-2.0-plus_727.yml", "YAML", 0, 0, 0, 5, 0, 0, 1, 6
"d:\IDEWORK\lvmen\src\licensedcode\data\rules\gpl-2.0-plus_728.yml", "YAML", 0, 0, 0, 3, 0, 0, 1, 4
"d:\IDEWORK\lvmen\src\licensedcode\data\rules\gpl-2.0-plus_729.yml", "YAML", 0, 0, 0, 3, 0, 0, 1, 4
"d:\IDEWORK\lvmen\src\licensedcode\data\rules\gpl-2.0-plus_73.yml", "YAML", 0, 0, 0, 2, 0, 0, 1, 3
"d:\IDEWORK\lvmen\src\licensedcode\data\rules\gpl-2.0-plus_730.yml", "YAML", 0, 0, 0, 3, 0, 0, 1, 4
"d:\IDEWORK\lvmen\src\licensedcode\data\rules\gpl-2.0-plus_731.yml", "YAML", 0, 0, 0, 3, 0, 0, 1, 4
"d:\IDEWORK\lvmen\src\licensedcode\data\rules\gpl-2.0-plus_732.yml", "YAML", 0, 0, 0, 5, 0, 0, 1, 6
"d:\IDEWORK\lvmen\src\licensedcode\data\rules\gpl-2.0-plus_733.yml", "YAML", 0, 0, 0, 3, 0, 0, 1, 4
"d:\IDEWORK\lvmen\src\licensedcode\data\rules\gpl-2.0-plus_734.yml", "YAML", 0, 0, 0, 5, 0, 0, 1, 6
"d:\IDEWORK\lvmen\src\licensedcode\data\rules\gpl-2.0-plus_735.yml", "YAML", 0, 0, 0, 7, 0, 0, 1, 8
"d:\IDEWORK\lvmen\src\licensedcode\data\rules\gpl-2.0-plus_736.yml", "YAML", 0, 0, 0, 7, 0, 0, 1, 8
"d:\IDEWORK\lvmen\src\licensedcode\data\rules\gpl-2.0-plus_737.yml", "YAML", 0, 0, 0, 5, 0, 0, 1, 6
"d:\IDEWORK\lvmen\src\licensedcode\data\rules\gpl-2.0-plus_738.yml", "YAML", 0, 0, 0, 5, 0, 0, 1, 6
"d:\IDEWORK\lvmen\src\licensedcode\data\rules\gpl-2.0-plus_739.yml", "YAML", 0, 0, 0, 5, 0, 0, 1, 6
"d:\IDEWORK\lvmen\src\licensedcode\data\rules\gpl-2.0-plus_74.yml", "YAML", 0, 0, 0, 4, 0, 0, 1, 5
"d:\IDEWORK\lvmen\src\licensedcode\data\rules\gpl-2.0-plus_740.yml", "YAML", 0, 0, 0, 7, 0, 0, 1, 8
"d:\IDEWORK\lvmen\src\licensedcode\data\rules\gpl-2.0-plus_741.yml", "YAML", 0, 0, 0, 7, 0, 0, 1, 8
"d:\IDEWORK\lvmen\src\licensedcode\data\rules\gpl-2.0-plus_742.yml", "YAML", 0, 0, 0, 7, 0, 0, 1, 8
"d:\IDEWORK\lvmen\src\licensedcode\data\rules\gpl-2.0-plus_743.yml", "YAML", 0, 0, 0, 3, 0, 0, 1, 4
"d:\IDEWORK\lvmen\src\licensedcode\data\rules\gpl-2.0-plus_744.yml", "YAML", 0, 0, 0, 5, 0, 0, 1, 6
"d:\IDEWORK\lvmen\src\licensedcode\data\rules\gpl-2.0-plus_745.yml", "YAML", 0, 0, 0, 3, 0, 0, 1, 4
"d:\IDEWORK\lvmen\src\licensedcode\data\rules\gpl-2.0-plus_746.yml", "YAML", 0, 0, 0, 5, 0, 0, 1, 6
"d:\IDEWORK\lvmen\src\licensedcode\data\rules\gpl-2.0-plus_747.yml", "YAML", 0, 0, 0, 4, 0, 0, 1, 5
"d:\IDEWORK\lvmen\src\licensedcode\data\rules\gpl-2.0-plus_748.yml", "YAML", 0, 0, 0, 3, 0, 0, 1, 4
"d:\IDEWORK\lvmen\src\licensedcode\data\rules\gpl-2.0-plus_749.yml", "YAML", 0, 0, 0, 5, 0, 0, 1, 6
"d:\IDEWORK\lvmen\src\licensedcode\data\rules\gpl-2.0-plus_75.yml", "YAML", 0, 0, 0, 4, 0, 0, 1, 5
"d:\IDEWORK\lvmen\src\licensedcode\data\rules\gpl-2.0-plus_750.yml", "YAML", 0, 0, 0, 6, 0, 0, 1, 7
"d:\IDEWORK\lvmen\src\licensedcode\data\rules\gpl-2.0-plus_751.yml", "YAML", 0, 0, 0, 6, 0, 0, 1, 7
"d:\IDEWORK\lvmen\src\licensedcode\data\rules\gpl-2.0-plus_752.yml", "YAML", 0, 0, 0, 5, 0, 0, 1, 6
"d:\IDEWORK\lvmen\src\licensedcode\data\rules\gpl-2.0-plus_753.yml", "YAML", 0, 0, 0, 3, 0, 0, 1, 4
"d:\IDEWORK\lvmen\src\licensedcode\data\rules\gpl-2.0-plus_754.yml", "YAML", 0, 0, 0, 3, 0, 0, 1, 4
"d:\IDEWORK\lvmen\src\licensedcode\data\rules\gpl-2.0-plus_755.yml", "YAML", 0, 0, 0, 3, 0, 0, 1, 4
"d:\IDEWORK\lvmen\src\licensedcode\data\rules\gpl-2.0-plus_756.yml", "YAML", 0, 0, 0, 3, 0, 0, 1, 4
"d:\IDEWORK\lvmen\src\licensedcode\data\rules\gpl-2.0-plus_757.yml", "YAML", 0, 0, 0, 4, 0, 0, 1, 5
"d:\IDEWORK\lvmen\src\licensedcode\data\rules\gpl-2.0-plus_758.yml", "YAML", 0, 0, 0, 3, 0, 0, 1, 4
"d:\IDEWORK\lvmen\src\licensedcode\data\rules\gpl-2.0-plus_759.yml", "YAML", 0, 0, 0, 7, 0, 0, 1, 8
"d:\IDEWORK\lvmen\src\licensedcode\data\rules\gpl-2.0-plus_76.yml", "YAML", 0, 0, 0, 4, 0, 0, 1, 5
"d:\IDEWORK\lvmen\src\licensedcode\data\rules\gpl-2.0-plus_760.yml", "YAML", 0, 0, 0, 7, 0, 0, 1, 8
"d:\IDEWORK\lvmen\src\licensedcode\data\rules\gpl-2.0-plus_761.yml", "YAML", 0, 0, 0, 3, 0, 0, 1, 4
"d:\IDEWORK\lvmen\src\licensedcode\data\rules\gpl-2.0-plus_762.yml", "YAML", 0, 0, 0, 3, 0, 0, 1, 4
"d:\IDEWORK\lvmen\src\licensedcode\data\rules\gpl-2.0-plus_763.yml", "YAML", 0, 0, 0, 3, 0, 0, 1, 4
"d:\IDEWORK\lvmen\src\licensedcode\data\rules\gpl-2.0-plus_764.yml", "YAML", 0, 0, 0, 3, 0, 0, 1, 4
"d:\IDEWORK\lvmen\src\licensedcode\data\rules\gpl-2.0-plus_765.yml", "YAML", 0, 0, 0, 4, 0, 0, 1, 5
"d:\IDEWORK\lvmen\src\licensedcode\data\rules\gpl-2.0-plus_766.yml", "YAML", 0, 0, 0, 4, 0, 0, 1, 5
"d:\IDEWORK\lvmen\src\licensedcode\data\rules\gpl-2.0-plus_767.yml", "YAML", 0, 0, 0, 3, 0, 0, 1, 4
"d:\IDEWORK\lvmen\src\licensedcode\data\rules\gpl-2.0-plus_768.yml", "YAML", 0, 0, 0, 3, 0, 0, 1, 4
"d:\IDEWORK\lvmen\src\licensedcode\data\rules\gpl-2.0-plus_769.yml", "YAML", 0, 0, 0, 3, 0, 0, 1, 4
"d:\IDEWORK\lvmen\src\licensedcode\data\rules\gpl-2.0-plus_77.yml", "YAML", 0, 0, 0, 6, 0, 0, 1, 7
"d:\IDEWORK\lvmen\src\licensedcode\data\rules\gpl-2.0-plus_770.yml", "YAML", 0, 0, 0, 5, 0, 0, 1, 6
"d:\IDEWORK\lvmen\src\licensedcode\data\rules\gpl-2.0-plus_771.yml", "YAML", 0, 0, 0, 3, 0, 0, 1, 4
"d:\IDEWORK\lvmen\src\licensedcode\data\rules\gpl-2.0-plus_772.yml", "YAML", 0, 0, 0, 3, 0, 0, 1, 4
"d:\IDEWORK\lvmen\src\licensedcode\data\rules\gpl-2.0-plus_773.yml", "YAML", 0, 0, 0, 5, 0, 0, 1, 6
"d:\IDEWORK\lvmen\src\licensedcode\data\rules\gpl-2.0-plus_774.yml", "YAML", 0, 0, 0, 3, 0, 0, 1, 4
"d:\IDEWORK\lvmen\src\licensedcode\data\rules\gpl-2.0-plus_775.yml", "YAML", 0, 0, 0, 3, 0, 0, 1, 4
"d:\IDEWORK\lvmen\src\licensedcode\data\rules\gpl-2.0-plus_776.yml", "YAML", 0, 0, 0, 3, 0, 0, 1, 4
"d:\IDEWORK\lvmen\src\licensedcode\data\rules\gpl-2.0-plus_777.yml", "YAML", 0, 0, 0, 6, 0, 0, 1, 7
"d:\IDEWORK\lvmen\src\licensedcode\data\rules\gpl-2.0-plus_778.yml", "YAML", 0, 0, 0, 3, 0, 0, 1, 4
"d:\IDEWORK\lvmen\src\licensedcode\data\rules\gpl-2.0-plus_779.yml", "YAML", 0, 0, 0, 3, 0, 0, 1, 4
"d:\IDEWORK\lvmen\src\licensedcode\data\rules\gpl-2.0-plus_78.yml", "YAML", 0, 0, 0, 2, 0, 0, 1, 3
"d:\IDEWORK\lvmen\src\licensedcode\data\rules\gpl-2.0-plus_780.yml", "YAML", 0, 0, 0, 3, 0, 0, 1, 4
"d:\IDEWORK\lvmen\src\licensedcode\data\rules\gpl-2.0-plus_781.yml", "YAML", 0, 0, 0, 3, 0, 0, 1, 4
"d:\IDEWORK\lvmen\src\licensedcode\data\rules\gpl-2.0-plus_782.yml", "YAML", 0, 0, 0, 5, 0, 0, 1, 6
"d:\IDEWORK\lvmen\src\licensedcode\data\rules\gpl-2.0-plus_783.yml", "YAML", 0, 0, 0, 6, 0, 0, 1, 7
"d:\IDEWORK\lvmen\src\licensedcode\data\rules\gpl-2.0-plus_784.yml", "YAML", 0, 0, 0, 3, 0, 0, 1, 4
"d:\IDEWORK\lvmen\src\licensedcode\data\rules\gpl-2.0-plus_785.yml", "YAML", 0, 0, 0, 3, 0, 0, 1, 4
"d:\IDEWORK\lvmen\src\licensedcode\data\rules\gpl-2.0-plus_786.yml", "YAML", 0, 0, 0, 5, 0, 0, 1, 6
"d:\IDEWORK\lvmen\src\licensedcode\data\rules\gpl-2.0-plus_787.yml", "YAML", 0, 0, 0, 5, 0, 0, 1, 6
"d:\IDEWORK\lvmen\src\licensedcode\data\rules\gpl-2.0-plus_788.yml", "YAML", 0, 0, 0, 3, 0, 0, 1, 4
"d:\IDEWORK\lvmen\src\licensedcode\data\rules\gpl-2.0-plus_789.yml", "YAML", 0, 0, 0, 3, 0, 0, 1, 4
"d:\IDEWORK\lvmen\src\licensedcode\data\rules\gpl-2.0-plus_79.yml", "YAML", 0, 0, 0, 3, 0, 0, 1, 4
"d:\IDEWORK\lvmen\src\licensedcode\data\rules\gpl-2.0-plus_790.yml", "YAML", 0, 0, 0, 3, 0, 0, 1, 4
"d:\IDEWORK\lvmen\src\licensedcode\data\rules\gpl-2.0-plus_791.yml", "YAML", 0, 0, 0, 5, 0, 0, 1, 6
"d:\IDEWORK\lvmen\src\licensedcode\data\rules\gpl-2.0-plus_792.yml", "YAML", 0, 0, 0, 5, 0, 0, 1, 6
"d:\IDEWORK\lvmen\src\licensedcode\data\rules\gpl-2.0-plus_793.yml", "YAML", 0, 0, 0, 4, 0, 0, 1, 5
"d:\IDEWORK\lvmen\src\licensedcode\data\rules\gpl-2.0-plus_794.yml", "YAML", 0, 0, 0, 6, 0, 0, 1, 7
"d:\IDEWORK\lvmen\src\licensedcode\data\rules\gpl-2.0-plus_795.yml", "YAML", 0, 0, 0, 3, 0, 0, 1, 4
"d:\IDEWORK\lvmen\src\licensedcode\data\rules\gpl-2.0-plus_796.yml", "YAML", 0, 0, 0, 3, 0, 0, 1, 4
"d:\IDEWORK\lvmen\src\licensedcode\data\rules\gpl-2.0-plus_797.yml", "YAML", 0, 0, 0, 3, 0, 0, 1, 4
"d:\IDEWORK\lvmen\src\licensedcode\data\rules\gpl-2.0-plus_798.yml", "YAML", 0, 0, 0, 4, 0, 0, 1, 5
"d:\IDEWORK\lvmen\src\licensedcode\data\rules\gpl-2.0-plus_799.yml", "YAML", 0, 0, 0, 3, 0, 0, 1, 4
"d:\IDEWORK\lvmen\src\licensedcode\data\rules\gpl-2.0-plus_8.yml", "YAML", 0, 0, 0, 2, 0, 0, 1, 3
"d:\IDEWORK\lvmen\src\licensedcode\data\rules\gpl-2.0-plus_80.yml", "YAML", 0, 0, 0, 3, 0, 0, 1, 4
"d:\IDEWORK\lvmen\src\licensedcode\data\rules\gpl-2.0-plus_800.yml", "YAML", 0, 0, 0, 5, 0, 0, 1, 6
"d:\IDEWORK\lvmen\src\licensedcode\data\rules\gpl-2.0-plus_801.yml", "YAML", 0, 0, 0, 3, 0, 0, 1, 4
"d:\IDEWORK\lvmen\src\licensedcode\data\rules\gpl-2.0-plus_802.yml", "YAML", 0, 0, 0, 3, 0, 0, 1, 4
"d:\IDEWORK\lvmen\src\licensedcode\data\rules\gpl-2.0-plus_803.yml", "YAML", 0, 0, 0, 3, 0, 0, 1, 4
"d:\IDEWORK\lvmen\src\licensedcode\data\rules\gpl-2.0-plus_804.yml", "YAML", 0, 0, 0, 3, 0, 0, 1, 4
"d:\IDEWORK\lvmen\src\licensedcode\data\rules\gpl-2.0-plus_805.yml", "YAML", 0, 0, 0, 3, 0, 0, 1, 4
"d:\IDEWORK\lvmen\src\licensedcode\data\rules\gpl-2.0-plus_806.yml", "YAML", 0, 0, 0, 4, 0, 0, 1, 5
"d:\IDEWORK\lvmen\src\licensedcode\data\rules\gpl-2.0-plus_807.yml", "YAML", 0, 0, 0, 4, 0, 0, 1, 5
"d:\IDEWORK\lvmen\src\licensedcode\data\rules\gpl-2.0-plus_808.yml", "YAML", 0, 0, 0, 3, 0, 0, 1, 4
"d:\IDEWORK\lvmen\src\licensedcode\data\rules\gpl-2.0-plus_809.yml", "YAML", 0, 0, 0, 3, 0, 0, 1, 4
"d:\IDEWORK\lvmen\src\licensedcode\data\rules\gpl-2.0-plus_81.yml", "YAML", 0, 0, 0, 2, 0, 0, 1, 3
"d:\IDEWORK\lvmen\src\licensedcode\data\rules\gpl-2.0-plus_810.yml", "YAML", 0, 0, 0, 5, 0, 0, 1, 6
"d:\IDEWORK\lvmen\src\licensedcode\data\rules\gpl-2.0-plus_811.yml", "YAML", 0, 0, 0, 4, 0, 0, 1, 5
"d:\IDEWORK\lvmen\src\licensedcode\data\rules\gpl-2.0-plus_812.yml", "YAML", 0, 0, 0, 5, 0, 0, 1, 6
"d:\IDEWORK\lvmen\src\licensedcode\data\rules\gpl-2.0-plus_813.yml", "YAML", 0, 0, 0, 3, 0, 0, 1, 4
"d:\IDEWORK\lvmen\src\licensedcode\data\rules\gpl-2.0-plus_814.yml", "YAML", 0, 0, 0, 6, 0, 0, 1, 7
"d:\IDEWORK\lvmen\src\licensedcode\data\rules\gpl-2.0-plus_815.yml", "YAML", 0, 0, 0, 3, 0, 0, 1, 4
"d:\IDEWORK\lvmen\src\licensedcode\data\rules\gpl-2.0-plus_816.yml", "YAML", 0, 0, 0, 3, 0, 0, 1, 4
"d:\IDEWORK\lvmen\src\licensedcode\data\rules\gpl-2.0-plus_817.yml", "YAML", 0, 0, 0, 3, 0, 0, 1, 4
"d:\IDEWORK\lvmen\src\licensedcode\data\rules\gpl-2.0-plus_818.yml", "YAML", 0, 0, 0, 5, 0, 0, 1, 6
"d:\IDEWORK\lvmen\src\licensedcode\data\rules\gpl-2.0-plus_819.yml", "YAML", 0, 0, 0, 3, 0, 0, 1, 4
"d:\IDEWORK\lvmen\src\licensedcode\data\rules\gpl-2.0-plus_82.yml", "YAML", 0, 0, 0, 2, 0, 0, 1, 3
"d:\IDEWORK\lvmen\src\licensedcode\data\rules\gpl-2.0-plus_820.yml", "YAML", 0, 0, 0, 3, 0, 0, 1, 4
"d:\IDEWORK\lvmen\src\licensedcode\data\rules\gpl-2.0-plus_821.yml", "YAML", 0, 0, 0, 3, 0, 0, 1, 4
"d:\IDEWORK\lvmen\src\licensedcode\data\rules\gpl-2.0-plus_822.yml", "YAML", 0, 0, 0, 3, 0, 0, 1, 4
"d:\IDEWORK\lvmen\src\licensedcode\data\rules\gpl-2.0-plus_823.yml", "YAML", 0, 0, 0, 4, 0, 0, 1, 5
"d:\IDEWORK\lvmen\src\licensedcode\data\rules\gpl-2.0-plus_824.yml", "YAML", 0, 0, 0, 4, 0, 0, 1, 5
"d:\IDEWORK\lvmen\src\licensedcode\data\rules\gpl-2.0-plus_825.yml", "YAML", 0, 0, 0, 3, 0, 0, 1, 4
"d:\IDEWORK\lvmen\src\licensedcode\data\rules\gpl-2.0-plus_826.yml", "YAML", 0, 0, 0, 5, 0, 0, 1, 6
"d:\IDEWORK\lvmen\src\licensedcode\data\rules\gpl-2.0-plus_827.yml", "YAML", 0, 0, 0, 3, 0, 0, 1, 4
"d:\IDEWORK\lvmen\src\licensedcode\data\rules\gpl-2.0-plus_828.yml", "YAML", 0, 0, 0, 2, 0, 0, 1, 3
"d:\IDEWORK\lvmen\src\licensedcode\data\rules\gpl-2.0-plus_829.yml", "YAML", 0, 0, 0, 3, 0, 0, 1, 4
"d:\IDEWORK\lvmen\src\licensedcode\data\rules\gpl-2.0-plus_83.yml", "YAML", 0, 0, 0, 3, 0, 0, 1, 4
"d:\IDEWORK\lvmen\src\licensedcode\data\rules\gpl-2.0-plus_830.yml", "YAML", 0, 0, 0, 3, 0, 0, 1, 4
"d:\IDEWORK\lvmen\src\licensedcode\data\rules\gpl-2.0-plus_831.yml", "YAML", 0, 0, 0, 3, 0, 0, 1, 4
"d:\IDEWORK\lvmen\src\licensedcode\data\rules\gpl-2.0-plus_832.yml", "YAML", 0, 0, 0, 3, 0, 0, 1, 4
"d:\IDEWORK\lvmen\src\licensedcode\data\rules\gpl-2.0-plus_833.yml", "YAML", 0, 0, 0, 5, 0, 0, 1, 6
"d:\IDEWORK\lvmen\src\licensedcode\data\rules\gpl-2.0-plus_834.yml", "YAML", 0, 0, 0, 4, 0, 0, 1, 5
"d:\IDEWORK\lvmen\src\licensedcode\data\rules\gpl-2.0-plus_835.yml", "YAML", 0, 0, 0, 4, 0, 0, 1, 5
"d:\IDEWORK\lvmen\src\licensedcode\data\rules\gpl-2.0-plus_836.yml", "YAML", 0, 0, 0, 2, 0, 0, 1, 3
"d:\IDEWORK\lvmen\src\licensedcode\data\rules\gpl-2.0-plus_837.yml", "YAML", 0, 0, 0, 2, 0, 0, 1, 3
"d:\IDEWORK\lvmen\src\licensedcode\data\rules\gpl-2.0-plus_838.yml", "YAML", 0, 0, 0, 4, 0, 0, 1, 5
"d:\IDEWORK\lvmen\src\licensedcode\data\rules\gpl-2.0-plus_839.yml", "YAML", 0, 0, 0, 6, 0, 0, 1, 7
"d:\IDEWORK\lvmen\src\licensedcode\data\rules\gpl-2.0-plus_84.yml", "YAML", 0, 0, 0, 2, 0, 0, 1, 3
"d:\IDEWORK\lvmen\src\licensedcode\data\rules\gpl-2.0-plus_840.yml", "YAML", 0, 0, 0, 2, 0, 0, 1, 3
"d:\IDEWORK\lvmen\src\licensedcode\data\rules\gpl-2.0-plus_841.yml", "YAML", 0, 0, 0, 4, 0, 0, 1, 5
"d:\IDEWORK\lvmen\src\licensedcode\data\rules\gpl-2.0-plus_842.yml", "YAML", 0, 0, 0, 4, 0, 0, 1, 5
"d:\IDEWORK\lvmen\src\licensedcode\data\rules\gpl-2.0-plus_843.yml", "YAML", 0, 0, 0, 4, 0, 0, 1, 5
"d:\IDEWORK\lvmen\src\licensedcode\data\rules\gpl-2.0-plus_844.yml", "YAML", 0, 0, 0, 2, 0, 0, 1, 3
"d:\IDEWORK\lvmen\src\licensedcode\data\rules\gpl-2.0-plus_845.yml", "YAML", 0, 0, 0, 4, 0, 0, 1, 5
"d:\IDEWORK\lvmen\src\licensedcode\data\rules\gpl-2.0-plus_846.yml", "YAML", 0, 0, 0, 6, 0, 0, 1, 7
"d:\IDEWORK\lvmen\src\licensedcode\data\rules\gpl-2.0-plus_847.yml", "YAML", 0, 0, 0, 4, 0, 0, 1, 5
"d:\IDEWORK\lvmen\src\licensedcode\data\rules\gpl-2.0-plus_848.yml", "YAML", 0, 0, 0, 2, 0, 0, 1, 3
"d:\IDEWORK\lvmen\src\licensedcode\data\rules\gpl-2.0-plus_849.yml", "YAML", 0, 0, 0, 2, 0, 0, 1, 3
"d:\IDEWORK\lvmen\src\licensedcode\data\rules\gpl-2.0-plus_85.yml", "YAML", 0, 0, 0, 2, 0, 0, 1, 3
"d:\IDEWORK\lvmen\src\licensedcode\data\rules\gpl-2.0-plus_850.yml", "YAML", 0, 0, 0, 2, 0, 0, 1, 3
"d:\IDEWORK\lvmen\src\licensedcode\data\rules\gpl-2.0-plus_851.yml", "YAML", 0, 0, 0, 4, 0, 0, 1, 5
"d:\IDEWORK\lvmen\src\licensedcode\data\rules\gpl-2.0-plus_852.yml", "YAML", 0, 0, 0, 4, 0, 0, 1, 5
"d:\IDEWORK\lvmen\src\licensedcode\data\rules\gpl-2.0-plus_853.yml", "YAML", 0, 0, 0, 3, 0, 0, 1, 4
"d:\IDEWORK\lvmen\src\licensedcode\data\rules\gpl-2.0-plus_854.yml", "YAML", 0, 0, 0, 6, 0, 0, 1, 7
"d:\IDEWORK\lvmen\src\licensedcode\data\rules\gpl-2.0-plus_855.yml", "YAML", 0, 0, 0, 2, 0, 0, 1, 3
"d:\IDEWORK\lvmen\src\licensedcode\data\rules\gpl-2.0-plus_856.yml", "YAML", 0, 0, 0, 2, 0, 0, 1, 3
"d:\IDEWORK\lvmen\src\licensedcode\data\rules\gpl-2.0-plus_857.yml", "YAML", 0, 0, 0, 4, 0, 0, 1, 5
"d:\IDEWORK\lvmen\src\licensedcode\data\rules\gpl-2.0-plus_858.yml", "YAML", 0, 0, 0, 4, 0, 0, 1, 5
"d:\IDEWORK\lvmen\src\licensedcode\data\rules\gpl-2.0-plus_859.yml", "YAML", 0, 0, 0, 6, 0, 0, 1, 7
"d:\IDEWORK\lvmen\src\licensedcode\data\rules\gpl-2.0-plus_86.yml", "YAML", 0, 0, 0, 2, 0, 0, 1, 3
"d:\IDEWORK\lvmen\src\licensedcode\data\rules\gpl-2.0-plus_860.yml", "YAML", 0, 0, 0, 4, 0, 0, 1, 5
"d:\IDEWORK\lvmen\src\licensedcode\data\rules\gpl-2.0-plus_861.yml", "YAML", 0, 0, 0, 6, 0, 0, 1, 7
"d:\IDEWORK\lvmen\src\licensedcode\data\rules\gpl-2.0-plus_862.yml", "YAML", 0, 0, 0, 4, 0, 0, 1, 5
"d:\IDEWORK\lvmen\src\licensedcode\data\rules\gpl-2.0-plus_863.yml", "YAML", 0, 0, 0, 4, 0, 0, 1, 5
"d:\IDEWORK\lvmen\src\licensedcode\data\rules\gpl-2.0-plus_864.yml", "YAML", 0, 0, 0, 3, 0, 0, 1, 4
"d:\IDEWORK\lvmen\src\licensedcode\data\rules\gpl-2.0-plus_865.yml", "YAML", 0, 0, 0, 4, 0, 0, 1, 5
"d:\IDEWORK\lvmen\src\licensedcode\data\rules\gpl-2.0-plus_866.yml", "YAML", 0, 0, 0, 5, 0, 0, 1, 6
"d:\IDEWORK\lvmen\src\licensedcode\data\rules\gpl-2.0-plus_867.yml", "YAML", 0, 0, 0, 7, 0, 0, 1, 8
"d:\IDEWORK\lvmen\src\licensedcode\data\rules\gpl-2.0-plus_868.yml", "YAML", 0, 0, 0, 5, 0, 0, 1, 6
"d:\IDEWORK\lvmen\src\licensedcode\data\rules\gpl-2.0-plus_869.yml", "YAML", 0, 0, 0, 3, 0, 0, 1, 4
"d:\IDEWORK\lvmen\src\licensedcode\data\rules\gpl-2.0-plus_87.yml", "YAML", 0, 0, 0, 4, 0, 0, 1, 5
"d:\IDEWORK\lvmen\src\licensedcode\data\rules\gpl-2.0-plus_870.yml", "YAML", 0, 0, 0, 3, 0, 0, 1, 4
"d:\IDEWORK\lvmen\src\licensedcode\data\rules\gpl-2.0-plus_871.yml", "YAML", 0, 0, 0, 5, 0, 0, 1, 6
"d:\IDEWORK\lvmen\src\licensedcode\data\rules\gpl-2.0-plus_872.yml", "YAML", 0, 0, 0, 4, 0, 0, 1, 5
"d:\IDEWORK\lvmen\src\licensedcode\data\rules\gpl-2.0-plus_873.yml", "YAML", 0, 0, 0, 5, 0, 0, 1, 6
"d:\IDEWORK\lvmen\src\licensedcode\data\rules\gpl-2.0-plus_874.yml", "YAML", 0, 0, 0, 7, 0, 0, 1, 8
"d:\IDEWORK\lvmen\src\licensedcode\data\rules\gpl-2.0-plus_875.yml", "YAML", 0, 0, 0, 7, 0, 0, 1, 8
"d:\IDEWORK\lvmen\src\licensedcode\data\rules\gpl-2.0-plus_876.yml", "YAML", 0, 0, 0, 5, 0, 0, 1, 6
"d:\IDEWORK\lvmen\src\licensedcode\data\rules\gpl-2.0-plus_877.yml", "YAML", 0, 0, 0, 5, 0, 0, 1, 6
"d:\IDEWORK\lvmen\src\licensedcode\data\rules\gpl-2.0-plus_878.yml", "YAML", 0, 0, 0, 5, 0, 0, 1, 6
"d:\IDEWORK\lvmen\src\licensedcode\data\rules\gpl-2.0-plus_879.yml", "YAML", 0, 0, 0, 5, 0, 0, 1, 6
"d:\IDEWORK\lvmen\src\licensedcode\data\rules\gpl-2.0-plus_88.yml", "YAML", 0, 0, 0, 4, 0, 0, 1, 5
"d:\IDEWORK\lvmen\src\licensedcode\data\rules\gpl-2.0-plus_880.yml", "YAML", 0, 0, 0, 7, 0, 0, 1, 8
"d:\IDEWORK\lvmen\src\licensedcode\data\rules\gpl-2.0-plus_881.yml", "YAML", 0, 0, 0, 2, 0, 0, 1, 3
"d:\IDEWORK\lvmen\src\licensedcode\data\rules\gpl-2.0-plus_882.yml", "YAML", 0, 0, 0, 5, 0, 0, 1, 6
"d:\IDEWORK\lvmen\src\licensedcode\data\rules\gpl-2.0-plus_883.yml", "YAML", 0, 0, 0, 5, 0, 0, 1, 6
"d:\IDEWORK\lvmen\src\licensedcode\data\rules\gpl-2.0-plus_884.yml", "YAML", 0, 0, 0, 5, 0, 0, 1, 6
"d:\IDEWORK\lvmen\src\licensedcode\data\rules\gpl-2.0-plus_885.yml", "YAML", 0, 0, 0, 5, 0, 0, 1, 6
"d:\IDEWORK\lvmen\src\licensedcode\data\rules\gpl-2.0-plus_886.yml", "YAML", 0, 0, 0, 5, 0, 0, 1, 6
"d:\IDEWORK\lvmen\src\licensedcode\data\rules\gpl-2.0-plus_887.yml", "YAML", 0, 0, 0, 5, 0, 0, 1, 6
"d:\IDEWORK\lvmen\src\licensedcode\data\rules\gpl-2.0-plus_888.yml", "YAML", 0, 0, 0, 7, 0, 0, 1, 8
"d:\IDEWORK\lvmen\src\licensedcode\data\rules\gpl-2.0-plus_889.yml", "YAML", 0, 0, 0, 3, 0, 0, 1, 4
"d:\IDEWORK\lvmen\src\licensedcode\data\rules\gpl-2.0-plus_89.yml", "YAML", 0, 0, 0, 4, 0, 0, 1, 5
"d:\IDEWORK\lvmen\src\licensedcode\data\rules\gpl-2.0-plus_890.yml", "YAML", 0, 0, 0, 5, 0, 0, 1, 6
"d:\IDEWORK\lvmen\src\licensedcode\data\rules\gpl-2.0-plus_891.yml", "YAML", 0, 0, 0, 5, 0, 0, 1, 6
"d:\IDEWORK\lvmen\src\licensedcode\data\rules\gpl-2.0-plus_892.yml", "YAML", 0, 0, 0, 7, 0, 0, 1, 8
"d:\IDEWORK\lvmen\src\licensedcode\data\rules\gpl-2.0-plus_893.yml", "YAML", 0, 0, 0, 4, 0, 0, 1, 5
"d:\IDEWORK\lvmen\src\licensedcode\data\rules\gpl-2.0-plus_894.yml", "YAML", 0, 0, 0, 3, 0, 0, 1, 4
"d:\IDEWORK\lvmen\src\licensedcode\data\rules\gpl-2.0-plus_895.yml", "YAML", 0, 0, 0, 5, 0, 0, 1, 6
"d:\IDEWORK\lvmen\src\licensedcode\data\rules\gpl-2.0-plus_896.yml", "YAML", 0, 0, 0, 6, 0, 0, 1, 7
"d:\IDEWORK\lvmen\src\licensedcode\data\rules\gpl-2.0-plus_897.yml", "YAML", 0, 0, 0, 4, 0, 0, 1, 5
"d:\IDEWORK\lvmen\src\licensedcode\data\rules\gpl-2.0-plus_898.yml", "YAML", 0, 0, 0, 4, 0, 0, 1, 5
"d:\IDEWORK\lvmen\src\licensedcode\data\rules\gpl-2.0-plus_899.yml", "YAML", 0, 0, 0, 3, 0, 0, 1, 4
"d:\IDEWORK\lvmen\src\licensedcode\data\rules\gpl-2.0-plus_9.yml", "YAML", 0, 0, 0, 3, 0, 0, 1, 4
"d:\IDEWORK\lvmen\src\licensedcode\data\rules\gpl-2.0-plus_90.yml", "YAML", 0, 0, 0, 2, 0, 0, 1, 3
"d:\IDEWORK\lvmen\src\licensedcode\data\rules\gpl-2.0-plus_900.yml", "YAML", 0, 0, 0, 4, 0, 0, 1, 5
"d:\IDEWORK\lvmen\src\licensedcode\data\rules\gpl-2.0-plus_901.yml", "YAML", 0, 0, 0, 3, 0, 0, 1, 4
"d:\IDEWORK\lvmen\src\licensedcode\data\rules\gpl-2.0-plus_902.yml", "YAML", 0, 0, 0, 4, 0, 0, 1, 5
"d:\IDEWORK\lvmen\src\licensedcode\data\rules\gpl-2.0-plus_903.yml", "YAML", 0, 0, 0, 7, 0, 0, 1, 8
"d:\IDEWORK\lvmen\src\licensedcode\data\rules\gpl-2.0-plus_904.yml", "YAML", 0, 0, 0, 4, 0, 0, 1, 5
"d:\IDEWORK\lvmen\src\licensedcode\data\rules\gpl-2.0-plus_905.yml", "YAML", 0, 0, 0, 4, 0, 0, 1, 5
"d:\IDEWORK\lvmen\src\licensedcode\data\rules\gpl-2.0-plus_906.yml", "YAML", 0, 0, 0, 4, 0, 0, 1, 5
"d:\IDEWORK\lvmen\src\licensedcode\data\rules\gpl-2.0-plus_907.yml", "YAML", 0, 0, 0, 5, 0, 0, 1, 6
"d:\IDEWORK\lvmen\src\licensedcode\data\rules\gpl-2.0-plus_908.yml", "YAML", 0, 0, 0, 5, 0, 0, 1, 6
"d:\IDEWORK\lvmen\src\licensedcode\data\rules\gpl-2.0-plus_909.yml", "YAML", 0, 0, 0, 5, 0, 0, 1, 6
"d:\IDEWORK\lvmen\src\licensedcode\data\rules\gpl-2.0-plus_91.yml", "YAML", 0, 0, 0, 2, 0, 0, 1, 3
"d:\IDEWORK\lvmen\src\licensedcode\data\rules\gpl-2.0-plus_910.yml", "YAML", 0, 0, 0, 7, 0, 0, 1, 8
"d:\IDEWORK\lvmen\src\licensedcode\data\rules\gpl-2.0-plus_911.yml", "YAML", 0, 0, 0, 5, 0, 0, 1, 6
"d:\IDEWORK\lvmen\src\licensedcode\data\rules\gpl-2.0-plus_912.yml", "YAML", 0, 0, 0, 5, 0, 0, 1, 6
"d:\IDEWORK\lvmen\src\licensedcode\data\rules\gpl-2.0-plus_913.yml", "YAML", 0, 0, 0, 5, 0, 0, 1, 6
"d:\IDEWORK\lvmen\src\licensedcode\data\rules\gpl-2.0-plus_914.yml", "YAML", 0, 0, 0, 5, 0, 0, 1, 6
"d:\IDEWORK\lvmen\src\licensedcode\data\rules\gpl-2.0-plus_915.yml", "YAML", 0, 0, 0, 5, 0, 0, 1, 6
"d:\IDEWORK\lvmen\src\licensedcode\data\rules\gpl-2.0-plus_916.yml", "YAML", 0, 0, 0, 5, 0, 0, 1, 6
"d:\IDEWORK\lvmen\src\licensedcode\data\rules\gpl-2.0-plus_917.yml", "YAML", 0, 0, 0, 5, 0, 0, 1, 6
"d:\IDEWORK\lvmen\src\licensedcode\data\rules\gpl-2.0-plus_918.yml", "YAML", 0, 0, 0, 5, 0, 0, 1, 6
"d:\IDEWORK\lvmen\src\licensedcode\data\rules\gpl-2.0-plus_919.yml", "YAML", 0, 0, 0, 5, 0, 0, 1, 6
"d:\IDEWORK\lvmen\src\licensedcode\data\rules\gpl-2.0-plus_92.yml", "YAML", 0, 0, 0, 2, 0, 0, 1, 3
"d:\IDEWORK\lvmen\src\licensedcode\data\rules\gpl-2.0-plus_920.yml", "YAML", 0, 0, 0, 5, 0, 0, 1, 6
"d:\IDEWORK\lvmen\src\licensedcode\data\rules\gpl-2.0-plus_921.yml", "YAML", 0, 0, 0, 7, 0, 0, 1, 8
"d:\IDEWORK\lvmen\src\licensedcode\data\rules\gpl-2.0-plus_922.yml", "YAML", 0, 0, 0, 7, 0, 0, 1, 8
"d:\IDEWORK\lvmen\src\licensedcode\data\rules\gpl-2.0-plus_923.yml", "YAML", 0, 0, 0, 6, 0, 0, 1, 7
"d:\IDEWORK\lvmen\src\licensedcode\data\rules\gpl-2.0-plus_924.yml", "YAML", 0, 0, 0, 7, 0, 0, 1, 8
"d:\IDEWORK\lvmen\src\licensedcode\data\rules\gpl-2.0-plus_925.yml", "YAML", 0, 0, 0, 5, 0, 0, 1, 6
"d:\IDEWORK\lvmen\src\licensedcode\data\rules\gpl-2.0-plus_926.yml", "YAML", 0, 0, 0, 7, 0, 0, 1, 8
"d:\IDEWORK\lvmen\src\licensedcode\data\rules\gpl-2.0-plus_927.yml", "YAML", 0, 0, 0, 8, 0, 0, 1, 9
"d:\IDEWORK\lvmen\src\licensedcode\data\rules\gpl-2.0-plus_928.yml", "YAML", 0, 0, 0, 6, 0, 0, 1, 7
"d:\IDEWORK\lvmen\src\licensedcode\data\rules\gpl-2.0-plus_929.yml", "YAML", 0, 0, 0, 5, 0, 0, 1, 6
"d:\IDEWORK\lvmen\src\licensedcode\data\rules\gpl-2.0-plus_93.yml", "YAML", 0, 0, 0, 4, 0, 0, 1, 5
"d:\IDEWORK\lvmen\src\licensedcode\data\rules\gpl-2.0-plus_930.yml", "YAML", 0, 0, 0, 5, 0, 0, 1, 6
"d:\IDEWORK\lvmen\src\licensedcode\data\rules\gpl-2.0-plus_931.yml", "YAML", 0, 0, 0, 5, 0, 0, 1, 6
"d:\IDEWORK\lvmen\src\licensedcode\data\rules\gpl-2.0-plus_932.yml", "YAML", 0, 0, 0, 6, 0, 0, 1, 7
"d:\IDEWORK\lvmen\src\licensedcode\data\rules\gpl-2.0-plus_933.yml", "YAML", 0, 0, 0, 5, 0, 0, 1, 6
"d:\IDEWORK\lvmen\src\licensedcode\data\rules\gpl-2.0-plus_934.yml", "YAML", 0, 0, 0, 5, 0, 0, 1, 6
"d:\IDEWORK\lvmen\src\licensedcode\data\rules\gpl-2.0-plus_935.yml", "YAML", 0, 0, 0, 5, 0, 0, 1, 6
"d:\IDEWORK\lvmen\src\licensedcode\data\rules\gpl-2.0-plus_936.yml", "YAML", 0, 0, 0, 7, 0, 0, 1, 8
"d:\IDEWORK\lvmen\src\licensedcode\data\rules\gpl-2.0-plus_937.yml", "YAML", 0, 0, 0, 8, 0, 0, 1, 9
"d:\IDEWORK\lvmen\src\licensedcode\data\rules\gpl-2.0-plus_938.yml", "YAML", 0, 0, 0, 7, 0, 0, 1, 8
"d:\IDEWORK\lvmen\src\licensedcode\data\rules\gpl-2.0-plus_939.yml", "YAML", 0, 0, 0, 5, 0, 0, 1, 6
"d:\IDEWORK\lvmen\src\licensedcode\data\rules\gpl-2.0-plus_94.yml", "YAML", 0, 0, 0, 5, 0, 0, 1, 6
"d:\IDEWORK\lvmen\src\licensedcode\data\rules\gpl-2.0-plus_940.yml", "YAML", 0, 0, 0, 8, 0, 0, 1, 9
"d:\IDEWORK\lvmen\src\licensedcode\data\rules\gpl-2.0-plus_941.yml", "YAML", 0, 0, 0, 5, 0, 0, 1, 6
"d:\IDEWORK\lvmen\src\licensedcode\data\rules\gpl-2.0-plus_942.yml", "YAML", 0, 0, 0, 6, 0, 0, 1, 7
"d:\IDEWORK\lvmen\src\licensedcode\data\rules\gpl-2.0-plus_943.yml", "YAML", 0, 0, 0, 5, 0, 0, 1, 6
"d:\IDEWORK\lvmen\src\licensedcode\data\rules\gpl-2.0-plus_944.yml", "YAML", 0, 0, 0, 5, 0, 0, 1, 6
"d:\IDEWORK\lvmen\src\licensedcode\data\rules\gpl-2.0-plus_945.yml", "YAML", 0, 0, 0, 5, 0, 0, 1, 6
"d:\IDEWORK\lvmen\src\licensedcode\data\rules\gpl-2.0-plus_946.yml", "YAML", 0, 0, 0, 5, 0, 0, 1, 6
"d:\IDEWORK\lvmen\src\licensedcode\data\rules\gpl-2.0-plus_947.yml", "YAML", 0, 0, 0, 5, 0, 0, 1, 6
"d:\IDEWORK\lvmen\src\licensedcode\data\rules\gpl-2.0-plus_948.yml", "YAML", 0, 0, 0, 7, 0, 0, 1, 8
"d:\IDEWORK\lvmen\src\licensedcode\data\rules\gpl-2.0-plus_949.yml", "YAML", 0, 0, 0, 7, 0, 0, 1, 8
"d:\IDEWORK\lvmen\src\licensedcode\data\rules\gpl-2.0-plus_95.yml", "YAML", 0, 0, 0, 2, 0, 0, 1, 3
"d:\IDEWORK\lvmen\src\licensedcode\data\rules\gpl-2.0-plus_950.yml", "YAML", 0, 0, 0, 7, 0, 0, 1, 8
"d:\IDEWORK\lvmen\src\licensedcode\data\rules\gpl-2.0-plus_951.yml", "YAML", 0, 0, 0, 5, 0, 0, 1, 6
"d:\IDEWORK\lvmen\src\licensedcode\data\rules\gpl-2.0-plus_952.yml", "YAML", 0, 0, 0, 7, 0, 0, 1, 8
"d:\IDEWORK\lvmen\src\licensedcode\data\rules\gpl-2.0-plus_953.yml", "YAML", 0, 0, 0, 5, 0, 0, 1, 6
"d:\IDEWORK\lvmen\src\licensedcode\data\rules\gpl-2.0-plus_954.yml", "YAML", 0, 0, 0, 5, 0, 0, 1, 6
"d:\IDEWORK\lvmen\src\licensedcode\data\rules\gpl-2.0-plus_955.yml", "YAML", 0, 0, 0, 6, 0, 0, 1, 7
"d:\IDEWORK\lvmen\src\licensedcode\data\rules\gpl-2.0-plus_956.yml", "YAML", 0, 0, 0, 8, 0, 0, 1, 9
"d:\IDEWORK\lvmen\src\licensedcode\data\rules\gpl-2.0-plus_957.yml", "YAML", 0, 0, 0, 6, 0, 0, 1, 7
"d:\IDEWORK\lvmen\src\licensedcode\data\rules\gpl-2.0-plus_958.yml", "YAML", 0, 0, 0, 6, 0, 0, 1, 7
"d:\IDEWORK\lvmen\src\licensedcode\data\rules\gpl-2.0-plus_959.yml", "YAML", 0, 0, 0, 7, 0, 0, 1, 8
"d:\IDEWORK\lvmen\src\licensedcode\data\rules\gpl-2.0-plus_96.yml", "YAML", 0, 0, 0, 3, 0, 0, 1, 4
"d:\IDEWORK\lvmen\src\licensedcode\data\rules\gpl-2.0-plus_960.yml", "YAML", 0, 0, 0, 7, 0, 0, 1, 8
"d:\IDEWORK\lvmen\src\licensedcode\data\rules\gpl-2.0-plus_961.yml", "YAML", 0, 0, 0, 7, 0, 0, 1, 8
"d:\IDEWORK\lvmen\src\licensedcode\data\rules\gpl-2.0-plus_962.yml", "YAML", 0, 0, 0, 5, 0, 0, 1, 6
"d:\IDEWORK\lvmen\src\licensedcode\data\rules\gpl-2.0-plus_963.yml", "YAML", 0, 0, 0, 5, 0, 0, 1, 6
"d:\IDEWORK\lvmen\src\licensedcode\data\rules\gpl-2.0-plus_964.yml", "YAML", 0, 0, 0, 5, 0, 0, 1, 6
"d:\IDEWORK\lvmen\src\licensedcode\data\rules\gpl-2.0-plus_965.yml", "YAML", 0, 0, 0, 6, 0, 0, 1, 7
"d:\IDEWORK\lvmen\src\licensedcode\data\rules\gpl-2.0-plus_966.yml", "YAML", 0, 0, 0, 5, 0, 0, 1, 6
"d:\IDEWORK\lvmen\src\licensedcode\data\rules\gpl-2.0-plus_967.yml", "YAML", 0, 0, 0, 5, 0, 0, 1, 6
"d:\IDEWORK\lvmen\src\licensedcode\data\rules\gpl-2.0-plus_968.yml", "YAML", 0, 0, 0, 7, 0, 0, 1, 8
"d:\IDEWORK\lvmen\src\licensedcode\data\rules\gpl-2.0-plus_969.yml", "YAML", 0, 0, 0, 6, 0, 0, 1, 7
"d:\IDEWORK\lvmen\src\licensedcode\data\rules\gpl-2.0-plus_97.yml", "YAML", 0, 0, 0, 3, 0, 0, 1, 4
"d:\IDEWORK\lvmen\src\licensedcode\data\rules\gpl-2.0-plus_970.yml", "YAML", 0, 0, 0, 8, 0, 0, 1, 9
"d:\IDEWORK\lvmen\src\licensedcode\data\rules\gpl-2.0-plus_971.yml", "YAML", 0, 0, 0, 5, 0, 0, 1, 6
"d:\IDEWORK\lvmen\src\licensedcode\data\rules\gpl-2.0-plus_972.yml", "YAML", 0, 0, 0, 6, 0, 0, 1, 7
"d:\IDEWORK\lvmen\src\licensedcode\data\rules\gpl-2.0-plus_973.yml", "YAML", 0, 0, 0, 7, 0, 0, 1, 8
"d:\IDEWORK\lvmen\src\licensedcode\data\rules\gpl-2.0-plus_974.yml", "YAML", 0, 0, 0, 6, 0, 0, 1, 7
"d:\IDEWORK\lvmen\src\licensedcode\data\rules\gpl-2.0-plus_975.yml", "YAML", 0, 0, 0, 6, 0, 0, 1, 7
"d:\IDEWORK\lvmen\src\licensedcode\data\rules\gpl-2.0-plus_976.yml", "YAML", 0, 0, 0, 5, 0, 0, 1, 6
"d:\IDEWORK\lvmen\src\licensedcode\data\rules\gpl-2.0-plus_977.yml", "YAML", 0, 0, 0, 5, 0, 0, 1, 6
"d:\IDEWORK\lvmen\src\licensedcode\data\rules\gpl-2.0-plus_978.yml", "YAML", 0, 0, 0, 5, 0, 0, 1, 6
"d:\IDEWORK\lvmen\src\licensedcode\data\rules\gpl-2.0-plus_979.yml", "YAML", 0, 0, 0, 5, 0, 0, 1, 6
"d:\IDEWORK\lvmen\src\licensedcode\data\rules\gpl-2.0-plus_98.yml", "YAML", 0, 0, 0, 3, 0, 0, 1, 4
"d:\IDEWORK\lvmen\src\licensedcode\data\rules\gpl-2.0-plus_980.yml", "YAML", 0, 0, 0, 6, 0, 0, 1, 7
"d:\IDEWORK\lvmen\src\licensedcode\data\rules\gpl-2.0-plus_981.yml", "YAML", 0, 0, 0, 5, 0, 0, 1, 6
"d:\IDEWORK\lvmen\src\licensedcode\data\rules\gpl-2.0-plus_982.yml", "YAML", 0, 0, 0, 8, 0, 0, 1, 9
"d:\IDEWORK\lvmen\src\licensedcode\data\rules\gpl-2.0-plus_983.yml", "YAML", 0, 0, 0, 6, 0, 0, 1, 7
"d:\IDEWORK\lvmen\src\licensedcode\data\rules\gpl-2.0-plus_984.yml", "YAML", 0, 0, 0, 4, 0, 0, 1, 5
"d:\IDEWORK\lvmen\src\licensedcode\data\rules\gpl-2.0-plus_985.yml", "YAML", 0, 0, 0, 4, 0, 0, 1, 5
"d:\IDEWORK\lvmen\src\licensedcode\data\rules\gpl-2.0-plus_986.yml", "YAML", 0, 0, 0, 2, 0, 0, 1, 3
"d:\IDEWORK\lvmen\src\licensedcode\data\rules\gpl-2.0-plus_987.yml", "YAML", 0, 0, 0, 2, 0, 0, 1, 3
"d:\IDEWORK\lvmen\src\licensedcode\data\rules\gpl-2.0-plus_988.yml", "YAML", 0, 0, 0, 3, 0, 0, 1, 4
"d:\IDEWORK\lvmen\src\licensedcode\data\rules\gpl-2.0-plus_989.yml", "YAML", 0, 0, 0, 2, 0, 0, 1, 3
"d:\IDEWORK\lvmen\src\licensedcode\data\rules\gpl-2.0-plus_99.yml", "YAML", 0, 0, 0, 4, 0, 0, 1, 5
"d:\IDEWORK\lvmen\src\licensedcode\data\rules\gpl-2.0-plus_990.yml", "YAML", 0, 0, 0, 4, 0, 0, 1, 5
"d:\IDEWORK\lvmen\src\licensedcode\data\rules\gpl-2.0-plus_991.yml", "YAML", 0, 0, 0, 3, 0, 0, 1, 4
"d:\IDEWORK\lvmen\src\licensedcode\data\rules\gpl-2.0-plus_992.yml", "YAML", 0, 0, 0, 3, 0, 0, 1, 4
"d:\IDEWORK\lvmen\src\licensedcode\data\rules\gpl-2.0-plus_993.yml", "YAML", 0, 0, 0, 5, 0, 0, 1, 6
"d:\IDEWORK\lvmen\src\licensedcode\data\rules\gpl-2.0-plus_994.yml", "YAML", 0, 0, 0, 5, 0, 0, 1, 6
"d:\IDEWORK\lvmen\src\licensedcode\data\rules\gpl-2.0-plus_995.yml", "YAML", 0, 0, 0, 3, 0, 0, 1, 4
"d:\IDEWORK\lvmen\src\licensedcode\data\rules\gpl-2.0-plus_996.yml", "YAML", 0, 0, 0, 4, 0, 0, 1, 5
"d:\IDEWORK\lvmen\src\licensedcode\data\rules\gpl-2.0-plus_997.yml", "YAML", 0, 0, 0, 5, 0, 0, 1, 6
"d:\IDEWORK\lvmen\src\licensedcode\data\rules\gpl-2.0-plus_998.yml", "YAML", 0, 0, 0, 7, 0, 0, 1, 8
"d:\IDEWORK\lvmen\src\licensedcode\data\rules\gpl-2.0-plus_999.yml", "YAML", 0, 0, 0, 5, 0, 0, 1, 6
"d:\IDEWORK\lvmen\src\licensedcode\data\rules\gpl-2.0-plus_and_bootloader-exception_1.yml", "YAML", 0, 0, 0, 5, 0, 0, 1, 6
"d:\IDEWORK\lvmen\src\licensedcode\data\rules\gpl-2.0-plus_and_bootloader-exception_2.yml", "YAML", 0, 0, 0, 3, 0, 0, 1, 4
"d:\IDEWORK\lvmen\src\licensedcode\data\rules\gpl-2.0-plus_and_bsd-new_1.yml", "YAML", 0, 0, 0, 3, 0, 0, 1, 4
"d:\IDEWORK\lvmen\src\licensedcode\data\rules\gpl-2.0-plus_and_bsd-new_2.yml", "YAML", 0, 0, 0, 3, 0, 0, 1, 4
"d:\IDEWORK\lvmen\src\licensedcode\data\rules\gpl-2.0-plus_and_cc-by-sa-3.0_1.yml", "YAML", 0, 0, 0, 3, 0, 0, 1, 4
"d:\IDEWORK\lvmen\src\licensedcode\data\rules\gpl-2.0-plus_and_cc-by-sa-3.0_2.yml", "YAML", 0, 0, 0, 3, 0, 0, 1, 4
"d:\IDEWORK\lvmen\src\licensedcode\data\rules\gpl-2.0-plus_and_cc-by-sa-4.0_and_other-copyleft_and_other-permissive_1.yml", "YAML", 0, 0, 0, 6, 0, 0, 1, 7
"d:\IDEWORK\lvmen\src\licensedcode\data\rules\gpl-2.0-plus_and_crypto-keys-redistribution.yml", "YAML", 0, 0, 0, 2, 0, 0, 1, 3
"d:\IDEWORK\lvmen\src\licensedcode\data\rules\gpl-2.0-plus_and_crypto-keys-redistribution2.yml", "YAML", 0, 0, 0, 3, 0, 0, 1, 4
"d:\IDEWORK\lvmen\src\licensedcode\data\rules\gpl-2.0-plus_and_gpl-3.0-plus.yml", "YAML", 0, 0, 0, 3, 0, 0, 1, 4
"d:\IDEWORK\lvmen\src\licensedcode\data\rules\gpl-2.0-plus_and_gpl-3.0-plus_1.yml", "YAML", 0, 0, 0, 3, 0, 0, 1, 4
"d:\IDEWORK\lvmen\src\licensedcode\data\rules\gpl-2.0-plus_and_gpl-3.0-plus_2.yml", "YAML", 0, 0, 0, 4, 0, 0, 1, 5
"d:\IDEWORK\lvmen\src\licensedcode\data\rules\gpl-2.0-plus_and_gpl-3.0-plus_3.yml", "YAML", 0, 0, 0, 4, 0, 0, 1, 5
"d:\IDEWORK\lvmen\src\licensedcode\data\rules\gpl-2.0-plus_and_gpl-3.0-plus_4.yml", "YAML", 0, 0, 0, 3, 0, 0, 1, 4
"d:\IDEWORK\lvmen\src\licensedcode\data\rules\gpl-2.0-plus_and_gpl-3.0.yml", "YAML", 0, 0, 0, 4, 0, 0, 1, 5
"d:\IDEWORK\lvmen\src\licensedcode\data\rules\gpl-2.0-plus_and_gpl-3.0_1.yml", "YAML", 0, 0, 0, 5, 0, 0, 1, 6
"d:\IDEWORK\lvmen\src\licensedcode\data\rules\gpl-2.0-plus_and_gpl-3.0_2.yml", "YAML", 0, 0, 0, 5, 0, 0, 1, 6
"d:\IDEWORK\lvmen\src\licensedcode\data\rules\gpl-2.0-plus_and_gpl-3.0_3.yml", "YAML", 0, 0, 0, 5, 0, 0, 1, 6
"d:\IDEWORK\lvmen\src\licensedcode\data\rules\gpl-2.0-plus_and_gpl-3.0_4.yml", "YAML", 0, 0, 0, 5, 0, 0, 1, 6
"d:\IDEWORK\lvmen\src\licensedcode\data\rules\gpl-2.0-plus_and_gpl-3.0_5.yml", "YAML", 0, 0, 0, 5, 0, 0, 1, 6
"d:\IDEWORK\lvmen\src\licensedcode\data\rules\gpl-2.0-plus_and_lgpl-2.0-plus_1.yml", "YAML", 0, 0, 0, 5, 0, 0, 1, 6
"d:\IDEWORK\lvmen\src\licensedcode\data\rules\gpl-2.0-plus_and_lgpl-2.0-plus_and_other-copyleft_and_other-permissive_1.yml", "YAML", 0, 0, 0, 11, 0, 0, 1, 12
"d:\IDEWORK\lvmen\src\licensedcode\data\rules\gpl-2.0-plus_and_lgpl-2.0_1.yml", "YAML", 0, 0, 0, 5, 0, 0, 1, 6
"d:\IDEWORK\lvmen\src\licensedcode\data\rules\gpl-2.0-plus_and_lgpl-2.0_2.yml", "YAML", 0, 0, 0, 4, 0, 0, 1, 5
"d:\IDEWORK\lvmen\src\licensedcode\data\rules\gpl-2.0-plus_and_lgpl-2.1-plus_1.yml", "YAML", 0, 0, 0, 3, 0, 0, 1, 4
"d:\IDEWORK\lvmen\src\licensedcode\data\rules\gpl-2.0-plus_and_lgpl-2.1-plus_2.yml", "YAML", 0, 0, 0, 3, 0, 0, 1, 4
"d:\IDEWORK\lvmen\src\licensedcode\data\rules\gpl-2.0-plus_and_lgpl-2.1-plus_and_cc-by-sa-4.0_and_bds-new.yml", "YAML", 0, 0, 0, 2, 0, 0, 1, 3
"d:\IDEWORK\lvmen\src\licensedcode\data\rules\gpl-2.0-plus_and_mit-synopsys.yml", "YAML", 0, 0, 0, 5, 0, 0, 1, 6
"d:\IDEWORK\lvmen\src\licensedcode\data\rules\gpl-2.0-plus_and_mit-synopsys_1.yml", "YAML", 0, 0, 0, 6, 0, 0, 1, 7
"d:\IDEWORK\lvmen\src\licensedcode\data\rules\gpl-2.0-plus_and_mit-synopsys_or_bsd-new_and_mit-synopsys.yml", "YAML", 0, 0, 0, 5, 0, 0, 1, 6
"d:\IDEWORK\lvmen\src\licensedcode\data\rules\gpl-2.0-plus_and_mit-synopsys_or_bsd-new_and_mit-synopsys_1.yml", "YAML", 0, 0, 0, 6, 0, 0, 1, 7
"d:\IDEWORK\lvmen\src\licensedcode\data\rules\gpl-2.0-plus_and_other-copyleft_1.yml", "YAML", 0, 0, 0, 6, 0, 0, 1, 7
"d:\IDEWORK\lvmen\src\licensedcode\data\rules\gpl-2.0-plus_and_other-permissive_and_other-copyleft_1.yml", "YAML", 0, 0, 0, 4, 0, 0, 1, 5
"d:\IDEWORK\lvmen\src\licensedcode\data\rules\gpl-2.0-plus_and_other-permissive_and_other-copyleft_2.yml", "YAML", 0, 0, 0, 4, 0, 0, 1, 5
"d:\IDEWORK\lvmen\src\licensedcode\data\rules\gpl-2.0-plus_and_proprietary-license_1.yml", "YAML", 0, 0, 0, 3, 0, 0, 1, 4
"d:\IDEWORK\lvmen\src\licensedcode\data\rules\gpl-2.0-plus_and_proprietary-license_2.yml", "YAML", 0, 0, 0, 4, 0, 0, 1, 5
"d:\IDEWORK\lvmen\src\licensedcode\data\rules\gpl-2.0-plus_and_proprietary-license_3.yml", "YAML", 0, 0, 0, 4, 0, 0, 1, 5
"d:\IDEWORK\lvmen\src\licensedcode\data\rules\gpl-2.0-plus_and_proprietary-license_or_commercial-license_1.yml", "YAML", 0, 0, 0, 3, 0, 0, 1, 4
"d:\IDEWORK\lvmen\src\licensedcode\data\rules\gpl-2.0-plus_and_proprietary_1.yml", "YAML", 0, 0, 0, 3, 0, 0, 1, 4
"d:\IDEWORK\lvmen\src\licensedcode\data\rules\gpl-2.0-plus_and_proprietary_2.yml", "YAML", 0, 0, 0, 7, 0, 0, 1, 8
"d:\IDEWORK\lvmen\src\licensedcode\data\rules\gpl-2.0-plus_and_proprietary_3.yml", "YAML", 0, 0, 0, 7, 0, 0, 1, 8
"d:\IDEWORK\lvmen\src\licensedcode\data\rules\gpl-2.0-plus_and_proprietary_4.yml", "YAML", 0, 0, 0, 7, 0, 0, 1, 8
"d:\IDEWORK\lvmen\src\licensedcode\data\rules\gpl-2.0-plus_and_proprietary_5.yml", "YAML", 0, 0, 0, 10, 0, 0, 1, 11
"d:\IDEWORK\lvmen\src\licensedcode\data\rules\gpl-2.0-plus_and_proprietary_6.yml", "YAML", 0, 0, 0, 7, 0, 0, 1, 8
"d:\IDEWORK\lvmen\src\licensedcode\data\rules\gpl-2.0-plus_and_public-domain_810.yml", "YAML", 0, 0, 0, 4, 0, 0, 1, 5
"d:\IDEWORK\lvmen\src\licensedcode\data\rules\gpl-2.0-plus_and_public_domain_1.yml", "YAML", 0, 0, 0, 4, 0, 0, 1, 5
"d:\IDEWORK\lvmen\src\licensedcode\data\rules\gpl-2.0-plus_and_public_domain_2.yml", "YAML", 0, 0, 0, 3, 0, 0, 1, 4
"d:\IDEWORK\lvmen\src\licensedcode\data\rules\gpl-2.0-plus_and_qlogic-microcode.yml", "YAML", 0, 0, 0, 3, 0, 0, 1, 4
"d:\IDEWORK\lvmen\src\licensedcode\data\rules\gpl-2.0-plus_and_qlogic-microcode2.yml", "YAML", 0, 0, 0, 7, 0, 0, 1, 8
"d:\IDEWORK\lvmen\src\licensedcode\data\rules\gpl-2.0-plus_and_softfloat.yml", "YAML", 0, 0, 0, 9, 0, 0, 1, 10
"d:\IDEWORK\lvmen\src\licensedcode\data\rules\gpl-2.0-plus_bare_single_word.yml", "YAML", 0, 0, 0, 3, 0, 0, 1, 4
"d:\IDEWORK\lvmen\src\licensedcode\data\rules\gpl-2.0-plus_busybox.yml", "YAML", 0, 0, 0, 3, 0, 0, 1, 4
"d:\IDEWORK\lvmen\src\licensedcode\data\rules\gpl-2.0-plus_composer_comment.yml", "YAML", 0, 0, 0, 2, 0, 0, 1, 3
"d:\IDEWORK\lvmen\src\licensedcode\data\rules\gpl-2.0-plus_debian.yml", "YAML", 0, 0, 0, 2, 0, 0, 1, 3
"d:\IDEWORK\lvmen\src\licensedcode\data\rules\gpl-2.0-plus_kodi.yml", "YAML", 0, 0, 0, 6, 0, 0, 1, 7
"d:\IDEWORK\lvmen\src\licensedcode\data\rules\gpl-2.0-plus_later_italian.yml", "YAML", 0, 0, 0, 3, 0, 0, 1, 4
"d:\IDEWORK\lvmen\src\licensedcode\data\rules\gpl-2.0-plus_module_license_1.yml", "YAML", 0, 0, 0, 4, 0, 0, 1, 5
"d:\IDEWORK\lvmen\src\licensedcode\data\rules\gpl-2.0-plus_module_license_2.yml", "YAML", 0, 0, 0, 6, 0, 0, 1, 7
"d:\IDEWORK\lvmen\src\licensedcode\data\rules\gpl-2.0-plus_module_license_3.yml", "YAML", 0, 0, 0, 6, 0, 0, 1, 7
"d:\IDEWORK\lvmen\src\licensedcode\data\rules\gpl-2.0-plus_not_gpl-2.0_20.yml", "YAML", 0, 0, 0, 5, 0, 0, 1, 6
"d:\IDEWORK\lvmen\src\licensedcode\data\rules\gpl-2.0-plus_not_gpl-2.0_20_1.yml", "YAML", 0, 0, 0, 5, 0, 0, 1, 6
"d:\IDEWORK\lvmen\src\licensedcode\data\rules\gpl-2.0-plus_not_gpl-2.0_24.yml", "YAML", 0, 0, 0, 4, 0, 0, 1, 5
"d:\IDEWORK\lvmen\src\licensedcode\data\rules\gpl-2.0-plus_not_gpl-2.0_42.yml", "YAML", 0, 0, 0, 6, 0, 0, 1, 7
"d:\IDEWORK\lvmen\src\licensedcode\data\rules\gpl-2.0-plus_not_lgpl.yml", "YAML", 0, 0, 0, 2, 0, 0, 1, 3
"d:\IDEWORK\lvmen\src\licensedcode\data\rules\gpl-2.0-plus_not_lgpl_2.yml", "YAML", 0, 0, 0, 3, 0, 0, 1, 4
"d:\IDEWORK\lvmen\src\licensedcode\data\rules\gpl-2.0-plus_or_afpl-9.0_1.yml", "YAML", 0, 0, 0, 8, 0, 0, 1, 9
"d:\IDEWORK\lvmen\src\licensedcode\data\rules\gpl-2.0-plus_or_artistic-2.0_1.yml", "YAML", 0, 0, 0, 2, 0, 0, 1, 3
"d:\IDEWORK\lvmen\src\licensedcode\data\rules\gpl-2.0-plus_or_artistic-2.0_2.yml", "YAML", 0, 0, 0, 2, 0, 0, 1, 3
"d:\IDEWORK\lvmen\src\licensedcode\data\rules\gpl-2.0-plus_or_artistic-perl-1.0_1.yml", "YAML", 0, 0, 0, 3, 0, 0, 1, 4
"d:\IDEWORK\lvmen\src\licensedcode\data\rules\gpl-2.0-plus_or_artistic-perl-1.0_2.yml", "YAML", 0, 0, 0, 3, 0, 0, 1, 4
"d:\IDEWORK\lvmen\src\licensedcode\data\rules\gpl-2.0-plus_or_bsd-innosys.yml", "YAML", 0, 0, 0, 3, 0, 0, 1, 4
"d:\IDEWORK\lvmen\src\licensedcode\data\rules\gpl-2.0-plus_or_bsd-innosys2.yml", "YAML", 0, 0, 0, 3, 0, 0, 1, 4
"d:\IDEWORK\lvmen\src\licensedcode\data\rules\gpl-2.0-plus_or_bsd-mylex_1.yml", "YAML", 0, 0, 0, 2, 0, 0, 1, 3
"d:\IDEWORK\lvmen\src\licensedcode\data\rules\gpl-2.0-plus_or_bsd-mylex_2.yml", "YAML", 0, 0, 0, 7, 0, 0, 1, 8
"d:\IDEWORK\lvmen\src\licensedcode\data\rules\gpl-2.0-plus_or_bsd-new_1.yml", "YAML", 0, 0, 0, 4, 0, 0, 1, 5
"d:\IDEWORK\lvmen\src\licensedcode\data\rules\gpl-2.0-plus_or_bsd-new_10.yml", "YAML", 0, 0, 0, 3, 0, 0, 1, 4
"d:\IDEWORK\lvmen\src\licensedcode\data\rules\gpl-2.0-plus_or_bsd-new_11.yml", "YAML", 0, 0, 0, 5, 0, 0, 1, 6
"d:\IDEWORK\lvmen\src\licensedcode\data\rules\gpl-2.0-plus_or_bsd-new_12.yml", "YAML", 0, 0, 0, 3, 0, 0, 1, 4
"d:\IDEWORK\lvmen\src\licensedcode\data\rules\gpl-2.0-plus_or_bsd-new_13.yml", "YAML", 0, 0, 0, 3, 0, 0, 1, 4
"d:\IDEWORK\lvmen\src\licensedcode\data\rules\gpl-2.0-plus_or_bsd-new_14.yml", "YAML", 0, 0, 0, 3, 0, 0, 1, 4
"d:\IDEWORK\lvmen\src\licensedcode\data\rules\gpl-2.0-plus_or_bsd-new_15.yml", "YAML", 0, 0, 0, 3, 0, 0, 1, 4
"d:\IDEWORK\lvmen\src\licensedcode\data\rules\gpl-2.0-plus_or_bsd-new_16.yml", "YAML", 0, 0, 0, 3, 0, 0, 1, 4
"d:\IDEWORK\lvmen\src\licensedcode\data\rules\gpl-2.0-plus_or_bsd-new_17.yml", "YAML", 0, 0, 0, 6, 0, 0, 1, 7
"d:\IDEWORK\lvmen\src\licensedcode\data\rules\gpl-2.0-plus_or_bsd-new_18.yml", "YAML", 0, 0, 0, 6, 0, 0, 1, 7
"d:\IDEWORK\lvmen\src\licensedcode\data\rules\gpl-2.0-plus_or_bsd-new_19.yml", "YAML", 0, 0, 0, 6, 0, 0, 1, 7
"d:\IDEWORK\lvmen\src\licensedcode\data\rules\gpl-2.0-plus_or_bsd-new_2.yml", "YAML", 0, 0, 0, 2, 0, 0, 1, 3
"d:\IDEWORK\lvmen\src\licensedcode\data\rules\gpl-2.0-plus_or_bsd-new_3.yml", "YAML", 0, 0, 0, 5, 0, 0, 1, 6
"d:\IDEWORK\lvmen\src\licensedcode\data\rules\gpl-2.0-plus_or_bsd-new_4.yml", "YAML", 0, 0, 0, 3, 0, 0, 1, 4
"d:\IDEWORK\lvmen\src\licensedcode\data\rules\gpl-2.0-plus_or_bsd-new_5.yml", "YAML", 0, 0, 0, 5, 0, 0, 1, 6
"d:\IDEWORK\lvmen\src\licensedcode\data\rules\gpl-2.0-plus_or_bsd-new_6.yml", "YAML", 0, 0, 0, 3, 0, 0, 1, 4
"d:\IDEWORK\lvmen\src\licensedcode\data\rules\gpl-2.0-plus_or_bsd-new_7.yml", "YAML", 0, 0, 0, 3, 0, 0, 1, 4
"d:\IDEWORK\lvmen\src\licensedcode\data\rules\gpl-2.0-plus_or_bsd-new_8.yml", "YAML", 0, 0, 0, 2, 0, 0, 1, 3
"d:\IDEWORK\lvmen\src\licensedcode\data\rules\gpl-2.0-plus_or_bsd-new_9.yml", "YAML", 0, 0, 0, 3, 0, 0, 1, 4
"d:\IDEWORK\lvmen\src\licensedcode\data\rules\gpl-2.0-plus_or_bsd-original_1.yml", "YAML", 0, 0, 0, 6, 0, 0, 1, 7
"d:\IDEWORK\lvmen\src\licensedcode\data\rules\gpl-2.0-plus_or_bsd-simplified.yml", "YAML", 0, 0, 0, 3, 0, 0, 1, 4
"d:\IDEWORK\lvmen\src\licensedcode\data\rules\gpl-2.0-plus_or_bsd-simplified2.yml", "YAML", 0, 0, 0, 3, 0, 0, 1, 4
"d:\IDEWORK\lvmen\src\licensedcode\data\rules\gpl-2.0-plus_or_bsd-simplified3.yml", "YAML", 0, 0, 0, 5, 0, 0, 1, 6
"d:\IDEWORK\lvmen\src\licensedcode\data\rules\gpl-2.0-plus_or_bsd-simplified_1.yml", "YAML", 0, 0, 0, 4, 0, 0, 1, 5
"d:\IDEWORK\lvmen\src\licensedcode\data\rules\gpl-2.0-plus_or_bsd-simplified_2.yml", "YAML", 0, 0, 0, 4, 0, 0, 1, 5
"d:\IDEWORK\lvmen\src\licensedcode\data\rules\gpl-2.0-plus_or_bsd-simplified_3.yml", "YAML", 0, 0, 0, 7, 0, 0, 1, 8
"d:\IDEWORK\lvmen\src\licensedcode\data\rules\gpl-2.0-plus_or_bsd-simplified_4.yml", "YAML", 0, 0, 0, 8, 0, 0, 1, 9
"d:\IDEWORK\lvmen\src\licensedcode\data\rules\gpl-2.0-plus_or_bsd-simplified_and_ocb-open-source-2013_1.yml", "YAML", 0, 0, 0, 3, 0, 0, 1, 4
"d:\IDEWORK\lvmen\src\licensedcode\data\rules\gpl-2.0-plus_or_bsd-unmodified_1.yml", "YAML", 0, 0, 0, 5, 0, 0, 1, 6
"d:\IDEWORK\lvmen\src\licensedcode\data\rules\gpl-2.0-plus_or_commercial-license_1.yml", "YAML", 0, 0, 0, 2, 0, 0, 1, 3
"d:\IDEWORK\lvmen\src\licensedcode\data\rules\gpl-2.0-plus_or_commercial-license_2.yml", "YAML", 0, 0, 0, 3, 0, 0, 1, 4
"d:\IDEWORK\lvmen\src\licensedcode\data\rules\gpl-2.0-plus_or_commercial-license_3.yml", "YAML", 0, 0, 0, 6, 0, 0, 1, 7
"d:\IDEWORK\lvmen\src\licensedcode\data\rules\gpl-2.0-plus_or_commercial-license_and_unknown-license-reference_1.yml", "YAML", 0, 0, 0, 11, 0, 0, 1, 12
"d:\IDEWORK\lvmen\src\licensedcode\data\rules\gpl-2.0-plus_or_commercial-license_and_unknown-license-reference_2.yml", "YAML", 0, 0, 0, 12, 0, 0, 1, 13
"d:\IDEWORK\lvmen\src\licensedcode\data\rules\gpl-2.0-plus_or_commercial-license_and_unknown-license-reference_3.yml", "YAML", 0, 0, 0, 12, 0, 0, 1, 13
"d:\IDEWORK\lvmen\src\licensedcode\data\rules\gpl-2.0-plus_or_commercial-license_and_unknown-license-reference_4.yml", "YAML", 0, 0, 0, 12, 0, 0, 1, 13
"d:\IDEWORK\lvmen\src\licensedcode\data\rules\gpl-2.0-plus_or_commercial-license_and_unknown-license-reference_5.yml", "YAML", 0, 0, 0, 12, 0, 0, 1, 13
"d:\IDEWORK\lvmen\src\licensedcode\data\rules\gpl-2.0-plus_or_commercial-license_and_unknown-license-reference_6.yml", "YAML", 0, 0, 0, 11, 0, 0, 1, 12
"d:\IDEWORK\lvmen\src\licensedcode\data\rules\gpl-2.0-plus_or_copyleft_next.yml", "YAML", 0, 0, 0, 4, 0, 0, 1, 5
"d:\IDEWORK\lvmen\src\licensedcode\data\rules\gpl-2.0-plus_or_gpl-3.0-plus_and_other-permissive_and_public-domain_1.yml", "YAML", 0, 0, 0, 2, 0, 0, 1, 3
"d:\IDEWORK\lvmen\src\licensedcode\data\rules\gpl-2.0-plus_or_gsoap-1.3b_or_commercial-license_1.yml", "YAML", 0, 0, 0, 3, 0, 0, 1, 4
"d:\IDEWORK\lvmen\src\licensedcode\data\rules\gpl-2.0-plus_or_isc_1.yml", "YAML", 0, 0, 0, 4, 0, 0, 1, 5
"d:\IDEWORK\lvmen\src\licensedcode\data\rules\gpl-2.0-plus_or_isc_2.yml", "YAML", 0, 0, 0, 4, 0, 0, 1, 5
"d:\IDEWORK\lvmen\src\licensedcode\data\rules\gpl-2.0-plus_or_lgpl-2.0-plus_1.yml", "YAML", 0, 0, 0, 3, 0, 0, 1, 4
"d:\IDEWORK\lvmen\src\licensedcode\data\rules\gpl-2.0-plus_or_lgpl-2.0-plus_10.yml", "YAML", 0, 0, 0, 6, 0, 0, 1, 7
"d:\IDEWORK\lvmen\src\licensedcode\data\rules\gpl-2.0-plus_or_lgpl-2.0-plus_11.yml", "YAML", 0, 0, 0, 4, 0, 0, 1, 5
"d:\IDEWORK\lvmen\src\licensedcode\data\rules\gpl-2.0-plus_or_lgpl-2.0-plus_12.yml", "YAML", 0, 0, 0, 3, 0, 0, 1, 4
"d:\IDEWORK\lvmen\src\licensedcode\data\rules\gpl-2.0-plus_or_lgpl-2.0-plus_13.yml", "YAML", 0, 0, 0, 6, 0, 0, 1, 7
"d:\IDEWORK\lvmen\src\licensedcode\data\rules\gpl-2.0-plus_or_lgpl-2.0-plus_14.yml", "YAML", 0, 0, 0, 6, 0, 0, 1, 7
"d:\IDEWORK\lvmen\src\licensedcode\data\rules\gpl-2.0-plus_or_lgpl-2.0-plus_2.yml", "YAML", 0, 0, 0, 3, 0, 0, 1, 4
"d:\IDEWORK\lvmen\src\licensedcode\data\rules\gpl-2.0-plus_or_lgpl-2.0-plus_3.yml", "YAML", 0, 0, 0, 4, 0, 0, 1, 5
"d:\IDEWORK\lvmen\src\licensedcode\data\rules\gpl-2.0-plus_or_lgpl-2.0-plus_4.yml", "YAML", 0, 0, 0, 3, 0, 0, 1, 4
"d:\IDEWORK\lvmen\src\licensedcode\data\rules\gpl-2.0-plus_or_lgpl-2.0-plus_5.yml", "YAML", 0, 0, 0, 3, 0, 0, 1, 4
"d:\IDEWORK\lvmen\src\licensedcode\data\rules\gpl-2.0-plus_or_lgpl-2.0-plus_6.yml", "YAML", 0, 0, 0, 3, 0, 0, 1, 4
"d:\IDEWORK\lvmen\src\licensedcode\data\rules\gpl-2.0-plus_or_lgpl-2.0-plus_7.yml", "YAML", 0, 0, 0, 3, 0, 0, 1, 4
"d:\IDEWORK\lvmen\src\licensedcode\data\rules\gpl-2.0-plus_or_lgpl-2.0-plus_8.yml", "YAML", 0, 0, 0, 6, 0, 0, 1, 7
"d:\IDEWORK\lvmen\src\licensedcode\data\rules\gpl-2.0-plus_or_lgpl-2.0-plus_9.yml", "YAML", 0, 0, 0, 3, 0, 0, 1, 4
"d:\IDEWORK\lvmen\src\licensedcode\data\rules\gpl-2.0-plus_or_lgpl-2.1-plus_1.yml", "YAML", 0, 0, 0, 3, 0, 0, 1, 4
"d:\IDEWORK\lvmen\src\licensedcode\data\rules\gpl-2.0-plus_or_lgpl-2.1-plus_2.yml", "YAML", 0, 0, 0, 3, 0, 0, 1, 4
"d:\IDEWORK\lvmen\src\licensedcode\data\rules\gpl-2.0-plus_or_lgpl-2.1-plus_3.yml", "YAML", 0, 0, 0, 3, 0, 0, 1, 4
"d:\IDEWORK\lvmen\src\licensedcode\data\rules\gpl-2.0-plus_or_lgpl-2.1-plus_4.yml", "YAML", 0, 0, 0, 4, 0, 0, 1, 5
"d:\IDEWORK\lvmen\src\licensedcode\data\rules\gpl-2.0-plus_or_lgpl-2.1-plus_5.yml", "YAML", 0, 0, 0, 3, 0, 0, 1, 4
"d:\IDEWORK\lvmen\src\licensedcode\data\rules\gpl-2.0-plus_or_lgpl-2.1-plus_6.yml", "YAML", 0, 0, 0, 6, 0, 0, 1, 7
"d:\IDEWORK\lvmen\src\licensedcode\data\rules\gpl-2.0-plus_or_lgpl-2.1-plus_and_other-permissive_1.yml", "YAML", 0, 0, 0, 6, 0, 0, 1, 7
"d:\IDEWORK\lvmen\src\licensedcode\data\rules\gpl-2.0-plus_or_lgpl-2.1-plus_or_mpl-1.1_1.yml", "YAML", 0, 0, 0, 3, 0, 0, 1, 4
"d:\IDEWORK\lvmen\src\licensedcode\data\rules\gpl-2.0-plus_or_lgpl-2.1-plus_or_mpl-1.1_10.yml", "YAML", 0, 0, 0, 7, 0, 0, 1, 8
"d:\IDEWORK\lvmen\src\licensedcode\data\rules\gpl-2.0-plus_or_lgpl-2.1-plus_or_mpl-1.1_11.yml", "YAML", 0, 0, 0, 7, 0, 0, 1, 8
"d:\IDEWORK\lvmen\src\licensedcode\data\rules\gpl-2.0-plus_or_lgpl-2.1-plus_or_mpl-1.1_12.yml", "YAML", 0, 0, 0, 7, 0, 0, 1, 8
"d:\IDEWORK\lvmen\src\licensedcode\data\rules\gpl-2.0-plus_or_lgpl-2.1-plus_or_mpl-1.1_2.yml", "YAML", 0, 0, 0, 7, 0, 0, 1, 8
"d:\IDEWORK\lvmen\src\licensedcode\data\rules\gpl-2.0-plus_or_lgpl-2.1-plus_or_mpl-1.1_3.yml", "YAML", 0, 0, 0, 3, 0, 0, 1, 4
"d:\IDEWORK\lvmen\src\licensedcode\data\rules\gpl-2.0-plus_or_lgpl-2.1-plus_or_mpl-1.1_4.yml", "YAML", 0, 0, 0, 7, 0, 0, 1, 8
"d:\IDEWORK\lvmen\src\licensedcode\data\rules\gpl-2.0-plus_or_lgpl-2.1-plus_or_mpl-1.1_5.yml", "YAML", 0, 0, 0, 7, 0, 0, 1, 8
"d:\IDEWORK\lvmen\src\licensedcode\data\rules\gpl-2.0-plus_or_lgpl-2.1-plus_or_mpl-1.1_6.yml", "YAML", 0, 0, 0, 4, 0, 0, 1, 5
"d:\IDEWORK\lvmen\src\licensedcode\data\rules\gpl-2.0-plus_or_lgpl-2.1-plus_or_mpl-1.1_7.yml", "YAML", 0, 0, 0, 8, 0, 0, 1, 9
"d:\IDEWORK\lvmen\src\licensedcode\data\rules\gpl-2.0-plus_or_lgpl-2.1-plus_or_mpl-1.1_8.yml", "YAML", 0, 0, 0, 7, 0, 0, 1, 8
"d:\IDEWORK\lvmen\src\licensedcode\data\rules\gpl-2.0-plus_or_lgpl-2.1-plus_or_mpl-1.1_9.yml", "YAML", 0, 0, 0, 8, 0, 0, 1, 9
"d:\IDEWORK\lvmen\src\licensedcode\data\rules\gpl-2.0-plus_or_lgpl-2.1-plus_or_mpl-1.1_or_bsd-new_1.yml", "YAML", 0, 0, 0, 2, 0, 0, 1, 3
"d:\IDEWORK\lvmen\src\licensedcode\data\rules\gpl-2.0-plus_or_lgpl-2.1-plus_or_mpl-1.1_or_later.yml", "YAML", 0, 0, 0, 6, 0, 0, 1, 7
"d:\IDEWORK\lvmen\src\licensedcode\data\rules\gpl-2.0-plus_or_lgpl-2.1-plus_or_mpl-1.1_or_later2.yml", "YAML", 0, 0, 0, 6, 0, 0, 1, 7
"d:\IDEWORK\lvmen\src\licensedcode\data\rules\gpl-2.0-plus_or_lgpl-2.1-plus_or_mpl-1.1_or_later3.yml", "YAML", 0, 0, 0, 6, 0, 0, 1, 7
"d:\IDEWORK\lvmen\src\licensedcode\data\rules\gpl-2.0-plus_or_lgpl-3.0-plus_1.yml", "YAML", 0, 0, 0, 5, 0, 0, 1, 6
"d:\IDEWORK\lvmen\src\licensedcode\data\rules\gpl-2.0-plus_or_lgpl-3.0-plus_2.yml", "YAML", 0, 0, 0, 6, 0, 0, 1, 7
"d:\IDEWORK\lvmen\src\licensedcode\data\rules\gpl-2.0-plus_or_lgpl-3.0-plus_and_gpl-3.0-plus_1.yml", "YAML", 0, 0, 0, 5, 0, 0, 1, 6
"d:\IDEWORK\lvmen\src\licensedcode\data\rules\gpl-2.0-plus_or_lgpl-3.0-plus_and_gpl-3.0-plus_2.yml", "YAML", 0, 0, 0, 4, 0, 0, 1, 5
"d:\IDEWORK\lvmen\src\licensedcode\data\rules\gpl-2.0-plus_or_lgpl-3.0-plus_and_gpl-3.0-plus_and_unicode-tou_and_unicode_and_other-permissive_and_other-copyleft_1.yml", "YAML", 0, 0, 0, 8, 0, 0, 1, 9
"d:\IDEWORK\lvmen\src\licensedcode\data\rules\gpl-2.0-plus_or_lgpl-3.0-plus_and_other.yml", "YAML", 0, 0, 0, 7, 0, 0, 1, 8
"d:\IDEWORK\lvmen\src\licensedcode\data\rules\gpl-2.0-plus_or_mit.yml", "YAML", 0, 0, 0, 5, 0, 0, 1, 6
"d:\IDEWORK\lvmen\src\licensedcode\data\rules\gpl-2.0-plus_or_mit2.yml", "YAML", 0, 0, 0, 3, 0, 0, 1, 4
"d:\IDEWORK\lvmen\src\licensedcode\data\rules\gpl-2.0-plus_or_mit4.yml", "YAML", 0, 0, 0, 3, 0, 0, 1, 4
"d:\IDEWORK\lvmen\src\licensedcode\data\rules\gpl-2.0-plus_or_mit5.yml", "YAML", 0, 0, 0, 3, 0, 0, 1, 4
"d:\IDEWORK\lvmen\src\licensedcode\data\rules\gpl-2.0-plus_or_mit6.yml", "YAML", 0, 0, 0, 3, 0, 0, 1, 4
"d:\IDEWORK\lvmen\src\licensedcode\data\rules\gpl-2.0-plus_or_mit7.yml", "YAML", 0, 0, 0, 3, 0, 0, 1, 4
"d:\IDEWORK\lvmen\src\licensedcode\data\rules\gpl-2.0-plus_or_mit8.yml", "YAML", 0, 0, 0, 5, 0, 0, 1, 6
"d:\IDEWORK\lvmen\src\licensedcode\data\rules\gpl-2.0-plus_or_mit9.yml", "YAML", 0, 0, 0, 2, 0, 0, 1, 3
"d:\IDEWORK\lvmen\src\licensedcode\data\rules\gpl-2.0-plus_or_mit_1.yml", "YAML", 0, 0, 0, 6, 0, 0, 1, 7
"d:\IDEWORK\lvmen\src\licensedcode\data\rules\gpl-2.0-plus_or_other-copyleft_or_commercial-license_1.yml", "YAML", 0, 0, 0, 4, 0, 0, 1, 5
"d:\IDEWORK\lvmen\src\licensedcode\data\rules\gpl-2.0-plus_or_php-3.0_1.yml", "YAML", 0, 0, 0, 8, 0, 0, 1, 9
"d:\IDEWORK\lvmen\src\licensedcode\data\rules\gpl-2.0-plus_or_php-3.0_2.yml", "YAML", 0, 0, 0, 5, 0, 0, 1, 6
"d:\IDEWORK\lvmen\src\licensedcode\data\rules\gpl-2.0-plus_or_tgppl-1.0_1.yml", "YAML", 0, 0, 0, 6, 0, 0, 1, 7
"d:\IDEWORK\lvmen\src\licensedcode\data\rules\gpl-2.0-plus_or_ubdl_1.yml", "YAML", 0, 0, 0, 5, 0, 0, 1, 6
"d:\IDEWORK\lvmen\src\licensedcode\data\rules\gpl-2.0-plus_pulp.yml", "YAML", 0, 0, 0, 4, 0, 0, 1, 5
"d:\IDEWORK\lvmen\src\licensedcode\data\rules\gpl-2.0-plus_structured.yml", "YAML", 0, 0, 0, 6, 0, 0, 1, 7
"d:\IDEWORK\lvmen\src\licensedcode\data\rules\gpl-2.0-plus_tag_1.yml", "YAML", 0, 0, 0, 3, 0, 0, 1, 4
"d:\IDEWORK\lvmen\src\licensedcode\data\rules\gpl-2.0-plus_url_1.yml", "YAML", 0, 0, 0, 5, 0, 0, 1, 6
"d:\IDEWORK\lvmen\src\licensedcode\data\rules\gpl-2.0-plus_url_2.yml", "YAML", 0, 0, 0, 5, 0, 0, 1, 6
"d:\IDEWORK\lvmen\src\licensedcode\data\rules\gpl-2.0-plus_with_ada-linking-exception_1.yml", "YAML", 0, 0, 0, 2, 0, 0, 1, 3
"d:\IDEWORK\lvmen\src\licensedcode\data\rules\gpl-2.0-plus_with_ada-linking-exception_2.yml", "YAML", 0, 0, 0, 5, 0, 0, 1, 6
"d:\IDEWORK\lvmen\src\licensedcode\data\rules\gpl-2.0-plus_with_ada-linking-exception_3.yml", "YAML", 0, 0, 0, 3, 0, 0, 1, 4
"d:\IDEWORK\lvmen\src\licensedcode\data\rules\gpl-2.0-plus_with_autoconf-exception-2.0_2.yml", "YAML", 0, 0, 0, 2, 0, 0, 1, 3
"d:\IDEWORK\lvmen\src\licensedcode\data\rules\gpl-2.0-plus_with_autoconf-exception-2.0_3.yml", "YAML", 0, 0, 0, 2, 0, 0, 1, 3
"d:\IDEWORK\lvmen\src\licensedcode\data\rules\gpl-2.0-plus_with_autoconf-macro-exception_1.yml", "YAML", 0, 0, 0, 2, 0, 0, 1, 3
"d:\IDEWORK\lvmen\src\licensedcode\data\rules\gpl-2.0-plus_with_autoconf-macro-exception_2.yml", "YAML", 0, 0, 0, 5, 0, 0, 1, 6
"d:\IDEWORK\lvmen\src\licensedcode\data\rules\gpl-2.0-plus_with_autoconf-macro-exception_3.yml", "YAML", 0, 0, 0, 3, 0, 0, 1, 4
"d:\IDEWORK\lvmen\src\licensedcode\data\rules\gpl-2.0-plus_with_autoconf-macro-exception_4.yml", "YAML", 0, 0, 0, 5, 0, 0, 1, 6
"d:\IDEWORK\lvmen\src\licensedcode\data\rules\gpl-2.0-plus_with_autoconf-simple-exception-2.0_1.yml", "YAML", 0, 0, 0, 3, 0, 0, 1, 4
"d:\IDEWORK\lvmen\src\licensedcode\data\rules\gpl-2.0-plus_with_autoconf-simple-exception-2.0_10.yml", "YAML", 0, 0, 0, 4, 0, 0, 1, 5
"d:\IDEWORK\lvmen\src\licensedcode\data\rules\gpl-2.0-plus_with_autoconf-simple-exception-2.0_11.yml", "YAML", 0, 0, 0, 3, 0, 0, 1, 4
"d:\IDEWORK\lvmen\src\licensedcode\data\rules\gpl-2.0-plus_with_autoconf-simple-exception-2.0_12.yml", "YAML", 0, 0, 0, 2, 0, 0, 1, 3
"d:\IDEWORK\lvmen\src\licensedcode\data\rules\gpl-2.0-plus_with_autoconf-simple-exception-2.0_13.yml", "YAML", 0, 0, 0, 3, 0, 0, 1, 4
"d:\IDEWORK\lvmen\src\licensedcode\data\rules\gpl-2.0-plus_with_autoconf-simple-exception-2.0_14.yml", "YAML", 0, 0, 0, 2, 0, 0, 1, 3
"d:\IDEWORK\lvmen\src\licensedcode\data\rules\gpl-2.0-plus_with_autoconf-simple-exception-2.0_15.yml", "YAML", 0, 0, 0, 5, 0, 0, 1, 6
"d:\IDEWORK\lvmen\src\licensedcode\data\rules\gpl-2.0-plus_with_autoconf-simple-exception-2.0_16.yml", "YAML", 0, 0, 0, 6, 0, 0, 1, 7
"d:\IDEWORK\lvmen\src\licensedcode\data\rules\gpl-2.0-plus_with_autoconf-simple-exception-2.0_17.yml", "YAML", 0, 0, 0, 3, 0, 0, 1, 4
"d:\IDEWORK\lvmen\src\licensedcode\data\rules\gpl-2.0-plus_with_autoconf-simple-exception-2.0_18.yml", "YAML", 0, 0, 0, 7, 0, 0, 1, 8
"d:\IDEWORK\lvmen\src\licensedcode\data\rules\gpl-2.0-plus_with_autoconf-simple-exception-2.0_2.yml", "YAML", 0, 0, 0, 5, 0, 0, 1, 6
"d:\IDEWORK\lvmen\src\licensedcode\data\rules\gpl-2.0-plus_with_autoconf-simple-exception-2.0_3.yml", "YAML", 0, 0, 0, 2, 0, 0, 1, 3
"d:\IDEWORK\lvmen\src\licensedcode\data\rules\gpl-2.0-plus_with_autoconf-simple-exception-2.0_4.yml", "YAML", 0, 0, 0, 2, 0, 0, 1, 3
"d:\IDEWORK\lvmen\src\licensedcode\data\rules\gpl-2.0-plus_with_autoconf-simple-exception-2.0_5.yml", "YAML", 0, 0, 0, 2, 0, 0, 1, 3
"d:\IDEWORK\lvmen\src\licensedcode\data\rules\gpl-2.0-plus_with_autoconf-simple-exception-2.0_6.yml", "YAML", 0, 0, 0, 2, 0, 0, 1, 3
"d:\IDEWORK\lvmen\src\licensedcode\data\rules\gpl-2.0-plus_with_autoconf-simple-exception-2.0_7.yml", "YAML", 0, 0, 0, 4, 0, 0, 1, 5
"d:\IDEWORK\lvmen\src\licensedcode\data\rules\gpl-2.0-plus_with_autoconf-simple-exception-2.0_8.yml", "YAML", 0, 0, 0, 2, 0, 0, 1, 3
"d:\IDEWORK\lvmen\src\licensedcode\data\rules\gpl-2.0-plus_with_autoconf-simple-exception-2.0_9.yml", "YAML", 0, 0, 0, 4, 0, 0, 1, 5
"d:\IDEWORK\lvmen\src\licensedcode\data\rules\gpl-2.0-plus_with_autoopts-exception-2.0_1.yml", "YAML", 0, 0, 0, 4, 0, 0, 1, 5
"d:\IDEWORK\lvmen\src\licensedcode\data\rules\gpl-2.0-plus_with_avisynth-c-interface-exception_1.yml", "YAML", 0, 0, 0, 4, 0, 0, 1, 5
"d:\IDEWORK\lvmen\src\licensedcode\data\rules\gpl-2.0-plus_with_avisynth-c-interface-exception_2.yml", "YAML", 0, 0, 0, 5, 0, 0, 1, 6
"d:\IDEWORK\lvmen\src\licensedcode\data\rules\gpl-2.0-plus_with_bison-exception-2.0_1.yml", "YAML", 0, 0, 0, 2, 0, 0, 1, 3
"d:\IDEWORK\lvmen\src\licensedcode\data\rules\gpl-2.0-plus_with_bison-exception-2.0_2.yml", "YAML", 0, 0, 0, 2, 0, 0, 1, 3
"d:\IDEWORK\lvmen\src\licensedcode\data\rules\gpl-2.0-plus_with_bison-exception-2.0_3.yml", "YAML", 0, 0, 0, 5, 0, 0, 1, 6
"d:\IDEWORK\lvmen\src\licensedcode\data\rules\gpl-2.0-plus_with_bison-exception-2.2_1.yml", "YAML", 0, 0, 0, 2, 0, 0, 1, 3
"d:\IDEWORK\lvmen\src\licensedcode\data\rules\gpl-2.0-plus_with_bison-exception-2.2_2.yml", "YAML", 0, 0, 0, 3, 0, 0, 1, 4
"d:\IDEWORK\lvmen\src\licensedcode\data\rules\gpl-2.0-plus_with_bootloader-exception_1.yml", "YAML", 0, 0, 0, 3, 0, 0, 1, 4
"d:\IDEWORK\lvmen\src\licensedcode\data\rules\gpl-2.0-plus_with_classpath-exception-2.0.yml", "YAML", 0, 0, 0, 5, 0, 0, 1, 6
"d:\IDEWORK\lvmen\src\licensedcode\data\rules\gpl-2.0-plus_with_classpath-exception-2.0_1.yml", "YAML", 0, 0, 0, 2, 0, 0, 1, 3
"d:\IDEWORK\lvmen\src\licensedcode\data\rules\gpl-2.0-plus_with_classpath-exception-2.0_10.yml", "YAML", 0, 0, 0, 3, 0, 0, 1, 4
"d:\IDEWORK\lvmen\src\licensedcode\data\rules\gpl-2.0-plus_with_classpath-exception-2.0_11.yml", "YAML", 0, 0, 0, 5, 0, 0, 1, 6
"d:\IDEWORK\lvmen\src\licensedcode\data\rules\gpl-2.0-plus_with_classpath-exception-2.0_12.yml", "YAML", 0, 0, 0, 6, 0, 0, 1, 7
"d:\IDEWORK\lvmen\src\licensedcode\data\rules\gpl-2.0-plus_with_classpath-exception-2.0_13.yml", "YAML", 0, 0, 0, 6, 0, 0, 1, 7
"d:\IDEWORK\lvmen\src\licensedcode\data\rules\gpl-2.0-plus_with_classpath-exception-2.0_16.yml", "YAML", 0, 0, 0, 3, 0, 0, 1, 4
"d:\IDEWORK\lvmen\src\licensedcode\data\rules\gpl-2.0-plus_with_classpath-exception-2.0_3.yml", "YAML", 0, 0, 0, 3, 0, 0, 1, 4
"d:\IDEWORK\lvmen\src\licensedcode\data\rules\gpl-2.0-plus_with_classpath-exception-2.0_4.yml", "YAML", 0, 0, 0, 2, 0, 0, 1, 3
"d:\IDEWORK\lvmen\src\licensedcode\data\rules\gpl-2.0-plus_with_classpath-exception-2.0_5.yml", "YAML", 0, 0, 0, 4, 0, 0, 1, 5
"d:\IDEWORK\lvmen\src\licensedcode\data\rules\gpl-2.0-plus_with_classpath-exception-2.0_6.yml", "YAML", 0, 0, 0, 4, 0, 0, 1, 5
"d:\IDEWORK\lvmen\src\licensedcode\data\rules\gpl-2.0-plus_with_classpath-exception-2.0_7.yml", "YAML", 0, 0, 0, 3, 0, 0, 1, 4
"d:\IDEWORK\lvmen\src\licensedcode\data\rules\gpl-2.0-plus_with_classpath-exception-2.0_8.yml", "YAML", 0, 0, 0, 2, 0, 0, 1, 3
"d:\IDEWORK\lvmen\src\licensedcode\data\rules\gpl-2.0-plus_with_classpath-exception-2.0_9.yml", "YAML", 0, 0, 0, 2, 0, 0, 1, 3
"d:\IDEWORK\lvmen\src\licensedcode\data\rules\gpl-2.0-plus_with_ecos-exception-2.0_1.yml", "YAML", 0, 0, 0, 2, 0, 0, 1, 3
"d:\IDEWORK\lvmen\src\licensedcode\data\rules\gpl-2.0-plus_with_ecos-exception-2.0_10.yml", "YAML", 0, 0, 0, 8, 0, 0, 1, 9
"d:\IDEWORK\lvmen\src\licensedcode\data\rules\gpl-2.0-plus_with_ecos-exception-2.0_11.yml", "YAML", 0, 0, 0, 2, 0, 0, 1, 3
"d:\IDEWORK\lvmen\src\licensedcode\data\rules\gpl-2.0-plus_with_ecos-exception-2.0_12.yml", "YAML", 0, 0, 0, 5, 0, 0, 1, 6
"d:\IDEWORK\lvmen\src\licensedcode\data\rules\gpl-2.0-plus_with_ecos-exception-2.0_13.yml", "YAML", 0, 0, 0, 4, 0, 0, 1, 5
"d:\IDEWORK\lvmen\src\licensedcode\data\rules\gpl-2.0-plus_with_ecos-exception-2.0_14.yml", "YAML", 0, 0, 0, 2, 0, 0, 1, 3
"d:\IDEWORK\lvmen\src\licensedcode\data\rules\gpl-2.0-plus_with_ecos-exception-2.0_15.yml", "YAML", 0, 0, 0, 2, 0, 0, 1, 3
"d:\IDEWORK\lvmen\src\licensedcode\data\rules\gpl-2.0-plus_with_ecos-exception-2.0_16.yml", "YAML", 0, 0, 0, 2, 0, 0, 1, 3
"d:\IDEWORK\lvmen\src\licensedcode\data\rules\gpl-2.0-plus_with_ecos-exception-2.0_17.yml", "YAML", 0, 0, 0, 6, 0, 0, 1, 7
"d:\IDEWORK\lvmen\src\licensedcode\data\rules\gpl-2.0-plus_with_ecos-exception-2.0_18.yml", "YAML", 0, 0, 0, 2, 0, 0, 1, 3
"d:\IDEWORK\lvmen\src\licensedcode\data\rules\gpl-2.0-plus_with_ecos-exception-2.0_19.yml", "YAML", 0, 0, 0, 5, 0, 0, 1, 6
"d:\IDEWORK\lvmen\src\licensedcode\data\rules\gpl-2.0-plus_with_ecos-exception-2.0_2.yml", "YAML", 0, 0, 0, 5, 0, 0, 1, 6
"d:\IDEWORK\lvmen\src\licensedcode\data\rules\gpl-2.0-plus_with_ecos-exception-2.0_20.yml", "YAML", 0, 0, 0, 4, 0, 0, 1, 5
"d:\IDEWORK\lvmen\src\licensedcode\data\rules\gpl-2.0-plus_with_ecos-exception-2.0_21.yml", "YAML", 0, 0, 0, 3, 0, 0, 1, 4
"d:\IDEWORK\lvmen\src\licensedcode\data\rules\gpl-2.0-plus_with_ecos-exception-2.0_22.yml", "YAML", 0, 0, 0, 7, 0, 0, 1, 8
"d:\IDEWORK\lvmen\src\licensedcode\data\rules\gpl-2.0-plus_with_ecos-exception-2.0_23.yml", "YAML", 0, 0, 0, 6, 0, 0, 1, 7
"d:\IDEWORK\lvmen\src\licensedcode\data\rules\gpl-2.0-plus_with_ecos-exception-2.0_24.yml", "YAML", 0, 0, 0, 5, 0, 0, 1, 6
"d:\IDEWORK\lvmen\src\licensedcode\data\rules\gpl-2.0-plus_with_ecos-exception-2.0_25.yml", "YAML", 0, 0, 0, 2, 0, 0, 1, 3
"d:\IDEWORK\lvmen\src\licensedcode\data\rules\gpl-2.0-plus_with_ecos-exception-2.0_3.yml", "YAML", 0, 0, 0, 5, 0, 0, 1, 6
"d:\IDEWORK\lvmen\src\licensedcode\data\rules\gpl-2.0-plus_with_ecos-exception-2.0_4.yml", "YAML", 0, 0, 0, 5, 0, 0, 1, 6
"d:\IDEWORK\lvmen\src\licensedcode\data\rules\gpl-2.0-plus_with_ecos-exception-2.0_5.yml", "YAML", 0, 0, 0, 4, 0, 0, 1, 5
"d:\IDEWORK\lvmen\src\licensedcode\data\rules\gpl-2.0-plus_with_ecos-exception-2.0_6.yml", "YAML", 0, 0, 0, 5, 0, 0, 1, 6
"d:\IDEWORK\lvmen\src\licensedcode\data\rules\gpl-2.0-plus_with_ecos-exception-2.0_7.yml", "YAML", 0, 0, 0, 6, 0, 0, 1, 7
"d:\IDEWORK\lvmen\src\licensedcode\data\rules\gpl-2.0-plus_with_ecos-exception-2.0_8.yml", "YAML", 0, 0, 0, 4, 0, 0, 1, 5
"d:\IDEWORK\lvmen\src\licensedcode\data\rules\gpl-2.0-plus_with_ecos-exception-2.0_9.yml", "YAML", 0, 0, 0, 8, 0, 0, 1, 9
"d:\IDEWORK\lvmen\src\licensedcode\data\rules\gpl-2.0-plus_with_font-exception-gpl_1.yml", "YAML", 0, 0, 0, 3, 0, 0, 1, 4
"d:\IDEWORK\lvmen\src\licensedcode\data\rules\gpl-2.0-plus_with_font-exception-gpl_2.yml", "YAML", 0, 0, 0, 5, 0, 0, 1, 6
"d:\IDEWORK\lvmen\src\licensedcode\data\rules\gpl-2.0-plus_with_font-exception-gpl_3.yml", "YAML", 0, 0, 0, 5, 0, 0, 1, 6
"d:\IDEWORK\lvmen\src\licensedcode\data\rules\gpl-2.0-plus_with_font-exception-gpl_and_unknown-license-reference_1.yml", "YAML", 0, 0, 0, 3, 0, 0, 1, 4
"d:\IDEWORK\lvmen\src\licensedcode\data\rules\gpl-2.0-plus_with_freertos-exception-2.0_1.yml", "YAML", 0, 0, 0, 5, 0, 0, 1, 6
"d:\IDEWORK\lvmen\src\licensedcode\data\rules\gpl-2.0-plus_with_gcc-compiler-exception-2.0_and_gpl-2.0-plus_with_and_others_1.yml", "YAML", 0, 0, 0, 4, 0, 0, 1, 5
"d:\IDEWORK\lvmen\src\licensedcode\data\rules\gpl-2.0-plus_with_gcc-compiler-exception-2.0_and_gpl-2.0-plus_with_and_others_2.yml", "YAML", 0, 0, 0, 4, 0, 0, 1, 5
"d:\IDEWORK\lvmen\src\licensedcode\data\rules\gpl-2.0-plus_with_gcc-compiler-exception-2.0_and_gpl-2.0-plus_with_and_others_3.yml", "YAML", 0, 0, 0, 4, 0, 0, 1, 5
"d:\IDEWORK\lvmen\src\licensedcode\data\rules\gpl-2.0-plus_with_gcc-linking-exception-2.0_1.yml", "YAML", 0, 0, 0, 6, 0, 0, 1, 7
"d:\IDEWORK\lvmen\src\licensedcode\data\rules\gpl-2.0-plus_with_gcc-linking-exception-2.0_2.yml", "YAML", 0, 0, 0, 5, 0, 0, 1, 6
"d:\IDEWORK\lvmen\src\licensedcode\data\rules\gpl-2.0-plus_with_gcc-linking-exception-2.0_3.yml", "YAML", 0, 0, 0, 5, 0, 0, 1, 6
"d:\IDEWORK\lvmen\src\licensedcode\data\rules\gpl-2.0-plus_with_gcc-linking-exception-2.0_4.yml", "YAML", 0, 0, 0, 4, 0, 0, 1, 5
"d:\IDEWORK\lvmen\src\licensedcode\data\rules\gpl-2.0-plus_with_gcc-linking-exception-2.0_5.yml", "YAML", 0, 0, 0, 4, 0, 0, 1, 5
"d:\IDEWORK\lvmen\src\licensedcode\data\rules\gpl-2.0-plus_with_gcc-linking-exception-2.0_6.yml", "YAML", 0, 0, 0, 4, 0, 0, 1, 5
"d:\IDEWORK\lvmen\src\licensedcode\data\rules\gpl-2.0-plus_with_gcc-linking-exception-2.0_7.yml", "YAML", 0, 0, 0, 4, 0, 0, 1, 5
"d:\IDEWORK\lvmen\src\licensedcode\data\rules\gpl-2.0-plus_with_gcc-linking-exception-2.0_8.yml", "YAML", 0, 0, 0, 6, 0, 0, 1, 7
"d:\IDEWORK\lvmen\src\licensedcode\data\rules\gpl-2.0-plus_with_generic-exception_1.yml", "YAML", 0, 0, 0, 4, 0, 0, 1, 5
"d:\IDEWORK\lvmen\src\licensedcode\data\rules\gpl-2.0-plus_with_generic-exception_2.yml", "YAML", 0, 0, 0, 6, 0, 0, 1, 7
"d:\IDEWORK\lvmen\src\licensedcode\data\rules\gpl-2.0-plus_with_geoserver-exception-2.0-plus_1.yml", "YAML", 0, 0, 0, 3, 0, 0, 1, 4
"d:\IDEWORK\lvmen\src\licensedcode\data\rules\gpl-2.0-plus_with_geoserver-exception-2.0-plus_2.yml", "YAML", 0, 0, 0, 3, 0, 0, 1, 4
"d:\IDEWORK\lvmen\src\licensedcode\data\rules\gpl-2.0-plus_with_gnu-javamail-exception_1.yml", "YAML", 0, 0, 0, 3, 0, 0, 1, 4
"d:\IDEWORK\lvmen\src\licensedcode\data\rules\gpl-2.0-plus_with_gpl-generic-additional-terms_1.yml", "YAML", 0, 0, 0, 3, 0, 0, 1, 4
"d:\IDEWORK\lvmen\src\licensedcode\data\rules\gpl-2.0-plus_with_gpl-generic-additional-terms_2.yml", "YAML", 0, 0, 0, 5, 0, 0, 1, 6
"d:\IDEWORK\lvmen\src\licensedcode\data\rules\gpl-2.0-plus_with_gpl-generic-additional-terms_3.yml", "YAML", 0, 0, 0, 7, 0, 0, 1, 8
"d:\IDEWORK\lvmen\src\licensedcode\data\rules\gpl-2.0-plus_with_gpl-generic-additional-terms_4.yml", "YAML", 0, 0, 0, 7, 0, 0, 1, 8
"d:\IDEWORK\lvmen\src\licensedcode\data\rules\gpl-2.0-plus_with_gpl-generic-additional-terms_5.yml", "YAML", 0, 0, 0, 5, 0, 0, 1, 6
"d:\IDEWORK\lvmen\src\licensedcode\data\rules\gpl-2.0-plus_with_guile-exception-2.0_1.yml", "YAML", 0, 0, 0, 3, 0, 0, 1, 4
"d:\IDEWORK\lvmen\src\licensedcode\data\rules\gpl-2.0-plus_with_iolib-exception-2.0_3.yml", "YAML", 0, 0, 0, 3, 0, 0, 1, 4
"d:\IDEWORK\lvmen\src\licensedcode\data\rules\gpl-2.0-plus_with_libtool-exception-2.0_1.yml", "YAML", 0, 0, 0, 7, 0, 0, 1, 8
"d:\IDEWORK\lvmen\src\licensedcode\data\rules\gpl-2.0-plus_with_libtool-exception-2.0_10.yml", "YAML", 0, 0, 0, 3, 0, 0, 1, 4
"d:\IDEWORK\lvmen\src\licensedcode\data\rules\gpl-2.0-plus_with_libtool-exception-2.0_11.yml", "YAML", 0, 0, 0, 8, 0, 0, 1, 9
"d:\IDEWORK\lvmen\src\licensedcode\data\rules\gpl-2.0-plus_with_libtool-exception-2.0_12.yml", "YAML", 0, 0, 0, 5, 0, 0, 1, 6
"d:\IDEWORK\lvmen\src\licensedcode\data\rules\gpl-2.0-plus_with_libtool-exception-2.0_13.yml", "YAML", 0, 0, 0, 5, 0, 0, 1, 6
"d:\IDEWORK\lvmen\src\licensedcode\data\rules\gpl-2.0-plus_with_libtool-exception-2.0_14.yml", "YAML", 0, 0, 0, 8, 0, 0, 1, 9
"d:\IDEWORK\lvmen\src\licensedcode\data\rules\gpl-2.0-plus_with_libtool-exception-2.0_15.yml", "YAML", 0, 0, 0, 8, 0, 0, 1, 9
"d:\IDEWORK\lvmen\src\licensedcode\data\rules\gpl-2.0-plus_with_libtool-exception-2.0_16.yml", "YAML", 0, 0, 0, 8, 0, 0, 1, 9
"d:\IDEWORK\lvmen\src\licensedcode\data\rules\gpl-2.0-plus_with_libtool-exception-2.0_17.yml", "YAML", 0, 0, 0, 6, 0, 0, 1, 7
"d:\IDEWORK\lvmen\src\licensedcode\data\rules\gpl-2.0-plus_with_libtool-exception-2.0_18.yml", "YAML", 0, 0, 0, 7, 0, 0, 1, 8
"d:\IDEWORK\lvmen\src\licensedcode\data\rules\gpl-2.0-plus_with_libtool-exception-2.0_19.yml", "YAML", 0, 0, 0, 3, 0, 0, 1, 4
"d:\IDEWORK\lvmen\src\licensedcode\data\rules\gpl-2.0-plus_with_libtool-exception-2.0_2.yml", "YAML", 0, 0, 0, 2, 0, 0, 1, 3
"d:\IDEWORK\lvmen\src\licensedcode\data\rules\gpl-2.0-plus_with_libtool-exception-2.0_3.yml", "YAML", 0, 0, 0, 7, 0, 0, 1, 8
"d:\IDEWORK\lvmen\src\licensedcode\data\rules\gpl-2.0-plus_with_libtool-exception-2.0_4.yml", "YAML", 0, 0, 0, 7, 0, 0, 1, 8
"d:\IDEWORK\lvmen\src\licensedcode\data\rules\gpl-2.0-plus_with_libtool-exception-2.0_5.yml", "YAML", 0, 0, 0, 4, 0, 0, 1, 5
"d:\IDEWORK\lvmen\src\licensedcode\data\rules\gpl-2.0-plus_with_libtool-exception-2.0_6.yml", "YAML", 0, 0, 0, 4, 0, 0, 1, 5
"d:\IDEWORK\lvmen\src\licensedcode\data\rules\gpl-2.0-plus_with_libtool-exception-2.0_7.yml", "YAML", 0, 0, 0, 7, 0, 0, 1, 8
"d:\IDEWORK\lvmen\src\licensedcode\data\rules\gpl-2.0-plus_with_libtool-exception-2.0_8.yml", "YAML", 0, 0, 0, 2, 0, 0, 1, 3
"d:\IDEWORK\lvmen\src\licensedcode\data\rules\gpl-2.0-plus_with_libtool-exception-2.0_9.yml", "YAML", 0, 0, 0, 2, 0, 0, 1, 3
"d:\IDEWORK\lvmen\src\licensedcode\data\rules\gpl-2.0-plus_with_linking-exception-2.0-plus_1.yml", "YAML", 0, 0, 0, 4, 0, 0, 1, 5
"d:\IDEWORK\lvmen\src\licensedcode\data\rules\gpl-2.0-plus_with_linking-exception-2.0-plus_2.yml", "YAML", 0, 0, 0, 4, 0, 0, 1, 5
"d:\IDEWORK\lvmen\src\licensedcode\data\rules\gpl-2.0-plus_with_mif-exception_1.yml", "YAML", 0, 0, 0, 2, 0, 0, 1, 3
"d:\IDEWORK\lvmen\src\licensedcode\data\rules\gpl-2.0-plus_with_mif-exception_10.yml", "YAML", 0, 0, 0, 3, 0, 0, 1, 4
"d:\IDEWORK\lvmen\src\licensedcode\data\rules\gpl-2.0-plus_with_mif-exception_2.yml", "YAML", 0, 0, 0, 5, 0, 0, 1, 6
"d:\IDEWORK\lvmen\src\licensedcode\data\rules\gpl-2.0-plus_with_mif-exception_3.yml", "YAML", 0, 0, 0, 5, 0, 0, 1, 6
"d:\IDEWORK\lvmen\src\licensedcode\data\rules\gpl-2.0-plus_with_mif-exception_4.yml", "YAML", 0, 0, 0, 3, 0, 0, 1, 4
"d:\IDEWORK\lvmen\src\licensedcode\data\rules\gpl-2.0-plus_with_mif-exception_5.yml", "YAML", 0, 0, 0, 5, 0, 0, 1, 6
"d:\IDEWORK\lvmen\src\licensedcode\data\rules\gpl-2.0-plus_with_mif-exception_9.yml", "YAML", 0, 0, 0, 3, 0, 0, 1, 4
"d:\IDEWORK\lvmen\src\licensedcode\data\rules\gpl-2.0-plus_with_mif-exception_jjfs2_1.yml", "YAML", 0, 0, 0, 7, 0, 0, 1, 8
"d:\IDEWORK\lvmen\src\licensedcode\data\rules\gpl-2.0-plus_with_mif-exception_jjfs2_2.yml", "YAML", 0, 0, 0, 7, 0, 0, 1, 8
"d:\IDEWORK\lvmen\src\licensedcode\data\rules\gpl-2.0-plus_with_mif-exception_jjfs2_3.yml", "YAML", 0, 0, 0, 7, 0, 0, 1, 8
"d:\IDEWORK\lvmen\src\licensedcode\data\rules\gpl-2.0-plus_with_mif-exception_jjfs2_4.yml", "YAML", 0, 0, 0, 6, 0, 0, 1, 7
"d:\IDEWORK\lvmen\src\licensedcode\data\rules\gpl-2.0-plus_with_mysql-floss-exception-2.0_1.yml", "YAML", 0, 0, 0, 8, 0, 0, 1, 9
"d:\IDEWORK\lvmen\src\licensedcode\data\rules\gpl-2.0-plus_with_nant-exception-2.0-plus_1.yml", "YAML", 0, 0, 0, 7, 0, 0, 1, 8
"d:\IDEWORK\lvmen\src\licensedcode\data\rules\gpl-2.0-plus_with_nant-exception-2.0-plus_2.yml", "YAML", 0, 0, 0, 7, 0, 0, 1, 8
"d:\IDEWORK\lvmen\src\licensedcode\data\rules\gpl-2.0-plus_with_openjdk-exception.yml", "YAML", 0, 0, 0, 7, 0, 0, 1, 8
"d:\IDEWORK\lvmen\src\licensedcode\data\rules\gpl-2.0-plus_with_openjdk-exception_1.yml", "YAML", 0, 0, 0, 8, 0, 0, 1, 9
"d:\IDEWORK\lvmen\src\licensedcode\data\rules\gpl-2.0-plus_with_openssl-exception-gpl-2.0_1.yml", "YAML", 0, 0, 0, 3, 0, 0, 1, 4
"d:\IDEWORK\lvmen\src\licensedcode\data\rules\gpl-2.0-plus_with_openssl-exception-gpl-2.0_10.yml", "YAML", 0, 0, 0, 6, 0, 0, 1, 7
"d:\IDEWORK\lvmen\src\licensedcode\data\rules\gpl-2.0-plus_with_openssl-exception-gpl-2.0_11.yml", "YAML", 0, 0, 0, 3, 0, 0, 1, 4
"d:\IDEWORK\lvmen\src\licensedcode\data\rules\gpl-2.0-plus_with_openssl-exception-gpl-2.0_12.yml", "YAML", 0, 0, 0, 3, 0, 0, 1, 4
"d:\IDEWORK\lvmen\src\licensedcode\data\rules\gpl-2.0-plus_with_openssl-exception-gpl-2.0_2.yml", "YAML", 0, 0, 0, 3, 0, 0, 1, 4
"d:\IDEWORK\lvmen\src\licensedcode\data\rules\gpl-2.0-plus_with_openssl-exception-gpl-2.0_3.yml", "YAML", 0, 0, 0, 5, 0, 0, 1, 6
"d:\IDEWORK\lvmen\src\licensedcode\data\rules\gpl-2.0-plus_with_openssl-exception-gpl-2.0_4.yml", "YAML", 0, 0, 0, 3, 0, 0, 1, 4
"d:\IDEWORK\lvmen\src\licensedcode\data\rules\gpl-2.0-plus_with_openssl-exception-gpl-2.0_5.yml", "YAML", 0, 0, 0, 3, 0, 0, 1, 4
"d:\IDEWORK\lvmen\src\licensedcode\data\rules\gpl-2.0-plus_with_openssl-exception-gpl-2.0_6.yml", "YAML", 0, 0, 0, 3, 0, 0, 1, 4
"d:\IDEWORK\lvmen\src\licensedcode\data\rules\gpl-2.0-plus_with_openssl-exception-gpl-2.0_7.yml", "YAML", 0, 0, 0, 3, 0, 0, 1, 4
"d:\IDEWORK\lvmen\src\licensedcode\data\rules\gpl-2.0-plus_with_openssl-exception-gpl-2.0_8.yml", "YAML", 0, 0, 0, 3, 0, 0, 1, 4
"d:\IDEWORK\lvmen\src\licensedcode\data\rules\gpl-2.0-plus_with_openssl-exception-gpl-2.0_9.yml", "YAML", 0, 0, 0, 3, 0, 0, 1, 4
"d:\IDEWORK\lvmen\src\licensedcode\data\rules\gpl-2.0-plus_with_openssl-exception-gpl-2.0_and_lgpl-2.1-plus_and_other-permissive_1.yml", "YAML", 0, 0, 0, 3, 0, 0, 1, 4
"d:\IDEWORK\lvmen\src\licensedcode\data\rules\gpl-2.0-plus_with_openssl-exception-gpl-2.0_or_gsoap-1.3b_or_commercial-license_1.yml", "YAML", 0, 0, 0, 5, 0, 0, 1, 6
"d:\IDEWORK\lvmen\src\licensedcode\data\rules\gpl-2.0-plus_with_openssl-exception-gpl-3.0-plus_1.yml", "YAML", 0, 0, 0, 6, 0, 0, 1, 7
"d:\IDEWORK\lvmen\src\licensedcode\data\rules\gpl-2.0-plus_with_openssl-exception-gpl-3.0-plus_2.yml", "YAML", 0, 0, 0, 4, 0, 0, 1, 5
"d:\IDEWORK\lvmen\src\licensedcode\data\rules\gpl-2.0-plus_with_openssl-exception-gpl-3.0-plus_3.yml", "YAML", 0, 0, 0, 4, 0, 0, 1, 5
"d:\IDEWORK\lvmen\src\licensedcode\data\rules\gpl-2.0-plus_with_openssl-exception-gpl-3.0-plus_4.yml", "YAML", 0, 0, 0, 4, 0, 0, 1, 5
"d:\IDEWORK\lvmen\src\licensedcode\data\rules\gpl-2.0-plus_with_openssl-exception-gpl-3.0-plus_5.yml", "YAML", 0, 0, 0, 4, 0, 0, 1, 5
"d:\IDEWORK\lvmen\src\licensedcode\data\rules\gpl-2.0-plus_with_openssl-exception-gpl-3.0-plus_6.yml", "YAML", 0, 0, 0, 6, 0, 0, 1, 7
"d:\IDEWORK\lvmen\src\licensedcode\data\rules\gpl-2.0-plus_with_openssl-exception-gpl-3.0-plus_7.yml", "YAML", 0, 0, 0, 4, 0, 0, 1, 5
"d:\IDEWORK\lvmen\src\licensedcode\data\rules\gpl-2.0-plus_with_openssl-exception-gpl-3.0-plus_8.yml", "YAML", 0, 0, 0, 4, 0, 0, 1, 5
"d:\IDEWORK\lvmen\src\licensedcode\data\rules\gpl-2.0-plus_with_sane-exception-2.0-plus_1.yml", "YAML", 0, 0, 0, 3, 0, 0, 1, 4
"d:\IDEWORK\lvmen\src\licensedcode\data\rules\gpl-2.0-plus_with_subcommander-exception-2.0-plus_1.yml", "YAML", 0, 0, 0, 3, 0, 0, 1, 4
"d:\IDEWORK\lvmen\src\licensedcode\data\rules\gpl-2.0-plus_with_tex-exception_1.yml", "YAML", 0, 0, 0, 4, 0, 0, 1, 5
"d:\IDEWORK\lvmen\src\licensedcode\data\rules\gpl-2.0-plus_with_tex-exception_2.yml", "YAML", 0, 0, 0, 4, 0, 0, 1, 5
"d:\IDEWORK\lvmen\src\licensedcode\data\rules\gpl-2.0-plus_with_u-boot-exception-2.0_1.yml", "YAML", 0, 0, 0, 10, 0, 0, 1, 11
"d:\IDEWORK\lvmen\src\licensedcode\data\rules\gpl-2.0-plus_with_unlimited-linking-exception-gpl_1.yml", "YAML", 0, 0, 0, 4, 0, 0, 1, 5
"d:\IDEWORK\lvmen\src\licensedcode\data\rules\gpl-2.0-plus_with_upx-exception-2.0-plus_1.yml", "YAML", 0, 0, 0, 13, 0, 0, 1, 14
"d:\IDEWORK\lvmen\src\licensedcode\data\rules\gpl-2.0-plus_with_upx-exception-2.0-plus_2.yml", "YAML", 0, 0, 0, 18, 0, 0, 1, 19
"d:\IDEWORK\lvmen\src\licensedcode\data\rules\gpl-2.0-plus_with_upx-exception-2.0-plus_3.yml", "YAML", 0, 0, 0, 5, 0, 0, 1, 6
"d:\IDEWORK\lvmen\src\licensedcode\data\rules\gpl-2.0-plus_with_upx-exception-2.0-plus_4.yml", "YAML", 0, 0, 0, 16, 0, 0, 1, 17
"d:\IDEWORK\lvmen\src\licensedcode\data\rules\gpl-2.0-plus_xvid_1.yml", "YAML", 0, 0, 0, 4, 0, 0, 1, 5
"d:\IDEWORK\lvmen\src\licensedcode\data\rules\gpl-2.0-redhat.yml", "YAML", 0, 0, 0, 5, 0, 0, 1, 6
"d:\IDEWORK\lvmen\src\licensedcode\data\rules\gpl-2.0-rrdtool-floss.yml", "YAML", 0, 0, 0, 4, 0, 0, 1, 5
"d:\IDEWORK\lvmen\src\licensedcode\data\rules\gpl-2.0-rrdtool-floss_1.yml", "YAML", 0, 0, 0, 4, 0, 0, 1, 5
"d:\IDEWORK\lvmen\src\licensedcode\data\rules\gpl-2.0-uboot_2.yml", "YAML", 0, 0, 0, 3, 0, 0, 1, 4
"d:\IDEWORK\lvmen\src\licensedcode\data\rules\gpl-2.0-uboot_3.yml", "YAML", 0, 0, 0, 3, 0, 0, 1, 4
"d:\IDEWORK\lvmen\src\licensedcode\data\rules\gpl-2.0-uboot_4.yml", "YAML", 0, 0, 0, 2, 0, 0, 1, 3
"d:\IDEWORK\lvmen\src\licensedcode\data\rules\gpl-2.0.SPDX.yml", "YAML", 0, 0, 0, 10, 0, 0, 1, 11
"d:\IDEWORK\lvmen\src\licensedcode\data\rules\gpl-2.0.yml", "YAML", 0, 0, 0, 3, 0, 0, 1, 4
"d:\IDEWORK\lvmen\src\licensedcode\data\rules\gpl-2.0_0.yml", "YAML", 0, 0, 0, 3, 0, 0, 1, 4
"d:\IDEWORK\lvmen\src\licensedcode\data\rules\gpl-2.0_1.yml", "YAML", 0, 0, 0, 5, 0, 0, 1, 6
"d:\IDEWORK\lvmen\src\licensedcode\data\rules\gpl-2.0_10.yml", "YAML", 0, 0, 0, 5, 0, 0, 1, 6
"d:\IDEWORK\lvmen\src\licensedcode\data\rules\gpl-2.0_100.yml", "YAML", 0, 0, 0, 10, 0, 0, 1, 11
"d:\IDEWORK\lvmen\src\licensedcode\data\rules\gpl-2.0_1000.yml", "YAML", 0, 0, 0, 5, 0, 0, 1, 6
"d:\IDEWORK\lvmen\src\licensedcode\data\rules\gpl-2.0_1001.yml", "YAML", 0, 0, 0, 5, 0, 0, 1, 6
"d:\IDEWORK\lvmen\src\licensedcode\data\rules\gpl-2.0_1002.yml", "YAML", 0, 0, 0, 5, 0, 0, 1, 6
"d:\IDEWORK\lvmen\src\licensedcode\data\rules\gpl-2.0_1003.yml", "YAML", 0, 0, 0, 5, 0, 0, 1, 6
"d:\IDEWORK\lvmen\src\licensedcode\data\rules\gpl-2.0_1004.yml", "YAML", 0, 0, 0, 3, 0, 0, 1, 4
"d:\IDEWORK\lvmen\src\licensedcode\data\rules\gpl-2.0_1005.yml", "YAML", 0, 0, 0, 3, 0, 0, 1, 4
"d:\IDEWORK\lvmen\src\licensedcode\data\rules\gpl-2.0_1006.yml", "YAML", 0, 0, 0, 3, 0, 0, 1, 4
"d:\IDEWORK\lvmen\src\licensedcode\data\rules\gpl-2.0_1007.yml", "YAML", 0, 0, 0, 3, 0, 0, 1, 4
"d:\IDEWORK\lvmen\src\licensedcode\data\rules\gpl-2.0_1008.yml", "YAML", 0, 0, 0, 4, 0, 0, 1, 5
"d:\IDEWORK\lvmen\src\licensedcode\data\rules\gpl-2.0_1009.yml", "YAML", 0, 0, 0, 3, 0, 0, 1, 4
"d:\IDEWORK\lvmen\src\licensedcode\data\rules\gpl-2.0_101.yml", "YAML", 0, 0, 0, 20, 0, 0, 1, 21
"d:\IDEWORK\lvmen\src\licensedcode\data\rules\gpl-2.0_1010.yml", "YAML", 0, 0, 0, 4, 0, 0, 1, 5
"d:\IDEWORK\lvmen\src\licensedcode\data\rules\gpl-2.0_1011.yml", "YAML", 0, 0, 0, 4, 0, 0, 1, 5
"d:\IDEWORK\lvmen\src\licensedcode\data\rules\gpl-2.0_1012.yml", "YAML", 0, 0, 0, 8, 0, 0, 1, 9
"d:\IDEWORK\lvmen\src\licensedcode\data\rules\gpl-2.0_1013.yml", "YAML", 0, 0, 0, 4, 0, 0, 1, 5
"d:\IDEWORK\lvmen\src\licensedcode\data\rules\gpl-2.0_1014.yml", "YAML", 0, 0, 0, 3, 0, 0, 1, 4
"d:\IDEWORK\lvmen\src\licensedcode\data\rules\gpl-2.0_1015.yml", "YAML", 0, 0, 0, 3, 0, 0, 1, 4
"d:\IDEWORK\lvmen\src\licensedcode\data\rules\gpl-2.0_1016.yml", "YAML", 0, 0, 0, 3, 0, 0, 1, 4
"d:\IDEWORK\lvmen\src\licensedcode\data\rules\gpl-2.0_1017.yml", "YAML", 0, 0, 0, 3, 0, 0, 1, 4
"d:\IDEWORK\lvmen\src\licensedcode\data\rules\gpl-2.0_1018.yml", "YAML", 0, 0, 0, 10, 0, 0, 1, 11
"d:\IDEWORK\lvmen\src\licensedcode\data\rules\gpl-2.0_1019.yml", "YAML", 0, 0, 0, 10, 0, 0, 1, 11
"d:\IDEWORK\lvmen\src\licensedcode\data\rules\gpl-2.0_102.yml", "YAML", 0, 0, 0, 21, 0, 0, 1, 22
"d:\IDEWORK\lvmen\src\licensedcode\data\rules\gpl-2.0_1020.yml", "YAML", 0, 0, 0, 12, 0, 0, 1, 13
"d:\IDEWORK\lvmen\src\licensedcode\data\rules\gpl-2.0_1021.yml", "YAML", 0, 0, 0, 10, 0, 0, 1, 11
"d:\IDEWORK\lvmen\src\licensedcode\data\rules\gpl-2.0_1022.yml", "YAML", 0, 0, 0, 10, 0, 0, 1, 11
"d:\IDEWORK\lvmen\src\licensedcode\data\rules\gpl-2.0_1023.yml", "YAML", 0, 0, 0, 4, 0, 0, 1, 5
"d:\IDEWORK\lvmen\src\licensedcode\data\rules\gpl-2.0_1024.yml", "YAML", 0, 0, 0, 4, 0, 0, 1, 5
"d:\IDEWORK\lvmen\src\licensedcode\data\rules\gpl-2.0_1025.yml", "YAML", 0, 0, 0, 4, 0, 0, 1, 5
"d:\IDEWORK\lvmen\src\licensedcode\data\rules\gpl-2.0_1026.yml", "YAML", 0, 0, 0, 4, 0, 0, 1, 5
"d:\IDEWORK\lvmen\src\licensedcode\data\rules\gpl-2.0_1027.yml", "YAML", 0, 0, 0, 6, 0, 0, 1, 7
"d:\IDEWORK\lvmen\src\licensedcode\data\rules\gpl-2.0_1028.yml", "YAML", 0, 0, 0, 5, 0, 0, 1, 6
"d:\IDEWORK\lvmen\src\licensedcode\data\rules\gpl-2.0_1029.yml", "YAML", 0, 0, 0, 10, 0, 0, 1, 11
"d:\IDEWORK\lvmen\src\licensedcode\data\rules\gpl-2.0_103.yml", "YAML", 0, 0, 0, 10, 0, 0, 1, 11
"d:\IDEWORK\lvmen\src\licensedcode\data\rules\gpl-2.0_1030.yml", "YAML", 0, 0, 0, 6, 0, 0, 1, 7
"d:\IDEWORK\lvmen\src\licensedcode\data\rules\gpl-2.0_1031.yml", "YAML", 0, 0, 0, 6, 0, 0, 1, 7
"d:\IDEWORK\lvmen\src\licensedcode\data\rules\gpl-2.0_1032.yml", "YAML", 0, 0, 0, 5, 0, 0, 1, 6
"d:\IDEWORK\lvmen\src\licensedcode\data\rules\gpl-2.0_1033.yml", "YAML", 0, 0, 0, 5, 0, 0, 1, 6
"d:\IDEWORK\lvmen\src\licensedcode\data\rules\gpl-2.0_1034.yml", "YAML", 0, 0, 0, 4, 0, 0, 1, 5
"d:\IDEWORK\lvmen\src\licensedcode\data\rules\gpl-2.0_1035.yml", "YAML", 0, 0, 0, 10, 0, 0, 1, 11
"d:\IDEWORK\lvmen\src\licensedcode\data\rules\gpl-2.0_1036.yml", "YAML", 0, 0, 0, 6, 0, 0, 1, 7
"d:\IDEWORK\lvmen\src\licensedcode\data\rules\gpl-2.0_1037.yml", "YAML", 0, 0, 0, 6, 0, 0, 1, 7
"d:\IDEWORK\lvmen\src\licensedcode\data\rules\gpl-2.0_1038.yml", "YAML", 0, 0, 0, 4, 0, 0, 1, 5
"d:\IDEWORK\lvmen\src\licensedcode\data\rules\gpl-2.0_1039.yml", "YAML", 0, 0, 0, 5, 0, 0, 1, 6
"d:\IDEWORK\lvmen\src\licensedcode\data\rules\gpl-2.0_104.yml", "YAML", 0, 0, 0, 3, 0, 0, 1, 4
"d:\IDEWORK\lvmen\src\licensedcode\data\rules\gpl-2.0_1040.yml", "YAML", 0, 0, 0, 3, 0, 0, 1, 4
"d:\IDEWORK\lvmen\src\licensedcode\data\rules\gpl-2.0_1041.yml", "YAML", 0, 0, 0, 3, 0, 0, 1, 4
"d:\IDEWORK\lvmen\src\licensedcode\data\rules\gpl-2.0_1042.yml", "YAML", 0, 0, 0, 3, 0, 0, 1, 4
"d:\IDEWORK\lvmen\src\licensedcode\data\rules\gpl-2.0_1043.yml", "YAML", 0, 0, 0, 3, 0, 0, 1, 4
"d:\IDEWORK\lvmen\src\licensedcode\data\rules\gpl-2.0_1044.yml", "YAML", 0, 0, 0, 5, 0, 0, 1, 6
"d:\IDEWORK\lvmen\src\licensedcode\data\rules\gpl-2.0_1045.yml", "YAML", 0, 0, 0, 3, 0, 0, 1, 4
"d:\IDEWORK\lvmen\src\licensedcode\data\rules\gpl-2.0_1046.yml", "YAML", 0, 0, 0, 5, 0, 0, 1, 6
"d:\IDEWORK\lvmen\src\licensedcode\data\rules\gpl-2.0_1047.yml", "YAML", 0, 0, 0, 3, 0, 0, 1, 4
"d:\IDEWORK\lvmen\src\licensedcode\data\rules\gpl-2.0_1048.yml", "YAML", 0, 0, 0, 3, 0, 0, 1, 4
"d:\IDEWORK\lvmen\src\licensedcode\data\rules\gpl-2.0_1049.yml", "YAML", 0, 0, 0, 3, 0, 0, 1, 4
"d:\IDEWORK\lvmen\src\licensedcode\data\rules\gpl-2.0_105.yml", "YAML", 0, 0, 0, 3, 0, 0, 1, 4
"d:\IDEWORK\lvmen\src\licensedcode\data\rules\gpl-2.0_1050.yml", "YAML", 0, 0, 0, 3, 0, 0, 1, 4
"d:\IDEWORK\lvmen\src\licensedcode\data\rules\gpl-2.0_1051.yml", "YAML", 0, 0, 0, 3, 0, 0, 1, 4
"d:\IDEWORK\lvmen\src\licensedcode\data\rules\gpl-2.0_1052.yml", "YAML", 0, 0, 0, 3, 0, 0, 1, 4
"d:\IDEWORK\lvmen\src\licensedcode\data\rules\gpl-2.0_1053.yml", "YAML", 0, 0, 0, 10, 0, 0, 1, 11
"d:\IDEWORK\lvmen\src\licensedcode\data\rules\gpl-2.0_1054.yml", "YAML", 0, 0, 0, 9, 0, 0, 1, 10
"d:\IDEWORK\lvmen\src\licensedcode\data\rules\gpl-2.0_1055.yml", "YAML", 0, 0, 0, 3, 0, 0, 1, 4
"d:\IDEWORK\lvmen\src\licensedcode\data\rules\gpl-2.0_1056.yml", "YAML", 0, 0, 0, 3, 0, 0, 1, 4
"d:\IDEWORK\lvmen\src\licensedcode\data\rules\gpl-2.0_1057.yml", "YAML", 0, 0, 0, 5, 0, 0, 1, 6
"d:\IDEWORK\lvmen\src\licensedcode\data\rules\gpl-2.0_1058.yml", "YAML", 0, 0, 0, 3, 0, 0, 1, 4
"d:\IDEWORK\lvmen\src\licensedcode\data\rules\gpl-2.0_1059.yml", "YAML", 0, 0, 0, 3, 0, 0, 1, 4
"d:\IDEWORK\lvmen\src\licensedcode\data\rules\gpl-2.0_106.yml", "YAML", 0, 0, 0, 3, 0, 0, 1, 4
"d:\IDEWORK\lvmen\src\licensedcode\data\rules\gpl-2.0_1060.yml", "YAML", 0, 0, 0, 3, 0, 0, 1, 4
"d:\IDEWORK\lvmen\src\licensedcode\data\rules\gpl-2.0_1061.yml", "YAML", 0, 0, 0, 3, 0, 0, 1, 4
"d:\IDEWORK\lvmen\src\licensedcode\data\rules\gpl-2.0_1062.yml", "YAML", 0, 0, 0, 3, 0, 0, 1, 4
"d:\IDEWORK\lvmen\src\licensedcode\data\rules\gpl-2.0_1063.yml", "YAML", 0, 0, 0, 3, 0, 0, 1, 4
"d:\IDEWORK\lvmen\src\licensedcode\data\rules\gpl-2.0_1064.yml", "YAML", 0, 0, 0, 3, 0, 0, 1, 4
"d:\IDEWORK\lvmen\src\licensedcode\data\rules\gpl-2.0_1065.yml", "YAML", 0, 0, 0, 3, 0, 0, 1, 4
"d:\IDEWORK\lvmen\src\licensedcode\data\rules\gpl-2.0_1066.yml", "YAML", 0, 0, 0, 3, 0, 0, 1, 4
"d:\IDEWORK\lvmen\src\licensedcode\data\rules\gpl-2.0_1067.yml", "YAML", 0, 0, 0, 3, 0, 0, 1, 4
"d:\IDEWORK\lvmen\src\licensedcode\data\rules\gpl-2.0_1068.yml", "YAML", 0, 0, 0, 3, 0, 0, 1, 4
"d:\IDEWORK\lvmen\src\licensedcode\data\rules\gpl-2.0_1069.yml", "YAML", 0, 0, 0, 3, 0, 0, 1, 4
"d:\IDEWORK\lvmen\src\licensedcode\data\rules\gpl-2.0_107.yml", "YAML", 0, 0, 0, 13, 0, 0, 1, 14
"d:\IDEWORK\lvmen\src\licensedcode\data\rules\gpl-2.0_1070.yml", "YAML", 0, 0, 0, 3, 0, 0, 1, 4
"d:\IDEWORK\lvmen\src\licensedcode\data\rules\gpl-2.0_1071.yml", "YAML", 0, 0, 0, 3, 0, 0, 1, 4
"d:\IDEWORK\lvmen\src\licensedcode\data\rules\gpl-2.0_1072.yml", "YAML", 0, 0, 0, 3, 0, 0, 1, 4
"d:\IDEWORK\lvmen\src\licensedcode\data\rules\gpl-2.0_1073.yml", "YAML", 0, 0, 0, 3, 0, 0, 1, 4
"d:\IDEWORK\lvmen\src\licensedcode\data\rules\gpl-2.0_1074.yml", "YAML", 0, 0, 0, 3, 0, 0, 1, 4
"d:\IDEWORK\lvmen\src\licensedcode\data\rules\gpl-2.0_1075.yml", "YAML", 0, 0, 0, 3, 0, 0, 1, 4
"d:\IDEWORK\lvmen\src\licensedcode\data\rules\gpl-2.0_1076.yml", "YAML", 0, 0, 0, 3, 0, 0, 1, 4
"d:\IDEWORK\lvmen\src\licensedcode\data\rules\gpl-2.0_1077.yml", "YAML", 0, 0, 0, 3, 0, 0, 1, 4
"d:\IDEWORK\lvmen\src\licensedcode\data\rules\gpl-2.0_1078.yml", "YAML", 0, 0, 0, 3, 0, 0, 1, 4
"d:\IDEWORK\lvmen\src\licensedcode\data\rules\gpl-2.0_1079.yml", "YAML", 0, 0, 0, 3, 0, 0, 1, 4
"d:\IDEWORK\lvmen\src\licensedcode\data\rules\gpl-2.0_108.yml", "YAML", 0, 0, 0, 4, 0, 0, 1, 5
"d:\IDEWORK\lvmen\src\licensedcode\data\rules\gpl-2.0_1080.yml", "YAML", 0, 0, 0, 3, 0, 0, 1, 4
"d:\IDEWORK\lvmen\src\licensedcode\data\rules\gpl-2.0_1081.yml", "YAML", 0, 0, 0, 3, 0, 0, 1, 4
"d:\IDEWORK\lvmen\src\licensedcode\data\rules\gpl-2.0_1082.yml", "YAML", 0, 0, 0, 3, 0, 0, 1, 4
"d:\IDEWORK\lvmen\src\licensedcode\data\rules\gpl-2.0_1083.yml", "YAML", 0, 0, 0, 3, 0, 0, 1, 4
"d:\IDEWORK\lvmen\src\licensedcode\data\rules\gpl-2.0_1084.yml", "YAML", 0, 0, 0, 3, 0, 0, 1, 4
"d:\IDEWORK\lvmen\src\licensedcode\data\rules\gpl-2.0_1085.yml", "YAML", 0, 0, 0, 3, 0, 0, 1, 4
"d:\IDEWORK\lvmen\src\licensedcode\data\rules\gpl-2.0_1086.yml", "YAML", 0, 0, 0, 3, 0, 0, 1, 4
"d:\IDEWORK\lvmen\src\licensedcode\data\rules\gpl-2.0_1087.yml", "YAML", 0, 0, 0, 3, 0, 0, 1, 4
"d:\IDEWORK\lvmen\src\licensedcode\data\rules\gpl-2.0_1088.yml", "YAML", 0, 0, 0, 5, 0, 0, 1, 6
"d:\IDEWORK\lvmen\src\licensedcode\data\rules\gpl-2.0_1089.yml", "YAML", 0, 0, 0, 3, 0, 0, 1, 4
"d:\IDEWORK\lvmen\src\licensedcode\data\rules\gpl-2.0_109.yml", "YAML", 0, 0, 0, 5, 0, 0, 1, 6
"d:\IDEWORK\lvmen\src\licensedcode\data\rules\gpl-2.0_1090.yml", "YAML", 0, 0, 0, 5, 0, 0, 1, 6
"d:\IDEWORK\lvmen\src\licensedcode\data\rules\gpl-2.0_1091.yml", "YAML", 0, 0, 0, 5, 0, 0, 1, 6
"d:\IDEWORK\lvmen\src\licensedcode\data\rules\gpl-2.0_1092.yml", "YAML", 0, 0, 0, 5, 0, 0, 1, 6
"d:\IDEWORK\lvmen\src\licensedcode\data\rules\gpl-2.0_1093.yml", "YAML", 0, 0, 0, 4, 0, 0, 1, 5
"d:\IDEWORK\lvmen\src\licensedcode\data\rules\gpl-2.0_1094.yml", "YAML", 0, 0, 0, 5, 0, 0, 1, 6
"d:\IDEWORK\lvmen\src\licensedcode\data\rules\gpl-2.0_1095.yml", "YAML", 0, 0, 0, 4, 0, 0, 1, 5
"d:\IDEWORK\lvmen\src\licensedcode\data\rules\gpl-2.0_1096.yml", "YAML", 0, 0, 0, 5, 0, 0, 1, 6
"d:\IDEWORK\lvmen\src\licensedcode\data\rules\gpl-2.0_1097.yml", "YAML", 0, 0, 0, 5, 0, 0, 1, 6
"d:\IDEWORK\lvmen\src\licensedcode\data\rules\gpl-2.0_1098.yml", "YAML", 0, 0, 0, 5, 0, 0, 1, 6
"d:\IDEWORK\lvmen\src\licensedcode\data\rules\gpl-2.0_1099.yml", "YAML", 0, 0, 0, 5, 0, 0, 1, 6
"d:\IDEWORK\lvmen\src\licensedcode\data\rules\gpl-2.0_11.yml", "YAML", 0, 0, 0, 2, 0, 0, 1, 3
"d:\IDEWORK\lvmen\src\licensedcode\data\rules\gpl-2.0_110.yml", "YAML", 0, 0, 0, 3, 0, 0, 1, 4
"d:\IDEWORK\lvmen\src\licensedcode\data\rules\gpl-2.0_1100.yml", "YAML", 0, 0, 0, 8, 0, 0, 1, 9
"d:\IDEWORK\lvmen\src\licensedcode\data\rules\gpl-2.0_1101.yml", "YAML", 0, 0, 0, 8, 0, 0, 1, 9
"d:\IDEWORK\lvmen\src\licensedcode\data\rules\gpl-2.0_1102.yml", "YAML", 0, 0, 0, 7, 0, 0, 1, 8
"d:\IDEWORK\lvmen\src\licensedcode\data\rules\gpl-2.0_1103.yml", "YAML", 0, 0, 0, 3, 0, 0, 1, 4
"d:\IDEWORK\lvmen\src\licensedcode\data\rules\gpl-2.0_1104.yml", "YAML", 0, 0, 0, 5, 0, 0, 1, 6
"d:\IDEWORK\lvmen\src\licensedcode\data\rules\gpl-2.0_1105.yml", "YAML", 0, 0, 0, 3, 0, 0, 1, 4
"d:\IDEWORK\lvmen\src\licensedcode\data\rules\gpl-2.0_1106.yml", "YAML", 0, 0, 0, 3, 0, 0, 1, 4
"d:\IDEWORK\lvmen\src\licensedcode\data\rules\gpl-2.0_1107.yml", "YAML", 0, 0, 0, 3, 0, 0, 1, 4
"d:\IDEWORK\lvmen\src\licensedcode\data\rules\gpl-2.0_1108.yml", "YAML", 0, 0, 0, 3, 0, 0, 1, 4
"d:\IDEWORK\lvmen\src\licensedcode\data\rules\gpl-2.0_1109.yml", "YAML", 0, 0, 0, 3, 0, 0, 1, 4
"d:\IDEWORK\lvmen\src\licensedcode\data\rules\gpl-2.0_111.yml", "YAML", 0, 0, 0, 8, 0, 0, 1, 9
"d:\IDEWORK\lvmen\src\licensedcode\data\rules\gpl-2.0_1110.yml", "YAML", 0, 0, 0, 3, 0, 0, 1, 4
"d:\IDEWORK\lvmen\src\licensedcode\data\rules\gpl-2.0_1111.yml", "YAML", 0, 0, 0, 3, 0, 0, 1, 4
"d:\IDEWORK\lvmen\src\licensedcode\data\rules\gpl-2.0_1112.yml", "YAML", 0, 0, 0, 3, 0, 0, 1, 4
"d:\IDEWORK\lvmen\src\licensedcode\data\rules\gpl-2.0_1113.yml", "YAML", 0, 0, 0, 3, 0, 0, 1, 4
"d:\IDEWORK\lvmen\src\licensedcode\data\rules\gpl-2.0_1114.yml", "YAML", 0, 0, 0, 3, 0, 0, 1, 4
"d:\IDEWORK\lvmen\src\licensedcode\data\rules\gpl-2.0_1115.yml", "YAML", 0, 0, 0, 3, 0, 0, 1, 4
"d:\IDEWORK\lvmen\src\licensedcode\data\rules\gpl-2.0_1116.yml", "YAML", 0, 0, 0, 3, 0, 0, 1, 4
"d:\IDEWORK\lvmen\src\licensedcode\data\rules\gpl-2.0_1117.yml", "YAML", 0, 0, 0, 5, 0, 0, 1, 6
"d:\IDEWORK\lvmen\src\licensedcode\data\rules\gpl-2.0_1118.yml", "YAML", 0, 0, 0, 3, 0, 0, 1, 4
"d:\IDEWORK\lvmen\src\licensedcode\data\rules\gpl-2.0_1119.yml", "YAML", 0, 0, 0, 4, 0, 0, 1, 5
"d:\IDEWORK\lvmen\src\licensedcode\data\rules\gpl-2.0_112.yml", "YAML", 0, 0, 0, 4, 0, 0, 1, 5
"d:\IDEWORK\lvmen\src\licensedcode\data\rules\gpl-2.0_1120.yml", "YAML", 0, 0, 0, 5, 0, 0, 1, 6
"d:\IDEWORK\lvmen\src\licensedcode\data\rules\gpl-2.0_1121.yml", "YAML", 0, 0, 0, 3, 0, 0, 1, 4
"d:\IDEWORK\lvmen\src\licensedcode\data\rules\gpl-2.0_1122.yml", "YAML", 0, 0, 0, 6, 0, 0, 1, 7
"d:\IDEWORK\lvmen\src\licensedcode\data\rules\gpl-2.0_1123.yml", "YAML", 0, 0, 0, 6, 0, 0, 0, 6
"d:\IDEWORK\lvmen\src\licensedcode\data\rules\gpl-2.0_1124.yml", "YAML", 0, 0, 0, 5, 0, 0, 1, 6
"d:\IDEWORK\lvmen\src\licensedcode\data\rules\gpl-2.0_1125.yml", "YAML", 0, 0, 0, 5, 0, 0, 1, 6
"d:\IDEWORK\lvmen\src\licensedcode\data\rules\gpl-2.0_1126.yml", "YAML", 0, 0, 0, 3, 0, 0, 1, 4
"d:\IDEWORK\lvmen\src\licensedcode\data\rules\gpl-2.0_1127.yml", "YAML", 0, 0, 0, 3, 0, 0, 1, 4
"d:\IDEWORK\lvmen\src\licensedcode\data\rules\gpl-2.0_1128.yml", "YAML", 0, 0, 0, 3, 0, 0, 1, 4
"d:\IDEWORK\lvmen\src\licensedcode\data\rules\gpl-2.0_1129.yml", "YAML", 0, 0, 0, 4, 0, 0, 1, 5
"d:\IDEWORK\lvmen\src\licensedcode\data\rules\gpl-2.0_113.yml", "YAML", 0, 0, 0, 2, 0, 0, 1, 3
"d:\IDEWORK\lvmen\src\licensedcode\data\rules\gpl-2.0_1130.yml", "YAML", 0, 0, 0, 10, 0, 0, 2, 12
"d:\IDEWORK\lvmen\src\licensedcode\data\rules\gpl-2.0_1131.yml", "YAML", 0, 0, 0, 3, 0, 0, 1, 4
"d:\IDEWORK\lvmen\src\licensedcode\data\rules\gpl-2.0_1132.yml", "YAML", 0, 0, 0, 3, 0, 0, 1, 4
"d:\IDEWORK\lvmen\src\licensedcode\data\rules\gpl-2.0_1133.yml", "YAML", 0, 0, 0, 3, 0, 0, 1, 4
"d:\IDEWORK\lvmen\src\licensedcode\data\rules\gpl-2.0_1134.yml", "YAML", 0, 0, 0, 3, 0, 0, 1, 4
"d:\IDEWORK\lvmen\src\licensedcode\data\rules\gpl-2.0_1135.yml", "YAML", 0, 0, 0, 3, 0, 0, 1, 4
"d:\IDEWORK\lvmen\src\licensedcode\data\rules\gpl-2.0_1136.yml", "YAML", 0, 0, 0, 3, 0, 0, 1, 4
"d:\IDEWORK\lvmen\src\licensedcode\data\rules\gpl-2.0_1137.yml", "YAML", 0, 0, 0, 3, 0, 0, 1, 4
"d:\IDEWORK\lvmen\src\licensedcode\data\rules\gpl-2.0_1138.yml", "YAML", 0, 0, 0, 4, 0, 0, 1, 5
"d:\IDEWORK\lvmen\src\licensedcode\data\rules\gpl-2.0_1139.yml", "YAML", 0, 0, 0, 4, 0, 0, 1, 5
"d:\IDEWORK\lvmen\src\licensedcode\data\rules\gpl-2.0_114.yml", "YAML", 0, 0, 0, 3, 0, 0, 1, 4
"d:\IDEWORK\lvmen\src\licensedcode\data\rules\gpl-2.0_1140.yml", "YAML", 0, 0, 0, 4, 0, 0, 1, 5
"d:\IDEWORK\lvmen\src\licensedcode\data\rules\gpl-2.0_1141.yml", "YAML", 0, 0, 0, 4, 0, 0, 1, 5
"d:\IDEWORK\lvmen\src\licensedcode\data\rules\gpl-2.0_1142.yml", "YAML", 0, 0, 0, 3, 0, 0, 1, 4
"d:\IDEWORK\lvmen\src\licensedcode\data\rules\gpl-2.0_1143.yml", "YAML", 0, 0, 0, 2, 0, 0, 1, 3
"d:\IDEWORK\lvmen\src\licensedcode\data\rules\gpl-2.0_1144.yml", "YAML", 0, 0, 0, 4, 0, 0, 1, 5
"d:\IDEWORK\lvmen\src\licensedcode\data\rules\gpl-2.0_1145.yml", "YAML", 0, 0, 0, 4, 0, 0, 1, 5
"d:\IDEWORK\lvmen\src\licensedcode\data\rules\gpl-2.0_1146.yml", "YAML", 0, 0, 0, 4, 0, 0, 1, 5
"d:\IDEWORK\lvmen\src\licensedcode\data\rules\gpl-2.0_1147.yml", "YAML", 0, 0, 0, 5, 0, 0, 1, 6
"d:\IDEWORK\lvmen\src\licensedcode\data\rules\gpl-2.0_1148.yml", "YAML", 0, 0, 0, 4, 0, 0, 1, 5
"d:\IDEWORK\lvmen\src\licensedcode\data\rules\gpl-2.0_1149.yml", "YAML", 0, 0, 0, 6, 0, 0, 1, 7
"d:\IDEWORK\lvmen\src\licensedcode\data\rules\gpl-2.0_115.yml", "YAML", 0, 0, 0, 3, 0, 0, 1, 4
"d:\IDEWORK\lvmen\src\licensedcode\data\rules\gpl-2.0_1150.yml", "YAML", 0, 0, 0, 3, 0, 0, 1, 4
"d:\IDEWORK\lvmen\src\licensedcode\data\rules\gpl-2.0_1151.yml", "YAML", 0, 0, 0, 4, 0, 0, 1, 5
"d:\IDEWORK\lvmen\src\licensedcode\data\rules\gpl-2.0_1152.yml", "YAML", 0, 0, 0, 4, 0, 0, 1, 5
"d:\IDEWORK\lvmen\src\licensedcode\data\rules\gpl-2.0_1153.yml", "YAML", 0, 0, 0, 6, 0, 0, 1, 7
"d:\IDEWORK\lvmen\src\licensedcode\data\rules\gpl-2.0_1154.yml", "YAML", 0, 0, 0, 4, 0, 0, 1, 5
"d:\IDEWORK\lvmen\src\licensedcode\data\rules\gpl-2.0_1155.yml", "YAML", 0, 0, 0, 4, 0, 0, 1, 5
"d:\IDEWORK\lvmen\src\licensedcode\data\rules\gpl-2.0_1156.yml", "YAML", 0, 0, 0, 3, 0, 0, 1, 4
"d:\IDEWORK\lvmen\src\licensedcode\data\rules\gpl-2.0_1157.yml", "YAML", 0, 0, 0, 4, 0, 0, 1, 5
"d:\IDEWORK\lvmen\src\licensedcode\data\rules\gpl-2.0_1158.yml", "YAML", 0, 0, 0, 4, 0, 0, 1, 5
"d:\IDEWORK\lvmen\src\licensedcode\data\rules\gpl-2.0_1159.yml", "YAML", 0, 0, 0, 4, 0, 0, 1, 5
"d:\IDEWORK\lvmen\src\licensedcode\data\rules\gpl-2.0_116.yml", "YAML", 0, 0, 0, 3, 0, 0, 1, 4
"d:\IDEWORK\lvmen\src\licensedcode\data\rules\gpl-2.0_1160.yml", "YAML", 0, 0, 0, 4, 0, 0, 1, 5
"d:\IDEWORK\lvmen\src\licensedcode\data\rules\gpl-2.0_1161.yml", "YAML", 0, 0, 0, 2, 0, 0, 1, 3
"d:\IDEWORK\lvmen\src\licensedcode\data\rules\gpl-2.0_1162.yml", "YAML", 0, 0, 0, 4, 0, 0, 1, 5
"d:\IDEWORK\lvmen\src\licensedcode\data\rules\gpl-2.0_1163.yml", "YAML", 0, 0, 0, 4, 0, 0, 1, 5
"d:\IDEWORK\lvmen\src\licensedcode\data\rules\gpl-2.0_1164.yml", "YAML", 0, 0, 0, 4, 0, 0, 1, 5
"d:\IDEWORK\lvmen\src\licensedcode\data\rules\gpl-2.0_1165.yml", "YAML", 0, 0, 0, 4, 0, 0, 1, 5
"d:\IDEWORK\lvmen\src\licensedcode\data\rules\gpl-2.0_1166.yml", "YAML", 0, 0, 0, 4, 0, 0, 1, 5
"d:\IDEWORK\lvmen\src\licensedcode\data\rules\gpl-2.0_1167.yml", "YAML", 0, 0, 0, 2, 0, 0, 1, 3
"d:\IDEWORK\lvmen\src\licensedcode\data\rules\gpl-2.0_1168.yml", "YAML", 0, 0, 0, 5, 0, 0, 1, 6
"d:\IDEWORK\lvmen\src\licensedcode\data\rules\gpl-2.0_1169.yml", "YAML", 0, 0, 0, 3, 0, 0, 1, 4
"d:\IDEWORK\lvmen\src\licensedcode\data\rules\gpl-2.0_117.yml", "YAML", 0, 0, 0, 5, 0, 0, 1, 6
"d:\IDEWORK\lvmen\src\licensedcode\data\rules\gpl-2.0_1170.yml", "YAML", 0, 0, 0, 7, 0, 0, 1, 8
"d:\IDEWORK\lvmen\src\licensedcode\data\rules\gpl-2.0_1171.yml", "YAML", 0, 0, 0, 5, 0, 0, 1, 6
"d:\IDEWORK\lvmen\src\licensedcode\data\rules\gpl-2.0_1172.yml", "YAML", 0, 0, 0, 5, 0, 0, 1, 6
"d:\IDEWORK\lvmen\src\licensedcode\data\rules\gpl-2.0_1173.yml", "YAML", 0, 0, 0, 6, 0, 0, 1, 7
"d:\IDEWORK\lvmen\src\licensedcode\data\rules\gpl-2.0_1174.yml", "YAML", 0, 0, 0, 3, 0, 0, 1, 4
"d:\IDEWORK\lvmen\src\licensedcode\data\rules\gpl-2.0_1175.yml", "YAML", 0, 0, 0, 5, 0, 0, 1, 6
"d:\IDEWORK\lvmen\src\licensedcode\data\rules\gpl-2.0_1176.yml", "YAML", 0, 0, 0, 3, 0, 0, 1, 4
"d:\IDEWORK\lvmen\src\licensedcode\data\rules\gpl-2.0_1177.yml", "YAML", 0, 0, 0, 3, 0, 0, 1, 4
"d:\IDEWORK\lvmen\src\licensedcode\data\rules\gpl-2.0_1178.yml", "YAML", 0, 0, 0, 5, 0, 0, 1, 6
"d:\IDEWORK\lvmen\src\licensedcode\data\rules\gpl-2.0_1179.yml", "YAML", 0, 0, 0, 5, 0, 0, 1, 6
"d:\IDEWORK\lvmen\src\licensedcode\data\rules\gpl-2.0_118.yml", "YAML", 0, 0, 0, 3, 0, 0, 1, 4
"d:\IDEWORK\lvmen\src\licensedcode\data\rules\gpl-2.0_1180.yml", "YAML", 0, 0, 0, 3, 0, 0, 1, 4
"d:\IDEWORK\lvmen\src\licensedcode\data\rules\gpl-2.0_1181.yml", "YAML", 0, 0, 0, 5, 0, 0, 1, 6
"d:\IDEWORK\lvmen\src\licensedcode\data\rules\gpl-2.0_1182.yml", "YAML", 0, 0, 0, 3, 0, 0, 1, 4
"d:\IDEWORK\lvmen\src\licensedcode\data\rules\gpl-2.0_1183.yml", "YAML", 0, 0, 0, 6, 0, 0, 1, 7
"d:\IDEWORK\lvmen\src\licensedcode\data\rules\gpl-2.0_1184.yml", "YAML", 0, 0, 0, 5, 0, 0, 1, 6
"d:\IDEWORK\lvmen\src\licensedcode\data\rules\gpl-2.0_1185.yml", "YAML", 0, 0, 0, 5, 0, 0, 1, 6
"d:\IDEWORK\lvmen\src\licensedcode\data\rules\gpl-2.0_1186.yml", "YAML", 0, 0, 0, 5, 0, 0, 1, 6
"d:\IDEWORK\lvmen\src\licensedcode\data\rules\gpl-2.0_1187.yml", "YAML", 0, 0, 0, 9, 0, 0, 1, 10
"d:\IDEWORK\lvmen\src\licensedcode\data\rules\gpl-2.0_1188.yml", "YAML", 0, 0, 0, 4, 0, 0, 1, 5
"d:\IDEWORK\lvmen\src\licensedcode\data\rules\gpl-2.0_1189.yml", "YAML", 0, 0, 0, 4, 0, 0, 1, 5
"d:\IDEWORK\lvmen\src\licensedcode\data\rules\gpl-2.0_119.yml", "YAML", 0, 0, 0, 4, 0, 0, 1, 5
"d:\IDEWORK\lvmen\src\licensedcode\data\rules\gpl-2.0_1190.yml", "YAML", 0, 0, 0, 5, 0, 0, 1, 6
"d:\IDEWORK\lvmen\src\licensedcode\data\rules\gpl-2.0_1191.yml", "YAML", 0, 0, 0, 5, 0, 0, 1, 6
"d:\IDEWORK\lvmen\src\licensedcode\data\rules\gpl-2.0_1192.yml", "YAML", 0, 0, 0, 5, 0, 0, 1, 6
"d:\IDEWORK\lvmen\src\licensedcode\data\rules\gpl-2.0_1193.yml", "YAML", 0, 0, 0, 5, 0, 0, 1, 6
"d:\IDEWORK\lvmen\src\licensedcode\data\rules\gpl-2.0_1194.yml", "YAML", 0, 0, 0, 6, 0, 0, 1, 7
"d:\IDEWORK\lvmen\src\licensedcode\data\rules\gpl-2.0_1195.yml", "YAML", 0, 0, 0, 5, 0, 0, 1, 6
"d:\IDEWORK\lvmen\src\licensedcode\data\rules\gpl-2.0_1196.yml", "YAML", 0, 0, 0, 5, 0, 0, 1, 6
"d:\IDEWORK\lvmen\src\licensedcode\data\rules\gpl-2.0_1197.yml", "YAML", 0, 0, 0, 5, 0, 0, 1, 6
"d:\IDEWORK\lvmen\src\licensedcode\data\rules\gpl-2.0_1198.yml", "YAML", 0, 0, 0, 6, 0, 0, 1, 7
"d:\IDEWORK\lvmen\src\licensedcode\data\rules\gpl-2.0_1199.yml", "YAML", 0, 0, 0, 6, 0, 0, 1, 7
"d:\IDEWORK\lvmen\src\licensedcode\data\rules\gpl-2.0_12.yml", "YAML", 0, 0, 0, 5, 0, 0, 1, 6
"d:\IDEWORK\lvmen\src\licensedcode\data\rules\gpl-2.0_120.yml", "YAML", 0, 0, 0, 4, 0, 0, 1, 5
"d:\IDEWORK\lvmen\src\licensedcode\data\rules\gpl-2.0_1200.yml", "YAML", 0, 0, 0, 5, 0, 0, 1, 6
"d:\IDEWORK\lvmen\src\licensedcode\data\rules\gpl-2.0_1201.yml", "YAML", 0, 0, 0, 5, 0, 0, 1, 6
"d:\IDEWORK\lvmen\src\licensedcode\data\rules\gpl-2.0_1202.yml", "YAML", 0, 0, 0, 5, 0, 0, 1, 6
"d:\IDEWORK\lvmen\src\licensedcode\data\rules\gpl-2.0_1203.yml", "YAML", 0, 0, 0, 5, 0, 0, 1, 6
"d:\IDEWORK\lvmen\src\licensedcode\data\rules\gpl-2.0_1204.yml", "YAML", 0, 0, 0, 5, 0, 0, 1, 6
"d:\IDEWORK\lvmen\src\licensedcode\data\rules\gpl-2.0_1205.yml", "YAML", 0, 0, 0, 5, 0, 0, 1, 6
"d:\IDEWORK\lvmen\src\licensedcode\data\rules\gpl-2.0_1206.yml", "YAML", 0, 0, 0, 5, 0, 0, 1, 6
"d:\IDEWORK\lvmen\src\licensedcode\data\rules\gpl-2.0_1207.yml", "YAML", 0, 0, 0, 7, 0, 0, 1, 8
"d:\IDEWORK\lvmen\src\licensedcode\data\rules\gpl-2.0_1208.yml", "YAML", 0, 0, 0, 8, 0, 0, 1, 9
"d:\IDEWORK\lvmen\src\licensedcode\data\rules\gpl-2.0_1209.yml", "YAML", 0, 0, 0, 5, 0, 0, 1, 6
"d:\IDEWORK\lvmen\src\licensedcode\data\rules\gpl-2.0_121.yml", "YAML", 0, 0, 0, 2, 0, 0, 1, 3
"d:\IDEWORK\lvmen\src\licensedcode\data\rules\gpl-2.0_1210.yml", "YAML", 0, 0, 0, 5, 0, 0, 1, 6
"d:\IDEWORK\lvmen\src\licensedcode\data\rules\gpl-2.0_1211.yml", "YAML", 0, 0, 0, 8, 0, 0, 1, 9
"d:\IDEWORK\lvmen\src\licensedcode\data\rules\gpl-2.0_1212.yml", "YAML", 0, 0, 0, 7, 0, 0, 1, 8
"d:\IDEWORK\lvmen\src\licensedcode\data\rules\gpl-2.0_1213.yml", "YAML", 0, 0, 0, 5, 0, 0, 1, 6
"d:\IDEWORK\lvmen\src\licensedcode\data\rules\gpl-2.0_1214.yml", "YAML", 0, 0, 0, 5, 0, 0, 1, 6
"d:\IDEWORK\lvmen\src\licensedcode\data\rules\gpl-2.0_1215.yml", "YAML", 0, 0, 0, 6, 0, 0, 1, 7
"d:\IDEWORK\lvmen\src\licensedcode\data\rules\gpl-2.0_1216.yml", "YAML", 0, 0, 0, 5, 0, 0, 1, 6
"d:\IDEWORK\lvmen\src\licensedcode\data\rules\gpl-2.0_1217.yml", "YAML", 0, 0, 0, 5, 0, 0, 1, 6
"d:\IDEWORK\lvmen\src\licensedcode\data\rules\gpl-2.0_1218.yml", "YAML", 0, 0, 0, 5, 0, 0, 1, 6
"d:\IDEWORK\lvmen\src\licensedcode\data\rules\gpl-2.0_1219.yml", "YAML", 0, 0, 0, 7, 0, 0, 1, 8
"d:\IDEWORK\lvmen\src\licensedcode\data\rules\gpl-2.0_122.yml", "YAML", 0, 0, 0, 2, 0, 0, 1, 3
"d:\IDEWORK\lvmen\src\licensedcode\data\rules\gpl-2.0_1220.yml", "YAML", 0, 0, 0, 5, 0, 0, 1, 6
"d:\IDEWORK\lvmen\src\licensedcode\data\rules\gpl-2.0_1221.yml", "YAML", 0, 0, 0, 7, 0, 0, 1, 8
"d:\IDEWORK\lvmen\src\licensedcode\data\rules\gpl-2.0_1222.yml", "YAML", 0, 0, 0, 5, 0, 0, 1, 6
"d:\IDEWORK\lvmen\src\licensedcode\data\rules\gpl-2.0_1223.yml", "YAML", 0, 0, 0, 5, 0, 0, 1, 6
"d:\IDEWORK\lvmen\src\licensedcode\data\rules\gpl-2.0_1224.yml", "YAML", 0, 0, 0, 5, 0, 0, 1, 6
"d:\IDEWORK\lvmen\src\licensedcode\data\rules\gpl-2.0_1225.yml", "YAML", 0, 0, 0, 5, 0, 0, 1, 6
"d:\IDEWORK\lvmen\src\licensedcode\data\rules\gpl-2.0_1226.yml", "YAML", 0, 0, 0, 5, 0, 0, 1, 6
"d:\IDEWORK\lvmen\src\licensedcode\data\rules\gpl-2.0_1227.yml", "YAML", 0, 0, 0, 5, 0, 0, 1, 6
"d:\IDEWORK\lvmen\src\licensedcode\data\rules\gpl-2.0_1228.yml", "YAML", 0, 0, 0, 7, 0, 0, 1, 8
"d:\IDEWORK\lvmen\src\licensedcode\data\rules\gpl-2.0_1229.yml", "YAML", 0, 0, 0, 5, 0, 0, 1, 6
"d:\IDEWORK\lvmen\src\licensedcode\data\rules\gpl-2.0_123.yml", "YAML", 0, 0, 0, 2, 0, 0, 1, 3
"d:\IDEWORK\lvmen\src\licensedcode\data\rules\gpl-2.0_1230.yml", "YAML", 0, 0, 0, 7, 0, 0, 1, 8
"d:\IDEWORK\lvmen\src\licensedcode\data\rules\gpl-2.0_1231.yml", "YAML", 0, 0, 0, 5, 0, 0, 1, 6
"d:\IDEWORK\lvmen\src\licensedcode\data\rules\gpl-2.0_1232.yml", "YAML", 0, 0, 0, 5, 0, 0, 1, 6
"d:\IDEWORK\lvmen\src\licensedcode\data\rules\gpl-2.0_1233.yml", "YAML", 0, 0, 0, 6, 0, 0, 1, 7
"d:\IDEWORK\lvmen\src\licensedcode\data\rules\gpl-2.0_1234.yml", "YAML", 0, 0, 0, 5, 0, 0, 1, 6
"d:\IDEWORK\lvmen\src\licensedcode\data\rules\gpl-2.0_1235.yml", "YAML", 0, 0, 0, 8, 0, 0, 1, 9
"d:\IDEWORK\lvmen\src\licensedcode\data\rules\gpl-2.0_1236.yml", "YAML", 0, 0, 0, 5, 0, 0, 1, 6
"d:\IDEWORK\lvmen\src\licensedcode\data\rules\gpl-2.0_1237.yml", "YAML", 0, 0, 0, 5, 0, 0, 1, 6
"d:\IDEWORK\lvmen\src\licensedcode\data\rules\gpl-2.0_1238.yml", "YAML", 0, 0, 0, 5, 0, 0, 1, 6
"d:\IDEWORK\lvmen\src\licensedcode\data\rules\gpl-2.0_1239.yml", "YAML", 0, 0, 0, 6, 0, 0, 1, 7
"d:\IDEWORK\lvmen\src\licensedcode\data\rules\gpl-2.0_124.yml", "YAML", 0, 0, 0, 3, 0, 0, 1, 4
"d:\IDEWORK\lvmen\src\licensedcode\data\rules\gpl-2.0_1240.yml", "YAML", 0, 0, 0, 8, 0, 0, 1, 9
"d:\IDEWORK\lvmen\src\licensedcode\data\rules\gpl-2.0_1241.yml", "YAML", 0, 0, 0, 5, 0, 0, 1, 6
"d:\IDEWORK\lvmen\src\licensedcode\data\rules\gpl-2.0_1242.yml", "YAML", 0, 0, 0, 5, 0, 0, 1, 6
"d:\IDEWORK\lvmen\src\licensedcode\data\rules\gpl-2.0_1243.yml", "YAML", 0, 0, 0, 5, 0, 0, 1, 6
"d:\IDEWORK\lvmen\src\licensedcode\data\rules\gpl-2.0_1244.yml", "YAML", 0, 0, 0, 5, 0, 0, 1, 6
"d:\IDEWORK\lvmen\src\licensedcode\data\rules\gpl-2.0_1245.yml", "YAML", 0, 0, 0, 7, 0, 0, 1, 8
"d:\IDEWORK\lvmen\src\licensedcode\data\rules\gpl-2.0_1246.yml", "YAML", 0, 0, 0, 5, 0, 0, 1, 6
"d:\IDEWORK\lvmen\src\licensedcode\data\rules\gpl-2.0_1247.yml", "YAML", 0, 0, 0, 6, 0, 0, 1, 7
"d:\IDEWORK\lvmen\src\licensedcode\data\rules\gpl-2.0_1248.yml", "YAML", 0, 0, 0, 5, 0, 0, 1, 6
"d:\IDEWORK\lvmen\src\licensedcode\data\rules\gpl-2.0_1249.yml", "YAML", 0, 0, 0, 7, 0, 0, 1, 8
"d:\IDEWORK\lvmen\src\licensedcode\data\rules\gpl-2.0_125.yml", "YAML", 0, 0, 0, 3, 0, 0, 1, 4
"d:\IDEWORK\lvmen\src\licensedcode\data\rules\gpl-2.0_1250.yml", "YAML", 0, 0, 0, 5, 0, 0, 1, 6
"d:\IDEWORK\lvmen\src\licensedcode\data\rules\gpl-2.0_1251.yml", "YAML", 0, 0, 0, 5, 0, 0, 1, 6
"d:\IDEWORK\lvmen\src\licensedcode\data\rules\gpl-2.0_1252.yml", "YAML", 0, 0, 0, 5, 0, 0, 1, 6
"d:\IDEWORK\lvmen\src\licensedcode\data\rules\gpl-2.0_1253.yml", "YAML", 0, 0, 0, 5, 0, 0, 1, 6
"d:\IDEWORK\lvmen\src\licensedcode\data\rules\gpl-2.0_1254.yml", "YAML", 0, 0, 0, 5, 0, 0, 1, 6
"d:\IDEWORK\lvmen\src\licensedcode\data\rules\gpl-2.0_1255.yml", "YAML", 0, 0, 0, 5, 0, 0, 1, 6
"d:\IDEWORK\lvmen\src\licensedcode\data\rules\gpl-2.0_1256.yml", "YAML", 0, 0, 0, 5, 0, 0, 1, 6
"d:\IDEWORK\lvmen\src\licensedcode\data\rules\gpl-2.0_1257.yml", "YAML", 0, 0, 0, 5, 0, 0, 1, 6
"d:\IDEWORK\lvmen\src\licensedcode\data\rules\gpl-2.0_1258.yml", "YAML", 0, 0, 0, 5, 0, 0, 1, 6
"d:\IDEWORK\lvmen\src\licensedcode\data\rules\gpl-2.0_1259.yml", "YAML", 0, 0, 0, 5, 0, 0, 1, 6
"d:\IDEWORK\lvmen\src\licensedcode\data\rules\gpl-2.0_126.yml", "YAML", 0, 0, 0, 3, 0, 0, 1, 4
"d:\IDEWORK\lvmen\src\licensedcode\data\rules\gpl-2.0_1260.yml", "YAML", 0, 0, 0, 7, 0, 0, 1, 8
"d:\IDEWORK\lvmen\src\licensedcode\data\rules\gpl-2.0_1261.yml", "YAML", 0, 0, 0, 7, 0, 0, 1, 8
"d:\IDEWORK\lvmen\src\licensedcode\data\rules\gpl-2.0_1262.yml", "YAML", 0, 0, 0, 5, 0, 0, 1, 6
"d:\IDEWORK\lvmen\src\licensedcode\data\rules\gpl-2.0_1263.yml", "YAML", 0, 0, 0, 9, 0, 0, 1, 10
"d:\IDEWORK\lvmen\src\licensedcode\data\rules\gpl-2.0_1264.yml", "YAML", 0, 0, 0, 9, 0, 0, 1, 10
"d:\IDEWORK\lvmen\src\licensedcode\data\rules\gpl-2.0_1265.yml", "YAML", 0, 0, 0, 5, 0, 0, 1, 6
"d:\IDEWORK\lvmen\src\licensedcode\data\rules\gpl-2.0_1266.yml", "YAML", 0, 0, 0, 9, 0, 0, 1, 10
"d:\IDEWORK\lvmen\src\licensedcode\data\rules\gpl-2.0_1267.yml", "YAML", 0, 0, 0, 5, 0, 0, 1, 6
"d:\IDEWORK\lvmen\src\licensedcode\data\rules\gpl-2.0_1268.yml", "YAML", 0, 0, 0, 5, 0, 0, 1, 6
"d:\IDEWORK\lvmen\src\licensedcode\data\rules\gpl-2.0_1269.yml", "YAML", 0, 0, 0, 5, 0, 0, 1, 6
"d:\IDEWORK\lvmen\src\licensedcode\data\rules\gpl-2.0_127.yml", "YAML", 0, 0, 0, 3, 0, 0, 1, 4
"d:\IDEWORK\lvmen\src\licensedcode\data\rules\gpl-2.0_1270.yml", "YAML", 0, 0, 0, 7, 0, 0, 1, 8
"d:\IDEWORK\lvmen\src\licensedcode\data\rules\gpl-2.0_1271.yml", "YAML", 0, 0, 0, 5, 0, 0, 1, 6
"d:\IDEWORK\lvmen\src\licensedcode\data\rules\gpl-2.0_1272.yml", "YAML", 0, 0, 0, 5, 0, 0, 1, 6
"d:\IDEWORK\lvmen\src\licensedcode\data\rules\gpl-2.0_1273.yml", "YAML", 0, 0, 0, 6, 0, 0, 1, 7
"d:\IDEWORK\lvmen\src\licensedcode\data\rules\gpl-2.0_1274.yml", "YAML", 0, 0, 0, 6, 0, 0, 1, 7
"d:\IDEWORK\lvmen\src\licensedcode\data\rules\gpl-2.0_1275.yml", "YAML", 0, 0, 0, 5, 0, 0, 1, 6
"d:\IDEWORK\lvmen\src\licensedcode\data\rules\gpl-2.0_1276.yml", "YAML", 0, 0, 0, 5, 0, 0, 1, 6
"d:\IDEWORK\lvmen\src\licensedcode\data\rules\gpl-2.0_1277.yml", "YAML", 0, 0, 0, 7, 0, 0, 1, 8
"d:\IDEWORK\lvmen\src\licensedcode\data\rules\gpl-2.0_1278.yml", "YAML", 0, 0, 0, 5, 0, 0, 1, 6
"d:\IDEWORK\lvmen\src\licensedcode\data\rules\gpl-2.0_1279.yml", "YAML", 0, 0, 0, 5, 0, 0, 1, 6
"d:\IDEWORK\lvmen\src\licensedcode\data\rules\gpl-2.0_128.yml", "YAML", 0, 0, 0, 2, 0, 0, 1, 3
"d:\IDEWORK\lvmen\src\licensedcode\data\rules\gpl-2.0_1280.yml", "YAML", 0, 0, 0, 8, 0, 0, 1, 9
"d:\IDEWORK\lvmen\src\licensedcode\data\rules\gpl-2.0_1281.yml", "YAML", 0, 0, 0, 5, 0, 0, 1, 6
"d:\IDEWORK\lvmen\src\licensedcode\data\rules\gpl-2.0_1282.yml", "YAML", 0, 0, 0, 6, 0, 0, 1, 7
"d:\IDEWORK\lvmen\src\licensedcode\data\rules\gpl-2.0_1283.yml", "YAML", 0, 0, 0, 8, 0, 0, 1, 9
"d:\IDEWORK\lvmen\src\licensedcode\data\rules\gpl-2.0_1284.yml", "YAML", 0, 0, 0, 5, 0, 0, 1, 6
"d:\IDEWORK\lvmen\src\licensedcode\data\rules\gpl-2.0_1285.yml", "YAML", 0, 0, 0, 5, 0, 0, 1, 6
"d:\IDEWORK\lvmen\src\licensedcode\data\rules\gpl-2.0_1286.yml", "YAML", 0, 0, 0, 5, 0, 0, 1, 6
"d:\IDEWORK\lvmen\src\licensedcode\data\rules\gpl-2.0_1287.yml", "YAML", 0, 0, 0, 6, 0, 0, 1, 7
"d:\IDEWORK\lvmen\src\licensedcode\data\rules\gpl-2.0_1288.yml", "YAML", 0, 0, 0, 5, 0, 0, 1, 6
"d:\IDEWORK\lvmen\src\licensedcode\data\rules\gpl-2.0_1289.yml", "YAML", 0, 0, 0, 5, 0, 0, 1, 6
"d:\IDEWORK\lvmen\src\licensedcode\data\rules\gpl-2.0_129.yml", "YAML", 0, 0, 0, 3, 0, 0, 1, 4
"d:\IDEWORK\lvmen\src\licensedcode\data\rules\gpl-2.0_1290.yml", "YAML", 0, 0, 0, 4, 0, 0, 1, 5
"d:\IDEWORK\lvmen\src\licensedcode\data\rules\gpl-2.0_1291.yml", "YAML", 0, 0, 0, 5, 0, 0, 1, 6
"d:\IDEWORK\lvmen\src\licensedcode\data\rules\gpl-2.0_1292.yml", "YAML", 0, 0, 0, 4, 0, 0, 1, 5
"d:\IDEWORK\lvmen\src\licensedcode\data\rules\gpl-2.0_1293.yml", "YAML", 0, 0, 0, 4, 0, 0, 1, 5
"d:\IDEWORK\lvmen\src\licensedcode\data\rules\gpl-2.0_1294.yml", "YAML", 0, 0, 0, 4, 0, 0, 1, 5
"d:\IDEWORK\lvmen\src\licensedcode\data\rules\gpl-2.0_1295.yml", "YAML", 0, 0, 0, 4, 0, 0, 1, 5
"d:\IDEWORK\lvmen\src\licensedcode\data\rules\gpl-2.0_1296.yml", "YAML", 0, 0, 0, 4, 0, 0, 1, 5
"d:\IDEWORK\lvmen\src\licensedcode\data\rules\gpl-2.0_1297.yml", "YAML", 0, 0, 0, 3, 0, 0, 1, 4
"d:\IDEWORK\lvmen\src\licensedcode\data\rules\gpl-2.0_1298.yml", "YAML", 0, 0, 0, 3, 0, 0, 1, 4
"d:\IDEWORK\lvmen\src\licensedcode\data\rules\gpl-2.0_1299.yml", "YAML", 0, 0, 0, 5, 0, 0, 1, 6
"d:\IDEWORK\lvmen\src\licensedcode\data\rules\gpl-2.0_13.yml", "YAML", 0, 0, 0, 4, 0, 0, 1, 5
"d:\IDEWORK\lvmen\src\licensedcode\data\rules\gpl-2.0_130.yml", "YAML", 0, 0, 0, 2, 0, 0, 1, 3
"d:\IDEWORK\lvmen\src\licensedcode\data\rules\gpl-2.0_1300.yml", "YAML", 0, 0, 0, 2, 0, 0, 1, 3
"d:\IDEWORK\lvmen\src\licensedcode\data\rules\gpl-2.0_1301.yml", "YAML", 0, 0, 0, 4, 0, 0, 1, 5
"d:\IDEWORK\lvmen\src\licensedcode\data\rules\gpl-2.0_1302.yml", "YAML", 0, 0, 0, 2, 0, 0, 1, 3
"d:\IDEWORK\lvmen\src\licensedcode\data\rules\gpl-2.0_1303.yml", "YAML", 0, 0, 0, 5, 0, 0, 1, 6
"d:\IDEWORK\lvmen\src\licensedcode\data\rules\gpl-2.0_1304.yml", "YAML", 0, 0, 0, 3, 0, 0, 1, 4
"d:\IDEWORK\lvmen\src\licensedcode\data\rules\gpl-2.0_1305.yml", "YAML", 0, 0, 0, 7, 0, 0, 1, 8
"d:\IDEWORK\lvmen\src\licensedcode\data\rules\gpl-2.0_1306.yml", "YAML", 0, 0, 0, 5, 0, 0, 1, 6
"d:\IDEWORK\lvmen\src\licensedcode\data\rules\gpl-2.0_1307.yml", "YAML", 0, 0, 0, 3, 0, 0, 1, 4
"d:\IDEWORK\lvmen\src\licensedcode\data\rules\gpl-2.0_1308.yml", "YAML", 0, 0, 0, 7, 0, 0, 1, 8
"d:\IDEWORK\lvmen\src\licensedcode\data\rules\gpl-2.0_1309.yml", "YAML", 0, 0, 0, 5, 0, 0, 1, 6
"d:\IDEWORK\lvmen\src\licensedcode\data\rules\gpl-2.0_131.yml", "YAML", 0, 0, 0, 5, 0, 0, 1, 6
"d:\IDEWORK\lvmen\src\licensedcode\data\rules\gpl-2.0_1310.yml", "YAML", 0, 0, 0, 6, 0, 0, 1, 7
"d:\IDEWORK\lvmen\src\licensedcode\data\rules\gpl-2.0_1311.yml", "YAML", 0, 0, 0, 3, 0, 0, 1, 4
"d:\IDEWORK\lvmen\src\licensedcode\data\rules\gpl-2.0_1312.yml", "YAML", 0, 0, 0, 3, 0, 0, 1, 4
"d:\IDEWORK\lvmen\src\licensedcode\data\rules\gpl-2.0_1313.yml", "YAML", 0, 0, 0, 3, 0, 0, 1, 4
"d:\IDEWORK\lvmen\src\licensedcode\data\rules\gpl-2.0_1314.yml", "YAML", 0, 0, 0, 5, 0, 0, 1, 6
"d:\IDEWORK\lvmen\src\licensedcode\data\rules\gpl-2.0_1315.yml", "YAML", 0, 0, 0, 5, 0, 0, 1, 6
"d:\IDEWORK\lvmen\src\licensedcode\data\rules\gpl-2.0_1316.yml", "YAML", 0, 0, 0, 5, 0, 0, 1, 6
"d:\IDEWORK\lvmen\src\licensedcode\data\rules\gpl-2.0_1317.yml", "YAML", 0, 0, 0, 3, 0, 0, 1, 4
"d:\IDEWORK\lvmen\src\licensedcode\data\rules\gpl-2.0_1318.yml", "YAML", 0, 0, 0, 3, 0, 0, 1, 4
"d:\IDEWORK\lvmen\src\licensedcode\data\rules\gpl-2.0_1319.yml", "YAML", 0, 0, 0, 6, 0, 0, 1, 7
"d:\IDEWORK\lvmen\src\licensedcode\data\rules\gpl-2.0_132.yml", "YAML", 0, 0, 0, 5, 0, 0, 1, 6
"d:\IDEWORK\lvmen\src\licensedcode\data\rules\gpl-2.0_1320.yml", "YAML", 0, 0, 0, 5, 0, 0, 1, 6
"d:\IDEWORK\lvmen\src\licensedcode\data\rules\gpl-2.0_1321.yml", "YAML", 0, 0, 0, 5, 0, 0, 1, 6
"d:\IDEWORK\lvmen\src\licensedcode\data\rules\gpl-2.0_1322.yml", "YAML", 0, 0, 0, 9, 0, 0, 1, 10
"d:\IDEWORK\lvmen\src\licensedcode\data\rules\gpl-2.0_1323.yml", "YAML", 0, 0, 0, 6, 0, 0, 1, 7
"d:\IDEWORK\lvmen\src\licensedcode\data\rules\gpl-2.0_1324.yml", "YAML", 0, 0, 0, 5, 0, 0, 1, 6
"d:\IDEWORK\lvmen\src\licensedcode\data\rules\gpl-2.0_1325.yml", "YAML", 0, 0, 0, 4, 0, 0, 1, 5
"d:\IDEWORK\lvmen\src\licensedcode\data\rules\gpl-2.0_1326.yml", "YAML", 0, 0, 0, 5, 0, 0, 1, 6
"d:\IDEWORK\lvmen\src\licensedcode\data\rules\gpl-2.0_1327.yml", "YAML", 0, 0, 0, 5, 0, 0, 1, 6
"d:\IDEWORK\lvmen\src\licensedcode\data\rules\gpl-2.0_1328.yml", "YAML", 0, 0, 0, 5, 0, 0, 1, 6
"d:\IDEWORK\lvmen\src\licensedcode\data\rules\gpl-2.0_1329.yml", "YAML", 0, 0, 0, 6, 0, 0, 1, 7
"d:\IDEWORK\lvmen\src\licensedcode\data\rules\gpl-2.0_133.yml", "YAML", 0, 0, 0, 3, 0, 0, 1, 4
"d:\IDEWORK\lvmen\src\licensedcode\data\rules\gpl-2.0_1330.yml", "YAML", 0, 0, 0, 4, 0, 0, 1, 5
"d:\IDEWORK\lvmen\src\licensedcode\data\rules\gpl-2.0_1331.yml", "YAML", 0, 0, 0, 2, 0, 0, 1, 3
"d:\IDEWORK\lvmen\src\licensedcode\data\rules\gpl-2.0_1332.yml", "YAML", 0, 0, 0, 4, 0, 0, 1, 5
"d:\IDEWORK\lvmen\src\licensedcode\data\rules\gpl-2.0_1333.yml", "YAML", 0, 0, 0, 4, 0, 0, 1, 5
"d:\IDEWORK\lvmen\src\licensedcode\data\rules\gpl-2.0_1334.yml", "YAML", 0, 0, 0, 3, 0, 0, 1, 4
"d:\IDEWORK\lvmen\src\licensedcode\data\rules\gpl-2.0_1335.yml", "YAML", 0, 0, 0, 2, 0, 0, 1, 3
"d:\IDEWORK\lvmen\src\licensedcode\data\rules\gpl-2.0_134.yml", "YAML", 0, 0, 0, 3, 0, 0, 1, 4
"d:\IDEWORK\lvmen\src\licensedcode\data\rules\gpl-2.0_135.yml", "YAML", 0, 0, 0, 4, 0, 0, 1, 5
"d:\IDEWORK\lvmen\src\licensedcode\data\rules\gpl-2.0_136.yml", "YAML", 0, 0, 0, 2, 0, 0, 1, 3
"d:\IDEWORK\lvmen\src\licensedcode\data\rules\gpl-2.0_137.yml", "YAML", 0, 0, 0, 4, 0, 0, 1, 5
"d:\IDEWORK\lvmen\src\licensedcode\data\rules\gpl-2.0_138.yml", "YAML", 0, 0, 0, 3, 0, 0, 1, 4
"d:\IDEWORK\lvmen\src\licensedcode\data\rules\gpl-2.0_139.yml", "YAML", 0, 0, 0, 2, 0, 0, 1, 3
"d:\IDEWORK\lvmen\src\licensedcode\data\rules\gpl-2.0_14.yml", "YAML", 0, 0, 0, 2, 0, 0, 1, 3
"d:\IDEWORK\lvmen\src\licensedcode\data\rules\gpl-2.0_140.yml", "YAML", 0, 0, 0, 3, 0, 0, 1, 4
"d:\IDEWORK\lvmen\src\licensedcode\data\rules\gpl-2.0_141.yml", "YAML", 0, 0, 0, 3, 0, 0, 1, 4
"d:\IDEWORK\lvmen\src\licensedcode\data\rules\gpl-2.0_142.yml", "YAML", 0, 0, 0, 3, 0, 0, 1, 4
"d:\IDEWORK\lvmen\src\licensedcode\data\rules\gpl-2.0_143.yml", "YAML", 0, 0, 0, 3, 0, 0, 1, 4
"d:\IDEWORK\lvmen\src\licensedcode\data\rules\gpl-2.0_144.yml", "YAML", 0, 0, 0, 4, 0, 0, 1, 5
"d:\IDEWORK\lvmen\src\licensedcode\data\rules\gpl-2.0_145.yml", "YAML", 0, 0, 0, 4, 0, 0, 1, 5
"d:\IDEWORK\lvmen\src\licensedcode\data\rules\gpl-2.0_146.yml", "YAML", 0, 0, 0, 3, 0, 0, 1, 4
"d:\IDEWORK\lvmen\src\licensedcode\data\rules\gpl-2.0_147.yml", "YAML", 0, 0, 0, 3, 0, 0, 1, 4
"d:\IDEWORK\lvmen\src\licensedcode\data\rules\gpl-2.0_148.yml", "YAML", 0, 0, 0, 2, 0, 0, 1, 3
"d:\IDEWORK\lvmen\src\licensedcode\data\rules\gpl-2.0_149.yml", "YAML", 0, 0, 0, 4, 0, 0, 1, 5
"d:\IDEWORK\lvmen\src\licensedcode\data\rules\gpl-2.0_15.yml", "YAML", 0, 0, 0, 4, 0, 0, 1, 5
"d:\IDEWORK\lvmen\src\licensedcode\data\rules\gpl-2.0_150.yml", "YAML", 0, 0, 0, 2, 0, 0, 1, 3
"d:\IDEWORK\lvmen\src\licensedcode\data\rules\gpl-2.0_151.yml", "YAML", 0, 0, 0, 3, 0, 0, 1, 4
"d:\IDEWORK\lvmen\src\licensedcode\data\rules\gpl-2.0_151_either.yml", "YAML", 0, 0, 0, 2, 0, 0, 1, 3
"d:\IDEWORK\lvmen\src\licensedcode\data\rules\gpl-2.0_152.yml", "YAML", 0, 0, 0, 3, 0, 0, 1, 4
"d:\IDEWORK\lvmen\src\licensedcode\data\rules\gpl-2.0_153.yml", "YAML", 0, 0, 0, 3, 0, 0, 1, 4
"d:\IDEWORK\lvmen\src\licensedcode\data\rules\gpl-2.0_154.yml", "YAML", 0, 0, 0, 4, 0, 0, 1, 5
"d:\IDEWORK\lvmen\src\licensedcode\data\rules\gpl-2.0_155.yml", "YAML", 0, 0, 0, 3, 0, 0, 1, 4
"d:\IDEWORK\lvmen\src\licensedcode\data\rules\gpl-2.0_156.yml", "YAML", 0, 0, 0, 7, 0, 0, 1, 8
"d:\IDEWORK\lvmen\src\licensedcode\data\rules\gpl-2.0_157.yml", "YAML", 0, 0, 0, 3, 0, 0, 1, 4
"d:\IDEWORK\lvmen\src\licensedcode\data\rules\gpl-2.0_158.yml", "YAML", 0, 0, 0, 2, 0, 0, 1, 3
"d:\IDEWORK\lvmen\src\licensedcode\data\rules\gpl-2.0_159.yml", "YAML", 0, 0, 0, 4, 0, 0, 1, 5
"d:\IDEWORK\lvmen\src\licensedcode\data\rules\gpl-2.0_16.yml", "YAML", 0, 0, 0, 3, 0, 0, 1, 4
"d:\IDEWORK\lvmen\src\licensedcode\data\rules\gpl-2.0_160.yml", "YAML", 0, 0, 0, 5, 0, 0, 1, 6
"d:\IDEWORK\lvmen\src\licensedcode\data\rules\gpl-2.0_161.yml", "YAML", 0, 0, 0, 3, 0, 0, 1, 4
"d:\IDEWORK\lvmen\src\licensedcode\data\rules\gpl-2.0_162.yml", "YAML", 0, 0, 0, 6, 0, 0, 1, 7
"d:\IDEWORK\lvmen\src\licensedcode\data\rules\gpl-2.0_162_1.yml", "YAML", 0, 0, 0, 7, 0, 0, 1, 8
"d:\IDEWORK\lvmen\src\licensedcode\data\rules\gpl-2.0_163.yml", "YAML", 0, 0, 0, 2, 0, 0, 1, 3
"d:\IDEWORK\lvmen\src\licensedcode\data\rules\gpl-2.0_164.yml", "YAML", 0, 0, 0, 2, 0, 0, 1, 3
"d:\IDEWORK\lvmen\src\licensedcode\data\rules\gpl-2.0_165.yml", "YAML", 0, 0, 0, 6, 0, 0, 1, 7
"d:\IDEWORK\lvmen\src\licensedcode\data\rules\gpl-2.0_166.yml", "YAML", 0, 0, 0, 3, 0, 0, 1, 4
"d:\IDEWORK\lvmen\src\licensedcode\data\rules\gpl-2.0_167.yml", "YAML", 0, 0, 0, 5, 0, 0, 1, 6
"d:\IDEWORK\lvmen\src\licensedcode\data\rules\gpl-2.0_168.yml", "YAML", 0, 0, 0, 3, 0, 0, 1, 4
"d:\IDEWORK\lvmen\src\licensedcode\data\rules\gpl-2.0_169.yml", "YAML", 0, 0, 0, 3, 0, 0, 1, 4
"d:\IDEWORK\lvmen\src\licensedcode\data\rules\gpl-2.0_17.yml", "YAML", 0, 0, 0, 3, 0, 0, 1, 4
"d:\IDEWORK\lvmen\src\licensedcode\data\rules\gpl-2.0_170.yml", "YAML", 0, 0, 0, 3, 0, 0, 1, 4
"d:\IDEWORK\lvmen\src\licensedcode\data\rules\gpl-2.0_171.yml", "YAML", 0, 0, 0, 3, 0, 0, 1, 4
"d:\IDEWORK\lvmen\src\licensedcode\data\rules\gpl-2.0_172.yml", "YAML", 0, 0, 0, 2, 0, 0, 1, 3
"d:\IDEWORK\lvmen\src\licensedcode\data\rules\gpl-2.0_173.yml", "YAML", 0, 0, 0, 3, 0, 0, 1, 4
"d:\IDEWORK\lvmen\src\licensedcode\data\rules\gpl-2.0_174.yml", "YAML", 0, 0, 0, 3, 0, 0, 1, 4
"d:\IDEWORK\lvmen\src\licensedcode\data\rules\gpl-2.0_175.yml", "YAML", 0, 0, 0, 4, 0, 0, 1, 5
"d:\IDEWORK\lvmen\src\licensedcode\data\rules\gpl-2.0_176.yml", "YAML", 0, 0, 0, 3, 0, 0, 1, 4
"d:\IDEWORK\lvmen\src\licensedcode\data\rules\gpl-2.0_177.yml", "YAML", 0, 0, 0, 3, 0, 0, 1, 4
"d:\IDEWORK\lvmen\src\licensedcode\data\rules\gpl-2.0_178.yml", "YAML", 0, 0, 0, 3, 0, 0, 1, 4
"d:\IDEWORK\lvmen\src\licensedcode\data\rules\gpl-2.0_179.yml", "YAML", 0, 0, 0, 5, 0, 0, 1, 6
"d:\IDEWORK\lvmen\src\licensedcode\data\rules\gpl-2.0_18.yml", "YAML", 0, 0, 0, 2, 0, 0, 1, 3
"d:\IDEWORK\lvmen\src\licensedcode\data\rules\gpl-2.0_180.yml", "YAML", 0, 0, 0, 3, 0, 0, 1, 4
"d:\IDEWORK\lvmen\src\licensedcode\data\rules\gpl-2.0_181.yml", "YAML", 0, 0, 0, 2, 0, 0, 1, 3
"d:\IDEWORK\lvmen\src\licensedcode\data\rules\gpl-2.0_181_1.yml", "YAML", 0, 0, 0, 3, 0, 0, 1, 4
"d:\IDEWORK\lvmen\src\licensedcode\data\rules\gpl-2.0_182.yml", "YAML", 0, 0, 0, 3, 0, 0, 1, 4
"d:\IDEWORK\lvmen\src\licensedcode\data\rules\gpl-2.0_183.yml", "YAML", 0, 0, 0, 3, 0, 0, 1, 4
"d:\IDEWORK\lvmen\src\licensedcode\data\rules\gpl-2.0_184.yml", "YAML", 0, 0, 0, 2, 0, 0, 1, 3
"d:\IDEWORK\lvmen\src\licensedcode\data\rules\gpl-2.0_185.yml", "YAML", 0, 0, 0, 4, 0, 0, 1, 5
"d:\IDEWORK\lvmen\src\licensedcode\data\rules\gpl-2.0_186.yml", "YAML", 0, 0, 0, 5, 0, 0, 1, 6
"d:\IDEWORK\lvmen\src\licensedcode\data\rules\gpl-2.0_187.yml", "YAML", 0, 0, 0, 3, 0, 0, 1, 4
"d:\IDEWORK\lvmen\src\licensedcode\data\rules\gpl-2.0_188.yml", "YAML", 0, 0, 0, 3, 0, 0, 1, 4
"d:\IDEWORK\lvmen\src\licensedcode\data\rules\gpl-2.0_189.yml", "YAML", 0, 0, 0, 3, 0, 0, 1, 4
"d:\IDEWORK\lvmen\src\licensedcode\data\rules\gpl-2.0_19.yml", "YAML", 0, 0, 0, 4, 0, 0, 1, 5
"d:\IDEWORK\lvmen\src\licensedcode\data\rules\gpl-2.0_190.yml", "YAML", 0, 0, 0, 8, 0, 0, 1, 9
"d:\IDEWORK\lvmen\src\licensedcode\data\rules\gpl-2.0_190_1.yml", "YAML", 0, 0, 0, 8, 0, 0, 1, 9
"d:\IDEWORK\lvmen\src\licensedcode\data\rules\gpl-2.0_191.yml", "YAML", 0, 0, 0, 3, 0, 0, 1, 4
"d:\IDEWORK\lvmen\src\licensedcode\data\rules\gpl-2.0_192.yml", "YAML", 0, 0, 0, 4, 0, 0, 1, 5
"d:\IDEWORK\lvmen\src\licensedcode\data\rules\gpl-2.0_193.yml", "YAML", 0, 0, 0, 2, 0, 0, 1, 3
"d:\IDEWORK\lvmen\src\licensedcode\data\rules\gpl-2.0_194.yml", "YAML", 0, 0, 0, 3, 0, 0, 1, 4
"d:\IDEWORK\lvmen\src\licensedcode\data\rules\gpl-2.0_195.yml", "YAML", 0, 0, 0, 5, 0, 0, 1, 6
"d:\IDEWORK\lvmen\src\licensedcode\data\rules\gpl-2.0_196.yml", "YAML", 0, 0, 0, 6, 0, 0, 1, 7
"d:\IDEWORK\lvmen\src\licensedcode\data\rules\gpl-2.0_197.yml", "YAML", 0, 0, 0, 6, 0, 0, 1, 7
"d:\IDEWORK\lvmen\src\licensedcode\data\rules\gpl-2.0_198.yml", "YAML", 0, 0, 0, 8, 0, 0, 1, 9
"d:\IDEWORK\lvmen\src\licensedcode\data\rules\gpl-2.0_199.yml", "YAML", 0, 0, 0, 6, 0, 0, 1, 7
"d:\IDEWORK\lvmen\src\licensedcode\data\rules\gpl-2.0_2.yml", "YAML", 0, 0, 0, 2, 0, 0, 1, 3
"d:\IDEWORK\lvmen\src\licensedcode\data\rules\gpl-2.0_20.yml", "YAML", 0, 0, 0, 3, 0, 0, 1, 4
"d:\IDEWORK\lvmen\src\licensedcode\data\rules\gpl-2.0_200.yml", "YAML", 0, 0, 0, 4, 0, 0, 1, 5
"d:\IDEWORK\lvmen\src\licensedcode\data\rules\gpl-2.0_201.yml", "YAML", 0, 0, 0, 8, 0, 0, 1, 9
"d:\IDEWORK\lvmen\src\licensedcode\data\rules\gpl-2.0_202.yml", "YAML", 0, 0, 0, 3, 0, 0, 1, 4
"d:\IDEWORK\lvmen\src\licensedcode\data\rules\gpl-2.0_203.yml", "YAML", 0, 0, 0, 2, 0, 0, 1, 3
"d:\IDEWORK\lvmen\src\licensedcode\data\rules\gpl-2.0_204.yml", "YAML", 0, 0, 0, 4, 0, 0, 1, 5
"d:\IDEWORK\lvmen\src\licensedcode\data\rules\gpl-2.0_205.yml", "YAML", 0, 0, 0, 4, 0, 0, 1, 5
"d:\IDEWORK\lvmen\src\licensedcode\data\rules\gpl-2.0_206.yml", "YAML", 0, 0, 0, 4, 0, 0, 1, 5
"d:\IDEWORK\lvmen\src\licensedcode\data\rules\gpl-2.0_207.yml", "YAML", 0, 0, 0, 3, 0, 0, 1, 4
"d:\IDEWORK\lvmen\src\licensedcode\data\rules\gpl-2.0_208.yml", "YAML", 0, 0, 0, 4, 0, 0, 1, 5
"d:\IDEWORK\lvmen\src\licensedcode\data\rules\gpl-2.0_209.yml", "YAML", 0, 0, 0, 2, 0, 0, 1, 3
"d:\IDEWORK\lvmen\src\licensedcode\data\rules\gpl-2.0_21.yml", "YAML", 0, 0, 0, 11, 0, 0, 1, 12
"d:\IDEWORK\lvmen\src\licensedcode\data\rules\gpl-2.0_210.yml", "YAML", 0, 0, 0, 2, 0, 0, 1, 3
"d:\IDEWORK\lvmen\src\licensedcode\data\rules\gpl-2.0_211.yml", "YAML", 0, 0, 0, 2, 0, 0, 1, 3
"d:\IDEWORK\lvmen\src\licensedcode\data\rules\gpl-2.0_212.yml", "YAML", 0, 0, 0, 2, 0, 0, 1, 3
"d:\IDEWORK\lvmen\src\licensedcode\data\rules\gpl-2.0_213.yml", "YAML", 0, 0, 0, 2, 0, 0, 1, 3
"d:\IDEWORK\lvmen\src\licensedcode\data\rules\gpl-2.0_214.yml", "YAML", 0, 0, 0, 6, 0, 0, 1, 7
"d:\IDEWORK\lvmen\src\licensedcode\data\rules\gpl-2.0_215.yml", "YAML", 0, 0, 0, 2, 0, 0, 1, 3
"d:\IDEWORK\lvmen\src\licensedcode\data\rules\gpl-2.0_216.yml", "YAML", 0, 0, 0, 4, 0, 0, 1, 5
"d:\IDEWORK\lvmen\src\licensedcode\data\rules\gpl-2.0_217.yml", "YAML", 0, 0, 0, 3, 0, 0, 1, 4
"d:\IDEWORK\lvmen\src\licensedcode\data\rules\gpl-2.0_218.yml", "YAML", 0, 0, 0, 3, 0, 0, 1, 4
"d:\IDEWORK\lvmen\src\licensedcode\data\rules\gpl-2.0_219.yml", "YAML", 0, 0, 0, 3, 0, 0, 1, 4
"d:\IDEWORK\lvmen\src\licensedcode\data\rules\gpl-2.0_22.yml", "YAML", 0, 0, 0, 6, 0, 0, 1, 7
"d:\IDEWORK\lvmen\src\licensedcode\data\rules\gpl-2.0_220.yml", "YAML", 0, 0, 0, 3, 0, 0, 1, 4
"d:\IDEWORK\lvmen\src\licensedcode\data\rules\gpl-2.0_221.yml", "YAML", 0, 0, 0, 3, 0, 0, 1, 4
"d:\IDEWORK\lvmen\src\licensedcode\data\rules\gpl-2.0_222.yml", "YAML", 0, 0, 0, 3, 0, 0, 1, 4
"d:\IDEWORK\lvmen\src\licensedcode\data\rules\gpl-2.0_223.yml", "YAML", 0, 0, 0, 3, 0, 0, 1, 4
"d:\IDEWORK\lvmen\src\licensedcode\data\rules\gpl-2.0_224.yml", "YAML", 0, 0, 0, 3, 0, 0, 1, 4
"d:\IDEWORK\lvmen\src\licensedcode\data\rules\gpl-2.0_225.yml", "YAML", 0, 0, 0, 3, 0, 0, 1, 4
"d:\IDEWORK\lvmen\src\licensedcode\data\rules\gpl-2.0_226.yml", "YAML", 0, 0, 0, 4, 0, 0, 1, 5
"d:\IDEWORK\lvmen\src\licensedcode\data\rules\gpl-2.0_227.yml", "YAML", 0, 0, 0, 5, 0, 0, 1, 6
"d:\IDEWORK\lvmen\src\licensedcode\data\rules\gpl-2.0_228.yml", "YAML", 0, 0, 0, 3, 0, 0, 1, 4
"d:\IDEWORK\lvmen\src\licensedcode\data\rules\gpl-2.0_229.yml", "YAML", 0, 0, 0, 4, 0, 0, 1, 5
"d:\IDEWORK\lvmen\src\licensedcode\data\rules\gpl-2.0_23.yml", "YAML", 0, 0, 0, 3, 0, 0, 1, 4
"d:\IDEWORK\lvmen\src\licensedcode\data\rules\gpl-2.0_230.yml", "YAML", 0, 0, 0, 3, 0, 0, 1, 4
"d:\IDEWORK\lvmen\src\licensedcode\data\rules\gpl-2.0_231.yml", "YAML", 0, 0, 0, 3, 0, 0, 1, 4
"d:\IDEWORK\lvmen\src\licensedcode\data\rules\gpl-2.0_232.yml", "YAML", 0, 0, 0, 3, 0, 0, 1, 4
"d:\IDEWORK\lvmen\src\licensedcode\data\rules\gpl-2.0_233.yml", "YAML", 0, 0, 0, 4, 0, 0, 1, 5
"d:\IDEWORK\lvmen\src\licensedcode\data\rules\gpl-2.0_234.yml", "YAML", 0, 0, 0, 3, 0, 0, 1, 4
"d:\IDEWORK\lvmen\src\licensedcode\data\rules\gpl-2.0_235.yml", "YAML", 0, 0, 0, 2, 0, 0, 1, 3
"d:\IDEWORK\lvmen\src\licensedcode\data\rules\gpl-2.0_236.yml", "YAML", 0, 0, 0, 2, 0, 0, 1, 3
"d:\IDEWORK\lvmen\src\licensedcode\data\rules\gpl-2.0_237.yml", "YAML", 0, 0, 0, 3, 0, 0, 1, 4
"d:\IDEWORK\lvmen\src\licensedcode\data\rules\gpl-2.0_238.yml", "YAML", 0, 0, 0, 3, 0, 0, 1, 4
"d:\IDEWORK\lvmen\src\licensedcode\data\rules\gpl-2.0_239.yml", "YAML", 0, 0, 0, 3, 0, 0, 1, 4
"d:\IDEWORK\lvmen\src\licensedcode\data\rules\gpl-2.0_24.yml", "YAML", 0, 0, 0, 9, 0, 0, 1, 10
"d:\IDEWORK\lvmen\src\licensedcode\data\rules\gpl-2.0_240.yml", "YAML", 0, 0, 0, 5, 0, 0, 1, 6
"d:\IDEWORK\lvmen\src\licensedcode\data\rules\gpl-2.0_241.yml", "YAML", 0, 0, 0, 3, 0, 0, 1, 4
"d:\IDEWORK\lvmen\src\licensedcode\data\rules\gpl-2.0_242.yml", "YAML", 0, 0, 0, 8, 0, 0, 1, 9
"d:\IDEWORK\lvmen\src\licensedcode\data\rules\gpl-2.0_243.yml", "YAML", 0, 0, 0, 2, 0, 0, 1, 3
"d:\IDEWORK\lvmen\src\licensedcode\data\rules\gpl-2.0_244.yml", "YAML", 0, 0, 0, 4, 0, 0, 1, 5
"d:\IDEWORK\lvmen\src\licensedcode\data\rules\gpl-2.0_245.yml", "YAML", 0, 0, 0, 4, 0, 0, 1, 5
"d:\IDEWORK\lvmen\src\licensedcode\data\rules\gpl-2.0_246.yml", "YAML", 0, 0, 0, 2, 0, 0, 1, 3
"d:\IDEWORK\lvmen\src\licensedcode\data\rules\gpl-2.0_247.yml", "YAML", 0, 0, 0, 8, 0, 0, 1, 9
"d:\IDEWORK\lvmen\src\licensedcode\data\rules\gpl-2.0_248.yml", "YAML", 0, 0, 0, 4, 0, 0, 1, 5
"d:\IDEWORK\lvmen\src\licensedcode\data\rules\gpl-2.0_249.yml", "YAML", 0, 0, 0, 5, 0, 0, 1, 6
"d:\IDEWORK\lvmen\src\licensedcode\data\rules\gpl-2.0_25.yml", "YAML", 0, 0, 0, 2, 0, 0, 1, 3
"d:\IDEWORK\lvmen\src\licensedcode\data\rules\gpl-2.0_250.yml", "YAML", 0, 0, 0, 4, 0, 0, 1, 5
"d:\IDEWORK\lvmen\src\licensedcode\data\rules\gpl-2.0_251.yml", "YAML", 0, 0, 0, 4, 0, 0, 1, 5
"d:\IDEWORK\lvmen\src\licensedcode\data\rules\gpl-2.0_252.yml", "YAML", 0, 0, 0, 2, 0, 0, 1, 3
"d:\IDEWORK\lvmen\src\licensedcode\data\rules\gpl-2.0_253.yml", "YAML", 0, 0, 0, 2, 0, 0, 1, 3
"d:\IDEWORK\lvmen\src\licensedcode\data\rules\gpl-2.0_254.yml", "YAML", 0, 0, 0, 2, 0, 0, 1, 3
"d:\IDEWORK\lvmen\src\licensedcode\data\rules\gpl-2.0_255.yml", "YAML", 0, 0, 0, 2, 0, 0, 1, 3
"d:\IDEWORK\lvmen\src\licensedcode\data\rules\gpl-2.0_256.yml", "YAML", 0, 0, 0, 2, 0, 0, 1, 3
"d:\IDEWORK\lvmen\src\licensedcode\data\rules\gpl-2.0_257.yml", "YAML", 0, 0, 0, 5, 0, 0, 1, 6
"d:\IDEWORK\lvmen\src\licensedcode\data\rules\gpl-2.0_258.yml", "YAML", 0, 0, 0, 5, 0, 0, 1, 6
"d:\IDEWORK\lvmen\src\licensedcode\data\rules\gpl-2.0_259.yml", "YAML", 0, 0, 0, 2, 0, 0, 1, 3
"d:\IDEWORK\lvmen\src\licensedcode\data\rules\gpl-2.0_26.yml", "YAML", 0, 0, 0, 10, 0, 0, 1, 11
"d:\IDEWORK\lvmen\src\licensedcode\data\rules\gpl-2.0_260.yml", "YAML", 0, 0, 0, 2, 0, 0, 1, 3
"d:\IDEWORK\lvmen\src\licensedcode\data\rules\gpl-2.0_261.yml", "YAML", 0, 0, 0, 2, 0, 0, 1, 3
"d:\IDEWORK\lvmen\src\licensedcode\data\rules\gpl-2.0_262.yml", "YAML", 0, 0, 0, 2, 0, 0, 1, 3
"d:\IDEWORK\lvmen\src\licensedcode\data\rules\gpl-2.0_263.yml", "YAML", 0, 0, 0, 2, 0, 0, 1, 3
"d:\IDEWORK\lvmen\src\licensedcode\data\rules\gpl-2.0_264.yml", "YAML", 0, 0, 0, 2, 0, 0, 1, 3
"d:\IDEWORK\lvmen\src\licensedcode\data\rules\gpl-2.0_265.yml", "YAML", 0, 0, 0, 5, 0, 0, 1, 6
"d:\IDEWORK\lvmen\src\licensedcode\data\rules\gpl-2.0_266.yml", "YAML", 0, 0, 0, 2, 0, 0, 1, 3
"d:\IDEWORK\lvmen\src\licensedcode\data\rules\gpl-2.0_267.yml", "YAML", 0, 0, 0, 2, 0, 0, 1, 3
"d:\IDEWORK\lvmen\src\licensedcode\data\rules\gpl-2.0_268.yml", "YAML", 0, 0, 0, 4, 0, 0, 1, 5
"d:\IDEWORK\lvmen\src\licensedcode\data\rules\gpl-2.0_269.yml", "YAML", 0, 0, 0, 4, 0, 0, 1, 5
"d:\IDEWORK\lvmen\src\licensedcode\data\rules\gpl-2.0_269_1.yml", "YAML", 0, 0, 0, 7, 0, 0, 1, 8
"d:\IDEWORK\lvmen\src\licensedcode\data\rules\gpl-2.0_27.yml", "YAML", 0, 0, 0, 6, 0, 0, 1, 7
"d:\IDEWORK\lvmen\src\licensedcode\data\rules\gpl-2.0_270.yml", "YAML", 0, 0, 0, 2, 0, 0, 1, 3
"d:\IDEWORK\lvmen\src\licensedcode\data\rules\gpl-2.0_271.yml", "YAML", 0, 0, 0, 2, 0, 0, 1, 3
"d:\IDEWORK\lvmen\src\licensedcode\data\rules\gpl-2.0_272.yml", "YAML", 0, 0, 0, 2, 0, 0, 1, 3
"d:\IDEWORK\lvmen\src\licensedcode\data\rules\gpl-2.0_273.yml", "YAML", 0, 0, 0, 2, 0, 0, 1, 3
"d:\IDEWORK\lvmen\src\licensedcode\data\rules\gpl-2.0_274.yml", "YAML", 0, 0, 0, 2, 0, 0, 1, 3
"d:\IDEWORK\lvmen\src\licensedcode\data\rules\gpl-2.0_275.yml", "YAML", 0, 0, 0, 2, 0, 0, 1, 3
"d:\IDEWORK\lvmen\src\licensedcode\data\rules\gpl-2.0_276.yml", "YAML", 0, 0, 0, 2, 0, 0, 1, 3
"d:\IDEWORK\lvmen\src\licensedcode\data\rules\gpl-2.0_277.yml", "YAML", 0, 0, 0, 2, 0, 0, 1, 3
"d:\IDEWORK\lvmen\src\licensedcode\data\rules\gpl-2.0_278.yml", "YAML", 0, 0, 0, 2, 0, 0, 1, 3
"d:\IDEWORK\lvmen\src\licensedcode\data\rules\gpl-2.0_279.yml", "YAML", 0, 0, 0, 2, 0, 0, 1, 3
"d:\IDEWORK\lvmen\src\licensedcode\data\rules\gpl-2.0_28.yml", "YAML", 0, 0, 0, 2, 0, 0, 1, 3
"d:\IDEWORK\lvmen\src\licensedcode\data\rules\gpl-2.0_280.yml", "YAML", 0, 0, 0, 2, 0, 0, 1, 3
"d:\IDEWORK\lvmen\src\licensedcode\data\rules\gpl-2.0_281.yml", "YAML", 0, 0, 0, 2, 0, 0, 1, 3
"d:\IDEWORK\lvmen\src\licensedcode\data\rules\gpl-2.0_282.yml", "YAML", 0, 0, 0, 2, 0, 0, 1, 3
"d:\IDEWORK\lvmen\src\licensedcode\data\rules\gpl-2.0_283.yml", "YAML", 0, 0, 0, 5, 0, 0, 1, 6
"d:\IDEWORK\lvmen\src\licensedcode\data\rules\gpl-2.0_284.yml", "YAML", 0, 0, 0, 5, 0, 0, 1, 6
"d:\IDEWORK\lvmen\src\licensedcode\data\rules\gpl-2.0_285.yml", "YAML", 0, 0, 0, 2, 0, 0, 1, 3
"d:\IDEWORK\lvmen\src\licensedcode\data\rules\gpl-2.0_286.yml", "YAML", 0, 0, 0, 2, 0, 0, 1, 3
"d:\IDEWORK\lvmen\src\licensedcode\data\rules\gpl-2.0_287.yml", "YAML", 0, 0, 0, 2, 0, 0, 1, 3
"d:\IDEWORK\lvmen\src\licensedcode\data\rules\gpl-2.0_288.yml", "YAML", 0, 0, 0, 2, 0, 0, 1, 3
"d:\IDEWORK\lvmen\src\licensedcode\data\rules\gpl-2.0_289.yml", "YAML", 0, 0, 0, 5, 0, 0, 1, 6
"d:\IDEWORK\lvmen\src\licensedcode\data\rules\gpl-2.0_29.yml", "YAML", 0, 0, 0, 5, 0, 0, 1, 6
"d:\IDEWORK\lvmen\src\licensedcode\data\rules\gpl-2.0_290.yml", "YAML", 0, 0, 0, 2, 0, 0, 1, 3
"d:\IDEWORK\lvmen\src\licensedcode\data\rules\gpl-2.0_291.yml", "YAML", 0, 0, 0, 2, 0, 0, 1, 3
"d:\IDEWORK\lvmen\src\licensedcode\data\rules\gpl-2.0_292.yml", "YAML", 0, 0, 0, 4, 0, 0, 1, 5
"d:\IDEWORK\lvmen\src\licensedcode\data\rules\gpl-2.0_293.yml", "YAML", 0, 0, 0, 2, 0, 0, 1, 3
"d:\IDEWORK\lvmen\src\licensedcode\data\rules\gpl-2.0_294.yml", "YAML", 0, 0, 0, 4, 0, 0, 1, 5
"d:\IDEWORK\lvmen\src\licensedcode\data\rules\gpl-2.0_295.yml", "YAML", 0, 0, 0, 2, 0, 0, 1, 3
"d:\IDEWORK\lvmen\src\licensedcode\data\rules\gpl-2.0_296.yml", "YAML", 0, 0, 0, 2, 0, 0, 1, 3
"d:\IDEWORK\lvmen\src\licensedcode\data\rules\gpl-2.0_297.yml", "YAML", 0, 0, 0, 2, 0, 0, 1, 3
"d:\IDEWORK\lvmen\src\licensedcode\data\rules\gpl-2.0_298.yml", "YAML", 0, 0, 0, 2, 0, 0, 1, 3
"d:\IDEWORK\lvmen\src\licensedcode\data\rules\gpl-2.0_299.yml", "YAML", 0, 0, 0, 4, 0, 0, 1, 5
"d:\IDEWORK\lvmen\src\licensedcode\data\rules\gpl-2.0_3.yml", "YAML", 0, 0, 0, 2, 0, 0, 1, 3
"d:\IDEWORK\lvmen\src\licensedcode\data\rules\gpl-2.0_30.yml", "YAML", 0, 0, 0, 4, 0, 0, 1, 5
"d:\IDEWORK\lvmen\src\licensedcode\data\rules\gpl-2.0_300.yml", "YAML", 0, 0, 0, 3, 0, 0, 1, 4
"d:\IDEWORK\lvmen\src\licensedcode\data\rules\gpl-2.0_301.yml", "YAML", 0, 0, 0, 3, 0, 0, 1, 4
"d:\IDEWORK\lvmen\src\licensedcode\data\rules\gpl-2.0_302.yml", "YAML", 0, 0, 0, 3, 0, 0, 1, 4
"d:\IDEWORK\lvmen\src\licensedcode\data\rules\gpl-2.0_303.yml", "YAML", 0, 0, 0, 3, 0, 0, 1, 4
"d:\IDEWORK\lvmen\src\licensedcode\data\rules\gpl-2.0_304.yml", "YAML", 0, 0, 0, 2, 0, 0, 1, 3
"d:\IDEWORK\lvmen\src\licensedcode\data\rules\gpl-2.0_305.yml", "YAML", 0, 0, 0, 6, 0, 0, 1, 7
"d:\IDEWORK\lvmen\src\licensedcode\data\rules\gpl-2.0_306.yml", "YAML", 0, 0, 0, 2, 0, 0, 1, 3
"d:\IDEWORK\lvmen\src\licensedcode\data\rules\gpl-2.0_307.yml", "YAML", 0, 0, 0, 5, 0, 0, 1, 6
"d:\IDEWORK\lvmen\src\licensedcode\data\rules\gpl-2.0_308.yml", "YAML", 0, 0, 0, 2, 0, 0, 1, 3
"d:\IDEWORK\lvmen\src\licensedcode\data\rules\gpl-2.0_309.yml", "YAML", 0, 0, 0, 2, 0, 0, 1, 3
"d:\IDEWORK\lvmen\src\licensedcode\data\rules\gpl-2.0_31.yml", "YAML", 0, 0, 0, 4, 0, 0, 1, 5
"d:\IDEWORK\lvmen\src\licensedcode\data\rules\gpl-2.0_310.yml", "YAML", 0, 0, 0, 3, 0, 0, 1, 4
"d:\IDEWORK\lvmen\src\licensedcode\data\rules\gpl-2.0_311.yml", "YAML", 0, 0, 0, 4, 0, 0, 1, 5
"d:\IDEWORK\lvmen\src\licensedcode\data\rules\gpl-2.0_312.yml", "YAML", 0, 0, 0, 5, 0, 0, 1, 6
"d:\IDEWORK\lvmen\src\licensedcode\data\rules\gpl-2.0_313.yml", "YAML", 0, 0, 0, 5, 0, 0, 1, 6
"d:\IDEWORK\lvmen\src\licensedcode\data\rules\gpl-2.0_314.yml", "YAML", 0, 0, 0, 4, 0, 0, 1, 5
"d:\IDEWORK\lvmen\src\licensedcode\data\rules\gpl-2.0_315.yml", "YAML", 0, 0, 0, 5, 0, 0, 1, 6
"d:\IDEWORK\lvmen\src\licensedcode\data\rules\gpl-2.0_316.yml", "YAML", 0, 0, 0, 3, 0, 0, 1, 4
"d:\IDEWORK\lvmen\src\licensedcode\data\rules\gpl-2.0_317.yml", "YAML", 0, 0, 0, 2, 0, 0, 1, 3
"d:\IDEWORK\lvmen\src\licensedcode\data\rules\gpl-2.0_318.yml", "YAML", 0, 0, 0, 2, 0, 0, 1, 3
"d:\IDEWORK\lvmen\src\licensedcode\data\rules\gpl-2.0_319.yml", "YAML", 0, 0, 0, 2, 0, 0, 1, 3
"d:\IDEWORK\lvmen\src\licensedcode\data\rules\gpl-2.0_32.yml", "YAML", 0, 0, 0, 8, 0, 0, 1, 9
"d:\IDEWORK\lvmen\src\licensedcode\data\rules\gpl-2.0_320.yml", "YAML", 0, 0, 0, 2, 0, 0, 1, 3
"d:\IDEWORK\lvmen\src\licensedcode\data\rules\gpl-2.0_321.yml", "YAML", 0, 0, 0, 2, 0, 0, 1, 3
"d:\IDEWORK\lvmen\src\licensedcode\data\rules\gpl-2.0_322.yml", "YAML", 0, 0, 0, 4, 0, 0, 1, 5
"d:\IDEWORK\lvmen\src\licensedcode\data\rules\gpl-2.0_323.yml", "YAML", 0, 0, 0, 2, 0, 0, 1, 3
"d:\IDEWORK\lvmen\src\licensedcode\data\rules\gpl-2.0_324.yml", "YAML", 0, 0, 0, 2, 0, 0, 1, 3
"d:\IDEWORK\lvmen\src\licensedcode\data\rules\gpl-2.0_325.yml", "YAML", 0, 0, 0, 5, 0, 0, 1, 6
"d:\IDEWORK\lvmen\src\licensedcode\data\rules\gpl-2.0_325_1.yml", "YAML", 0, 0, 0, 4, 0, 0, 1, 5
"d:\IDEWORK\lvmen\src\licensedcode\data\rules\gpl-2.0_325_2.yml", "YAML", 0, 0, 0, 4, 0, 0, 1, 5
"d:\IDEWORK\lvmen\src\licensedcode\data\rules\gpl-2.0_325_3.yml", "YAML", 0, 0, 0, 5, 0, 0, 1, 6
"d:\IDEWORK\lvmen\src\licensedcode\data\rules\gpl-2.0_326.yml", "YAML", 0, 0, 0, 2, 0, 0, 1, 3
"d:\IDEWORK\lvmen\src\licensedcode\data\rules\gpl-2.0_327.yml", "YAML", 0, 0, 0, 2, 0, 0, 1, 3
"d:\IDEWORK\lvmen\src\licensedcode\data\rules\gpl-2.0_328.yml", "YAML", 0, 0, 0, 2, 0, 0, 1, 3
"d:\IDEWORK\lvmen\src\licensedcode\data\rules\gpl-2.0_329.yml", "YAML", 0, 0, 0, 2, 0, 0, 1, 3
"d:\IDEWORK\lvmen\src\licensedcode\data\rules\gpl-2.0_33.yml", "YAML", 0, 0, 0, 3, 0, 0, 1, 4
"d:\IDEWORK\lvmen\src\licensedcode\data\rules\gpl-2.0_330.yml", "YAML", 0, 0, 0, 3, 0, 0, 1, 4
"d:\IDEWORK\lvmen\src\licensedcode\data\rules\gpl-2.0_331.yml", "YAML", 0, 0, 0, 6, 0, 0, 1, 7
"d:\IDEWORK\lvmen\src\licensedcode\data\rules\gpl-2.0_332.yml", "YAML", 0, 0, 0, 4, 0, 0, 1, 5
"d:\IDEWORK\lvmen\src\licensedcode\data\rules\gpl-2.0_333.yml", "YAML", 0, 0, 0, 4, 0, 0, 1, 5
"d:\IDEWORK\lvmen\src\licensedcode\data\rules\gpl-2.0_334.yml", "YAML", 0, 0, 0, 3, 0, 0, 1, 4
"d:\IDEWORK\lvmen\src\licensedcode\data\rules\gpl-2.0_335.yml", "YAML", 0, 0, 0, 4, 0, 0, 1, 5
"d:\IDEWORK\lvmen\src\licensedcode\data\rules\gpl-2.0_336.yml", "YAML", 0, 0, 0, 5, 0, 0, 1, 6
"d:\IDEWORK\lvmen\src\licensedcode\data\rules\gpl-2.0_337.yml", "YAML", 0, 0, 0, 5, 0, 0, 1, 6
"d:\IDEWORK\lvmen\src\licensedcode\data\rules\gpl-2.0_338.yml", "YAML", 0, 0, 0, 5, 0, 0, 1, 6
"d:\IDEWORK\lvmen\src\licensedcode\data\rules\gpl-2.0_339.yml", "YAML", 0, 0, 0, 2, 0, 0, 1, 3
"d:\IDEWORK\lvmen\src\licensedcode\data\rules\gpl-2.0_34.yml", "YAML", 0, 0, 0, 3, 0, 0, 1, 4
"d:\IDEWORK\lvmen\src\licensedcode\data\rules\gpl-2.0_340.yml", "YAML", 0, 0, 0, 2, 0, 0, 1, 3
"d:\IDEWORK\lvmen\src\licensedcode\data\rules\gpl-2.0_341.yml", "YAML", 0, 0, 0, 3, 0, 0, 1, 4
"d:\IDEWORK\lvmen\src\licensedcode\data\rules\gpl-2.0_342.yml", "YAML", 0, 0, 0, 2, 0, 0, 1, 3
"d:\IDEWORK\lvmen\src\licensedcode\data\rules\gpl-2.0_343.yml", "YAML", 0, 0, 0, 3, 0, 0, 1, 4
"d:\IDEWORK\lvmen\src\licensedcode\data\rules\gpl-2.0_344.yml", "YAML", 0, 0, 0, 2, 0, 0, 1, 3
"d:\IDEWORK\lvmen\src\licensedcode\data\rules\gpl-2.0_345.yml", "YAML", 0, 0, 0, 2, 0, 0, 1, 3
"d:\IDEWORK\lvmen\src\licensedcode\data\rules\gpl-2.0_346.yml", "YAML", 0, 0, 0, 2, 0, 0, 1, 3
"d:\IDEWORK\lvmen\src\licensedcode\data\rules\gpl-2.0_347.yml", "YAML", 0, 0, 0, 5, 0, 0, 1, 6
"d:\IDEWORK\lvmen\src\licensedcode\data\rules\gpl-2.0_348.yml", "YAML", 0, 0, 0, 5, 0, 0, 1, 6
"d:\IDEWORK\lvmen\src\licensedcode\data\rules\gpl-2.0_349.yml", "YAML", 0, 0, 0, 2, 0, 0, 1, 3
"d:\IDEWORK\lvmen\src\licensedcode\data\rules\gpl-2.0_35.yml", "YAML", 0, 0, 0, 3, 0, 0, 1, 4
"d:\IDEWORK\lvmen\src\licensedcode\data\rules\gpl-2.0_350.yml", "YAML", 0, 0, 0, 4, 0, 0, 1, 5
"d:\IDEWORK\lvmen\src\licensedcode\data\rules\gpl-2.0_351.yml", "YAML", 0, 0, 0, 3, 0, 0, 1, 4
"d:\IDEWORK\lvmen\src\licensedcode\data\rules\gpl-2.0_352.yml", "YAML", 0, 0, 0, 4, 0, 0, 1, 5
"d:\IDEWORK\lvmen\src\licensedcode\data\rules\gpl-2.0_353.yml", "YAML", 0, 0, 0, 4, 0, 0, 1, 5
"d:\IDEWORK\lvmen\src\licensedcode\data\rules\gpl-2.0_354.yml", "YAML", 0, 0, 0, 4, 0, 0, 1, 5
"d:\IDEWORK\lvmen\src\licensedcode\data\rules\gpl-2.0_355.yml", "YAML", 0, 0, 0, 4, 0, 0, 1, 5
"d:\IDEWORK\lvmen\src\licensedcode\data\rules\gpl-2.0_356.yml", "YAML", 0, 0, 0, 4, 0, 0, 1, 5
"d:\IDEWORK\lvmen\src\licensedcode\data\rules\gpl-2.0_357.yml", "YAML", 0, 0, 0, 4, 0, 0, 1, 5
"d:\IDEWORK\lvmen\src\licensedcode\data\rules\gpl-2.0_358.yml", "YAML", 0, 0, 0, 3, 0, 0, 1, 4
"d:\IDEWORK\lvmen\src\licensedcode\data\rules\gpl-2.0_359.yml", "YAML", 0, 0, 0, 7, 0, 0, 1, 8
"d:\IDEWORK\lvmen\src\licensedcode\data\rules\gpl-2.0_36.yml", "YAML", 0, 0, 0, 5, 0, 0, 1, 6
"d:\IDEWORK\lvmen\src\licensedcode\data\rules\gpl-2.0_360.yml", "YAML", 0, 0, 0, 6, 0, 0, 1, 7
"d:\IDEWORK\lvmen\src\licensedcode\data\rules\gpl-2.0_361.yml", "YAML", 0, 0, 0, 5, 0, 0, 1, 6
"d:\IDEWORK\lvmen\src\licensedcode\data\rules\gpl-2.0_362.yml", "YAML", 0, 0, 0, 5, 0, 0, 1, 6
"d:\IDEWORK\lvmen\src\licensedcode\data\rules\gpl-2.0_363.yml", "YAML", 0, 0, 0, 3, 0, 0, 1, 4
"d:\IDEWORK\lvmen\src\licensedcode\data\rules\gpl-2.0_364.yml", "YAML", 0, 0, 0, 2, 0, 0, 1, 3
"d:\IDEWORK\lvmen\src\licensedcode\data\rules\gpl-2.0_365.yml", "YAML", 0, 0, 0, 2, 0, 0, 1, 3
"d:\IDEWORK\lvmen\src\licensedcode\data\rules\gpl-2.0_366.yml", "YAML", 0, 0, 0, 5, 0, 0, 1, 6
"d:\IDEWORK\lvmen\src\licensedcode\data\rules\gpl-2.0_367.yml", "YAML", 0, 0, 0, 3, 0, 0, 1, 4
"d:\IDEWORK\lvmen\src\licensedcode\data\rules\gpl-2.0_368.yml", "YAML", 0, 0, 0, 7, 0, 0, 1, 8
"d:\IDEWORK\lvmen\src\licensedcode\data\rules\gpl-2.0_369.yml", "YAML", 0, 0, 0, 7, 0, 0, 1, 8
"d:\IDEWORK\lvmen\src\licensedcode\data\rules\gpl-2.0_37.yml", "YAML", 0, 0, 0, 4, 0, 0, 1, 5
"d:\IDEWORK\lvmen\src\licensedcode\data\rules\gpl-2.0_370.yml", "YAML", 0, 0, 0, 7, 0, 0, 1, 8
"d:\IDEWORK\lvmen\src\licensedcode\data\rules\gpl-2.0_371.yml", "YAML", 0, 0, 0, 7, 0, 0, 1, 8
"d:\IDEWORK\lvmen\src\licensedcode\data\rules\gpl-2.0_372.yml", "YAML", 0, 0, 0, 4, 0, 0, 1, 5
"d:\IDEWORK\lvmen\src\licensedcode\data\rules\gpl-2.0_373.yml", "YAML", 0, 0, 0, 2, 0, 0, 1, 3
"d:\IDEWORK\lvmen\src\licensedcode\data\rules\gpl-2.0_374.yml", "YAML", 0, 0, 0, 3, 0, 0, 1, 4
"d:\IDEWORK\lvmen\src\licensedcode\data\rules\gpl-2.0_375.yml", "YAML", 0, 0, 0, 7, 0, 0, 1, 8
"d:\IDEWORK\lvmen\src\licensedcode\data\rules\gpl-2.0_376.yml", "YAML", 0, 0, 0, 3, 0, 0, 1, 4
"d:\IDEWORK\lvmen\src\licensedcode\data\rules\gpl-2.0_377.yml", "YAML", 0, 0, 0, 4, 0, 0, 1, 5
"d:\IDEWORK\lvmen\src\licensedcode\data\rules\gpl-2.0_378.yml", "YAML", 0, 0, 0, 2, 0, 0, 1, 3
"d:\IDEWORK\lvmen\src\licensedcode\data\rules\gpl-2.0_379.yml", "YAML", 0, 0, 0, 3, 0, 0, 1, 4
"d:\IDEWORK\lvmen\src\licensedcode\data\rules\gpl-2.0_38.yml", "YAML", 0, 0, 0, 9, 0, 0, 1, 10
"d:\IDEWORK\lvmen\src\licensedcode\data\rules\gpl-2.0_380.yml", "YAML", 0, 0, 0, 2, 0, 0, 1, 3
"d:\IDEWORK\lvmen\src\licensedcode\data\rules\gpl-2.0_381.yml", "YAML", 0, 0, 0, 5, 0, 0, 1, 6
"d:\IDEWORK\lvmen\src\licensedcode\data\rules\gpl-2.0_382.yml", "YAML", 0, 0, 0, 4, 0, 0, 1, 5
"d:\IDEWORK\lvmen\src\licensedcode\data\rules\gpl-2.0_383.yml", "YAML", 0, 0, 0, 11, 0, 0, 1, 12
"d:\IDEWORK\lvmen\src\licensedcode\data\rules\gpl-2.0_384.yml", "YAML", 0, 0, 0, 5, 0, 0, 1, 6
"d:\IDEWORK\lvmen\src\licensedcode\data\rules\gpl-2.0_385.yml", "YAML", 0, 0, 0, 3, 0, 0, 1, 4
"d:\IDEWORK\lvmen\src\licensedcode\data\rules\gpl-2.0_386.yml", "YAML", 0, 0, 0, 3, 0, 0, 1, 4
"d:\IDEWORK\lvmen\src\licensedcode\data\rules\gpl-2.0_387.yml", "YAML", 0, 0, 0, 5, 0, 0, 1, 6
"d:\IDEWORK\lvmen\src\licensedcode\data\rules\gpl-2.0_388.yml", "YAML", 0, 0, 0, 6, 0, 0, 1, 7
"d:\IDEWORK\lvmen\src\licensedcode\data\rules\gpl-2.0_389.yml", "YAML", 0, 0, 0, 5, 0, 0, 1, 6
"d:\IDEWORK\lvmen\src\licensedcode\data\rules\gpl-2.0_39.yml", "YAML", 0, 0, 0, 4, 0, 0, 1, 5
"d:\IDEWORK\lvmen\src\licensedcode\data\rules\gpl-2.0_390.yml", "YAML", 0, 0, 0, 4, 0, 0, 1, 5
"d:\IDEWORK\lvmen\src\licensedcode\data\rules\gpl-2.0_391.yml", "YAML", 0, 0, 0, 4, 0, 0, 1, 5
"d:\IDEWORK\lvmen\src\licensedcode\data\rules\gpl-2.0_392.yml", "YAML", 0, 0, 0, 4, 0, 0, 1, 5
"d:\IDEWORK\lvmen\src\licensedcode\data\rules\gpl-2.0_393.yml", "YAML", 0, 0, 0, 4, 0, 0, 1, 5
"d:\IDEWORK\lvmen\src\licensedcode\data\rules\gpl-2.0_394.yml", "YAML", 0, 0, 0, 4, 0, 0, 1, 5
"d:\IDEWORK\lvmen\src\licensedcode\data\rules\gpl-2.0_395.yml", "YAML", 0, 0, 0, 4, 0, 0, 1, 5
"d:\IDEWORK\lvmen\src\licensedcode\data\rules\gpl-2.0_396.yml", "YAML", 0, 0, 0, 2, 0, 0, 1, 3
"d:\IDEWORK\lvmen\src\licensedcode\data\rules\gpl-2.0_397.yml", "YAML", 0, 0, 0, 3, 0, 0, 1, 4
"d:\IDEWORK\lvmen\src\licensedcode\data\rules\gpl-2.0_398.yml", "YAML", 0, 0, 0, 3, 0, 0, 1, 4
"d:\IDEWORK\lvmen\src\licensedcode\data\rules\gpl-2.0_399.yml", "YAML", 0, 0, 0, 3, 0, 0, 1, 4
"d:\IDEWORK\lvmen\src\licensedcode\data\rules\gpl-2.0_4.yml", "YAML", 0, 0, 0, 2, 0, 0, 1, 3
"d:\IDEWORK\lvmen\src\licensedcode\data\rules\gpl-2.0_40.yml", "YAML", 0, 0, 0, 5, 0, 0, 1, 6
"d:\IDEWORK\lvmen\src\licensedcode\data\rules\gpl-2.0_400.yml", "YAML", 0, 0, 0, 2, 0, 0, 1, 3
"d:\IDEWORK\lvmen\src\licensedcode\data\rules\gpl-2.0_401.yml", "YAML", 0, 0, 0, 4, 0, 0, 1, 5
"d:\IDEWORK\lvmen\src\licensedcode\data\rules\gpl-2.0_402.yml", "YAML", 0, 0, 0, 5, 0, 0, 1, 6
"d:\IDEWORK\lvmen\src\licensedcode\data\rules\gpl-2.0_403.yml", "YAML", 0, 0, 0, 3, 0, 0, 1, 4
"d:\IDEWORK\lvmen\src\licensedcode\data\rules\gpl-2.0_404.yml", "YAML", 0, 0, 0, 2, 0, 0, 1, 3
"d:\IDEWORK\lvmen\src\licensedcode\data\rules\gpl-2.0_405.yml", "YAML", 0, 0, 0, 3, 0, 0, 1, 4
"d:\IDEWORK\lvmen\src\licensedcode\data\rules\gpl-2.0_406.yml", "YAML", 0, 0, 0, 3, 0, 0, 1, 4
"d:\IDEWORK\lvmen\src\licensedcode\data\rules\gpl-2.0_407.yml", "YAML", 0, 0, 0, 2, 0, 0, 1, 3
"d:\IDEWORK\lvmen\src\licensedcode\data\rules\gpl-2.0_408.yml", "YAML", 0, 0, 0, 2, 0, 0, 1, 3
"d:\IDEWORK\lvmen\src\licensedcode\data\rules\gpl-2.0_409.yml", "YAML", 0, 0, 0, 2, 0, 0, 1, 3
"d:\IDEWORK\lvmen\src\licensedcode\data\rules\gpl-2.0_41.yml", "YAML", 0, 0, 0, 9, 0, 0, 1, 10
"d:\IDEWORK\lvmen\src\licensedcode\data\rules\gpl-2.0_410.yml", "YAML", 0, 0, 0, 4, 0, 0, 1, 5
"d:\IDEWORK\lvmen\src\licensedcode\data\rules\gpl-2.0_411.yml", "YAML", 0, 0, 0, 4, 0, 0, 1, 5
"d:\IDEWORK\lvmen\src\licensedcode\data\rules\gpl-2.0_412.yml", "YAML", 0, 0, 0, 4, 0, 0, 1, 5
"d:\IDEWORK\lvmen\src\licensedcode\data\rules\gpl-2.0_413.yml", "YAML", 0, 0, 0, 4, 0, 0, 1, 5
"d:\IDEWORK\lvmen\src\licensedcode\data\rules\gpl-2.0_414.yml", "YAML", 0, 0, 0, 2, 0, 0, 1, 3
"d:\IDEWORK\lvmen\src\licensedcode\data\rules\gpl-2.0_415.yml", "YAML", 0, 0, 0, 2, 0, 0, 1, 3
"d:\IDEWORK\lvmen\src\licensedcode\data\rules\gpl-2.0_416.yml", "YAML", 0, 0, 0, 2, 0, 0, 1, 3
"d:\IDEWORK\lvmen\src\licensedcode\data\rules\gpl-2.0_417.yml", "YAML", 0, 0, 0, 4, 0, 0, 1, 5
"d:\IDEWORK\lvmen\src\licensedcode\data\rules\gpl-2.0_418.yml", "YAML", 0, 0, 0, 4, 0, 0, 1, 5
"d:\IDEWORK\lvmen\src\licensedcode\data\rules\gpl-2.0_419.yml", "YAML", 0, 0, 0, 2, 0, 0, 1, 3
"d:\IDEWORK\lvmen\src\licensedcode\data\rules\gpl-2.0_42.yml", "YAML", 0, 0, 0, 6, 0, 0, 1, 7
"d:\IDEWORK\lvmen\src\licensedcode\data\rules\gpl-2.0_420.yml", "YAML", 0, 0, 0, 3, 0, 0, 1, 4
"d:\IDEWORK\lvmen\src\licensedcode\data\rules\gpl-2.0_421.yml", "YAML", 0, 0, 0, 4, 0, 0, 1, 5
"d:\IDEWORK\lvmen\src\licensedcode\data\rules\gpl-2.0_422.yml", "YAML", 0, 0, 0, 2, 0, 0, 1, 3
"d:\IDEWORK\lvmen\src\licensedcode\data\rules\gpl-2.0_423.yml", "YAML", 0, 0, 0, 2, 0, 0, 1, 3
"d:\IDEWORK\lvmen\src\licensedcode\data\rules\gpl-2.0_424.yml", "YAML", 0, 0, 0, 4, 0, 0, 1, 5
"d:\IDEWORK\lvmen\src\licensedcode\data\rules\gpl-2.0_425.yml", "YAML", 0, 0, 0, 2, 0, 0, 1, 3
"d:\IDEWORK\lvmen\src\licensedcode\data\rules\gpl-2.0_426.yml", "YAML", 0, 0, 0, 2, 0, 0, 1, 3
"d:\IDEWORK\lvmen\src\licensedcode\data\rules\gpl-2.0_427.yml", "YAML", 0, 0, 0, 2, 0, 0, 1, 3
"d:\IDEWORK\lvmen\src\licensedcode\data\rules\gpl-2.0_428.yml", "YAML", 0, 0, 0, 4, 0, 0, 1, 5
"d:\IDEWORK\lvmen\src\licensedcode\data\rules\gpl-2.0_429.yml", "YAML", 0, 0, 0, 2, 0, 0, 1, 3
"d:\IDEWORK\lvmen\src\licensedcode\data\rules\gpl-2.0_43.yml", "YAML", 0, 0, 0, 3, 0, 0, 1, 4
"d:\IDEWORK\lvmen\src\licensedcode\data\rules\gpl-2.0_430.yml", "YAML", 0, 0, 0, 2, 0, 0, 1, 3
"d:\IDEWORK\lvmen\src\licensedcode\data\rules\gpl-2.0_431.yml", "YAML", 0, 0, 0, 2, 0, 0, 1, 3
"d:\IDEWORK\lvmen\src\licensedcode\data\rules\gpl-2.0_432.yml", "YAML", 0, 0, 0, 2, 0, 0, 1, 3
"d:\IDEWORK\lvmen\src\licensedcode\data\rules\gpl-2.0_433.yml", "YAML", 0, 0, 0, 2, 0, 0, 1, 3
"d:\IDEWORK\lvmen\src\licensedcode\data\rules\gpl-2.0_434.yml", "YAML", 0, 0, 0, 2, 0, 0, 1, 3
"d:\IDEWORK\lvmen\src\licensedcode\data\rules\gpl-2.0_435.yml", "YAML", 0, 0, 0, 2, 0, 0, 1, 3
"d:\IDEWORK\lvmen\src\licensedcode\data\rules\gpl-2.0_436.yml", "YAML", 0, 0, 0, 4, 0, 0, 1, 5
"d:\IDEWORK\lvmen\src\licensedcode\data\rules\gpl-2.0_437.yml", "YAML", 0, 0, 0, 4, 0, 0, 1, 5
"d:\IDEWORK\lvmen\src\licensedcode\data\rules\gpl-2.0_438.yml", "YAML", 0, 0, 0, 4, 0, 0, 1, 5
"d:\IDEWORK\lvmen\src\licensedcode\data\rules\gpl-2.0_439.yml", "YAML", 0, 0, 0, 2, 0, 0, 1, 3
"d:\IDEWORK\lvmen\src\licensedcode\data\rules\gpl-2.0_44.yml", "YAML", 0, 0, 0, 2, 0, 0, 1, 3
"d:\IDEWORK\lvmen\src\licensedcode\data\rules\gpl-2.0_440.yml", "YAML", 0, 0, 0, 2, 0, 0, 1, 3
"d:\IDEWORK\lvmen\src\licensedcode\data\rules\gpl-2.0_441.yml", "YAML", 0, 0, 0, 2, 0, 0, 1, 3
"d:\IDEWORK\lvmen\src\licensedcode\data\rules\gpl-2.0_442.yml", "YAML", 0, 0, 0, 2, 0, 0, 1, 3
"d:\IDEWORK\lvmen\src\licensedcode\data\rules\gpl-2.0_443.yml", "YAML", 0, 0, 0, 2, 0, 0, 1, 3
"d:\IDEWORK\lvmen\src\licensedcode\data\rules\gpl-2.0_444.yml", "YAML", 0, 0, 0, 2, 0, 0, 1, 3
"d:\IDEWORK\lvmen\src\licensedcode\data\rules\gpl-2.0_445.yml", "YAML", 0, 0, 0, 2, 0, 0, 1, 3
"d:\IDEWORK\lvmen\src\licensedcode\data\rules\gpl-2.0_446.yml", "YAML", 0, 0, 0, 4, 0, 0, 1, 5
"d:\IDEWORK\lvmen\src\licensedcode\data\rules\gpl-2.0_447.yml", "YAML", 0, 0, 0, 2, 0, 0, 1, 3
"d:\IDEWORK\lvmen\src\licensedcode\data\rules\gpl-2.0_448.yml", "YAML", 0, 0, 0, 2, 0, 0, 1, 3
"d:\IDEWORK\lvmen\src\licensedcode\data\rules\gpl-2.0_449.yml", "YAML", 0, 0, 0, 4, 0, 0, 1, 5
"d:\IDEWORK\lvmen\src\licensedcode\data\rules\gpl-2.0_45.yml", "YAML", 0, 0, 0, 3, 0, 0, 1, 4
"d:\IDEWORK\lvmen\src\licensedcode\data\rules\gpl-2.0_450.yml", "YAML", 0, 0, 0, 2, 0, 0, 1, 3
"d:\IDEWORK\lvmen\src\licensedcode\data\rules\gpl-2.0_451.yml", "YAML", 0, 0, 0, 3, 0, 0, 2, 5
"d:\IDEWORK\lvmen\src\licensedcode\data\rules\gpl-2.0_452.yml", "YAML", 0, 0, 0, 2, 0, 0, 1, 3
"d:\IDEWORK\lvmen\src\licensedcode\data\rules\gpl-2.0_453.yml", "YAML", 0, 0, 0, 2, 0, 0, 1, 3
"d:\IDEWORK\lvmen\src\licensedcode\data\rules\gpl-2.0_454.yml", "YAML", 0, 0, 0, 2, 0, 0, 1, 3
"d:\IDEWORK\lvmen\src\licensedcode\data\rules\gpl-2.0_455.yml", "YAML", 0, 0, 0, 2, 0, 0, 1, 3
"d:\IDEWORK\lvmen\src\licensedcode\data\rules\gpl-2.0_456.yml", "YAML", 0, 0, 0, 2, 0, 0, 1, 3
"d:\IDEWORK\lvmen\src\licensedcode\data\rules\gpl-2.0_456_1.yml", "YAML", 0, 0, 0, 2, 0, 0, 1, 3
"d:\IDEWORK\lvmen\src\licensedcode\data\rules\gpl-2.0_457.yml", "YAML", 0, 0, 0, 2, 0, 0, 1, 3
"d:\IDEWORK\lvmen\src\licensedcode\data\rules\gpl-2.0_458.yml", "YAML", 0, 0, 0, 2, 0, 0, 1, 3
"d:\IDEWORK\lvmen\src\licensedcode\data\rules\gpl-2.0_459.yml", "YAML", 0, 0, 0, 4, 0, 0, 1, 5
"d:\IDEWORK\lvmen\src\licensedcode\data\rules\gpl-2.0_46.yml", "YAML", 0, 0, 0, 3, 0, 0, 1, 4
"d:\IDEWORK\lvmen\src\licensedcode\data\rules\gpl-2.0_460.yml", "YAML", 0, 0, 0, 2, 0, 0, 1, 3
"d:\IDEWORK\lvmen\src\licensedcode\data\rules\gpl-2.0_461.yml", "YAML", 0, 0, 0, 3, 0, 0, 1, 4
"d:\IDEWORK\lvmen\src\licensedcode\data\rules\gpl-2.0_462.yml", "YAML", 0, 0, 0, 2, 0, 0, 1, 3
"d:\IDEWORK\lvmen\src\licensedcode\data\rules\gpl-2.0_463.yml", "YAML", 0, 0, 0, 2, 0, 0, 1, 3
"d:\IDEWORK\lvmen\src\licensedcode\data\rules\gpl-2.0_464.yml", "YAML", 0, 0, 0, 2, 0, 0, 1, 3
"d:\IDEWORK\lvmen\src\licensedcode\data\rules\gpl-2.0_465.yml", "YAML", 0, 0, 0, 2, 0, 0, 1, 3
"d:\IDEWORK\lvmen\src\licensedcode\data\rules\gpl-2.0_466.yml", "YAML", 0, 0, 0, 2, 0, 0, 1, 3
"d:\IDEWORK\lvmen\src\licensedcode\data\rules\gpl-2.0_467.yml", "YAML", 0, 0, 0, 2, 0, 0, 1, 3
"d:\IDEWORK\lvmen\src\licensedcode\data\rules\gpl-2.0_468.yml", "YAML", 0, 0, 0, 3, 0, 0, 1, 4
"d:\IDEWORK\lvmen\src\licensedcode\data\rules\gpl-2.0_469.yml", "YAML", 0, 0, 0, 2, 0, 0, 1, 3
"d:\IDEWORK\lvmen\src\licensedcode\data\rules\gpl-2.0_47.yml", "YAML", 0, 0, 0, 5, 0, 0, 1, 6
"d:\IDEWORK\lvmen\src\licensedcode\data\rules\gpl-2.0_470.yml", "YAML", 0, 0, 0, 2, 0, 0, 1, 3
"d:\IDEWORK\lvmen\src\licensedcode\data\rules\gpl-2.0_471.yml", "YAML", 0, 0, 0, 2, 0, 0, 1, 3
"d:\IDEWORK\lvmen\src\licensedcode\data\rules\gpl-2.0_472.yml", "YAML", 0, 0, 0, 2, 0, 0, 1, 3
"d:\IDEWORK\lvmen\src\licensedcode\data\rules\gpl-2.0_473.yml", "YAML", 0, 0, 0, 2, 0, 0, 1, 3
"d:\IDEWORK\lvmen\src\licensedcode\data\rules\gpl-2.0_474.yml", "YAML", 0, 0, 0, 5, 0, 0, 1, 6
"d:\IDEWORK\lvmen\src\licensedcode\data\rules\gpl-2.0_475.yml", "YAML", 0, 0, 0, 3, 0, 0, 1, 4
"d:\IDEWORK\lvmen\src\licensedcode\data\rules\gpl-2.0_476.yml", "YAML", 0, 0, 0, 3, 0, 0, 1, 4
"d:\IDEWORK\lvmen\src\licensedcode\data\rules\gpl-2.0_477.yml", "YAML", 0, 0, 0, 3, 0, 0, 1, 4
"d:\IDEWORK\lvmen\src\licensedcode\data\rules\gpl-2.0_478.yml", "YAML", 0, 0, 0, 3, 0, 0, 1, 4
"d:\IDEWORK\lvmen\src\licensedcode\data\rules\gpl-2.0_479.yml", "YAML", 0, 0, 0, 2, 0, 0, 1, 3
"d:\IDEWORK\lvmen\src\licensedcode\data\rules\gpl-2.0_48.yml", "YAML", 0, 0, 0, 5, 0, 0, 1, 6
"d:\IDEWORK\lvmen\src\licensedcode\data\rules\gpl-2.0_480.yml", "YAML", 0, 0, 0, 3, 0, 0, 1, 4
"d:\IDEWORK\lvmen\src\licensedcode\data\rules\gpl-2.0_481.yml", "YAML", 0, 0, 0, 3, 0, 0, 1, 4
"d:\IDEWORK\lvmen\src\licensedcode\data\rules\gpl-2.0_482.yml", "YAML", 0, 0, 0, 3, 0, 0, 1, 4
"d:\IDEWORK\lvmen\src\licensedcode\data\rules\gpl-2.0_483.yml", "YAML", 0, 0, 0, 3, 0, 0, 1, 4
"d:\IDEWORK\lvmen\src\licensedcode\data\rules\gpl-2.0_484.yml", "YAML", 0, 0, 0, 2, 0, 0, 1, 3
"d:\IDEWORK\lvmen\src\licensedcode\data\rules\gpl-2.0_485.yml", "YAML", 0, 0, 0, 5, 0, 0, 1, 6
"d:\IDEWORK\lvmen\src\licensedcode\data\rules\gpl-2.0_486.yml", "YAML", 0, 0, 0, 3, 0, 0, 1, 4
"d:\IDEWORK\lvmen\src\licensedcode\data\rules\gpl-2.0_487.yml", "YAML", 0, 0, 0, 5, 0, 0, 1, 6
"d:\IDEWORK\lvmen\src\licensedcode\data\rules\gpl-2.0_488.yml", "YAML", 0, 0, 0, 3, 0, 0, 1, 4
"d:\IDEWORK\lvmen\src\licensedcode\data\rules\gpl-2.0_489.yml", "YAML", 0, 0, 0, 3, 0, 0, 1, 4
"d:\IDEWORK\lvmen\src\licensedcode\data\rules\gpl-2.0_49.yml", "YAML", 0, 0, 0, 10, 0, 0, 1, 11
"d:\IDEWORK\lvmen\src\licensedcode\data\rules\gpl-2.0_490.yml", "YAML", 0, 0, 0, 2, 0, 0, 1, 3
"d:\IDEWORK\lvmen\src\licensedcode\data\rules\gpl-2.0_491.yml", "YAML", 0, 0, 0, 3, 0, 0, 1, 4
"d:\IDEWORK\lvmen\src\licensedcode\data\rules\gpl-2.0_492.yml", "YAML", 0, 0, 0, 3, 0, 0, 1, 4
"d:\IDEWORK\lvmen\src\licensedcode\data\rules\gpl-2.0_493.yml", "YAML", 0, 0, 0, 3, 0, 0, 1, 4
"d:\IDEWORK\lvmen\src\licensedcode\data\rules\gpl-2.0_494.yml", "YAML", 0, 0, 0, 3, 0, 0, 1, 4
"d:\IDEWORK\lvmen\src\licensedcode\data\rules\gpl-2.0_495.yml", "YAML", 0, 0, 0, 3, 0, 0, 1, 4
"d:\IDEWORK\lvmen\src\licensedcode\data\rules\gpl-2.0_496.yml", "YAML", 0, 0, 0, 3, 0, 0, 1, 4
"d:\IDEWORK\lvmen\src\licensedcode\data\rules\gpl-2.0_497.yml", "YAML", 0, 0, 0, 3, 0, 0, 1, 4
"d:\IDEWORK\lvmen\src\licensedcode\data\rules\gpl-2.0_498.yml", "YAML", 0, 0, 0, 5, 0, 0, 1, 6
"d:\IDEWORK\lvmen\src\licensedcode\data\rules\gpl-2.0_499.yml", "YAML", 0, 0, 0, 3, 0, 0, 1, 4
"d:\IDEWORK\lvmen\src\licensedcode\data\rules\gpl-2.0_5.yml", "YAML", 0, 0, 0, 2, 0, 0, 1, 3
"d:\IDEWORK\lvmen\src\licensedcode\data\rules\gpl-2.0_50.yml", "YAML", 0, 0, 0, 3, 0, 0, 1, 4
"d:\IDEWORK\lvmen\src\licensedcode\data\rules\gpl-2.0_500.yml", "YAML", 0, 0, 0, 3, 0, 0, 1, 4
"d:\IDEWORK\lvmen\src\licensedcode\data\rules\gpl-2.0_501.yml", "YAML", 0, 0, 0, 3, 0, 0, 1, 4
"d:\IDEWORK\lvmen\src\licensedcode\data\rules\gpl-2.0_502.yml", "YAML", 0, 0, 0, 3, 0, 0, 1, 4
"d:\IDEWORK\lvmen\src\licensedcode\data\rules\gpl-2.0_503.yml", "YAML", 0, 0, 0, 3, 0, 0, 1, 4
"d:\IDEWORK\lvmen\src\licensedcode\data\rules\gpl-2.0_504.yml", "YAML", 0, 0, 0, 3, 0, 0, 1, 4
"d:\IDEWORK\lvmen\src\licensedcode\data\rules\gpl-2.0_505.yml", "YAML", 0, 0, 0, 5, 0, 0, 1, 6
"d:\IDEWORK\lvmen\src\licensedcode\data\rules\gpl-2.0_506.yml", "YAML", 0, 0, 0, 5, 0, 0, 1, 6
"d:\IDEWORK\lvmen\src\licensedcode\data\rules\gpl-2.0_507.yml", "YAML", 0, 0, 0, 4, 0, 0, 1, 5
"d:\IDEWORK\lvmen\src\licensedcode\data\rules\gpl-2.0_508.yml", "YAML", 0, 0, 0, 6, 0, 0, 1, 7
"d:\IDEWORK\lvmen\src\licensedcode\data\rules\gpl-2.0_509.yml", "YAML", 0, 0, 0, 4, 0, 0, 1, 5
"d:\IDEWORK\lvmen\src\licensedcode\data\rules\gpl-2.0_51.yml", "YAML", 0, 0, 0, 3, 0, 0, 1, 4
"d:\IDEWORK\lvmen\src\licensedcode\data\rules\gpl-2.0_510.yml", "YAML", 0, 0, 0, 4, 0, 0, 1, 5
"d:\IDEWORK\lvmen\src\licensedcode\data\rules\gpl-2.0_511.yml", "YAML", 0, 0, 0, 3, 0, 0, 1, 4
"d:\IDEWORK\lvmen\src\licensedcode\data\rules\gpl-2.0_512.yml", "YAML", 0, 0, 0, 4, 0, 0, 1, 5
"d:\IDEWORK\lvmen\src\licensedcode\data\rules\gpl-2.0_513.yml", "YAML", 0, 0, 0, 2, 0, 0, 1, 3
"d:\IDEWORK\lvmen\src\licensedcode\data\rules\gpl-2.0_514.yml", "YAML", 0, 0, 0, 2, 0, 0, 1, 3
"d:\IDEWORK\lvmen\src\licensedcode\data\rules\gpl-2.0_515.yml", "YAML", 0, 0, 0, 4, 0, 0, 1, 5
"d:\IDEWORK\lvmen\src\licensedcode\data\rules\gpl-2.0_516.yml", "YAML", 0, 0, 0, 2, 0, 0, 1, 3
"d:\IDEWORK\lvmen\src\licensedcode\data\rules\gpl-2.0_517.yml", "YAML", 0, 0, 0, 2, 0, 0, 1, 3
"d:\IDEWORK\lvmen\src\licensedcode\data\rules\gpl-2.0_518.yml", "YAML", 0, 0, 0, 5, 0, 0, 1, 6
"d:\IDEWORK\lvmen\src\licensedcode\data\rules\gpl-2.0_519.yml", "YAML", 0, 0, 0, 2, 0, 0, 1, 3
"d:\IDEWORK\lvmen\src\licensedcode\data\rules\gpl-2.0_52.yml", "YAML", 0, 0, 0, 3, 0, 0, 1, 4
"d:\IDEWORK\lvmen\src\licensedcode\data\rules\gpl-2.0_520.yml", "YAML", 0, 0, 0, 2, 0, 0, 1, 3
"d:\IDEWORK\lvmen\src\licensedcode\data\rules\gpl-2.0_521.yml", "YAML", 0, 0, 0, 3, 0, 0, 1, 4
"d:\IDEWORK\lvmen\src\licensedcode\data\rules\gpl-2.0_522.yml", "YAML", 0, 0, 0, 2, 0, 0, 1, 3
"d:\IDEWORK\lvmen\src\licensedcode\data\rules\gpl-2.0_523.yml", "YAML", 0, 0, 0, 4, 0, 0, 1, 5
"d:\IDEWORK\lvmen\src\licensedcode\data\rules\gpl-2.0_524.yml", "YAML", 0, 0, 0, 2, 0, 0, 1, 3
"d:\IDEWORK\lvmen\src\licensedcode\data\rules\gpl-2.0_525.yml", "YAML", 0, 0, 0, 4, 0, 0, 1, 5
"d:\IDEWORK\lvmen\src\licensedcode\data\rules\gpl-2.0_526.yml", "YAML", 0, 0, 0, 5, 0, 0, 1, 6
"d:\IDEWORK\lvmen\src\licensedcode\data\rules\gpl-2.0_527.yml", "YAML", 0, 0, 0, 7, 0, 0, 1, 8
"d:\IDEWORK\lvmen\src\licensedcode\data\rules\gpl-2.0_528.yml", "YAML", 0, 0, 0, 2, 0, 0, 1, 3
"d:\IDEWORK\lvmen\src\licensedcode\data\rules\gpl-2.0_529.yml", "YAML", 0, 0, 0, 3, 0, 0, 1, 4
"d:\IDEWORK\lvmen\src\licensedcode\data\rules\gpl-2.0_53.yml", "YAML", 0, 0, 0, 3, 0, 0, 1, 4
"d:\IDEWORK\lvmen\src\licensedcode\data\rules\gpl-2.0_530.yml", "YAML", 0, 0, 0, 2, 0, 0, 1, 3
"d:\IDEWORK\lvmen\src\licensedcode\data\rules\gpl-2.0_531.yml", "YAML", 0, 0, 0, 2, 0, 0, 1, 3
"d:\IDEWORK\lvmen\src\licensedcode\data\rules\gpl-2.0_532.yml", "YAML", 0, 0, 0, 2, 0, 0, 1, 3
"d:\IDEWORK\lvmen\src\licensedcode\data\rules\gpl-2.0_533.yml", "YAML", 0, 0, 0, 2, 0, 0, 1, 3
"d:\IDEWORK\lvmen\src\licensedcode\data\rules\gpl-2.0_534.yml", "YAML", 0, 0, 0, 5, 0, 0, 1, 6
"d:\IDEWORK\lvmen\src\licensedcode\data\rules\gpl-2.0_535.yml", "YAML", 0, 0, 0, 3, 0, 0, 1, 4
"d:\IDEWORK\lvmen\src\licensedcode\data\rules\gpl-2.0_536.yml", "YAML", 0, 0, 0, 11, 0, 0, 1, 12
"d:\IDEWORK\lvmen\src\licensedcode\data\rules\gpl-2.0_537.yml", "YAML", 0, 0, 0, 2, 0, 0, 1, 3
"d:\IDEWORK\lvmen\src\licensedcode\data\rules\gpl-2.0_538.yml", "YAML", 0, 0, 0, 6, 0, 0, 1, 7
"d:\IDEWORK\lvmen\src\licensedcode\data\rules\gpl-2.0_539.yml", "YAML", 0, 0, 0, 4, 0, 0, 1, 5
"d:\IDEWORK\lvmen\src\licensedcode\data\rules\gpl-2.0_54.yml", "YAML", 0, 0, 0, 7, 0, 0, 1, 8
"d:\IDEWORK\lvmen\src\licensedcode\data\rules\gpl-2.0_540.yml", "YAML", 0, 0, 0, 2, 0, 0, 1, 3
"d:\IDEWORK\lvmen\src\licensedcode\data\rules\gpl-2.0_541.yml", "YAML", 0, 0, 0, 3, 0, 0, 1, 4
"d:\IDEWORK\lvmen\src\licensedcode\data\rules\gpl-2.0_542.yml", "YAML", 0, 0, 0, 3, 0, 0, 1, 4
"d:\IDEWORK\lvmen\src\licensedcode\data\rules\gpl-2.0_543.yml", "YAML", 0, 0, 0, 4, 0, 0, 1, 5
"d:\IDEWORK\lvmen\src\licensedcode\data\rules\gpl-2.0_544.yml", "YAML", 0, 0, 0, 5, 0, 0, 1, 6
"d:\IDEWORK\lvmen\src\licensedcode\data\rules\gpl-2.0_545.yml", "YAML", 0, 0, 0, 5, 0, 0, 1, 6
"d:\IDEWORK\lvmen\src\licensedcode\data\rules\gpl-2.0_546.yml", "YAML", 0, 0, 0, 3, 0, 0, 1, 4
"d:\IDEWORK\lvmen\src\licensedcode\data\rules\gpl-2.0_547.yml", "YAML", 0, 0, 0, 6, 0, 0, 1, 7
"d:\IDEWORK\lvmen\src\licensedcode\data\rules\gpl-2.0_548.yml", "YAML", 0, 0, 0, 3, 0, 0, 1, 4
"d:\IDEWORK\lvmen\src\licensedcode\data\rules\gpl-2.0_549.yml", "YAML", 0, 0, 0, 3, 0, 0, 1, 4
"d:\IDEWORK\lvmen\src\licensedcode\data\rules\gpl-2.0_55.yml", "YAML", 0, 0, 0, 3, 0, 0, 1, 4
"d:\IDEWORK\lvmen\src\licensedcode\data\rules\gpl-2.0_550.yml", "YAML", 0, 0, 0, 3, 0, 0, 1, 4
"d:\IDEWORK\lvmen\src\licensedcode\data\rules\gpl-2.0_551.yml", "YAML", 0, 0, 0, 4, 0, 0, 1, 5
"d:\IDEWORK\lvmen\src\licensedcode\data\rules\gpl-2.0_552.yml", "YAML", 0, 0, 0, 6, 0, 0, 1, 7
"d:\IDEWORK\lvmen\src\licensedcode\data\rules\gpl-2.0_553.yml", "YAML", 0, 0, 0, 3, 0, 0, 1, 4
"d:\IDEWORK\lvmen\src\licensedcode\data\rules\gpl-2.0_554.yml", "YAML", 0, 0, 0, 2, 0, 0, 1, 3
"d:\IDEWORK\lvmen\src\licensedcode\data\rules\gpl-2.0_555.yml", "YAML", 0, 0, 0, 4, 0, 0, 1, 5
"d:\IDEWORK\lvmen\src\licensedcode\data\rules\gpl-2.0_556.yml", "YAML", 0, 0, 0, 4, 0, 0, 1, 5
"d:\IDEWORK\lvmen\src\licensedcode\data\rules\gpl-2.0_557.yml", "YAML", 0, 0, 0, 2, 0, 0, 1, 3
"d:\IDEWORK\lvmen\src\licensedcode\data\rules\gpl-2.0_558.yml", "YAML", 0, 0, 0, 3, 0, 0, 1, 4
"d:\IDEWORK\lvmen\src\licensedcode\data\rules\gpl-2.0_559.yml", "YAML", 0, 0, 0, 5, 0, 0, 1, 6
"d:\IDEWORK\lvmen\src\licensedcode\data\rules\gpl-2.0_56.yml", "YAML", 0, 0, 0, 2, 0, 0, 1, 3
"d:\IDEWORK\lvmen\src\licensedcode\data\rules\gpl-2.0_560.yml", "YAML", 0, 0, 0, 2, 0, 0, 1, 3
"d:\IDEWORK\lvmen\src\licensedcode\data\rules\gpl-2.0_561.yml", "YAML", 0, 0, 0, 3, 0, 0, 1, 4
"d:\IDEWORK\lvmen\src\licensedcode\data\rules\gpl-2.0_562.yml", "YAML", 0, 0, 0, 3, 0, 0, 1, 4
"d:\IDEWORK\lvmen\src\licensedcode\data\rules\gpl-2.0_563.yml", "YAML", 0, 0, 0, 2, 0, 0, 1, 3
"d:\IDEWORK\lvmen\src\licensedcode\data\rules\gpl-2.0_564.yml", "YAML", 0, 0, 0, 8, 0, 0, 1, 9
"d:\IDEWORK\lvmen\src\licensedcode\data\rules\gpl-2.0_565.yml", "YAML", 0, 0, 0, 10, 0, 0, 1, 11
"d:\IDEWORK\lvmen\src\licensedcode\data\rules\gpl-2.0_566.yml", "YAML", 0, 0, 0, 3, 0, 0, 1, 4
"d:\IDEWORK\lvmen\src\licensedcode\data\rules\gpl-2.0_567.yml", "YAML", 0, 0, 0, 4, 0, 0, 1, 5
"d:\IDEWORK\lvmen\src\licensedcode\data\rules\gpl-2.0_568.yml", "YAML", 0, 0, 0, 4, 0, 0, 1, 5
"d:\IDEWORK\lvmen\src\licensedcode\data\rules\gpl-2.0_569.yml", "YAML", 0, 0, 0, 2, 0, 0, 1, 3
"d:\IDEWORK\lvmen\src\licensedcode\data\rules\gpl-2.0_57.yml", "YAML", 0, 0, 0, 5, 0, 0, 1, 6
"d:\IDEWORK\lvmen\src\licensedcode\data\rules\gpl-2.0_570.yml", "YAML", 0, 0, 0, 3, 0, 0, 1, 4
"d:\IDEWORK\lvmen\src\licensedcode\data\rules\gpl-2.0_571.yml", "YAML", 0, 0, 0, 3, 0, 0, 1, 4
"d:\IDEWORK\lvmen\src\licensedcode\data\rules\gpl-2.0_572.yml", "YAML", 0, 0, 0, 3, 0, 0, 1, 4
"d:\IDEWORK\lvmen\src\licensedcode\data\rules\gpl-2.0_573.yml", "YAML", 0, 0, 0, 3, 0, 0, 1, 4
"d:\IDEWORK\lvmen\src\licensedcode\data\rules\gpl-2.0_574.yml", "YAML", 0, 0, 0, 2, 0, 0, 1, 3
"d:\IDEWORK\lvmen\src\licensedcode\data\rules\gpl-2.0_575.yml", "YAML", 0, 0, 0, 6, 0, 0, 1, 7
"d:\IDEWORK\lvmen\src\licensedcode\data\rules\gpl-2.0_576.yml", "YAML", 0, 0, 0, 5, 0, 0, 1, 6
"d:\IDEWORK\lvmen\src\licensedcode\data\rules\gpl-2.0_577.yml", "YAML", 0, 0, 0, 3, 0, 0, 1, 4
"d:\IDEWORK\lvmen\src\licensedcode\data\rules\gpl-2.0_578.yml", "YAML", 0, 0, 0, 9, 0, 0, 1, 10
"d:\IDEWORK\lvmen\src\licensedcode\data\rules\gpl-2.0_579.yml", "YAML", 0, 0, 0, 3, 0, 0, 1, 4
"d:\IDEWORK\lvmen\src\licensedcode\data\rules\gpl-2.0_58.yml", "YAML", 0, 0, 0, 4, 0, 0, 1, 5
"d:\IDEWORK\lvmen\src\licensedcode\data\rules\gpl-2.0_580.yml", "YAML", 0, 0, 0, 5, 0, 0, 1, 6
"d:\IDEWORK\lvmen\src\licensedcode\data\rules\gpl-2.0_581.yml", "YAML", 0, 0, 0, 3, 0, 0, 1, 4
"d:\IDEWORK\lvmen\src\licensedcode\data\rules\gpl-2.0_582.yml", "YAML", 0, 0, 0, 3, 0, 0, 1, 4
"d:\IDEWORK\lvmen\src\licensedcode\data\rules\gpl-2.0_583.yml", "YAML", 0, 0, 0, 3, 0, 0, 1, 4
"d:\IDEWORK\lvmen\src\licensedcode\data\rules\gpl-2.0_584.yml", "YAML", 0, 0, 0, 3, 0, 0, 1, 4
"d:\IDEWORK\lvmen\src\licensedcode\data\rules\gpl-2.0_585.yml", "YAML", 0, 0, 0, 4, 0, 0, 1, 5
"d:\IDEWORK\lvmen\src\licensedcode\data\rules\gpl-2.0_586.yml", "YAML", 0, 0, 0, 11, 0, 0, 1, 12
"d:\IDEWORK\lvmen\src\licensedcode\data\rules\gpl-2.0_587.yml", "YAML", 0, 0, 0, 12, 0, 0, 1, 13
"d:\IDEWORK\lvmen\src\licensedcode\data\rules\gpl-2.0_588.yml", "YAML", 0, 0, 0, 3, 0, 0, 1, 4
"d:\IDEWORK\lvmen\src\licensedcode\data\rules\gpl-2.0_589.yml", "YAML", 0, 0, 0, 3, 0, 0, 1, 4
"d:\IDEWORK\lvmen\src\licensedcode\data\rules\gpl-2.0_59.yml", "YAML", 0, 0, 0, 2, 0, 0, 1, 3
"d:\IDEWORK\lvmen\src\licensedcode\data\rules\gpl-2.0_590.yml", "YAML", 0, 0, 0, 8, 0, 0, 1, 9
"d:\IDEWORK\lvmen\src\licensedcode\data\rules\gpl-2.0_591.yml", "YAML", 0, 0, 0, 3, 0, 0, 1, 4
"d:\IDEWORK\lvmen\src\licensedcode\data\rules\gpl-2.0_592.yml", "YAML", 0, 0, 0, 3, 0, 0, 1, 4
"d:\IDEWORK\lvmen\src\licensedcode\data\rules\gpl-2.0_593.yml", "YAML", 0, 0, 0, 3, 0, 0, 1, 4
"d:\IDEWORK\lvmen\src\licensedcode\data\rules\gpl-2.0_594.yml", "YAML", 0, 0, 0, 3, 0, 0, 1, 4
"d:\IDEWORK\lvmen\src\licensedcode\data\rules\gpl-2.0_595.yml", "YAML", 0, 0, 0, 3, 0, 0, 1, 4
"d:\IDEWORK\lvmen\src\licensedcode\data\rules\gpl-2.0_596.yml", "YAML", 0, 0, 0, 4, 0, 0, 1, 5
"d:\IDEWORK\lvmen\src\licensedcode\data\rules\gpl-2.0_597.yml", "YAML", 0, 0, 0, 3, 0, 0, 1, 4
"d:\IDEWORK\lvmen\src\licensedcode\data\rules\gpl-2.0_598.yml", "YAML", 0, 0, 0, 5, 0, 0, 1, 6
"d:\IDEWORK\lvmen\src\licensedcode\data\rules\gpl-2.0_599.yml", "YAML", 0, 0, 0, 6, 0, 0, 1, 7
"d:\IDEWORK\lvmen\src\licensedcode\data\rules\gpl-2.0_6.yml", "YAML", 0, 0, 0, 4, 0, 0, 1, 5
"d:\IDEWORK\lvmen\src\licensedcode\data\rules\gpl-2.0_60.yml", "YAML", 0, 0, 0, 3, 0, 0, 1, 4
"d:\IDEWORK\lvmen\src\licensedcode\data\rules\gpl-2.0_600.yml", "YAML", 0, 0, 0, 3, 0, 0, 1, 4
"d:\IDEWORK\lvmen\src\licensedcode\data\rules\gpl-2.0_601.yml", "YAML", 0, 0, 0, 2, 0, 0, 1, 3
"d:\IDEWORK\lvmen\src\licensedcode\data\rules\gpl-2.0_602.yml", "YAML", 0, 0, 0, 2, 0, 0, 1, 3
"d:\IDEWORK\lvmen\src\licensedcode\data\rules\gpl-2.0_603.yml", "YAML", 0, 0, 0, 4, 0, 0, 1, 5
"d:\IDEWORK\lvmen\src\licensedcode\data\rules\gpl-2.0_604.yml", "YAML", 0, 0, 0, 2, 0, 0, 1, 3
"d:\IDEWORK\lvmen\src\licensedcode\data\rules\gpl-2.0_605.yml", "YAML", 0, 0, 0, 2, 0, 0, 1, 3
"d:\IDEWORK\lvmen\src\licensedcode\data\rules\gpl-2.0_606.yml", "YAML", 0, 0, 0, 2, 0, 0, 1, 3
"d:\IDEWORK\lvmen\src\licensedcode\data\rules\gpl-2.0_607.yml", "YAML", 0, 0, 0, 2, 0, 0, 1, 3
"d:\IDEWORK\lvmen\src\licensedcode\data\rules\gpl-2.0_608.yml", "YAML", 0, 0, 0, 2, 0, 0, 1, 3
"d:\IDEWORK\lvmen\src\licensedcode\data\rules\gpl-2.0_609.yml", "YAML", 0, 0, 0, 3, 0, 0, 1, 4
"d:\IDEWORK\lvmen\src\licensedcode\data\rules\gpl-2.0_61.yml", "YAML", 0, 0, 0, 3, 0, 0, 1, 4
"d:\IDEWORK\lvmen\src\licensedcode\data\rules\gpl-2.0_610.yml", "YAML", 0, 0, 0, 8, 0, 0, 1, 9
"d:\IDEWORK\lvmen\src\licensedcode\data\rules\gpl-2.0_611.yml", "YAML", 0, 0, 0, 4, 0, 0, 1, 5
"d:\IDEWORK\lvmen\src\licensedcode\data\rules\gpl-2.0_612.yml", "YAML", 0, 0, 0, 5, 0, 0, 1, 6
"d:\IDEWORK\lvmen\src\licensedcode\data\rules\gpl-2.0_613.yml", "YAML", 0, 0, 0, 2, 0, 0, 1, 3
"d:\IDEWORK\lvmen\src\licensedcode\data\rules\gpl-2.0_614.yml", "YAML", 0, 0, 0, 2, 0, 0, 1, 3
"d:\IDEWORK\lvmen\src\licensedcode\data\rules\gpl-2.0_615.yml", "YAML", 0, 0, 0, 3, 0, 0, 1, 4
"d:\IDEWORK\lvmen\src\licensedcode\data\rules\gpl-2.0_616.yml", "YAML", 0, 0, 0, 6, 0, 0, 1, 7
"d:\IDEWORK\lvmen\src\licensedcode\data\rules\gpl-2.0_617.yml", "YAML", 0, 0, 0, 7, 0, 0, 1, 8
"d:\IDEWORK\lvmen\src\licensedcode\data\rules\gpl-2.0_617_1.yml", "YAML", 0, 0, 0, 9, 0, 0, 1, 10
"d:\IDEWORK\lvmen\src\licensedcode\data\rules\gpl-2.0_618.yml", "YAML", 0, 0, 0, 5, 0, 0, 1, 6
"d:\IDEWORK\lvmen\src\licensedcode\data\rules\gpl-2.0_619.yml", "YAML", 0, 0, 0, 8, 0, 0, 1, 9
"d:\IDEWORK\lvmen\src\licensedcode\data\rules\gpl-2.0_62.yml", "YAML", 0, 0, 0, 2, 0, 0, 1, 3
"d:\IDEWORK\lvmen\src\licensedcode\data\rules\gpl-2.0_620.yml", "YAML", 0, 0, 0, 3, 0, 0, 1, 4
"d:\IDEWORK\lvmen\src\licensedcode\data\rules\gpl-2.0_621.yml", "YAML", 0, 0, 0, 5, 0, 0, 1, 6
"d:\IDEWORK\lvmen\src\licensedcode\data\rules\gpl-2.0_622.yml", "YAML", 0, 0, 0, 3, 0, 0, 1, 4
"d:\IDEWORK\lvmen\src\licensedcode\data\rules\gpl-2.0_623.yml", "YAML", 0, 0, 0, 5, 0, 0, 1, 6
"d:\IDEWORK\lvmen\src\licensedcode\data\rules\gpl-2.0_624.yml", "YAML", 0, 0, 0, 3, 0, 0, 1, 4
"d:\IDEWORK\lvmen\src\licensedcode\data\rules\gpl-2.0_625.yml", "YAML", 0, 0, 0, 4, 0, 0, 1, 5
"d:\IDEWORK\lvmen\src\licensedcode\data\rules\gpl-2.0_626.yml", "YAML", 0, 0, 0, 4, 0, 0, 1, 5
"d:\IDEWORK\lvmen\src\licensedcode\data\rules\gpl-2.0_627.yml", "YAML", 0, 0, 0, 5, 0, 0, 1, 6
"d:\IDEWORK\lvmen\src\licensedcode\data\rules\gpl-2.0_628.yml", "YAML", 0, 0, 0, 5, 0, 0, 1, 6
"d:\IDEWORK\lvmen\src\licensedcode\data\rules\gpl-2.0_629.yml", "YAML", 0, 0, 0, 3, 0, 0, 1, 4
"d:\IDEWORK\lvmen\src\licensedcode\data\rules\gpl-2.0_63.yml", "YAML", 0, 0, 0, 2, 0, 0, 1, 3
"d:\IDEWORK\lvmen\src\licensedcode\data\rules\gpl-2.0_630.yml", "YAML", 0, 0, 0, 9, 0, 0, 1, 10
"d:\IDEWORK\lvmen\src\licensedcode\data\rules\gpl-2.0_631.yml", "YAML", 0, 0, 0, 3, 0, 0, 1, 4
"d:\IDEWORK\lvmen\src\licensedcode\data\rules\gpl-2.0_632.yml", "YAML", 0, 0, 0, 2, 0, 0, 1, 3
"d:\IDEWORK\lvmen\src\licensedcode\data\rules\gpl-2.0_633.yml", "YAML", 0, 0, 0, 5, 0, 0, 1, 6
"d:\IDEWORK\lvmen\src\licensedcode\data\rules\gpl-2.0_634.yml", "YAML", 0, 0, 0, 8, 0, 0, 1, 9
"d:\IDEWORK\lvmen\src\licensedcode\data\rules\gpl-2.0_635.yml", "YAML", 0, 0, 0, 3, 0, 0, 1, 4
"d:\IDEWORK\lvmen\src\licensedcode\data\rules\gpl-2.0_636.yml", "YAML", 0, 0, 0, 3, 0, 0, 1, 4
"d:\IDEWORK\lvmen\src\licensedcode\data\rules\gpl-2.0_637.yml", "YAML", 0, 0, 0, 3, 0, 0, 1, 4
"d:\IDEWORK\lvmen\src\licensedcode\data\rules\gpl-2.0_638.yml", "YAML", 0, 0, 0, 3, 0, 0, 1, 4
"d:\IDEWORK\lvmen\src\licensedcode\data\rules\gpl-2.0_639.yml", "YAML", 0, 0, 0, 3, 0, 0, 1, 4
"d:\IDEWORK\lvmen\src\licensedcode\data\rules\gpl-2.0_64.yml", "YAML", 0, 0, 0, 3, 0, 0, 1, 4
"d:\IDEWORK\lvmen\src\licensedcode\data\rules\gpl-2.0_640.yml", "YAML", 0, 0, 0, 3, 0, 0, 1, 4
"d:\IDEWORK\lvmen\src\licensedcode\data\rules\gpl-2.0_641.yml", "YAML", 0, 0, 0, 3, 0, 0, 1, 4
"d:\IDEWORK\lvmen\src\licensedcode\data\rules\gpl-2.0_642.yml", "YAML", 0, 0, 0, 3, 0, 0, 1, 4
"d:\IDEWORK\lvmen\src\licensedcode\data\rules\gpl-2.0_643.yml", "YAML", 0, 0, 0, 5, 0, 0, 1, 6
"d:\IDEWORK\lvmen\src\licensedcode\data\rules\gpl-2.0_644.yml", "YAML", 0, 0, 0, 3, 0, 0, 1, 4
"d:\IDEWORK\lvmen\src\licensedcode\data\rules\gpl-2.0_645.yml", "YAML", 0, 0, 0, 2, 0, 0, 1, 3
"d:\IDEWORK\lvmen\src\licensedcode\data\rules\gpl-2.0_646.yml", "YAML", 0, 0, 0, 7, 0, 0, 1, 8
"d:\IDEWORK\lvmen\src\licensedcode\data\rules\gpl-2.0_647.yml", "YAML", 0, 0, 0, 7, 0, 0, 1, 8
"d:\IDEWORK\lvmen\src\licensedcode\data\rules\gpl-2.0_648.yml", "YAML", 0, 0, 0, 3, 0, 0, 1, 4
"d:\IDEWORK\lvmen\src\licensedcode\data\rules\gpl-2.0_649.yml", "YAML", 0, 0, 0, 9, 0, 0, 1, 10
"d:\IDEWORK\lvmen\src\licensedcode\data\rules\gpl-2.0_65.yml", "YAML", 0, 0, 0, 2, 0, 0, 1, 3
"d:\IDEWORK\lvmen\src\licensedcode\data\rules\gpl-2.0_650.yml", "YAML", 0, 0, 0, 3, 0, 0, 1, 4
"d:\IDEWORK\lvmen\src\licensedcode\data\rules\gpl-2.0_651.yml", "YAML", 0, 0, 0, 8, 0, 0, 1, 9
"d:\IDEWORK\lvmen\src\licensedcode\data\rules\gpl-2.0_652.yml", "YAML", 0, 0, 0, 8, 0, 0, 1, 9
"d:\IDEWORK\lvmen\src\licensedcode\data\rules\gpl-2.0_653.yml", "YAML", 0, 0, 0, 5, 0, 0, 1, 6
"d:\IDEWORK\lvmen\src\licensedcode\data\rules\gpl-2.0_654.yml", "YAML", 0, 0, 0, 5, 0, 0, 1, 6
"d:\IDEWORK\lvmen\src\licensedcode\data\rules\gpl-2.0_655.yml", "YAML", 0, 0, 0, 3, 0, 0, 1, 4
"d:\IDEWORK\lvmen\src\licensedcode\data\rules\gpl-2.0_656.yml", "YAML", 0, 0, 0, 3, 0, 0, 1, 4
"d:\IDEWORK\lvmen\src\licensedcode\data\rules\gpl-2.0_657.yml", "YAML", 0, 0, 0, 3, 0, 0, 1, 4
"d:\IDEWORK\lvmen\src\licensedcode\data\rules\gpl-2.0_658.yml", "YAML", 0, 0, 0, 5, 0, 0, 1, 6
"d:\IDEWORK\lvmen\src\licensedcode\data\rules\gpl-2.0_659.yml", "YAML", 0, 0, 0, 3, 0, 0, 1, 4
"d:\IDEWORK\lvmen\src\licensedcode\data\rules\gpl-2.0_66.yml", "YAML", 0, 0, 0, 2, 0, 0, 1, 3
"d:\IDEWORK\lvmen\src\licensedcode\data\rules\gpl-2.0_660.yml", "YAML", 0, 0, 0, 3, 0, 0, 1, 4
"d:\IDEWORK\lvmen\src\licensedcode\data\rules\gpl-2.0_661.yml", "YAML", 0, 0, 0, 3, 0, 0, 1, 4
"d:\IDEWORK\lvmen\src\licensedcode\data\rules\gpl-2.0_662.yml", "YAML", 0, 0, 0, 3, 0, 0, 1, 4
"d:\IDEWORK\lvmen\src\licensedcode\data\rules\gpl-2.0_663.yml", "YAML", 0, 0, 0, 3, 0, 0, 1, 4
"d:\IDEWORK\lvmen\src\licensedcode\data\rules\gpl-2.0_664.yml", "YAML", 0, 0, 0, 5, 0, 0, 1, 6
"d:\IDEWORK\lvmen\src\licensedcode\data\rules\gpl-2.0_665.yml", "YAML", 0, 0, 0, 5, 0, 0, 1, 6
"d:\IDEWORK\lvmen\src\licensedcode\data\rules\gpl-2.0_666.yml", "YAML", 0, 0, 0, 3, 0, 0, 1, 4
"d:\IDEWORK\lvmen\src\licensedcode\data\rules\gpl-2.0_667.yml", "YAML", 0, 0, 0, 5, 0, 0, 1, 6
"d:\IDEWORK\lvmen\src\licensedcode\data\rules\gpl-2.0_668.yml", "YAML", 0, 0, 0, 3, 0, 0, 1, 4
"d:\IDEWORK\lvmen\src\licensedcode\data\rules\gpl-2.0_669.yml", "YAML", 0, 0, 0, 3, 0, 0, 1, 4
"d:\IDEWORK\lvmen\src\licensedcode\data\rules\gpl-2.0_67.yml", "YAML", 0, 0, 0, 2, 0, 0, 1, 3
"d:\IDEWORK\lvmen\src\licensedcode\data\rules\gpl-2.0_670.yml", "YAML", 0, 0, 0, 3, 0, 0, 1, 4
"d:\IDEWORK\lvmen\src\licensedcode\data\rules\gpl-2.0_671.yml", "YAML", 0, 0, 0, 3, 0, 0, 1, 4
"d:\IDEWORK\lvmen\src\licensedcode\data\rules\gpl-2.0_672.yml", "YAML", 0, 0, 0, 3, 0, 0, 1, 4
"d:\IDEWORK\lvmen\src\licensedcode\data\rules\gpl-2.0_673.yml", "YAML", 0, 0, 0, 3, 0, 0, 1, 4
"d:\IDEWORK\lvmen\src\licensedcode\data\rules\gpl-2.0_674.yml", "YAML", 0, 0, 0, 3, 0, 0, 1, 4
"d:\IDEWORK\lvmen\src\licensedcode\data\rules\gpl-2.0_675.yml", "YAML", 0, 0, 0, 3, 0, 0, 1, 4
"d:\IDEWORK\lvmen\src\licensedcode\data\rules\gpl-2.0_676.yml", "YAML", 0, 0, 0, 3, 0, 0, 1, 4
"d:\IDEWORK\lvmen\src\licensedcode\data\rules\gpl-2.0_677.yml", "YAML", 0, 0, 0, 8, 0, 0, 1, 9
"d:\IDEWORK\lvmen\src\licensedcode\data\rules\gpl-2.0_677_1.yml", "YAML", 0, 0, 0, 8, 0, 0, 1, 9
"d:\IDEWORK\lvmen\src\licensedcode\data\rules\gpl-2.0_678.yml", "YAML", 0, 0, 0, 3, 0, 0, 1, 4
"d:\IDEWORK\lvmen\src\licensedcode\data\rules\gpl-2.0_679.yml", "YAML", 0, 0, 0, 4, 0, 0, 1, 5
"d:\IDEWORK\lvmen\src\licensedcode\data\rules\gpl-2.0_68.yml", "YAML", 0, 0, 0, 3, 0, 0, 1, 4
"d:\IDEWORK\lvmen\src\licensedcode\data\rules\gpl-2.0_680.yml", "YAML", 0, 0, 0, 3, 0, 0, 1, 4
"d:\IDEWORK\lvmen\src\licensedcode\data\rules\gpl-2.0_681.yml", "YAML", 0, 0, 0, 5, 0, 0, 1, 6
"d:\IDEWORK\lvmen\src\licensedcode\data\rules\gpl-2.0_682.yml", "YAML", 0, 0, 0, 3, 0, 0, 1, 4
"d:\IDEWORK\lvmen\src\licensedcode\data\rules\gpl-2.0_683.yml", "YAML", 0, 0, 0, 3, 0, 0, 1, 4
"d:\IDEWORK\lvmen\src\licensedcode\data\rules\gpl-2.0_684.yml", "YAML", 0, 0, 0, 2, 0, 0, 1, 3
"d:\IDEWORK\lvmen\src\licensedcode\data\rules\gpl-2.0_685.yml", "YAML", 0, 0, 0, 2, 0, 0, 1, 3
"d:\IDEWORK\lvmen\src\licensedcode\data\rules\gpl-2.0_686.yml", "YAML", 0, 0, 0, 4, 0, 0, 1, 5
"d:\IDEWORK\lvmen\src\licensedcode\data\rules\gpl-2.0_687.yml", "YAML", 0, 0, 0, 2, 0, 0, 1, 3
"d:\IDEWORK\lvmen\src\licensedcode\data\rules\gpl-2.0_688.yml", "YAML", 0, 0, 0, 3, 0, 0, 1, 4
"d:\IDEWORK\lvmen\src\licensedcode\data\rules\gpl-2.0_689.yml", "YAML", 0, 0, 0, 3, 0, 0, 1, 4
"d:\IDEWORK\lvmen\src\licensedcode\data\rules\gpl-2.0_69.yml", "YAML", 0, 0, 0, 8, 0, 0, 1, 9
"d:\IDEWORK\lvmen\src\licensedcode\data\rules\gpl-2.0_690.yml", "YAML", 0, 0, 0, 5, 0, 0, 1, 6
"d:\IDEWORK\lvmen\src\licensedcode\data\rules\gpl-2.0_691.yml", "YAML", 0, 0, 0, 3, 0, 0, 1, 4
"d:\IDEWORK\lvmen\src\licensedcode\data\rules\gpl-2.0_692.yml", "YAML", 0, 0, 0, 3, 0, 0, 1, 4
"d:\IDEWORK\lvmen\src\licensedcode\data\rules\gpl-2.0_693.yml", "YAML", 0, 0, 0, 5, 0, 0, 1, 6
"d:\IDEWORK\lvmen\src\licensedcode\data\rules\gpl-2.0_694.yml", "YAML", 0, 0, 0, 3, 0, 0, 1, 4
"d:\IDEWORK\lvmen\src\licensedcode\data\rules\gpl-2.0_695.yml", "YAML", 0, 0, 0, 3, 0, 0, 1, 4
"d:\IDEWORK\lvmen\src\licensedcode\data\rules\gpl-2.0_696.yml", "YAML", 0, 0, 0, 3, 0, 0, 1, 4
"d:\IDEWORK\lvmen\src\licensedcode\data\rules\gpl-2.0_697.yml", "YAML", 0, 0, 0, 3, 0, 0, 1, 4
"d:\IDEWORK\lvmen\src\licensedcode\data\rules\gpl-2.0_698.yml", "YAML", 0, 0, 0, 3, 0, 0, 1, 4
"d:\IDEWORK\lvmen\src\licensedcode\data\rules\gpl-2.0_699.yml", "YAML", 0, 0, 0, 3, 0, 0, 1, 4
"d:\IDEWORK\lvmen\src\licensedcode\data\rules\gpl-2.0_7.yml", "YAML", 0, 0, 0, 2, 0, 0, 1, 3
"d:\IDEWORK\lvmen\src\licensedcode\data\rules\gpl-2.0_70.yml", "YAML", 0, 0, 0, 3, 0, 0, 1, 4
"d:\IDEWORK\lvmen\src\licensedcode\data\rules\gpl-2.0_700.yml", "YAML", 0, 0, 0, 3, 0, 0, 1, 4
"d:\IDEWORK\lvmen\src\licensedcode\data\rules\gpl-2.0_701.yml", "YAML", 0, 0, 0, 3, 0, 0, 1, 4
"d:\IDEWORK\lvmen\src\licensedcode\data\rules\gpl-2.0_702.yml", "YAML", 0, 0, 0, 3, 0, 0, 1, 4
"d:\IDEWORK\lvmen\src\licensedcode\data\rules\gpl-2.0_703.yml", "YAML", 0, 0, 0, 3, 0, 0, 1, 4
"d:\IDEWORK\lvmen\src\licensedcode\data\rules\gpl-2.0_704.yml", "YAML", 0, 0, 0, 3, 0, 0, 1, 4
"d:\IDEWORK\lvmen\src\licensedcode\data\rules\gpl-2.0_705.yml", "YAML", 0, 0, 0, 3, 0, 0, 1, 4
"d:\IDEWORK\lvmen\src\licensedcode\data\rules\gpl-2.0_706.yml", "YAML", 0, 0, 0, 3, 0, 0, 1, 4
"d:\IDEWORK\lvmen\src\licensedcode\data\rules\gpl-2.0_707.yml", "YAML", 0, 0, 0, 3, 0, 0, 1, 4
"d:\IDEWORK\lvmen\src\licensedcode\data\rules\gpl-2.0_708.yml", "YAML", 0, 0, 0, 3, 0, 0, 1, 4
"d:\IDEWORK\lvmen\src\licensedcode\data\rules\gpl-2.0_709.yml", "YAML", 0, 0, 0, 3, 0, 0, 1, 4
"d:\IDEWORK\lvmen\src\licensedcode\data\rules\gpl-2.0_71.yml", "YAML", 0, 0, 0, 2, 0, 0, 1, 3
"d:\IDEWORK\lvmen\src\licensedcode\data\rules\gpl-2.0_710.yml", "YAML", 0, 0, 0, 3, 0, 0, 1, 4
"d:\IDEWORK\lvmen\src\licensedcode\data\rules\gpl-2.0_711.yml", "YAML", 0, 0, 0, 3, 0, 0, 1, 4
"d:\IDEWORK\lvmen\src\licensedcode\data\rules\gpl-2.0_712.yml", "YAML", 0, 0, 0, 3, 0, 0, 1, 4
"d:\IDEWORK\lvmen\src\licensedcode\data\rules\gpl-2.0_713.yml", "YAML", 0, 0, 0, 3, 0, 0, 1, 4
"d:\IDEWORK\lvmen\src\licensedcode\data\rules\gpl-2.0_714.yml", "YAML", 0, 0, 0, 3, 0, 0, 1, 4
"d:\IDEWORK\lvmen\src\licensedcode\data\rules\gpl-2.0_715.yml", "YAML", 0, 0, 0, 3, 0, 0, 1, 4
"d:\IDEWORK\lvmen\src\licensedcode\data\rules\gpl-2.0_716.yml", "YAML", 0, 0, 0, 5, 0, 0, 1, 6
"d:\IDEWORK\lvmen\src\licensedcode\data\rules\gpl-2.0_717.yml", "YAML", 0, 0, 0, 3, 0, 0, 1, 4
"d:\IDEWORK\lvmen\src\licensedcode\data\rules\gpl-2.0_718.yml", "YAML", 0, 0, 0, 3, 0, 0, 1, 4
"d:\IDEWORK\lvmen\src\licensedcode\data\rules\gpl-2.0_719.yml", "YAML", 0, 0, 0, 5, 0, 0, 1, 6
"d:\IDEWORK\lvmen\src\licensedcode\data\rules\gpl-2.0_72.yml", "YAML", 0, 0, 0, 2, 0, 0, 1, 3
"d:\IDEWORK\lvmen\src\licensedcode\data\rules\gpl-2.0_720.yml", "YAML", 0, 0, 0, 5, 0, 0, 1, 6
"d:\IDEWORK\lvmen\src\licensedcode\data\rules\gpl-2.0_721.yml", "YAML", 0, 0, 0, 5, 0, 0, 1, 6
"d:\IDEWORK\lvmen\src\licensedcode\data\rules\gpl-2.0_722.yml", "YAML", 0, 0, 0, 3, 0, 0, 1, 4
"d:\IDEWORK\lvmen\src\licensedcode\data\rules\gpl-2.0_723.yml", "YAML", 0, 0, 0, 9, 0, 0, 1, 10
"d:\IDEWORK\lvmen\src\licensedcode\data\rules\gpl-2.0_724.yml", "YAML", 0, 0, 0, 3, 0, 0, 1, 4
"d:\IDEWORK\lvmen\src\licensedcode\data\rules\gpl-2.0_725.yml", "YAML", 0, 0, 0, 3, 0, 0, 1, 4
"d:\IDEWORK\lvmen\src\licensedcode\data\rules\gpl-2.0_726.yml", "YAML", 0, 0, 0, 3, 0, 0, 1, 4
"d:\IDEWORK\lvmen\src\licensedcode\data\rules\gpl-2.0_727.yml", "YAML", 0, 0, 0, 3, 0, 0, 1, 4
"d:\IDEWORK\lvmen\src\licensedcode\data\rules\gpl-2.0_728.yml", "YAML", 0, 0, 0, 3, 0, 0, 1, 4
"d:\IDEWORK\lvmen\src\licensedcode\data\rules\gpl-2.0_729.yml", "YAML", 0, 0, 0, 7, 0, 0, 1, 8
"d:\IDEWORK\lvmen\src\licensedcode\data\rules\gpl-2.0_73.yml", "YAML", 0, 0, 0, 4, 0, 0, 1, 5
"d:\IDEWORK\lvmen\src\licensedcode\data\rules\gpl-2.0_730.yml", "YAML", 0, 0, 0, 7, 0, 0, 1, 8
"d:\IDEWORK\lvmen\src\licensedcode\data\rules\gpl-2.0_731.yml", "YAML", 0, 0, 0, 3, 0, 0, 1, 4
"d:\IDEWORK\lvmen\src\licensedcode\data\rules\gpl-2.0_732.yml", "YAML", 0, 0, 0, 3, 0, 0, 1, 4
"d:\IDEWORK\lvmen\src\licensedcode\data\rules\gpl-2.0_733.yml", "YAML", 0, 0, 0, 7, 0, 0, 1, 8
"d:\IDEWORK\lvmen\src\licensedcode\data\rules\gpl-2.0_734.yml", "YAML", 0, 0, 0, 7, 0, 0, 1, 8
"d:\IDEWORK\lvmen\src\licensedcode\data\rules\gpl-2.0_735.yml", "YAML", 0, 0, 0, 7, 0, 0, 1, 8
"d:\IDEWORK\lvmen\src\licensedcode\data\rules\gpl-2.0_736.yml", "YAML", 0, 0, 0, 7, 0, 0, 1, 8
"d:\IDEWORK\lvmen\src\licensedcode\data\rules\gpl-2.0_737.yml", "YAML", 0, 0, 0, 3, 0, 0, 1, 4
"d:\IDEWORK\lvmen\src\licensedcode\data\rules\gpl-2.0_738.yml", "YAML", 0, 0, 0, 3, 0, 0, 1, 4
"d:\IDEWORK\lvmen\src\licensedcode\data\rules\gpl-2.0_739.yml", "YAML", 0, 0, 0, 7, 0, 0, 1, 8
"d:\IDEWORK\lvmen\src\licensedcode\data\rules\gpl-2.0_74.yml", "YAML", 0, 0, 0, 3, 0, 0, 1, 4
"d:\IDEWORK\lvmen\src\licensedcode\data\rules\gpl-2.0_740.yml", "YAML", 0, 0, 0, 7, 0, 0, 1, 8
"d:\IDEWORK\lvmen\src\licensedcode\data\rules\gpl-2.0_741.yml", "YAML", 0, 0, 0, 9, 0, 0, 1, 10
"d:\IDEWORK\lvmen\src\licensedcode\data\rules\gpl-2.0_742.yml", "YAML", 0, 0, 0, 9, 0, 0, 1, 10
"d:\IDEWORK\lvmen\src\licensedcode\data\rules\gpl-2.0_743.yml", "YAML", 0, 0, 0, 7, 0, 0, 1, 8
"d:\IDEWORK\lvmen\src\licensedcode\data\rules\gpl-2.0_744.yml", "YAML", 0, 0, 0, 7, 0, 0, 1, 8
"d:\IDEWORK\lvmen\src\licensedcode\data\rules\gpl-2.0_745.yml", "YAML", 0, 0, 0, 7, 0, 0, 1, 8
"d:\IDEWORK\lvmen\src\licensedcode\data\rules\gpl-2.0_746.yml", "YAML", 0, 0, 0, 7, 0, 0, 1, 8
"d:\IDEWORK\lvmen\src\licensedcode\data\rules\gpl-2.0_747.yml", "YAML", 0, 0, 0, 3, 0, 0, 1, 4
"d:\IDEWORK\lvmen\src\licensedcode\data\rules\gpl-2.0_748.yml", "YAML", 0, 0, 0, 3, 0, 0, 1, 4
"d:\IDEWORK\lvmen\src\licensedcode\data\rules\gpl-2.0_749.yml", "YAML", 0, 0, 0, 5, 0, 0, 1, 6
"d:\IDEWORK\lvmen\src\licensedcode\data\rules\gpl-2.0_75.yml", "YAML", 0, 0, 0, 9, 0, 0, 1, 10
"d:\IDEWORK\lvmen\src\licensedcode\data\rules\gpl-2.0_750.yml", "YAML", 0, 0, 0, 3, 0, 0, 1, 4
"d:\IDEWORK\lvmen\src\licensedcode\data\rules\gpl-2.0_751.yml", "YAML", 0, 0, 0, 3, 0, 0, 1, 4
"d:\IDEWORK\lvmen\src\licensedcode\data\rules\gpl-2.0_752.yml", "YAML", 0, 0, 0, 5, 0, 0, 1, 6
"d:\IDEWORK\lvmen\src\licensedcode\data\rules\gpl-2.0_753.yml", "YAML", 0, 0, 0, 5, 0, 0, 1, 6
"d:\IDEWORK\lvmen\src\licensedcode\data\rules\gpl-2.0_754.yml", "YAML", 0, 0, 0, 5, 0, 0, 1, 6
"d:\IDEWORK\lvmen\src\licensedcode\data\rules\gpl-2.0_755.yml", "YAML", 0, 0, 0, 3, 0, 0, 1, 4
"d:\IDEWORK\lvmen\src\licensedcode\data\rules\gpl-2.0_756.yml", "YAML", 0, 0, 0, 3, 0, 0, 1, 4
"d:\IDEWORK\lvmen\src\licensedcode\data\rules\gpl-2.0_757.yml", "YAML", 0, 0, 0, 3, 0, 0, 1, 4
"d:\IDEWORK\lvmen\src\licensedcode\data\rules\gpl-2.0_758.yml", "YAML", 0, 0, 0, 3, 0, 0, 1, 4
"d:\IDEWORK\lvmen\src\licensedcode\data\rules\gpl-2.0_759.yml", "YAML", 0, 0, 0, 3, 0, 0, 1, 4
"d:\IDEWORK\lvmen\src\licensedcode\data\rules\gpl-2.0_76.yml", "YAML", 0, 0, 0, 3, 0, 0, 1, 4
"d:\IDEWORK\lvmen\src\licensedcode\data\rules\gpl-2.0_760.yml", "YAML", 0, 0, 0, 5, 0, 0, 1, 6
"d:\IDEWORK\lvmen\src\licensedcode\data\rules\gpl-2.0_761.yml", "YAML", 0, 0, 0, 5, 0, 0, 1, 6
"d:\IDEWORK\lvmen\src\licensedcode\data\rules\gpl-2.0_762.yml", "YAML", 0, 0, 0, 3, 0, 0, 1, 4
"d:\IDEWORK\lvmen\src\licensedcode\data\rules\gpl-2.0_763.yml", "YAML", 0, 0, 0, 5, 0, 0, 1, 6
"d:\IDEWORK\lvmen\src\licensedcode\data\rules\gpl-2.0_764.yml", "YAML", 0, 0, 0, 5, 0, 0, 1, 6
"d:\IDEWORK\lvmen\src\licensedcode\data\rules\gpl-2.0_765.yml", "YAML", 0, 0, 0, 3, 0, 0, 1, 4
"d:\IDEWORK\lvmen\src\licensedcode\data\rules\gpl-2.0_766.yml", "YAML", 0, 0, 0, 3, 0, 0, 1, 4
"d:\IDEWORK\lvmen\src\licensedcode\data\rules\gpl-2.0_767.yml", "YAML", 0, 0, 0, 3, 0, 0, 1, 4
"d:\IDEWORK\lvmen\src\licensedcode\data\rules\gpl-2.0_768.yml", "YAML", 0, 0, 0, 3, 0, 0, 1, 4
"d:\IDEWORK\lvmen\src\licensedcode\data\rules\gpl-2.0_769.yml", "YAML", 0, 0, 0, 3, 0, 0, 1, 4
"d:\IDEWORK\lvmen\src\licensedcode\data\rules\gpl-2.0_77.yml", "YAML", 0, 0, 0, 3, 0, 0, 1, 4
"d:\IDEWORK\lvmen\src\licensedcode\data\rules\gpl-2.0_770.yml", "YAML", 0, 0, 0, 8, 0, 0, 1, 9
"d:\IDEWORK\lvmen\src\licensedcode\data\rules\gpl-2.0_771.yml", "YAML", 0, 0, 0, 5, 0, 0, 1, 6
"d:\IDEWORK\lvmen\src\licensedcode\data\rules\gpl-2.0_772.yml", "YAML", 0, 0, 0, 3, 0, 0, 1, 4
"d:\IDEWORK\lvmen\src\licensedcode\data\rules\gpl-2.0_773.yml", "YAML", 0, 0, 0, 5, 0, 0, 1, 6
"d:\IDEWORK\lvmen\src\licensedcode\data\rules\gpl-2.0_774.yml", "YAML", 0, 0, 0, 3, 0, 0, 1, 4
"d:\IDEWORK\lvmen\src\licensedcode\data\rules\gpl-2.0_775.yml", "YAML", 0, 0, 0, 3, 0, 0, 1, 4
"d:\IDEWORK\lvmen\src\licensedcode\data\rules\gpl-2.0_776.yml", "YAML", 0, 0, 0, 3, 0, 0, 1, 4
"d:\IDEWORK\lvmen\src\licensedcode\data\rules\gpl-2.0_777.yml", "YAML", 0, 0, 0, 3, 0, 0, 1, 4
"d:\IDEWORK\lvmen\src\licensedcode\data\rules\gpl-2.0_778.yml", "YAML", 0, 0, 0, 5, 0, 0, 1, 6
"d:\IDEWORK\lvmen\src\licensedcode\data\rules\gpl-2.0_779.yml", "YAML", 0, 0, 0, 3, 0, 0, 1, 4
"d:\IDEWORK\lvmen\src\licensedcode\data\rules\gpl-2.0_78.yml", "YAML", 0, 0, 0, 5, 0, 0, 1, 6
"d:\IDEWORK\lvmen\src\licensedcode\data\rules\gpl-2.0_780.yml", "YAML", 0, 0, 0, 5, 0, 0, 1, 6
"d:\IDEWORK\lvmen\src\licensedcode\data\rules\gpl-2.0_781.yml", "YAML", 0, 0, 0, 5, 0, 0, 1, 6
"d:\IDEWORK\lvmen\src\licensedcode\data\rules\gpl-2.0_782.yml", "YAML", 0, 0, 0, 5, 0, 0, 1, 6
"d:\IDEWORK\lvmen\src\licensedcode\data\rules\gpl-2.0_783.yml", "YAML", 0, 0, 0, 5, 0, 0, 1, 6
"d:\IDEWORK\lvmen\src\licensedcode\data\rules\gpl-2.0_784.yml", "YAML", 0, 0, 0, 3, 0, 0, 1, 4
"d:\IDEWORK\lvmen\src\licensedcode\data\rules\gpl-2.0_785.yml", "YAML", 0, 0, 0, 3, 0, 0, 1, 4
"d:\IDEWORK\lvmen\src\licensedcode\data\rules\gpl-2.0_786.yml", "YAML", 0, 0, 0, 3, 0, 0, 1, 4
"d:\IDEWORK\lvmen\src\licensedcode\data\rules\gpl-2.0_787.yml", "YAML", 0, 0, 0, 5, 0, 0, 1, 6
"d:\IDEWORK\lvmen\src\licensedcode\data\rules\gpl-2.0_788.yml", "YAML", 0, 0, 0, 5, 0, 0, 1, 6
"d:\IDEWORK\lvmen\src\licensedcode\data\rules\gpl-2.0_789.yml", "YAML", 0, 0, 0, 5, 0, 0, 1, 6
"d:\IDEWORK\lvmen\src\licensedcode\data\rules\gpl-2.0_79.yml", "YAML", 0, 0, 0, 5, 0, 0, 1, 6
"d:\IDEWORK\lvmen\src\licensedcode\data\rules\gpl-2.0_790.yml", "YAML", 0, 0, 0, 3, 0, 0, 1, 4
"d:\IDEWORK\lvmen\src\licensedcode\data\rules\gpl-2.0_791.yml", "YAML", 0, 0, 0, 3, 0, 0, 1, 4
"d:\IDEWORK\lvmen\src\licensedcode\data\rules\gpl-2.0_792.yml", "YAML", 0, 0, 0, 10, 0, 0, 1, 11
"d:\IDEWORK\lvmen\src\licensedcode\data\rules\gpl-2.0_793.yml", "YAML", 0, 0, 0, 3, 0, 0, 1, 4
"d:\IDEWORK\lvmen\src\licensedcode\data\rules\gpl-2.0_794.yml", "YAML", 0, 0, 0, 5, 0, 0, 1, 6
"d:\IDEWORK\lvmen\src\licensedcode\data\rules\gpl-2.0_795.yml", "YAML", 0, 0, 0, 5, 0, 0, 1, 6
"d:\IDEWORK\lvmen\src\licensedcode\data\rules\gpl-2.0_796.yml", "YAML", 0, 0, 0, 5, 0, 0, 1, 6
"d:\IDEWORK\lvmen\src\licensedcode\data\rules\gpl-2.0_797.yml", "YAML", 0, 0, 0, 3, 0, 0, 1, 4
"d:\IDEWORK\lvmen\src\licensedcode\data\rules\gpl-2.0_798.yml", "YAML", 0, 0, 0, 5, 0, 0, 1, 6
"d:\IDEWORK\lvmen\src\licensedcode\data\rules\gpl-2.0_799.yml", "YAML", 0, 0, 0, 5, 0, 0, 1, 6
"d:\IDEWORK\lvmen\src\licensedcode\data\rules\gpl-2.0_8.yml", "YAML", 0, 0, 0, 2, 0, 0, 1, 3
"d:\IDEWORK\lvmen\src\licensedcode\data\rules\gpl-2.0_80.yml", "YAML", 0, 0, 0, 4, 0, 0, 1, 5
"d:\IDEWORK\lvmen\src\licensedcode\data\rules\gpl-2.0_800.yml", "YAML", 0, 0, 0, 5, 0, 0, 1, 6
"d:\IDEWORK\lvmen\src\licensedcode\data\rules\gpl-2.0_801.yml", "YAML", 0, 0, 0, 5, 0, 0, 1, 6
"d:\IDEWORK\lvmen\src\licensedcode\data\rules\gpl-2.0_802.yml", "YAML", 0, 0, 0, 5, 0, 0, 1, 6
"d:\IDEWORK\lvmen\src\licensedcode\data\rules\gpl-2.0_803.yml", "YAML", 0, 0, 0, 5, 0, 0, 1, 6
"d:\IDEWORK\lvmen\src\licensedcode\data\rules\gpl-2.0_804.yml", "YAML", 0, 0, 0, 5, 0, 0, 1, 6
"d:\IDEWORK\lvmen\src\licensedcode\data\rules\gpl-2.0_805.yml", "YAML", 0, 0, 0, 5, 0, 0, 1, 6
"d:\IDEWORK\lvmen\src\licensedcode\data\rules\gpl-2.0_806.yml", "YAML", 0, 0, 0, 5, 0, 0, 1, 6
"d:\IDEWORK\lvmen\src\licensedcode\data\rules\gpl-2.0_807.yml", "YAML", 0, 0, 0, 5, 0, 0, 1, 6
"d:\IDEWORK\lvmen\src\licensedcode\data\rules\gpl-2.0_808.yml", "YAML", 0, 0, 0, 5, 0, 0, 1, 6
"d:\IDEWORK\lvmen\src\licensedcode\data\rules\gpl-2.0_809.yml", "YAML", 0, 0, 0, 5, 0, 0, 1, 6
"d:\IDEWORK\lvmen\src\licensedcode\data\rules\gpl-2.0_81.yml", "YAML", 0, 0, 0, 2, 0, 0, 1, 3
"d:\IDEWORK\lvmen\src\licensedcode\data\rules\gpl-2.0_810.yml", "YAML", 0, 0, 0, 5, 0, 0, 1, 6
"d:\IDEWORK\lvmen\src\licensedcode\data\rules\gpl-2.0_811.yml", "YAML", 0, 0, 0, 5, 0, 0, 1, 6
"d:\IDEWORK\lvmen\src\licensedcode\data\rules\gpl-2.0_812.yml", "YAML", 0, 0, 0, 5, 0, 0, 1, 6
"d:\IDEWORK\lvmen\src\licensedcode\data\rules\gpl-2.0_813.yml", "YAML", 0, 0, 0, 5, 0, 0, 1, 6
"d:\IDEWORK\lvmen\src\licensedcode\data\rules\gpl-2.0_814.yml", "YAML", 0, 0, 0, 3, 0, 0, 1, 4
"d:\IDEWORK\lvmen\src\licensedcode\data\rules\gpl-2.0_815.yml", "YAML", 0, 0, 0, 5, 0, 0, 1, 6
"d:\IDEWORK\lvmen\src\licensedcode\data\rules\gpl-2.0_816.yml", "YAML", 0, 0, 0, 5, 0, 0, 1, 6
"d:\IDEWORK\lvmen\src\licensedcode\data\rules\gpl-2.0_817.yml", "YAML", 0, 0, 0, 5, 0, 0, 1, 6
"d:\IDEWORK\lvmen\src\licensedcode\data\rules\gpl-2.0_818.yml", "YAML", 0, 0, 0, 3, 0, 0, 1, 4
"d:\IDEWORK\lvmen\src\licensedcode\data\rules\gpl-2.0_819.yml", "YAML", 0, 0, 0, 5, 0, 0, 1, 6
"d:\IDEWORK\lvmen\src\licensedcode\data\rules\gpl-2.0_82.yml", "YAML", 0, 0, 0, 3, 0, 0, 1, 4
"d:\IDEWORK\lvmen\src\licensedcode\data\rules\gpl-2.0_820.yml", "YAML", 0, 0, 0, 5, 0, 0, 1, 6
"d:\IDEWORK\lvmen\src\licensedcode\data\rules\gpl-2.0_821.yml", "YAML", 0, 0, 0, 3, 0, 0, 1, 4
"d:\IDEWORK\lvmen\src\licensedcode\data\rules\gpl-2.0_822.yml", "YAML", 0, 0, 0, 3, 0, 0, 1, 4
"d:\IDEWORK\lvmen\src\licensedcode\data\rules\gpl-2.0_823.yml", "YAML", 0, 0, 0, 3, 0, 0, 1, 4
"d:\IDEWORK\lvmen\src\licensedcode\data\rules\gpl-2.0_824.yml", "YAML", 0, 0, 0, 3, 0, 0, 1, 4
"d:\IDEWORK\lvmen\src\licensedcode\data\rules\gpl-2.0_825.yml", "YAML", 0, 0, 0, 3, 0, 0, 1, 4
"d:\IDEWORK\lvmen\src\licensedcode\data\rules\gpl-2.0_826.yml", "YAML", 0, 0, 0, 3, 0, 0, 1, 4
"d:\IDEWORK\lvmen\src\licensedcode\data\rules\gpl-2.0_827.yml", "YAML", 0, 0, 0, 3, 0, 0, 1, 4
"d:\IDEWORK\lvmen\src\licensedcode\data\rules\gpl-2.0_828.yml", "YAML", 0, 0, 0, 5, 0, 0, 1, 6
"d:\IDEWORK\lvmen\src\licensedcode\data\rules\gpl-2.0_829.yml", "YAML", 0, 0, 0, 3, 0, 0, 1, 4
"d:\IDEWORK\lvmen\src\licensedcode\data\rules\gpl-2.0_82_1.yml", "YAML", 0, 0, 0, 3, 0, 0, 1, 4
"d:\IDEWORK\lvmen\src\licensedcode\data\rules\gpl-2.0_83.yml", "YAML", 0, 0, 0, 4, 0, 0, 1, 5
"d:\IDEWORK\lvmen\src\licensedcode\data\rules\gpl-2.0_830.yml", "YAML", 0, 0, 0, 5, 0, 0, 1, 6
"d:\IDEWORK\lvmen\src\licensedcode\data\rules\gpl-2.0_831.yml", "YAML", 0, 0, 0, 5, 0, 0, 1, 6
"d:\IDEWORK\lvmen\src\licensedcode\data\rules\gpl-2.0_832.yml", "YAML", 0, 0, 0, 5, 0, 0, 1, 6
"d:\IDEWORK\lvmen\src\licensedcode\data\rules\gpl-2.0_833.yml", "YAML", 0, 0, 0, 3, 0, 0, 1, 4
"d:\IDEWORK\lvmen\src\licensedcode\data\rules\gpl-2.0_834.yml", "YAML", 0, 0, 0, 3, 0, 0, 1, 4
"d:\IDEWORK\lvmen\src\licensedcode\data\rules\gpl-2.0_835.yml", "YAML", 0, 0, 0, 3, 0, 0, 1, 4
"d:\IDEWORK\lvmen\src\licensedcode\data\rules\gpl-2.0_836.yml", "YAML", 0, 0, 0, 3, 0, 0, 1, 4
"d:\IDEWORK\lvmen\src\licensedcode\data\rules\gpl-2.0_837.yml", "YAML", 0, 0, 0, 3, 0, 0, 1, 4
"d:\IDEWORK\lvmen\src\licensedcode\data\rules\gpl-2.0_838.yml", "YAML", 0, 0, 0, 3, 0, 0, 1, 4
"d:\IDEWORK\lvmen\src\licensedcode\data\rules\gpl-2.0_839.yml", "YAML", 0, 0, 0, 3, 0, 0, 1, 4
"d:\IDEWORK\lvmen\src\licensedcode\data\rules\gpl-2.0_84.yml", "YAML", 0, 0, 0, 2, 0, 0, 1, 3
"d:\IDEWORK\lvmen\src\licensedcode\data\rules\gpl-2.0_840.yml", "YAML", 0, 0, 0, 3, 0, 0, 1, 4
"d:\IDEWORK\lvmen\src\licensedcode\data\rules\gpl-2.0_841.yml", "YAML", 0, 0, 0, 6, 0, 0, 1, 7
"d:\IDEWORK\lvmen\src\licensedcode\data\rules\gpl-2.0_842.yml", "YAML", 0, 0, 0, 5, 0, 0, 1, 6
"d:\IDEWORK\lvmen\src\licensedcode\data\rules\gpl-2.0_843.yml", "YAML", 0, 0, 0, 3, 0, 0, 1, 4
"d:\IDEWORK\lvmen\src\licensedcode\data\rules\gpl-2.0_844.yml", "YAML", 0, 0, 0, 3, 0, 0, 1, 4
"d:\IDEWORK\lvmen\src\licensedcode\data\rules\gpl-2.0_845.yml", "YAML", 0, 0, 0, 3, 0, 0, 1, 4
"d:\IDEWORK\lvmen\src\licensedcode\data\rules\gpl-2.0_846.yml", "YAML", 0, 0, 0, 3, 0, 0, 1, 4
"d:\IDEWORK\lvmen\src\licensedcode\data\rules\gpl-2.0_847.yml", "YAML", 0, 0, 0, 3, 0, 0, 1, 4
"d:\IDEWORK\lvmen\src\licensedcode\data\rules\gpl-2.0_848.yml", "YAML", 0, 0, 0, 3, 0, 0, 1, 4
"d:\IDEWORK\lvmen\src\licensedcode\data\rules\gpl-2.0_849.yml", "YAML", 0, 0, 0, 5, 0, 0, 1, 6
"d:\IDEWORK\lvmen\src\licensedcode\data\rules\gpl-2.0_85.yml", "YAML", 0, 0, 0, 6, 0, 0, 1, 7
"d:\IDEWORK\lvmen\src\licensedcode\data\rules\gpl-2.0_850.yml", "YAML", 0, 0, 0, 5, 0, 0, 1, 6
"d:\IDEWORK\lvmen\src\licensedcode\data\rules\gpl-2.0_851.yml", "YAML", 0, 0, 0, 3, 0, 0, 1, 4
"d:\IDEWORK\lvmen\src\licensedcode\data\rules\gpl-2.0_852.yml", "YAML", 0, 0, 0, 3, 0, 0, 1, 4
"d:\IDEWORK\lvmen\src\licensedcode\data\rules\gpl-2.0_853.yml", "YAML", 0, 0, 0, 3, 0, 0, 1, 4
"d:\IDEWORK\lvmen\src\licensedcode\data\rules\gpl-2.0_854.yml", "YAML", 0, 0, 0, 3, 0, 0, 1, 4
"d:\IDEWORK\lvmen\src\licensedcode\data\rules\gpl-2.0_855.yml", "YAML", 0, 0, 0, 3, 0, 0, 1, 4
"d:\IDEWORK\lvmen\src\licensedcode\data\rules\gpl-2.0_856.yml", "YAML", 0, 0, 0, 3, 0, 0, 1, 4
"d:\IDEWORK\lvmen\src\licensedcode\data\rules\gpl-2.0_857.yml", "YAML", 0, 0, 0, 5, 0, 0, 1, 6
"d:\IDEWORK\lvmen\src\licensedcode\data\rules\gpl-2.0_858.yml", "YAML", 0, 0, 0, 3, 0, 0, 1, 4
"d:\IDEWORK\lvmen\src\licensedcode\data\rules\gpl-2.0_859.yml", "YAML", 0, 0, 0, 4, 0, 0, 1, 5
"d:\IDEWORK\lvmen\src\licensedcode\data\rules\gpl-2.0_86.yml", "YAML", 0, 0, 0, 4, 0, 0, 1, 5
"d:\IDEWORK\lvmen\src\licensedcode\data\rules\gpl-2.0_860.yml", "YAML", 0, 0, 0, 3, 0, 0, 1, 4
"d:\IDEWORK\lvmen\src\licensedcode\data\rules\gpl-2.0_861.yml", "YAML", 0, 0, 0, 3, 0, 0, 1, 4
"d:\IDEWORK\lvmen\src\licensedcode\data\rules\gpl-2.0_862.yml", "YAML", 0, 0, 0, 3, 0, 0, 1, 4
"d:\IDEWORK\lvmen\src\licensedcode\data\rules\gpl-2.0_863.yml", "YAML", 0, 0, 0, 3, 0, 0, 1, 4
"d:\IDEWORK\lvmen\src\licensedcode\data\rules\gpl-2.0_864.yml", "YAML", 0, 0, 0, 3, 0, 0, 1, 4
"d:\IDEWORK\lvmen\src\licensedcode\data\rules\gpl-2.0_865.yml", "YAML", 0, 0, 0, 3, 0, 0, 1, 4
"d:\IDEWORK\lvmen\src\licensedcode\data\rules\gpl-2.0_866.yml", "YAML", 0, 0, 0, 3, 0, 0, 1, 4
"d:\IDEWORK\lvmen\src\licensedcode\data\rules\gpl-2.0_867.yml", "YAML", 0, 0, 0, 3, 0, 0, 1, 4
"d:\IDEWORK\lvmen\src\licensedcode\data\rules\gpl-2.0_868.yml", "YAML", 0, 0, 0, 3, 0, 0, 1, 4
"d:\IDEWORK\lvmen\src\licensedcode\data\rules\gpl-2.0_869.yml", "YAML", 0, 0, 0, 3, 0, 0, 1, 4
"d:\IDEWORK\lvmen\src\licensedcode\data\rules\gpl-2.0_87.yml", "YAML", 0, 0, 0, 2, 0, 0, 1, 3
"d:\IDEWORK\lvmen\src\licensedcode\data\rules\gpl-2.0_870.yml", "YAML", 0, 0, 0, 3, 0, 0, 1, 4
"d:\IDEWORK\lvmen\src\licensedcode\data\rules\gpl-2.0_871.yml", "YAML", 0, 0, 0, 9, 0, 0, 1, 10
"d:\IDEWORK\lvmen\src\licensedcode\data\rules\gpl-2.0_872.yml", "YAML", 0, 0, 0, 11, 0, 0, 1, 12
"d:\IDEWORK\lvmen\src\licensedcode\data\rules\gpl-2.0_873.yml", "YAML", 0, 0, 0, 5, 0, 0, 1, 6
"d:\IDEWORK\lvmen\src\licensedcode\data\rules\gpl-2.0_874.yml", "YAML", 0, 0, 0, 5, 0, 0, 1, 6
"d:\IDEWORK\lvmen\src\licensedcode\data\rules\gpl-2.0_875.yml", "YAML", 0, 0, 0, 5, 0, 0, 1, 6
"d:\IDEWORK\lvmen\src\licensedcode\data\rules\gpl-2.0_876.yml", "YAML", 0, 0, 0, 6, 0, 0, 1, 7
"d:\IDEWORK\lvmen\src\licensedcode\data\rules\gpl-2.0_877.yml", "YAML", 0, 0, 0, 3, 0, 0, 1, 4
"d:\IDEWORK\lvmen\src\licensedcode\data\rules\gpl-2.0_878.yml", "YAML", 0, 0, 0, 3, 0, 0, 1, 4
"d:\IDEWORK\lvmen\src\licensedcode\data\rules\gpl-2.0_879.yml", "YAML", 0, 0, 0, 3, 0, 0, 1, 4
"d:\IDEWORK\lvmen\src\licensedcode\data\rules\gpl-2.0_88.yml", "YAML", 0, 0, 0, 9, 0, 0, 1, 10
"d:\IDEWORK\lvmen\src\licensedcode\data\rules\gpl-2.0_880.yml", "YAML", 0, 0, 0, 3, 0, 0, 1, 4
"d:\IDEWORK\lvmen\src\licensedcode\data\rules\gpl-2.0_881.yml", "YAML", 0, 0, 0, 3, 0, 0, 1, 4
"d:\IDEWORK\lvmen\src\licensedcode\data\rules\gpl-2.0_882.yml", "YAML", 0, 0, 0, 3, 0, 0, 1, 4
"d:\IDEWORK\lvmen\src\licensedcode\data\rules\gpl-2.0_883.yml", "YAML", 0, 0, 0, 3, 0, 0, 1, 4
"d:\IDEWORK\lvmen\src\licensedcode\data\rules\gpl-2.0_884.yml", "YAML", 0, 0, 0, 3, 0, 0, 1, 4
"d:\IDEWORK\lvmen\src\licensedcode\data\rules\gpl-2.0_885.yml", "YAML", 0, 0, 0, 5, 0, 0, 1, 6
"d:\IDEWORK\lvmen\src\licensedcode\data\rules\gpl-2.0_886.yml", "YAML", 0, 0, 0, 3, 0, 0, 1, 4
"d:\IDEWORK\lvmen\src\licensedcode\data\rules\gpl-2.0_887.yml", "YAML", 0, 0, 0, 3, 0, 0, 1, 4
"d:\IDEWORK\lvmen\src\licensedcode\data\rules\gpl-2.0_888.yml", "YAML", 0, 0, 0, 3, 0, 0, 1, 4
"d:\IDEWORK\lvmen\src\licensedcode\data\rules\gpl-2.0_889.yml", "YAML", 0, 0, 0, 3, 0, 0, 1, 4
"d:\IDEWORK\lvmen\src\licensedcode\data\rules\gpl-2.0_89.yml", "YAML", 0, 0, 0, 2, 0, 0, 1, 3
"d:\IDEWORK\lvmen\src\licensedcode\data\rules\gpl-2.0_890.yml", "YAML", 0, 0, 0, 3, 0, 0, 1, 4
"d:\IDEWORK\lvmen\src\licensedcode\data\rules\gpl-2.0_891.yml", "YAML", 0, 0, 0, 8, 0, 0, 1, 9
"d:\IDEWORK\lvmen\src\licensedcode\data\rules\gpl-2.0_892.yml", "YAML", 0, 0, 0, 6, 0, 0, 1, 7
"d:\IDEWORK\lvmen\src\licensedcode\data\rules\gpl-2.0_893.yml", "YAML", 0, 0, 0, 5, 0, 0, 1, 6
"d:\IDEWORK\lvmen\src\licensedcode\data\rules\gpl-2.0_894.yml", "YAML", 0, 0, 0, 5, 0, 0, 1, 6
"d:\IDEWORK\lvmen\src\licensedcode\data\rules\gpl-2.0_895.yml", "YAML", 0, 0, 0, 3, 0, 0, 1, 4
"d:\IDEWORK\lvmen\src\licensedcode\data\rules\gpl-2.0_896.yml", "YAML", 0, 0, 0, 5, 0, 0, 1, 6
"d:\IDEWORK\lvmen\src\licensedcode\data\rules\gpl-2.0_897.yml", "YAML", 0, 0, 0, 5, 0, 0, 1, 6
"d:\IDEWORK\lvmen\src\licensedcode\data\rules\gpl-2.0_898.yml", "YAML", 0, 0, 0, 3, 0, 0, 1, 4
"d:\IDEWORK\lvmen\src\licensedcode\data\rules\gpl-2.0_899.yml", "YAML", 0, 0, 0, 3, 0, 0, 1, 4
"d:\IDEWORK\lvmen\src\licensedcode\data\rules\gpl-2.0_9.yml", "YAML", 0, 0, 0, 3, 0, 0, 1, 4
"d:\IDEWORK\lvmen\src\licensedcode\data\rules\gpl-2.0_90.yml", "YAML", 0, 0, 0, 2, 0, 0, 1, 3
"d:\IDEWORK\lvmen\src\licensedcode\data\rules\gpl-2.0_900.yml", "YAML", 0, 0, 0, 3, 0, 0, 1, 4
"d:\IDEWORK\lvmen\src\licensedcode\data\rules\gpl-2.0_901.yml", "YAML", 0, 0, 0, 5, 0, 0, 1, 6
"d:\IDEWORK\lvmen\src\licensedcode\data\rules\gpl-2.0_902.yml", "YAML", 0, 0, 0, 5, 0, 0, 1, 6
"d:\IDEWORK\lvmen\src\licensedcode\data\rules\gpl-2.0_903.yml", "YAML", 0, 0, 0, 5, 0, 0, 1, 6
"d:\IDEWORK\lvmen\src\licensedcode\data\rules\gpl-2.0_904.yml", "YAML", 0, 0, 0, 3, 0, 0, 1, 4
"d:\IDEWORK\lvmen\src\licensedcode\data\rules\gpl-2.0_905.yml", "YAML", 0, 0, 0, 3, 0, 0, 1, 4
"d:\IDEWORK\lvmen\src\licensedcode\data\rules\gpl-2.0_906.yml", "YAML", 0, 0, 0, 5, 0, 0, 1, 6
"d:\IDEWORK\lvmen\src\licensedcode\data\rules\gpl-2.0_907.yml", "YAML", 0, 0, 0, 3, 0, 0, 1, 4
"d:\IDEWORK\lvmen\src\licensedcode\data\rules\gpl-2.0_908.yml", "YAML", 0, 0, 0, 5, 0, 0, 1, 6
"d:\IDEWORK\lvmen\src\licensedcode\data\rules\gpl-2.0_909.yml", "YAML", 0, 0, 0, 6, 0, 0, 1, 7
"d:\IDEWORK\lvmen\src\licensedcode\data\rules\gpl-2.0_91.yml", "YAML", 0, 0, 0, 10, 0, 0, 1, 11
"d:\IDEWORK\lvmen\src\licensedcode\data\rules\gpl-2.0_910.yml", "YAML", 0, 0, 0, 7, 0, 0, 1, 8
"d:\IDEWORK\lvmen\src\licensedcode\data\rules\gpl-2.0_911.yml", "YAML", 0, 0, 0, 3, 0, 0, 1, 4
"d:\IDEWORK\lvmen\src\licensedcode\data\rules\gpl-2.0_912.yml", "YAML", 0, 0, 0, 9, 0, 0, 1, 10
"d:\IDEWORK\lvmen\src\licensedcode\data\rules\gpl-2.0_913.yml", "YAML", 0, 0, 0, 4, 0, 0, 1, 5
"d:\IDEWORK\lvmen\src\licensedcode\data\rules\gpl-2.0_914.yml", "YAML", 0, 0, 0, 3, 0, 0, 1, 4
"d:\IDEWORK\lvmen\src\licensedcode\data\rules\gpl-2.0_915.yml", "YAML", 0, 0, 0, 3, 0, 0, 1, 4
"d:\IDEWORK\lvmen\src\licensedcode\data\rules\gpl-2.0_916.yml", "YAML", 0, 0, 0, 3, 0, 0, 1, 4
"d:\IDEWORK\lvmen\src\licensedcode\data\rules\gpl-2.0_917.yml", "YAML", 0, 0, 0, 3, 0, 0, 1, 4
"d:\IDEWORK\lvmen\src\licensedcode\data\rules\gpl-2.0_918.yml", "YAML", 0, 0, 0, 5, 0, 0, 1, 6
"d:\IDEWORK\lvmen\src\licensedcode\data\rules\gpl-2.0_919.yml", "YAML", 0, 0, 0, 5, 0, 0, 1, 6
"d:\IDEWORK\lvmen\src\licensedcode\data\rules\gpl-2.0_92.yml", "YAML", 0, 0, 0, 8, 0, 0, 1, 9
"d:\IDEWORK\lvmen\src\licensedcode\data\rules\gpl-2.0_920.yml", "YAML", 0, 0, 0, 5, 0, 0, 1, 6
"d:\IDEWORK\lvmen\src\licensedcode\data\rules\gpl-2.0_921.yml", "YAML", 0, 0, 0, 5, 0, 0, 1, 6
"d:\IDEWORK\lvmen\src\licensedcode\data\rules\gpl-2.0_922.yml", "YAML", 0, 0, 0, 5, 0, 0, 1, 6
"d:\IDEWORK\lvmen\src\licensedcode\data\rules\gpl-2.0_923.yml", "YAML", 0, 0, 0, 5, 0, 0, 1, 6
"d:\IDEWORK\lvmen\src\licensedcode\data\rules\gpl-2.0_924.yml", "YAML", 0, 0, 0, 5, 0, 0, 1, 6
"d:\IDEWORK\lvmen\src\licensedcode\data\rules\gpl-2.0_925.yml", "YAML", 0, 0, 0, 5, 0, 0, 1, 6
"d:\IDEWORK\lvmen\src\licensedcode\data\rules\gpl-2.0_926.yml", "YAML", 0, 0, 0, 3, 0, 0, 1, 4
"d:\IDEWORK\lvmen\src\licensedcode\data\rules\gpl-2.0_927.yml", "YAML", 0, 0, 0, 3, 0, 0, 1, 4
"d:\IDEWORK\lvmen\src\licensedcode\data\rules\gpl-2.0_928.yml", "YAML", 0, 0, 0, 9, 0, 0, 1, 10
"d:\IDEWORK\lvmen\src\licensedcode\data\rules\gpl-2.0_929.yml", "YAML", 0, 0, 0, 3, 0, 0, 1, 4
"d:\IDEWORK\lvmen\src\licensedcode\data\rules\gpl-2.0_93.yml", "YAML", 0, 0, 0, 5, 0, 0, 1, 6
"d:\IDEWORK\lvmen\src\licensedcode\data\rules\gpl-2.0_930.yml", "YAML", 0, 0, 0, 7, 0, 0, 1, 8
"d:\IDEWORK\lvmen\src\licensedcode\data\rules\gpl-2.0_931.yml", "YAML", 0, 0, 0, 3, 0, 0, 1, 4
"d:\IDEWORK\lvmen\src\licensedcode\data\rules\gpl-2.0_932.yml", "YAML", 0, 0, 0, 3, 0, 0, 1, 4
"d:\IDEWORK\lvmen\src\licensedcode\data\rules\gpl-2.0_933.yml", "YAML", 0, 0, 0, 3, 0, 0, 1, 4
"d:\IDEWORK\lvmen\src\licensedcode\data\rules\gpl-2.0_934.yml", "YAML", 0, 0, 0, 5, 0, 0, 1, 6
"d:\IDEWORK\lvmen\src\licensedcode\data\rules\gpl-2.0_935.yml", "YAML", 0, 0, 0, 4, 0, 0, 1, 5
"d:\IDEWORK\lvmen\src\licensedcode\data\rules\gpl-2.0_936.yml", "YAML", 0, 0, 0, 4, 0, 0, 1, 5
"d:\IDEWORK\lvmen\src\licensedcode\data\rules\gpl-2.0_937.yml", "YAML", 0, 0, 0, 4, 0, 0, 1, 5
"d:\IDEWORK\lvmen\src\licensedcode\data\rules\gpl-2.0_938.yml", "YAML", 0, 0, 0, 4, 0, 0, 1, 5
"d:\IDEWORK\lvmen\src\licensedcode\data\rules\gpl-2.0_939.yml", "YAML", 0, 0, 0, 4, 0, 0, 1, 5
"d:\IDEWORK\lvmen\src\licensedcode\data\rules\gpl-2.0_94.yml", "YAML", 0, 0, 0, 10, 0, 0, 1, 11
"d:\IDEWORK\lvmen\src\licensedcode\data\rules\gpl-2.0_940.yml", "YAML", 0, 0, 0, 4, 0, 0, 1, 5
"d:\IDEWORK\lvmen\src\licensedcode\data\rules\gpl-2.0_941.yml", "YAML", 0, 0, 0, 4, 0, 0, 1, 5
"d:\IDEWORK\lvmen\src\licensedcode\data\rules\gpl-2.0_942.yml", "YAML", 0, 0, 0, 4, 0, 0, 1, 5
"d:\IDEWORK\lvmen\src\licensedcode\data\rules\gpl-2.0_943.yml", "YAML", 0, 0, 0, 4, 0, 0, 1, 5
"d:\IDEWORK\lvmen\src\licensedcode\data\rules\gpl-2.0_944.yml", "YAML", 0, 0, 0, 4, 0, 0, 1, 5
"d:\IDEWORK\lvmen\src\licensedcode\data\rules\gpl-2.0_945.yml", "YAML", 0, 0, 0, 4, 0, 0, 1, 5
"d:\IDEWORK\lvmen\src\licensedcode\data\rules\gpl-2.0_946.yml", "YAML", 0, 0, 0, 4, 0, 0, 1, 5
"d:\IDEWORK\lvmen\src\licensedcode\data\rules\gpl-2.0_947.yml", "YAML", 0, 0, 0, 4, 0, 0, 1, 5
"d:\IDEWORK\lvmen\src\licensedcode\data\rules\gpl-2.0_948.yml", "YAML", 0, 0, 0, 3, 0, 0, 1, 4
"d:\IDEWORK\lvmen\src\licensedcode\data\rules\gpl-2.0_949.yml", "YAML", 0, 0, 0, 3, 0, 0, 1, 4
"d:\IDEWORK\lvmen\src\licensedcode\data\rules\gpl-2.0_95.yml", "YAML", 0, 0, 0, 2, 0, 0, 1, 3
"d:\IDEWORK\lvmen\src\licensedcode\data\rules\gpl-2.0_950.yml", "YAML", 0, 0, 0, 6, 0, 0, 1, 7
"d:\IDEWORK\lvmen\src\licensedcode\data\rules\gpl-2.0_951.yml", "YAML", 0, 0, 0, 4, 0, 0, 1, 5
"d:\IDEWORK\lvmen\src\licensedcode\data\rules\gpl-2.0_952.yml", "YAML", 0, 0, 0, 4, 0, 0, 1, 5
"d:\IDEWORK\lvmen\src\licensedcode\data\rules\gpl-2.0_953.yml", "YAML", 0, 0, 0, 4, 0, 0, 1, 5
"d:\IDEWORK\lvmen\src\licensedcode\data\rules\gpl-2.0_954.yml", "YAML", 0, 0, 0, 3, 0, 0, 1, 4
"d:\IDEWORK\lvmen\src\licensedcode\data\rules\gpl-2.0_955.yml", "YAML", 0, 0, 0, 5, 0, 0, 1, 6
"d:\IDEWORK\lvmen\src\licensedcode\data\rules\gpl-2.0_956.yml", "YAML", 0, 0, 0, 3, 0, 0, 1, 4
"d:\IDEWORK\lvmen\src\licensedcode\data\rules\gpl-2.0_957.yml", "YAML", 0, 0, 0, 3, 0, 0, 1, 4
"d:\IDEWORK\lvmen\src\licensedcode\data\rules\gpl-2.0_958.yml", "YAML", 0, 0, 0, 3, 0, 0, 1, 4
"d:\IDEWORK\lvmen\src\licensedcode\data\rules\gpl-2.0_959.yml", "YAML", 0, 0, 0, 5, 0, 0, 1, 6
"d:\IDEWORK\lvmen\src\licensedcode\data\rules\gpl-2.0_96.yml", "YAML", 0, 0, 0, 4, 0, 0, 1, 5
"d:\IDEWORK\lvmen\src\licensedcode\data\rules\gpl-2.0_960.yml", "YAML", 0, 0, 0, 3, 0, 0, 1, 4
"d:\IDEWORK\lvmen\src\licensedcode\data\rules\gpl-2.0_961.yml", "YAML", 0, 0, 0, 3, 0, 0, 1, 4
"d:\IDEWORK\lvmen\src\licensedcode\data\rules\gpl-2.0_962.yml", "YAML", 0, 0, 0, 3, 0, 0, 1, 4
"d:\IDEWORK\lvmen\src\licensedcode\data\rules\gpl-2.0_963.yml", "YAML", 0, 0, 0, 5, 0, 0, 1, 6
"d:\IDEWORK\lvmen\src\licensedcode\data\rules\gpl-2.0_964.yml", "YAML", 0, 0, 0, 8, 0, 0, 1, 9
"d:\IDEWORK\lvmen\src\licensedcode\data\rules\gpl-2.0_965.yml", "YAML", 0, 0, 0, 8, 0, 0, 1, 9
"d:\IDEWORK\lvmen\src\licensedcode\data\rules\gpl-2.0_966.yml", "YAML", 0, 0, 0, 5, 0, 0, 1, 6
"d:\IDEWORK\lvmen\src\licensedcode\data\rules\gpl-2.0_967.yml", "YAML", 0, 0, 0, 3, 0, 0, 1, 4
"d:\IDEWORK\lvmen\src\licensedcode\data\rules\gpl-2.0_968.yml", "YAML", 0, 0, 0, 3, 0, 0, 1, 4
"d:\IDEWORK\lvmen\src\licensedcode\data\rules\gpl-2.0_969.yml", "YAML", 0, 0, 0, 3, 0, 0, 1, 4
"d:\IDEWORK\lvmen\src\licensedcode\data\rules\gpl-2.0_97.yml", "YAML", 0, 0, 0, 2, 0, 0, 1, 3
"d:\IDEWORK\lvmen\src\licensedcode\data\rules\gpl-2.0_970.yml", "YAML", 0, 0, 0, 3, 0, 0, 1, 4
"d:\IDEWORK\lvmen\src\licensedcode\data\rules\gpl-2.0_971.yml", "YAML", 0, 0, 0, 5, 0, 0, 1, 6
"d:\IDEWORK\lvmen\src\licensedcode\data\rules\gpl-2.0_972.yml", "YAML", 0, 0, 0, 5, 0, 0, 1, 6
"d:\IDEWORK\lvmen\src\licensedcode\data\rules\gpl-2.0_973.yml", "YAML", 0, 0, 0, 3, 0, 0, 1, 4
"d:\IDEWORK\lvmen\src\licensedcode\data\rules\gpl-2.0_974.yml", "YAML", 0, 0, 0, 5, 0, 0, 1, 6
"d:\IDEWORK\lvmen\src\licensedcode\data\rules\gpl-2.0_975.yml", "YAML", 0, 0, 0, 3, 0, 0, 1, 4
"d:\IDEWORK\lvmen\src\licensedcode\data\rules\gpl-2.0_976.yml", "YAML", 0, 0, 0, 3, 0, 0, 1, 4
"d:\IDEWORK\lvmen\src\licensedcode\data\rules\gpl-2.0_977.yml", "YAML", 0, 0, 0, 7, 0, 0, 1, 8
"d:\IDEWORK\lvmen\src\licensedcode\data\rules\gpl-2.0_978.yml", "YAML", 0, 0, 0, 5, 0, 0, 1, 6
"d:\IDEWORK\lvmen\src\licensedcode\data\rules\gpl-2.0_979.yml", "YAML", 0, 0, 0, 3, 0, 0, 1, 4
"d:\IDEWORK\lvmen\src\licensedcode\data\rules\gpl-2.0_98.yml", "YAML", 0, 0, 0, 2, 0, 0, 1, 3
"d:\IDEWORK\lvmen\src\licensedcode\data\rules\gpl-2.0_980.yml", "YAML", 0, 0, 0, 3, 0, 0, 1, 4
"d:\IDEWORK\lvmen\src\licensedcode\data\rules\gpl-2.0_981.yml", "YAML", 0, 0, 0, 5, 0, 0, 1, 6
"d:\IDEWORK\lvmen\src\licensedcode\data\rules\gpl-2.0_982.yml", "YAML", 0, 0, 0, 3, 0, 0, 1, 4
"d:\IDEWORK\lvmen\src\licensedcode\data\rules\gpl-2.0_983.yml", "YAML", 0, 0, 0, 5, 0, 0, 1, 6
"d:\IDEWORK\lvmen\src\licensedcode\data\rules\gpl-2.0_984.yml", "YAML", 0, 0, 0, 5, 0, 0, 1, 6
"d:\IDEWORK\lvmen\src\licensedcode\data\rules\gpl-2.0_985.yml", "YAML", 0, 0, 0, 5, 0, 0, 1, 6
"d:\IDEWORK\lvmen\src\licensedcode\data\rules\gpl-2.0_986.yml", "YAML", 0, 0, 0, 3, 0, 0, 1, 4
"d:\IDEWORK\lvmen\src\licensedcode\data\rules\gpl-2.0_987.yml", "YAML", 0, 0, 0, 5, 0, 0, 1, 6
"d:\IDEWORK\lvmen\src\licensedcode\data\rules\gpl-2.0_988.yml", "YAML", 0, 0, 0, 3, 0, 0, 1, 4
"d:\IDEWORK\lvmen\src\licensedcode\data\rules\gpl-2.0_989.yml", "YAML", 0, 0, 0, 3, 0, 0, 1, 4
"d:\IDEWORK\lvmen\src\licensedcode\data\rules\gpl-2.0_99.yml", "YAML", 0, 0, 0, 3, 0, 0, 1, 4
"d:\IDEWORK\lvmen\src\licensedcode\data\rules\gpl-2.0_990.yml", "YAML", 0, 0, 0, 5, 0, 0, 1, 6
"d:\IDEWORK\lvmen\src\licensedcode\data\rules\gpl-2.0_991.yml", "YAML", 0, 0, 0, 5, 0, 0, 1, 6
"d:\IDEWORK\lvmen\src\licensedcode\data\rules\gpl-2.0_992.yml", "YAML", 0, 0, 0, 3, 0, 0, 1, 4
"d:\IDEWORK\lvmen\src\licensedcode\data\rules\gpl-2.0_993.yml", "YAML", 0, 0, 0, 3, 0, 0, 1, 4
"d:\IDEWORK\lvmen\src\licensedcode\data\rules\gpl-2.0_994.yml", "YAML", 0, 0, 0, 6, 0, 0, 1, 7
"d:\IDEWORK\lvmen\src\licensedcode\data\rules\gpl-2.0_995.yml", "YAML", 0, 0, 0, 4, 0, 0, 1, 5
"d:\IDEWORK\lvmen\src\licensedcode\data\rules\gpl-2.0_996.yml", "YAML", 0, 0, 0, 3, 0, 0, 1, 4
"d:\IDEWORK\lvmen\src\licensedcode\data\rules\gpl-2.0_997.yml", "YAML", 0, 0, 0, 5, 0, 0, 1, 6
"d:\IDEWORK\lvmen\src\licensedcode\data\rules\gpl-2.0_998.yml", "YAML", 0, 0, 0, 5, 0, 0, 1, 6
"d:\IDEWORK\lvmen\src\licensedcode\data\rules\gpl-2.0_999.yml", "YAML", 0, 0, 0, 5, 0, 0, 1, 6
"d:\IDEWORK\lvmen\src\licensedcode\data\rules\gpl-2.0_and-unknown-license-reference_1.yml", "YAML", 0, 0, 0, 4, 0, 0, 1, 5
"d:\IDEWORK\lvmen\src\licensedcode\data\rules\gpl-2.0_and_bsd-new_and_mit_1.yml", "YAML", 0, 0, 0, 2, 0, 0, 1, 3
"d:\IDEWORK\lvmen\src\licensedcode\data\rules\gpl-2.0_and_bsd-new_or_gpl-2.0_1.yml", "YAML", 0, 0, 0, 6, 0, 0, 1, 7
"d:\IDEWORK\lvmen\src\licensedcode\data\rules\gpl-2.0_and_epl-1.0_1.yml", "YAML", 0, 0, 0, 6, 0, 0, 1, 7
"d:\IDEWORK\lvmen\src\licensedcode\data\rules\gpl-2.0_and_epl-1.0_2.yml", "YAML", 0, 0, 0, 6, 0, 0, 1, 7
"d:\IDEWORK\lvmen\src\licensedcode\data\rules\gpl-2.0_and_free-unknown_1.yml", "YAML", 0, 0, 0, 4, 0, 0, 1, 5
"d:\IDEWORK\lvmen\src\licensedcode\data\rules\gpl-2.0_and_free-unknown_2.yml", "YAML", 0, 0, 0, 4, 0, 0, 1, 5
"d:\IDEWORK\lvmen\src\licensedcode\data\rules\gpl-2.0_and_free-unknown_3.yml", "YAML", 0, 0, 0, 3, 0, 0, 1, 4
"d:\IDEWORK\lvmen\src\licensedcode\data\rules\gpl-2.0_and_free-unknown_4.yml", "YAML", 0, 0, 0, 4, 0, 0, 1, 5
"d:\IDEWORK\lvmen\src\licensedcode\data\rules\gpl-2.0_and_free-unknown_centos_notice_2.yml", "YAML", 0, 0, 0, 3, 0, 0, 1, 4
"d:\IDEWORK\lvmen\src\licensedcode\data\rules\gpl-2.0_and_free-unknown_centos_notice_3.yml", "YAML", 0, 0, 0, 2, 0, 0, 1, 3
"d:\IDEWORK\lvmen\src\licensedcode\data\rules\gpl-2.0_and_generic-cla_and_mit_1.yml", "YAML", 0, 0, 0, 4, 0, 0, 1, 5
"d:\IDEWORK\lvmen\src\licensedcode\data\rules\gpl-2.0_and_gpl-2.0-plus.yml", "YAML", 0, 0, 0, 3, 0, 0, 1, 4
"d:\IDEWORK\lvmen\src\licensedcode\data\rules\gpl-2.0_and_gpl-2.0-plus2.yml", "YAML", 0, 0, 0, 7, 0, 0, 1, 8
"d:\IDEWORK\lvmen\src\licensedcode\data\rules\gpl-2.0_and_gpl-2.0-plus_1.yml", "YAML", 0, 0, 0, 7, 0, 0, 1, 8
"d:\IDEWORK\lvmen\src\licensedcode\data\rules\gpl-2.0_and_gpl-2.0-plus_2.yml", "YAML", 0, 0, 0, 5, 0, 0, 1, 6
"d:\IDEWORK\lvmen\src\licensedcode\data\rules\gpl-2.0_and_gpl-2.0_or_gpl-2.0-plus_1.yml", "YAML", 0, 0, 0, 5, 0, 0, 1, 6
"d:\IDEWORK\lvmen\src\licensedcode\data\rules\gpl-2.0_and_gpl-2.0_or_gpl-2.0-plus_2.yml", "YAML", 0, 0, 0, 6, 0, 0, 1, 7
"d:\IDEWORK\lvmen\src\licensedcode\data\rules\gpl-2.0_and_gpl-2.0_or_lgpl-2.0_1.yml", "YAML", 0, 0, 0, 3, 0, 0, 1, 4
"d:\IDEWORK\lvmen\src\licensedcode\data\rules\gpl-2.0_and_gpl-2.0_or_lgpl-2.0_4.yml", "YAML", 0, 0, 0, 3, 0, 0, 1, 4
"d:\IDEWORK\lvmen\src\licensedcode\data\rules\gpl-2.0_and_gpl-2.0_or_lgpl-2.0_5.yml", "YAML", 0, 0, 0, 3, 0, 0, 1, 4
"d:\IDEWORK\lvmen\src\licensedcode\data\rules\gpl-2.0_and_gpl-2.0_or_lgpl-2.0_7.yml", "YAML", 0, 0, 0, 2, 0, 0, 1, 3
"d:\IDEWORK\lvmen\src\licensedcode\data\rules\gpl-2.0_and_gpl-2.0_or_lgpl-2.1_f2fs_1.yml", "YAML", 0, 0, 0, 3, 0, 0, 1, 4
"d:\IDEWORK\lvmen\src\licensedcode\data\rules\gpl-2.0_and_khronos.yml", "YAML", 0, 0, 0, 3, 0, 0, 1, 4
"d:\IDEWORK\lvmen\src\licensedcode\data\rules\gpl-2.0_and_lgpl-2.0-plus.yml", "YAML", 0, 0, 0, 9, 0, 0, 1, 10
"d:\IDEWORK\lvmen\src\licensedcode\data\rules\gpl-2.0_and_lgpl-2.0.yml", "YAML", 0, 0, 0, 5, 0, 0, 1, 6
"d:\IDEWORK\lvmen\src\licensedcode\data\rules\gpl-2.0_and_lgpl-2.0_2.yml", "YAML", 0, 0, 0, 4, 0, 0, 1, 5
"d:\IDEWORK\lvmen\src\licensedcode\data\rules\gpl-2.0_and_lgpl-2.0_3.yml", "YAML", 0, 0, 0, 4, 0, 0, 1, 5
"d:\IDEWORK\lvmen\src\licensedcode\data\rules\gpl-2.0_and_lgpl-2.0_4.yml", "YAML", 0, 0, 0, 5, 0, 0, 1, 6
"d:\IDEWORK\lvmen\src\licensedcode\data\rules\gpl-2.0_and_lgpl-2.0_and_bsd-new_and_mit_1.yml", "YAML", 0, 0, 0, 5, 0, 0, 1, 6
"d:\IDEWORK\lvmen\src\licensedcode\data\rules\gpl-2.0_and_lgpl-2.0_and_bsd-new_and_mit_2.yml", "YAML", 0, 0, 0, 3, 0, 0, 1, 4
"d:\IDEWORK\lvmen\src\licensedcode\data\rules\gpl-2.0_and_lgpl-2.0_and_bsd-new_and_mit_3.yml", "YAML", 0, 0, 0, 3, 0, 0, 1, 4
"d:\IDEWORK\lvmen\src\licensedcode\data\rules\gpl-2.0_and_lgpl-2.0_and_bsd-new_and_mit_4.yml", "YAML", 0, 0, 0, 3, 0, 0, 1, 4
"d:\IDEWORK\lvmen\src\licensedcode\data\rules\gpl-2.0_and_lgpl-2.0_and_bsd-new_and_mit_5.yml", "YAML", 0, 0, 0, 6, 0, 0, 1, 7
"d:\IDEWORK\lvmen\src\licensedcode\data\rules\gpl-2.0_and_lgpl-2.0_and_gpl-3.0_1.yml", "YAML", 0, 0, 0, 4, 0, 0, 1, 5
"d:\IDEWORK\lvmen\src\licensedcode\data\rules\gpl-2.0_and_lgpl-2.0_and_gpl-3.0_2.yml", "YAML", 0, 0, 0, 4, 0, 0, 1, 5
"d:\IDEWORK\lvmen\src\licensedcode\data\rules\gpl-2.0_and_lgpl-2.0_and_gpl-3.0_3.yml", "YAML", 0, 0, 0, 4, 0, 0, 1, 5
"d:\IDEWORK\lvmen\src\licensedcode\data\rules\gpl-2.0_and_lgpl-2.1-plus_and_other-permissive_1.yml", "YAML", 0, 0, 0, 5, 0, 0, 1, 6
"d:\IDEWORK\lvmen\src\licensedcode\data\rules\gpl-2.0_and_lgpl-2.1_1.yml", "YAML", 0, 0, 0, 3, 0, 0, 1, 4
"d:\IDEWORK\lvmen\src\licensedcode\data\rules\gpl-2.0_and_lgpl-2.1_10.yml", "YAML", 0, 0, 0, 5, 0, 0, 1, 6
"d:\IDEWORK\lvmen\src\licensedcode\data\rules\gpl-2.0_and_lgpl-2.1_2.yml", "YAML", 0, 0, 0, 3, 0, 0, 1, 4
"d:\IDEWORK\lvmen\src\licensedcode\data\rules\gpl-2.0_and_lgpl-2.1_3.yml", "YAML", 0, 0, 0, 3, 0, 0, 1, 4
"d:\IDEWORK\lvmen\src\licensedcode\data\rules\gpl-2.0_and_lgpl-2.1_4.yml", "YAML", 0, 0, 0, 3, 0, 0, 1, 4
"d:\IDEWORK\lvmen\src\licensedcode\data\rules\gpl-2.0_and_lgpl-2.1_5.yml", "YAML", 0, 0, 0, 3, 0, 0, 1, 4
"d:\IDEWORK\lvmen\src\licensedcode\data\rules\gpl-2.0_and_lgpl-2.1_6.yml", "YAML", 0, 0, 0, 6, 0, 0, 1, 7
"d:\IDEWORK\lvmen\src\licensedcode\data\rules\gpl-2.0_and_lgpl-2.1_7.yml", "YAML", 0, 0, 0, 6, 0, 0, 1, 7
"d:\IDEWORK\lvmen\src\licensedcode\data\rules\gpl-2.0_and_lgpl-2.1_8.yml", "YAML", 0, 0, 0, 6, 0, 0, 1, 7
"d:\IDEWORK\lvmen\src\licensedcode\data\rules\gpl-2.0_and_lgpl-2.1_9.yml", "YAML", 0, 0, 0, 6, 0, 0, 1, 7
"d:\IDEWORK\lvmen\src\licensedcode\data\rules\gpl-2.0_and_lgpl-2.1_arduino.yml", "YAML", 0, 0, 0, 3, 0, 0, 1, 4
"d:\IDEWORK\lvmen\src\licensedcode\data\rules\gpl-2.0_and_lgpl-2.1_command_and_lib_1.yml", "YAML", 0, 0, 0, 7, 0, 0, 1, 8
"d:\IDEWORK\lvmen\src\licensedcode\data\rules\gpl-2.0_and_mit-old-style-no-advert_1.yml", "YAML", 0, 0, 0, 3, 0, 0, 1, 4
"d:\IDEWORK\lvmen\src\licensedcode\data\rules\gpl-2.0_and_other-copyleft_1.yml", "YAML", 0, 0, 0, 9, 0, 0, 1, 10
"d:\IDEWORK\lvmen\src\licensedcode\data\rules\gpl-2.0_and_other-copyleft_and_other-permissive_1.yml", "YAML", 0, 0, 0, 3, 0, 0, 1, 4
"d:\IDEWORK\lvmen\src\licensedcode\data\rules\gpl-2.0_and_other-copyleft_and_other-permissive_2.yml", "YAML", 0, 0, 0, 3, 0, 0, 1, 4
"d:\IDEWORK\lvmen\src\licensedcode\data\rules\gpl-2.0_and_other-permissive_1.yml", "YAML", 0, 0, 0, 5, 0, 0, 1, 6
"d:\IDEWORK\lvmen\src\licensedcode\data\rules\gpl-2.0_and_patent-disclaimer.yml", "YAML", 0, 0, 0, 5, 0, 0, 1, 6
"d:\IDEWORK\lvmen\src\licensedcode\data\rules\gpl-2.0_and_patent-disclaimer_1.yml", "YAML", 0, 0, 0, 2, 0, 0, 1, 3
"d:\IDEWORK\lvmen\src\licensedcode\data\rules\gpl-2.0_and_patent-disclaimer_2.yml", "YAML", 0, 0, 0, 2, 0, 0, 1, 3
"d:\IDEWORK\lvmen\src\licensedcode\data\rules\gpl-2.0_and_proprietary-license_1.yml", "YAML", 0, 0, 0, 5, 0, 0, 1, 6
"d:\IDEWORK\lvmen\src\licensedcode\data\rules\gpl-2.0_and_proprietary-license_10.yml", "YAML", 0, 0, 0, 4, 0, 0, 1, 5
"d:\IDEWORK\lvmen\src\licensedcode\data\rules\gpl-2.0_and_proprietary-license_11.yml", "YAML", 0, 0, 0, 8, 0, 0, 1, 9
"d:\IDEWORK\lvmen\src\licensedcode\data\rules\gpl-2.0_and_proprietary-license_12.yml", "YAML", 0, 0, 0, 4, 0, 0, 1, 5
"d:\IDEWORK\lvmen\src\licensedcode\data\rules\gpl-2.0_and_proprietary-license_13.yml", "YAML", 0, 0, 0, 3, 0, 0, 1, 4
"d:\IDEWORK\lvmen\src\licensedcode\data\rules\gpl-2.0_and_proprietary-license_14.yml", "YAML", 0, 0, 0, 5, 0, 0, 1, 6
"d:\IDEWORK\lvmen\src\licensedcode\data\rules\gpl-2.0_and_proprietary-license_15.yml", "YAML", 0, 0, 0, 3, 0, 0, 1, 4
"d:\IDEWORK\lvmen\src\licensedcode\data\rules\gpl-2.0_and_proprietary-license_2.yml", "YAML", 0, 0, 0, 3, 0, 0, 1, 4
"d:\IDEWORK\lvmen\src\licensedcode\data\rules\gpl-2.0_and_proprietary-license_3.yml", "YAML", 0, 0, 0, 8, 0, 0, 1, 9
"d:\IDEWORK\lvmen\src\licensedcode\data\rules\gpl-2.0_and_proprietary-license_4.yml", "YAML", 0, 0, 0, 6, 0, 0, 1, 7
"d:\IDEWORK\lvmen\src\licensedcode\data\rules\gpl-2.0_and_proprietary-license_5.yml", "YAML", 0, 0, 0, 7, 0, 0, 1, 8
"d:\IDEWORK\lvmen\src\licensedcode\data\rules\gpl-2.0_and_proprietary-license_6.yml", "YAML", 0, 0, 0, 6, 0, 0, 1, 7
"d:\IDEWORK\lvmen\src\licensedcode\data\rules\gpl-2.0_and_proprietary-license_7.yml", "YAML", 0, 0, 0, 6, 0, 0, 1, 7
"d:\IDEWORK\lvmen\src\licensedcode\data\rules\gpl-2.0_and_proprietary-license_8.yml", "YAML", 0, 0, 0, 6, 0, 0, 1, 7
"d:\IDEWORK\lvmen\src\licensedcode\data\rules\gpl-2.0_and_proprietary-license_9.yml", "YAML", 0, 0, 0, 3, 0, 0, 1, 4
"d:\IDEWORK\lvmen\src\licensedcode\data\rules\gpl-2.0_and_proprietary-license_or_commercial-license_and_generic-cla_and_other-copyleft_and_other-permissive_1.yml", "YAML", 0, 0, 0, 11, 0, 0, 1, 12
"d:\IDEWORK\lvmen\src\licensedcode\data\rules\gpl-2.0_and_proprietary-license_or_commercial-license_and_others_1.yml", "YAML", 0, 0, 0, 11, 0, 0, 1, 12
"d:\IDEWORK\lvmen\src\licensedcode\data\rules\gpl-2.0_and_proprietary.yml", "YAML", 0, 0, 0, 7, 0, 0, 1, 8
"d:\IDEWORK\lvmen\src\licensedcode\data\rules\gpl-2.0_and_proprietary2.yml", "YAML", 0, 0, 0, 9, 0, 0, 1, 10
"d:\IDEWORK\lvmen\src\licensedcode\data\rules\gpl-2.0_and_proprietary3.yml", "YAML", 0, 0, 0, 11, 0, 0, 1, 12
"d:\IDEWORK\lvmen\src\licensedcode\data\rules\gpl-2.0_and_trademark-notice_and_gpl-generic-additional-terms_1.yml", "YAML", 0, 0, 0, 14, 0, 0, 1, 15
"d:\IDEWORK\lvmen\src\licensedcode\data\rules\gpl-2.0_and_unknown_trommel_1.yml", "YAML", 0, 0, 0, 9, 0, 0, 1, 10
"d:\IDEWORK\lvmen\src\licensedcode\data\rules\gpl-2.0_and_unknown_trommel_2.yml", "YAML", 0, 0, 0, 7, 0, 0, 1, 8
"d:\IDEWORK\lvmen\src\licensedcode\data\rules\gpl-2.0_arduino.yml", "YAML", 0, 0, 0, 8, 0, 0, 1, 9
"d:\IDEWORK\lvmen\src\licensedcode\data\rules\gpl-2.0_bare_single_word.yml", "YAML", 0, 0, 0, 3, 0, 0, 1, 4
"d:\IDEWORK\lvmen\src\licensedcode\data\rules\gpl-2.0_bcm.yml", "YAML", 0, 0, 0, 4, 0, 0, 1, 5
"d:\IDEWORK\lvmen\src\licensedcode\data\rules\gpl-2.0_busybox_1.yml", "YAML", 0, 0, 0, 4, 0, 0, 1, 5
"d:\IDEWORK\lvmen\src\licensedcode\data\rules\gpl-2.0_cal.yml", "YAML", 0, 0, 0, 5, 0, 0, 1, 6
"d:\IDEWORK\lvmen\src\licensedcode\data\rules\gpl-2.0_centos_notice_1.yml", "YAML", 0, 0, 0, 3, 0, 0, 1, 4
"d:\IDEWORK\lvmen\src\licensedcode\data\rules\gpl-2.0_copying_gplv2.yml", "YAML", 0, 0, 0, 3, 0, 0, 1, 4
"d:\IDEWORK\lvmen\src\licensedcode\data\rules\gpl-2.0_debian.yml", "YAML", 0, 0, 0, 5, 0, 0, 1, 6
"d:\IDEWORK\lvmen\src\licensedcode\data\rules\gpl-2.0_debian2.yml", "YAML", 0, 0, 0, 2, 0, 0, 1, 3
"d:\IDEWORK\lvmen\src\licensedcode\data\rules\gpl-2.0_gpl_20_bare_words.yml", "YAML", 0, 0, 0, 4, 0, 0, 2, 6
"d:\IDEWORK\lvmen\src\licensedcode\data\rules\gpl-2.0_intel2100_1.yml", "YAML", 0, 0, 0, 4, 0, 0, 1, 5
"d:\IDEWORK\lvmen\src\licensedcode\data\rules\gpl-2.0_intel2100_2.yml", "YAML", 0, 0, 0, 4, 0, 0, 1, 5
"d:\IDEWORK\lvmen\src\licensedcode\data\rules\gpl-2.0_intel2100_3.yml", "YAML", 0, 0, 0, 3, 0, 0, 1, 4
"d:\IDEWORK\lvmen\src\licensedcode\data\rules\gpl-2.0_kernel_229.yml", "YAML", 0, 0, 0, 4, 0, 0, 1, 5
"d:\IDEWORK\lvmen\src\licensedcode\data\rules\gpl-2.0_kernel_export_data_symbol_gpl.yml", "YAML", 0, 0, 0, 5, 0, 0, 1, 6
"d:\IDEWORK\lvmen\src\licensedcode\data\rules\gpl-2.0_kernel_export_symbol_gpl.yml", "YAML", 0, 0, 0, 5, 0, 0, 1, 6
"d:\IDEWORK\lvmen\src\licensedcode\data\rules\gpl-2.0_kernel_export_symbol_gpl_1.yml", "YAML", 0, 0, 0, 5, 0, 0, 1, 6
"d:\IDEWORK\lvmen\src\licensedcode\data\rules\gpl-2.0_kernel_export_symbol_gpl_2.yml", "YAML", 0, 0, 0, 5, 0, 0, 1, 6
"d:\IDEWORK\lvmen\src\licensedcode\data\rules\gpl-2.0_kernel_export_symbol_gpl_3.yml", "YAML", 0, 0, 0, 5, 0, 0, 1, 6
"d:\IDEWORK\lvmen\src\licensedcode\data\rules\gpl-2.0_kernel_export_tracepoint_symbol_gpl.yml", "YAML", 0, 0, 0, 5, 0, 0, 1, 6
"d:\IDEWORK\lvmen\src\licensedcode\data\rules\gpl-2.0_kodi.yml", "YAML", 0, 0, 0, 8, 0, 0, 1, 9
"d:\IDEWORK\lvmen\src\licensedcode\data\rules\gpl-2.0_kodi2.yml", "YAML", 0, 0, 0, 3, 0, 0, 1, 4
"d:\IDEWORK\lvmen\src\licensedcode\data\rules\gpl-2.0_licensebutton.yml", "YAML", 0, 0, 0, 5, 0, 0, 1, 6
"d:\IDEWORK\lvmen\src\licensedcode\data\rules\gpl-2.0_module_license.yml", "YAML", 0, 0, 0, 3, 0, 0, 1, 4
"d:\IDEWORK\lvmen\src\licensedcode\data\rules\gpl-2.0_module_license2.yml", "YAML", 0, 0, 0, 3, 0, 0, 1, 4
"d:\IDEWORK\lvmen\src\licensedcode\data\rules\gpl-2.0_module_license3.yml", "YAML", 0, 0, 0, 3, 0, 0, 1, 4
"d:\IDEWORK\lvmen\src\licensedcode\data\rules\gpl-2.0_module_license30.yml", "YAML", 0, 0, 0, 4, 0, 0, 1, 5
"d:\IDEWORK\lvmen\src\licensedcode\data\rules\gpl-2.0_module_license30_2.yml", "YAML", 0, 0, 0, 4, 0, 0, 1, 5
"d:\IDEWORK\lvmen\src\licensedcode\data\rules\gpl-2.0_module_license31.yml", "YAML", 0, 0, 0, 4, 0, 0, 1, 5
"d:\IDEWORK\lvmen\src\licensedcode\data\rules\gpl-2.0_module_license4.yml", "YAML", 0, 0, 0, 3, 0, 0, 1, 4
"d:\IDEWORK\lvmen\src\licensedcode\data\rules\gpl-2.0_not_above.yml", "YAML", 0, 0, 0, 5, 0, 0, 1, 6
"d:\IDEWORK\lvmen\src\licensedcode\data\rules\gpl-2.0_not_unknown_kernel.yml", "YAML", 0, 0, 0, 5, 0, 0, 1, 6
"d:\IDEWORK\lvmen\src\licensedcode\data\rules\gpl-2.0_nuget_url_1.yml", "YAML", 0, 0, 0, 5, 0, 0, 1, 6
"d:\IDEWORK\lvmen\src\licensedcode\data\rules\gpl-2.0_nuget_url_2.yml", "YAML", 0, 0, 0, 5, 0, 0, 1, 6
"d:\IDEWORK\lvmen\src\licensedcode\data\rules\gpl-2.0_nuget_url_3.yml", "YAML", 0, 0, 0, 5, 0, 0, 1, 6
"d:\IDEWORK\lvmen\src\licensedcode\data\rules\gpl-2.0_only.yml", "YAML", 0, 0, 0, 4, 0, 0, 1, 5
"d:\IDEWORK\lvmen\src\licensedcode\data\rules\gpl-2.0_only2.yml", "YAML", 0, 0, 0, 2, 0, 0, 1, 3
"d:\IDEWORK\lvmen\src\licensedcode\data\rules\gpl-2.0_only3.yml", "YAML", 0, 0, 0, 2, 0, 0, 1, 3
"d:\IDEWORK\lvmen\src\licensedcode\data\rules\gpl-2.0_only4.yml", "YAML", 0, 0, 0, 3, 0, 0, 1, 4
"d:\IDEWORK\lvmen\src\licensedcode\data\rules\gpl-2.0_only5.yml", "YAML", 0, 0, 0, 3, 0, 0, 1, 4
"d:\IDEWORK\lvmen\src\licensedcode\data\rules\gpl-2.0_only_402.yml", "YAML", 0, 0, 0, 3, 0, 0, 1, 4
"d:\IDEWORK\lvmen\src\licensedcode\data\rules\gpl-2.0_or_agpl-3.0_and_unknown_1.yml", "YAML", 0, 0, 0, 7, 0, 0, 1, 8
"d:\IDEWORK\lvmen\src\licensedcode\data\rules\gpl-2.0_or_anu-license.yml", "YAML", 0, 0, 0, 5, 0, 0, 1, 6
"d:\IDEWORK\lvmen\src\licensedcode\data\rules\gpl-2.0_or_apache-2.0.yml", "YAML", 0, 0, 0, 2, 0, 0, 1, 3
"d:\IDEWORK\lvmen\src\licensedcode\data\rules\gpl-2.0_or_apache-2.0_1.yml", "YAML", 0, 0, 0, 4, 0, 0, 1, 5
"d:\IDEWORK\lvmen\src\licensedcode\data\rules\gpl-2.0_or_apache-2.0_2.yml", "YAML", 0, 0, 0, 6, 0, 0, 1, 7
"d:\IDEWORK\lvmen\src\licensedcode\data\rules\gpl-2.0_or_apache-2.0_3.yml", "YAML", 0, 0, 0, 6, 0, 0, 1, 7
"d:\IDEWORK\lvmen\src\licensedcode\data\rules\gpl-2.0_or_apache-2.0_4.yml", "YAML", 0, 0, 0, 14, 0, 0, 1, 15
"d:\IDEWORK\lvmen\src\licensedcode\data\rules\gpl-2.0_or_apache-2.0_5.yml", "YAML", 0, 0, 0, 7, 0, 0, 1, 8
"d:\IDEWORK\lvmen\src\licensedcode\data\rules\gpl-2.0_or_apache-2.0_6.yml", "YAML", 0, 0, 0, 3, 0, 0, 1, 4
"d:\IDEWORK\lvmen\src\licensedcode\data\rules\gpl-2.0_or_apache-2.0_7.yml", "YAML", 0, 0, 0, 6, 0, 0, 1, 7
"d:\IDEWORK\lvmen\src\licensedcode\data\rules\gpl-2.0_or_apache-2.0_8.yml", "YAML", 0, 0, 0, 6, 0, 0, 1, 7
"d:\IDEWORK\lvmen\src\licensedcode\data\rules\gpl-2.0_or_apache-2.0_9.yml", "YAML", 0, 0, 0, 14, 0, 0, 1, 15
"d:\IDEWORK\lvmen\src\licensedcode\data\rules\gpl-2.0_or_apache-2.0_and_bsd-new_1.yml", "YAML", 0, 0, 0, 8, 0, 0, 1, 9
"d:\IDEWORK\lvmen\src\licensedcode\data\rules\gpl-2.0_or_artistic-perl-1.0_1.yml", "YAML", 0, 0, 0, 3, 0, 0, 1, 4
"d:\IDEWORK\lvmen\src\licensedcode\data\rules\gpl-2.0_or_artistic-perl-1.0_2.yml", "YAML", 0, 0, 0, 4, 0, 0, 1, 5
"d:\IDEWORK\lvmen\src\licensedcode\data\rules\gpl-2.0_or_artistic-perl-1.0_3.yml", "YAML", 0, 0, 0, 4, 0, 0, 1, 5
"d:\IDEWORK\lvmen\src\licensedcode\data\rules\gpl-2.0_or_broadcom-confidential_1.yml", "YAML", 0, 0, 0, 3, 0, 0, 1, 4
"d:\IDEWORK\lvmen\src\licensedcode\data\rules\gpl-2.0_or_broadcom-linking-unmodified_or_proprietary-license_1.yml", "YAML", 0, 0, 0, 5, 0, 0, 1, 6
"d:\IDEWORK\lvmen\src\licensedcode\data\rules\gpl-2.0_or_bsd-export_cavium.yml", "YAML", 0, 0, 0, 3, 0, 0, 1, 4
"d:\IDEWORK\lvmen\src\licensedcode\data\rules\gpl-2.0_or_bsd-new1.yml", "YAML", 0, 0, 0, 5, 0, 0, 1, 6
"d:\IDEWORK\lvmen\src\licensedcode\data\rules\gpl-2.0_or_bsd-new10.yml", "YAML", 0, 0, 0, 5, 0, 0, 1, 6
"d:\IDEWORK\lvmen\src\licensedcode\data\rules\gpl-2.0_or_bsd-new11.yml", "YAML", 0, 0, 0, 4, 0, 0, 1, 5
"d:\IDEWORK\lvmen\src\licensedcode\data\rules\gpl-2.0_or_bsd-new12.yml", "YAML", 0, 0, 0, 4, 0, 0, 1, 5
"d:\IDEWORK\lvmen\src\licensedcode\data\rules\gpl-2.0_or_bsd-new13.yml", "YAML", 0, 0, 0, 5, 0, 0, 1, 6
"d:\IDEWORK\lvmen\src\licensedcode\data\rules\gpl-2.0_or_bsd-new14.yml", "YAML", 0, 0, 0, 4, 0, 0, 1, 5
"d:\IDEWORK\lvmen\src\licensedcode\data\rules\gpl-2.0_or_bsd-new15.yml", "YAML", 0, 0, 0, 3, 0, 0, 1, 4
"d:\IDEWORK\lvmen\src\licensedcode\data\rules\gpl-2.0_or_bsd-new16.yml", "YAML", 0, 0, 0, 3, 0, 0, 1, 4
"d:\IDEWORK\lvmen\src\licensedcode\data\rules\gpl-2.0_or_bsd-new17.yml", "YAML", 0, 0, 0, 2, 0, 0, 1, 3
"d:\IDEWORK\lvmen\src\licensedcode\data\rules\gpl-2.0_or_bsd-new19.yml", "YAML", 0, 0, 0, 2, 0, 0, 1, 3
"d:\IDEWORK\lvmen\src\licensedcode\data\rules\gpl-2.0_or_bsd-new20.yml", "YAML", 0, 0, 0, 9, 0, 0, 1, 10
"d:\IDEWORK\lvmen\src\licensedcode\data\rules\gpl-2.0_or_bsd-new21.yml", "YAML", 0, 0, 0, 3, 0, 0, 1, 4
"d:\IDEWORK\lvmen\src\licensedcode\data\rules\gpl-2.0_or_bsd-new22.yml", "YAML", 0, 0, 0, 2, 0, 0, 1, 3
"d:\IDEWORK\lvmen\src\licensedcode\data\rules\gpl-2.0_or_bsd-new23.yml", "YAML", 0, 0, 0, 6, 0, 0, 1, 7
"d:\IDEWORK\lvmen\src\licensedcode\data\rules\gpl-2.0_or_bsd-new25.yml", "YAML", 0, 0, 0, 3, 0, 0, 1, 4
"d:\IDEWORK\lvmen\src\licensedcode\data\rules\gpl-2.0_or_bsd-new26.yml", "YAML", 0, 0, 0, 3, 0, 0, 1, 4
"d:\IDEWORK\lvmen\src\licensedcode\data\rules\gpl-2.0_or_bsd-new27.yml", "YAML", 0, 0, 0, 3, 0, 0, 1, 4
"d:\IDEWORK\lvmen\src\licensedcode\data\rules\gpl-2.0_or_bsd-new28.yml", "YAML", 0, 0, 0, 5, 0, 0, 1, 6
"d:\IDEWORK\lvmen\src\licensedcode\data\rules\gpl-2.0_or_bsd-new29.yml", "YAML", 0, 0, 0, 3, 0, 0, 1, 4
"d:\IDEWORK\lvmen\src\licensedcode\data\rules\gpl-2.0_or_bsd-new3.yml", "YAML", 0, 0, 0, 6, 0, 0, 1, 7
"d:\IDEWORK\lvmen\src\licensedcode\data\rules\gpl-2.0_or_bsd-new30.yml", "YAML", 0, 0, 0, 3, 0, 0, 1, 4
"d:\IDEWORK\lvmen\src\licensedcode\data\rules\gpl-2.0_or_bsd-new31.yml", "YAML", 0, 0, 0, 3, 0, 0, 1, 4
"d:\IDEWORK\lvmen\src\licensedcode\data\rules\gpl-2.0_or_bsd-new32.yml", "YAML", 0, 0, 0, 3, 0, 0, 1, 4
"d:\IDEWORK\lvmen\src\licensedcode\data\rules\gpl-2.0_or_bsd-new33.yml", "YAML", 0, 0, 0, 4, 0, 0, 1, 5
"d:\IDEWORK\lvmen\src\licensedcode\data\rules\gpl-2.0_or_bsd-new34.yml", "YAML", 0, 0, 0, 7, 0, 0, 1, 8
"d:\IDEWORK\lvmen\src\licensedcode\data\rules\gpl-2.0_or_bsd-new35.yml", "YAML", 0, 0, 0, 5, 0, 0, 1, 6
"d:\IDEWORK\lvmen\src\licensedcode\data\rules\gpl-2.0_or_bsd-new36.yml", "YAML", 0, 0, 0, 5, 0, 0, 1, 6
"d:\IDEWORK\lvmen\src\licensedcode\data\rules\gpl-2.0_or_bsd-new37.yml", "YAML", 0, 0, 0, 3, 0, 0, 1, 4
"d:\IDEWORK\lvmen\src\licensedcode\data\rules\gpl-2.0_or_bsd-new38.yml", "YAML", 0, 0, 0, 4, 0, 0, 1, 5
"d:\IDEWORK\lvmen\src\licensedcode\data\rules\gpl-2.0_or_bsd-new4.yml", "YAML", 0, 0, 0, 4, 0, 0, 1, 5
"d:\IDEWORK\lvmen\src\licensedcode\data\rules\gpl-2.0_or_bsd-new40.yml", "YAML", 0, 0, 0, 4, 0, 0, 1, 5
"d:\IDEWORK\lvmen\src\licensedcode\data\rules\gpl-2.0_or_bsd-new41.yml", "YAML", 0, 0, 0, 4, 0, 0, 1, 5
"d:\IDEWORK\lvmen\src\licensedcode\data\rules\gpl-2.0_or_bsd-new42.yml", "YAML", 0, 0, 0, 3, 0, 0, 1, 4
"d:\IDEWORK\lvmen\src\licensedcode\data\rules\gpl-2.0_or_bsd-new43.yml", "YAML", 0, 0, 0, 5, 0, 0, 1, 6
"d:\IDEWORK\lvmen\src\licensedcode\data\rules\gpl-2.0_or_bsd-new44.yml", "YAML", 0, 0, 0, 3, 0, 0, 1, 4
"d:\IDEWORK\lvmen\src\licensedcode\data\rules\gpl-2.0_or_bsd-new45.yml", "YAML", 0, 0, 0, 5, 0, 0, 1, 6
"d:\IDEWORK\lvmen\src\licensedcode\data\rules\gpl-2.0_or_bsd-new46.yml", "YAML", 0, 0, 0, 2, 0, 0, 1, 3
"d:\IDEWORK\lvmen\src\licensedcode\data\rules\gpl-2.0_or_bsd-new47.yml", "YAML", 0, 0, 0, 2, 0, 0, 1, 3
"d:\IDEWORK\lvmen\src\licensedcode\data\rules\gpl-2.0_or_bsd-new48.yml", "YAML", 0, 0, 0, 3, 0, 0, 1, 4
"d:\IDEWORK\lvmen\src\licensedcode\data\rules\gpl-2.0_or_bsd-new49.yml", "YAML", 0, 0, 0, 3, 0, 0, 1, 4
"d:\IDEWORK\lvmen\src\licensedcode\data\rules\gpl-2.0_or_bsd-new5.yml", "YAML", 0, 0, 0, 5, 0, 0, 1, 6
"d:\IDEWORK\lvmen\src\licensedcode\data\rules\gpl-2.0_or_bsd-new6.yml", "YAML", 0, 0, 0, 5, 0, 0, 1, 6
"d:\IDEWORK\lvmen\src\licensedcode\data\rules\gpl-2.0_or_bsd-new7.yml", "YAML", 0, 0, 0, 3, 0, 0, 1, 4
"d:\IDEWORK\lvmen\src\licensedcode\data\rules\gpl-2.0_or_bsd-new8.yml", "YAML", 0, 0, 0, 3, 0, 0, 1, 4
"d:\IDEWORK\lvmen\src\licensedcode\data\rules\gpl-2.0_or_bsd-new9.yml", "YAML", 0, 0, 0, 3, 0, 0, 1, 4
"d:\IDEWORK\lvmen\src\licensedcode\data\rules\gpl-2.0_or_bsd-new_1.yml", "YAML", 0, 0, 0, 3, 0, 0, 1, 4
"d:\IDEWORK\lvmen\src\licensedcode\data\rules\gpl-2.0_or_bsd-new_10.yml", "YAML", 0, 0, 0, 3, 0, 0, 1, 4
"d:\IDEWORK\lvmen\src\licensedcode\data\rules\gpl-2.0_or_bsd-new_11.yml", "YAML", 0, 0, 0, 3, 0, 0, 1, 4
"d:\IDEWORK\lvmen\src\licensedcode\data\rules\gpl-2.0_or_bsd-new_12.yml", "YAML", 0, 0, 0, 3, 0, 0, 1, 4
"d:\IDEWORK\lvmen\src\licensedcode\data\rules\gpl-2.0_or_bsd-new_13.yml", "YAML", 0, 0, 0, 3, 0, 0, 1, 4
"d:\IDEWORK\lvmen\src\licensedcode\data\rules\gpl-2.0_or_bsd-new_14.yml", "YAML", 0, 0, 0, 3, 0, 0, 1, 4
"d:\IDEWORK\lvmen\src\licensedcode\data\rules\gpl-2.0_or_bsd-new_15.yml", "YAML", 0, 0, 0, 3, 0, 0, 1, 4
"d:\IDEWORK\lvmen\src\licensedcode\data\rules\gpl-2.0_or_bsd-new_16.yml", "YAML", 0, 0, 0, 3, 0, 0, 1, 4
"d:\IDEWORK\lvmen\src\licensedcode\data\rules\gpl-2.0_or_bsd-new_17.yml", "YAML", 0, 0, 0, 3, 0, 0, 1, 4
"d:\IDEWORK\lvmen\src\licensedcode\data\rules\gpl-2.0_or_bsd-new_18.yml", "YAML", 0, 0, 0, 3, 0, 0, 1, 4
"d:\IDEWORK\lvmen\src\licensedcode\data\rules\gpl-2.0_or_bsd-new_19.yml", "YAML", 0, 0, 0, 3, 0, 0, 1, 4
"d:\IDEWORK\lvmen\src\licensedcode\data\rules\gpl-2.0_or_bsd-new_2.yml", "YAML", 0, 0, 0, 4, 0, 0, 1, 5
"d:\IDEWORK\lvmen\src\licensedcode\data\rules\gpl-2.0_or_bsd-new_20.yml", "YAML", 0, 0, 0, 3, 0, 0, 1, 4
"d:\IDEWORK\lvmen\src\licensedcode\data\rules\gpl-2.0_or_bsd-new_21.yml", "YAML", 0, 0, 0, 4, 0, 0, 1, 5
"d:\IDEWORK\lvmen\src\licensedcode\data\rules\gpl-2.0_or_bsd-new_22.yml", "YAML", 0, 0, 0, 4, 0, 0, 1, 5
"d:\IDEWORK\lvmen\src\licensedcode\data\rules\gpl-2.0_or_bsd-new_23.yml", "YAML", 0, 0, 0, 10, 0, 0, 1, 11
"d:\IDEWORK\lvmen\src\licensedcode\data\rules\gpl-2.0_or_bsd-new_24.yml", "YAML", 0, 0, 0, 4, 0, 0, 1, 5
"d:\IDEWORK\lvmen\src\licensedcode\data\rules\gpl-2.0_or_bsd-new_25.yml", "YAML", 0, 0, 0, 3, 0, 0, 1, 4
"d:\IDEWORK\lvmen\src\licensedcode\data\rules\gpl-2.0_or_bsd-new_26.yml", "YAML", 0, 0, 0, 3, 0, 0, 1, 4
"d:\IDEWORK\lvmen\src\licensedcode\data\rules\gpl-2.0_or_bsd-new_27.yml", "YAML", 0, 0, 0, 8, 0, 0, 1, 9
"d:\IDEWORK\lvmen\src\licensedcode\data\rules\gpl-2.0_or_bsd-new_3.yml", "YAML", 0, 0, 0, 6, 0, 0, 1, 7
"d:\IDEWORK\lvmen\src\licensedcode\data\rules\gpl-2.0_or_bsd-new_4.yml", "YAML", 0, 0, 0, 6, 0, 0, 1, 7
"d:\IDEWORK\lvmen\src\licensedcode\data\rules\gpl-2.0_or_bsd-new_5.yml", "YAML", 0, 0, 0, 6, 0, 0, 1, 7
"d:\IDEWORK\lvmen\src\licensedcode\data\rules\gpl-2.0_or_bsd-new_6.yml", "YAML", 0, 0, 0, 3, 0, 0, 1, 4
"d:\IDEWORK\lvmen\src\licensedcode\data\rules\gpl-2.0_or_bsd-new_7.yml", "YAML", 0, 0, 0, 2, 0, 0, 1, 3
"d:\IDEWORK\lvmen\src\licensedcode\data\rules\gpl-2.0_or_bsd-new_8.yml", "YAML", 0, 0, 0, 3, 0, 0, 1, 4
"d:\IDEWORK\lvmen\src\licensedcode\data\rules\gpl-2.0_or_bsd-new_9.yml", "YAML", 0, 0, 0, 3, 0, 0, 1, 4
"d:\IDEWORK\lvmen\src\licensedcode\data\rules\gpl-2.0_or_bsd-new_aes_1.yml", "YAML", 0, 0, 0, 6, 0, 0, 1, 7
"d:\IDEWORK\lvmen\src\licensedcode\data\rules\gpl-2.0_or_bsd-new_aes_2.yml", "YAML", 0, 0, 0, 5, 0, 0, 1, 6
"d:\IDEWORK\lvmen\src\licensedcode\data\rules\gpl-2.0_or_bsd-simplified_1.yml", "YAML", 0, 0, 0, 3, 0, 0, 1, 4
"d:\IDEWORK\lvmen\src\licensedcode\data\rules\gpl-2.0_or_bsd-simplified_10.yml", "YAML", 0, 0, 0, 3, 0, 0, 1, 4
"d:\IDEWORK\lvmen\src\licensedcode\data\rules\gpl-2.0_or_bsd-simplified_11.yml", "YAML", 0, 0, 0, 9, 0, 0, 1, 10
"d:\IDEWORK\lvmen\src\licensedcode\data\rules\gpl-2.0_or_bsd-simplified_12.yml", "YAML", 0, 0, 0, 8, 0, 0, 1, 9
"d:\IDEWORK\lvmen\src\licensedcode\data\rules\gpl-2.0_or_bsd-simplified_13.yml", "YAML", 0, 0, 0, 3, 0, 0, 1, 4
"d:\IDEWORK\lvmen\src\licensedcode\data\rules\gpl-2.0_or_bsd-simplified_14.yml", "YAML", 0, 0, 0, 8, 0, 0, 1, 9
"d:\IDEWORK\lvmen\src\licensedcode\data\rules\gpl-2.0_or_bsd-simplified_15.yml", "YAML", 0, 0, 0, 5, 0, 0, 1, 6
"d:\IDEWORK\lvmen\src\licensedcode\data\rules\gpl-2.0_or_bsd-simplified_16.yml", "YAML", 0, 0, 0, 6, 0, 0, 1, 7
"d:\IDEWORK\lvmen\src\licensedcode\data\rules\gpl-2.0_or_bsd-simplified_17.yml", "YAML", 0, 0, 0, 7, 0, 0, 1, 8
"d:\IDEWORK\lvmen\src\licensedcode\data\rules\gpl-2.0_or_bsd-simplified_19.yml", "YAML", 0, 0, 0, 7, 0, 0, 1, 8
"d:\IDEWORK\lvmen\src\licensedcode\data\rules\gpl-2.0_or_bsd-simplified_2.yml", "YAML", 0, 0, 0, 3, 0, 0, 1, 4
"d:\IDEWORK\lvmen\src\licensedcode\data\rules\gpl-2.0_or_bsd-simplified_3.yml", "YAML", 0, 0, 0, 5, 0, 0, 1, 6
"d:\IDEWORK\lvmen\src\licensedcode\data\rules\gpl-2.0_or_bsd-simplified_30.yml", "YAML", 0, 0, 0, 3, 0, 0, 1, 4
"d:\IDEWORK\lvmen\src\licensedcode\data\rules\gpl-2.0_or_bsd-simplified_4.yml", "YAML", 0, 0, 0, 5, 0, 0, 1, 6
"d:\IDEWORK\lvmen\src\licensedcode\data\rules\gpl-2.0_or_bsd-simplified_5.yml", "YAML", 0, 0, 0, 5, 0, 0, 1, 6
"d:\IDEWORK\lvmen\src\licensedcode\data\rules\gpl-2.0_or_bsd-simplified_6.yml", "YAML", 0, 0, 0, 3, 0, 0, 1, 4
"d:\IDEWORK\lvmen\src\licensedcode\data\rules\gpl-2.0_or_bsd-simplified_7.yml", "YAML", 0, 0, 0, 5, 0, 0, 1, 6
"d:\IDEWORK\lvmen\src\licensedcode\data\rules\gpl-2.0_or_bsd-simplified_8.yml", "YAML", 0, 0, 0, 5, 0, 0, 1, 6
"d:\IDEWORK\lvmen\src\licensedcode\data\rules\gpl-2.0_or_bsd-simplified_9.yml", "YAML", 0, 0, 0, 5, 0, 0, 1, 6
"d:\IDEWORK\lvmen\src\licensedcode\data\rules\gpl-2.0_or_bsd-simplified_or_cpl-1.0_1.yml", "YAML", 0, 0, 0, 3, 0, 0, 1, 4
"d:\IDEWORK\lvmen\src\licensedcode\data\rules\gpl-2.0_or_bsd-unmodified_9.yml", "YAML", 0, 0, 0, 3, 0, 0, 1, 4
"d:\IDEWORK\lvmen\src\licensedcode\data\rules\gpl-2.0_or_commercial-license_1.yml", "YAML", 0, 0, 0, 3, 0, 0, 1, 4
"d:\IDEWORK\lvmen\src\licensedcode\data\rules\gpl-2.0_or_commercial-license_2.yml", "YAML", 0, 0, 0, 3, 0, 0, 1, 4
"d:\IDEWORK\lvmen\src\licensedcode\data\rules\gpl-2.0_or_commercial-license_3.yml", "YAML", 0, 0, 0, 4, 0, 0, 1, 5
"d:\IDEWORK\lvmen\src\licensedcode\data\rules\gpl-2.0_or_commercial-license_4.yml", "YAML", 0, 0, 0, 6, 0, 0, 1, 7
"d:\IDEWORK\lvmen\src\licensedcode\data\rules\gpl-2.0_or_commercial-license_5.yml", "YAML", 0, 0, 0, 4, 0, 0, 1, 5
"d:\IDEWORK\lvmen\src\licensedcode\data\rules\gpl-2.0_or_commercial-license_6.yml", "YAML", 0, 0, 0, 7, 0, 0, 1, 8
"d:\IDEWORK\lvmen\src\licensedcode\data\rules\gpl-2.0_or_commercial-license_7.yml", "YAML", 0, 0, 0, 6, 0, 0, 1, 7
"d:\IDEWORK\lvmen\src\licensedcode\data\rules\gpl-2.0_or_commercial-option_1.yml", "YAML", 0, 0, 0, 7, 0, 0, 1, 8
"d:\IDEWORK\lvmen\src\licensedcode\data\rules\gpl-2.0_or_commercial-option_2.yml", "YAML", 0, 0, 0, 5, 0, 0, 1, 6
"d:\IDEWORK\lvmen\src\licensedcode\data\rules\gpl-2.0_or_commercial-option_3.yml", "YAML", 0, 0, 0, 5, 0, 0, 1, 6
"d:\IDEWORK\lvmen\src\licensedcode\data\rules\gpl-2.0_or_commercial-option_4.yml", "YAML", 0, 0, 0, 9, 0, 0, 1, 10
"d:\IDEWORK\lvmen\src\licensedcode\data\rules\gpl-2.0_or_commercial-option_5.yml", "YAML", 0, 0, 0, 9, 0, 0, 1, 10
"d:\IDEWORK\lvmen\src\licensedcode\data\rules\gpl-2.0_or_commercial-option_6.yml", "YAML", 0, 0, 0, 2, 0, 0, 1, 3
"d:\IDEWORK\lvmen\src\licensedcode\data\rules\gpl-2.0_or_epl-1.0_1.yml", "YAML", 0, 0, 0, 7, 0, 0, 1, 8
"d:\IDEWORK\lvmen\src\licensedcode\data\rules\gpl-2.0_or_epl-1.0_2.yml", "YAML", 0, 0, 0, 3, 0, 0, 1, 4
"d:\IDEWORK\lvmen\src\licensedcode\data\rules\gpl-2.0_or_gfdl-1.1-plus_1.yml", "YAML", 0, 0, 0, 2, 0, 0, 1, 3
"d:\IDEWORK\lvmen\src\licensedcode\data\rules\gpl-2.0_or_gfdl-1.1-plus_2.yml", "YAML", 0, 0, 0, 2, 0, 0, 1, 3
"d:\IDEWORK\lvmen\src\licensedcode\data\rules\gpl-2.0_or_gpl-2.0_1.yml", "YAML", 0, 0, 0, 3, 0, 0, 1, 4
"d:\IDEWORK\lvmen\src\licensedcode\data\rules\gpl-2.0_or_gpl-2.0_or_mit.yml", "YAML", 0, 0, 0, 4, 0, 0, 1, 5
"d:\IDEWORK\lvmen\src\licensedcode\data\rules\gpl-2.0_or_gpl-3.0-plus_1.yml", "YAML", 0, 0, 0, 6, 0, 0, 1, 7
"d:\IDEWORK\lvmen\src\licensedcode\data\rules\gpl-2.0_or_gpl-3.0_1.yml", "YAML", 0, 0, 0, 3, 0, 0, 1, 4
"d:\IDEWORK\lvmen\src\licensedcode\data\rules\gpl-2.0_or_gpl-3.0_10.yml", "YAML", 0, 0, 0, 3, 0, 0, 1, 4
"d:\IDEWORK\lvmen\src\licensedcode\data\rules\gpl-2.0_or_gpl-3.0_11.yml", "YAML", 0, 0, 0, 2, 0, 0, 1, 3
"d:\IDEWORK\lvmen\src\licensedcode\data\rules\gpl-2.0_or_gpl-3.0_12.yml", "YAML", 0, 0, 0, 3, 0, 0, 1, 4
"d:\IDEWORK\lvmen\src\licensedcode\data\rules\gpl-2.0_or_gpl-3.0_13.yml", "YAML", 0, 0, 0, 3, 0, 0, 1, 4
"d:\IDEWORK\lvmen\src\licensedcode\data\rules\gpl-2.0_or_gpl-3.0_14.yml", "YAML", 0, 0, 0, 4, 0, 0, 1, 5
"d:\IDEWORK\lvmen\src\licensedcode\data\rules\gpl-2.0_or_gpl-3.0_15.yml", "YAML", 0, 0, 0, 4, 0, 0, 1, 5
"d:\IDEWORK\lvmen\src\licensedcode\data\rules\gpl-2.0_or_gpl-3.0_16.yml", "YAML", 0, 0, 0, 5, 0, 0, 1, 6
"d:\IDEWORK\lvmen\src\licensedcode\data\rules\gpl-2.0_or_gpl-3.0_17.yml", "YAML", 0, 0, 0, 7, 0, 0, 1, 8
"d:\IDEWORK\lvmen\src\licensedcode\data\rules\gpl-2.0_or_gpl-3.0_18.yml", "YAML", 0, 0, 0, 5, 0, 0, 1, 6
"d:\IDEWORK\lvmen\src\licensedcode\data\rules\gpl-2.0_or_gpl-3.0_19.yml", "YAML", 0, 0, 0, 4, 0, 0, 1, 5
"d:\IDEWORK\lvmen\src\licensedcode\data\rules\gpl-2.0_or_gpl-3.0_2.yml", "YAML", 0, 0, 0, 3, 0, 0, 1, 4
"d:\IDEWORK\lvmen\src\licensedcode\data\rules\gpl-2.0_or_gpl-3.0_20.yml", "YAML", 0, 0, 0, 2, 0, 0, 1, 3
"d:\IDEWORK\lvmen\src\licensedcode\data\rules\gpl-2.0_or_gpl-3.0_3.yml", "YAML", 0, 0, 0, 3, 0, 0, 1, 4
"d:\IDEWORK\lvmen\src\licensedcode\data\rules\gpl-2.0_or_gpl-3.0_4.yml", "YAML", 0, 0, 0, 3, 0, 0, 1, 4
"d:\IDEWORK\lvmen\src\licensedcode\data\rules\gpl-2.0_or_gpl-3.0_5.yml", "YAML", 0, 0, 0, 4, 0, 0, 1, 5
"d:\IDEWORK\lvmen\src\licensedcode\data\rules\gpl-2.0_or_gpl-3.0_6.yml", "YAML", 0, 0, 0, 6, 0, 0, 1, 7
"d:\IDEWORK\lvmen\src\licensedcode\data\rules\gpl-2.0_or_gpl-3.0_7.yml", "YAML", 0, 0, 0, 3, 0, 0, 1, 4
"d:\IDEWORK\lvmen\src\licensedcode\data\rules\gpl-2.0_or_gpl-3.0_8.yml", "YAML", 0, 0, 0, 3, 0, 0, 1, 4
"d:\IDEWORK\lvmen\src\licensedcode\data\rules\gpl-2.0_or_gpl-3.0_9.yml", "YAML", 0, 0, 0, 3, 0, 0, 1, 4
"d:\IDEWORK\lvmen\src\licensedcode\data\rules\gpl-2.0_or_gpl-3.0_and_lgpl-2.1-plus_1.yml", "YAML", 0, 0, 0, 11, 0, 0, 1, 12
"d:\IDEWORK\lvmen\src\licensedcode\data\rules\gpl-2.0_or_gpl-3.0_or_apache-2.0_1.yml", "YAML", 0, 0, 0, 7, 0, 0, 1, 8
"d:\IDEWORK\lvmen\src\licensedcode\data\rules\gpl-2.0_or_gpl-3.0_or_apache-2.0_2.yml", "YAML", 0, 0, 0, 4, 0, 0, 1, 5
"d:\IDEWORK\lvmen\src\licensedcode\data\rules\gpl-2.0_or_gpl-3.0_or_apache-2.0_3.yml", "YAML", 0, 0, 0, 8, 0, 0, 1, 9
"d:\IDEWORK\lvmen\src\licensedcode\data\rules\gpl-2.0_or_gpl-3.0_or_kde-accepted-gpl_1.yml", "YAML", 0, 0, 0, 5, 0, 0, 1, 6
"d:\IDEWORK\lvmen\src\licensedcode\data\rules\gpl-2.0_or_gpl-3.0_or_kde-accepted-gpl_2.yml", "YAML", 0, 0, 0, 5, 0, 0, 1, 6
"d:\IDEWORK\lvmen\src\licensedcode\data\rules\gpl-2.0_or_gpl-3.0_or_kde-accepted-gpl_3.yml", "YAML", 0, 0, 0, 5, 0, 0, 1, 6
"d:\IDEWORK\lvmen\src\licensedcode\data\rules\gpl-2.0_or_gpl-3.0_or_kde-accepted-gpl_4.yml", "YAML", 0, 0, 0, 3, 0, 0, 1, 4
"d:\IDEWORK\lvmen\src\licensedcode\data\rules\gpl-2.0_or_gpl-3.0_or_kde-accepted-gpl_5.yml", "YAML", 0, 0, 0, 5, 0, 0, 1, 6
"d:\IDEWORK\lvmen\src\licensedcode\data\rules\gpl-2.0_or_gpl-3.0_or_kde-accepted-gpl_6.yml", "YAML", 0, 0, 0, 3, 0, 0, 1, 4
"d:\IDEWORK\lvmen\src\licensedcode\data\rules\gpl-2.0_or_gpl-3.0_or_kde-accepted-gpl_7.yml", "YAML", 0, 0, 0, 5, 0, 0, 1, 6
"d:\IDEWORK\lvmen\src\licensedcode\data\rules\gpl-2.0_or_ibm-pibs_1.yml", "YAML", 0, 0, 0, 7, 0, 0, 1, 8
"d:\IDEWORK\lvmen\src\licensedcode\data\rules\gpl-2.0_or_lgpl-2.0-plus_1.yml", "YAML", 0, 0, 0, 5, 0, 0, 1, 6
"d:\IDEWORK\lvmen\src\licensedcode\data\rules\gpl-2.0_or_lgpl-2.0_1.yml", "YAML", 0, 0, 0, 9, 0, 0, 1, 10
"d:\IDEWORK\lvmen\src\licensedcode\data\rules\gpl-2.0_or_lgpl-2.0_2.yml", "YAML", 0, 0, 0, 7, 0, 0, 1, 8
"d:\IDEWORK\lvmen\src\licensedcode\data\rules\gpl-2.0_or_lgpl-2.0_3.yml", "YAML", 0, 0, 0, 4, 0, 0, 1, 5
"d:\IDEWORK\lvmen\src\licensedcode\data\rules\gpl-2.0_or_lgpl-2.0_7.yml", "YAML", 0, 0, 0, 3, 0, 0, 1, 4
"d:\IDEWORK\lvmen\src\licensedcode\data\rules\gpl-2.0_or_lgpl-2.1_1.yml", "YAML", 0, 0, 0, 2, 0, 0, 1, 3
"d:\IDEWORK\lvmen\src\licensedcode\data\rules\gpl-2.0_or_lgpl-2.1_2.yml", "YAML", 0, 0, 0, 3, 0, 0, 1, 4
"d:\IDEWORK\lvmen\src\licensedcode\data\rules\gpl-2.0_or_lgpl-2.1_3.yml", "YAML", 0, 0, 0, 5, 0, 0, 1, 6
"d:\IDEWORK\lvmen\src\licensedcode\data\rules\gpl-2.0_or_lgpl-2.1_4.yml", "YAML", 0, 0, 0, 5, 0, 0, 1, 6
"d:\IDEWORK\lvmen\src\licensedcode\data\rules\gpl-2.0_or_lgpl-2.1_or_mpl-1.1_1.yml", "YAML", 0, 0, 0, 3, 0, 0, 1, 4
"d:\IDEWORK\lvmen\src\licensedcode\data\rules\gpl-2.0_or_lgpl-2.1_or_mpl-1.1_2.yml", "YAML", 0, 0, 0, 3, 0, 0, 1, 4
"d:\IDEWORK\lvmen\src\licensedcode\data\rules\gpl-2.0_or_lgpl-2.1_or_mpl-1.1_3.yml", "YAML", 0, 0, 0, 5, 0, 0, 1, 6
"d:\IDEWORK\lvmen\src\licensedcode\data\rules\gpl-2.0_or_linux-openib_1.yml", "YAML", 0, 0, 0, 5, 0, 0, 1, 6
"d:\IDEWORK\lvmen\src\licensedcode\data\rules\gpl-2.0_or_linux-openib_10.yml", "YAML", 0, 0, 0, 3, 0, 0, 1, 4
"d:\IDEWORK\lvmen\src\licensedcode\data\rules\gpl-2.0_or_linux-openib_11.yml", "YAML", 0, 0, 0, 7, 0, 0, 1, 8
"d:\IDEWORK\lvmen\src\licensedcode\data\rules\gpl-2.0_or_linux-openib_12.yml", "YAML", 0, 0, 0, 7, 0, 0, 1, 8
"d:\IDEWORK\lvmen\src\licensedcode\data\rules\gpl-2.0_or_linux-openib_13.yml", "YAML", 0, 0, 0, 4, 0, 0, 1, 5
"d:\IDEWORK\lvmen\src\licensedcode\data\rules\gpl-2.0_or_linux-openib_2.yml", "YAML", 0, 0, 0, 6, 0, 0, 1, 7
"d:\IDEWORK\lvmen\src\licensedcode\data\rules\gpl-2.0_or_linux-openib_4.yml", "YAML", 0, 0, 0, 6, 0, 0, 1, 7
"d:\IDEWORK\lvmen\src\licensedcode\data\rules\gpl-2.0_or_linux-openib_6.yml", "YAML", 0, 0, 0, 3, 0, 0, 1, 4
"d:\IDEWORK\lvmen\src\licensedcode\data\rules\gpl-2.0_or_linux-openib_7.yml", "YAML", 0, 0, 0, 5, 0, 0, 1, 6
"d:\IDEWORK\lvmen\src\licensedcode\data\rules\gpl-2.0_or_linux-openib_8.yml", "YAML", 0, 0, 0, 7, 0, 0, 1, 8
"d:\IDEWORK\lvmen\src\licensedcode\data\rules\gpl-2.0_or_linux-openib_9.yml", "YAML", 0, 0, 0, 5, 0, 0, 1, 6
"d:\IDEWORK\lvmen\src\licensedcode\data\rules\gpl-2.0_or_mit.yml", "YAML", 0, 0, 0, 4, 0, 0, 1, 5
"d:\IDEWORK\lvmen\src\licensedcode\data\rules\gpl-2.0_or_mit_1.yml", "YAML", 0, 0, 0, 3, 0, 0, 1, 4
"d:\IDEWORK\lvmen\src\licensedcode\data\rules\gpl-2.0_or_mit_10.yml", "YAML", 0, 0, 0, 3, 0, 0, 1, 4
"d:\IDEWORK\lvmen\src\licensedcode\data\rules\gpl-2.0_or_mit_11.yml", "YAML", 0, 0, 0, 3, 0, 0, 1, 4
"d:\IDEWORK\lvmen\src\licensedcode\data\rules\gpl-2.0_or_mit_2.yml", "YAML", 0, 0, 0, 3, 0, 0, 1, 4
"d:\IDEWORK\lvmen\src\licensedcode\data\rules\gpl-2.0_or_mit_3.yml", "YAML", 0, 0, 0, 3, 0, 0, 1, 4
"d:\IDEWORK\lvmen\src\licensedcode\data\rules\gpl-2.0_or_mit_4.yml", "YAML", 0, 0, 0, 3, 0, 0, 1, 4
"d:\IDEWORK\lvmen\src\licensedcode\data\rules\gpl-2.0_or_mit_5.yml", "YAML", 0, 0, 0, 3, 0, 0, 1, 4
"d:\IDEWORK\lvmen\src\licensedcode\data\rules\gpl-2.0_or_mit_6.yml", "YAML", 0, 0, 0, 3, 0, 0, 1, 4
"d:\IDEWORK\lvmen\src\licensedcode\data\rules\gpl-2.0_or_mit_7.yml", "YAML", 0, 0, 0, 3, 0, 0, 1, 4
"d:\IDEWORK\lvmen\src\licensedcode\data\rules\gpl-2.0_or_mit_8.yml", "YAML", 0, 0, 0, 3, 0, 0, 1, 4
"d:\IDEWORK\lvmen\src\licensedcode\data\rules\gpl-2.0_or_mit_9.yml", "YAML", 0, 0, 0, 3, 0, 0, 1, 4
"d:\IDEWORK\lvmen\src\licensedcode\data\rules\gpl-2.0_or_mpl-1.0_1.yml", "YAML", 0, 0, 0, 2, 0, 0, 1, 3
"d:\IDEWORK\lvmen\src\licensedcode\data\rules\gpl-2.0_or_other-copyleft_1.yml", "YAML", 0, 0, 0, 5, 0, 0, 1, 6
"d:\IDEWORK\lvmen\src\licensedcode\data\rules\gpl-2.0_or_other-copyleft_or_other-permissive_1.yml", "YAML", 0, 0, 0, 3, 0, 0, 1, 4
"d:\IDEWORK\lvmen\src\licensedcode\data\rules\gpl-2.0_or_other-permissive_1.yml", "YAML", 0, 0, 0, 4, 0, 0, 1, 5
"d:\IDEWORK\lvmen\src\licensedcode\data\rules\gpl-2.0_or_proprietary-license_1.yml", "YAML", 0, 0, 0, 6, 0, 0, 1, 7
"d:\IDEWORK\lvmen\src\licensedcode\data\rules\gpl-2.0_or_proprietary-license_2.yml", "YAML", 0, 0, 0, 6, 0, 0, 1, 7
"d:\IDEWORK\lvmen\src\licensedcode\data\rules\gpl-2.0_or_proprietary-license_3.yml", "YAML", 0, 0, 0, 6, 0, 0, 1, 7
"d:\IDEWORK\lvmen\src\licensedcode\data\rules\gpl-2.0_or_proprietary-license_4.yml", "YAML", 0, 0, 0, 6, 0, 0, 1, 7
"d:\IDEWORK\lvmen\src\licensedcode\data\rules\gpl-2.0_or_proprietary-license_5.yml", "YAML", 0, 0, 0, 6, 0, 0, 1, 7
"d:\IDEWORK\lvmen\src\licensedcode\data\rules\gpl-2.0_or_proprietary-license_6.yml", "YAML", 0, 0, 0, 6, 0, 0, 1, 7
"d:\IDEWORK\lvmen\src\licensedcode\data\rules\gpl-2.0_or_proprietary-license_7.yml", "YAML", 0, 0, 0, 6, 0, 0, 1, 7
"d:\IDEWORK\lvmen\src\licensedcode\data\rules\gpl-2.0_or_proprietary-license_8.yml", "YAML", 0, 0, 0, 6, 0, 0, 1, 7
"d:\IDEWORK\lvmen\src\licensedcode\data\rules\gpl-2.0_or_proprietary.yml", "YAML", 0, 0, 0, 3, 0, 0, 1, 4
"d:\IDEWORK\lvmen\src\licensedcode\data\rules\gpl-2.0_or_proprietary2.yml", "YAML", 0, 0, 0, 5, 0, 0, 1, 6
"d:\IDEWORK\lvmen\src\licensedcode\data\rules\gpl-2.0_or_proprietary3.yml", "YAML", 0, 0, 0, 3, 0, 0, 1, 4
"d:\IDEWORK\lvmen\src\licensedcode\data\rules\gpl-2.0_or_proprietary4.yml", "YAML", 0, 0, 0, 5, 0, 0, 1, 6
"d:\IDEWORK\lvmen\src\licensedcode\data\rules\gpl-2.0_or_ruby_1.yml", "YAML", 0, 0, 0, 9, 0, 0, 1, 10
"d:\IDEWORK\lvmen\src\licensedcode\data\rules\gpl-2.0_or_ruby_2.yml", "YAML", 0, 0, 0, 11, 0, 0, 1, 12
"d:\IDEWORK\lvmen\src\licensedcode\data\rules\gpl-2.0_or_w3c_or_bsd-new_or_mit_1.yml", "YAML", 0, 0, 0, 3, 0, 0, 1, 4
"d:\IDEWORK\lvmen\src\licensedcode\data\rules\gpl-2.0_or_x11.yml", "YAML", 0, 0, 0, 3, 0, 0, 1, 4
"d:\IDEWORK\lvmen\src\licensedcode\data\rules\gpl-2.0_qt.yml", "YAML", 0, 0, 0, 2, 0, 0, 1, 3
"d:\IDEWORK\lvmen\src\licensedcode\data\rules\gpl-2.0_released.yml", "YAML", 0, 0, 0, 3, 0, 0, 1, 4
"d:\IDEWORK\lvmen\src\licensedcode\data\rules\gpl-2.0_templatized.yml", "YAML", 0, 0, 0, 10, 0, 0, 1, 11
"d:\IDEWORK\lvmen\src\licensedcode\data\rules\gpl-2.0_temple_variant.yml", "YAML", 0, 0, 0, 10, 0, 0, 1, 11
"d:\IDEWORK\lvmen\src\licensedcode\data\rules\gpl-2.0_url_1.yml", "YAML", 0, 0, 0, 5, 0, 0, 1, 6
"d:\IDEWORK\lvmen\src\licensedcode\data\rules\gpl-2.0_url_2.yml", "YAML", 0, 0, 0, 5, 0, 0, 1, 6
"d:\IDEWORK\lvmen\src\licensedcode\data\rules\gpl-2.0_url_badge.yml", "YAML", 0, 0, 0, 5, 0, 0, 1, 6
"d:\IDEWORK\lvmen\src\licensedcode\data\rules\gpl-2.0_url_glc_131.yml", "YAML", 0, 0, 0, 5, 0, 0, 1, 6
"d:\IDEWORK\lvmen\src\licensedcode\data\rules\gpl-2.0_url_glc_166.yml", "YAML", 0, 0, 0, 5, 0, 0, 1, 6
"d:\IDEWORK\lvmen\src\licensedcode\data\rules\gpl-2.0_url_glc_167.yml", "YAML", 0, 0, 0, 5, 0, 0, 1, 6
"d:\IDEWORK\lvmen\src\licensedcode\data\rules\gpl-2.0_with_389-exception.yml", "YAML", 0, 0, 0, 2, 0, 0, 1, 3
"d:\IDEWORK\lvmen\src\licensedcode\data\rules\gpl-2.0_with_bash-exception-gpl_1.yml", "YAML", 0, 0, 0, 11, 0, 0, 1, 12
"d:\IDEWORK\lvmen\src\licensedcode\data\rules\gpl-2.0_with_bison-exception-2.2_1.yml", "YAML", 0, 0, 0, 3, 0, 0, 1, 4
"d:\IDEWORK\lvmen\src\licensedcode\data\rules\gpl-2.0_with_bison-exception-2.2_2.yml", "YAML", 0, 0, 0, 3, 0, 0, 1, 4
"d:\IDEWORK\lvmen\src\licensedcode\data\rules\gpl-2.0_with_bison-exception-2.2_3.yml", "YAML", 0, 0, 0, 3, 0, 0, 1, 4
"d:\IDEWORK\lvmen\src\licensedcode\data\rules\gpl-2.0_with_broadcom-linking-unmodified_or_proprietary.yml", "YAML", 0, 0, 0, 4, 0, 0, 1, 5
"d:\IDEWORK\lvmen\src\licensedcode\data\rules\gpl-2.0_with_classpath-exception-2.0_1.yml", "YAML", 0, 0, 0, 6, 0, 0, 1, 7
"d:\IDEWORK\lvmen\src\licensedcode\data\rules\gpl-2.0_with_classpath-exception-2.0_10.yml", "YAML", 0, 0, 0, 4, 0, 0, 1, 5
"d:\IDEWORK\lvmen\src\licensedcode\data\rules\gpl-2.0_with_classpath-exception-2.0_11.yml", "YAML", 0, 0, 0, 6, 0, 0, 1, 7
"d:\IDEWORK\lvmen\src\licensedcode\data\rules\gpl-2.0_with_classpath-exception-2.0_12.yml", "YAML", 0, 0, 0, 4, 0, 0, 1, 5
"d:\IDEWORK\lvmen\src\licensedcode\data\rules\gpl-2.0_with_classpath-exception-2.0_13.yml", "YAML", 0, 0, 0, 8, 0, 0, 1, 9
"d:\IDEWORK\lvmen\src\licensedcode\data\rules\gpl-2.0_with_classpath-exception-2.0_14.yml", "YAML", 0, 0, 0, 4, 0, 0, 1, 5
"d:\IDEWORK\lvmen\src\licensedcode\data\rules\gpl-2.0_with_classpath-exception-2.0_15.yml", "YAML", 0, 0, 0, 4, 0, 0, 1, 5
"d:\IDEWORK\lvmen\src\licensedcode\data\rules\gpl-2.0_with_classpath-exception-2.0_16.yml", "YAML", 0, 0, 0, 4, 0, 0, 1, 5
"d:\IDEWORK\lvmen\src\licensedcode\data\rules\gpl-2.0_with_classpath-exception-2.0_17.yml", "YAML", 0, 0, 0, 3, 0, 0, 1, 4
"d:\IDEWORK\lvmen\src\licensedcode\data\rules\gpl-2.0_with_classpath-exception-2.0_18.yml", "YAML", 0, 0, 0, 9, 0, 0, 1, 10
"d:\IDEWORK\lvmen\src\licensedcode\data\rules\gpl-2.0_with_classpath-exception-2.0_19.yml", "YAML", 0, 0, 0, 4, 0, 0, 1, 5
"d:\IDEWORK\lvmen\src\licensedcode\data\rules\gpl-2.0_with_classpath-exception-2.0_2.yml", "YAML", 0, 0, 0, 6, 0, 0, 1, 7
"d:\IDEWORK\lvmen\src\licensedcode\data\rules\gpl-2.0_with_classpath-exception-2.0_20.yml", "YAML", 0, 0, 0, 7, 0, 0, 1, 8
"d:\IDEWORK\lvmen\src\licensedcode\data\rules\gpl-2.0_with_classpath-exception-2.0_21.yml", "YAML", 0, 0, 0, 7, 0, 0, 1, 8
"d:\IDEWORK\lvmen\src\licensedcode\data\rules\gpl-2.0_with_classpath-exception-2.0_22.yml", "YAML", 0, 0, 0, 7, 0, 0, 1, 8
"d:\IDEWORK\lvmen\src\licensedcode\data\rules\gpl-2.0_with_classpath-exception-2.0_23.yml", "YAML", 0, 0, 0, 5, 0, 0, 1, 6
"d:\IDEWORK\lvmen\src\licensedcode\data\rules\gpl-2.0_with_classpath-exception-2.0_24.yml", "YAML", 0, 0, 0, 5, 0, 0, 1, 6
"d:\IDEWORK\lvmen\src\licensedcode\data\rules\gpl-2.0_with_classpath-exception-2.0_25.yml", "YAML", 0, 0, 0, 5, 0, 0, 1, 6
"d:\IDEWORK\lvmen\src\licensedcode\data\rules\gpl-2.0_with_classpath-exception-2.0_26.yml", "YAML", 0, 0, 0, 5, 0, 0, 1, 6
"d:\IDEWORK\lvmen\src\licensedcode\data\rules\gpl-2.0_with_classpath-exception-2.0_27.yml", "YAML", 0, 0, 0, 3, 0, 0, 1, 4
"d:\IDEWORK\lvmen\src\licensedcode\data\rules\gpl-2.0_with_classpath-exception-2.0_28.yml", "YAML", 0, 0, 0, 3, 0, 0, 1, 4
"d:\IDEWORK\lvmen\src\licensedcode\data\rules\gpl-2.0_with_classpath-exception-2.0_29.yml", "YAML", 0, 0, 0, 3, 0, 0, 1, 4
"d:\IDEWORK\lvmen\src\licensedcode\data\rules\gpl-2.0_with_classpath-exception-2.0_3.yml", "YAML", 0, 0, 0, 9, 0, 0, 1, 10
"d:\IDEWORK\lvmen\src\licensedcode\data\rules\gpl-2.0_with_classpath-exception-2.0_30.yml", "YAML", 0, 0, 0, 4, 0, 0, 1, 5
"d:\IDEWORK\lvmen\src\licensedcode\data\rules\gpl-2.0_with_classpath-exception-2.0_31.yml", "YAML", 0, 0, 0, 7, 0, 0, 1, 8
"d:\IDEWORK\lvmen\src\licensedcode\data\rules\gpl-2.0_with_classpath-exception-2.0_32.yml", "YAML", 0, 0, 0, 3, 0, 0, 1, 4
"d:\IDEWORK\lvmen\src\licensedcode\data\rules\gpl-2.0_with_classpath-exception-2.0_33.yml", "YAML", 0, 0, 0, 5, 0, 0, 1, 6
"d:\IDEWORK\lvmen\src\licensedcode\data\rules\gpl-2.0_with_classpath-exception-2.0_34.yml", "YAML", 0, 0, 0, 3, 0, 0, 1, 4
"d:\IDEWORK\lvmen\src\licensedcode\data\rules\gpl-2.0_with_classpath-exception-2.0_35.yml", "YAML", 0, 0, 0, 3, 0, 0, 1, 4
"d:\IDEWORK\lvmen\src\licensedcode\data\rules\gpl-2.0_with_classpath-exception-2.0_36.yml", "YAML", 0, 0, 0, 3, 0, 0, 1, 4
"d:\IDEWORK\lvmen\src\licensedcode\data\rules\gpl-2.0_with_classpath-exception-2.0_37.yml", "YAML", 0, 0, 0, 3, 0, 0, 1, 4
"d:\IDEWORK\lvmen\src\licensedcode\data\rules\gpl-2.0_with_classpath-exception-2.0_38.yml", "YAML", 0, 0, 0, 3, 0, 0, 1, 4
"d:\IDEWORK\lvmen\src\licensedcode\data\rules\gpl-2.0_with_classpath-exception-2.0_39.yml", "YAML", 0, 0, 0, 3, 0, 0, 1, 4
"d:\IDEWORK\lvmen\src\licensedcode\data\rules\gpl-2.0_with_classpath-exception-2.0_4.yml", "YAML", 0, 0, 0, 8, 0, 0, 1, 9
"d:\IDEWORK\lvmen\src\licensedcode\data\rules\gpl-2.0_with_classpath-exception-2.0_40.yml", "YAML", 0, 0, 0, 3, 0, 0, 1, 4
"d:\IDEWORK\lvmen\src\licensedcode\data\rules\gpl-2.0_with_classpath-exception-2.0_41.yml", "YAML", 0, 0, 0, 3, 0, 0, 1, 4
"d:\IDEWORK\lvmen\src\licensedcode\data\rules\gpl-2.0_with_classpath-exception-2.0_42.yml", "YAML", 0, 0, 0, 3, 0, 0, 1, 4
"d:\IDEWORK\lvmen\src\licensedcode\data\rules\gpl-2.0_with_classpath-exception-2.0_43.yml", "YAML", 0, 0, 0, 4, 0, 0, 1, 5
"d:\IDEWORK\lvmen\src\licensedcode\data\rules\gpl-2.0_with_classpath-exception-2.0_44.yml", "YAML", 0, 0, 0, 3, 0, 0, 1, 4
"d:\IDEWORK\lvmen\src\licensedcode\data\rules\gpl-2.0_with_classpath-exception-2.0_45.yml", "YAML", 0, 0, 0, 3, 0, 0, 1, 4
"d:\IDEWORK\lvmen\src\licensedcode\data\rules\gpl-2.0_with_classpath-exception-2.0_46.yml", "YAML", 0, 0, 0, 4, 0, 0, 1, 5
"d:\IDEWORK\lvmen\src\licensedcode\data\rules\gpl-2.0_with_classpath-exception-2.0_47.yml", "YAML", 0, 0, 0, 5, 0, 0, 1, 6
"d:\IDEWORK\lvmen\src\licensedcode\data\rules\gpl-2.0_with_classpath-exception-2.0_48.yml", "YAML", 0, 0, 0, 7, 0, 0, 1, 8
"d:\IDEWORK\lvmen\src\licensedcode\data\rules\gpl-2.0_with_classpath-exception-2.0_5.yml", "YAML", 0, 0, 0, 3, 0, 0, 1, 4
"d:\IDEWORK\lvmen\src\licensedcode\data\rules\gpl-2.0_with_classpath-exception-2.0_6.yml", "YAML", 0, 0, 0, 3, 0, 0, 1, 4
"d:\IDEWORK\lvmen\src\licensedcode\data\rules\gpl-2.0_with_classpath-exception-2.0_7.yml", "YAML", 0, 0, 0, 5, 0, 0, 1, 6
"d:\IDEWORK\lvmen\src\licensedcode\data\rules\gpl-2.0_with_classpath-exception-2.0_8.yml", "YAML", 0, 0, 0, 3, 0, 0, 1, 4
"d:\IDEWORK\lvmen\src\licensedcode\data\rules\gpl-2.0_with_classpath-exception-2.0_9.yml", "YAML", 0, 0, 0, 6, 0, 0, 1, 7
"d:\IDEWORK\lvmen\src\licensedcode\data\rules\gpl-2.0_with_classpath-exception-2.0_and_bsd-new_1.yml", "YAML", 0, 0, 0, 7, 0, 0, 1, 8
"d:\IDEWORK\lvmen\src\licensedcode\data\rules\gpl-2.0_with_classpath-exception-2.0_and_bsd-new_2.yml", "YAML", 0, 0, 0, 7, 0, 0, 1, 8
"d:\IDEWORK\lvmen\src\licensedcode\data\rules\gpl-2.0_with_classpath-exception-2.0_and_bsd-new_3.yml", "YAML", 0, 0, 0, 7, 0, 0, 1, 8
"d:\IDEWORK\lvmen\src\licensedcode\data\rules\gpl-2.0_with_classpath-exception-2.0_and_bsd-new_4.yml", "YAML", 0, 0, 0, 7, 0, 0, 1, 8
"d:\IDEWORK\lvmen\src\licensedcode\data\rules\gpl-2.0_with_classpath-exception-2.0_and_bsd-new_or_apache-2.0_1.yml", "YAML", 0, 0, 0, 8, 0, 0, 1, 9
"d:\IDEWORK\lvmen\src\licensedcode\data\rules\gpl-2.0_with_classpath-exception-2.0_and_bsd-new_or_apache-2.0_2.yml", "YAML", 0, 0, 0, 8, 0, 0, 1, 9
"d:\IDEWORK\lvmen\src\licensedcode\data\rules\gpl-2.0_with_classpath-exception-2.0_and_cc0-1.0_1.yml", "YAML", 0, 0, 0, 7, 0, 0, 1, 8
"d:\IDEWORK\lvmen\src\licensedcode\data\rules\gpl-2.0_with_classpath-exception-2.0_and_cc0-1.0_2.yml", "YAML", 0, 0, 0, 10, 0, 0, 1, 11
"d:\IDEWORK\lvmen\src\licensedcode\data\rules\gpl-2.0_with_classpath-exception-2.0_and_mit_1.yml", "YAML", 0, 0, 0, 7, 0, 0, 1, 8
"d:\IDEWORK\lvmen\src\licensedcode\data\rules\gpl-2.0_with_classpath-exception-2.0_and_mit_2.yml", "YAML", 0, 0, 0, 7, 0, 0, 1, 8
"d:\IDEWORK\lvmen\src\licensedcode\data\rules\gpl-2.0_with_classpath-exception-2.0_and_mit_3.yml", "YAML", 0, 0, 0, 7, 0, 0, 1, 8
"d:\IDEWORK\lvmen\src\licensedcode\data\rules\gpl-2.0_with_classpath-exception-2.0_and_other-permissive_1.yml", "YAML", 0, 0, 0, 2, 0, 0, 1, 3
"d:\IDEWORK\lvmen\src\licensedcode\data\rules\gpl-2.0_with_classpath-exception-2.0_and_others_1.yml", "YAML", 0, 0, 0, 6, 0, 0, 1, 7
"d:\IDEWORK\lvmen\src\licensedcode\data\rules\gpl-2.0_with_classpath-exception-2.0_and_w3c_1.yml", "YAML", 0, 0, 0, 13, 0, 0, 1, 14
"d:\IDEWORK\lvmen\src\licensedcode\data\rules\gpl-2.0_with_classpath-exception-2.0_and_w3c_2.yml", "YAML", 0, 0, 0, 13, 0, 0, 1, 14
"d:\IDEWORK\lvmen\src\licensedcode\data\rules\gpl-2.0_with_classpath-exception-2.0_and_w3c_3.yml", "YAML", 0, 0, 0, 12, 0, 0, 1, 13
"d:\IDEWORK\lvmen\src\licensedcode\data\rules\gpl-2.0_with_classpath-exception-2.0_and_w3c_4.yml", "YAML", 0, 0, 0, 15, 0, 0, 1, 16
"d:\IDEWORK\lvmen\src\licensedcode\data\rules\gpl-2.0_with_classpath-exception-2.0_and_x11-xconsortium_1.yml", "YAML", 0, 0, 0, 7, 0, 0, 1, 8
"d:\IDEWORK\lvmen\src\licensedcode\data\rules\gpl-2.0_with_classpath-exception-2.0_and_x11-xconsortium_2.yml", "YAML", 0, 0, 0, 3, 0, 0, 1, 4
"d:\IDEWORK\lvmen\src\licensedcode\data\rules\gpl-2.0_with_classpath-exception-2.0_grammatica_1.yml", "YAML", 0, 0, 0, 10, 0, 0, 1, 11
"d:\IDEWORK\lvmen\src\licensedcode\data\rules\gpl-2.0_with_classpath-exception-2.0_grammatica_2.yml", "YAML", 0, 0, 0, 6, 0, 0, 1, 7
"d:\IDEWORK\lvmen\src\licensedcode\data\rules\gpl-2.0_with_classpath-exception-2.0_library-exception.yml", "YAML", 0, 0, 0, 4, 0, 0, 1, 5
"d:\IDEWORK\lvmen\src\licensedcode\data\rules\gpl-2.0_with_classpath-exception-2.0_or_cddl-1.1_1.yml", "YAML", 0, 0, 0, 7, 0, 0, 1, 8
"d:\IDEWORK\lvmen\src\licensedcode\data\rules\gpl-2.0_with_classpath-exception-2.0_or_cddl-1.1_2.yml", "YAML", 0, 0, 0, 5, 0, 0, 1, 6
"d:\IDEWORK\lvmen\src\licensedcode\data\rules\gpl-2.0_with_classpath-exception-2.0_or_cddl-1.1_3.yml", "YAML", 0, 0, 0, 5, 0, 0, 1, 6
"d:\IDEWORK\lvmen\src\licensedcode\data\rules\gpl-2.0_with_classpath-exception-2.0_or_cddl-1.1_4.yml", "YAML", 0, 0, 0, 7, 0, 0, 1, 8
"d:\IDEWORK\lvmen\src\licensedcode\data\rules\gpl-2.0_with_classpath-exception-2.0_or_cddl-1.1_5.yml", "YAML", 0, 0, 0, 5, 0, 0, 1, 6
"d:\IDEWORK\lvmen\src\licensedcode\data\rules\gpl-2.0_with_classpath-exception-2.0_or_cddl-1.1_url_1.yml", "YAML", 0, 0, 0, 5, 0, 0, 1, 6
"d:\IDEWORK\lvmen\src\licensedcode\data\rules\gpl-2.0_with_cygwin-exception-2.0_1.yml", "YAML", 0, 0, 0, 5, 0, 0, 1, 6
"d:\IDEWORK\lvmen\src\licensedcode\data\rules\gpl-2.0_with_cygwin-exception-2.0_2.yml", "YAML", 0, 0, 0, 5, 0, 0, 1, 6
"d:\IDEWORK\lvmen\src\licensedcode\data\rules\gpl-2.0_with_dune-exception_1.yml", "YAML", 0, 0, 0, 3, 0, 0, 1, 4
"d:\IDEWORK\lvmen\src\licensedcode\data\rules\gpl-2.0_with_ecos-exception-2.0_1.yml", "YAML", 0, 0, 0, 3, 0, 0, 1, 4
"d:\IDEWORK\lvmen\src\licensedcode\data\rules\gpl-2.0_with_ecos-exception-2.0_10.yml", "YAML", 0, 0, 0, 10, 0, 0, 1, 11
"d:\IDEWORK\lvmen\src\licensedcode\data\rules\gpl-2.0_with_ecos-exception-2.0_11.yml", "YAML", 0, 0, 0, 3, 0, 0, 1, 4
"d:\IDEWORK\lvmen\src\licensedcode\data\rules\gpl-2.0_with_ecos-exception-2.0_12.yml", "YAML", 0, 0, 0, 10, 0, 0, 1, 11
"d:\IDEWORK\lvmen\src\licensedcode\data\rules\gpl-2.0_with_ecos-exception-2.0_2.yml", "YAML", 0, 0, 0, 5, 0, 0, 1, 6
"d:\IDEWORK\lvmen\src\licensedcode\data\rules\gpl-2.0_with_ecos-exception-2.0_3.yml", "YAML", 0, 0, 0, 5, 0, 0, 1, 6
"d:\IDEWORK\lvmen\src\licensedcode\data\rules\gpl-2.0_with_ecos-exception-2.0_4.yml", "YAML", 0, 0, 0, 5, 0, 0, 1, 6
"d:\IDEWORK\lvmen\src\licensedcode\data\rules\gpl-2.0_with_ecos-exception-2.0_5.yml", "YAML", 0, 0, 0, 3, 0, 0, 1, 4
"d:\IDEWORK\lvmen\src\licensedcode\data\rules\gpl-2.0_with_ecos-exception-2.0_6.yml", "YAML", 0, 0, 0, 3, 0, 0, 1, 4
"d:\IDEWORK\lvmen\src\licensedcode\data\rules\gpl-2.0_with_ecos-exception-2.0_7.yml", "YAML", 0, 0, 0, 3, 0, 0, 1, 4
"d:\IDEWORK\lvmen\src\licensedcode\data\rules\gpl-2.0_with_ecos-exception-2.0_8.yml", "YAML", 0, 0, 0, 3, 0, 0, 1, 4
"d:\IDEWORK\lvmen\src\licensedcode\data\rules\gpl-2.0_with_ecos-exception-2.0_9.yml", "YAML", 0, 0, 0, 4, 0, 0, 1, 5
"d:\IDEWORK\lvmen\src\licensedcode\data\rules\gpl-2.0_with_font-exception-gpl_1.yml", "YAML", 0, 0, 0, 2, 0, 0, 1, 3
"d:\IDEWORK\lvmen\src\licensedcode\data\rules\gpl-2.0_with_font-exception-gpl_2.yml", "YAML", 0, 0, 0, 12, 0, 0, 1, 13
"d:\IDEWORK\lvmen\src\licensedcode\data\rules\gpl-2.0_with_font-exception-gpl_3.yml", "YAML", 0, 0, 0, 4, 0, 0, 1, 5
"d:\IDEWORK\lvmen\src\licensedcode\data\rules\gpl-2.0_with_font-exception-gpl_4.yml", "YAML", 0, 0, 0, 3, 0, 0, 1, 4
"d:\IDEWORK\lvmen\src\licensedcode\data\rules\gpl-2.0_with_font-exception-gpl_5.yml", "YAML", 0, 0, 0, 3, 0, 0, 1, 4
"d:\IDEWORK\lvmen\src\licensedcode\data\rules\gpl-2.0_with_font-exception-gpl_or_ofl-1.1_1.yml", "YAML", 0, 0, 0, 7, 0, 0, 1, 8
"d:\IDEWORK\lvmen\src\licensedcode\data\rules\gpl-2.0_with_gcc-compiler-exception-2.0_and_gpl-2.0_with_mif-exception_1.yml", "YAML", 0, 0, 0, 3, 0, 0, 1, 4
"d:\IDEWORK\lvmen\src\licensedcode\data\rules\gpl-2.0_with_gcc-linking-exception-2.0_1.yml", "YAML", 0, 0, 0, 3, 0, 0, 1, 4
"d:\IDEWORK\lvmen\src\licensedcode\data\rules\gpl-2.0_with_gcc-linking-exception-2.0_2.yml", "YAML", 0, 0, 0, 5, 0, 0, 1, 6
"d:\IDEWORK\lvmen\src\licensedcode\data\rules\gpl-2.0_with_gcc-linking-exception-2.0_3.yml", "YAML", 0, 0, 0, 4, 0, 0, 1, 5
"d:\IDEWORK\lvmen\src\licensedcode\data\rules\gpl-2.0_with_gcc-linking-exception-2.0_4.yml", "YAML", 0, 0, 0, 3, 0, 0, 1, 4
"d:\IDEWORK\lvmen\src\licensedcode\data\rules\gpl-2.0_with_gcc-linking-exception-2.0_5.yml", "YAML", 0, 0, 0, 6, 0, 0, 1, 7
"d:\IDEWORK\lvmen\src\licensedcode\data\rules\gpl-2.0_with_gcc-linking-exception-2.0_6.yml", "YAML", 0, 0, 0, 3, 0, 0, 1, 4
"d:\IDEWORK\lvmen\src\licensedcode\data\rules\gpl-2.0_with_generic-exception_1.yml", "YAML", 0, 0, 0, 5, 0, 0, 1, 6
"d:\IDEWORK\lvmen\src\licensedcode\data\rules\gpl-2.0_with_generic-exception_10.yml", "YAML", 0, 0, 0, 6, 0, 0, 1, 7
"d:\IDEWORK\lvmen\src\licensedcode\data\rules\gpl-2.0_with_generic-exception_11.yml", "YAML", 0, 0, 0, 6, 0, 0, 1, 7
"d:\IDEWORK\lvmen\src\licensedcode\data\rules\gpl-2.0_with_generic-exception_12.yml", "YAML", 0, 0, 0, 8, 0, 0, 1, 9
"d:\IDEWORK\lvmen\src\licensedcode\data\rules\gpl-2.0_with_generic-exception_13.yml", "YAML", 0, 0, 0, 6, 0, 0, 1, 7
"d:\IDEWORK\lvmen\src\licensedcode\data\rules\gpl-2.0_with_generic-exception_14.yml", "YAML", 0, 0, 0, 6, 0, 0, 1, 7
"d:\IDEWORK\lvmen\src\licensedcode\data\rules\gpl-2.0_with_generic-exception_2.yml", "YAML", 0, 0, 0, 4, 0, 0, 1, 5
"d:\IDEWORK\lvmen\src\licensedcode\data\rules\gpl-2.0_with_generic-exception_3.yml", "YAML", 0, 0, 0, 5, 0, 0, 1, 6
"d:\IDEWORK\lvmen\src\licensedcode\data\rules\gpl-2.0_with_generic-exception_4.yml", "YAML", 0, 0, 0, 3, 0, 0, 1, 4
"d:\IDEWORK\lvmen\src\licensedcode\data\rules\gpl-2.0_with_generic-exception_5.yml", "YAML", 0, 0, 0, 3, 0, 0, 1, 4
"d:\IDEWORK\lvmen\src\licensedcode\data\rules\gpl-2.0_with_generic-exception_6.yml", "YAML", 0, 0, 0, 5, 0, 0, 1, 6
"d:\IDEWORK\lvmen\src\licensedcode\data\rules\gpl-2.0_with_generic-exception_7.yml", "YAML", 0, 0, 0, 3, 0, 0, 1, 4
"d:\IDEWORK\lvmen\src\licensedcode\data\rules\gpl-2.0_with_generic-exception_8.yml", "YAML", 0, 0, 0, 10, 0, 0, 1, 11
"d:\IDEWORK\lvmen\src\licensedcode\data\rules\gpl-2.0_with_generic-exception_9.yml", "YAML", 0, 0, 0, 6, 0, 0, 1, 7
"d:\IDEWORK\lvmen\src\licensedcode\data\rules\gpl-2.0_with_generic-exception_and_gpl-generic-additional-terms_1.yml", "YAML", 0, 0, 0, 11, 0, 0, 1, 12
"d:\IDEWORK\lvmen\src\licensedcode\data\rules\gpl-2.0_with_gpl-2.0-broadcom-linking_or_commercial-option_1.yml", "YAML", 0, 0, 0, 4, 0, 0, 1, 5
"d:\IDEWORK\lvmen\src\licensedcode\data\rules\gpl-2.0_with_gpl-2.0-broadcom-linking_or_commercial-option_2.yml", "YAML", 0, 0, 0, 4, 0, 0, 1, 5
"d:\IDEWORK\lvmen\src\licensedcode\data\rules\gpl-2.0_with_gpl-2.0-broadcom-linking_or_commercial-option_3.yml", "YAML", 0, 0, 0, 4, 0, 0, 1, 5
"d:\IDEWORK\lvmen\src\licensedcode\data\rules\gpl-2.0_with_gpl-2.0-broadcom-linking_or_commercial-option_4.yml", "YAML", 0, 0, 0, 8, 0, 0, 1, 9
"d:\IDEWORK\lvmen\src\licensedcode\data\rules\gpl-2.0_with_gpl-2.0-broadcom-linking_or_commercial-option_5.yml", "YAML", 0, 0, 0, 4, 0, 0, 1, 5
"d:\IDEWORK\lvmen\src\licensedcode\data\rules\gpl-2.0_with_gpl-generic-additional-terms_1.yml", "YAML", 0, 0, 0, 5, 0, 0, 1, 6
"d:\IDEWORK\lvmen\src\licensedcode\data\rules\gpl-2.0_with_gpl-generic-additional-terms_and_mit-old-style-no-advert_1.yml", "YAML", 0, 0, 0, 5, 0, 0, 1, 6
"d:\IDEWORK\lvmen\src\licensedcode\data\rules\gpl-2.0_with_gpl-generic-additional-terms_and_mit-old-style-no-advert_2.yml", "YAML", 0, 0, 0, 5, 0, 0, 1, 6
"d:\IDEWORK\lvmen\src\licensedcode\data\rules\gpl-2.0_with_ice-exception-2.0_1.yml", "YAML", 0, 0, 0, 7, 0, 0, 1, 8
"d:\IDEWORK\lvmen\src\licensedcode\data\rules\gpl-2.0_with_ice-exception-2.0_2.yml", "YAML", 0, 0, 0, 8, 0, 0, 1, 9
"d:\IDEWORK\lvmen\src\licensedcode\data\rules\gpl-2.0_with_ice-exception-2.0_3.yml", "YAML", 0, 0, 0, 8, 0, 0, 1, 9
"d:\IDEWORK\lvmen\src\licensedcode\data\rules\gpl-2.0_with_liberation-font-exception_1.yml", "YAML", 0, 0, 0, 5, 0, 0, 1, 6
"d:\IDEWORK\lvmen\src\licensedcode\data\rules\gpl-2.0_with_linux-syscall-exception-gpl_1.yml", "YAML", 0, 0, 0, 3, 0, 0, 1, 4
"d:\IDEWORK\lvmen\src\licensedcode\data\rules\gpl-2.0_with_linux-syscall-exception-gpl_10.yml", "YAML", 0, 0, 0, 8, 0, 0, 1, 9
"d:\IDEWORK\lvmen\src\licensedcode\data\rules\gpl-2.0_with_linux-syscall-exception-gpl_2.yml", "YAML", 0, 0, 0, 12, 0, 0, 1, 13
"d:\IDEWORK\lvmen\src\licensedcode\data\rules\gpl-2.0_with_linux-syscall-exception-gpl_3.yml", "YAML", 0, 0, 0, 12, 0, 0, 1, 13
"d:\IDEWORK\lvmen\src\licensedcode\data\rules\gpl-2.0_with_linux-syscall-exception-gpl_4.yml", "YAML", 0, 0, 0, 12, 0, 0, 1, 13
"d:\IDEWORK\lvmen\src\licensedcode\data\rules\gpl-2.0_with_linux-syscall-exception-gpl_5.yml", "YAML", 0, 0, 0, 12, 0, 0, 1, 13
"d:\IDEWORK\lvmen\src\licensedcode\data\rules\gpl-2.0_with_linux-syscall-exception-gpl_6.yml", "YAML", 0, 0, 0, 13, 0, 0, 1, 14
"d:\IDEWORK\lvmen\src\licensedcode\data\rules\gpl-2.0_with_linux-syscall-exception-gpl_7.yml", "YAML", 0, 0, 0, 12, 0, 0, 1, 13
"d:\IDEWORK\lvmen\src\licensedcode\data\rules\gpl-2.0_with_linux-syscall-exception-gpl_8.yml", "YAML", 0, 0, 0, 11, 0, 0, 1, 12
"d:\IDEWORK\lvmen\src\licensedcode\data\rules\gpl-2.0_with_linux-syscall-exception-gpl_9.yml", "YAML", 0, 0, 0, 10, 0, 0, 1, 11
"d:\IDEWORK\lvmen\src\licensedcode\data\rules\gpl-2.0_with_linux-syscall-exception-gpl_and_other-permissive_and_other-copyleft_1.yml", "YAML", 0, 0, 0, 4, 0, 0, 1, 5
"d:\IDEWORK\lvmen\src\licensedcode\data\rules\gpl-2.0_with_linux-syscall-exception-gpl_or_bsd-new_1.yml", "YAML", 0, 0, 0, 4, 0, 0, 1, 5
"d:\IDEWORK\lvmen\src\licensedcode\data\rules\gpl-2.0_with_mif-exception_1.yml", "YAML", 0, 0, 0, 4, 0, 0, 1, 5
"d:\IDEWORK\lvmen\src\licensedcode\data\rules\gpl-2.0_with_mysql-floss-exception-2.0_1.yml", "YAML", 0, 0, 0, 6, 0, 0, 1, 7
"d:\IDEWORK\lvmen\src\licensedcode\data\rules\gpl-2.0_with_mysql-floss-exception-2.0_2.yml", "YAML", 0, 0, 0, 6, 0, 0, 1, 7
"d:\IDEWORK\lvmen\src\licensedcode\data\rules\gpl-2.0_with_mysql-floss-exception-2.0_3.yml", "YAML", 0, 0, 0, 6, 0, 0, 1, 7
"d:\IDEWORK\lvmen\src\licensedcode\data\rules\gpl-2.0_with_mysql-floss-exception-2.0_4.yml", "YAML", 0, 0, 0, 6, 0, 0, 1, 7
"d:\IDEWORK\lvmen\src\licensedcode\data\rules\gpl-2.0_with_mysql-linking-exception-2018_1.yml", "YAML", 0, 0, 0, 3, 0, 0, 1, 4
"d:\IDEWORK\lvmen\src\licensedcode\data\rules\gpl-2.0_with_mysql-linking-exception-2018_2.yml", "YAML", 0, 0, 0, 3, 0, 0, 1, 4
"d:\IDEWORK\lvmen\src\licensedcode\data\rules\gpl-2.0_with_mysql-linking-exception-2018_and_gpl-2.0_with_and_others_1.yml", "YAML", 0, 0, 0, 5, 0, 0, 1, 6
"d:\IDEWORK\lvmen\src\licensedcode\data\rules\gpl-2.0_with_mysql-linking-exception-2018_and_gpl-2.0_with_and_others_2.yml", "YAML", 0, 0, 0, 5, 0, 0, 1, 6
"d:\IDEWORK\lvmen\src\licensedcode\data\rules\gpl-2.0_with_mysql-linking-exception-2018_and_gpl-2.0_with_and_others_3.yml", "YAML", 0, 0, 0, 5, 0, 0, 1, 6
"d:\IDEWORK\lvmen\src\licensedcode\data\rules\gpl-2.0_with_openjdk-exception2.yml", "YAML", 0, 0, 0, 5, 0, 0, 1, 6
"d:\IDEWORK\lvmen\src\licensedcode\data\rules\gpl-2.0_with_openjdk-exception_1.yml", "YAML", 0, 0, 0, 6, 0, 0, 1, 7
"d:\IDEWORK\lvmen\src\licensedcode\data\rules\gpl-2.0_with_openssl-exception-gpl-2.0_1.yml", "YAML", 0, 0, 0, 5, 0, 0, 1, 6
"d:\IDEWORK\lvmen\src\licensedcode\data\rules\gpl-2.0_with_openssl-exception-gpl-2.0_10.yml", "YAML", 0, 0, 0, 4, 0, 0, 1, 5
"d:\IDEWORK\lvmen\src\licensedcode\data\rules\gpl-2.0_with_openssl-exception-gpl-2.0_11.yml", "YAML", 0, 0, 0, 5, 0, 0, 1, 6
"d:\IDEWORK\lvmen\src\licensedcode\data\rules\gpl-2.0_with_openssl-exception-gpl-2.0_2.yml", "YAML", 0, 0, 0, 3, 0, 0, 1, 4
"d:\IDEWORK\lvmen\src\licensedcode\data\rules\gpl-2.0_with_openssl-exception-gpl-2.0_3.yml", "YAML", 0, 0, 0, 5, 0, 0, 1, 6
"d:\IDEWORK\lvmen\src\licensedcode\data\rules\gpl-2.0_with_openssl-exception-gpl-2.0_4.yml", "YAML", 0, 0, 0, 5, 0, 0, 1, 6
"d:\IDEWORK\lvmen\src\licensedcode\data\rules\gpl-2.0_with_openssl-exception-gpl-2.0_5.yml", "YAML", 0, 0, 0, 3, 0, 0, 1, 4
"d:\IDEWORK\lvmen\src\licensedcode\data\rules\gpl-2.0_with_openssl-exception-gpl-2.0_6.yml", "YAML", 0, 0, 0, 3, 0, 0, 1, 4
"d:\IDEWORK\lvmen\src\licensedcode\data\rules\gpl-2.0_with_openssl-exception-gpl-2.0_7.yml", "YAML", 0, 0, 0, 4, 0, 0, 1, 5
"d:\IDEWORK\lvmen\src\licensedcode\data\rules\gpl-2.0_with_openssl-exception-gpl-2.0_8.yml", "YAML", 0, 0, 0, 2, 0, 0, 1, 3
"d:\IDEWORK\lvmen\src\licensedcode\data\rules\gpl-2.0_with_openssl-exception-gpl-2.0_9.yml", "YAML", 0, 0, 0, 4, 0, 0, 1, 5
"d:\IDEWORK\lvmen\src\licensedcode\data\rules\gpl-2.0_with_openssl-exception-gpl-3.0-plus_1.yml", "YAML", 0, 0, 0, 5, 0, 0, 1, 6
"d:\IDEWORK\lvmen\src\licensedcode\data\rules\gpl-2.0_with_openssl-exception-gpl-3.0-plus_2.yml", "YAML", 0, 0, 0, 5, 0, 0, 1, 6
"d:\IDEWORK\lvmen\src\licensedcode\data\rules\gpl-2.0_with_openssl-exception-gpl-3.0-plus_3.yml", "YAML", 0, 0, 0, 5, 0, 0, 1, 6
"d:\IDEWORK\lvmen\src\licensedcode\data\rules\gpl-2.0_with_openssl-exception-gpl-3.0-plus_4.yml", "YAML", 0, 0, 0, 5, 0, 0, 1, 6
"d:\IDEWORK\lvmen\src\licensedcode\data\rules\gpl-2.0_with_openssl-exception-gpl-3.0-plus_and_openssl-ssleay_1.yml", "YAML", 0, 0, 0, 5, 0, 0, 1, 6
"d:\IDEWORK\lvmen\src\licensedcode\data\rules\gpl-2.0_with_openssl-exception-gpl-3.0-plus_and_unknown_1.yml", "YAML", 0, 0, 0, 7, 0, 0, 1, 8
"d:\IDEWORK\lvmen\src\licensedcode\data\rules\gpl-2.0_with_openvpn-openssl-exception_1.yml", "YAML", 0, 0, 0, 3, 0, 0, 1, 4
"d:\IDEWORK\lvmen\src\licensedcode\data\rules\gpl-2.0_with_openvpn-openssl-exception_2.yml", "YAML", 0, 0, 0, 4, 0, 0, 1, 5
"d:\IDEWORK\lvmen\src\licensedcode\data\rules\gpl-2.0_with_oracle-openjdk-classpath-exception-2.0_1.yml", "YAML", 0, 0, 0, 10, 0, 0, 1, 11
"d:\IDEWORK\lvmen\src\licensedcode\data\rules\gpl-2.0_with_oracle-openjdk-classpath-exception-2.0_and_other_1.yml", "YAML", 0, 0, 0, 6, 0, 0, 1, 7
"d:\IDEWORK\lvmen\src\licensedcode\data\rules\gpl-2.0_with_qt-qca-exception-2.0_1.yml", "YAML", 0, 0, 0, 4, 0, 0, 1, 5
"d:\IDEWORK\lvmen\src\licensedcode\data\rules\gpl-2.0_with_trolltech-gpl-exception-1.2_1.yml", "YAML", 0, 0, 0, 11, 0, 0, 1, 12
"d:\IDEWORK\lvmen\src\licensedcode\data\rules\gpl-2.0_with_trolltech-gpl-exception-1.2_or_gpl-3.0_with_and_others_1.yml", "YAML", 0, 0, 0, 12, 0, 0, 1, 13
"d:\IDEWORK\lvmen\src\licensedcode\data\rules\gpl-2.0_with_trolltech-gpl-exception-1.2_or_gpl-3.0_with_and_others_2.yml", "YAML", 0, 0, 0, 4, 0, 0, 1, 5
"d:\IDEWORK\lvmen\src\licensedcode\data\rules\gpl-2.0_with_u-boot-exception-2.0_1.yml", "YAML", 0, 0, 0, 9, 0, 0, 1, 10
"d:\IDEWORK\lvmen\src\licensedcode\data\rules\gpl-2.0_with_universal-foss-exception-1.0_1.yml", "YAML", 0, 0, 0, 5, 0, 0, 1, 6
"d:\IDEWORK\lvmen\src\licensedcode\data\rules\gpl-2.0_with_universal-foss-exception-1.0_2.yml", "YAML", 0, 0, 0, 5, 0, 0, 1, 6
"d:\IDEWORK\lvmen\src\licensedcode\data\rules\gpl-2.0_with_universal-foss-exception-1.0_3.yml", "YAML", 0, 0, 0, 5, 0, 0, 1, 6
"d:\IDEWORK\lvmen\src\licensedcode\data\rules\gpl-2.0_with_universal-foss-exception-1.0_4.yml", "YAML", 0, 0, 0, 3, 0, 0, 1, 4
"d:\IDEWORK\lvmen\src\licensedcode\data\rules\gpl-2.0_with_universal-foss-exception-1.0_5.yml", "YAML", 0, 0, 0, 3, 0, 0, 1, 4
"d:\IDEWORK\lvmen\src\licensedcode\data\rules\gpl-2.0_with_universal-foss-exception-1.0_6.yml", "YAML", 0, 0, 0, 5, 0, 0, 1, 6
"d:\IDEWORK\lvmen\src\licensedcode\data\rules\gpl-3.0-plus_0.yml", "YAML", 0, 0, 0, 7, 0, 0, 1, 8
"d:\IDEWORK\lvmen\src\licensedcode\data\rules\gpl-3.0-plus_1.yml", "YAML", 0, 0, 0, 7, 0, 0, 1, 8
"d:\IDEWORK\lvmen\src\licensedcode\data\rules\gpl-3.0-plus_10.yml", "YAML", 0, 0, 0, 3, 0, 0, 1, 4
"d:\IDEWORK\lvmen\src\licensedcode\data\rules\gpl-3.0-plus_100.yml", "YAML", 0, 0, 0, 4, 0, 0, 1, 5
"d:\IDEWORK\lvmen\src\licensedcode\data\rules\gpl-3.0-plus_101.yml", "YAML", 0, 0, 0, 2, 0, 0, 1, 3
"d:\IDEWORK\lvmen\src\licensedcode\data\rules\gpl-3.0-plus_102.yml", "YAML", 0, 0, 0, 3, 0, 0, 1, 4
"d:\IDEWORK\lvmen\src\licensedcode\data\rules\gpl-3.0-plus_103.yml", "YAML", 0, 0, 0, 2, 0, 0, 1, 3
"d:\IDEWORK\lvmen\src\licensedcode\data\rules\gpl-3.0-plus_104.yml", "YAML", 0, 0, 0, 2, 0, 0, 1, 3
"d:\IDEWORK\lvmen\src\licensedcode\data\rules\gpl-3.0-plus_105.yml", "YAML", 0, 0, 0, 3, 0, 0, 1, 4
"d:\IDEWORK\lvmen\src\licensedcode\data\rules\gpl-3.0-plus_106.yml", "YAML", 0, 0, 0, 3, 0, 0, 1, 4
"d:\IDEWORK\lvmen\src\licensedcode\data\rules\gpl-3.0-plus_107.yml", "YAML", 0, 0, 0, 2, 0, 0, 1, 3
"d:\IDEWORK\lvmen\src\licensedcode\data\rules\gpl-3.0-plus_108.yml", "YAML", 0, 0, 0, 8, 0, 0, 1, 9
"d:\IDEWORK\lvmen\src\licensedcode\data\rules\gpl-3.0-plus_109.yml", "YAML", 0, 0, 0, 5, 0, 0, 1, 6
"d:\IDEWORK\lvmen\src\licensedcode\data\rules\gpl-3.0-plus_11.yml", "YAML", 0, 0, 0, 2, 0, 0, 1, 3
"d:\IDEWORK\lvmen\src\licensedcode\data\rules\gpl-3.0-plus_110.yml", "YAML", 0, 0, 0, 5, 0, 0, 1, 6
"d:\IDEWORK\lvmen\src\licensedcode\data\rules\gpl-3.0-plus_111.yml", "YAML", 0, 0, 0, 3, 0, 0, 1, 4
"d:\IDEWORK\lvmen\src\licensedcode\data\rules\gpl-3.0-plus_112.yml", "YAML", 0, 0, 0, 3, 0, 0, 1, 4
"d:\IDEWORK\lvmen\src\licensedcode\data\rules\gpl-3.0-plus_113.yml", "YAML", 0, 0, 0, 4, 0, 0, 1, 5
"d:\IDEWORK\lvmen\src\licensedcode\data\rules\gpl-3.0-plus_114.yml", "YAML", 0, 0, 0, 3, 0, 0, 1, 4
"d:\IDEWORK\lvmen\src\licensedcode\data\rules\gpl-3.0-plus_115.yml", "YAML", 0, 0, 0, 4, 0, 0, 1, 5
"d:\IDEWORK\lvmen\src\licensedcode\data\rules\gpl-3.0-plus_116.yml", "YAML", 0, 0, 0, 3, 0, 0, 1, 4
"d:\IDEWORK\lvmen\src\licensedcode\data\rules\gpl-3.0-plus_117.yml", "YAML", 0, 0, 0, 3, 0, 0, 1, 4
"d:\IDEWORK\lvmen\src\licensedcode\data\rules\gpl-3.0-plus_118.yml", "YAML", 0, 0, 0, 5, 0, 0, 1, 6
"d:\IDEWORK\lvmen\src\licensedcode\data\rules\gpl-3.0-plus_119.yml", "YAML", 0, 0, 0, 3, 0, 0, 1, 4
"d:\IDEWORK\lvmen\src\licensedcode\data\rules\gpl-3.0-plus_12.yml", "YAML", 0, 0, 0, 2, 0, 0, 1, 3
"d:\IDEWORK\lvmen\src\licensedcode\data\rules\gpl-3.0-plus_120.yml", "YAML", 0, 0, 0, 3, 0, 0, 1, 4
"d:\IDEWORK\lvmen\src\licensedcode\data\rules\gpl-3.0-plus_121.yml", "YAML", 0, 0, 0, 3, 0, 0, 1, 4
"d:\IDEWORK\lvmen\src\licensedcode\data\rules\gpl-3.0-plus_122.yml", "YAML", 0, 0, 0, 3, 0, 0, 1, 4
"d:\IDEWORK\lvmen\src\licensedcode\data\rules\gpl-3.0-plus_123.yml", "YAML", 0, 0, 0, 3, 0, 0, 1, 4
"d:\IDEWORK\lvmen\src\licensedcode\data\rules\gpl-3.0-plus_124.yml", "YAML", 0, 0, 0, 3, 0, 0, 1, 4
"d:\IDEWORK\lvmen\src\licensedcode\data\rules\gpl-3.0-plus_125.yml", "YAML", 0, 0, 0, 3, 0, 0, 1, 4
"d:\IDEWORK\lvmen\src\licensedcode\data\rules\gpl-3.0-plus_126.yml", "YAML", 0, 0, 0, 3, 0, 0, 1, 4
"d:\IDEWORK\lvmen\src\licensedcode\data\rules\gpl-3.0-plus_127.yml", "YAML", 0, 0, 0, 3, 0, 0, 1, 4
"d:\IDEWORK\lvmen\src\licensedcode\data\rules\gpl-3.0-plus_128.yml", "YAML", 0, 0, 0, 3, 0, 0, 1, 4
"d:\IDEWORK\lvmen\src\licensedcode\data\rules\gpl-3.0-plus_129.yml", "YAML", 0, 0, 0, 3, 0, 0, 1, 4
"d:\IDEWORK\lvmen\src\licensedcode\data\rules\gpl-3.0-plus_13.yml", "YAML", 0, 0, 0, 2, 0, 0, 1, 3
"d:\IDEWORK\lvmen\src\licensedcode\data\rules\gpl-3.0-plus_130.yml", "YAML", 0, 0, 0, 3, 0, 0, 1, 4
"d:\IDEWORK\lvmen\src\licensedcode\data\rules\gpl-3.0-plus_131.yml", "YAML", 0, 0, 0, 3, 0, 0, 1, 4
"d:\IDEWORK\lvmen\src\licensedcode\data\rules\gpl-3.0-plus_132.yml", "YAML", 0, 0, 0, 3, 0, 0, 1, 4
"d:\IDEWORK\lvmen\src\licensedcode\data\rules\gpl-3.0-plus_133.yml", "YAML", 0, 0, 0, 3, 0, 0, 1, 4
"d:\IDEWORK\lvmen\src\licensedcode\data\rules\gpl-3.0-plus_134.yml", "YAML", 0, 0, 0, 3, 0, 0, 1, 4
"d:\IDEWORK\lvmen\src\licensedcode\data\rules\gpl-3.0-plus_135.yml", "YAML", 0, 0, 0, 3, 0, 0, 1, 4
"d:\IDEWORK\lvmen\src\licensedcode\data\rules\gpl-3.0-plus_136.yml", "YAML", 0, 0, 0, 3, 0, 0, 1, 4
"d:\IDEWORK\lvmen\src\licensedcode\data\rules\gpl-3.0-plus_137.yml", "YAML", 0, 0, 0, 3, 0, 0, 1, 4
"d:\IDEWORK\lvmen\src\licensedcode\data\rules\gpl-3.0-plus_138.yml", "YAML", 0, 0, 0, 3, 0, 0, 1, 4
"d:\IDEWORK\lvmen\src\licensedcode\data\rules\gpl-3.0-plus_139.yml", "YAML", 0, 0, 0, 3, 0, 0, 1, 4
"d:\IDEWORK\lvmen\src\licensedcode\data\rules\gpl-3.0-plus_14.yml", "YAML", 0, 0, 0, 5, 0, 0, 1, 6
"d:\IDEWORK\lvmen\src\licensedcode\data\rules\gpl-3.0-plus_140.yml", "YAML", 0, 0, 0, 3, 0, 0, 1, 4
"d:\IDEWORK\lvmen\src\licensedcode\data\rules\gpl-3.0-plus_141.yml", "YAML", 0, 0, 0, 3, 0, 0, 1, 4
"d:\IDEWORK\lvmen\src\licensedcode\data\rules\gpl-3.0-plus_142.yml", "YAML", 0, 0, 0, 3, 0, 0, 1, 4
"d:\IDEWORK\lvmen\src\licensedcode\data\rules\gpl-3.0-plus_143.yml", "YAML", 0, 0, 0, 3, 0, 0, 1, 4
"d:\IDEWORK\lvmen\src\licensedcode\data\rules\gpl-3.0-plus_144.yml", "YAML", 0, 0, 0, 3, 0, 0, 1, 4
"d:\IDEWORK\lvmen\src\licensedcode\data\rules\gpl-3.0-plus_145.yml", "YAML", 0, 0, 0, 3, 0, 0, 1, 4
"d:\IDEWORK\lvmen\src\licensedcode\data\rules\gpl-3.0-plus_146.yml", "YAML", 0, 0, 0, 3, 0, 0, 1, 4
"d:\IDEWORK\lvmen\src\licensedcode\data\rules\gpl-3.0-plus_147.yml", "YAML", 0, 0, 0, 3, 0, 0, 1, 4
"d:\IDEWORK\lvmen\src\licensedcode\data\rules\gpl-3.0-plus_148.yml", "YAML", 0, 0, 0, 3, 0, 0, 1, 4
"d:\IDEWORK\lvmen\src\licensedcode\data\rules\gpl-3.0-plus_149.yml", "YAML", 0, 0, 0, 3, 0, 0, 1, 4
"d:\IDEWORK\lvmen\src\licensedcode\data\rules\gpl-3.0-plus_15.yml", "YAML", 0, 0, 0, 3, 0, 0, 1, 4
"d:\IDEWORK\lvmen\src\licensedcode\data\rules\gpl-3.0-plus_150.yml", "YAML", 0, 0, 0, 3, 0, 0, 1, 4
"d:\IDEWORK\lvmen\src\licensedcode\data\rules\gpl-3.0-plus_151.yml", "YAML", 0, 0, 0, 3, 0, 0, 1, 4
"d:\IDEWORK\lvmen\src\licensedcode\data\rules\gpl-3.0-plus_152.yml", "YAML", 0, 0, 0, 3, 0, 0, 1, 4
"d:\IDEWORK\lvmen\src\licensedcode\data\rules\gpl-3.0-plus_153.yml", "YAML", 0, 0, 0, 3, 0, 0, 1, 4
"d:\IDEWORK\lvmen\src\licensedcode\data\rules\gpl-3.0-plus_154.yml", "YAML", 0, 0, 0, 3, 0, 0, 1, 4
"d:\IDEWORK\lvmen\src\licensedcode\data\rules\gpl-3.0-plus_155.yml", "YAML", 0, 0, 0, 3, 0, 0, 1, 4
"d:\IDEWORK\lvmen\src\licensedcode\data\rules\gpl-3.0-plus_156.yml", "YAML", 0, 0, 0, 3, 0, 0, 1, 4
"d:\IDEWORK\lvmen\src\licensedcode\data\rules\gpl-3.0-plus_157.yml", "YAML", 0, 0, 0, 3, 0, 0, 1, 4
"d:\IDEWORK\lvmen\src\licensedcode\data\rules\gpl-3.0-plus_158.yml", "YAML", 0, 0, 0, 3, 0, 0, 1, 4
"d:\IDEWORK\lvmen\src\licensedcode\data\rules\gpl-3.0-plus_159.yml", "YAML", 0, 0, 0, 3, 0, 0, 1, 4
"d:\IDEWORK\lvmen\src\licensedcode\data\rules\gpl-3.0-plus_16.yml", "YAML", 0, 0, 0, 4, 0, 0, 1, 5
"d:\IDEWORK\lvmen\src\licensedcode\data\rules\gpl-3.0-plus_160.yml", "YAML", 0, 0, 0, 3, 0, 0, 1, 4
"d:\IDEWORK\lvmen\src\licensedcode\data\rules\gpl-3.0-plus_161.yml", "YAML", 0, 0, 0, 3, 0, 0, 1, 4
"d:\IDEWORK\lvmen\src\licensedcode\data\rules\gpl-3.0-plus_162.yml", "YAML", 0, 0, 0, 3, 0, 0, 1, 4
"d:\IDEWORK\lvmen\src\licensedcode\data\rules\gpl-3.0-plus_163.yml", "YAML", 0, 0, 0, 3, 0, 0, 1, 4
"d:\IDEWORK\lvmen\src\licensedcode\data\rules\gpl-3.0-plus_164.yml", "YAML", 0, 0, 0, 3, 0, 0, 1, 4
"d:\IDEWORK\lvmen\src\licensedcode\data\rules\gpl-3.0-plus_165.yml", "YAML", 0, 0, 0, 3, 0, 0, 1, 4
"d:\IDEWORK\lvmen\src\licensedcode\data\rules\gpl-3.0-plus_166.yml", "YAML", 0, 0, 0, 3, 0, 0, 1, 4
"d:\IDEWORK\lvmen\src\licensedcode\data\rules\gpl-3.0-plus_167.yml", "YAML", 0, 0, 0, 3, 0, 0, 1, 4
"d:\IDEWORK\lvmen\src\licensedcode\data\rules\gpl-3.0-plus_168.yml", "YAML", 0, 0, 0, 3, 0, 0, 1, 4
"d:\IDEWORK\lvmen\src\licensedcode\data\rules\gpl-3.0-plus_169.yml", "YAML", 0, 0, 0, 3, 0, 0, 1, 4
"d:\IDEWORK\lvmen\src\licensedcode\data\rules\gpl-3.0-plus_17.yml", "YAML", 0, 0, 0, 2, 0, 0, 1, 3
"d:\IDEWORK\lvmen\src\licensedcode\data\rules\gpl-3.0-plus_170.yml", "YAML", 0, 0, 0, 3, 0, 0, 1, 4
"d:\IDEWORK\lvmen\src\licensedcode\data\rules\gpl-3.0-plus_171.yml", "YAML", 0, 0, 0, 3, 0, 0, 1, 4
"d:\IDEWORK\lvmen\src\licensedcode\data\rules\gpl-3.0-plus_172.yml", "YAML", 0, 0, 0, 3, 0, 0, 1, 4
"d:\IDEWORK\lvmen\src\licensedcode\data\rules\gpl-3.0-plus_173.yml", "YAML", 0, 0, 0, 3, 0, 0, 1, 4
"d:\IDEWORK\lvmen\src\licensedcode\data\rules\gpl-3.0-plus_174.yml", "YAML", 0, 0, 0, 3, 0, 0, 1, 4
"d:\IDEWORK\lvmen\src\licensedcode\data\rules\gpl-3.0-plus_175.yml", "YAML", 0, 0, 0, 3, 0, 0, 1, 4
"d:\IDEWORK\lvmen\src\licensedcode\data\rules\gpl-3.0-plus_176.yml", "YAML", 0, 0, 0, 3, 0, 0, 1, 4
"d:\IDEWORK\lvmen\src\licensedcode\data\rules\gpl-3.0-plus_177.yml", "YAML", 0, 0, 0, 3, 0, 0, 1, 4
"d:\IDEWORK\lvmen\src\licensedcode\data\rules\gpl-3.0-plus_178.yml", "YAML", 0, 0, 0, 3, 0, 0, 1, 4
"d:\IDEWORK\lvmen\src\licensedcode\data\rules\gpl-3.0-plus_179.yml", "YAML", 0, 0, 0, 3, 0, 0, 1, 4
"d:\IDEWORK\lvmen\src\licensedcode\data\rules\gpl-3.0-plus_18.yml", "YAML", 0, 0, 0, 4, 0, 0, 1, 5
"d:\IDEWORK\lvmen\src\licensedcode\data\rules\gpl-3.0-plus_180.yml", "YAML", 0, 0, 0, 3, 0, 0, 1, 4
"d:\IDEWORK\lvmen\src\licensedcode\data\rules\gpl-3.0-plus_181.yml", "YAML", 0, 0, 0, 7, 0, 0, 1, 8
"d:\IDEWORK\lvmen\src\licensedcode\data\rules\gpl-3.0-plus_182.yml", "YAML", 0, 0, 0, 9, 0, 0, 1, 10
"d:\IDEWORK\lvmen\src\licensedcode\data\rules\gpl-3.0-plus_183.yml", "YAML", 0, 0, 0, 7, 0, 0, 1, 8
"d:\IDEWORK\lvmen\src\licensedcode\data\rules\gpl-3.0-plus_184.yml", "YAML", 0, 0, 0, 9, 0, 0, 1, 10
"d:\IDEWORK\lvmen\src\licensedcode\data\rules\gpl-3.0-plus_185.yml", "YAML", 0, 0, 0, 7, 0, 0, 1, 8
"d:\IDEWORK\lvmen\src\licensedcode\data\rules\gpl-3.0-plus_186.yml", "YAML", 0, 0, 0, 3, 0, 0, 1, 4
"d:\IDEWORK\lvmen\src\licensedcode\data\rules\gpl-3.0-plus_187.yml", "YAML", 0, 0, 0, 5, 0, 0, 1, 6
"d:\IDEWORK\lvmen\src\licensedcode\data\rules\gpl-3.0-plus_188.yml", "YAML", 0, 0, 0, 3, 0, 0, 1, 4
"d:\IDEWORK\lvmen\src\licensedcode\data\rules\gpl-3.0-plus_189.yml", "YAML", 0, 0, 0, 3, 0, 0, 1, 4
"d:\IDEWORK\lvmen\src\licensedcode\data\rules\gpl-3.0-plus_19.yml", "YAML", 0, 0, 0, 2, 0, 0, 1, 3
"d:\IDEWORK\lvmen\src\licensedcode\data\rules\gpl-3.0-plus_190.yml", "YAML", 0, 0, 0, 5, 0, 0, 1, 6
"d:\IDEWORK\lvmen\src\licensedcode\data\rules\gpl-3.0-plus_191.yml", "YAML", 0, 0, 0, 5, 0, 0, 1, 6
"d:\IDEWORK\lvmen\src\licensedcode\data\rules\gpl-3.0-plus_192.yml", "YAML", 0, 0, 0, 3, 0, 0, 1, 4
"d:\IDEWORK\lvmen\src\licensedcode\data\rules\gpl-3.0-plus_193.yml", "YAML", 0, 0, 0, 3, 0, 0, 1, 4
"d:\IDEWORK\lvmen\src\licensedcode\data\rules\gpl-3.0-plus_194.yml", "YAML", 0, 0, 0, 5, 0, 0, 1, 6
"d:\IDEWORK\lvmen\src\licensedcode\data\rules\gpl-3.0-plus_195.yml", "YAML", 0, 0, 0, 5, 0, 0, 1, 6
"d:\IDEWORK\lvmen\src\licensedcode\data\rules\gpl-3.0-plus_196.yml", "YAML", 0, 0, 0, 5, 0, 0, 1, 6
"d:\IDEWORK\lvmen\src\licensedcode\data\rules\gpl-3.0-plus_197.yml", "YAML", 0, 0, 0, 3, 0, 0, 1, 4
"d:\IDEWORK\lvmen\src\licensedcode\data\rules\gpl-3.0-plus_198.yml", "YAML", 0, 0, 0, 3, 0, 0, 1, 4
"d:\IDEWORK\lvmen\src\licensedcode\data\rules\gpl-3.0-plus_199.yml", "YAML", 0, 0, 0, 3, 0, 0, 1, 4
"d:\IDEWORK\lvmen\src\licensedcode\data\rules\gpl-3.0-plus_2.yml", "YAML", 0, 0, 0, 5, 0, 0, 1, 6
"d:\IDEWORK\lvmen\src\licensedcode\data\rules\gpl-3.0-plus_20.yml", "YAML", 0, 0, 0, 4, 0, 0, 1, 5
"d:\IDEWORK\lvmen\src\licensedcode\data\rules\gpl-3.0-plus_200.yml", "YAML", 0, 0, 0, 5, 0, 0, 1, 6
"d:\IDEWORK\lvmen\src\licensedcode\data\rules\gpl-3.0-plus_201.yml", "YAML", 0, 0, 0, 5, 0, 0, 1, 6
"d:\IDEWORK\lvmen\src\licensedcode\data\rules\gpl-3.0-plus_202.yml", "YAML", 0, 0, 0, 8, 0, 0, 1, 9
"d:\IDEWORK\lvmen\src\licensedcode\data\rules\gpl-3.0-plus_203.yml", "YAML", 0, 0, 0, 3, 0, 0, 1, 4
"d:\IDEWORK\lvmen\src\licensedcode\data\rules\gpl-3.0-plus_204.yml", "YAML", 0, 0, 0, 3, 0, 0, 1, 4
"d:\IDEWORK\lvmen\src\licensedcode\data\rules\gpl-3.0-plus_205.yml", "YAML", 0, 0, 0, 3, 0, 0, 1, 4
"d:\IDEWORK\lvmen\src\licensedcode\data\rules\gpl-3.0-plus_206.yml", "YAML", 0, 0, 0, 5, 0, 0, 1, 6
"d:\IDEWORK\lvmen\src\licensedcode\data\rules\gpl-3.0-plus_207.yml", "YAML", 0, 0, 0, 5, 0, 0, 1, 6
"d:\IDEWORK\lvmen\src\licensedcode\data\rules\gpl-3.0-plus_208.yml", "YAML", 0, 0, 0, 6, 0, 0, 1, 7
"d:\IDEWORK\lvmen\src\licensedcode\data\rules\gpl-3.0-plus_209.yml", "YAML", 0, 0, 0, 5, 0, 0, 1, 6
"d:\IDEWORK\lvmen\src\licensedcode\data\rules\gpl-3.0-plus_21.yml", "YAML", 0, 0, 0, 5, 0, 0, 1, 6
"d:\IDEWORK\lvmen\src\licensedcode\data\rules\gpl-3.0-plus_210.yml", "YAML", 0, 0, 0, 5, 0, 0, 1, 6
"d:\IDEWORK\lvmen\src\licensedcode\data\rules\gpl-3.0-plus_211.yml", "YAML", 0, 0, 0, 5, 0, 0, 1, 6
"d:\IDEWORK\lvmen\src\licensedcode\data\rules\gpl-3.0-plus_212.yml", "YAML", 0, 0, 0, 4, 0, 0, 1, 5
"d:\IDEWORK\lvmen\src\licensedcode\data\rules\gpl-3.0-plus_213.yml", "YAML", 0, 0, 0, 3, 0, 0, 1, 4
"d:\IDEWORK\lvmen\src\licensedcode\data\rules\gpl-3.0-plus_214.yml", "YAML", 0, 0, 0, 5, 0, 0, 1, 6
"d:\IDEWORK\lvmen\src\licensedcode\data\rules\gpl-3.0-plus_215.yml", "YAML", 0, 0, 0, 3, 0, 0, 1, 4
"d:\IDEWORK\lvmen\src\licensedcode\data\rules\gpl-3.0-plus_216.yml", "YAML", 0, 0, 0, 3, 0, 0, 1, 4
"d:\IDEWORK\lvmen\src\licensedcode\data\rules\gpl-3.0-plus_217.yml", "YAML", 0, 0, 0, 7, 0, 0, 1, 8
"d:\IDEWORK\lvmen\src\licensedcode\data\rules\gpl-3.0-plus_218.yml", "YAML", 0, 0, 0, 7, 0, 0, 1, 8
"d:\IDEWORK\lvmen\src\licensedcode\data\rules\gpl-3.0-plus_219.yml", "YAML", 0, 0, 0, 3, 0, 0, 1, 4
"d:\IDEWORK\lvmen\src\licensedcode\data\rules\gpl-3.0-plus_22.yml", "YAML", 0, 0, 0, 6, 0, 0, 1, 7
"d:\IDEWORK\lvmen\src\licensedcode\data\rules\gpl-3.0-plus_220.yml", "YAML", 0, 0, 0, 3, 0, 0, 1, 4
"d:\IDEWORK\lvmen\src\licensedcode\data\rules\gpl-3.0-plus_221.yml", "YAML", 0, 0, 0, 5, 0, 0, 1, 6
"d:\IDEWORK\lvmen\src\licensedcode\data\rules\gpl-3.0-plus_222.yml", "YAML", 0, 0, 0, 5, 0, 0, 1, 6
"d:\IDEWORK\lvmen\src\licensedcode\data\rules\gpl-3.0-plus_223.yml", "YAML", 0, 0, 0, 3, 0, 0, 1, 4
"d:\IDEWORK\lvmen\src\licensedcode\data\rules\gpl-3.0-plus_224.yml", "YAML", 0, 0, 0, 3, 0, 0, 1, 4
"d:\IDEWORK\lvmen\src\licensedcode\data\rules\gpl-3.0-plus_225.yml", "YAML", 0, 0, 0, 7, 0, 0, 1, 8
"d:\IDEWORK\lvmen\src\licensedcode\data\rules\gpl-3.0-plus_226.yml", "YAML", 0, 0, 0, 3, 0, 0, 1, 4
"d:\IDEWORK\lvmen\src\licensedcode\data\rules\gpl-3.0-plus_227.yml", "YAML", 0, 0, 0, 5, 0, 0, 1, 6
"d:\IDEWORK\lvmen\src\licensedcode\data\rules\gpl-3.0-plus_228.yml", "YAML", 0, 0, 0, 5, 0, 0, 1, 6
"d:\IDEWORK\lvmen\src\licensedcode\data\rules\gpl-3.0-plus_229.yml", "YAML", 0, 0, 0, 5, 0, 0, 1, 6
"d:\IDEWORK\lvmen\src\licensedcode\data\rules\gpl-3.0-plus_23.yml", "YAML", 0, 0, 0, 4, 0, 0, 1, 5
"d:\IDEWORK\lvmen\src\licensedcode\data\rules\gpl-3.0-plus_230.yml", "YAML", 0, 0, 0, 5, 0, 0, 1, 6
"d:\IDEWORK\lvmen\src\licensedcode\data\rules\gpl-3.0-plus_231.yml", "YAML", 0, 0, 0, 5, 0, 0, 1, 6
"d:\IDEWORK\lvmen\src\licensedcode\data\rules\gpl-3.0-plus_232.yml", "YAML", 0, 0, 0, 5, 0, 0, 1, 6
"d:\IDEWORK\lvmen\src\licensedcode\data\rules\gpl-3.0-plus_233.yml", "YAML", 0, 0, 0, 7, 0, 0, 1, 8
"d:\IDEWORK\lvmen\src\licensedcode\data\rules\gpl-3.0-plus_234.yml", "YAML", 0, 0, 0, 5, 0, 0, 1, 6
"d:\IDEWORK\lvmen\src\licensedcode\data\rules\gpl-3.0-plus_235.yml", "YAML", 0, 0, 0, 4, 0, 0, 1, 5
"d:\IDEWORK\lvmen\src\licensedcode\data\rules\gpl-3.0-plus_236.yml", "YAML", 0, 0, 0, 4, 0, 0, 1, 5
"d:\IDEWORK\lvmen\src\licensedcode\data\rules\gpl-3.0-plus_237.yml", "YAML", 0, 0, 0, 7, 0, 0, 2, 9
"d:\IDEWORK\lvmen\src\licensedcode\data\rules\gpl-3.0-plus_238.yml", "YAML", 0, 0, 0, 5, 0, 0, 1, 6
"d:\IDEWORK\lvmen\src\licensedcode\data\rules\gpl-3.0-plus_239.yml", "YAML", 0, 0, 0, 3, 0, 0, 1, 4
"d:\IDEWORK\lvmen\src\licensedcode\data\rules\gpl-3.0-plus_24.yml", "YAML", 0, 0, 0, 3, 0, 0, 1, 4
"d:\IDEWORK\lvmen\src\licensedcode\data\rules\gpl-3.0-plus_240.yml", "YAML", 0, 0, 0, 5, 0, 0, 1, 6
"d:\IDEWORK\lvmen\src\licensedcode\data\rules\gpl-3.0-plus_241.yml", "YAML", 0, 0, 0, 6, 0, 0, 1, 7
"d:\IDEWORK\lvmen\src\licensedcode\data\rules\gpl-3.0-plus_242.yml", "YAML", 0, 0, 0, 3, 0, 0, 1, 4
"d:\IDEWORK\lvmen\src\licensedcode\data\rules\gpl-3.0-plus_243.yml", "YAML", 0, 0, 0, 3, 0, 0, 1, 4
"d:\IDEWORK\lvmen\src\licensedcode\data\rules\gpl-3.0-plus_244.yml", "YAML", 0, 0, 0, 3, 0, 0, 1, 4
"d:\IDEWORK\lvmen\src\licensedcode\data\rules\gpl-3.0-plus_245.yml", "YAML", 0, 0, 0, 3, 0, 0, 1, 4
"d:\IDEWORK\lvmen\src\licensedcode\data\rules\gpl-3.0-plus_246.yml", "YAML", 0, 0, 0, 3, 0, 0, 1, 4
"d:\IDEWORK\lvmen\src\licensedcode\data\rules\gpl-3.0-plus_247.yml", "YAML", 0, 0, 0, 3, 0, 0, 1, 4
"d:\IDEWORK\lvmen\src\licensedcode\data\rules\gpl-3.0-plus_248.yml", "YAML", 0, 0, 0, 3, 0, 0, 1, 4
"d:\IDEWORK\lvmen\src\licensedcode\data\rules\gpl-3.0-plus_249.yml", "YAML", 0, 0, 0, 3, 0, 0, 1, 4
"d:\IDEWORK\lvmen\src\licensedcode\data\rules\gpl-3.0-plus_25.yml", "YAML", 0, 0, 0, 5, 0, 0, 1, 6
"d:\IDEWORK\lvmen\src\licensedcode\data\rules\gpl-3.0-plus_250.yml", "YAML", 0, 0, 0, 3, 0, 0, 1, 4
"d:\IDEWORK\lvmen\src\licensedcode\data\rules\gpl-3.0-plus_251.yml", "YAML", 0, 0, 0, 3, 0, 0, 1, 4
"d:\IDEWORK\lvmen\src\licensedcode\data\rules\gpl-3.0-plus_252.yml", "YAML", 0, 0, 0, 3, 0, 0, 1, 4
"d:\IDEWORK\lvmen\src\licensedcode\data\rules\gpl-3.0-plus_253.yml", "YAML", 0, 0, 0, 4, 0, 0, 1, 5
"d:\IDEWORK\lvmen\src\licensedcode\data\rules\gpl-3.0-plus_254.yml", "YAML", 0, 0, 0, 4, 0, 0, 1, 5
"d:\IDEWORK\lvmen\src\licensedcode\data\rules\gpl-3.0-plus_255.yml", "YAML", 0, 0, 0, 4, 0, 0, 1, 5
"d:\IDEWORK\lvmen\src\licensedcode\data\rules\gpl-3.0-plus_256.yml", "YAML", 0, 0, 0, 4, 0, 0, 1, 5
"d:\IDEWORK\lvmen\src\licensedcode\data\rules\gpl-3.0-plus_257.yml", "YAML", 0, 0, 0, 5, 0, 0, 1, 6
"d:\IDEWORK\lvmen\src\licensedcode\data\rules\gpl-3.0-plus_258.yml", "YAML", 0, 0, 0, 5, 0, 0, 1, 6
"d:\IDEWORK\lvmen\src\licensedcode\data\rules\gpl-3.0-plus_259.yml", "YAML", 0, 0, 0, 3, 0, 0, 1, 4
"d:\IDEWORK\lvmen\src\licensedcode\data\rules\gpl-3.0-plus_26.yml", "YAML", 0, 0, 0, 5, 0, 0, 1, 6
"d:\IDEWORK\lvmen\src\licensedcode\data\rules\gpl-3.0-plus_260.yml", "YAML", 0, 0, 0, 3, 0, 0, 1, 4
"d:\IDEWORK\lvmen\src\licensedcode\data\rules\gpl-3.0-plus_261.yml", "YAML", 0, 0, 0, 3, 0, 0, 1, 4
"d:\IDEWORK\lvmen\src\licensedcode\data\rules\gpl-3.0-plus_262.yml", "YAML", 0, 0, 0, 7, 0, 0, 1, 8
"d:\IDEWORK\lvmen\src\licensedcode\data\rules\gpl-3.0-plus_263.yml", "YAML", 0, 0, 0, 3, 0, 0, 1, 4
"d:\IDEWORK\lvmen\src\licensedcode\data\rules\gpl-3.0-plus_264.yml", "YAML", 0, 0, 0, 3, 0, 0, 1, 4
"d:\IDEWORK\lvmen\src\licensedcode\data\rules\gpl-3.0-plus_265.yml", "YAML", 0, 0, 0, 3, 0, 0, 1, 4
"d:\IDEWORK\lvmen\src\licensedcode\data\rules\gpl-3.0-plus_266.yml", "YAML", 0, 0, 0, 3, 0, 0, 1, 4
"d:\IDEWORK\lvmen\src\licensedcode\data\rules\gpl-3.0-plus_267.yml", "YAML", 0, 0, 0, 3, 0, 0, 1, 4
"d:\IDEWORK\lvmen\src\licensedcode\data\rules\gpl-3.0-plus_268.yml", "YAML", 0, 0, 0, 5, 0, 0, 1, 6
"d:\IDEWORK\lvmen\src\licensedcode\data\rules\gpl-3.0-plus_269.yml", "YAML", 0, 0, 0, 3, 0, 0, 1, 4
"d:\IDEWORK\lvmen\src\licensedcode\data\rules\gpl-3.0-plus_27.yml", "YAML", 0, 0, 0, 5, 0, 0, 1, 6
"d:\IDEWORK\lvmen\src\licensedcode\data\rules\gpl-3.0-plus_270.yml", "YAML", 0, 0, 0, 3, 0, 0, 1, 4
"d:\IDEWORK\lvmen\src\licensedcode\data\rules\gpl-3.0-plus_271.yml", "YAML", 0, 0, 0, 5, 0, 0, 1, 6
"d:\IDEWORK\lvmen\src\licensedcode\data\rules\gpl-3.0-plus_272.yml", "YAML", 0, 0, 0, 5, 0, 0, 1, 6
"d:\IDEWORK\lvmen\src\licensedcode\data\rules\gpl-3.0-plus_273.yml", "YAML", 0, 0, 0, 5, 0, 0, 1, 6
"d:\IDEWORK\lvmen\src\licensedcode\data\rules\gpl-3.0-plus_274.yml", "YAML", 0, 0, 0, 5, 0, 0, 1, 6
"d:\IDEWORK\lvmen\src\licensedcode\data\rules\gpl-3.0-plus_275.yml", "YAML", 0, 0, 0, 3, 0, 0, 1, 4
"d:\IDEWORK\lvmen\src\licensedcode\data\rules\gpl-3.0-plus_276.yml", "YAML", 0, 0, 0, 3, 0, 0, 1, 4
"d:\IDEWORK\lvmen\src\licensedcode\data\rules\gpl-3.0-plus_277.yml", "YAML", 0, 0, 0, 3, 0, 0, 1, 4
"d:\IDEWORK\lvmen\src\licensedcode\data\rules\gpl-3.0-plus_278.yml", "YAML", 0, 0, 0, 3, 0, 0, 1, 4
"d:\IDEWORK\lvmen\src\licensedcode\data\rules\gpl-3.0-plus_279.yml", "YAML", 0, 0, 0, 5, 0, 0, 1, 6
"d:\IDEWORK\lvmen\src\licensedcode\data\rules\gpl-3.0-plus_28.yml", "YAML", 0, 0, 0, 3, 0, 0, 1, 4
"d:\IDEWORK\lvmen\src\licensedcode\data\rules\gpl-3.0-plus_280.yml", "YAML", 0, 0, 0, 3, 0, 0, 1, 4
"d:\IDEWORK\lvmen\src\licensedcode\data\rules\gpl-3.0-plus_281.yml", "YAML", 0, 0, 0, 3, 0, 0, 1, 4
"d:\IDEWORK\lvmen\src\licensedcode\data\rules\gpl-3.0-plus_282.yml", "YAML", 0, 0, 0, 6, 0, 0, 1, 7
"d:\IDEWORK\lvmen\src\licensedcode\data\rules\gpl-3.0-plus_283.yml", "YAML", 0, 0, 0, 5, 0, 0, 1, 6
"d:\IDEWORK\lvmen\src\licensedcode\data\rules\gpl-3.0-plus_284.yml", "YAML", 0, 0, 0, 3, 0, 0, 1, 4
"d:\IDEWORK\lvmen\src\licensedcode\data\rules\gpl-3.0-plus_285.yml", "YAML", 0, 0, 0, 5, 0, 0, 1, 6
"d:\IDEWORK\lvmen\src\licensedcode\data\rules\gpl-3.0-plus_286.yml", "YAML", 0, 0, 0, 7, 0, 0, 1, 8
"d:\IDEWORK\lvmen\src\licensedcode\data\rules\gpl-3.0-plus_287.yml", "YAML", 0, 0, 0, 5, 0, 0, 1, 6
"d:\IDEWORK\lvmen\src\licensedcode\data\rules\gpl-3.0-plus_288.yml", "YAML", 0, 0, 0, 7, 0, 0, 1, 8
"d:\IDEWORK\lvmen\src\licensedcode\data\rules\gpl-3.0-plus_289.yml", "YAML", 0, 0, 0, 7, 0, 0, 1, 8
"d:\IDEWORK\lvmen\src\licensedcode\data\rules\gpl-3.0-plus_29.yml", "YAML", 0, 0, 0, 4, 0, 0, 1, 5
"d:\IDEWORK\lvmen\src\licensedcode\data\rules\gpl-3.0-plus_290.yml", "YAML", 0, 0, 0, 6, 0, 0, 1, 7
"d:\IDEWORK\lvmen\src\licensedcode\data\rules\gpl-3.0-plus_291.yml", "YAML", 0, 0, 0, 3, 0, 0, 1, 4
"d:\IDEWORK\lvmen\src\licensedcode\data\rules\gpl-3.0-plus_292.yml", "YAML", 0, 0, 0, 3, 0, 0, 1, 4
"d:\IDEWORK\lvmen\src\licensedcode\data\rules\gpl-3.0-plus_293.yml", "YAML", 0, 0, 0, 3, 0, 0, 1, 4
"d:\IDEWORK\lvmen\src\licensedcode\data\rules\gpl-3.0-plus_294.yml", "YAML", 0, 0, 0, 5, 0, 0, 1, 6
"d:\IDEWORK\lvmen\src\licensedcode\data\rules\gpl-3.0-plus_295.yml", "YAML", 0, 0, 0, 3, 0, 0, 1, 4
"d:\IDEWORK\lvmen\src\licensedcode\data\rules\gpl-3.0-plus_296.yml", "YAML", 0, 0, 0, 3, 0, 0, 1, 4
"d:\IDEWORK\lvmen\src\licensedcode\data\rules\gpl-3.0-plus_297.yml", "YAML", 0, 0, 0, 3, 0, 0, 1, 4
"d:\IDEWORK\lvmen\src\licensedcode\data\rules\gpl-3.0-plus_298.yml", "YAML", 0, 0, 0, 7, 0, 0, 1, 8
"d:\IDEWORK\lvmen\src\licensedcode\data\rules\gpl-3.0-plus_299.yml", "YAML", 0, 0, 0, 5, 0, 0, 1, 6
"d:\IDEWORK\lvmen\src\licensedcode\data\rules\gpl-3.0-plus_3.yml", "YAML", 0, 0, 0, 4, 0, 0, 1, 5
"d:\IDEWORK\lvmen\src\licensedcode\data\rules\gpl-3.0-plus_30.yml", "YAML", 0, 0, 0, 5, 0, 0, 1, 6
"d:\IDEWORK\lvmen\src\licensedcode\data\rules\gpl-3.0-plus_300.yml", "YAML", 0, 0, 0, 5, 0, 0, 1, 6
"d:\IDEWORK\lvmen\src\licensedcode\data\rules\gpl-3.0-plus_301.yml", "YAML", 0, 0, 0, 3, 0, 0, 1, 4
"d:\IDEWORK\lvmen\src\licensedcode\data\rules\gpl-3.0-plus_302.yml", "YAML", 0, 0, 0, 3, 0, 0, 1, 4
"d:\IDEWORK\lvmen\src\licensedcode\data\rules\gpl-3.0-plus_303.yml", "YAML", 0, 0, 0, 3, 0, 0, 1, 4
"d:\IDEWORK\lvmen\src\licensedcode\data\rules\gpl-3.0-plus_304.yml", "YAML", 0, 0, 0, 3, 0, 0, 1, 4
"d:\IDEWORK\lvmen\src\licensedcode\data\rules\gpl-3.0-plus_305.yml", "YAML", 0, 0, 0, 3, 0, 0, 1, 4
"d:\IDEWORK\lvmen\src\licensedcode\data\rules\gpl-3.0-plus_306.yml", "YAML", 0, 0, 0, 3, 0, 0, 1, 4
"d:\IDEWORK\lvmen\src\licensedcode\data\rules\gpl-3.0-plus_307.yml", "YAML", 0, 0, 0, 3, 0, 0, 1, 4
"d:\IDEWORK\lvmen\src\licensedcode\data\rules\gpl-3.0-plus_308.yml", "YAML", 0, 0, 0, 3, 0, 0, 1, 4
"d:\IDEWORK\lvmen\src\licensedcode\data\rules\gpl-3.0-plus_309.yml", "YAML", 0, 0, 0, 3, 0, 0, 1, 4
"d:\IDEWORK\lvmen\src\licensedcode\data\rules\gpl-3.0-plus_31.yml", "YAML", 0, 0, 0, 3, 0, 0, 1, 4
"d:\IDEWORK\lvmen\src\licensedcode\data\rules\gpl-3.0-plus_310.yml", "YAML", 0, 0, 0, 3, 0, 0, 1, 4
"d:\IDEWORK\lvmen\src\licensedcode\data\rules\gpl-3.0-plus_311.yml", "YAML", 0, 0, 0, 3, 0, 0, 1, 4
"d:\IDEWORK\lvmen\src\licensedcode\data\rules\gpl-3.0-plus_312.yml", "YAML", 0, 0, 0, 5, 0, 0, 1, 6
"d:\IDEWORK\lvmen\src\licensedcode\data\rules\gpl-3.0-plus_313.yml", "YAML", 0, 0, 0, 5, 0, 0, 1, 6
"d:\IDEWORK\lvmen\src\licensedcode\data\rules\gpl-3.0-plus_314.yml", "YAML", 0, 0, 0, 3, 0, 0, 1, 4
"d:\IDEWORK\lvmen\src\licensedcode\data\rules\gpl-3.0-plus_315.yml", "YAML", 0, 0, 0, 4, 0, 0, 1, 5
"d:\IDEWORK\lvmen\src\licensedcode\data\rules\gpl-3.0-plus_316.yml", "YAML", 0, 0, 0, 3, 0, 0, 1, 4
"d:\IDEWORK\lvmen\src\licensedcode\data\rules\gpl-3.0-plus_317.yml", "YAML", 0, 0, 0, 7, 0, 0, 1, 8
"d:\IDEWORK\lvmen\src\licensedcode\data\rules\gpl-3.0-plus_318.yml", "YAML", 0, 0, 0, 5, 0, 0, 1, 6
"d:\IDEWORK\lvmen\src\licensedcode\data\rules\gpl-3.0-plus_319.yml", "YAML", 0, 0, 0, 7, 0, 0, 1, 8
"d:\IDEWORK\lvmen\src\licensedcode\data\rules\gpl-3.0-plus_32.yml", "YAML", 0, 0, 0, 3, 0, 0, 1, 4
"d:\IDEWORK\lvmen\src\licensedcode\data\rules\gpl-3.0-plus_320.yml", "YAML", 0, 0, 0, 5, 0, 0, 1, 6
"d:\IDEWORK\lvmen\src\licensedcode\data\rules\gpl-3.0-plus_321.yml", "YAML", 0, 0, 0, 7, 0, 0, 1, 8
"d:\IDEWORK\lvmen\src\licensedcode\data\rules\gpl-3.0-plus_322.yml", "YAML", 0, 0, 0, 5, 0, 0, 1, 6
"d:\IDEWORK\lvmen\src\licensedcode\data\rules\gpl-3.0-plus_323.yml", "YAML", 0, 0, 0, 7, 0, 0, 1, 8
"d:\IDEWORK\lvmen\src\licensedcode\data\rules\gpl-3.0-plus_324.yml", "YAML", 0, 0, 0, 5, 0, 0, 1, 6
"d:\IDEWORK\lvmen\src\licensedcode\data\rules\gpl-3.0-plus_325.yml", "YAML", 0, 0, 0, 7, 0, 0, 1, 8
"d:\IDEWORK\lvmen\src\licensedcode\data\rules\gpl-3.0-plus_326.yml", "YAML", 0, 0, 0, 7, 0, 0, 1, 8
"d:\IDEWORK\lvmen\src\licensedcode\data\rules\gpl-3.0-plus_327.yml", "YAML", 0, 0, 0, 3, 0, 0, 1, 4
"d:\IDEWORK\lvmen\src\licensedcode\data\rules\gpl-3.0-plus_328.yml", "YAML", 0, 0, 0, 3, 0, 0, 1, 4
"d:\IDEWORK\lvmen\src\licensedcode\data\rules\gpl-3.0-plus_329.yml", "YAML", 0, 0, 0, 6, 0, 0, 1, 7
"d:\IDEWORK\lvmen\src\licensedcode\data\rules\gpl-3.0-plus_33.yml", "YAML", 0, 0, 0, 4, 0, 0, 1, 5
"d:\IDEWORK\lvmen\src\licensedcode\data\rules\gpl-3.0-plus_330.yml", "YAML", 0, 0, 0, 3, 0, 0, 1, 4
"d:\IDEWORK\lvmen\src\licensedcode\data\rules\gpl-3.0-plus_331.yml", "YAML", 0, 0, 0, 3, 0, 0, 1, 4
"d:\IDEWORK\lvmen\src\licensedcode\data\rules\gpl-3.0-plus_332.yml", "YAML", 0, 0, 0, 3, 0, 0, 1, 4
"d:\IDEWORK\lvmen\src\licensedcode\data\rules\gpl-3.0-plus_333.yml", "YAML", 0, 0, 0, 3, 0, 0, 1, 4
"d:\IDEWORK\lvmen\src\licensedcode\data\rules\gpl-3.0-plus_334.yml", "YAML", 0, 0, 0, 5, 0, 0, 1, 6
"d:\IDEWORK\lvmen\src\licensedcode\data\rules\gpl-3.0-plus_335.yml", "YAML", 0, 0, 0, 5, 0, 0, 1, 6
"d:\IDEWORK\lvmen\src\licensedcode\data\rules\gpl-3.0-plus_336.yml", "YAML", 0, 0, 0, 5, 0, 0, 1, 6
"d:\IDEWORK\lvmen\src\licensedcode\data\rules\gpl-3.0-plus_337.yml", "YAML", 0, 0, 0, 5, 0, 0, 1, 6
"d:\IDEWORK\lvmen\src\licensedcode\data\rules\gpl-3.0-plus_338.yml", "YAML", 0, 0, 0, 5, 0, 0, 1, 6
"d:\IDEWORK\lvmen\src\licensedcode\data\rules\gpl-3.0-plus_339.yml", "YAML", 0, 0, 0, 5, 0, 0, 1, 6
"d:\IDEWORK\lvmen\src\licensedcode\data\rules\gpl-3.0-plus_34.yml", "YAML", 0, 0, 0, 4, 0, 0, 1, 5
"d:\IDEWORK\lvmen\src\licensedcode\data\rules\gpl-3.0-plus_340.yml", "YAML", 0, 0, 0, 3, 0, 0, 1, 4
"d:\IDEWORK\lvmen\src\licensedcode\data\rules\gpl-3.0-plus_341.yml", "YAML", 0, 0, 0, 3, 0, 0, 1, 4
"d:\IDEWORK\lvmen\src\licensedcode\data\rules\gpl-3.0-plus_342.yml", "YAML", 0, 0, 0, 3, 0, 0, 1, 4
"d:\IDEWORK\lvmen\src\licensedcode\data\rules\gpl-3.0-plus_343.yml", "YAML", 0, 0, 0, 3, 0, 0, 1, 4
"d:\IDEWORK\lvmen\src\licensedcode\data\rules\gpl-3.0-plus_344.yml", "YAML", 0, 0, 0, 3, 0, 0, 1, 4
"d:\IDEWORK\lvmen\src\licensedcode\data\rules\gpl-3.0-plus_345.yml", "YAML", 0, 0, 0, 5, 0, 0, 1, 6
"d:\IDEWORK\lvmen\src\licensedcode\data\rules\gpl-3.0-plus_346.yml", "YAML", 0, 0, 0, 5, 0, 0, 1, 6
"d:\IDEWORK\lvmen\src\licensedcode\data\rules\gpl-3.0-plus_347.yml", "YAML", 0, 0, 0, 5, 0, 0, 1, 6
"d:\IDEWORK\lvmen\src\licensedcode\data\rules\gpl-3.0-plus_348.yml", "YAML", 0, 0, 0, 5, 0, 0, 1, 6
"d:\IDEWORK\lvmen\src\licensedcode\data\rules\gpl-3.0-plus_349.yml", "YAML", 0, 0, 0, 3, 0, 0, 1, 4
"d:\IDEWORK\lvmen\src\licensedcode\data\rules\gpl-3.0-plus_35.yml", "YAML", 0, 0, 0, 3, 0, 0, 1, 4
"d:\IDEWORK\lvmen\src\licensedcode\data\rules\gpl-3.0-plus_350.yml", "YAML", 0, 0, 0, 3, 0, 0, 1, 4
"d:\IDEWORK\lvmen\src\licensedcode\data\rules\gpl-3.0-plus_351.yml", "YAML", 0, 0, 0, 3, 0, 0, 1, 4
"d:\IDEWORK\lvmen\src\licensedcode\data\rules\gpl-3.0-plus_352.yml", "YAML", 0, 0, 0, 5, 0, 0, 1, 6
"d:\IDEWORK\lvmen\src\licensedcode\data\rules\gpl-3.0-plus_353.yml", "YAML", 0, 0, 0, 2, 0, 0, 1, 3
"d:\IDEWORK\lvmen\src\licensedcode\data\rules\gpl-3.0-plus_354.yml", "YAML", 0, 0, 0, 4, 0, 0, 1, 5
"d:\IDEWORK\lvmen\src\licensedcode\data\rules\gpl-3.0-plus_355.yml", "YAML", 0, 0, 0, 3, 0, 0, 1, 4
"d:\IDEWORK\lvmen\src\licensedcode\data\rules\gpl-3.0-plus_356.yml", "YAML", 0, 0, 0, 3, 0, 0, 1, 4
"d:\IDEWORK\lvmen\src\licensedcode\data\rules\gpl-3.0-plus_357.yml", "YAML", 0, 0, 0, 3, 0, 0, 1, 4
"d:\IDEWORK\lvmen\src\licensedcode\data\rules\gpl-3.0-plus_358.yml", "YAML", 0, 0, 0, 5, 0, 0, 1, 6
"d:\IDEWORK\lvmen\src\licensedcode\data\rules\gpl-3.0-plus_359.yml", "YAML", 0, 0, 0, 3, 0, 0, 1, 4
"d:\IDEWORK\lvmen\src\licensedcode\data\rules\gpl-3.0-plus_36.yml", "YAML", 0, 0, 0, 3, 0, 0, 1, 4
"d:\IDEWORK\lvmen\src\licensedcode\data\rules\gpl-3.0-plus_360.yml", "YAML", 0, 0, 0, 5, 0, 0, 1, 6
"d:\IDEWORK\lvmen\src\licensedcode\data\rules\gpl-3.0-plus_361.yml", "YAML", 0, 0, 0, 3, 0, 0, 1, 4
"d:\IDEWORK\lvmen\src\licensedcode\data\rules\gpl-3.0-plus_362.yml", "YAML", 0, 0, 0, 5, 0, 0, 1, 6
"d:\IDEWORK\lvmen\src\licensedcode\data\rules\gpl-3.0-plus_363.yml", "YAML", 0, 0, 0, 5, 0, 0, 1, 6
"d:\IDEWORK\lvmen\src\licensedcode\data\rules\gpl-3.0-plus_364.yml", "YAML", 0, 0, 0, 3, 0, 0, 1, 4
"d:\IDEWORK\lvmen\src\licensedcode\data\rules\gpl-3.0-plus_365.yml", "YAML", 0, 0, 0, 5, 0, 0, 1, 6
"d:\IDEWORK\lvmen\src\licensedcode\data\rules\gpl-3.0-plus_366.yml", "YAML", 0, 0, 0, 5, 0, 0, 1, 6
"d:\IDEWORK\lvmen\src\licensedcode\data\rules\gpl-3.0-plus_367.yml", "YAML", 0, 0, 0, 5, 0, 0, 1, 6
"d:\IDEWORK\lvmen\src\licensedcode\data\rules\gpl-3.0-plus_368.yml", "YAML", 0, 0, 0, 3, 0, 0, 1, 4
"d:\IDEWORK\lvmen\src\licensedcode\data\rules\gpl-3.0-plus_369.yml", "YAML", 0, 0, 0, 3, 0, 0, 1, 4
"d:\IDEWORK\lvmen\src\licensedcode\data\rules\gpl-3.0-plus_37.yml", "YAML", 0, 0, 0, 2, 0, 0, 1, 3
"d:\IDEWORK\lvmen\src\licensedcode\data\rules\gpl-3.0-plus_370.yml", "YAML", 0, 0, 0, 3, 0, 0, 1, 4
"d:\IDEWORK\lvmen\src\licensedcode\data\rules\gpl-3.0-plus_371.yml", "YAML", 0, 0, 0, 3, 0, 0, 1, 4
"d:\IDEWORK\lvmen\src\licensedcode\data\rules\gpl-3.0-plus_372.yml", "YAML", 0, 0, 0, 5, 0, 0, 1, 6
"d:\IDEWORK\lvmen\src\licensedcode\data\rules\gpl-3.0-plus_373.yml", "YAML", 0, 0, 0, 3, 0, 0, 1, 4
"d:\IDEWORK\lvmen\src\licensedcode\data\rules\gpl-3.0-plus_374.yml", "YAML", 0, 0, 0, 2, 0, 0, 1, 3
"d:\IDEWORK\lvmen\src\licensedcode\data\rules\gpl-3.0-plus_375.yml", "YAML", 0, 0, 0, 2, 0, 0, 1, 3
"d:\IDEWORK\lvmen\src\licensedcode\data\rules\gpl-3.0-plus_376.yml", "YAML", 0, 0, 0, 3, 0, 0, 1, 4
"d:\IDEWORK\lvmen\src\licensedcode\data\rules\gpl-3.0-plus_377.yml", "YAML", 0, 0, 0, 3, 0, 0, 1, 4
"d:\IDEWORK\lvmen\src\licensedcode\data\rules\gpl-3.0-plus_378.yml", "YAML", 0, 0, 0, 3, 0, 0, 1, 4
"d:\IDEWORK\lvmen\src\licensedcode\data\rules\gpl-3.0-plus_379.yml", "YAML", 0, 0, 0, 3, 0, 0, 1, 4
"d:\IDEWORK\lvmen\src\licensedcode\data\rules\gpl-3.0-plus_38.yml", "YAML", 0, 0, 0, 3, 0, 0, 1, 4
"d:\IDEWORK\lvmen\src\licensedcode\data\rules\gpl-3.0-plus_380.yml", "YAML", 0, 0, 0, 3, 0, 0, 1, 4
"d:\IDEWORK\lvmen\src\licensedcode\data\rules\gpl-3.0-plus_381.yml", "YAML", 0, 0, 0, 4, 0, 0, 1, 5
"d:\IDEWORK\lvmen\src\licensedcode\data\rules\gpl-3.0-plus_382.yml", "YAML", 0, 0, 0, 4, 0, 0, 1, 5
"d:\IDEWORK\lvmen\src\licensedcode\data\rules\gpl-3.0-plus_383.yml", "YAML", 0, 0, 0, 2, 0, 0, 1, 3
"d:\IDEWORK\lvmen\src\licensedcode\data\rules\gpl-3.0-plus_384.yml", "YAML", 0, 0, 0, 2, 0, 0, 1, 3
"d:\IDEWORK\lvmen\src\licensedcode\data\rules\gpl-3.0-plus_385.yml", "YAML", 0, 0, 0, 6, 0, 0, 1, 7
"d:\IDEWORK\lvmen\src\licensedcode\data\rules\gpl-3.0-plus_386.yml", "YAML", 0, 0, 0, 4, 0, 0, 1, 5
"d:\IDEWORK\lvmen\src\licensedcode\data\rules\gpl-3.0-plus_387.yml", "YAML", 0, 0, 0, 4, 0, 0, 1, 5
"d:\IDEWORK\lvmen\src\licensedcode\data\rules\gpl-3.0-plus_388.yml", "YAML", 0, 0, 0, 5, 0, 0, 1, 6
"d:\IDEWORK\lvmen\src\licensedcode\data\rules\gpl-3.0-plus_389.yml", "YAML", 0, 0, 0, 3, 0, 0, 1, 4
"d:\IDEWORK\lvmen\src\licensedcode\data\rules\gpl-3.0-plus_39.yml", "YAML", 0, 0, 0, 4, 0, 0, 1, 5
"d:\IDEWORK\lvmen\src\licensedcode\data\rules\gpl-3.0-plus_390.yml", "YAML", 0, 0, 0, 3, 0, 0, 1, 4
"d:\IDEWORK\lvmen\src\licensedcode\data\rules\gpl-3.0-plus_391.yml", "YAML", 0, 0, 0, 3, 0, 0, 1, 4
"d:\IDEWORK\lvmen\src\licensedcode\data\rules\gpl-3.0-plus_392.yml", "YAML", 0, 0, 0, 4, 0, 0, 1, 5
"d:\IDEWORK\lvmen\src\licensedcode\data\rules\gpl-3.0-plus_393.yml", "YAML", 0, 0, 0, 3, 0, 0, 1, 4
"d:\IDEWORK\lvmen\src\licensedcode\data\rules\gpl-3.0-plus_394.yml", "YAML", 0, 0, 0, 2, 0, 0, 1, 3
"d:\IDEWORK\lvmen\src\licensedcode\data\rules\gpl-3.0-plus_395.yml", "YAML", 0, 0, 0, 4, 0, 0, 1, 5
"d:\IDEWORK\lvmen\src\licensedcode\data\rules\gpl-3.0-plus_396.yml", "YAML", 0, 0, 0, 4, 0, 0, 1, 5
"d:\IDEWORK\lvmen\src\licensedcode\data\rules\gpl-3.0-plus_397.yml", "YAML", 0, 0, 0, 2, 0, 0, 1, 3
"d:\IDEWORK\lvmen\src\licensedcode\data\rules\gpl-3.0-plus_398.yml", "YAML", 0, 0, 0, 2, 0, 0, 1, 3
"d:\IDEWORK\lvmen\src\licensedcode\data\rules\gpl-3.0-plus_399.yml", "YAML", 0, 0, 0, 6, 0, 0, 1, 7
"d:\IDEWORK\lvmen\src\licensedcode\data\rules\gpl-3.0-plus_4.yml", "YAML", 0, 0, 0, 3, 0, 0, 1, 4
"d:\IDEWORK\lvmen\src\licensedcode\data\rules\gpl-3.0-plus_40.yml", "YAML", 0, 0, 0, 3, 0, 0, 1, 4
"d:\IDEWORK\lvmen\src\licensedcode\data\rules\gpl-3.0-plus_400.yml", "YAML", 0, 0, 0, 5, 0, 0, 1, 6
"d:\IDEWORK\lvmen\src\licensedcode\data\rules\gpl-3.0-plus_401.yml", "YAML", 0, 0, 0, 7, 0, 0, 1, 8
"d:\IDEWORK\lvmen\src\licensedcode\data\rules\gpl-3.0-plus_402.yml", "YAML", 0, 0, 0, 5, 0, 0, 1, 6
"d:\IDEWORK\lvmen\src\licensedcode\data\rules\gpl-3.0-plus_403.yml", "YAML", 0, 0, 0, 5, 0, 0, 1, 6
"d:\IDEWORK\lvmen\src\licensedcode\data\rules\gpl-3.0-plus_404.yml", "YAML", 0, 0, 0, 6, 0, 0, 1, 7
"d:\IDEWORK\lvmen\src\licensedcode\data\rules\gpl-3.0-plus_405.yml", "YAML", 0, 0, 0, 7, 0, 0, 1, 8
"d:\IDEWORK\lvmen\src\licensedcode\data\rules\gpl-3.0-plus_406.yml", "YAML", 0, 0, 0, 3, 0, 0, 1, 4
"d:\IDEWORK\lvmen\src\licensedcode\data\rules\gpl-3.0-plus_407.yml", "YAML", 0, 0, 0, 7, 0, 0, 1, 8
"d:\IDEWORK\lvmen\src\licensedcode\data\rules\gpl-3.0-plus_408.yml", "YAML", 0, 0, 0, 5, 0, 0, 1, 6
"d:\IDEWORK\lvmen\src\licensedcode\data\rules\gpl-3.0-plus_409.yml", "YAML", 0, 0, 0, 5, 0, 0, 1, 6
"d:\IDEWORK\lvmen\src\licensedcode\data\rules\gpl-3.0-plus_41.yml", "YAML", 0, 0, 0, 5, 0, 0, 1, 6
"d:\IDEWORK\lvmen\src\licensedcode\data\rules\gpl-3.0-plus_410.yml", "YAML", 0, 0, 0, 6, 0, 0, 1, 7
"d:\IDEWORK\lvmen\src\licensedcode\data\rules\gpl-3.0-plus_411.yml", "YAML", 0, 0, 0, 7, 0, 0, 1, 8
"d:\IDEWORK\lvmen\src\licensedcode\data\rules\gpl-3.0-plus_412.yml", "YAML", 0, 0, 0, 5, 0, 0, 1, 6
"d:\IDEWORK\lvmen\src\licensedcode\data\rules\gpl-3.0-plus_413.yml", "YAML", 0, 0, 0, 7, 0, 0, 1, 8
"d:\IDEWORK\lvmen\src\licensedcode\data\rules\gpl-3.0-plus_414.yml", "YAML", 0, 0, 0, 7, 0, 0, 1, 8
"d:\IDEWORK\lvmen\src\licensedcode\data\rules\gpl-3.0-plus_415.yml", "YAML", 0, 0, 0, 7, 0, 0, 1, 8
"d:\IDEWORK\lvmen\src\licensedcode\data\rules\gpl-3.0-plus_416.yml", "YAML", 0, 0, 0, 6, 0, 0, 1, 7
"d:\IDEWORK\lvmen\src\licensedcode\data\rules\gpl-3.0-plus_417.yml", "YAML", 0, 0, 0, 6, 0, 0, 1, 7
"d:\IDEWORK\lvmen\src\licensedcode\data\rules\gpl-3.0-plus_418.yml", "YAML", 0, 0, 0, 5, 0, 0, 1, 6
"d:\IDEWORK\lvmen\src\licensedcode\data\rules\gpl-3.0-plus_419.yml", "YAML", 0, 0, 0, 6, 0, 0, 1, 7
"d:\IDEWORK\lvmen\src\licensedcode\data\rules\gpl-3.0-plus_42.yml", "YAML", 0, 0, 0, 4, 0, 0, 1, 5
"d:\IDEWORK\lvmen\src\licensedcode\data\rules\gpl-3.0-plus_420.yml", "YAML", 0, 0, 0, 5, 0, 0, 1, 6
"d:\IDEWORK\lvmen\src\licensedcode\data\rules\gpl-3.0-plus_421.yml", "YAML", 0, 0, 0, 6, 0, 0, 1, 7
"d:\IDEWORK\lvmen\src\licensedcode\data\rules\gpl-3.0-plus_422.yml", "YAML", 0, 0, 0, 5, 0, 0, 1, 6
"d:\IDEWORK\lvmen\src\licensedcode\data\rules\gpl-3.0-plus_423.yml", "YAML", 0, 0, 0, 5, 0, 0, 1, 6
"d:\IDEWORK\lvmen\src\licensedcode\data\rules\gpl-3.0-plus_424.yml", "YAML", 0, 0, 0, 5, 0, 0, 1, 6
"d:\IDEWORK\lvmen\src\licensedcode\data\rules\gpl-3.0-plus_425.yml", "YAML", 0, 0, 0, 5, 0, 0, 1, 6
"d:\IDEWORK\lvmen\src\licensedcode\data\rules\gpl-3.0-plus_426.yml", "YAML", 0, 0, 0, 5, 0, 0, 1, 6
"d:\IDEWORK\lvmen\src\licensedcode\data\rules\gpl-3.0-plus_427.yml", "YAML", 0, 0, 0, 5, 0, 0, 1, 6
"d:\IDEWORK\lvmen\src\licensedcode\data\rules\gpl-3.0-plus_428.yml", "YAML", 0, 0, 0, 5, 0, 0, 1, 6
"d:\IDEWORK\lvmen\src\licensedcode\data\rules\gpl-3.0-plus_429.yml", "YAML", 0, 0, 0, 6, 0, 0, 1, 7
"d:\IDEWORK\lvmen\src\licensedcode\data\rules\gpl-3.0-plus_43.yml", "YAML", 0, 0, 0, 2, 0, 0, 1, 3
"d:\IDEWORK\lvmen\src\licensedcode\data\rules\gpl-3.0-plus_430.yml", "YAML", 0, 0, 0, 5, 0, 0, 1, 6
"d:\IDEWORK\lvmen\src\licensedcode\data\rules\gpl-3.0-plus_431.yml", "YAML", 0, 0, 0, 5, 0, 0, 1, 6
"d:\IDEWORK\lvmen\src\licensedcode\data\rules\gpl-3.0-plus_432.yml", "YAML", 0, 0, 0, 7, 0, 0, 1, 8
"d:\IDEWORK\lvmen\src\licensedcode\data\rules\gpl-3.0-plus_433.yml", "YAML", 0, 0, 0, 7, 0, 0, 1, 8
"d:\IDEWORK\lvmen\src\licensedcode\data\rules\gpl-3.0-plus_434.yml", "YAML", 0, 0, 0, 5, 0, 0, 1, 6
"d:\IDEWORK\lvmen\src\licensedcode\data\rules\gpl-3.0-plus_435.yml", "YAML", 0, 0, 0, 6, 0, 0, 1, 7
"d:\IDEWORK\lvmen\src\licensedcode\data\rules\gpl-3.0-plus_436.yml", "YAML", 0, 0, 0, 6, 0, 0, 1, 7
"d:\IDEWORK\lvmen\src\licensedcode\data\rules\gpl-3.0-plus_437.yml", "YAML", 0, 0, 0, 6, 0, 0, 1, 7
"d:\IDEWORK\lvmen\src\licensedcode\data\rules\gpl-3.0-plus_438.yml", "YAML", 0, 0, 0, 5, 0, 0, 1, 6
"d:\IDEWORK\lvmen\src\licensedcode\data\rules\gpl-3.0-plus_439.yml", "YAML", 0, 0, 0, 5, 0, 0, 1, 6
"d:\IDEWORK\lvmen\src\licensedcode\data\rules\gpl-3.0-plus_44.yml", "YAML", 0, 0, 0, 3, 0, 0, 1, 4
"d:\IDEWORK\lvmen\src\licensedcode\data\rules\gpl-3.0-plus_440.yml", "YAML", 0, 0, 0, 6, 0, 0, 1, 7
"d:\IDEWORK\lvmen\src\licensedcode\data\rules\gpl-3.0-plus_441.yml", "YAML", 0, 0, 0, 5, 0, 0, 1, 6
"d:\IDEWORK\lvmen\src\licensedcode\data\rules\gpl-3.0-plus_442.yml", "YAML", 0, 0, 0, 6, 0, 0, 1, 7
"d:\IDEWORK\lvmen\src\licensedcode\data\rules\gpl-3.0-plus_443.yml", "YAML", 0, 0, 0, 5, 0, 0, 1, 6
"d:\IDEWORK\lvmen\src\licensedcode\data\rules\gpl-3.0-plus_444.yml", "YAML", 0, 0, 0, 5, 0, 0, 1, 6
"d:\IDEWORK\lvmen\src\licensedcode\data\rules\gpl-3.0-plus_445.yml", "YAML", 0, 0, 0, 6, 0, 0, 1, 7
"d:\IDEWORK\lvmen\src\licensedcode\data\rules\gpl-3.0-plus_446.yml", "YAML", 0, 0, 0, 5, 0, 0, 1, 6
"d:\IDEWORK\lvmen\src\licensedcode\data\rules\gpl-3.0-plus_447.yml", "YAML", 0, 0, 0, 5, 0, 0, 1, 6
"d:\IDEWORK\lvmen\src\licensedcode\data\rules\gpl-3.0-plus_448.yml", "YAML", 0, 0, 0, 8, 0, 0, 1, 9
"d:\IDEWORK\lvmen\src\licensedcode\data\rules\gpl-3.0-plus_449.yml", "YAML", 0, 0, 0, 5, 0, 0, 1, 6
"d:\IDEWORK\lvmen\src\licensedcode\data\rules\gpl-3.0-plus_45.yml", "YAML", 0, 0, 0, 6, 0, 0, 1, 7
"d:\IDEWORK\lvmen\src\licensedcode\data\rules\gpl-3.0-plus_450.yml", "YAML", 0, 0, 0, 7, 0, 0, 1, 8
"d:\IDEWORK\lvmen\src\licensedcode\data\rules\gpl-3.0-plus_451.yml", "YAML", 0, 0, 0, 6, 0, 0, 1, 7
"d:\IDEWORK\lvmen\src\licensedcode\data\rules\gpl-3.0-plus_452.yml", "YAML", 0, 0, 0, 5, 0, 0, 1, 6
"d:\IDEWORK\lvmen\src\licensedcode\data\rules\gpl-3.0-plus_453.yml", "YAML", 0, 0, 0, 7, 0, 0, 1, 8
"d:\IDEWORK\lvmen\src\licensedcode\data\rules\gpl-3.0-plus_454.yml", "YAML", 0, 0, 0, 8, 0, 0, 1, 9
"d:\IDEWORK\lvmen\src\licensedcode\data\rules\gpl-3.0-plus_455.yml", "YAML", 0, 0, 0, 5, 0, 0, 1, 6
"d:\IDEWORK\lvmen\src\licensedcode\data\rules\gpl-3.0-plus_456.yml", "YAML", 0, 0, 0, 5, 0, 0, 1, 6
"d:\IDEWORK\lvmen\src\licensedcode\data\rules\gpl-3.0-plus_457.yml", "YAML", 0, 0, 0, 5, 0, 0, 1, 6
"d:\IDEWORK\lvmen\src\licensedcode\data\rules\gpl-3.0-plus_458.yml", "YAML", 0, 0, 0, 6, 0, 0, 1, 7
"d:\IDEWORK\lvmen\src\licensedcode\data\rules\gpl-3.0-plus_459.yml", "YAML", 0, 0, 0, 5, 0, 0, 1, 6
"d:\IDEWORK\lvmen\src\licensedcode\data\rules\gpl-3.0-plus_46.yml", "YAML", 0, 0, 0, 3, 0, 0, 1, 4
"d:\IDEWORK\lvmen\src\licensedcode\data\rules\gpl-3.0-plus_460.yml", "YAML", 0, 0, 0, 5, 0, 0, 1, 6
"d:\IDEWORK\lvmen\src\licensedcode\data\rules\gpl-3.0-plus_461.yml", "YAML", 0, 0, 0, 8, 0, 0, 1, 9
"d:\IDEWORK\lvmen\src\licensedcode\data\rules\gpl-3.0-plus_462.yml", "YAML", 0, 0, 0, 5, 0, 0, 1, 6
"d:\IDEWORK\lvmen\src\licensedcode\data\rules\gpl-3.0-plus_463.yml", "YAML", 0, 0, 0, 5, 0, 0, 1, 6
"d:\IDEWORK\lvmen\src\licensedcode\data\rules\gpl-3.0-plus_464.yml", "YAML", 0, 0, 0, 5, 0, 0, 1, 6
"d:\IDEWORK\lvmen\src\licensedcode\data\rules\gpl-3.0-plus_465.yml", "YAML", 0, 0, 0, 6, 0, 0, 1, 7
"d:\IDEWORK\lvmen\src\licensedcode\data\rules\gpl-3.0-plus_466.yml", "YAML", 0, 0, 0, 5, 0, 0, 1, 6
"d:\IDEWORK\lvmen\src\licensedcode\data\rules\gpl-3.0-plus_467.yml", "YAML", 0, 0, 0, 5, 0, 0, 1, 6
"d:\IDEWORK\lvmen\src\licensedcode\data\rules\gpl-3.0-plus_468.yml", "YAML", 0, 0, 0, 6, 0, 0, 1, 7
"d:\IDEWORK\lvmen\src\licensedcode\data\rules\gpl-3.0-plus_469.yml", "YAML", 0, 0, 0, 5, 0, 0, 1, 6
"d:\IDEWORK\lvmen\src\licensedcode\data\rules\gpl-3.0-plus_47.yml", "YAML", 0, 0, 0, 2, 0, 0, 1, 3
"d:\IDEWORK\lvmen\src\licensedcode\data\rules\gpl-3.0-plus_470.yml", "YAML", 0, 0, 0, 7, 0, 0, 1, 8
"d:\IDEWORK\lvmen\src\licensedcode\data\rules\gpl-3.0-plus_471.yml", "YAML", 0, 0, 0, 5, 0, 0, 1, 6
"d:\IDEWORK\lvmen\src\licensedcode\data\rules\gpl-3.0-plus_472.yml", "YAML", 0, 0, 0, 6, 0, 0, 1, 7
"d:\IDEWORK\lvmen\src\licensedcode\data\rules\gpl-3.0-plus_473.yml", "YAML", 0, 0, 0, 7, 0, 0, 1, 8
"d:\IDEWORK\lvmen\src\licensedcode\data\rules\gpl-3.0-plus_474.yml", "YAML", 0, 0, 0, 6, 0, 0, 1, 7
"d:\IDEWORK\lvmen\src\licensedcode\data\rules\gpl-3.0-plus_475.yml", "YAML", 0, 0, 0, 5, 0, 0, 1, 6
"d:\IDEWORK\lvmen\src\licensedcode\data\rules\gpl-3.0-plus_476.yml", "YAML", 0, 0, 0, 6, 0, 0, 1, 7
"d:\IDEWORK\lvmen\src\licensedcode\data\rules\gpl-3.0-plus_477.yml", "YAML", 0, 0, 0, 5, 0, 0, 1, 6
"d:\IDEWORK\lvmen\src\licensedcode\data\rules\gpl-3.0-plus_478.yml", "YAML", 0, 0, 0, 7, 0, 0, 1, 8
"d:\IDEWORK\lvmen\src\licensedcode\data\rules\gpl-3.0-plus_479.yml", "YAML", 0, 0, 0, 4, 0, 0, 1, 5
"d:\IDEWORK\lvmen\src\licensedcode\data\rules\gpl-3.0-plus_48.yml", "YAML", 0, 0, 0, 2, 0, 0, 1, 3
"d:\IDEWORK\lvmen\src\licensedcode\data\rules\gpl-3.0-plus_480.yml", "YAML", 0, 0, 0, 6, 0, 0, 1, 7
"d:\IDEWORK\lvmen\src\licensedcode\data\rules\gpl-3.0-plus_481.yml", "YAML", 0, 0, 0, 4, 0, 0, 1, 5
"d:\IDEWORK\lvmen\src\licensedcode\data\rules\gpl-3.0-plus_482.yml", "YAML", 0, 0, 0, 6, 0, 0, 1, 7
"d:\IDEWORK\lvmen\src\licensedcode\data\rules\gpl-3.0-plus_483.yml", "YAML", 0, 0, 0, 7, 0, 0, 1, 8
"d:\IDEWORK\lvmen\src\licensedcode\data\rules\gpl-3.0-plus_484.yml", "YAML", 0, 0, 0, 6, 0, 0, 1, 7
"d:\IDEWORK\lvmen\src\licensedcode\data\rules\gpl-3.0-plus_485.yml", "YAML", 0, 0, 0, 6, 0, 0, 1, 7
"d:\IDEWORK\lvmen\src\licensedcode\data\rules\gpl-3.0-plus_486.yml", "YAML", 0, 0, 0, 7, 0, 0, 1, 8
"d:\IDEWORK\lvmen\src\licensedcode\data\rules\gpl-3.0-plus_487.yml", "YAML", 0, 0, 0, 5, 0, 0, 1, 6
"d:\IDEWORK\lvmen\src\licensedcode\data\rules\gpl-3.0-plus_488.yml", "YAML", 0, 0, 0, 7, 0, 0, 1, 8
"d:\IDEWORK\lvmen\src\licensedcode\data\rules\gpl-3.0-plus_489.yml", "YAML", 0, 0, 0, 3, 0, 0, 1, 4
"d:\IDEWORK\lvmen\src\licensedcode\data\rules\gpl-3.0-plus_49.yml", "YAML", 0, 0, 0, 7, 0, 0, 1, 8
"d:\IDEWORK\lvmen\src\licensedcode\data\rules\gpl-3.0-plus_490.yml", "YAML", 0, 0, 0, 6, 0, 0, 1, 7
"d:\IDEWORK\lvmen\src\licensedcode\data\rules\gpl-3.0-plus_491.yml", "YAML", 0, 0, 0, 5, 0, 0, 1, 6
"d:\IDEWORK\lvmen\src\licensedcode\data\rules\gpl-3.0-plus_492.yml", "YAML", 0, 0, 0, 5, 0, 0, 1, 6
"d:\IDEWORK\lvmen\src\licensedcode\data\rules\gpl-3.0-plus_493.yml", "YAML", 0, 0, 0, 7, 0, 0, 1, 8
"d:\IDEWORK\lvmen\src\licensedcode\data\rules\gpl-3.0-plus_494.yml", "YAML", 0, 0, 0, 6, 0, 0, 1, 7
"d:\IDEWORK\lvmen\src\licensedcode\data\rules\gpl-3.0-plus_495.yml", "YAML", 0, 0, 0, 6, 0, 0, 1, 7
"d:\IDEWORK\lvmen\src\licensedcode\data\rules\gpl-3.0-plus_496.yml", "YAML", 0, 0, 0, 7, 0, 0, 1, 8
"d:\IDEWORK\lvmen\src\licensedcode\data\rules\gpl-3.0-plus_497.yml", "YAML", 0, 0, 0, 5, 0, 0, 1, 6
"d:\IDEWORK\lvmen\src\licensedcode\data\rules\gpl-3.0-plus_498.yml", "YAML", 0, 0, 0, 5, 0, 0, 1, 6
"d:\IDEWORK\lvmen\src\licensedcode\data\rules\gpl-3.0-plus_499.yml", "YAML", 0, 0, 0, 7, 0, 0, 1, 8
"d:\IDEWORK\lvmen\src\licensedcode\data\rules\gpl-3.0-plus_5.yml", "YAML", 0, 0, 0, 3, 0, 0, 1, 4
"d:\IDEWORK\lvmen\src\licensedcode\data\rules\gpl-3.0-plus_50.yml", "YAML", 0, 0, 0, 5, 0, 0, 1, 6
"d:\IDEWORK\lvmen\src\licensedcode\data\rules\gpl-3.0-plus_500.yml", "YAML", 0, 0, 0, 7, 0, 0, 1, 8
"d:\IDEWORK\lvmen\src\licensedcode\data\rules\gpl-3.0-plus_501.yml", "YAML", 0, 0, 0, 7, 0, 0, 1, 8
"d:\IDEWORK\lvmen\src\licensedcode\data\rules\gpl-3.0-plus_502.yml", "YAML", 0, 0, 0, 7, 0, 0, 1, 8
"d:\IDEWORK\lvmen\src\licensedcode\data\rules\gpl-3.0-plus_503.yml", "YAML", 0, 0, 0, 5, 0, 0, 1, 6
"d:\IDEWORK\lvmen\src\licensedcode\data\rules\gpl-3.0-plus_504.yml", "YAML", 0, 0, 0, 7, 0, 0, 1, 8
"d:\IDEWORK\lvmen\src\licensedcode\data\rules\gpl-3.0-plus_505.yml", "YAML", 0, 0, 0, 7, 0, 0, 1, 8
"d:\IDEWORK\lvmen\src\licensedcode\data\rules\gpl-3.0-plus_506.yml", "YAML", 0, 0, 0, 7, 0, 0, 1, 8
"d:\IDEWORK\lvmen\src\licensedcode\data\rules\gpl-3.0-plus_507.yml", "YAML", 0, 0, 0, 7, 0, 0, 1, 8
"d:\IDEWORK\lvmen\src\licensedcode\data\rules\gpl-3.0-plus_508.yml", "YAML", 0, 0, 0, 4, 0, 0, 1, 5
"d:\IDEWORK\lvmen\src\licensedcode\data\rules\gpl-3.0-plus_509.yml", "YAML", 0, 0, 0, 4, 0, 0, 1, 5
"d:\IDEWORK\lvmen\src\licensedcode\data\rules\gpl-3.0-plus_51.yml", "YAML", 0, 0, 0, 2, 0, 0, 1, 3
"d:\IDEWORK\lvmen\src\licensedcode\data\rules\gpl-3.0-plus_510.yml", "YAML", 0, 0, 0, 2, 0, 0, 1, 3
"d:\IDEWORK\lvmen\src\licensedcode\data\rules\gpl-3.0-plus_511.yml", "YAML", 0, 0, 0, 4, 0, 0, 1, 5
"d:\IDEWORK\lvmen\src\licensedcode\data\rules\gpl-3.0-plus_512.yml", "YAML", 0, 0, 0, 4, 0, 0, 1, 5
"d:\IDEWORK\lvmen\src\licensedcode\data\rules\gpl-3.0-plus_513.yml", "YAML", 0, 0, 0, 11, 0, 0, 1, 12
"d:\IDEWORK\lvmen\src\licensedcode\data\rules\gpl-3.0-plus_514.yml", "YAML", 0, 0, 0, 3, 0, 0, 1, 4
"d:\IDEWORK\lvmen\src\licensedcode\data\rules\gpl-3.0-plus_52.yml", "YAML", 0, 0, 0, 3, 0, 0, 1, 4
"d:\IDEWORK\lvmen\src\licensedcode\data\rules\gpl-3.0-plus_53.yml", "YAML", 0, 0, 0, 6, 0, 0, 1, 7
"d:\IDEWORK\lvmen\src\licensedcode\data\rules\gpl-3.0-plus_54.yml", "YAML", 0, 0, 0, 5, 0, 0, 1, 6
"d:\IDEWORK\lvmen\src\licensedcode\data\rules\gpl-3.0-plus_55.yml", "YAML", 0, 0, 0, 5, 0, 0, 1, 6
"d:\IDEWORK\lvmen\src\licensedcode\data\rules\gpl-3.0-plus_56.yml", "YAML", 0, 0, 0, 6, 0, 0, 2, 8
"d:\IDEWORK\lvmen\src\licensedcode\data\rules\gpl-3.0-plus_57.yml", "YAML", 0, 0, 0, 5, 0, 0, 1, 6
"d:\IDEWORK\lvmen\src\licensedcode\data\rules\gpl-3.0-plus_58.yml", "YAML", 0, 0, 0, 4, 0, 0, 1, 5
"d:\IDEWORK\lvmen\src\licensedcode\data\rules\gpl-3.0-plus_59.yml", "YAML", 0, 0, 0, 2, 0, 0, 1, 3
"d:\IDEWORK\lvmen\src\licensedcode\data\rules\gpl-3.0-plus_6.yml", "YAML", 0, 0, 0, 7, 0, 0, 1, 8
"d:\IDEWORK\lvmen\src\licensedcode\data\rules\gpl-3.0-plus_60.yml", "YAML", 0, 0, 0, 4, 0, 0, 1, 5
"d:\IDEWORK\lvmen\src\licensedcode\data\rules\gpl-3.0-plus_61.yml", "YAML", 0, 0, 0, 4, 0, 0, 1, 5
"d:\IDEWORK\lvmen\src\licensedcode\data\rules\gpl-3.0-plus_62.yml", "YAML", 0, 0, 0, 4, 0, 0, 1, 5
"d:\IDEWORK\lvmen\src\licensedcode\data\rules\gpl-3.0-plus_63.yml", "YAML", 0, 0, 0, 6, 0, 0, 1, 7
"d:\IDEWORK\lvmen\src\licensedcode\data\rules\gpl-3.0-plus_64.yml", "YAML", 0, 0, 0, 4, 0, 0, 1, 5
"d:\IDEWORK\lvmen\src\licensedcode\data\rules\gpl-3.0-plus_65.yml", "YAML", 0, 0, 0, 4, 0, 0, 1, 5
"d:\IDEWORK\lvmen\src\licensedcode\data\rules\gpl-3.0-plus_66.yml", "YAML", 0, 0, 0, 4, 0, 0, 1, 5
"d:\IDEWORK\lvmen\src\licensedcode\data\rules\gpl-3.0-plus_67.yml", "YAML", 0, 0, 0, 4, 0, 0, 1, 5
"d:\IDEWORK\lvmen\src\licensedcode\data\rules\gpl-3.0-plus_68.yml", "YAML", 0, 0, 0, 3, 0, 0, 1, 4
"d:\IDEWORK\lvmen\src\licensedcode\data\rules\gpl-3.0-plus_69.yml", "YAML", 0, 0, 0, 3, 0, 0, 1, 4
"d:\IDEWORK\lvmen\src\licensedcode\data\rules\gpl-3.0-plus_7.yml", "YAML", 0, 0, 0, 3, 0, 0, 1, 4
"d:\IDEWORK\lvmen\src\licensedcode\data\rules\gpl-3.0-plus_70.yml", "YAML", 0, 0, 0, 4, 0, 0, 1, 5
"d:\IDEWORK\lvmen\src\licensedcode\data\rules\gpl-3.0-plus_71.yml", "YAML", 0, 0, 0, 4, 0, 0, 1, 5
"d:\IDEWORK\lvmen\src\licensedcode\data\rules\gpl-3.0-plus_72.yml", "YAML", 0, 0, 0, 4, 0, 0, 1, 5
"d:\IDEWORK\lvmen\src\licensedcode\data\rules\gpl-3.0-plus_73.yml", "YAML", 0, 0, 0, 4, 0, 0, 1, 5
"d:\IDEWORK\lvmen\src\licensedcode\data\rules\gpl-3.0-plus_74.yml", "YAML", 0, 0, 0, 3, 0, 0, 1, 4
"d:\IDEWORK\lvmen\src\licensedcode\data\rules\gpl-3.0-plus_75.yml", "YAML", 0, 0, 0, 4, 0, 0, 1, 5
"d:\IDEWORK\lvmen\src\licensedcode\data\rules\gpl-3.0-plus_76.yml", "YAML", 0, 0, 0, 3, 0, 0, 1, 4
"d:\IDEWORK\lvmen\src\licensedcode\data\rules\gpl-3.0-plus_77.yml", "YAML", 0, 0, 0, 3, 0, 0, 1, 4
"d:\IDEWORK\lvmen\src\licensedcode\data\rules\gpl-3.0-plus_78.yml", "YAML", 0, 0, 0, 3, 0, 0, 1, 4
"d:\IDEWORK\lvmen\src\licensedcode\data\rules\gpl-3.0-plus_79.yml", "YAML", 0, 0, 0, 4, 0, 0, 1, 5
"d:\IDEWORK\lvmen\src\licensedcode\data\rules\gpl-3.0-plus_8.yml", "YAML", 0, 0, 0, 4, 0, 0, 1, 5
"d:\IDEWORK\lvmen\src\licensedcode\data\rules\gpl-3.0-plus_80.yml", "YAML", 0, 0, 0, 3, 0, 0, 1, 4
"d:\IDEWORK\lvmen\src\licensedcode\data\rules\gpl-3.0-plus_81.yml", "YAML", 0, 0, 0, 5, 0, 0, 1, 6
"d:\IDEWORK\lvmen\src\licensedcode\data\rules\gpl-3.0-plus_82.yml", "YAML", 0, 0, 0, 5, 0, 0, 1, 6
"d:\IDEWORK\lvmen\src\licensedcode\data\rules\gpl-3.0-plus_83.yml", "YAML", 0, 0, 0, 5, 0, 0, 1, 6
"d:\IDEWORK\lvmen\src\licensedcode\data\rules\gpl-3.0-plus_84.yml", "YAML", 0, 0, 0, 5, 0, 0, 1, 6
"d:\IDEWORK\lvmen\src\licensedcode\data\rules\gpl-3.0-plus_85.yml", "YAML", 0, 0, 0, 4, 0, 0, 1, 5
"d:\IDEWORK\lvmen\src\licensedcode\data\rules\gpl-3.0-plus_86.yml", "YAML", 0, 0, 0, 5, 0, 0, 1, 6
"d:\IDEWORK\lvmen\src\licensedcode\data\rules\gpl-3.0-plus_87.yml", "YAML", 0, 0, 0, 3, 0, 0, 1, 4
"d:\IDEWORK\lvmen\src\licensedcode\data\rules\gpl-3.0-plus_88.yml", "YAML", 0, 0, 0, 5, 0, 0, 1, 6
"d:\IDEWORK\lvmen\src\licensedcode\data\rules\gpl-3.0-plus_89.yml", "YAML", 0, 0, 0, 3, 0, 0, 1, 4
"d:\IDEWORK\lvmen\src\licensedcode\data\rules\gpl-3.0-plus_9.yml", "YAML", 0, 0, 0, 3, 0, 0, 2, 5
"d:\IDEWORK\lvmen\src\licensedcode\data\rules\gpl-3.0-plus_90.yml", "YAML", 0, 0, 0, 3, 0, 0, 1, 4
"d:\IDEWORK\lvmen\src\licensedcode\data\rules\gpl-3.0-plus_91.yml", "YAML", 0, 0, 0, 4, 0, 0, 1, 5
"d:\IDEWORK\lvmen\src\licensedcode\data\rules\gpl-3.0-plus_92.yml", "YAML", 0, 0, 0, 3, 0, 0, 1, 4
"d:\IDEWORK\lvmen\src\licensedcode\data\rules\gpl-3.0-plus_93.yml", "YAML", 0, 0, 0, 3, 0, 0, 1, 4
"d:\IDEWORK\lvmen\src\licensedcode\data\rules\gpl-3.0-plus_94.yml", "YAML", 0, 0, 0, 4, 0, 0, 1, 5
"d:\IDEWORK\lvmen\src\licensedcode\data\rules\gpl-3.0-plus_95.yml", "YAML", 0, 0, 0, 2, 0, 0, 1, 3
"d:\IDEWORK\lvmen\src\licensedcode\data\rules\gpl-3.0-plus_96.yml", "YAML", 0, 0, 0, 2, 0, 0, 1, 3
"d:\IDEWORK\lvmen\src\licensedcode\data\rules\gpl-3.0-plus_97.yml", "YAML", 0, 0, 0, 4, 0, 0, 1, 5
"d:\IDEWORK\lvmen\src\licensedcode\data\rules\gpl-3.0-plus_98.yml", "YAML", 0, 0, 0, 2, 0, 0, 1, 3
"d:\IDEWORK\lvmen\src\licensedcode\data\rules\gpl-3.0-plus_99.yml", "YAML", 0, 0, 0, 4, 0, 0, 1, 5
"d:\IDEWORK\lvmen\src\licensedcode\data\rules\gpl-3.0-plus_and_cygwin-exception-3.0_1.yml", "YAML", 0, 0, 0, 5, 0, 0, 1, 6
"d:\IDEWORK\lvmen\src\licensedcode\data\rules\gpl-3.0-plus_and_cygwin-exception-3.0_2.yml", "YAML", 0, 0, 0, 6, 0, 0, 1, 7
"d:\IDEWORK\lvmen\src\licensedcode\data\rules\gpl-3.0-plus_and_cygwin-exception-3.0_3.yml", "YAML", 0, 0, 0, 5, 0, 0, 1, 6
"d:\IDEWORK\lvmen\src\licensedcode\data\rules\gpl-3.0-plus_and_gpl-2.0-plus__and_mit_1.yml", "YAML", 0, 0, 0, 3, 0, 0, 1, 4
"d:\IDEWORK\lvmen\src\licensedcode\data\rules\gpl-3.0-plus_and_gpl-3.0-gcc.yml", "YAML", 0, 0, 0, 7, 0, 0, 1, 8
"d:\IDEWORK\lvmen\src\licensedcode\data\rules\gpl-3.0-plus_and_gpl-3.0-gcc_2.yml", "YAML", 0, 0, 0, 7, 0, 0, 1, 8
"d:\IDEWORK\lvmen\src\licensedcode\data\rules\gpl-3.0-plus_and_lgpl-3.0-plus_1.yml", "YAML", 0, 0, 0, 5, 0, 0, 1, 6
"d:\IDEWORK\lvmen\src\licensedcode\data\rules\gpl-3.0-plus_and_lgpl-3.0-plus_2.yml", "YAML", 0, 0, 0, 8, 0, 0, 1, 9
"d:\IDEWORK\lvmen\src\licensedcode\data\rules\gpl-3.0-plus_and_lgpl-3.0-plus_3.yml", "YAML", 0, 0, 0, 6, 0, 0, 1, 7
"d:\IDEWORK\lvmen\src\licensedcode\data\rules\gpl-3.0-plus_and_other-copyleft_1.yml", "YAML", 0, 0, 0, 4, 0, 0, 1, 5
"d:\IDEWORK\lvmen\src\licensedcode\data\rules\gpl-3.0-plus_and_other-permissive_1.yml", "YAML", 0, 0, 0, 3, 0, 0, 1, 4
"d:\IDEWORK\lvmen\src\licensedcode\data\rules\gpl-3.0-plus_and_other-permissive_2.yml", "YAML", 0, 0, 0, 3, 0, 0, 1, 4
"d:\IDEWORK\lvmen\src\licensedcode\data\rules\gpl-3.0-plus_and_other-permissive_3.yml", "YAML", 0, 0, 0, 3, 0, 0, 1, 4
"d:\IDEWORK\lvmen\src\licensedcode\data\rules\gpl-3.0-plus_and_proprietary-license_1.yml", "YAML", 0, 0, 0, 3, 0, 0, 1, 4
"d:\IDEWORK\lvmen\src\licensedcode\data\rules\gpl-3.0-plus_and_proprietary-license_2.yml", "YAML", 0, 0, 0, 5, 0, 0, 1, 6
"d:\IDEWORK\lvmen\src\licensedcode\data\rules\gpl-3.0-plus_and_proprietary-license_3.yml", "YAML", 0, 0, 0, 5, 0, 0, 1, 6
"d:\IDEWORK\lvmen\src\licensedcode\data\rules\gpl-3.0-plus_and_swig.yml", "YAML", 0, 0, 0, 2, 0, 0, 1, 3
"d:\IDEWORK\lvmen\src\licensedcode\data\rules\gpl-3.0-plus_available.yml", "YAML", 0, 0, 0, 3, 0, 0, 1, 4
"d:\IDEWORK\lvmen\src\licensedcode\data\rules\gpl-3.0-plus_dist.yml", "YAML", 0, 0, 0, 3, 0, 0, 1, 4
"d:\IDEWORK\lvmen\src\licensedcode\data\rules\gpl-3.0-plus_docutils.yml", "YAML", 0, 0, 0, 2, 0, 0, 1, 3
"d:\IDEWORK\lvmen\src\licensedcode\data\rules\gpl-3.0-plus_fr.yml", "YAML", 0, 0, 0, 5, 0, 0, 1, 6
"d:\IDEWORK\lvmen\src\licensedcode\data\rules\gpl-3.0-plus_fr2.yml", "YAML", 0, 0, 0, 4, 0, 0, 1, 5
"d:\IDEWORK\lvmen\src\licensedcode\data\rules\gpl-3.0-plus_fsfe.yml", "YAML", 0, 0, 0, 3, 0, 0, 1, 4
"d:\IDEWORK\lvmen\src\licensedcode\data\rules\gpl-3.0-plus_licenced.yml", "YAML", 0, 0, 0, 3, 0, 0, 1, 4
"d:\IDEWORK\lvmen\src\licensedcode\data\rules\gpl-3.0-plus_notice_2.yml", "YAML", 0, 0, 0, 3, 0, 0, 1, 4
"d:\IDEWORK\lvmen\src\licensedcode\data\rules\gpl-3.0-plus_notice_3.yml", "YAML", 0, 0, 0, 3, 0, 0, 1, 4
"d:\IDEWORK\lvmen\src\licensedcode\data\rules\gpl-3.0-plus_notice_4.yml", "YAML", 0, 0, 0, 3, 0, 0, 1, 4
"d:\IDEWORK\lvmen\src\licensedcode\data\rules\gpl-3.0-plus_or_bsd-simplified_1.yml", "YAML", 0, 0, 0, 7, 0, 0, 1, 8
"d:\IDEWORK\lvmen\src\licensedcode\data\rules\gpl-3.0-plus_or_bsd-simplified_2.yml", "YAML", 0, 0, 0, 6, 0, 0, 1, 7
"d:\IDEWORK\lvmen\src\licensedcode\data\rules\gpl-3.0-plus_or_bsd-simplified_3.yml", "YAML", 0, 0, 0, 6, 0, 0, 1, 7
"d:\IDEWORK\lvmen\src\licensedcode\data\rules\gpl-3.0-plus_or_bsd-simplified_4.yml", "YAML", 0, 0, 0, 6, 0, 0, 1, 7
"d:\IDEWORK\lvmen\src\licensedcode\data\rules\gpl-3.0-plus_or_bsd-simplified_5.yml", "YAML", 0, 0, 0, 6, 0, 0, 1, 7
"d:\IDEWORK\lvmen\src\licensedcode\data\rules\gpl-3.0-plus_or_bsd-simplified_6.yml", "YAML", 0, 0, 0, 3, 0, 0, 1, 4
"d:\IDEWORK\lvmen\src\licensedcode\data\rules\gpl-3.0-plus_or_bsd-simplified_7.yml", "YAML", 0, 0, 0, 3, 0, 0, 1, 4
"d:\IDEWORK\lvmen\src\licensedcode\data\rules\gpl-3.0-plus_or_cc-by-sa-3.0_or_cc-by-sa-4.0_1.yml", "YAML", 0, 0, 0, 4, 0, 0, 1, 5
"d:\IDEWORK\lvmen\src\licensedcode\data\rules\gpl-3.0-plus_or_cc-by-sa-3.0_or_cc-by-sa-4.0_2.yml", "YAML", 0, 0, 0, 6, 0, 0, 1, 7
"d:\IDEWORK\lvmen\src\licensedcode\data\rules\gpl-3.0-plus_or_commercial-license_1.yml", "YAML", 0, 0, 0, 3, 0, 0, 1, 4
"d:\IDEWORK\lvmen\src\licensedcode\data\rules\gpl-3.0-plus_or_commercial-license_2.yml", "YAML", 0, 0, 0, 5, 0, 0, 1, 6
"d:\IDEWORK\lvmen\src\licensedcode\data\rules\gpl-3.0-plus_or_commercial-option_1.yml", "YAML", 0, 0, 0, 4, 0, 0, 1, 5
"d:\IDEWORK\lvmen\src\licensedcode\data\rules\gpl-3.0-plus_or_commercial-option_2.yml", "YAML", 0, 0, 0, 2, 0, 0, 1, 3
"d:\IDEWORK\lvmen\src\licensedcode\data\rules\gpl-3.0-plus_or_lgpl-3.0-plus_libreoffice.yml", "YAML", 0, 0, 0, 3, 0, 0, 1, 4
"d:\IDEWORK\lvmen\src\licensedcode\data\rules\gpl-3.0-plus_or_mit.yml", "YAML", 0, 0, 0, 3, 0, 0, 1, 4
"d:\IDEWORK\lvmen\src\licensedcode\data\rules\gpl-3.0-plus_or_mit2.yml", "YAML", 0, 0, 0, 3, 0, 0, 1, 4
"d:\IDEWORK\lvmen\src\licensedcode\data\rules\gpl-3.0-plus_or_mit3.yml", "YAML", 0, 0, 0, 5, 0, 0, 1, 6
"d:\IDEWORK\lvmen\src\licensedcode\data\rules\gpl-3.0-plus_or_mit4.yml", "YAML", 0, 0, 0, 5, 0, 0, 1, 6
"d:\IDEWORK\lvmen\src\licensedcode\data\rules\gpl-3.0-plus_or_mit5.yml", "YAML", 0, 0, 0, 4, 0, 0, 1, 5
"d:\IDEWORK\lvmen\src\licensedcode\data\rules\gpl-3.0-plus_or_mit6.yml", "YAML", 0, 0, 0, 3, 0, 0, 1, 4
"d:\IDEWORK\lvmen\src\licensedcode\data\rules\gpl-3.0-plus_or_mit_1.yml", "YAML", 0, 0, 0, 6, 0, 0, 1, 7
"d:\IDEWORK\lvmen\src\licensedcode\data\rules\gpl-3.0-plus_or_mit_10.yml", "YAML", 0, 0, 0, 6, 0, 0, 1, 7
"d:\IDEWORK\lvmen\src\licensedcode\data\rules\gpl-3.0-plus_or_mit_11.yml", "YAML", 0, 0, 0, 5, 0, 0, 1, 6
"d:\IDEWORK\lvmen\src\licensedcode\data\rules\gpl-3.0-plus_or_mit_2.yml", "YAML", 0, 0, 0, 3, 0, 0, 1, 4
"d:\IDEWORK\lvmen\src\licensedcode\data\rules\gpl-3.0-plus_or_mit_3.yml", "YAML", 0, 0, 0, 3, 0, 0, 1, 4
"d:\IDEWORK\lvmen\src\licensedcode\data\rules\gpl-3.0-plus_or_mit_4.yml", "YAML", 0, 0, 0, 3, 0, 0, 1, 4
"d:\IDEWORK\lvmen\src\licensedcode\data\rules\gpl-3.0-plus_or_mit_5.yml", "YAML", 0, 0, 0, 3, 0, 0, 1, 4
"d:\IDEWORK\lvmen\src\licensedcode\data\rules\gpl-3.0-plus_or_mit_6.yml", "YAML", 0, 0, 0, 5, 0, 0, 1, 6
"d:\IDEWORK\lvmen\src\licensedcode\data\rules\gpl-3.0-plus_or_mit_7.yml", "YAML", 0, 0, 0, 3, 0, 0, 1, 4
"d:\IDEWORK\lvmen\src\licensedcode\data\rules\gpl-3.0-plus_or_mit_8.yml", "YAML", 0, 0, 0, 6, 0, 0, 1, 7
"d:\IDEWORK\lvmen\src\licensedcode\data\rules\gpl-3.0-plus_or_mit_9.yml", "YAML", 0, 0, 0, 5, 0, 0, 1, 6
"d:\IDEWORK\lvmen\src\licensedcode\data\rules\gpl-3.0-plus_pychess.yml", "YAML", 0, 0, 0, 3, 0, 0, 1, 4
"d:\IDEWORK\lvmen\src\licensedcode\data\rules\gpl-3.0-plus_readme.yml", "YAML", 0, 0, 0, 6, 0, 0, 1, 7
"d:\IDEWORK\lvmen\src\licensedcode\data\rules\gpl-3.0-plus_readme2.yml", "YAML", 0, 0, 0, 2, 0, 0, 1, 3
"d:\IDEWORK\lvmen\src\licensedcode\data\rules\gpl-3.0-plus_tag_1.yml", "YAML", 0, 0, 0, 3, 0, 0, 1, 4
"d:\IDEWORK\lvmen\src\licensedcode\data\rules\gpl-3.0-plus_tag_2.yml", "YAML", 0, 0, 0, 3, 0, 0, 1, 4
"d:\IDEWORK\lvmen\src\licensedcode\data\rules\gpl-3.0-plus_tag_3.yml", "YAML", 0, 0, 0, 3, 0, 0, 1, 4
"d:\IDEWORK\lvmen\src\licensedcode\data\rules\gpl-3.0-plus_url_1.yml", "YAML", 0, 0, 0, 5, 0, 0, 1, 6
"d:\IDEWORK\lvmen\src\licensedcode\data\rules\gpl-3.0-plus_url_2.yml", "YAML", 0, 0, 0, 5, 0, 0, 1, 6
"d:\IDEWORK\lvmen\src\licensedcode\data\rules\gpl-3.0-plus_with_autoconf-exception-2.0_1.yml", "YAML", 0, 0, 0, 3, 0, 0, 1, 4
"d:\IDEWORK\lvmen\src\licensedcode\data\rules\gpl-3.0-plus_with_autoconf-exception-2.0_2.yml", "YAML", 0, 0, 0, 6, 0, 0, 1, 7
"d:\IDEWORK\lvmen\src\licensedcode\data\rules\gpl-3.0-plus_with_autoconf-exception-3.0_1.yml", "YAML", 0, 0, 0, 10, 0, 0, 1, 11
"d:\IDEWORK\lvmen\src\licensedcode\data\rules\gpl-3.0-plus_with_autoconf-exception-3.0_2.yml", "YAML", 0, 0, 0, 11, 0, 0, 1, 12
"d:\IDEWORK\lvmen\src\licensedcode\data\rules\gpl-3.0-plus_with_autoconf-exception-3.0_3.yml", "YAML", 0, 0, 0, 3, 0, 0, 1, 4
"d:\IDEWORK\lvmen\src\licensedcode\data\rules\gpl-3.0-plus_with_autoconf-macro-exception_1.yml", "YAML", 0, 0, 0, 5, 0, 0, 1, 6
"d:\IDEWORK\lvmen\src\licensedcode\data\rules\gpl-3.0-plus_with_autoconf-macro-exception_2.yml", "YAML", 0, 0, 0, 5, 0, 0, 1, 6
"d:\IDEWORK\lvmen\src\licensedcode\data\rules\gpl-3.0-plus_with_autoconf-macro-exception_3.yml", "YAML", 0, 0, 0, 5, 0, 0, 1, 6
"d:\IDEWORK\lvmen\src\licensedcode\data\rules\gpl-3.0-plus_with_autoconf-macro-exception_4.yml", "YAML", 0, 0, 0, 5, 0, 0, 1, 6
"d:\IDEWORK\lvmen\src\licensedcode\data\rules\gpl-3.0-plus_with_autoconf-macro-exception_5.yml", "YAML", 0, 0, 0, 6, 0, 0, 1, 7
"d:\IDEWORK\lvmen\src\licensedcode\data\rules\gpl-3.0-plus_with_autoconf-macro-exception_6.yml", "YAML", 0, 0, 0, 6, 0, 0, 1, 7
"d:\IDEWORK\lvmen\src\licensedcode\data\rules\gpl-3.0-plus_with_autoconf-macro-exception_7.yml", "YAML", 0, 0, 0, 7, 0, 0, 1, 8
"d:\IDEWORK\lvmen\src\licensedcode\data\rules\gpl-3.0-plus_with_autoconf-simple-exception-2.0_1.yml", "YAML", 0, 0, 0, 5, 0, 0, 1, 6
"d:\IDEWORK\lvmen\src\licensedcode\data\rules\gpl-3.0-plus_with_autoconf-simple-exception-2.0_2.yml", "YAML", 0, 0, 0, 5, 0, 0, 1, 6
"d:\IDEWORK\lvmen\src\licensedcode\data\rules\gpl-3.0-plus_with_autoconf-simple-exception_1.yml", "YAML", 0, 0, 0, 5, 0, 0, 1, 6
"d:\IDEWORK\lvmen\src\licensedcode\data\rules\gpl-3.0-plus_with_autoconf-simple-exception_2.yml", "YAML", 0, 0, 0, 2, 0, 0, 1, 3
"d:\IDEWORK\lvmen\src\licensedcode\data\rules\gpl-3.0-plus_with_autoconf-simple-exception_3.yml", "YAML", 0, 0, 0, 5, 0, 0, 1, 6
"d:\IDEWORK\lvmen\src\licensedcode\data\rules\gpl-3.0-plus_with_autoconf-simple-exception_4.yml", "YAML", 0, 0, 0, 5, 0, 0, 1, 6
"d:\IDEWORK\lvmen\src\licensedcode\data\rules\gpl-3.0-plus_with_autoconf-simple-exception_5.yml", "YAML", 0, 0, 0, 6, 0, 0, 1, 7
"d:\IDEWORK\lvmen\src\licensedcode\data\rules\gpl-3.0-plus_with_autoconf-simple-exception_6.yml", "YAML", 0, 0, 0, 6, 0, 0, 1, 7
"d:\IDEWORK\lvmen\src\licensedcode\data\rules\gpl-3.0-plus_with_autoconf-simple-exception_7.yml", "YAML", 0, 0, 0, 7, 0, 0, 1, 8
"d:\IDEWORK\lvmen\src\licensedcode\data\rules\gpl-3.0-plus_with_bison-exception-2.2_1.yml", "YAML", 0, 0, 0, 3, 0, 0, 1, 4
"d:\IDEWORK\lvmen\src\licensedcode\data\rules\gpl-3.0-plus_with_bison-exception-2.2_2.yml", "YAML", 0, 0, 0, 10, 0, 0, 1, 11
"d:\IDEWORK\lvmen\src\licensedcode\data\rules\gpl-3.0-plus_with_bison-exception-2.2_3.yml", "YAML", 0, 0, 0, 3, 0, 0, 1, 4
"d:\IDEWORK\lvmen\src\licensedcode\data\rules\gpl-3.0-plus_with_bison-exception-2.2_4.yml", "YAML", 0, 0, 0, 3, 0, 0, 1, 4
"d:\IDEWORK\lvmen\src\licensedcode\data\rules\gpl-3.0-plus_with_bison-exception-2.2_5.yml", "YAML", 0, 0, 0, 3, 0, 0, 1, 4
"d:\IDEWORK\lvmen\src\licensedcode\data\rules\gpl-3.0-plus_with_bison-exception-2.2_6.yml", "YAML", 0, 0, 0, 2, 0, 0, 1, 3
"d:\IDEWORK\lvmen\src\licensedcode\data\rules\gpl-3.0-plus_with_bison-exception-2.2_7.yml", "YAML", 0, 0, 0, 10, 0, 0, 1, 11
"d:\IDEWORK\lvmen\src\licensedcode\data\rules\gpl-3.0-plus_with_bison-exception-2.2_8.yml", "YAML", 0, 0, 0, 6, 0, 0, 1, 7
"d:\IDEWORK\lvmen\src\licensedcode\data\rules\gpl-3.0-plus_with_bison-exception-3.0_1.yml", "YAML", 0, 0, 0, 5, 0, 0, 1, 6
"d:\IDEWORK\lvmen\src\licensedcode\data\rules\gpl-3.0-plus_with_classpath-exception-2.0_1.yml", "YAML", 0, 0, 0, 5, 0, 0, 1, 6
"d:\IDEWORK\lvmen\src\licensedcode\data\rules\gpl-3.0-plus_with_classpath-exception-2.0_2.yml", "YAML", 0, 0, 0, 5, 0, 0, 1, 6
"d:\IDEWORK\lvmen\src\licensedcode\data\rules\gpl-3.0-plus_with_classpath-exception-2.0_3.yml", "YAML", 0, 0, 0, 3, 0, 0, 1, 4
"d:\IDEWORK\lvmen\src\licensedcode\data\rules\gpl-3.0-plus_with_classpath-exception-2.0_4.yml", "YAML", 0, 0, 0, 6, 0, 0, 1, 7
"d:\IDEWORK\lvmen\src\licensedcode\data\rules\gpl-3.0-plus_with_classpath-exception-2.0_5.yml", "YAML", 0, 0, 0, 6, 0, 0, 1, 7
"d:\IDEWORK\lvmen\src\licensedcode\data\rules\gpl-3.0-plus_with_cygwin-exception-3.0_1.yml", "YAML", 0, 0, 0, 5, 0, 0, 1, 6
"d:\IDEWORK\lvmen\src\licensedcode\data\rules\gpl-3.0-plus_with_cygwin-exception-3.0_and_other-permissive_1.yml", "YAML", 0, 0, 0, 5, 0, 0, 1, 6
"d:\IDEWORK\lvmen\src\licensedcode\data\rules\gpl-3.0-plus_with_font-exception-gpl_1.yml", "YAML", 0, 0, 0, 6, 0, 0, 1, 7
"d:\IDEWORK\lvmen\src\licensedcode\data\rules\gpl-3.0-plus_with_font-exception-gpl_10.yml", "YAML", 0, 0, 0, 6, 0, 0, 1, 7
"d:\IDEWORK\lvmen\src\licensedcode\data\rules\gpl-3.0-plus_with_font-exception-gpl_11.yml", "YAML", 0, 0, 0, 6, 0, 0, 1, 7
"d:\IDEWORK\lvmen\src\licensedcode\data\rules\gpl-3.0-plus_with_font-exception-gpl_12.yml", "YAML", 0, 0, 0, 5, 0, 0, 1, 6
"d:\IDEWORK\lvmen\src\licensedcode\data\rules\gpl-3.0-plus_with_font-exception-gpl_13.yml", "YAML", 0, 0, 0, 5, 0, 0, 1, 6
"d:\IDEWORK\lvmen\src\licensedcode\data\rules\gpl-3.0-plus_with_font-exception-gpl_14.yml", "YAML", 0, 0, 0, 7, 0, 0, 1, 8
"d:\IDEWORK\lvmen\src\licensedcode\data\rules\gpl-3.0-plus_with_font-exception-gpl_15.yml", "YAML", 0, 0, 0, 7, 0, 0, 1, 8
"d:\IDEWORK\lvmen\src\licensedcode\data\rules\gpl-3.0-plus_with_font-exception-gpl_16.yml", "YAML", 0, 0, 0, 6, 0, 0, 1, 7
"d:\IDEWORK\lvmen\src\licensedcode\data\rules\gpl-3.0-plus_with_font-exception-gpl_17.yml", "YAML", 0, 0, 0, 6, 0, 0, 1, 7
"d:\IDEWORK\lvmen\src\licensedcode\data\rules\gpl-3.0-plus_with_font-exception-gpl_18.yml", "YAML", 0, 0, 0, 6, 0, 0, 1, 7
"d:\IDEWORK\lvmen\src\licensedcode\data\rules\gpl-3.0-plus_with_font-exception-gpl_19.yml", "YAML", 0, 0, 0, 6, 0, 0, 1, 7
"d:\IDEWORK\lvmen\src\licensedcode\data\rules\gpl-3.0-plus_with_font-exception-gpl_2.yml", "YAML", 0, 0, 0, 4, 0, 0, 1, 5
"d:\IDEWORK\lvmen\src\licensedcode\data\rules\gpl-3.0-plus_with_font-exception-gpl_20.yml", "YAML", 0, 0, 0, 6, 0, 0, 1, 7
"d:\IDEWORK\lvmen\src\licensedcode\data\rules\gpl-3.0-plus_with_font-exception-gpl_21.yml", "YAML", 0, 0, 0, 6, 0, 0, 1, 7
"d:\IDEWORK\lvmen\src\licensedcode\data\rules\gpl-3.0-plus_with_font-exception-gpl_22.yml", "YAML", 0, 0, 0, 4, 0, 0, 1, 5
"d:\IDEWORK\lvmen\src\licensedcode\data\rules\gpl-3.0-plus_with_font-exception-gpl_23.yml", "YAML", 0, 0, 0, 4, 0, 0, 1, 5
"d:\IDEWORK\lvmen\src\licensedcode\data\rules\gpl-3.0-plus_with_font-exception-gpl_24.yml", "YAML", 0, 0, 0, 7, 0, 0, 1, 8
"d:\IDEWORK\lvmen\src\licensedcode\data\rules\gpl-3.0-plus_with_font-exception-gpl_25.yml", "YAML", 0, 0, 0, 6, 0, 0, 1, 7
"d:\IDEWORK\lvmen\src\licensedcode\data\rules\gpl-3.0-plus_with_font-exception-gpl_26.yml", "YAML", 0, 0, 0, 7, 0, 0, 1, 8
"d:\IDEWORK\lvmen\src\licensedcode\data\rules\gpl-3.0-plus_with_font-exception-gpl_27.yml", "YAML", 0, 0, 0, 6, 0, 0, 1, 7
"d:\IDEWORK\lvmen\src\licensedcode\data\rules\gpl-3.0-plus_with_font-exception-gpl_28.yml", "YAML", 0, 0, 0, 6, 0, 0, 1, 7
"d:\IDEWORK\lvmen\src\licensedcode\data\rules\gpl-3.0-plus_with_font-exception-gpl_29.yml", "YAML", 0, 0, 0, 6, 0, 0, 1, 7
"d:\IDEWORK\lvmen\src\licensedcode\data\rules\gpl-3.0-plus_with_font-exception-gpl_3.yml", "YAML", 0, 0, 0, 3, 0, 0, 1, 4
"d:\IDEWORK\lvmen\src\licensedcode\data\rules\gpl-3.0-plus_with_font-exception-gpl_30.yml", "YAML", 0, 0, 0, 6, 0, 0, 1, 7
"d:\IDEWORK\lvmen\src\licensedcode\data\rules\gpl-3.0-plus_with_font-exception-gpl_31.yml", "YAML", 0, 0, 0, 7, 0, 0, 1, 8
"d:\IDEWORK\lvmen\src\licensedcode\data\rules\gpl-3.0-plus_with_font-exception-gpl_33.yml", "YAML", 0, 0, 0, 6, 0, 0, 1, 7
"d:\IDEWORK\lvmen\src\licensedcode\data\rules\gpl-3.0-plus_with_font-exception-gpl_34.yml", "YAML", 0, 0, 0, 5, 0, 0, 1, 6
"d:\IDEWORK\lvmen\src\licensedcode\data\rules\gpl-3.0-plus_with_font-exception-gpl_35.yml", "YAML", 0, 0, 0, 5, 0, 0, 1, 6
"d:\IDEWORK\lvmen\src\licensedcode\data\rules\gpl-3.0-plus_with_font-exception-gpl_38.yml", "YAML", 0, 0, 0, 5, 0, 0, 1, 6
"d:\IDEWORK\lvmen\src\licensedcode\data\rules\gpl-3.0-plus_with_font-exception-gpl_4.yml", "YAML", 0, 0, 0, 6, 0, 0, 1, 7
"d:\IDEWORK\lvmen\src\licensedcode\data\rules\gpl-3.0-plus_with_font-exception-gpl_5.yml", "YAML", 0, 0, 0, 6, 0, 0, 1, 7
"d:\IDEWORK\lvmen\src\licensedcode\data\rules\gpl-3.0-plus_with_font-exception-gpl_6.yml", "YAML", 0, 0, 0, 6, 0, 0, 1, 7
"d:\IDEWORK\lvmen\src\licensedcode\data\rules\gpl-3.0-plus_with_font-exception-gpl_7.yml", "YAML", 0, 0, 0, 7, 0, 0, 1, 8
"d:\IDEWORK\lvmen\src\licensedcode\data\rules\gpl-3.0-plus_with_font-exception-gpl_8.yml", "YAML", 0, 0, 0, 5, 0, 0, 1, 6
"d:\IDEWORK\lvmen\src\licensedcode\data\rules\gpl-3.0-plus_with_font-exception-gpl_9.yml", "YAML", 0, 0, 0, 7, 0, 0, 1, 8
"d:\IDEWORK\lvmen\src\licensedcode\data\rules\gpl-3.0-plus_with_gcc-exception-3.1_1.yml", "YAML", 0, 0, 0, 5, 0, 0, 1, 6
"d:\IDEWORK\lvmen\src\licensedcode\data\rules\gpl-3.0-plus_with_gcc-exception-3.1_10.yml", "YAML", 0, 0, 0, 7, 0, 0, 1, 8
"d:\IDEWORK\lvmen\src\licensedcode\data\rules\gpl-3.0-plus_with_gcc-exception-3.1_11.yml", "YAML", 0, 0, 0, 7, 0, 0, 1, 8
"d:\IDEWORK\lvmen\src\licensedcode\data\rules\gpl-3.0-plus_with_gcc-exception-3.1_12.yml", "YAML", 0, 0, 0, 7, 0, 0, 1, 8
"d:\IDEWORK\lvmen\src\licensedcode\data\rules\gpl-3.0-plus_with_gcc-exception-3.1_13.yml", "YAML", 0, 0, 0, 9, 0, 0, 1, 10
"d:\IDEWORK\lvmen\src\licensedcode\data\rules\gpl-3.0-plus_with_gcc-exception-3.1_14.yml", "YAML", 0, 0, 0, 7, 0, 0, 1, 8
"d:\IDEWORK\lvmen\src\licensedcode\data\rules\gpl-3.0-plus_with_gcc-exception-3.1_15.yml", "YAML", 0, 0, 0, 8, 0, 0, 1, 9
"d:\IDEWORK\lvmen\src\licensedcode\data\rules\gpl-3.0-plus_with_gcc-exception-3.1_16.yml", "YAML", 0, 0, 0, 8, 0, 0, 1, 9
"d:\IDEWORK\lvmen\src\licensedcode\data\rules\gpl-3.0-plus_with_gcc-exception-3.1_17.yml", "YAML", 0, 0, 0, 8, 0, 0, 1, 9
"d:\IDEWORK\lvmen\src\licensedcode\data\rules\gpl-3.0-plus_with_gcc-exception-3.1_18.yml", "YAML", 0, 0, 0, 3, 0, 0, 1, 4
"d:\IDEWORK\lvmen\src\licensedcode\data\rules\gpl-3.0-plus_with_gcc-exception-3.1_19.yml", "YAML", 0, 0, 0, 3, 0, 0, 1, 4
"d:\IDEWORK\lvmen\src\licensedcode\data\rules\gpl-3.0-plus_with_gcc-exception-3.1_2.yml", "YAML", 0, 0, 0, 8, 0, 0, 1, 9
"d:\IDEWORK\lvmen\src\licensedcode\data\rules\gpl-3.0-plus_with_gcc-exception-3.1_20.yml", "YAML", 0, 0, 0, 2, 0, 0, 1, 3
"d:\IDEWORK\lvmen\src\licensedcode\data\rules\gpl-3.0-plus_with_gcc-exception-3.1_21.yml", "YAML", 0, 0, 0, 4, 0, 0, 1, 5
"d:\IDEWORK\lvmen\src\licensedcode\data\rules\gpl-3.0-plus_with_gcc-exception-3.1_22.yml", "YAML", 0, 0, 0, 2, 0, 0, 1, 3
"d:\IDEWORK\lvmen\src\licensedcode\data\rules\gpl-3.0-plus_with_gcc-exception-3.1_23.yml", "YAML", 0, 0, 0, 8, 0, 0, 1, 9
"d:\IDEWORK\lvmen\src\licensedcode\data\rules\gpl-3.0-plus_with_gcc-exception-3.1_24.yml", "YAML", 0, 0, 0, 10, 0, 0, 1, 11
"d:\IDEWORK\lvmen\src\licensedcode\data\rules\gpl-3.0-plus_with_gcc-exception-3.1_25.yml", "YAML", 0, 0, 0, 8, 0, 0, 1, 9
"d:\IDEWORK\lvmen\src\licensedcode\data\rules\gpl-3.0-plus_with_gcc-exception-3.1_26.yml", "YAML", 0, 0, 0, 8, 0, 0, 1, 9
"d:\IDEWORK\lvmen\src\licensedcode\data\rules\gpl-3.0-plus_with_gcc-exception-3.1_27.yml", "YAML", 0, 0, 0, 9, 0, 0, 1, 10
"d:\IDEWORK\lvmen\src\licensedcode\data\rules\gpl-3.0-plus_with_gcc-exception-3.1_28.yml", "YAML", 0, 0, 0, 8, 0, 0, 1, 9
"d:\IDEWORK\lvmen\src\licensedcode\data\rules\gpl-3.0-plus_with_gcc-exception-3.1_29.yml", "YAML", 0, 0, 0, 9, 0, 0, 1, 10
"d:\IDEWORK\lvmen\src\licensedcode\data\rules\gpl-3.0-plus_with_gcc-exception-3.1_3.yml", "YAML", 0, 0, 0, 11, 0, 0, 1, 12
"d:\IDEWORK\lvmen\src\licensedcode\data\rules\gpl-3.0-plus_with_gcc-exception-3.1_30.yml", "YAML", 0, 0, 0, 9, 0, 0, 1, 10
"d:\IDEWORK\lvmen\src\licensedcode\data\rules\gpl-3.0-plus_with_gcc-exception-3.1_31.yml", "YAML", 0, 0, 0, 12, 0, 0, 1, 13
"d:\IDEWORK\lvmen\src\licensedcode\data\rules\gpl-3.0-plus_with_gcc-exception-3.1_32.yml", "YAML", 0, 0, 0, 8, 0, 0, 1, 9
"d:\IDEWORK\lvmen\src\licensedcode\data\rules\gpl-3.0-plus_with_gcc-exception-3.1_33.yml", "YAML", 0, 0, 0, 8, 0, 0, 1, 9
"d:\IDEWORK\lvmen\src\licensedcode\data\rules\gpl-3.0-plus_with_gcc-exception-3.1_34.yml", "YAML", 0, 0, 0, 8, 0, 0, 1, 9
"d:\IDEWORK\lvmen\src\licensedcode\data\rules\gpl-3.0-plus_with_gcc-exception-3.1_35.yml", "YAML", 0, 0, 0, 8, 0, 0, 1, 9
"d:\IDEWORK\lvmen\src\licensedcode\data\rules\gpl-3.0-plus_with_gcc-exception-3.1_36.yml", "YAML", 0, 0, 0, 7, 0, 0, 1, 8
"d:\IDEWORK\lvmen\src\licensedcode\data\rules\gpl-3.0-plus_with_gcc-exception-3.1_37.yml", "YAML", 0, 0, 0, 9, 0, 0, 1, 10
"d:\IDEWORK\lvmen\src\licensedcode\data\rules\gpl-3.0-plus_with_gcc-exception-3.1_38.yml", "YAML", 0, 0, 0, 8, 0, 0, 1, 9
"d:\IDEWORK\lvmen\src\licensedcode\data\rules\gpl-3.0-plus_with_gcc-exception-3.1_39.yml", "YAML", 0, 0, 0, 8, 0, 0, 1, 9
"d:\IDEWORK\lvmen\src\licensedcode\data\rules\gpl-3.0-plus_with_gcc-exception-3.1_4.yml", "YAML", 0, 0, 0, 8, 0, 0, 1, 9
"d:\IDEWORK\lvmen\src\licensedcode\data\rules\gpl-3.0-plus_with_gcc-exception-3.1_40.yml", "YAML", 0, 0, 0, 8, 0, 0, 1, 9
"d:\IDEWORK\lvmen\src\licensedcode\data\rules\gpl-3.0-plus_with_gcc-exception-3.1_41.yml", "YAML", 0, 0, 0, 3, 0, 0, 1, 4
"d:\IDEWORK\lvmen\src\licensedcode\data\rules\gpl-3.0-plus_with_gcc-exception-3.1_5.yml", "YAML", 0, 0, 0, 7, 0, 0, 1, 8
"d:\IDEWORK\lvmen\src\licensedcode\data\rules\gpl-3.0-plus_with_gcc-exception-3.1_6.yml", "YAML", 0, 0, 0, 8, 0, 0, 1, 9
"d:\IDEWORK\lvmen\src\licensedcode\data\rules\gpl-3.0-plus_with_gcc-exception-3.1_7.yml", "YAML", 0, 0, 0, 8, 0, 0, 1, 9
"d:\IDEWORK\lvmen\src\licensedcode\data\rules\gpl-3.0-plus_with_gcc-exception-3.1_8.yml", "YAML", 0, 0, 0, 6, 0, 0, 1, 7
"d:\IDEWORK\lvmen\src\licensedcode\data\rules\gpl-3.0-plus_with_gcc-exception-3.1_9.yml", "YAML", 0, 0, 0, 7, 0, 0, 1, 8
"d:\IDEWORK\lvmen\src\licensedcode\data\rules\gpl-3.0-plus_with_gcc-exception-3.1_and_gpl-3.0-plus_with_linking-exception-2.0-plus_1.yml", "YAML", 0, 0, 0, 9, 0, 0, 1, 10
"d:\IDEWORK\lvmen\src\licensedcode\data\rules\gpl-3.0-plus_with_gcc-exception-3.1_and_linking-exception-2.0-plus_1.yml", "YAML", 0, 0, 0, 8, 0, 0, 1, 9
"d:\IDEWORK\lvmen\src\licensedcode\data\rules\gpl-3.0-plus_with_gcc-linking-exception-2.0_1.yml", "YAML", 0, 0, 0, 6, 0, 0, 1, 7
"d:\IDEWORK\lvmen\src\licensedcode\data\rules\gpl-3.0-plus_with_gcc-linking-exception-2.0_2.yml", "YAML", 0, 0, 0, 5, 0, 0, 1, 6
"d:\IDEWORK\lvmen\src\licensedcode\data\rules\gpl-3.0-plus_with_gcc-linking-exception-2.0_3.yml", "YAML", 0, 0, 0, 7, 0, 0, 1, 8
"d:\IDEWORK\lvmen\src\licensedcode\data\rules\gpl-3.0-plus_with_gpl-generic-additional-terms_and_other-copyleft_1.yml", "YAML", 0, 0, 0, 3, 0, 0, 1, 4
"d:\IDEWORK\lvmen\src\licensedcode\data\rules\gpl-3.0-plus_with_libtool-exception-2.0_1.yml", "YAML", 0, 0, 0, 5, 0, 0, 1, 6
"d:\IDEWORK\lvmen\src\licensedcode\data\rules\gpl-3.0-plus_with_libtool-exception-2.0_2.yml", "YAML", 0, 0, 0, 3, 0, 0, 1, 4
"d:\IDEWORK\lvmen\src\licensedcode\data\rules\gpl-3.0-plus_with_libtool-exception-2.0_3.yml", "YAML", 0, 0, 0, 6, 0, 0, 1, 7
"d:\IDEWORK\lvmen\src\licensedcode\data\rules\gpl-3.0-plus_with_linking-exception-2.0-plus_1.yml", "YAML", 0, 0, 0, 5, 0, 0, 1, 6
"d:\IDEWORK\lvmen\src\licensedcode\data\rules\gpl-3.0-plus_with_linking-exception-2.0-plus_2.yml", "YAML", 0, 0, 0, 6, 0, 0, 1, 7
"d:\IDEWORK\lvmen\src\licensedcode\data\rules\gpl-3.0-plus_with_openssl-exception-gpl-2.0_or_gpl-2.0-plus_with_and_others_1.yml", "YAML", 0, 0, 0, 9, 0, 0, 1, 10
"d:\IDEWORK\lvmen\src\licensedcode\data\rules\gpl-3.0-plus_with_openssl-exception-gpl-3.0-plus_1.yml", "YAML", 0, 0, 0, 5, 0, 0, 1, 6
"d:\IDEWORK\lvmen\src\licensedcode\data\rules\gpl-3.0-plus_with_other-copyleft_1.yml", "YAML", 0, 0, 0, 6, 0, 0, 1, 7
"d:\IDEWORK\lvmen\src\licensedcode\data\rules\gpl-3.0-plus_with_other-copyleft_2.yml", "YAML", 0, 0, 0, 3, 0, 0, 1, 4
"d:\IDEWORK\lvmen\src\licensedcode\data\rules\gpl-3.0-plus_with_tex-exception_1.yml", "YAML", 0, 0, 0, 5, 0, 0, 1, 6
"d:\IDEWORK\lvmen\src\licensedcode\data\rules\gpl-3.0-plus_with_tex-exception_2.yml", "YAML", 0, 0, 0, 5, 0, 0, 1, 6
"d:\IDEWORK\lvmen\src\licensedcode\data\rules\gpl-3.0-plus_with_tex-exception_3.yml", "YAML", 0, 0, 0, 5, 0, 0, 1, 6
"d:\IDEWORK\lvmen\src\licensedcode\data\rules\gpl-3.0-plus_with_tex-exception_4.yml", "YAML", 0, 0, 0, 3, 0, 0, 1, 4
"d:\IDEWORK\lvmen\src\licensedcode\data\rules\gpl-3.0-plus_with_tex-exception_5.yml", "YAML", 0, 0, 0, 5, 0, 0, 1, 6
"d:\IDEWORK\lvmen\src\licensedcode\data\rules\gpl-3.0-plus_with_tex-exception_6.yml", "YAML", 0, 0, 0, 6, 0, 0, 1, 7
"d:\IDEWORK\lvmen\src\licensedcode\data\rules\gpl-3.0.SPDX.yml", "YAML", 0, 0, 0, 12, 0, 0, 1, 13
"d:\IDEWORK\lvmen\src\licensedcode\data\rules\gpl-3.0.yml", "YAML", 0, 0, 0, 3, 0, 0, 1, 4
"d:\IDEWORK\lvmen\src\licensedcode\data\rules\gpl-3.0_0.yml", "YAML", 0, 0, 0, 3, 0, 0, 1, 4
"d:\IDEWORK\lvmen\src\licensedcode\data\rules\gpl-3.0_1.yml", "YAML", 0, 0, 0, 5, 0, 0, 1, 6
"d:\IDEWORK\lvmen\src\licensedcode\data\rules\gpl-3.0_10.yml", "YAML", 0, 0, 0, 3, 0, 0, 1, 4
"d:\IDEWORK\lvmen\src\licensedcode\data\rules\gpl-3.0_100.yml", "YAML", 0, 0, 0, 4, 0, 0, 1, 5
"d:\IDEWORK\lvmen\src\licensedcode\data\rules\gpl-3.0_101.yml", "YAML", 0, 0, 0, 3, 0, 0, 1, 4
"d:\IDEWORK\lvmen\src\licensedcode\data\rules\gpl-3.0_102.yml", "YAML", 0, 0, 0, 3, 0, 0, 1, 4
"d:\IDEWORK\lvmen\src\licensedcode\data\rules\gpl-3.0_103.yml", "YAML", 0, 0, 0, 3, 0, 0, 1, 4
"d:\IDEWORK\lvmen\src\licensedcode\data\rules\gpl-3.0_104.yml", "YAML", 0, 0, 0, 3, 0, 0, 1, 4
"d:\IDEWORK\lvmen\src\licensedcode\data\rules\gpl-3.0_105.yml", "YAML", 0, 0, 0, 3, 0, 0, 1, 4
"d:\IDEWORK\lvmen\src\licensedcode\data\rules\gpl-3.0_106.yml", "YAML", 0, 0, 0, 3, 0, 0, 1, 4
"d:\IDEWORK\lvmen\src\licensedcode\data\rules\gpl-3.0_107.yml", "YAML", 0, 0, 0, 3, 0, 0, 1, 4
"d:\IDEWORK\lvmen\src\licensedcode\data\rules\gpl-3.0_108.yml", "YAML", 0, 0, 0, 5, 0, 0, 1, 6
"d:\IDEWORK\lvmen\src\licensedcode\data\rules\gpl-3.0_109.yml", "YAML", 0, 0, 0, 7, 0, 0, 1, 8
"d:\IDEWORK\lvmen\src\licensedcode\data\rules\gpl-3.0_11.yml", "YAML", 0, 0, 0, 5, 0, 0, 1, 6
"d:\IDEWORK\lvmen\src\licensedcode\data\rules\gpl-3.0_110.yml", "YAML", 0, 0, 0, 5, 0, 0, 1, 6
"d:\IDEWORK\lvmen\src\licensedcode\data\rules\gpl-3.0_111.yml", "YAML", 0, 0, 0, 3, 0, 0, 1, 4
"d:\IDEWORK\lvmen\src\licensedcode\data\rules\gpl-3.0_112.yml", "YAML", 0, 0, 0, 3, 0, 0, 1, 4
"d:\IDEWORK\lvmen\src\licensedcode\data\rules\gpl-3.0_113.yml", "YAML", 0, 0, 0, 3, 0, 0, 1, 4
"d:\IDEWORK\lvmen\src\licensedcode\data\rules\gpl-3.0_114.yml", "YAML", 0, 0, 0, 3, 0, 0, 1, 4
"d:\IDEWORK\lvmen\src\licensedcode\data\rules\gpl-3.0_115.yml", "YAML", 0, 0, 0, 5, 0, 0, 1, 6
"d:\IDEWORK\lvmen\src\licensedcode\data\rules\gpl-3.0_116.yml", "YAML", 0, 0, 0, 3, 0, 0, 1, 4
"d:\IDEWORK\lvmen\src\licensedcode\data\rules\gpl-3.0_117.yml", "YAML", 0, 0, 0, 3, 0, 0, 1, 4
"d:\IDEWORK\lvmen\src\licensedcode\data\rules\gpl-3.0_118.yml", "YAML", 0, 0, 0, 3, 0, 0, 1, 4
"d:\IDEWORK\lvmen\src\licensedcode\data\rules\gpl-3.0_119.yml", "YAML", 0, 0, 0, 3, 0, 0, 1, 4
"d:\IDEWORK\lvmen\src\licensedcode\data\rules\gpl-3.0_12.yml", "YAML", 0, 0, 0, 5, 0, 0, 1, 6
"d:\IDEWORK\lvmen\src\licensedcode\data\rules\gpl-3.0_120.yml", "YAML", 0, 0, 0, 5, 0, 0, 1, 6
"d:\IDEWORK\lvmen\src\licensedcode\data\rules\gpl-3.0_121.yml", "YAML", 0, 0, 0, 4, 0, 0, 1, 5
"d:\IDEWORK\lvmen\src\licensedcode\data\rules\gpl-3.0_122.yml", "YAML", 0, 0, 0, 3, 0, 0, 1, 4
"d:\IDEWORK\lvmen\src\licensedcode\data\rules\gpl-3.0_123.yml", "YAML", 0, 0, 0, 3, 0, 0, 1, 4
"d:\IDEWORK\lvmen\src\licensedcode\data\rules\gpl-3.0_124.yml", "YAML", 0, 0, 0, 3, 0, 0, 1, 4
"d:\IDEWORK\lvmen\src\licensedcode\data\rules\gpl-3.0_125.yml", "YAML", 0, 0, 0, 3, 0, 0, 1, 4
"d:\IDEWORK\lvmen\src\licensedcode\data\rules\gpl-3.0_126.yml", "YAML", 0, 0, 0, 3, 0, 0, 1, 4
"d:\IDEWORK\lvmen\src\licensedcode\data\rules\gpl-3.0_127.yml", "YAML", 0, 0, 0, 3, 0, 0, 1, 4
"d:\IDEWORK\lvmen\src\licensedcode\data\rules\gpl-3.0_128.yml", "YAML", 0, 0, 0, 3, 0, 0, 1, 4
"d:\IDEWORK\lvmen\src\licensedcode\data\rules\gpl-3.0_129.yml", "YAML", 0, 0, 0, 3, 0, 0, 1, 4
"d:\IDEWORK\lvmen\src\licensedcode\data\rules\gpl-3.0_13.yml", "YAML", 0, 0, 0, 5, 0, 0, 1, 6
"d:\IDEWORK\lvmen\src\licensedcode\data\rules\gpl-3.0_130.yml", "YAML", 0, 0, 0, 3, 0, 0, 1, 4
"d:\IDEWORK\lvmen\src\licensedcode\data\rules\gpl-3.0_131.yml", "YAML", 0, 0, 0, 3, 0, 0, 1, 4
"d:\IDEWORK\lvmen\src\licensedcode\data\rules\gpl-3.0_132.yml", "YAML", 0, 0, 0, 3, 0, 0, 1, 4
"d:\IDEWORK\lvmen\src\licensedcode\data\rules\gpl-3.0_133.yml", "YAML", 0, 0, 0, 3, 0, 0, 1, 4
"d:\IDEWORK\lvmen\src\licensedcode\data\rules\gpl-3.0_134.yml", "YAML", 0, 0, 0, 3, 0, 0, 1, 4
"d:\IDEWORK\lvmen\src\licensedcode\data\rules\gpl-3.0_135.yml", "YAML", 0, 0, 0, 3, 0, 0, 1, 4
"d:\IDEWORK\lvmen\src\licensedcode\data\rules\gpl-3.0_136.yml", "YAML", 0, 0, 0, 3, 0, 0, 1, 4
"d:\IDEWORK\lvmen\src\licensedcode\data\rules\gpl-3.0_137.yml", "YAML", 0, 0, 0, 3, 0, 0, 1, 4
"d:\IDEWORK\lvmen\src\licensedcode\data\rules\gpl-3.0_138.yml", "YAML", 0, 0, 0, 3, 0, 0, 1, 4
"d:\IDEWORK\lvmen\src\licensedcode\data\rules\gpl-3.0_139.yml", "YAML", 0, 0, 0, 3, 0, 0, 1, 4
"d:\IDEWORK\lvmen\src\licensedcode\data\rules\gpl-3.0_14.yml", "YAML", 0, 0, 0, 9, 0, 0, 1, 10
"d:\IDEWORK\lvmen\src\licensedcode\data\rules\gpl-3.0_140.yml", "YAML", 0, 0, 0, 3, 0, 0, 1, 4
"d:\IDEWORK\lvmen\src\licensedcode\data\rules\gpl-3.0_141.yml", "YAML", 0, 0, 0, 3, 0, 0, 1, 4
"d:\IDEWORK\lvmen\src\licensedcode\data\rules\gpl-3.0_142.yml", "YAML", 0, 0, 0, 3, 0, 0, 1, 4
"d:\IDEWORK\lvmen\src\licensedcode\data\rules\gpl-3.0_143.yml", "YAML", 0, 0, 0, 3, 0, 0, 1, 4
"d:\IDEWORK\lvmen\src\licensedcode\data\rules\gpl-3.0_144.yml", "YAML", 0, 0, 0, 3, 0, 0, 1, 4
"d:\IDEWORK\lvmen\src\licensedcode\data\rules\gpl-3.0_145.yml", "YAML", 0, 0, 0, 3, 0, 0, 1, 4
"d:\IDEWORK\lvmen\src\licensedcode\data\rules\gpl-3.0_146.yml", "YAML", 0, 0, 0, 3, 0, 0, 1, 4
"d:\IDEWORK\lvmen\src\licensedcode\data\rules\gpl-3.0_147.yml", "YAML", 0, 0, 0, 3, 0, 0, 1, 4
"d:\IDEWORK\lvmen\src\licensedcode\data\rules\gpl-3.0_148.yml", "YAML", 0, 0, 0, 3, 0, 0, 1, 4
"d:\IDEWORK\lvmen\src\licensedcode\data\rules\gpl-3.0_149.yml", "YAML", 0, 0, 0, 3, 0, 0, 1, 4
"d:\IDEWORK\lvmen\src\licensedcode\data\rules\gpl-3.0_15.yml", "YAML", 0, 0, 0, 3, 0, 0, 1, 4
"d:\IDEWORK\lvmen\src\licensedcode\data\rules\gpl-3.0_150.yml", "YAML", 0, 0, 0, 3, 0, 0, 1, 4
"d:\IDEWORK\lvmen\src\licensedcode\data\rules\gpl-3.0_151.yml", "YAML", 0, 0, 0, 5, 0, 0, 1, 6
"d:\IDEWORK\lvmen\src\licensedcode\data\rules\gpl-3.0_152.yml", "YAML", 0, 0, 0, 5, 0, 0, 1, 6
"d:\IDEWORK\lvmen\src\licensedcode\data\rules\gpl-3.0_153.yml", "YAML", 0, 0, 0, 5, 0, 0, 1, 6
"d:\IDEWORK\lvmen\src\licensedcode\data\rules\gpl-3.0_154.yml", "YAML", 0, 0, 0, 5, 0, 0, 1, 6
"d:\IDEWORK\lvmen\src\licensedcode\data\rules\gpl-3.0_155.yml", "YAML", 0, 0, 0, 5, 0, 0, 1, 6
"d:\IDEWORK\lvmen\src\licensedcode\data\rules\gpl-3.0_156.yml", "YAML", 0, 0, 0, 5, 0, 0, 1, 6
"d:\IDEWORK\lvmen\src\licensedcode\data\rules\gpl-3.0_157.yml", "YAML", 0, 0, 0, 5, 0, 0, 1, 6
"d:\IDEWORK\lvmen\src\licensedcode\data\rules\gpl-3.0_158.yml", "YAML", 0, 0, 0, 3, 0, 0, 1, 4
"d:\IDEWORK\lvmen\src\licensedcode\data\rules\gpl-3.0_159.yml", "YAML", 0, 0, 0, 3, 0, 0, 1, 4
"d:\IDEWORK\lvmen\src\licensedcode\data\rules\gpl-3.0_16.yml", "YAML", 0, 0, 0, 5, 0, 0, 1, 6
"d:\IDEWORK\lvmen\src\licensedcode\data\rules\gpl-3.0_160.yml", "YAML", 0, 0, 0, 3, 0, 0, 1, 4
"d:\IDEWORK\lvmen\src\licensedcode\data\rules\gpl-3.0_161.yml", "YAML", 0, 0, 0, 7, 0, 0, 1, 8
"d:\IDEWORK\lvmen\src\licensedcode\data\rules\gpl-3.0_162.yml", "YAML", 0, 0, 0, 3, 0, 0, 1, 4
"d:\IDEWORK\lvmen\src\licensedcode\data\rules\gpl-3.0_163.yml", "YAML", 0, 0, 0, 5, 0, 0, 1, 6
"d:\IDEWORK\lvmen\src\licensedcode\data\rules\gpl-3.0_164.yml", "YAML", 0, 0, 0, 3, 0, 0, 1, 4
"d:\IDEWORK\lvmen\src\licensedcode\data\rules\gpl-3.0_165.yml", "YAML", 0, 0, 0, 3, 0, 0, 1, 4
"d:\IDEWORK\lvmen\src\licensedcode\data\rules\gpl-3.0_166.yml", "YAML", 0, 0, 0, 3, 0, 0, 1, 4
"d:\IDEWORK\lvmen\src\licensedcode\data\rules\gpl-3.0_167.yml", "YAML", 0, 0, 0, 3, 0, 0, 1, 4
"d:\IDEWORK\lvmen\src\licensedcode\data\rules\gpl-3.0_168.yml", "YAML", 0, 0, 0, 3, 0, 0, 1, 4
"d:\IDEWORK\lvmen\src\licensedcode\data\rules\gpl-3.0_169.yml", "YAML", 0, 0, 0, 7, 0, 0, 1, 8
"d:\IDEWORK\lvmen\src\licensedcode\data\rules\gpl-3.0_17.yml", "YAML", 0, 0, 0, 3, 0, 0, 1, 4
"d:\IDEWORK\lvmen\src\licensedcode\data\rules\gpl-3.0_170.yml", "YAML", 0, 0, 0, 3, 0, 0, 1, 4
"d:\IDEWORK\lvmen\src\licensedcode\data\rules\gpl-3.0_171.yml", "YAML", 0, 0, 0, 5, 0, 0, 1, 6
"d:\IDEWORK\lvmen\src\licensedcode\data\rules\gpl-3.0_172.yml", "YAML", 0, 0, 0, 3, 0, 0, 1, 4
"d:\IDEWORK\lvmen\src\licensedcode\data\rules\gpl-3.0_173.yml", "YAML", 0, 0, 0, 3, 0, 0, 1, 4
"d:\IDEWORK\lvmen\src\licensedcode\data\rules\gpl-3.0_174.yml", "YAML", 0, 0, 0, 3, 0, 0, 1, 4
"d:\IDEWORK\lvmen\src\licensedcode\data\rules\gpl-3.0_175.yml", "YAML", 0, 0, 0, 3, 0, 0, 1, 4
"d:\IDEWORK\lvmen\src\licensedcode\data\rules\gpl-3.0_176.yml", "YAML", 0, 0, 0, 3, 0, 0, 1, 4
"d:\IDEWORK\lvmen\src\licensedcode\data\rules\gpl-3.0_177.yml", "YAML", 0, 0, 0, 3, 0, 0, 1, 4
"d:\IDEWORK\lvmen\src\licensedcode\data\rules\gpl-3.0_178.yml", "YAML", 0, 0, 0, 3, 0, 0, 1, 4
"d:\IDEWORK\lvmen\src\licensedcode\data\rules\gpl-3.0_179.yml", "YAML", 0, 0, 0, 3, 0, 0, 1, 4
"d:\IDEWORK\lvmen\src\licensedcode\data\rules\gpl-3.0_18.yml", "YAML", 0, 0, 0, 3, 0, 0, 1, 4
"d:\IDEWORK\lvmen\src\licensedcode\data\rules\gpl-3.0_180.yml", "YAML", 0, 0, 0, 3, 0, 0, 1, 4
"d:\IDEWORK\lvmen\src\licensedcode\data\rules\gpl-3.0_181.yml", "YAML", 0, 0, 0, 3, 0, 0, 1, 4
"d:\IDEWORK\lvmen\src\licensedcode\data\rules\gpl-3.0_182.yml", "YAML", 0, 0, 0, 3, 0, 0, 1, 4
"d:\IDEWORK\lvmen\src\licensedcode\data\rules\gpl-3.0_183.yml", "YAML", 0, 0, 0, 3, 0, 0, 1, 4
"d:\IDEWORK\lvmen\src\licensedcode\data\rules\gpl-3.0_184.yml", "YAML", 0, 0, 0, 3, 0, 0, 1, 4
"d:\IDEWORK\lvmen\src\licensedcode\data\rules\gpl-3.0_185.yml", "YAML", 0, 0, 0, 3, 0, 0, 1, 4
"d:\IDEWORK\lvmen\src\licensedcode\data\rules\gpl-3.0_186.yml", "YAML", 0, 0, 0, 3, 0, 0, 1, 4
"d:\IDEWORK\lvmen\src\licensedcode\data\rules\gpl-3.0_187.yml", "YAML", 0, 0, 0, 3, 0, 0, 1, 4
"d:\IDEWORK\lvmen\src\licensedcode\data\rules\gpl-3.0_188.yml", "YAML", 0, 0, 0, 5, 0, 0, 1, 6
"d:\IDEWORK\lvmen\src\licensedcode\data\rules\gpl-3.0_189.yml", "YAML", 0, 0, 0, 5, 0, 0, 1, 6
"d:\IDEWORK\lvmen\src\licensedcode\data\rules\gpl-3.0_19.yml", "YAML", 0, 0, 0, 4, 0, 0, 1, 5
"d:\IDEWORK\lvmen\src\licensedcode\data\rules\gpl-3.0_190.yml", "YAML", 0, 0, 0, 5, 0, 0, 1, 6
"d:\IDEWORK\lvmen\src\licensedcode\data\rules\gpl-3.0_191.yml", "YAML", 0, 0, 0, 5, 0, 0, 1, 6
"d:\IDEWORK\lvmen\src\licensedcode\data\rules\gpl-3.0_192.yml", "YAML", 0, 0, 0, 5, 0, 0, 1, 6
"d:\IDEWORK\lvmen\src\licensedcode\data\rules\gpl-3.0_193.yml", "YAML", 0, 0, 0, 5, 0, 0, 1, 6
"d:\IDEWORK\lvmen\src\licensedcode\data\rules\gpl-3.0_194.yml", "YAML", 0, 0, 0, 5, 0, 0, 1, 6
"d:\IDEWORK\lvmen\src\licensedcode\data\rules\gpl-3.0_195.yml", "YAML", 0, 0, 0, 5, 0, 0, 1, 6
"d:\IDEWORK\lvmen\src\licensedcode\data\rules\gpl-3.0_196.yml", "YAML", 0, 0, 0, 5, 0, 0, 1, 6
"d:\IDEWORK\lvmen\src\licensedcode\data\rules\gpl-3.0_197.yml", "YAML", 0, 0, 0, 5, 0, 0, 1, 6
"d:\IDEWORK\lvmen\src\licensedcode\data\rules\gpl-3.0_198.yml", "YAML", 0, 0, 0, 5, 0, 0, 1, 6
"d:\IDEWORK\lvmen\src\licensedcode\data\rules\gpl-3.0_199.yml", "YAML", 0, 0, 0, 5, 0, 0, 1, 6
"d:\IDEWORK\lvmen\src\licensedcode\data\rules\gpl-3.0_2.yml", "YAML", 0, 0, 0, 5, 0, 0, 1, 6
"d:\IDEWORK\lvmen\src\licensedcode\data\rules\gpl-3.0_20.yml", "YAML", 0, 0, 0, 4, 0, 0, 1, 5
"d:\IDEWORK\lvmen\src\licensedcode\data\rules\gpl-3.0_200.yml", "YAML", 0, 0, 0, 5, 0, 0, 1, 6
"d:\IDEWORK\lvmen\src\licensedcode\data\rules\gpl-3.0_201.yml", "YAML", 0, 0, 0, 5, 0, 0, 1, 6
"d:\IDEWORK\lvmen\src\licensedcode\data\rules\gpl-3.0_202.yml", "YAML", 0, 0, 0, 5, 0, 0, 1, 6
"d:\IDEWORK\lvmen\src\licensedcode\data\rules\gpl-3.0_203.yml", "YAML", 0, 0, 0, 3, 0, 0, 1, 4
"d:\IDEWORK\lvmen\src\licensedcode\data\rules\gpl-3.0_204.yml", "YAML", 0, 0, 0, 10, 0, 0, 1, 11
"d:\IDEWORK\lvmen\src\licensedcode\data\rules\gpl-3.0_205.yml", "YAML", 0, 0, 0, 3, 0, 0, 1, 4
"d:\IDEWORK\lvmen\src\licensedcode\data\rules\gpl-3.0_206.yml", "YAML", 0, 0, 0, 5, 0, 0, 1, 6
"d:\IDEWORK\lvmen\src\licensedcode\data\rules\gpl-3.0_207.yml", "YAML", 0, 0, 0, 5, 0, 0, 1, 6
"d:\IDEWORK\lvmen\src\licensedcode\data\rules\gpl-3.0_208.yml", "YAML", 0, 0, 0, 5, 0, 0, 1, 6
"d:\IDEWORK\lvmen\src\licensedcode\data\rules\gpl-3.0_209.yml", "YAML", 0, 0, 0, 5, 0, 0, 1, 6
"d:\IDEWORK\lvmen\src\licensedcode\data\rules\gpl-3.0_21.yml", "YAML", 0, 0, 0, 3, 0, 0, 1, 4
"d:\IDEWORK\lvmen\src\licensedcode\data\rules\gpl-3.0_210.yml", "YAML", 0, 0, 0, 3, 0, 0, 1, 4
"d:\IDEWORK\lvmen\src\licensedcode\data\rules\gpl-3.0_211.yml", "YAML", 0, 0, 0, 5, 0, 0, 1, 6
"d:\IDEWORK\lvmen\src\licensedcode\data\rules\gpl-3.0_212.yml", "YAML", 0, 0, 0, 3, 0, 0, 1, 4
"d:\IDEWORK\lvmen\src\licensedcode\data\rules\gpl-3.0_213.yml", "YAML", 0, 0, 0, 5, 0, 0, 1, 6
"d:\IDEWORK\lvmen\src\licensedcode\data\rules\gpl-3.0_214.yml", "YAML", 0, 0, 0, 3, 0, 0, 1, 4
"d:\IDEWORK\lvmen\src\licensedcode\data\rules\gpl-3.0_215.yml", "YAML", 0, 0, 0, 5, 0, 0, 1, 6
"d:\IDEWORK\lvmen\src\licensedcode\data\rules\gpl-3.0_216.yml", "YAML", 0, 0, 0, 5, 0, 0, 1, 6
"d:\IDEWORK\lvmen\src\licensedcode\data\rules\gpl-3.0_217.yml", "YAML", 0, 0, 0, 5, 0, 0, 1, 6
"d:\IDEWORK\lvmen\src\licensedcode\data\rules\gpl-3.0_218.yml", "YAML", 0, 0, 0, 5, 0, 0, 1, 6
"d:\IDEWORK\lvmen\src\licensedcode\data\rules\gpl-3.0_219.yml", "YAML", 0, 0, 0, 5, 0, 0, 1, 6
"d:\IDEWORK\lvmen\src\licensedcode\data\rules\gpl-3.0_22.yml", "YAML", 0, 0, 0, 4, 0, 0, 1, 5
"d:\IDEWORK\lvmen\src\licensedcode\data\rules\gpl-3.0_220.yml", "YAML", 0, 0, 0, 5, 0, 0, 1, 6
"d:\IDEWORK\lvmen\src\licensedcode\data\rules\gpl-3.0_221.yml", "YAML", 0, 0, 0, 5, 0, 0, 1, 6
"d:\IDEWORK\lvmen\src\licensedcode\data\rules\gpl-3.0_222.yml", "YAML", 0, 0, 0, 5, 0, 0, 1, 6
"d:\IDEWORK\lvmen\src\licensedcode\data\rules\gpl-3.0_223.yml", "YAML", 0, 0, 0, 5, 0, 0, 1, 6
"d:\IDEWORK\lvmen\src\licensedcode\data\rules\gpl-3.0_224.yml", "YAML", 0, 0, 0, 5, 0, 0, 1, 6
"d:\IDEWORK\lvmen\src\licensedcode\data\rules\gpl-3.0_225.yml", "YAML", 0, 0, 0, 5, 0, 0, 1, 6
"d:\IDEWORK\lvmen\src\licensedcode\data\rules\gpl-3.0_226.yml", "YAML", 0, 0, 0, 6, 0, 0, 1, 7
"d:\IDEWORK\lvmen\src\licensedcode\data\rules\gpl-3.0_227.yml", "YAML", 0, 0, 0, 5, 0, 0, 1, 6
"d:\IDEWORK\lvmen\src\licensedcode\data\rules\gpl-3.0_228.yml", "YAML", 0, 0, 0, 5, 0, 0, 1, 6
"d:\IDEWORK\lvmen\src\licensedcode\data\rules\gpl-3.0_229.yml", "YAML", 0, 0, 0, 5, 0, 0, 1, 6
"d:\IDEWORK\lvmen\src\licensedcode\data\rules\gpl-3.0_23.yml", "YAML", 0, 0, 0, 12, 0, 0, 1, 13
"d:\IDEWORK\lvmen\src\licensedcode\data\rules\gpl-3.0_230.yml", "YAML", 0, 0, 0, 5, 0, 0, 1, 6
"d:\IDEWORK\lvmen\src\licensedcode\data\rules\gpl-3.0_231.yml", "YAML", 0, 0, 0, 5, 0, 0, 1, 6
"d:\IDEWORK\lvmen\src\licensedcode\data\rules\gpl-3.0_232.yml", "YAML", 0, 0, 0, 5, 0, 0, 1, 6
"d:\IDEWORK\lvmen\src\licensedcode\data\rules\gpl-3.0_233.yml", "YAML", 0, 0, 0, 3, 0, 0, 1, 4
"d:\IDEWORK\lvmen\src\licensedcode\data\rules\gpl-3.0_234.yml", "YAML", 0, 0, 0, 11, 0, 0, 1, 12
"d:\IDEWORK\lvmen\src\licensedcode\data\rules\gpl-3.0_235.yml", "YAML", 0, 0, 0, 3, 0, 0, 1, 4
"d:\IDEWORK\lvmen\src\licensedcode\data\rules\gpl-3.0_236.yml", "YAML", 0, 0, 0, 3, 0, 0, 1, 4
"d:\IDEWORK\lvmen\src\licensedcode\data\rules\gpl-3.0_237.yml", "YAML", 0, 0, 0, 3, 0, 0, 1, 4
"d:\IDEWORK\lvmen\src\licensedcode\data\rules\gpl-3.0_238.yml", "YAML", 0, 0, 0, 5, 0, 0, 1, 6
"d:\IDEWORK\lvmen\src\licensedcode\data\rules\gpl-3.0_239.yml", "YAML", 0, 0, 0, 3, 0, 0, 1, 4
"d:\IDEWORK\lvmen\src\licensedcode\data\rules\gpl-3.0_24.yml", "YAML", 0, 0, 0, 4, 0, 0, 1, 5
"d:\IDEWORK\lvmen\src\licensedcode\data\rules\gpl-3.0_240.yml", "YAML", 0, 0, 0, 3, 0, 0, 1, 4
"d:\IDEWORK\lvmen\src\licensedcode\data\rules\gpl-3.0_241.yml", "YAML", 0, 0, 0, 3, 0, 0, 1, 4
"d:\IDEWORK\lvmen\src\licensedcode\data\rules\gpl-3.0_242.yml", "YAML", 0, 0, 0, 3, 0, 0, 1, 4
"d:\IDEWORK\lvmen\src\licensedcode\data\rules\gpl-3.0_243.yml", "YAML", 0, 0, 0, 3, 0, 0, 1, 4
"d:\IDEWORK\lvmen\src\licensedcode\data\rules\gpl-3.0_244.yml", "YAML", 0, 0, 0, 3, 0, 0, 1, 4
"d:\IDEWORK\lvmen\src\licensedcode\data\rules\gpl-3.0_245.yml", "YAML", 0, 0, 0, 5, 0, 0, 1, 6
"d:\IDEWORK\lvmen\src\licensedcode\data\rules\gpl-3.0_246.yml", "YAML", 0, 0, 0, 3, 0, 0, 1, 4
"d:\IDEWORK\lvmen\src\licensedcode\data\rules\gpl-3.0_247.yml", "YAML", 0, 0, 0, 3, 0, 0, 1, 4
"d:\IDEWORK\lvmen\src\licensedcode\data\rules\gpl-3.0_248.yml", "YAML", 0, 0, 0, 3, 0, 0, 1, 4
"d:\IDEWORK\lvmen\src\licensedcode\data\rules\gpl-3.0_249.yml", "YAML", 0, 0, 0, 3, 0, 0, 1, 4
"d:\IDEWORK\lvmen\src\licensedcode\data\rules\gpl-3.0_25.yml", "YAML", 0, 0, 0, 3, 0, 0, 1, 4
"d:\IDEWORK\lvmen\src\licensedcode\data\rules\gpl-3.0_250.yml", "YAML", 0, 0, 0, 3, 0, 0, 1, 4
"d:\IDEWORK\lvmen\src\licensedcode\data\rules\gpl-3.0_251.yml", "YAML", 0, 0, 0, 3, 0, 0, 1, 4
"d:\IDEWORK\lvmen\src\licensedcode\data\rules\gpl-3.0_252.yml", "YAML", 0, 0, 0, 3, 0, 0, 1, 4
"d:\IDEWORK\lvmen\src\licensedcode\data\rules\gpl-3.0_253.yml", "YAML", 0, 0, 0, 6, 0, 0, 1, 7
"d:\IDEWORK\lvmen\src\licensedcode\data\rules\gpl-3.0_254.yml", "YAML", 0, 0, 0, 3, 0, 0, 1, 4
"d:\IDEWORK\lvmen\src\licensedcode\data\rules\gpl-3.0_255.yml", "YAML", 0, 0, 0, 3, 0, 0, 1, 4
"d:\IDEWORK\lvmen\src\licensedcode\data\rules\gpl-3.0_256.yml", "YAML", 0, 0, 0, 3, 0, 0, 1, 4
"d:\IDEWORK\lvmen\src\licensedcode\data\rules\gpl-3.0_257.yml", "YAML", 0, 0, 0, 5, 0, 0, 1, 6
"d:\IDEWORK\lvmen\src\licensedcode\data\rules\gpl-3.0_258.yml", "YAML", 0, 0, 0, 5, 0, 0, 1, 6
"d:\IDEWORK\lvmen\src\licensedcode\data\rules\gpl-3.0_259.yml", "YAML", 0, 0, 0, 11, 0, 0, 1, 12
"d:\IDEWORK\lvmen\src\licensedcode\data\rules\gpl-3.0_26.yml", "YAML", 0, 0, 0, 4, 0, 0, 1, 5
"d:\IDEWORK\lvmen\src\licensedcode\data\rules\gpl-3.0_260.yml", "YAML", 0, 0, 0, 3, 0, 0, 1, 4
"d:\IDEWORK\lvmen\src\licensedcode\data\rules\gpl-3.0_261.yml", "YAML", 0, 0, 0, 3, 0, 0, 1, 4
"d:\IDEWORK\lvmen\src\licensedcode\data\rules\gpl-3.0_262.yml", "YAML", 0, 0, 0, 3, 0, 0, 1, 4
"d:\IDEWORK\lvmen\src\licensedcode\data\rules\gpl-3.0_263.yml", "YAML", 0, 0, 0, 3, 0, 0, 1, 4
"d:\IDEWORK\lvmen\src\licensedcode\data\rules\gpl-3.0_264.yml", "YAML", 0, 0, 0, 3, 0, 0, 1, 4
"d:\IDEWORK\lvmen\src\licensedcode\data\rules\gpl-3.0_265.yml", "YAML", 0, 0, 0, 3, 0, 0, 1, 4
"d:\IDEWORK\lvmen\src\licensedcode\data\rules\gpl-3.0_266.yml", "YAML", 0, 0, 0, 3, 0, 0, 1, 4
"d:\IDEWORK\lvmen\src\licensedcode\data\rules\gpl-3.0_267.yml", "YAML", 0, 0, 0, 3, 0, 0, 1, 4
"d:\IDEWORK\lvmen\src\licensedcode\data\rules\gpl-3.0_268.yml", "YAML", 0, 0, 0, 3, 0, 0, 1, 4
"d:\IDEWORK\lvmen\src\licensedcode\data\rules\gpl-3.0_269.yml", "YAML", 0, 0, 0, 3, 0, 0, 1, 4
"d:\IDEWORK\lvmen\src\licensedcode\data\rules\gpl-3.0_27.yml", "YAML", 0, 0, 0, 4, 0, 0, 1, 5
"d:\IDEWORK\lvmen\src\licensedcode\data\rules\gpl-3.0_270.yml", "YAML", 0, 0, 0, 5, 0, 0, 1, 6
"d:\IDEWORK\lvmen\src\licensedcode\data\rules\gpl-3.0_271.yml", "YAML", 0, 0, 0, 5, 0, 0, 1, 6
"d:\IDEWORK\lvmen\src\licensedcode\data\rules\gpl-3.0_272.yml", "YAML", 0, 0, 0, 3, 0, 0, 1, 4
"d:\IDEWORK\lvmen\src\licensedcode\data\rules\gpl-3.0_273.yml", "YAML", 0, 0, 0, 3, 0, 0, 1, 4
"d:\IDEWORK\lvmen\src\licensedcode\data\rules\gpl-3.0_274.yml", "YAML", 0, 0, 0, 3, 0, 0, 1, 4
"d:\IDEWORK\lvmen\src\licensedcode\data\rules\gpl-3.0_275.yml", "YAML", 0, 0, 0, 5, 0, 0, 1, 6
"d:\IDEWORK\lvmen\src\licensedcode\data\rules\gpl-3.0_276.yml", "YAML", 0, 0, 0, 3, 0, 0, 1, 4
"d:\IDEWORK\lvmen\src\licensedcode\data\rules\gpl-3.0_277.yml", "YAML", 0, 0, 0, 5, 0, 0, 1, 6
"d:\IDEWORK\lvmen\src\licensedcode\data\rules\gpl-3.0_278.yml", "YAML", 0, 0, 0, 5, 0, 0, 1, 6
"d:\IDEWORK\lvmen\src\licensedcode\data\rules\gpl-3.0_279.yml", "YAML", 0, 0, 0, 3, 0, 0, 1, 4
"d:\IDEWORK\lvmen\src\licensedcode\data\rules\gpl-3.0_28.yml", "YAML", 0, 0, 0, 4, 0, 0, 1, 5
"d:\IDEWORK\lvmen\src\licensedcode\data\rules\gpl-3.0_280.yml", "YAML", 0, 0, 0, 3, 0, 0, 1, 4
"d:\IDEWORK\lvmen\src\licensedcode\data\rules\gpl-3.0_281.yml", "YAML", 0, 0, 0, 3, 0, 0, 1, 4
"d:\IDEWORK\lvmen\src\licensedcode\data\rules\gpl-3.0_282.yml", "YAML", 0, 0, 0, 3, 0, 0, 1, 4
"d:\IDEWORK\lvmen\src\licensedcode\data\rules\gpl-3.0_283.yml", "YAML", 0, 0, 0, 4, 0, 0, 1, 5
"d:\IDEWORK\lvmen\src\licensedcode\data\rules\gpl-3.0_284.yml", "YAML", 0, 0, 0, 3, 0, 0, 1, 4
"d:\IDEWORK\lvmen\src\licensedcode\data\rules\gpl-3.0_285.yml", "YAML", 0, 0, 0, 5, 0, 0, 1, 6
"d:\IDEWORK\lvmen\src\licensedcode\data\rules\gpl-3.0_286.yml", "YAML", 0, 0, 0, 5, 0, 0, 1, 6
"d:\IDEWORK\lvmen\src\licensedcode\data\rules\gpl-3.0_287.yml", "YAML", 0, 0, 0, 3, 0, 0, 1, 4
"d:\IDEWORK\lvmen\src\licensedcode\data\rules\gpl-3.0_288.yml", "YAML", 0, 0, 0, 3, 0, 0, 1, 4
"d:\IDEWORK\lvmen\src\licensedcode\data\rules\gpl-3.0_289.yml", "YAML", 0, 0, 0, 5, 0, 0, 1, 6
"d:\IDEWORK\lvmen\src\licensedcode\data\rules\gpl-3.0_29.yml", "YAML", 0, 0, 0, 3, 0, 0, 1, 4
"d:\IDEWORK\lvmen\src\licensedcode\data\rules\gpl-3.0_290.yml", "YAML", 0, 0, 0, 5, 0, 0, 1, 6
"d:\IDEWORK\lvmen\src\licensedcode\data\rules\gpl-3.0_291.yml", "YAML", 0, 0, 0, 5, 0, 0, 1, 6
"d:\IDEWORK\lvmen\src\licensedcode\data\rules\gpl-3.0_292.yml", "YAML", 0, 0, 0, 6, 0, 0, 1, 7
"d:\IDEWORK\lvmen\src\licensedcode\data\rules\gpl-3.0_293.yml", "YAML", 0, 0, 0, 5, 0, 0, 1, 6
"d:\IDEWORK\lvmen\src\licensedcode\data\rules\gpl-3.0_294.yml", "YAML", 0, 0, 0, 5, 0, 0, 1, 6
"d:\IDEWORK\lvmen\src\licensedcode\data\rules\gpl-3.0_295.yml", "YAML", 0, 0, 0, 6, 0, 0, 1, 7
"d:\IDEWORK\lvmen\src\licensedcode\data\rules\gpl-3.0_296.yml", "YAML", 0, 0, 0, 3, 0, 0, 1, 4
"d:\IDEWORK\lvmen\src\licensedcode\data\rules\gpl-3.0_297.yml", "YAML", 0, 0, 0, 5, 0, 0, 1, 6
"d:\IDEWORK\lvmen\src\licensedcode\data\rules\gpl-3.0_298.yml", "YAML", 0, 0, 0, 5, 0, 0, 1, 6
"d:\IDEWORK\lvmen\src\licensedcode\data\rules\gpl-3.0_299.yml", "YAML", 0, 0, 0, 6, 0, 0, 1, 7
"d:\IDEWORK\lvmen\src\licensedcode\data\rules\gpl-3.0_3.yml", "YAML", 0, 0, 0, 3, 0, 0, 1, 4
"d:\IDEWORK\lvmen\src\licensedcode\data\rules\gpl-3.0_30.yml", "YAML", 0, 0, 0, 3, 0, 0, 1, 4
"d:\IDEWORK\lvmen\src\licensedcode\data\rules\gpl-3.0_300.yml", "YAML", 0, 0, 0, 4, 0, 0, 1, 5
"d:\IDEWORK\lvmen\src\licensedcode\data\rules\gpl-3.0_301.yml", "YAML", 0, 0, 0, 4, 0, 0, 1, 5
"d:\IDEWORK\lvmen\src\licensedcode\data\rules\gpl-3.0_302.yml", "YAML", 0, 0, 0, 4, 0, 0, 1, 5
"d:\IDEWORK\lvmen\src\licensedcode\data\rules\gpl-3.0_303.yml", "YAML", 0, 0, 0, 4, 0, 0, 1, 5
"d:\IDEWORK\lvmen\src\licensedcode\data\rules\gpl-3.0_304.yml", "YAML", 0, 0, 0, 4, 0, 0, 1, 5
"d:\IDEWORK\lvmen\src\licensedcode\data\rules\gpl-3.0_305.yml", "YAML", 0, 0, 0, 4, 0, 0, 1, 5
"d:\IDEWORK\lvmen\src\licensedcode\data\rules\gpl-3.0_306.yml", "YAML", 0, 0, 0, 4, 0, 0, 1, 5
"d:\IDEWORK\lvmen\src\licensedcode\data\rules\gpl-3.0_307.yml", "YAML", 0, 0, 0, 4, 0, 0, 1, 5
"d:\IDEWORK\lvmen\src\licensedcode\data\rules\gpl-3.0_308.yml", "YAML", 0, 0, 0, 4, 0, 0, 1, 5
"d:\IDEWORK\lvmen\src\licensedcode\data\rules\gpl-3.0_309.yml", "YAML", 0, 0, 0, 4, 0, 0, 1, 5
"d:\IDEWORK\lvmen\src\licensedcode\data\rules\gpl-3.0_31.yml", "YAML", 0, 0, 0, 4, 0, 0, 1, 5
"d:\IDEWORK\lvmen\src\licensedcode\data\rules\gpl-3.0_310.yml", "YAML", 0, 0, 0, 4, 0, 0, 1, 5
"d:\IDEWORK\lvmen\src\licensedcode\data\rules\gpl-3.0_311.yml", "YAML", 0, 0, 0, 4, 0, 0, 1, 5
"d:\IDEWORK\lvmen\src\licensedcode\data\rules\gpl-3.0_312.yml", "YAML", 0, 0, 0, 4, 0, 0, 1, 5
"d:\IDEWORK\lvmen\src\licensedcode\data\rules\gpl-3.0_313.yml", "YAML", 0, 0, 0, 4, 0, 0, 1, 5
"d:\IDEWORK\lvmen\src\licensedcode\data\rules\gpl-3.0_314.yml", "YAML", 0, 0, 0, 4, 0, 0, 1, 5
"d:\IDEWORK\lvmen\src\licensedcode\data\rules\gpl-3.0_315.yml", "YAML", 0, 0, 0, 4, 0, 0, 1, 5
"d:\IDEWORK\lvmen\src\licensedcode\data\rules\gpl-3.0_316.yml", "YAML", 0, 0, 0, 4, 0, 0, 1, 5
"d:\IDEWORK\lvmen\src\licensedcode\data\rules\gpl-3.0_317.yml", "YAML", 0, 0, 0, 4, 0, 0, 1, 5
"d:\IDEWORK\lvmen\src\licensedcode\data\rules\gpl-3.0_318.yml", "YAML", 0, 0, 0, 4, 0, 0, 1, 5
"d:\IDEWORK\lvmen\src\licensedcode\data\rules\gpl-3.0_319.yml", "YAML", 0, 0, 0, 4, 0, 0, 1, 5
"d:\IDEWORK\lvmen\src\licensedcode\data\rules\gpl-3.0_32.yml", "YAML", 0, 0, 0, 3, 0, 0, 1, 4
"d:\IDEWORK\lvmen\src\licensedcode\data\rules\gpl-3.0_320.yml", "YAML", 0, 0, 0, 4, 0, 0, 1, 5
"d:\IDEWORK\lvmen\src\licensedcode\data\rules\gpl-3.0_321.yml", "YAML", 0, 0, 0, 4, 0, 0, 1, 5
"d:\IDEWORK\lvmen\src\licensedcode\data\rules\gpl-3.0_322.yml", "YAML", 0, 0, 0, 4, 0, 0, 1, 5
"d:\IDEWORK\lvmen\src\licensedcode\data\rules\gpl-3.0_323.yml", "YAML", 0, 0, 0, 4, 0, 0, 1, 5
"d:\IDEWORK\lvmen\src\licensedcode\data\rules\gpl-3.0_324.yml", "YAML", 0, 0, 0, 4, 0, 0, 1, 5
"d:\IDEWORK\lvmen\src\licensedcode\data\rules\gpl-3.0_325.yml", "YAML", 0, 0, 0, 4, 0, 0, 1, 5
"d:\IDEWORK\lvmen\src\licensedcode\data\rules\gpl-3.0_326.yml", "YAML", 0, 0, 0, 4, 0, 0, 1, 5
"d:\IDEWORK\lvmen\src\licensedcode\data\rules\gpl-3.0_327.yml", "YAML", 0, 0, 0, 4, 0, 0, 1, 5
"d:\IDEWORK\lvmen\src\licensedcode\data\rules\gpl-3.0_328.yml", "YAML", 0, 0, 0, 4, 0, 0, 1, 5
"d:\IDEWORK\lvmen\src\licensedcode\data\rules\gpl-3.0_329.yml", "YAML", 0, 0, 0, 4, 0, 0, 1, 5
"d:\IDEWORK\lvmen\src\licensedcode\data\rules\gpl-3.0_33.yml", "YAML", 0, 0, 0, 3, 0, 0, 1, 4
"d:\IDEWORK\lvmen\src\licensedcode\data\rules\gpl-3.0_330.yml", "YAML", 0, 0, 0, 4, 0, 0, 1, 5
"d:\IDEWORK\lvmen\src\licensedcode\data\rules\gpl-3.0_331.yml", "YAML", 0, 0, 0, 11, 0, 0, 1, 12
"d:\IDEWORK\lvmen\src\licensedcode\data\rules\gpl-3.0_332.yml", "YAML", 0, 0, 0, 3, 0, 0, 1, 4
"d:\IDEWORK\lvmen\src\licensedcode\data\rules\gpl-3.0_333.yml", "YAML", 0, 0, 0, 3, 0, 0, 1, 4
"d:\IDEWORK\lvmen\src\licensedcode\data\rules\gpl-3.0_334.yml", "YAML", 0, 0, 0, 3, 0, 0, 1, 4
"d:\IDEWORK\lvmen\src\licensedcode\data\rules\gpl-3.0_335.yml", "YAML", 0, 0, 0, 3, 0, 0, 1, 4
"d:\IDEWORK\lvmen\src\licensedcode\data\rules\gpl-3.0_336.yml", "YAML", 0, 0, 0, 3, 0, 0, 1, 4
"d:\IDEWORK\lvmen\src\licensedcode\data\rules\gpl-3.0_337.yml", "YAML", 0, 0, 0, 5, 0, 0, 1, 6
"d:\IDEWORK\lvmen\src\licensedcode\data\rules\gpl-3.0_338.yml", "YAML", 0, 0, 0, 5, 0, 0, 1, 6
"d:\IDEWORK\lvmen\src\licensedcode\data\rules\gpl-3.0_339.yml", "YAML", 0, 0, 0, 5, 0, 0, 1, 6
"d:\IDEWORK\lvmen\src\licensedcode\data\rules\gpl-3.0_34.yml", "YAML", 0, 0, 0, 3, 0, 0, 1, 4
"d:\IDEWORK\lvmen\src\licensedcode\data\rules\gpl-3.0_340.yml", "YAML", 0, 0, 0, 3, 0, 0, 1, 4
"d:\IDEWORK\lvmen\src\licensedcode\data\rules\gpl-3.0_341.yml", "YAML", 0, 0, 0, 3, 0, 0, 1, 4
"d:\IDEWORK\lvmen\src\licensedcode\data\rules\gpl-3.0_342.yml", "YAML", 0, 0, 0, 3, 0, 0, 1, 4
"d:\IDEWORK\lvmen\src\licensedcode\data\rules\gpl-3.0_343.yml", "YAML", 0, 0, 0, 3, 0, 0, 1, 4
"d:\IDEWORK\lvmen\src\licensedcode\data\rules\gpl-3.0_344.yml", "YAML", 0, 0, 0, 3, 0, 0, 1, 4
"d:\IDEWORK\lvmen\src\licensedcode\data\rules\gpl-3.0_345.yml", "YAML", 0, 0, 0, 3, 0, 0, 1, 4
"d:\IDEWORK\lvmen\src\licensedcode\data\rules\gpl-3.0_346.yml", "YAML", 0, 0, 0, 3, 0, 0, 1, 4
"d:\IDEWORK\lvmen\src\licensedcode\data\rules\gpl-3.0_347.yml", "YAML", 0, 0, 0, 3, 0, 0, 1, 4
"d:\IDEWORK\lvmen\src\licensedcode\data\rules\gpl-3.0_348.yml", "YAML", 0, 0, 0, 3, 0, 0, 1, 4
"d:\IDEWORK\lvmen\src\licensedcode\data\rules\gpl-3.0_349.yml", "YAML", 0, 0, 0, 3, 0, 0, 1, 4
"d:\IDEWORK\lvmen\src\licensedcode\data\rules\gpl-3.0_35.yml", "YAML", 0, 0, 0, 3, 0, 0, 1, 4
"d:\IDEWORK\lvmen\src\licensedcode\data\rules\gpl-3.0_350.yml", "YAML", 0, 0, 0, 3, 0, 0, 1, 4
"d:\IDEWORK\lvmen\src\licensedcode\data\rules\gpl-3.0_351.yml", "YAML", 0, 0, 0, 3, 0, 0, 1, 4
"d:\IDEWORK\lvmen\src\licensedcode\data\rules\gpl-3.0_352.yml", "YAML", 0, 0, 0, 6, 0, 0, 1, 7
"d:\IDEWORK\lvmen\src\licensedcode\data\rules\gpl-3.0_353.yml", "YAML", 0, 0, 0, 3, 0, 0, 1, 4
"d:\IDEWORK\lvmen\src\licensedcode\data\rules\gpl-3.0_354.yml", "YAML", 0, 0, 0, 6, 0, 0, 1, 7
"d:\IDEWORK\lvmen\src\licensedcode\data\rules\gpl-3.0_355.yml", "YAML", 0, 0, 0, 5, 0, 0, 1, 6
"d:\IDEWORK\lvmen\src\licensedcode\data\rules\gpl-3.0_356.yml", "YAML", 0, 0, 0, 3, 0, 0, 1, 4
"d:\IDEWORK\lvmen\src\licensedcode\data\rules\gpl-3.0_357.yml", "YAML", 0, 0, 0, 5, 0, 0, 1, 6
"d:\IDEWORK\lvmen\src\licensedcode\data\rules\gpl-3.0_358.yml", "YAML", 0, 0, 0, 3, 0, 0, 1, 4
"d:\IDEWORK\lvmen\src\licensedcode\data\rules\gpl-3.0_359.yml", "YAML", 0, 0, 0, 3, 0, 0, 1, 4
"d:\IDEWORK\lvmen\src\licensedcode\data\rules\gpl-3.0_36.yml", "YAML", 0, 0, 0, 3, 0, 0, 1, 4
"d:\IDEWORK\lvmen\src\licensedcode\data\rules\gpl-3.0_360.yml", "YAML", 0, 0, 0, 5, 0, 0, 1, 6
"d:\IDEWORK\lvmen\src\licensedcode\data\rules\gpl-3.0_361.yml", "YAML", 0, 0, 0, 5, 0, 0, 1, 6
"d:\IDEWORK\lvmen\src\licensedcode\data\rules\gpl-3.0_362.yml", "YAML", 0, 0, 0, 3, 0, 0, 1, 4
"d:\IDEWORK\lvmen\src\licensedcode\data\rules\gpl-3.0_363.yml", "YAML", 0, 0, 0, 3, 0, 0, 1, 4
"d:\IDEWORK\lvmen\src\licensedcode\data\rules\gpl-3.0_364.yml", "YAML", 0, 0, 0, 3, 0, 0, 1, 4
"d:\IDEWORK\lvmen\src\licensedcode\data\rules\gpl-3.0_365.yml", "YAML", 0, 0, 0, 3, 0, 0, 1, 4
"d:\IDEWORK\lvmen\src\licensedcode\data\rules\gpl-3.0_366.yml", "YAML", 0, 0, 0, 3, 0, 0, 1, 4
"d:\IDEWORK\lvmen\src\licensedcode\data\rules\gpl-3.0_367.yml", "YAML", 0, 0, 0, 3, 0, 0, 1, 4
"d:\IDEWORK\lvmen\src\licensedcode\data\rules\gpl-3.0_368.yml", "YAML", 0, 0, 0, 3, 0, 0, 1, 4
"d:\IDEWORK\lvmen\src\licensedcode\data\rules\gpl-3.0_369.yml", "YAML", 0, 0, 0, 3, 0, 0, 1, 4
"d:\IDEWORK\lvmen\src\licensedcode\data\rules\gpl-3.0_37.yml", "YAML", 0, 0, 0, 3, 0, 0, 1, 4
"d:\IDEWORK\lvmen\src\licensedcode\data\rules\gpl-3.0_370.yml", "YAML", 0, 0, 0, 3, 0, 0, 1, 4
"d:\IDEWORK\lvmen\src\licensedcode\data\rules\gpl-3.0_371.yml", "YAML", 0, 0, 0, 3, 0, 0, 1, 4
"d:\IDEWORK\lvmen\src\licensedcode\data\rules\gpl-3.0_372.yml", "YAML", 0, 0, 0, 3, 0, 0, 1, 4
"d:\IDEWORK\lvmen\src\licensedcode\data\rules\gpl-3.0_373.yml", "YAML", 0, 0, 0, 5, 0, 0, 1, 6
"d:\IDEWORK\lvmen\src\licensedcode\data\rules\gpl-3.0_374.yml", "YAML", 0, 0, 0, 5, 0, 0, 1, 6
"d:\IDEWORK\lvmen\src\licensedcode\data\rules\gpl-3.0_375.yml", "YAML", 0, 0, 0, 7, 0, 0, 1, 8
"d:\IDEWORK\lvmen\src\licensedcode\data\rules\gpl-3.0_376.yml", "YAML", 0, 0, 0, 7, 0, 0, 1, 8
"d:\IDEWORK\lvmen\src\licensedcode\data\rules\gpl-3.0_377.yml", "YAML", 0, 0, 0, 3, 0, 0, 1, 4
"d:\IDEWORK\lvmen\src\licensedcode\data\rules\gpl-3.0_378.yml", "YAML", 0, 0, 0, 3, 0, 0, 1, 4
"d:\IDEWORK\lvmen\src\licensedcode\data\rules\gpl-3.0_379.yml", "YAML", 0, 0, 0, 3, 0, 0, 1, 4
"d:\IDEWORK\lvmen\src\licensedcode\data\rules\gpl-3.0_38.yml", "YAML", 0, 0, 0, 3, 0, 0, 1, 4
"d:\IDEWORK\lvmen\src\licensedcode\data\rules\gpl-3.0_380.yml", "YAML", 0, 0, 0, 3, 0, 0, 1, 4
"d:\IDEWORK\lvmen\src\licensedcode\data\rules\gpl-3.0_381.yml", "YAML", 0, 0, 0, 5, 0, 0, 1, 6
"d:\IDEWORK\lvmen\src\licensedcode\data\rules\gpl-3.0_382.yml", "YAML", 0, 0, 0, 3, 0, 0, 1, 4
"d:\IDEWORK\lvmen\src\licensedcode\data\rules\gpl-3.0_383.yml", "YAML", 0, 0, 0, 3, 0, 0, 1, 4
"d:\IDEWORK\lvmen\src\licensedcode\data\rules\gpl-3.0_384.yml", "YAML", 0, 0, 0, 3, 0, 0, 1, 4
"d:\IDEWORK\lvmen\src\licensedcode\data\rules\gpl-3.0_385.yml", "YAML", 0, 0, 0, 3, 0, 0, 1, 4
"d:\IDEWORK\lvmen\src\licensedcode\data\rules\gpl-3.0_386.yml", "YAML", 0, 0, 0, 3, 0, 0, 1, 4
"d:\IDEWORK\lvmen\src\licensedcode\data\rules\gpl-3.0_387.yml", "YAML", 0, 0, 0, 3, 0, 0, 1, 4
"d:\IDEWORK\lvmen\src\licensedcode\data\rules\gpl-3.0_388.yml", "YAML", 0, 0, 0, 3, 0, 0, 1, 4
"d:\IDEWORK\lvmen\src\licensedcode\data\rules\gpl-3.0_389.yml", "YAML", 0, 0, 0, 5, 0, 0, 1, 6
"d:\IDEWORK\lvmen\src\licensedcode\data\rules\gpl-3.0_39.yml", "YAML", 0, 0, 0, 3, 0, 0, 1, 4
"d:\IDEWORK\lvmen\src\licensedcode\data\rules\gpl-3.0_390.yml", "YAML", 0, 0, 0, 3, 0, 0, 1, 4
"d:\IDEWORK\lvmen\src\licensedcode\data\rules\gpl-3.0_391.yml", "YAML", 0, 0, 0, 3, 0, 0, 1, 4
"d:\IDEWORK\lvmen\src\licensedcode\data\rules\gpl-3.0_392.yml", "YAML", 0, 0, 0, 3, 0, 0, 1, 4
"d:\IDEWORK\lvmen\src\licensedcode\data\rules\gpl-3.0_393.yml", "YAML", 0, 0, 0, 6, 0, 0, 1, 7
"d:\IDEWORK\lvmen\src\licensedcode\data\rules\gpl-3.0_394.yml", "YAML", 0, 0, 0, 5, 0, 0, 1, 6
"d:\IDEWORK\lvmen\src\licensedcode\data\rules\gpl-3.0_395.yml", "YAML", 0, 0, 0, 5, 0, 0, 1, 6
"d:\IDEWORK\lvmen\src\licensedcode\data\rules\gpl-3.0_396.yml", "YAML", 0, 0, 0, 3, 0, 0, 1, 4
"d:\IDEWORK\lvmen\src\licensedcode\data\rules\gpl-3.0_397.yml", "YAML", 0, 0, 0, 4, 0, 0, 1, 5
"d:\IDEWORK\lvmen\src\licensedcode\data\rules\gpl-3.0_398.yml", "YAML", 0, 0, 0, 3, 0, 0, 1, 4
"d:\IDEWORK\lvmen\src\licensedcode\data\rules\gpl-3.0_399.yml", "YAML", 0, 0, 0, 3, 0, 0, 1, 4
"d:\IDEWORK\lvmen\src\licensedcode\data\rules\gpl-3.0_4.yml", "YAML", 0, 0, 0, 4, 0, 0, 1, 5
"d:\IDEWORK\lvmen\src\licensedcode\data\rules\gpl-3.0_40.yml", "YAML", 0, 0, 0, 5, 0, 0, 1, 6
"d:\IDEWORK\lvmen\src\licensedcode\data\rules\gpl-3.0_400.yml", "YAML", 0, 0, 0, 5, 0, 0, 1, 6
"d:\IDEWORK\lvmen\src\licensedcode\data\rules\gpl-3.0_401.yml", "YAML", 0, 0, 0, 3, 0, 0, 1, 4
"d:\IDEWORK\lvmen\src\licensedcode\data\rules\gpl-3.0_402.yml", "YAML", 0, 0, 0, 3, 0, 0, 1, 4
"d:\IDEWORK\lvmen\src\licensedcode\data\rules\gpl-3.0_403.yml", "YAML", 0, 0, 0, 7, 0, 0, 1, 8
"d:\IDEWORK\lvmen\src\licensedcode\data\rules\gpl-3.0_404.yml", "YAML", 0, 0, 0, 4, 0, 0, 1, 5
"d:\IDEWORK\lvmen\src\licensedcode\data\rules\gpl-3.0_405.yml", "YAML", 0, 0, 0, 2, 0, 0, 1, 3
"d:\IDEWORK\lvmen\src\licensedcode\data\rules\gpl-3.0_406.yml", "YAML", 0, 0, 0, 5, 0, 0, 1, 6
"d:\IDEWORK\lvmen\src\licensedcode\data\rules\gpl-3.0_407.yml", "YAML", 0, 0, 0, 3, 0, 0, 1, 4
"d:\IDEWORK\lvmen\src\licensedcode\data\rules\gpl-3.0_408.yml", "YAML", 0, 0, 0, 5, 0, 0, 1, 6
"d:\IDEWORK\lvmen\src\licensedcode\data\rules\gpl-3.0_409.yml", "YAML", 0, 0, 0, 3, 0, 0, 1, 4
"d:\IDEWORK\lvmen\src\licensedcode\data\rules\gpl-3.0_41.yml", "YAML", 0, 0, 0, 3, 0, 0, 1, 4
"d:\IDEWORK\lvmen\src\licensedcode\data\rules\gpl-3.0_410.yml", "YAML", 0, 0, 0, 3, 0, 0, 1, 4
"d:\IDEWORK\lvmen\src\licensedcode\data\rules\gpl-3.0_411.yml", "YAML", 0, 0, 0, 3, 0, 0, 1, 4
"d:\IDEWORK\lvmen\src\licensedcode\data\rules\gpl-3.0_412.yml", "YAML", 0, 0, 0, 3, 0, 0, 1, 4
"d:\IDEWORK\lvmen\src\licensedcode\data\rules\gpl-3.0_413.yml", "YAML", 0, 0, 0, 3, 0, 0, 1, 4
"d:\IDEWORK\lvmen\src\licensedcode\data\rules\gpl-3.0_414.yml", "YAML", 0, 0, 0, 4, 0, 0, 1, 5
"d:\IDEWORK\lvmen\src\licensedcode\data\rules\gpl-3.0_415.yml", "YAML", 0, 0, 0, 4, 0, 0, 1, 5
"d:\IDEWORK\lvmen\src\licensedcode\data\rules\gpl-3.0_416.yml", "YAML", 0, 0, 0, 4, 0, 0, 1, 5
"d:\IDEWORK\lvmen\src\licensedcode\data\rules\gpl-3.0_417.yml", "YAML", 0, 0, 0, 4, 0, 0, 1, 5
"d:\IDEWORK\lvmen\src\licensedcode\data\rules\gpl-3.0_418.yml", "YAML", 0, 0, 0, 2, 0, 0, 1, 3
"d:\IDEWORK\lvmen\src\licensedcode\data\rules\gpl-3.0_419.yml", "YAML", 0, 0, 0, 4, 0, 0, 1, 5
"d:\IDEWORK\lvmen\src\licensedcode\data\rules\gpl-3.0_42.yml", "YAML", 0, 0, 0, 5, 0, 0, 1, 6
"d:\IDEWORK\lvmen\src\licensedcode\data\rules\gpl-3.0_420.yml", "YAML", 0, 0, 0, 4, 0, 0, 1, 5
"d:\IDEWORK\lvmen\src\licensedcode\data\rules\gpl-3.0_421.yml", "YAML", 0, 0, 0, 4, 0, 0, 1, 5
"d:\IDEWORK\lvmen\src\licensedcode\data\rules\gpl-3.0_422.yml", "YAML", 0, 0, 0, 4, 0, 0, 1, 5
"d:\IDEWORK\lvmen\src\licensedcode\data\rules\gpl-3.0_423.yml", "YAML", 0, 0, 0, 4, 0, 0, 1, 5
"d:\IDEWORK\lvmen\src\licensedcode\data\rules\gpl-3.0_424.yml", "YAML", 0, 0, 0, 5, 0, 0, 1, 6
"d:\IDEWORK\lvmen\src\licensedcode\data\rules\gpl-3.0_425.yml", "YAML", 0, 0, 0, 5, 0, 0, 1, 6
"d:\IDEWORK\lvmen\src\licensedcode\data\rules\gpl-3.0_426.yml", "YAML", 0, 0, 0, 5, 0, 0, 1, 6
"d:\IDEWORK\lvmen\src\licensedcode\data\rules\gpl-3.0_427.yml", "YAML", 0, 0, 0, 5, 0, 0, 1, 6
"d:\IDEWORK\lvmen\src\licensedcode\data\rules\gpl-3.0_428.yml", "YAML", 0, 0, 0, 5, 0, 0, 1, 6
"d:\IDEWORK\lvmen\src\licensedcode\data\rules\gpl-3.0_429.yml", "YAML", 0, 0, 0, 3, 0, 0, 1, 4
"d:\IDEWORK\lvmen\src\licensedcode\data\rules\gpl-3.0_43.yml", "YAML", 0, 0, 0, 5, 0, 0, 1, 6
"d:\IDEWORK\lvmen\src\licensedcode\data\rules\gpl-3.0_430.yml", "YAML", 0, 0, 0, 6, 0, 0, 1, 7
"d:\IDEWORK\lvmen\src\licensedcode\data\rules\gpl-3.0_431.yml", "YAML", 0, 0, 0, 5, 0, 0, 1, 6
"d:\IDEWORK\lvmen\src\licensedcode\data\rules\gpl-3.0_432.yml", "YAML", 0, 0, 0, 5, 0, 0, 1, 6
"d:\IDEWORK\lvmen\src\licensedcode\data\rules\gpl-3.0_433.yml", "YAML", 0, 0, 0, 5, 0, 0, 1, 6
"d:\IDEWORK\lvmen\src\licensedcode\data\rules\gpl-3.0_434.yml", "YAML", 0, 0, 0, 5, 0, 0, 1, 6
"d:\IDEWORK\lvmen\src\licensedcode\data\rules\gpl-3.0_435.yml", "YAML", 0, 0, 0, 5, 0, 0, 1, 6
"d:\IDEWORK\lvmen\src\licensedcode\data\rules\gpl-3.0_436.yml", "YAML", 0, 0, 0, 5, 0, 0, 1, 6
"d:\IDEWORK\lvmen\src\licensedcode\data\rules\gpl-3.0_437.yml", "YAML", 0, 0, 0, 5, 0, 0, 1, 6
"d:\IDEWORK\lvmen\src\licensedcode\data\rules\gpl-3.0_438.yml", "YAML", 0, 0, 0, 5, 0, 0, 1, 6
"d:\IDEWORK\lvmen\src\licensedcode\data\rules\gpl-3.0_439.yml", "YAML", 0, 0, 0, 5, 0, 0, 1, 6
"d:\IDEWORK\lvmen\src\licensedcode\data\rules\gpl-3.0_44.yml", "YAML", 0, 0, 0, 4, 0, 0, 1, 5
"d:\IDEWORK\lvmen\src\licensedcode\data\rules\gpl-3.0_440.yml", "YAML", 0, 0, 0, 5, 0, 0, 1, 6
"d:\IDEWORK\lvmen\src\licensedcode\data\rules\gpl-3.0_441.yml", "YAML", 0, 0, 0, 5, 0, 0, 1, 6
"d:\IDEWORK\lvmen\src\licensedcode\data\rules\gpl-3.0_442.yml", "YAML", 0, 0, 0, 6, 0, 0, 1, 7
"d:\IDEWORK\lvmen\src\licensedcode\data\rules\gpl-3.0_443.yml", "YAML", 0, 0, 0, 5, 0, 0, 1, 6
"d:\IDEWORK\lvmen\src\licensedcode\data\rules\gpl-3.0_444.yml", "YAML", 0, 0, 0, 5, 0, 0, 1, 6
"d:\IDEWORK\lvmen\src\licensedcode\data\rules\gpl-3.0_445.yml", "YAML", 0, 0, 0, 5, 0, 0, 1, 6
"d:\IDEWORK\lvmen\src\licensedcode\data\rules\gpl-3.0_446.yml", "YAML", 0, 0, 0, 5, 0, 0, 1, 6
"d:\IDEWORK\lvmen\src\licensedcode\data\rules\gpl-3.0_447.yml", "YAML", 0, 0, 0, 7, 0, 0, 1, 8
"d:\IDEWORK\lvmen\src\licensedcode\data\rules\gpl-3.0_448.yml", "YAML", 0, 0, 0, 13, 0, 0, 1, 14
"d:\IDEWORK\lvmen\src\licensedcode\data\rules\gpl-3.0_449.yml", "YAML", 0, 0, 0, 5, 0, 0, 1, 6
"d:\IDEWORK\lvmen\src\licensedcode\data\rules\gpl-3.0_45.yml", "YAML", 0, 0, 0, 7, 0, 0, 1, 8
"d:\IDEWORK\lvmen\src\licensedcode\data\rules\gpl-3.0_450.yml", "YAML", 0, 0, 0, 12, 0, 0, 1, 13
"d:\IDEWORK\lvmen\src\licensedcode\data\rules\gpl-3.0_451.yml", "YAML", 0, 0, 0, 6, 0, 0, 1, 7
"d:\IDEWORK\lvmen\src\licensedcode\data\rules\gpl-3.0_452.yml", "YAML", 0, 0, 0, 6, 0, 0, 1, 7
"d:\IDEWORK\lvmen\src\licensedcode\data\rules\gpl-3.0_453.yml", "YAML", 0, 0, 0, 6, 0, 0, 1, 7
"d:\IDEWORK\lvmen\src\licensedcode\data\rules\gpl-3.0_454.yml", "YAML", 0, 0, 0, 5, 0, 0, 1, 6
"d:\IDEWORK\lvmen\src\licensedcode\data\rules\gpl-3.0_455.yml", "YAML", 0, 0, 0, 11, 0, 0, 1, 12
"d:\IDEWORK\lvmen\src\licensedcode\data\rules\gpl-3.0_456.yml", "YAML", 0, 0, 0, 5, 0, 0, 1, 6
"d:\IDEWORK\lvmen\src\licensedcode\data\rules\gpl-3.0_457.yml", "YAML", 0, 0, 0, 6, 0, 0, 1, 7
"d:\IDEWORK\lvmen\src\licensedcode\data\rules\gpl-3.0_458.yml", "YAML", 0, 0, 0, 5, 0, 0, 1, 6
"d:\IDEWORK\lvmen\src\licensedcode\data\rules\gpl-3.0_459.yml", "YAML", 0, 0, 0, 5, 0, 0, 1, 6
"d:\IDEWORK\lvmen\src\licensedcode\data\rules\gpl-3.0_46.yml", "YAML", 0, 0, 0, 3, 0, 0, 1, 4
"d:\IDEWORK\lvmen\src\licensedcode\data\rules\gpl-3.0_460.yml", "YAML", 0, 0, 0, 7, 0, 0, 1, 8
"d:\IDEWORK\lvmen\src\licensedcode\data\rules\gpl-3.0_461.yml", "YAML", 0, 0, 0, 5, 0, 0, 1, 6
"d:\IDEWORK\lvmen\src\licensedcode\data\rules\gpl-3.0_462.yml", "YAML", 0, 0, 0, 5, 0, 0, 1, 6
"d:\IDEWORK\lvmen\src\licensedcode\data\rules\gpl-3.0_463.yml", "YAML", 0, 0, 0, 5, 0, 0, 1, 6
"d:\IDEWORK\lvmen\src\licensedcode\data\rules\gpl-3.0_464.yml", "YAML", 0, 0, 0, 5, 0, 0, 1, 6
"d:\IDEWORK\lvmen\src\licensedcode\data\rules\gpl-3.0_465.yml", "YAML", 0, 0, 0, 5, 0, 0, 1, 6
"d:\IDEWORK\lvmen\src\licensedcode\data\rules\gpl-3.0_466.yml", "YAML", 0, 0, 0, 13, 0, 0, 1, 14
"d:\IDEWORK\lvmen\src\licensedcode\data\rules\gpl-3.0_467.yml", "YAML", 0, 0, 0, 5, 0, 0, 1, 6
"d:\IDEWORK\lvmen\src\licensedcode\data\rules\gpl-3.0_468.yml", "YAML", 0, 0, 0, 5, 0, 0, 1, 6
"d:\IDEWORK\lvmen\src\licensedcode\data\rules\gpl-3.0_469.yml", "YAML", 0, 0, 0, 5, 0, 0, 1, 6
"d:\IDEWORK\lvmen\src\licensedcode\data\rules\gpl-3.0_47.yml", "YAML", 0, 0, 0, 3, 0, 0, 1, 4
"d:\IDEWORK\lvmen\src\licensedcode\data\rules\gpl-3.0_470.yml", "YAML", 0, 0, 0, 3, 0, 0, 1, 4
"d:\IDEWORK\lvmen\src\licensedcode\data\rules\gpl-3.0_471.yml", "YAML", 0, 0, 0, 3, 0, 0, 1, 4
"d:\IDEWORK\lvmen\src\licensedcode\data\rules\gpl-3.0_472.yml", "YAML", 0, 0, 0, 3, 0, 0, 1, 4
"d:\IDEWORK\lvmen\src\licensedcode\data\rules\gpl-3.0_473.yml", "YAML", 0, 0, 0, 3, 0, 0, 1, 4
"d:\IDEWORK\lvmen\src\licensedcode\data\rules\gpl-3.0_474.yml", "YAML", 0, 0, 0, 3, 0, 0, 1, 4
"d:\IDEWORK\lvmen\src\licensedcode\data\rules\gpl-3.0_475.yml", "YAML", 0, 0, 0, 5, 0, 0, 1, 6
"d:\IDEWORK\lvmen\src\licensedcode\data\rules\gpl-3.0_476.yml", "YAML", 0, 0, 0, 6, 0, 0, 1, 7
"d:\IDEWORK\lvmen\src\licensedcode\data\rules\gpl-3.0_477.yml", "YAML", 0, 0, 0, 7, 0, 0, 1, 8
"d:\IDEWORK\lvmen\src\licensedcode\data\rules\gpl-3.0_478.yml", "YAML", 0, 0, 0, 5, 0, 0, 1, 6
"d:\IDEWORK\lvmen\src\licensedcode\data\rules\gpl-3.0_479.yml", "YAML", 0, 0, 0, 3, 0, 0, 1, 4
"d:\IDEWORK\lvmen\src\licensedcode\data\rules\gpl-3.0_48.yml", "YAML", 0, 0, 0, 3, 0, 0, 1, 4
"d:\IDEWORK\lvmen\src\licensedcode\data\rules\gpl-3.0_480.yml", "YAML", 0, 0, 0, 4, 0, 0, 1, 5
"d:\IDEWORK\lvmen\src\licensedcode\data\rules\gpl-3.0_481.yml", "YAML", 0, 0, 0, 4, 0, 0, 1, 5
"d:\IDEWORK\lvmen\src\licensedcode\data\rules\gpl-3.0_482.yml", "YAML", 0, 0, 0, 4, 0, 0, 1, 5
"d:\IDEWORK\lvmen\src\licensedcode\data\rules\gpl-3.0_483.yml", "YAML", 0, 0, 0, 9, 0, 0, 1, 10
"d:\IDEWORK\lvmen\src\licensedcode\data\rules\gpl-3.0_484.yml", "YAML", 0, 0, 0, 5, 0, 0, 1, 6
"d:\IDEWORK\lvmen\src\licensedcode\data\rules\gpl-3.0_485.yml", "YAML", 0, 0, 0, 5, 0, 0, 1, 6
"d:\IDEWORK\lvmen\src\licensedcode\data\rules\gpl-3.0_486.yml", "YAML", 0, 0, 0, 5, 0, 0, 1, 6
"d:\IDEWORK\lvmen\src\licensedcode\data\rules\gpl-3.0_487.yml", "YAML", 0, 0, 0, 5, 0, 0, 1, 6
"d:\IDEWORK\lvmen\src\licensedcode\data\rules\gpl-3.0_49.yml", "YAML", 0, 0, 0, 3, 0, 0, 1, 4
"d:\IDEWORK\lvmen\src\licensedcode\data\rules\gpl-3.0_5.yml", "YAML", 0, 0, 0, 2, 0, 0, 1, 3
"d:\IDEWORK\lvmen\src\licensedcode\data\rules\gpl-3.0_50.yml", "YAML", 0, 0, 0, 3, 0, 0, 1, 4
"d:\IDEWORK\lvmen\src\licensedcode\data\rules\gpl-3.0_500.yml", "YAML", 0, 0, 0, 5, 0, 0, 1, 6
"d:\IDEWORK\lvmen\src\licensedcode\data\rules\gpl-3.0_501.yml", "YAML", 0, 0, 0, 5, 0, 0, 1, 6
"d:\IDEWORK\lvmen\src\licensedcode\data\rules\gpl-3.0_502.yml", "YAML", 0, 0, 0, 5, 0, 0, 1, 6
"d:\IDEWORK\lvmen\src\licensedcode\data\rules\gpl-3.0_51.yml", "YAML", 0, 0, 0, 5, 0, 0, 1, 6
"d:\IDEWORK\lvmen\src\licensedcode\data\rules\gpl-3.0_52.yml", "YAML", 0, 0, 0, 5, 0, 0, 1, 6
"d:\IDEWORK\lvmen\src\licensedcode\data\rules\gpl-3.0_53.yml", "YAML", 0, 0, 0, 5, 0, 0, 1, 6
"d:\IDEWORK\lvmen\src\licensedcode\data\rules\gpl-3.0_54.yml", "YAML", 0, 0, 0, 3, 0, 0, 1, 4
"d:\IDEWORK\lvmen\src\licensedcode\data\rules\gpl-3.0_55.yml", "YAML", 0, 0, 0, 3, 0, 0, 1, 4
"d:\IDEWORK\lvmen\src\licensedcode\data\rules\gpl-3.0_56.yml", "YAML", 0, 0, 0, 3, 0, 0, 1, 4
"d:\IDEWORK\lvmen\src\licensedcode\data\rules\gpl-3.0_57.yml", "YAML", 0, 0, 0, 3, 0, 0, 1, 4
"d:\IDEWORK\lvmen\src\licensedcode\data\rules\gpl-3.0_58.yml", "YAML", 0, 0, 0, 3, 0, 0, 1, 4
"d:\IDEWORK\lvmen\src\licensedcode\data\rules\gpl-3.0_59.yml", "YAML", 0, 0, 0, 3, 0, 0, 1, 4
"d:\IDEWORK\lvmen\src\licensedcode\data\rules\gpl-3.0_6.yml", "YAML", 0, 0, 0, 3, 0, 0, 1, 4
"d:\IDEWORK\lvmen\src\licensedcode\data\rules\gpl-3.0_60.yml", "YAML", 0, 0, 0, 3, 0, 0, 1, 4
"d:\IDEWORK\lvmen\src\licensedcode\data\rules\gpl-3.0_61.yml", "YAML", 0, 0, 0, 2, 0, 0, 1, 3
"d:\IDEWORK\lvmen\src\licensedcode\data\rules\gpl-3.0_62.yml", "YAML", 0, 0, 0, 4, 0, 0, 1, 5
"d:\IDEWORK\lvmen\src\licensedcode\data\rules\gpl-3.0_63.yml", "YAML", 0, 0, 0, 5, 0, 0, 1, 6
"d:\IDEWORK\lvmen\src\licensedcode\data\rules\gpl-3.0_64.yml", "YAML", 0, 0, 0, 3, 0, 0, 1, 4
"d:\IDEWORK\lvmen\src\licensedcode\data\rules\gpl-3.0_65.yml", "YAML", 0, 0, 0, 4, 0, 0, 1, 5
"d:\IDEWORK\lvmen\src\licensedcode\data\rules\gpl-3.0_66.yml", "YAML", 0, 0, 0, 3, 0, 0, 1, 4
"d:\IDEWORK\lvmen\src\licensedcode\data\rules\gpl-3.0_67.yml", "YAML", 0, 0, 0, 3, 0, 0, 1, 4
"d:\IDEWORK\lvmen\src\licensedcode\data\rules\gpl-3.0_68.yml", "YAML", 0, 0, 0, 4, 0, 0, 1, 5
"d:\IDEWORK\lvmen\src\licensedcode\data\rules\gpl-3.0_69.yml", "YAML", 0, 0, 0, 3, 0, 0, 1, 4
"d:\IDEWORK\lvmen\src\licensedcode\data\rules\gpl-3.0_7.yml", "YAML", 0, 0, 0, 5, 0, 0, 1, 6
"d:\IDEWORK\lvmen\src\licensedcode\data\rules\gpl-3.0_70.yml", "YAML", 0, 0, 0, 7, 0, 0, 1, 8
"d:\IDEWORK\lvmen\src\licensedcode\data\rules\gpl-3.0_71.yml", "YAML", 0, 0, 0, 5, 0, 0, 1, 6
"d:\IDEWORK\lvmen\src\licensedcode\data\rules\gpl-3.0_71_1.yml", "YAML", 0, 0, 0, 5, 0, 0, 1, 6
"d:\IDEWORK\lvmen\src\licensedcode\data\rules\gpl-3.0_72.yml", "YAML", 0, 0, 0, 3, 0, 0, 1, 4
"d:\IDEWORK\lvmen\src\licensedcode\data\rules\gpl-3.0_73.yml", "YAML", 0, 0, 0, 5, 0, 0, 1, 6
"d:\IDEWORK\lvmen\src\licensedcode\data\rules\gpl-3.0_74.yml", "YAML", 0, 0, 0, 5, 0, 0, 1, 6
"d:\IDEWORK\lvmen\src\licensedcode\data\rules\gpl-3.0_75.yml", "YAML", 0, 0, 0, 5, 0, 0, 1, 6
"d:\IDEWORK\lvmen\src\licensedcode\data\rules\gpl-3.0_76.yml", "YAML", 0, 0, 0, 3, 0, 0, 1, 4
"d:\IDEWORK\lvmen\src\licensedcode\data\rules\gpl-3.0_77.yml", "YAML", 0, 0, 0, 3, 0, 0, 1, 4
"d:\IDEWORK\lvmen\src\licensedcode\data\rules\gpl-3.0_78.yml", "YAML", 0, 0, 0, 3, 0, 0, 1, 4
"d:\IDEWORK\lvmen\src\licensedcode\data\rules\gpl-3.0_79.yml", "YAML", 0, 0, 0, 3, 0, 0, 1, 4
"d:\IDEWORK\lvmen\src\licensedcode\data\rules\gpl-3.0_8.yml", "YAML", 0, 0, 0, 3, 0, 0, 1, 4
"d:\IDEWORK\lvmen\src\licensedcode\data\rules\gpl-3.0_80.yml", "YAML", 0, 0, 0, 8, 0, 0, 1, 9
"d:\IDEWORK\lvmen\src\licensedcode\data\rules\gpl-3.0_81.yml", "YAML", 0, 0, 0, 3, 0, 0, 1, 4
"d:\IDEWORK\lvmen\src\licensedcode\data\rules\gpl-3.0_82.yml", "YAML", 0, 0, 0, 3, 0, 0, 1, 4
"d:\IDEWORK\lvmen\src\licensedcode\data\rules\gpl-3.0_83.yml", "YAML", 0, 0, 0, 3, 0, 0, 1, 4
"d:\IDEWORK\lvmen\src\licensedcode\data\rules\gpl-3.0_84.yml", "YAML", 0, 0, 0, 3, 0, 0, 1, 4
"d:\IDEWORK\lvmen\src\licensedcode\data\rules\gpl-3.0_85.yml", "YAML", 0, 0, 0, 3, 0, 0, 1, 4
"d:\IDEWORK\lvmen\src\licensedcode\data\rules\gpl-3.0_86.yml", "YAML", 0, 0, 0, 3, 0, 0, 1, 4
"d:\IDEWORK\lvmen\src\licensedcode\data\rules\gpl-3.0_87.yml", "YAML", 0, 0, 0, 3, 0, 0, 1, 4
"d:\IDEWORK\lvmen\src\licensedcode\data\rules\gpl-3.0_88.yml", "YAML", 0, 0, 0, 3, 0, 0, 1, 4
"d:\IDEWORK\lvmen\src\licensedcode\data\rules\gpl-3.0_89.yml", "YAML", 0, 0, 0, 11, 0, 0, 1, 12
"d:\IDEWORK\lvmen\src\licensedcode\data\rules\gpl-3.0_9.yml", "YAML", 0, 0, 0, 3, 0, 0, 1, 4
"d:\IDEWORK\lvmen\src\licensedcode\data\rules\gpl-3.0_90.yml", "YAML", 0, 0, 0, 3, 0, 0, 1, 4
"d:\IDEWORK\lvmen\src\licensedcode\data\rules\gpl-3.0_91.yml", "YAML", 0, 0, 0, 3, 0, 0, 1, 4
"d:\IDEWORK\lvmen\src\licensedcode\data\rules\gpl-3.0_92.yml", "YAML", 0, 0, 0, 3, 0, 0, 1, 4
"d:\IDEWORK\lvmen\src\licensedcode\data\rules\gpl-3.0_93.yml", "YAML", 0, 0, 0, 5, 0, 0, 1, 6
"d:\IDEWORK\lvmen\src\licensedcode\data\rules\gpl-3.0_94.yml", "YAML", 0, 0, 0, 3, 0, 0, 1, 4
"d:\IDEWORK\lvmen\src\licensedcode\data\rules\gpl-3.0_95.yml", "YAML", 0, 0, 0, 3, 0, 0, 1, 4
"d:\IDEWORK\lvmen\src\licensedcode\data\rules\gpl-3.0_96.yml", "YAML", 0, 0, 0, 4, 0, 0, 1, 5
"d:\IDEWORK\lvmen\src\licensedcode\data\rules\gpl-3.0_97.yml", "YAML", 0, 0, 0, 2, 0, 0, 1, 3
"d:\IDEWORK\lvmen\src\licensedcode\data\rules\gpl-3.0_98.yml", "YAML", 0, 0, 0, 3, 0, 0, 1, 4
"d:\IDEWORK\lvmen\src\licensedcode\data\rules\gpl-3.0_99.yml", "YAML", 0, 0, 0, 2, 0, 0, 1, 3
"d:\IDEWORK\lvmen\src\licensedcode\data\rules\gpl-3.0_and_agpl-3.0_1.yml", "YAML", 0, 0, 0, 3, 0, 0, 1, 4
"d:\IDEWORK\lvmen\src\licensedcode\data\rules\gpl-3.0_and_cc-by-nc-sa.yml", "YAML", 0, 0, 0, 2, 0, 0, 1, 3
"d:\IDEWORK\lvmen\src\licensedcode\data\rules\gpl-3.0_and_cc0-1.0_1.yml", "YAML", 0, 0, 0, 3, 0, 0, 1, 4
"d:\IDEWORK\lvmen\src\licensedcode\data\rules\gpl-3.0_and_cc0-1.0_2.yml", "YAML", 0, 0, 0, 6, 0, 0, 1, 7
"d:\IDEWORK\lvmen\src\licensedcode\data\rules\gpl-3.0_and_gpl-2.0-plus_1.yml", "YAML", 0, 0, 0, 5, 0, 0, 1, 6
"d:\IDEWORK\lvmen\src\licensedcode\data\rules\gpl-3.0_and_gpl-2.0-plus_2.yml", "YAML", 0, 0, 0, 6, 0, 0, 1, 7
"d:\IDEWORK\lvmen\src\licensedcode\data\rules\gpl-3.0_and_gpl-2.0_and_lgpl-3.0-plus_and_other-copyleft_and_other-permissive_1.yml", "YAML", 0, 0, 0, 6, 0, 0, 1, 7
"d:\IDEWORK\lvmen\src\licensedcode\data\rules\gpl-3.0_and_lgpl-2.1_1.yml", "YAML", 0, 0, 0, 3, 0, 0, 2, 5
"d:\IDEWORK\lvmen\src\licensedcode\data\rules\gpl-3.0_and_lgpl-2.1_2.yml", "YAML", 0, 0, 0, 4, 0, 0, 1, 5
"d:\IDEWORK\lvmen\src\licensedcode\data\rules\gpl-3.0_and_lgpl-2.1_3.yml", "YAML", 0, 0, 0, 3, 0, 0, 1, 4
"d:\IDEWORK\lvmen\src\licensedcode\data\rules\gpl-3.0_and_lgpl-2.1_and_lgpl-3.0_1.yml", "YAML", 0, 0, 0, 4, 0, 0, 1, 5
"d:\IDEWORK\lvmen\src\licensedcode\data\rules\gpl-3.0_and_lgpl-3.0_1.yml", "YAML", 0, 0, 0, 4, 0, 0, 1, 5
"d:\IDEWORK\lvmen\src\licensedcode\data\rules\gpl-3.0_and_lgpl-3.0_2.yml", "YAML", 0, 0, 0, 9, 0, 0, 1, 10
"d:\IDEWORK\lvmen\src\licensedcode\data\rules\gpl-3.0_and_lgpl-3.0_3.yml", "YAML", 0, 0, 0, 9, 0, 0, 1, 10
"d:\IDEWORK\lvmen\src\licensedcode\data\rules\gpl-3.0_and_mit_1.yml", "YAML", 0, 0, 0, 3, 0, 0, 1, 4
"d:\IDEWORK\lvmen\src\licensedcode\data\rules\gpl-3.0_and_other-copyleft_1.yml", "YAML", 0, 0, 0, 3, 0, 0, 1, 4
"d:\IDEWORK\lvmen\src\licensedcode\data\rules\gpl-3.0_and_other-copyleft_2.yml", "YAML", 0, 0, 0, 5, 0, 0, 1, 6
"d:\IDEWORK\lvmen\src\licensedcode\data\rules\gpl-3.0_and_other-copyleft_3.yml", "YAML", 0, 0, 0, 6, 0, 0, 1, 7
"d:\IDEWORK\lvmen\src\licensedcode\data\rules\gpl-3.0_and_other-copyleft_4.yml", "YAML", 0, 0, 0, 5, 0, 0, 1, 6
"d:\IDEWORK\lvmen\src\licensedcode\data\rules\gpl-3.0_and_other-copyleft_5.yml", "YAML", 0, 0, 0, 6, 0, 0, 1, 7
"d:\IDEWORK\lvmen\src\licensedcode\data\rules\gpl-3.0_and_other-permissive_1.yml", "YAML", 0, 0, 0, 5, 0, 0, 1, 6
"d:\IDEWORK\lvmen\src\licensedcode\data\rules\gpl-3.0_and_other-permissive_2.yml", "YAML", 0, 0, 0, 5, 0, 0, 1, 6
"d:\IDEWORK\lvmen\src\licensedcode\data\rules\gpl-3.0_and_proprietary-license_1.yml", "YAML", 0, 0, 0, 4, 0, 0, 1, 5
"d:\IDEWORK\lvmen\src\licensedcode\data\rules\gpl-3.0_and_proprietary-license_2.yml", "YAML", 0, 0, 0, 3, 0, 0, 1, 4
"d:\IDEWORK\lvmen\src\licensedcode\data\rules\gpl-3.0_and_proprietary-license_3.yml", "YAML", 0, 0, 0, 5, 0, 0, 1, 6
"d:\IDEWORK\lvmen\src\licensedcode\data\rules\gpl-3.0_and_proprietary-license_4.yml", "YAML", 0, 0, 0, 5, 0, 0, 1, 6
"d:\IDEWORK\lvmen\src\licensedcode\data\rules\gpl-3.0_and_proprietary-license_and_unknown_1.yml", "YAML", 0, 0, 0, 4, 0, 0, 1, 5
"d:\IDEWORK\lvmen\src\licensedcode\data\rules\gpl-3.0_and_public-domain_1.yml", "YAML", 0, 0, 0, 3, 0, 0, 1, 4
"d:\IDEWORK\lvmen\src\licensedcode\data\rules\gpl-3.0_bruce_korb.yml", "YAML", 0, 0, 0, 6, 0, 0, 1, 7
"d:\IDEWORK\lvmen\src\licensedcode\data\rules\gpl-3.0_copying_gplv3.yml", "YAML", 0, 0, 0, 3, 0, 0, 1, 4
"d:\IDEWORK\lvmen\src\licensedcode\data\rules\gpl-3.0_directory.yml", "YAML", 0, 0, 0, 3, 0, 0, 1, 4
"d:\IDEWORK\lvmen\src\licensedcode\data\rules\gpl-3.0_flossmole.yml", "YAML", 0, 0, 0, 3, 0, 0, 1, 4
"d:\IDEWORK\lvmen\src\licensedcode\data\rules\gpl-3.0_gpl_30_bare_words.yml", "YAML", 0, 0, 0, 4, 0, 0, 2, 6
"d:\IDEWORK\lvmen\src\licensedcode\data\rules\gpl-3.0_nuget_url_1.yml", "YAML", 0, 0, 0, 5, 0, 0, 1, 6
"d:\IDEWORK\lvmen\src\licensedcode\data\rules\gpl-3.0_nuget_url_2.yml", "YAML", 0, 0, 0, 5, 0, 0, 1, 6
"d:\IDEWORK\lvmen\src\licensedcode\data\rules\gpl-3.0_nuget_url_3.yml", "YAML", 0, 0, 0, 5, 0, 0, 1, 6
"d:\IDEWORK\lvmen\src\licensedcode\data\rules\gpl-3.0_only.yml", "YAML", 0, 0, 0, 5, 0, 0, 1, 6
"d:\IDEWORK\lvmen\src\licensedcode\data\rules\gpl-3.0_only_1.yml", "YAML", 0, 0, 0, 3, 0, 0, 1, 4
"d:\IDEWORK\lvmen\src\licensedcode\data\rules\gpl-3.0_only_2.yml", "YAML", 0, 0, 0, 5, 0, 0, 1, 6
"d:\IDEWORK\lvmen\src\licensedcode\data\rules\gpl-3.0_or_agpl-3.0_1.yml", "YAML", 0, 0, 0, 6, 0, 0, 1, 7
"d:\IDEWORK\lvmen\src\licensedcode\data\rules\gpl-3.0_or_agpl-3.0_2.yml", "YAML", 0, 0, 0, 6, 0, 0, 1, 7
"d:\IDEWORK\lvmen\src\licensedcode\data\rules\gpl-3.0_or_apache-2.0.yml", "YAML", 0, 0, 0, 5, 0, 0, 1, 6
"d:\IDEWORK\lvmen\src\licensedcode\data\rules\gpl-3.0_or_apache-2.0_1.yml", "YAML", 0, 0, 0, 3, 0, 0, 1, 4
"d:\IDEWORK\lvmen\src\licensedcode\data\rules\gpl-3.0_or_apache-2.0_10.yml", "YAML", 0, 0, 0, 5, 0, 0, 1, 6
"d:\IDEWORK\lvmen\src\licensedcode\data\rules\gpl-3.0_or_apache-2.0_11.yml", "YAML", 0, 0, 0, 7, 0, 0, 1, 8
"d:\IDEWORK\lvmen\src\licensedcode\data\rules\gpl-3.0_or_apache-2.0_12.yml", "YAML", 0, 0, 0, 8, 0, 0, 1, 9
"d:\IDEWORK\lvmen\src\licensedcode\data\rules\gpl-3.0_or_apache-2.0_13.yml", "YAML", 0, 0, 0, 8, 0, 0, 1, 9
"d:\IDEWORK\lvmen\src\licensedcode\data\rules\gpl-3.0_or_apache-2.0_14.yml", "YAML", 0, 0, 0, 6, 0, 0, 1, 7
"d:\IDEWORK\lvmen\src\licensedcode\data\rules\gpl-3.0_or_apache-2.0_2.yml", "YAML", 0, 0, 0, 4, 0, 0, 1, 5
"d:\IDEWORK\lvmen\src\licensedcode\data\rules\gpl-3.0_or_apache-2.0_3.yml", "YAML", 0, 0, 0, 4, 0, 0, 1, 5
"d:\IDEWORK\lvmen\src\licensedcode\data\rules\gpl-3.0_or_apache-2.0_4.yml", "YAML", 0, 0, 0, 4, 0, 0, 1, 5
"d:\IDEWORK\lvmen\src\licensedcode\data\rules\gpl-3.0_or_apache-2.0_5.yml", "YAML", 0, 0, 0, 7, 0, 0, 1, 8
"d:\IDEWORK\lvmen\src\licensedcode\data\rules\gpl-3.0_or_apache-2.0_6.yml", "YAML", 0, 0, 0, 5, 0, 0, 1, 6
"d:\IDEWORK\lvmen\src\licensedcode\data\rules\gpl-3.0_or_apache-2.0_7.yml", "YAML", 0, 0, 0, 5, 0, 0, 1, 6
"d:\IDEWORK\lvmen\src\licensedcode\data\rules\gpl-3.0_or_apache-2.0_8.yml", "YAML", 0, 0, 0, 5, 0, 0, 1, 6
"d:\IDEWORK\lvmen\src\licensedcode\data\rules\gpl-3.0_or_apache-2.0_9.yml", "YAML", 0, 0, 0, 5, 0, 0, 1, 6
"d:\IDEWORK\lvmen\src\licensedcode\data\rules\gpl-3.0_or_bsd-new_1.yml", "YAML", 0, 0, 0, 3, 0, 0, 1, 4
"d:\IDEWORK\lvmen\src\licensedcode\data\rules\gpl-3.0_or_commercial-license_1.yml", "YAML", 0, 0, 0, 7, 0, 0, 1, 8
"d:\IDEWORK\lvmen\src\licensedcode\data\rules\gpl-3.0_or_commercial-license_2.yml", "YAML", 0, 0, 0, 3, 0, 0, 1, 4
"d:\IDEWORK\lvmen\src\licensedcode\data\rules\gpl-3.0_or_commercial-license_3.yml", "YAML", 0, 0, 0, 5, 0, 0, 1, 6
"d:\IDEWORK\lvmen\src\licensedcode\data\rules\gpl-3.0_or_commercial-license_4.yml", "YAML", 0, 0, 0, 5, 0, 0, 1, 6
"d:\IDEWORK\lvmen\src\licensedcode\data\rules\gpl-3.0_or_commercial-license_5.yml", "YAML", 0, 0, 0, 3, 0, 0, 1, 4
"d:\IDEWORK\lvmen\src\licensedcode\data\rules\gpl-3.0_or_commercial-license_6.yml", "YAML", 0, 0, 0, 10, 0, 0, 1, 11
"d:\IDEWORK\lvmen\src\licensedcode\data\rules\gpl-3.0_or_commercial-license_7.yml", "YAML", 0, 0, 0, 10, 0, 0, 1, 11
"d:\IDEWORK\lvmen\src\licensedcode\data\rules\gpl-3.0_or_gpl-2.0_or_gpl-1.0_or_lgpl-3.0_or_mpl-2.0_or_commercial-license_1.yml", "YAML", 0, 0, 0, 10, 0, 0, 1, 11
"d:\IDEWORK\lvmen\src\licensedcode\data\rules\gpl-3.0_or_gpl-2.0_or_gpl-1.0_or_lgpl-3.0_or_mpl-2.0_or_commercial-license_2.yml", "YAML", 0, 0, 0, 10, 0, 0, 1, 11
"d:\IDEWORK\lvmen\src\licensedcode\data\rules\gpl-3.0_or_kde-accepted-gpl_1.yml", "YAML", 0, 0, 0, 5, 0, 0, 1, 6
"d:\IDEWORK\lvmen\src\licensedcode\data\rules\gpl-3.0_or_mit_1.yml", "YAML", 0, 0, 0, 3, 0, 0, 1, 4
"d:\IDEWORK\lvmen\src\licensedcode\data\rules\gpl-3.0_or_mit_2.yml", "YAML", 0, 0, 0, 3, 0, 0, 1, 4
"d:\IDEWORK\lvmen\src\licensedcode\data\rules\gpl-3.0_rdesc_1.yml", "YAML", 0, 0, 0, 3, 0, 0, 1, 4
"d:\IDEWORK\lvmen\src\licensedcode\data\rules\gpl-3.0_url_1.yml", "YAML", 0, 0, 0, 5, 0, 0, 1, 6
"d:\IDEWORK\lvmen\src\licensedcode\data\rules\gpl-3.0_url_2.yml", "YAML", 0, 0, 0, 5, 0, 0, 1, 6
"d:\IDEWORK\lvmen\src\licensedcode\data\rules\gpl-3.0_url_badge.yml", "YAML", 0, 0, 0, 5, 0, 0, 1, 6
"d:\IDEWORK\lvmen\src\licensedcode\data\rules\gpl-3.0_url_glc_123.yml", "YAML", 0, 0, 0, 5, 0, 0, 1, 6
"d:\IDEWORK\lvmen\src\licensedcode\data\rules\gpl-3.0_url_glc_168.yml", "YAML", 0, 0, 0, 5, 0, 0, 1, 6
"d:\IDEWORK\lvmen\src\licensedcode\data\rules\gpl-3.0_url_glc_169.yml", "YAML", 0, 0, 0, 5, 0, 0, 1, 6
"d:\IDEWORK\lvmen\src\licensedcode\data\rules\gpl-3.0_with_aptana-exception-3.0_and_unknown_1.yml", "YAML", 0, 0, 0, 4, 0, 0, 1, 5
"d:\IDEWORK\lvmen\src\licensedcode\data\rules\gpl-3.0_with_autoconf-exception-3.0_1.yml", "YAML", 0, 0, 0, 10, 0, 0, 1, 11
"d:\IDEWORK\lvmen\src\licensedcode\data\rules\gpl-3.0_with_autoconf-exception-3.0_2.yml", "YAML", 0, 0, 0, 4, 0, 0, 1, 5
"d:\IDEWORK\lvmen\src\licensedcode\data\rules\gpl-3.0_with_autoconf-exception-3.0_3.yml", "YAML", 0, 0, 0, 2, 0, 0, 1, 3
"d:\IDEWORK\lvmen\src\licensedcode\data\rules\gpl-3.0_with_autoconf-simple-exception-2.0_1.yml", "YAML", 0, 0, 0, 3, 0, 0, 1, 4
"d:\IDEWORK\lvmen\src\licensedcode\data\rules\gpl-3.0_with_bison-exception-2.2_1.yml", "YAML", 0, 0, 0, 3, 0, 0, 1, 4
"d:\IDEWORK\lvmen\src\licensedcode\data\rules\gpl-3.0_with_bison-exception-2.2_2.yml", "YAML", 0, 0, 0, 3, 0, 0, 1, 4
"d:\IDEWORK\lvmen\src\licensedcode\data\rules\gpl-3.0_with_classpath-exception-2.0_1.yml", "YAML", 0, 0, 0, 3, 0, 0, 1, 4
"d:\IDEWORK\lvmen\src\licensedcode\data\rules\gpl-3.0_with_font-exception-gpl_1.yml", "YAML", 0, 0, 0, 3, 0, 0, 1, 4
"d:\IDEWORK\lvmen\src\licensedcode\data\rules\gpl-3.0_with_font-exception-gpl_2.yml", "YAML", 0, 0, 0, 4, 0, 0, 1, 5
"d:\IDEWORK\lvmen\src\licensedcode\data\rules\gpl-3.0_with_font-exception-gpl_3.yml", "YAML", 0, 0, 0, 4, 0, 0, 1, 5
"d:\IDEWORK\lvmen\src\licensedcode\data\rules\gpl-3.0_with_font-exception-gpl_4.yml", "YAML", 0, 0, 0, 6, 0, 0, 1, 7
"d:\IDEWORK\lvmen\src\licensedcode\data\rules\gpl-3.0_with_font-exception-gpl_5.yml", "YAML", 0, 0, 0, 4, 0, 0, 1, 5
"d:\IDEWORK\lvmen\src\licensedcode\data\rules\gpl-3.0_with_font-exception-gpl_or_gpl-2.0_with_font-exception-gpl_1.yml", "YAML", 0, 0, 0, 3, 0, 0, 1, 4
"d:\IDEWORK\lvmen\src\licensedcode\data\rules\gpl-3.0_with_font-exception-gpl_or_gpl-2.0_with_font-exception-gpl_2.yml", "YAML", 0, 0, 0, 3, 0, 0, 1, 4
"d:\IDEWORK\lvmen\src\licensedcode\data\rules\gpl-3.0_with_font-exception-gpl_or_gpl-2.0_with_font-exception-gpl_3.yml", "YAML", 0, 0, 0, 3, 0, 0, 1, 4
"d:\IDEWORK\lvmen\src\licensedcode\data\rules\gpl-3.0_with_gcc-exception-3.1_1.yml", "YAML", 0, 0, 0, 3, 0, 0, 1, 4
"d:\IDEWORK\lvmen\src\licensedcode\data\rules\gpl-3.0_with_gcc-exception-3.1_2.yml", "YAML", 0, 0, 0, 3, 0, 0, 1, 4
"d:\IDEWORK\lvmen\src\licensedcode\data\rules\gpl-3.0_with_gcc-exception-3.1_3.yml", "YAML", 0, 0, 0, 3, 0, 0, 1, 4
"d:\IDEWORK\lvmen\src\licensedcode\data\rules\gpl-3.0_with_gcc-exception-3.1_4.yml", "YAML", 0, 0, 0, 5, 0, 0, 1, 6
"d:\IDEWORK\lvmen\src\licensedcode\data\rules\gpl-3.0_with_gcc-exception-3.1_5.yml", "YAML", 0, 0, 0, 2, 0, 0, 1, 3
"d:\IDEWORK\lvmen\src\licensedcode\data\rules\gpl-3.0_with_gcc-exception-3.1_6.yml", "YAML", 0, 0, 0, 5, 0, 0, 1, 6
"d:\IDEWORK\lvmen\src\licensedcode\data\rules\gpl-3.0_with_gcc-exception-3.1_7.yml", "YAML", 0, 0, 0, 5, 0, 0, 1, 6
"d:\IDEWORK\lvmen\src\licensedcode\data\rules\gpl-3.0_with_gcc-exception-3.1_8.yml", "YAML", 0, 0, 0, 2, 0, 0, 1, 3
"d:\IDEWORK\lvmen\src\licensedcode\data\rules\gpl-3.0_with_gcc-linking-exception-2.0_1.yml", "YAML", 0, 0, 0, 5, 0, 0, 1, 6
"d:\IDEWORK\lvmen\src\licensedcode\data\rules\gpl-3.0_with_gcc-linking-exception-2.0_2.yml", "YAML", 0, 0, 0, 4, 0, 0, 1, 5
"d:\IDEWORK\lvmen\src\licensedcode\data\rules\gpl-3.0_with_gcc_exception31_1.yml", "YAML", 0, 0, 0, 4, 0, 0, 1, 5
"d:\IDEWORK\lvmen\src\licensedcode\data\rules\gpl-3.0_with_gpl-generic-additional-terms_1.yml", "YAML", 0, 0, 0, 3, 0, 0, 1, 4
"d:\IDEWORK\lvmen\src\licensedcode\data\rules\gpl-3.0_with_gpl-generic-additional-terms_2.yml", "YAML", 0, 0, 0, 3, 0, 0, 1, 4
"d:\IDEWORK\lvmen\src\licensedcode\data\rules\gpl-3.0_with_gpl-generic-additional-terms_3.yml", "YAML", 0, 0, 0, 3, 0, 0, 1, 4
"d:\IDEWORK\lvmen\src\licensedcode\data\rules\gpl-3.0_with_gpl-generic-additional-terms_4.yml", "YAML", 0, 0, 0, 5, 0, 0, 1, 6
"d:\IDEWORK\lvmen\src\licensedcode\data\rules\gpl-3.0_with_gpl-generic-additional-terms_5.yml", "YAML", 0, 0, 0, 4, 0, 0, 1, 5
"d:\IDEWORK\lvmen\src\licensedcode\data\rules\gpl-3.0_with_gpl-generic-additional-terms_6.yml", "YAML", 0, 0, 0, 5, 0, 0, 1, 6
"d:\IDEWORK\lvmen\src\licensedcode\data\rules\gpl-3.0_with_openssl-exception-gpl-2.0_1.yml", "YAML", 0, 0, 0, 3, 0, 0, 1, 4
"d:\IDEWORK\lvmen\src\licensedcode\data\rules\gpl-3.0_with_other-copyleft_1.yml", "YAML", 0, 0, 0, 5, 0, 0, 1, 6
"d:\IDEWORK\lvmen\src\licensedcode\data\rules\gpl-3.0_with_qt-gpl-exception-1.0_1.yml", "YAML", 0, 0, 0, 3, 0, 0, 1, 4
"d:\IDEWORK\lvmen\src\licensedcode\data\rules\gpl-3.0_with_qt-gpl-exception-1.0_or_commercial-license_1.yml", "YAML", 0, 0, 0, 8, 0, 0, 1, 9
"d:\IDEWORK\lvmen\src\licensedcode\data\rules\gpl-3.0_with_sencha-app-floss-exception_or_gpl-3.0_with_sencha-dev-floss-exception_or_sencha-commercial_and_public-domain_and_mit_and_mit_1.yml", "YAML", 0, 0, 0, 16, 0, 0, 1, 17
"d:\IDEWORK\lvmen\src\licensedcode\data\rules\gpl-3.0_without_qt-gpl-exception-1.0_or_commercial-license_2.yml", "YAML", 0, 0, 0, 8, 0, 0, 1, 9
"d:\IDEWORK\lvmen\src\licensedcode\data\rules\gpl-derived.yml", "YAML", 0, 0, 0, 5, 0, 0, 1, 6
"d:\IDEWORK\lvmen\src\licensedcode\data\rules\gpl-derived2.yml", "YAML", 0, 0, 0, 6, 0, 0, 1, 7
"d:\IDEWORK\lvmen\src\licensedcode\data\rules\gpl1_bare_word_only.yml", "YAML", 0, 0, 0, 3, 0, 0, 1, 4
"d:\IDEWORK\lvmen\src\licensedcode\data\rules\gpl2_bare_word_only.yml", "YAML", 0, 0, 0, 3, 0, 0, 1, 4
"d:\IDEWORK\lvmen\src\licensedcode\data\rules\gpl_0.yml", "YAML", 0, 0, 0, 3, 0, 0, 1, 4
"d:\IDEWORK\lvmen\src\licensedcode\data\rules\gpl_1.yml", "YAML", 0, 0, 0, 3, 0, 0, 1, 4
"d:\IDEWORK\lvmen\src\licensedcode\data\rules\gpl_10.yml", "YAML", 0, 0, 0, 3, 0, 0, 1, 4
"d:\IDEWORK\lvmen\src\licensedcode\data\rules\gpl_100.yml", "YAML", 0, 0, 0, 3, 0, 0, 1, 4
"d:\IDEWORK\lvmen\src\licensedcode\data\rules\gpl_101.yml", "YAML", 0, 0, 0, 3, 0, 0, 1, 4
"d:\IDEWORK\lvmen\src\licensedcode\data\rules\gpl_102.yml", "YAML", 0, 0, 0, 3, 0, 0, 1, 4
"d:\IDEWORK\lvmen\src\licensedcode\data\rules\gpl_103.yml", "YAML", 0, 0, 0, 3, 0, 0, 1, 4
"d:\IDEWORK\lvmen\src\licensedcode\data\rules\gpl_104.yml", "YAML", 0, 0, 0, 3, 0, 0, 1, 4
"d:\IDEWORK\lvmen\src\licensedcode\data\rules\gpl_105.yml", "YAML", 0, 0, 0, 3, 0, 0, 1, 4
"d:\IDEWORK\lvmen\src\licensedcode\data\rules\gpl_106.yml", "YAML", 0, 0, 0, 3, 0, 0, 1, 4
"d:\IDEWORK\lvmen\src\licensedcode\data\rules\gpl_107.yml", "YAML", 0, 0, 0, 5, 0, 0, 1, 6
"d:\IDEWORK\lvmen\src\licensedcode\data\rules\gpl_108.yml", "YAML", 0, 0, 0, 5, 0, 0, 1, 6
"d:\IDEWORK\lvmen\src\licensedcode\data\rules\gpl_109.yml", "YAML", 0, 0, 0, 3, 0, 0, 1, 4
"d:\IDEWORK\lvmen\src\licensedcode\data\rules\gpl_11.yml", "YAML", 0, 0, 0, 2, 0, 0, 1, 3
"d:\IDEWORK\lvmen\src\licensedcode\data\rules\gpl_110.yml", "YAML", 0, 0, 0, 3, 0, 0, 1, 4
"d:\IDEWORK\lvmen\src\licensedcode\data\rules\gpl_111.yml", "YAML", 0, 0, 0, 3, 0, 0, 1, 4
"d:\IDEWORK\lvmen\src\licensedcode\data\rules\gpl_112.yml", "YAML", 0, 0, 0, 3, 0, 0, 1, 4
"d:\IDEWORK\lvmen\src\licensedcode\data\rules\gpl_113.yml", "YAML", 0, 0, 0, 4, 0, 0, 1, 5
"d:\IDEWORK\lvmen\src\licensedcode\data\rules\gpl_114.yml", "YAML", 0, 0, 0, 4, 0, 0, 1, 5
"d:\IDEWORK\lvmen\src\licensedcode\data\rules\gpl_115.yml", "YAML", 0, 0, 0, 4, 0, 0, 1, 5
"d:\IDEWORK\lvmen\src\licensedcode\data\rules\gpl_116.yml", "YAML", 0, 0, 0, 2, 0, 0, 1, 3
"d:\IDEWORK\lvmen\src\licensedcode\data\rules\gpl_117.yml", "YAML", 0, 0, 0, 7, 0, 0, 1, 8
"d:\IDEWORK\lvmen\src\licensedcode\data\rules\gpl_118.yml", "YAML", 0, 0, 0, 5, 0, 0, 1, 6
"d:\IDEWORK\lvmen\src\licensedcode\data\rules\gpl_118_2.yml", "YAML", 0, 0, 0, 5, 0, 0, 1, 6
"d:\IDEWORK\lvmen\src\licensedcode\data\rules\gpl_119.yml", "YAML", 0, 0, 0, 3, 0, 0, 1, 4
"d:\IDEWORK\lvmen\src\licensedcode\data\rules\gpl_12.yml", "YAML", 0, 0, 0, 3, 0, 0, 1, 4
"d:\IDEWORK\lvmen\src\licensedcode\data\rules\gpl_120.yml", "YAML", 0, 0, 0, 3, 0, 0, 1, 4
"d:\IDEWORK\lvmen\src\licensedcode\data\rules\gpl_121.yml", "YAML", 0, 0, 0, 3, 0, 0, 1, 4
"d:\IDEWORK\lvmen\src\licensedcode\data\rules\gpl_122.yml", "YAML", 0, 0, 0, 3, 0, 0, 1, 4
"d:\IDEWORK\lvmen\src\licensedcode\data\rules\gpl_123.yml", "YAML", 0, 0, 0, 3, 0, 0, 1, 4
"d:\IDEWORK\lvmen\src\licensedcode\data\rules\gpl_124.yml", "YAML", 0, 0, 0, 3, 0, 0, 1, 4
"d:\IDEWORK\lvmen\src\licensedcode\data\rules\gpl_125.yml", "YAML", 0, 0, 0, 3, 0, 0, 1, 4
"d:\IDEWORK\lvmen\src\licensedcode\data\rules\gpl_126.yml", "YAML", 0, 0, 0, 3, 0, 0, 1, 4
"d:\IDEWORK\lvmen\src\licensedcode\data\rules\gpl_127.yml", "YAML", 0, 0, 0, 5, 0, 0, 1, 6
"d:\IDEWORK\lvmen\src\licensedcode\data\rules\gpl_128.yml", "YAML", 0, 0, 0, 3, 0, 0, 1, 4
"d:\IDEWORK\lvmen\src\licensedcode\data\rules\gpl_129.yml", "YAML", 0, 0, 0, 3, 0, 0, 1, 4
"d:\IDEWORK\lvmen\src\licensedcode\data\rules\gpl_13.yml", "YAML", 0, 0, 0, 4, 0, 0, 1, 5
"d:\IDEWORK\lvmen\src\licensedcode\data\rules\gpl_130.yml", "YAML", 0, 0, 0, 4, 0, 0, 1, 5
"d:\IDEWORK\lvmen\src\licensedcode\data\rules\gpl_131.yml", "YAML", 0, 0, 0, 2, 0, 0, 1, 3
"d:\IDEWORK\lvmen\src\licensedcode\data\rules\gpl_132.yml", "YAML", 0, 0, 0, 4, 0, 0, 1, 5
"d:\IDEWORK\lvmen\src\licensedcode\data\rules\gpl_133.yml", "YAML", 0, 0, 0, 2, 0, 0, 1, 3
"d:\IDEWORK\lvmen\src\licensedcode\data\rules\gpl_134.yml", "YAML", 0, 0, 0, 2, 0, 0, 1, 3
"d:\IDEWORK\lvmen\src\licensedcode\data\rules\gpl_135.yml", "YAML", 0, 0, 0, 6, 0, 0, 1, 7
"d:\IDEWORK\lvmen\src\licensedcode\data\rules\gpl_136.yml", "YAML", 0, 0, 0, 2, 0, 0, 1, 3
"d:\IDEWORK\lvmen\src\licensedcode\data\rules\gpl_137.yml", "YAML", 0, 0, 0, 2, 0, 0, 1, 3
"d:\IDEWORK\lvmen\src\licensedcode\data\rules\gpl_138.yml", "YAML", 0, 0, 0, 2, 0, 0, 1, 3
"d:\IDEWORK\lvmen\src\licensedcode\data\rules\gpl_139.yml", "YAML", 0, 0, 0, 2, 0, 0, 1, 3
"d:\IDEWORK\lvmen\src\licensedcode\data\rules\gpl_14.yml", "YAML", 0, 0, 0, 3, 0, 0, 1, 4
"d:\IDEWORK\lvmen\src\licensedcode\data\rules\gpl_140.yml", "YAML", 0, 0, 0, 3, 0, 0, 1, 4
"d:\IDEWORK\lvmen\src\licensedcode\data\rules\gpl_141.yml", "YAML", 0, 0, 0, 2, 0, 0, 1, 3
"d:\IDEWORK\lvmen\src\licensedcode\data\rules\gpl_142.yml", "YAML", 0, 0, 0, 3, 0, 0, 1, 4
"d:\IDEWORK\lvmen\src\licensedcode\data\rules\gpl_143.yml", "YAML", 0, 0, 0, 2, 0, 0, 1, 3
"d:\IDEWORK\lvmen\src\licensedcode\data\rules\gpl_144.yml", "YAML", 0, 0, 0, 3, 0, 0, 1, 4
"d:\IDEWORK\lvmen\src\licensedcode\data\rules\gpl_145.yml", "YAML", 0, 0, 0, 3, 0, 0, 1, 4
"d:\IDEWORK\lvmen\src\licensedcode\data\rules\gpl_146.yml", "YAML", 0, 0, 0, 3, 0, 0, 1, 4
"d:\IDEWORK\lvmen\src\licensedcode\data\rules\gpl_147.yml", "YAML", 0, 0, 0, 4, 0, 0, 1, 5
"d:\IDEWORK\lvmen\src\licensedcode\data\rules\gpl_148.yml", "YAML", 0, 0, 0, 2, 0, 0, 1, 3
"d:\IDEWORK\lvmen\src\licensedcode\data\rules\gpl_149.yml", "YAML", 0, 0, 0, 3, 0, 0, 1, 4
"d:\IDEWORK\lvmen\src\licensedcode\data\rules\gpl_15.yml", "YAML", 0, 0, 0, 3, 0, 0, 1, 4
"d:\IDEWORK\lvmen\src\licensedcode\data\rules\gpl_150.yml", "YAML", 0, 0, 0, 5, 0, 0, 1, 6
"d:\IDEWORK\lvmen\src\licensedcode\data\rules\gpl_151.yml", "YAML", 0, 0, 0, 2, 0, 0, 1, 3
"d:\IDEWORK\lvmen\src\licensedcode\data\rules\gpl_152.yml", "YAML", 0, 0, 0, 3, 0, 0, 1, 4
"d:\IDEWORK\lvmen\src\licensedcode\data\rules\gpl_153.yml", "YAML", 0, 0, 0, 2, 0, 0, 1, 3
"d:\IDEWORK\lvmen\src\licensedcode\data\rules\gpl_153_1.yml", "YAML", 0, 0, 0, 2, 0, 0, 1, 3
"d:\IDEWORK\lvmen\src\licensedcode\data\rules\gpl_154.yml", "YAML", 0, 0, 0, 2, 0, 0, 1, 3
"d:\IDEWORK\lvmen\src\licensedcode\data\rules\gpl_155.yml", "YAML", 0, 0, 0, 3, 0, 0, 1, 4
"d:\IDEWORK\lvmen\src\licensedcode\data\rules\gpl_156.yml", "YAML", 0, 0, 0, 3, 0, 0, 1, 4
"d:\IDEWORK\lvmen\src\licensedcode\data\rules\gpl_157.yml", "YAML", 0, 0, 0, 3, 0, 0, 1, 4
"d:\IDEWORK\lvmen\src\licensedcode\data\rules\gpl_158.yml", "YAML", 0, 0, 0, 2, 0, 0, 1, 3
"d:\IDEWORK\lvmen\src\licensedcode\data\rules\gpl_159.yml", "YAML", 0, 0, 0, 3, 0, 0, 1, 4
"d:\IDEWORK\lvmen\src\licensedcode\data\rules\gpl_16.yml", "YAML", 0, 0, 0, 3, 0, 0, 1, 4
"d:\IDEWORK\lvmen\src\licensedcode\data\rules\gpl_160.yml", "YAML", 0, 0, 0, 3, 0, 0, 1, 4
"d:\IDEWORK\lvmen\src\licensedcode\data\rules\gpl_161.yml", "YAML", 0, 0, 0, 3, 0, 0, 1, 4
"d:\IDEWORK\lvmen\src\licensedcode\data\rules\gpl_162.yml", "YAML", 0, 0, 0, 5, 0, 0, 1, 6
"d:\IDEWORK\lvmen\src\licensedcode\data\rules\gpl_163.yml", "YAML", 0, 0, 0, 3, 0, 0, 1, 4
"d:\IDEWORK\lvmen\src\licensedcode\data\rules\gpl_164.yml", "YAML", 0, 0, 0, 3, 0, 0, 1, 4
"d:\IDEWORK\lvmen\src\licensedcode\data\rules\gpl_165.yml", "YAML", 0, 0, 0, 5, 0, 0, 1, 6
"d:\IDEWORK\lvmen\src\licensedcode\data\rules\gpl_166.yml", "YAML", 0, 0, 0, 5, 0, 0, 1, 6
"d:\IDEWORK\lvmen\src\licensedcode\data\rules\gpl_167.yml", "YAML", 0, 0, 0, 5, 0, 0, 1, 6
"d:\IDEWORK\lvmen\src\licensedcode\data\rules\gpl_168.yml", "YAML", 0, 0, 0, 5, 0, 0, 1, 6
"d:\IDEWORK\lvmen\src\licensedcode\data\rules\gpl_169.yml", "YAML", 0, 0, 0, 3, 0, 0, 1, 4
"d:\IDEWORK\lvmen\src\licensedcode\data\rules\gpl_17.yml", "YAML", 0, 0, 0, 4, 0, 0, 1, 5
"d:\IDEWORK\lvmen\src\licensedcode\data\rules\gpl_170.yml", "YAML", 0, 0, 0, 3, 0, 0, 1, 4
"d:\IDEWORK\lvmen\src\licensedcode\data\rules\gpl_171.yml", "YAML", 0, 0, 0, 3, 0, 0, 1, 4
"d:\IDEWORK\lvmen\src\licensedcode\data\rules\gpl_172.yml", "YAML", 0, 0, 0, 3, 0, 0, 1, 4
"d:\IDEWORK\lvmen\src\licensedcode\data\rules\gpl_173.yml", "YAML", 0, 0, 0, 3, 0, 0, 1, 4
"d:\IDEWORK\lvmen\src\licensedcode\data\rules\gpl_174.yml", "YAML", 0, 0, 0, 5, 0, 0, 1, 6
"d:\IDEWORK\lvmen\src\licensedcode\data\rules\gpl_175.yml", "YAML", 0, 0, 0, 3, 0, 0, 1, 4
"d:\IDEWORK\lvmen\src\licensedcode\data\rules\gpl_176.yml", "YAML", 0, 0, 0, 5, 0, 0, 1, 6
"d:\IDEWORK\lvmen\src\licensedcode\data\rules\gpl_177.yml", "YAML", 0, 0, 0, 3, 0, 0, 1, 4
"d:\IDEWORK\lvmen\src\licensedcode\data\rules\gpl_178.yml", "YAML", 0, 0, 0, 3, 0, 0, 1, 4
"d:\IDEWORK\lvmen\src\licensedcode\data\rules\gpl_179.yml", "YAML", 0, 0, 0, 3, 0, 0, 1, 4
"d:\IDEWORK\lvmen\src\licensedcode\data\rules\gpl_18.yml", "YAML", 0, 0, 0, 3, 0, 0, 1, 4
"d:\IDEWORK\lvmen\src\licensedcode\data\rules\gpl_180.yml", "YAML", 0, 0, 0, 4, 0, 0, 1, 5
"d:\IDEWORK\lvmen\src\licensedcode\data\rules\gpl_181.yml", "YAML", 0, 0, 0, 4, 0, 0, 1, 5
"d:\IDEWORK\lvmen\src\licensedcode\data\rules\gpl_182.yml", "YAML", 0, 0, 0, 2, 0, 0, 1, 3
"d:\IDEWORK\lvmen\src\licensedcode\data\rules\gpl_183.yml", "YAML", 0, 0, 0, 3, 0, 0, 1, 4
"d:\IDEWORK\lvmen\src\licensedcode\data\rules\gpl_184.yml", "YAML", 0, 0, 0, 3, 0, 0, 1, 4
"d:\IDEWORK\lvmen\src\licensedcode\data\rules\gpl_185.yml", "YAML", 0, 0, 0, 4, 0, 0, 1, 5
"d:\IDEWORK\lvmen\src\licensedcode\data\rules\gpl_186.yml", "YAML", 0, 0, 0, 3, 0, 0, 1, 4
"d:\IDEWORK\lvmen\src\licensedcode\data\rules\gpl_187.yml", "YAML", 0, 0, 0, 3, 0, 0, 1, 4
"d:\IDEWORK\lvmen\src\licensedcode\data\rules\gpl_188.yml", "YAML", 0, 0, 0, 3, 0, 0, 1, 4
"d:\IDEWORK\lvmen\src\licensedcode\data\rules\gpl_189.yml", "YAML", 0, 0, 0, 3, 0, 0, 1, 4
"d:\IDEWORK\lvmen\src\licensedcode\data\rules\gpl_19.yml", "YAML", 0, 0, 0, 7, 0, 0, 1, 8
"d:\IDEWORK\lvmen\src\licensedcode\data\rules\gpl_190.yml", "YAML", 0, 0, 0, 3, 0, 0, 1, 4
"d:\IDEWORK\lvmen\src\licensedcode\data\rules\gpl_191.yml", "YAML", 0, 0, 0, 3, 0, 0, 1, 4
"d:\IDEWORK\lvmen\src\licensedcode\data\rules\gpl_192.yml", "YAML", 0, 0, 0, 3, 0, 0, 1, 4
"d:\IDEWORK\lvmen\src\licensedcode\data\rules\gpl_193.yml", "YAML", 0, 0, 0, 3, 0, 0, 1, 4
"d:\IDEWORK\lvmen\src\licensedcode\data\rules\gpl_194.yml", "YAML", 0, 0, 0, 3, 0, 0, 1, 4
"d:\IDEWORK\lvmen\src\licensedcode\data\rules\gpl_194_1.yml", "YAML", 0, 0, 0, 5, 0, 0, 1, 6
"d:\IDEWORK\lvmen\src\licensedcode\data\rules\gpl_195.yml", "YAML", 0, 0, 0, 3, 0, 0, 1, 4
"d:\IDEWORK\lvmen\src\licensedcode\data\rules\gpl_196.yml", "YAML", 0, 0, 0, 3, 0, 0, 1, 4
"d:\IDEWORK\lvmen\src\licensedcode\data\rules\gpl_197.yml", "YAML", 0, 0, 0, 2, 0, 0, 1, 3
"d:\IDEWORK\lvmen\src\licensedcode\data\rules\gpl_198.yml", "YAML", 0, 0, 0, 3, 0, 0, 1, 4
"d:\IDEWORK\lvmen\src\licensedcode\data\rules\gpl_199.yml", "YAML", 0, 0, 0, 3, 0, 0, 1, 4
"d:\IDEWORK\lvmen\src\licensedcode\data\rules\gpl_2.yml", "YAML", 0, 0, 0, 3, 0, 0, 1, 4
"d:\IDEWORK\lvmen\src\licensedcode\data\rules\gpl_20.yml", "YAML", 0, 0, 0, 3, 0, 0, 1, 4
"d:\IDEWORK\lvmen\src\licensedcode\data\rules\gpl_200.yml", "YAML", 0, 0, 0, 3, 0, 0, 1, 4
"d:\IDEWORK\lvmen\src\licensedcode\data\rules\gpl_200_1.yml", "YAML", 0, 0, 0, 3, 0, 0, 1, 4
"d:\IDEWORK\lvmen\src\licensedcode\data\rules\gpl_201.yml", "YAML", 0, 0, 0, 3, 0, 0, 1, 4
"d:\IDEWORK\lvmen\src\licensedcode\data\rules\gpl_203.yml", "YAML", 0, 0, 0, 3, 0, 0, 1, 4
"d:\IDEWORK\lvmen\src\licensedcode\data\rules\gpl_204.yml", "YAML", 0, 0, 0, 3, 0, 0, 1, 4
"d:\IDEWORK\lvmen\src\licensedcode\data\rules\gpl_205.yml", "YAML", 0, 0, 0, 3, 0, 0, 1, 4
"d:\IDEWORK\lvmen\src\licensedcode\data\rules\gpl_206.yml", "YAML", 0, 0, 0, 3, 0, 0, 1, 4
"d:\IDEWORK\lvmen\src\licensedcode\data\rules\gpl_207.yml", "YAML", 0, 0, 0, 3, 0, 0, 1, 4
"d:\IDEWORK\lvmen\src\licensedcode\data\rules\gpl_208.yml", "YAML", 0, 0, 0, 3, 0, 0, 1, 4
"d:\IDEWORK\lvmen\src\licensedcode\data\rules\gpl_209.yml", "YAML", 0, 0, 0, 3, 0, 0, 1, 4
"d:\IDEWORK\lvmen\src\licensedcode\data\rules\gpl_21.yml", "YAML", 0, 0, 0, 2, 0, 0, 1, 3
"d:\IDEWORK\lvmen\src\licensedcode\data\rules\gpl_210.yml", "YAML", 0, 0, 0, 3, 0, 0, 1, 4
"d:\IDEWORK\lvmen\src\licensedcode\data\rules\gpl_211.yml", "YAML", 0, 0, 0, 2, 0, 0, 1, 3
"d:\IDEWORK\lvmen\src\licensedcode\data\rules\gpl_212.yml", "YAML", 0, 0, 0, 3, 0, 0, 1, 4
"d:\IDEWORK\lvmen\src\licensedcode\data\rules\gpl_213.yml", "YAML", 0, 0, 0, 3, 0, 0, 1, 4
"d:\IDEWORK\lvmen\src\licensedcode\data\rules\gpl_214.yml", "YAML", 0, 0, 0, 3, 0, 0, 1, 4
"d:\IDEWORK\lvmen\src\licensedcode\data\rules\gpl_215.yml", "YAML", 0, 0, 0, 2, 0, 0, 1, 3
"d:\IDEWORK\lvmen\src\licensedcode\data\rules\gpl_216.yml", "YAML", 0, 0, 0, 4, 0, 0, 1, 5
"d:\IDEWORK\lvmen\src\licensedcode\data\rules\gpl_217.yml", "YAML", 0, 0, 0, 4, 0, 0, 1, 5
"d:\IDEWORK\lvmen\src\licensedcode\data\rules\gpl_218.yml", "YAML", 0, 0, 0, 3, 0, 0, 1, 4
"d:\IDEWORK\lvmen\src\licensedcode\data\rules\gpl_219.yml", "YAML", 0, 0, 0, 3, 0, 0, 1, 4
"d:\IDEWORK\lvmen\src\licensedcode\data\rules\gpl_22.yml", "YAML", 0, 0, 0, 3, 0, 0, 1, 4
"d:\IDEWORK\lvmen\src\licensedcode\data\rules\gpl_220.yml", "YAML", 0, 0, 0, 3, 0, 0, 1, 4
"d:\IDEWORK\lvmen\src\licensedcode\data\rules\gpl_221.yml", "YAML", 0, 0, 0, 3, 0, 0, 1, 4
"d:\IDEWORK\lvmen\src\licensedcode\data\rules\gpl_222.yml", "YAML", 0, 0, 0, 3, 0, 0, 1, 4
"d:\IDEWORK\lvmen\src\licensedcode\data\rules\gpl_223.yml", "YAML", 0, 0, 0, 5, 0, 0, 1, 6
"d:\IDEWORK\lvmen\src\licensedcode\data\rules\gpl_224.yml", "YAML", 0, 0, 0, 5, 0, 0, 1, 6
"d:\IDEWORK\lvmen\src\licensedcode\data\rules\gpl_225.yml", "YAML", 0, 0, 0, 5, 0, 0, 1, 6
"d:\IDEWORK\lvmen\src\licensedcode\data\rules\gpl_226.yml", "YAML", 0, 0, 0, 3, 0, 0, 1, 4
"d:\IDEWORK\lvmen\src\licensedcode\data\rules\gpl_227.yml", "YAML", 0, 0, 0, 3, 0, 0, 1, 4
"d:\IDEWORK\lvmen\src\licensedcode\data\rules\gpl_228.yml", "YAML", 0, 0, 0, 3, 0, 0, 1, 4
"d:\IDEWORK\lvmen\src\licensedcode\data\rules\gpl_229.yml", "YAML", 0, 0, 0, 3, 0, 0, 1, 4
"d:\IDEWORK\lvmen\src\licensedcode\data\rules\gpl_23.yml", "YAML", 0, 0, 0, 3, 0, 0, 1, 4
"d:\IDEWORK\lvmen\src\licensedcode\data\rules\gpl_230.yml", "YAML", 0, 0, 0, 5, 0, 0, 1, 6
"d:\IDEWORK\lvmen\src\licensedcode\data\rules\gpl_231.yml", "YAML", 0, 0, 0, 5, 0, 0, 1, 6
"d:\IDEWORK\lvmen\src\licensedcode\data\rules\gpl_232.yml", "YAML", 0, 0, 0, 6, 0, 0, 1, 7
"d:\IDEWORK\lvmen\src\licensedcode\data\rules\gpl_233.yml", "YAML", 0, 0, 0, 3, 0, 0, 1, 4
"d:\IDEWORK\lvmen\src\licensedcode\data\rules\gpl_234.yml", "YAML", 0, 0, 0, 3, 0, 0, 1, 4
"d:\IDEWORK\lvmen\src\licensedcode\data\rules\gpl_235.yml", "YAML", 0, 0, 0, 3, 0, 0, 1, 4
"d:\IDEWORK\lvmen\src\licensedcode\data\rules\gpl_236.yml", "YAML", 0, 0, 0, 3, 0, 0, 1, 4
"d:\IDEWORK\lvmen\src\licensedcode\data\rules\gpl_237.yml", "YAML", 0, 0, 0, 3, 0, 0, 1, 4
"d:\IDEWORK\lvmen\src\licensedcode\data\rules\gpl_238.yml", "YAML", 0, 0, 0, 5, 0, 0, 1, 6
"d:\IDEWORK\lvmen\src\licensedcode\data\rules\gpl_239.yml", "YAML", 0, 0, 0, 3, 0, 0, 1, 4
"d:\IDEWORK\lvmen\src\licensedcode\data\rules\gpl_24.yml", "YAML", 0, 0, 0, 4, 0, 0, 1, 5
"d:\IDEWORK\lvmen\src\licensedcode\data\rules\gpl_240.yml", "YAML", 0, 0, 0, 3, 0, 0, 1, 4
"d:\IDEWORK\lvmen\src\licensedcode\data\rules\gpl_241.yml", "YAML", 0, 0, 0, 3, 0, 0, 1, 4
"d:\IDEWORK\lvmen\src\licensedcode\data\rules\gpl_242.yml", "YAML", 0, 0, 0, 3, 0, 0, 1, 4
"d:\IDEWORK\lvmen\src\licensedcode\data\rules\gpl_243.yml", "YAML", 0, 0, 0, 3, 0, 0, 1, 4
"d:\IDEWORK\lvmen\src\licensedcode\data\rules\gpl_244.yml", "YAML", 0, 0, 0, 3, 0, 0, 1, 4
"d:\IDEWORK\lvmen\src\licensedcode\data\rules\gpl_245.yml", "YAML", 0, 0, 0, 3, 0, 0, 1, 4
"d:\IDEWORK\lvmen\src\licensedcode\data\rules\gpl_246.yml", "YAML", 0, 0, 0, 3, 0, 0, 1, 4
"d:\IDEWORK\lvmen\src\licensedcode\data\rules\gpl_25.yml", "YAML", 0, 0, 0, 4, 0, 0, 1, 5
"d:\IDEWORK\lvmen\src\licensedcode\data\rules\gpl_26.yml", "YAML", 0, 0, 0, 3, 0, 0, 1, 4
"d:\IDEWORK\lvmen\src\licensedcode\data\rules\gpl_27.yml", "YAML", 0, 0, 0, 4, 0, 0, 1, 5
"d:\IDEWORK\lvmen\src\licensedcode\data\rules\gpl_28.yml", "YAML", 0, 0, 0, 3, 0, 0, 1, 4
"d:\IDEWORK\lvmen\src\licensedcode\data\rules\gpl_29.yml", "YAML", 0, 0, 0, 5, 0, 0, 1, 6
"d:\IDEWORK\lvmen\src\licensedcode\data\rules\gpl_3.yml", "YAML", 0, 0, 0, 3, 0, 0, 1, 4
"d:\IDEWORK\lvmen\src\licensedcode\data\rules\gpl_30.yml", "YAML", 0, 0, 0, 4, 0, 0, 1, 5
"d:\IDEWORK\lvmen\src\licensedcode\data\rules\gpl_31.yml", "YAML", 0, 0, 0, 4, 0, 0, 1, 5
"d:\IDEWORK\lvmen\src\licensedcode\data\rules\gpl_32.yml", "YAML", 0, 0, 0, 2, 0, 0, 1, 3
"d:\IDEWORK\lvmen\src\licensedcode\data\rules\gpl_33.yml", "YAML", 0, 0, 0, 6, 0, 0, 1, 7
"d:\IDEWORK\lvmen\src\licensedcode\data\rules\gpl_34.yml", "YAML", 0, 0, 0, 3, 0, 0, 1, 4
"d:\IDEWORK\lvmen\src\licensedcode\data\rules\gpl_35.yml", "YAML", 0, 0, 0, 6, 0, 0, 1, 7
"d:\IDEWORK\lvmen\src\licensedcode\data\rules\gpl_36.yml", "YAML", 0, 0, 0, 4, 0, 0, 1, 5
"d:\IDEWORK\lvmen\src\licensedcode\data\rules\gpl_37.yml", "YAML", 0, 0, 0, 3, 0, 0, 1, 4
"d:\IDEWORK\lvmen\src\licensedcode\data\rules\gpl_38.yml", "YAML", 0, 0, 0, 3, 0, 0, 1, 4
"d:\IDEWORK\lvmen\src\licensedcode\data\rules\gpl_39.yml", "YAML", 0, 0, 0, 3, 0, 0, 1, 4
"d:\IDEWORK\lvmen\src\licensedcode\data\rules\gpl_4.yml", "YAML", 0, 0, 0, 3, 0, 0, 1, 4
"d:\IDEWORK\lvmen\src\licensedcode\data\rules\gpl_40.yml", "YAML", 0, 0, 0, 3, 0, 0, 1, 4
"d:\IDEWORK\lvmen\src\licensedcode\data\rules\gpl_41.yml", "YAML", 0, 0, 0, 4, 0, 0, 1, 5
"d:\IDEWORK\lvmen\src\licensedcode\data\rules\gpl_42.yml", "YAML", 0, 0, 0, 4, 0, 0, 1, 5
"d:\IDEWORK\lvmen\src\licensedcode\data\rules\gpl_43.yml", "YAML", 0, 0, 0, 4, 0, 0, 1, 5
"d:\IDEWORK\lvmen\src\licensedcode\data\rules\gpl_44.yml", "YAML", 0, 0, 0, 3, 0, 0, 1, 4
"d:\IDEWORK\lvmen\src\licensedcode\data\rules\gpl_45.yml", "YAML", 0, 0, 0, 2, 0, 0, 1, 3
"d:\IDEWORK\lvmen\src\licensedcode\data\rules\gpl_46.yml", "YAML", 0, 0, 0, 3, 0, 0, 1, 4
"d:\IDEWORK\lvmen\src\licensedcode\data\rules\gpl_47.yml", "YAML", 0, 0, 0, 2, 0, 0, 1, 3
"d:\IDEWORK\lvmen\src\licensedcode\data\rules\gpl_48.yml", "YAML", 0, 0, 0, 3, 0, 0, 1, 4
"d:\IDEWORK\lvmen\src\licensedcode\data\rules\gpl_49.yml", "YAML", 0, 0, 0, 3, 0, 0, 1, 4
"d:\IDEWORK\lvmen\src\licensedcode\data\rules\gpl_5.yml", "YAML", 0, 0, 0, 4, 0, 0, 1, 5
"d:\IDEWORK\lvmen\src\licensedcode\data\rules\gpl_50.yml", "YAML", 0, 0, 0, 3, 0, 0, 1, 4
"d:\IDEWORK\lvmen\src\licensedcode\data\rules\gpl_51.yml", "YAML", 0, 0, 0, 5, 0, 0, 1, 6
"d:\IDEWORK\lvmen\src\licensedcode\data\rules\gpl_52.yml", "YAML", 0, 0, 0, 14, 0, 0, 1, 15
"d:\IDEWORK\lvmen\src\licensedcode\data\rules\gpl_53.yml", "YAML", 0, 0, 0, 4, 0, 0, 1, 5
"d:\IDEWORK\lvmen\src\licensedcode\data\rules\gpl_54.yml", "YAML", 0, 0, 0, 4, 0, 0, 1, 5
"d:\IDEWORK\lvmen\src\licensedcode\data\rules\gpl_55.yml", "YAML", 0, 0, 0, 4, 0, 0, 1, 5
"d:\IDEWORK\lvmen\src\licensedcode\data\rules\gpl_56.yml", "YAML", 0, 0, 0, 3, 0, 0, 1, 4
"d:\IDEWORK\lvmen\src\licensedcode\data\rules\gpl_57.yml", "YAML", 0, 0, 0, 3, 0, 0, 1, 4
"d:\IDEWORK\lvmen\src\licensedcode\data\rules\gpl_58.yml", "YAML", 0, 0, 0, 2, 0, 0, 1, 3
"d:\IDEWORK\lvmen\src\licensedcode\data\rules\gpl_59.yml", "YAML", 0, 0, 0, 5, 0, 0, 1, 6
"d:\IDEWORK\lvmen\src\licensedcode\data\rules\gpl_6.yml", "YAML", 0, 0, 0, 3, 0, 0, 1, 4
"d:\IDEWORK\lvmen\src\licensedcode\data\rules\gpl_60.yml", "YAML", 0, 0, 0, 5, 0, 0, 1, 6
"d:\IDEWORK\lvmen\src\licensedcode\data\rules\gpl_61.yml", "YAML", 0, 0, 0, 3, 0, 0, 1, 4
"d:\IDEWORK\lvmen\src\licensedcode\data\rules\gpl_62.yml", "YAML", 0, 0, 0, 3, 0, 0, 1, 4
"d:\IDEWORK\lvmen\src\licensedcode\data\rules\gpl_63.yml", "YAML", 0, 0, 0, 5, 0, 0, 1, 6
"d:\IDEWORK\lvmen\src\licensedcode\data\rules\gpl_64.yml", "YAML", 0, 0, 0, 6, 0, 0, 1, 7
"d:\IDEWORK\lvmen\src\licensedcode\data\rules\gpl_65.yml", "YAML", 0, 0, 0, 3, 0, 0, 1, 4
"d:\IDEWORK\lvmen\src\licensedcode\data\rules\gpl_66.yml", "YAML", 0, 0, 0, 2, 0, 0, 1, 3
"d:\IDEWORK\lvmen\src\licensedcode\data\rules\gpl_67.yml", "YAML", 0, 0, 0, 2, 0, 0, 1, 3
"d:\IDEWORK\lvmen\src\licensedcode\data\rules\gpl_68.yml", "YAML", 0, 0, 0, 3, 0, 0, 1, 4
"d:\IDEWORK\lvmen\src\licensedcode\data\rules\gpl_69.yml", "YAML", 0, 0, 0, 3, 0, 0, 1, 4
"d:\IDEWORK\lvmen\src\licensedcode\data\rules\gpl_7.yml", "YAML", 0, 0, 0, 3, 0, 0, 1, 4
"d:\IDEWORK\lvmen\src\licensedcode\data\rules\gpl_70.yml", "YAML", 0, 0, 0, 3, 0, 0, 1, 4
"d:\IDEWORK\lvmen\src\licensedcode\data\rules\gpl_71.yml", "YAML", 0, 0, 0, 5, 0, 0, 1, 6
"d:\IDEWORK\lvmen\src\licensedcode\data\rules\gpl_72.yml", "YAML", 0, 0, 0, 3, 0, 0, 1, 4
"d:\IDEWORK\lvmen\src\licensedcode\data\rules\gpl_73.yml", "YAML", 0, 0, 0, 6, 0, 0, 1, 7
"d:\IDEWORK\lvmen\src\licensedcode\data\rules\gpl_74.yml", "YAML", 0, 0, 0, 2, 0, 0, 1, 3
"d:\IDEWORK\lvmen\src\licensedcode\data\rules\gpl_75.yml", "YAML", 0, 0, 0, 3, 0, 0, 1, 4
"d:\IDEWORK\lvmen\src\licensedcode\data\rules\gpl_76.yml", "YAML", 0, 0, 0, 3, 0, 0, 1, 4
"d:\IDEWORK\lvmen\src\licensedcode\data\rules\gpl_77.yml", "YAML", 0, 0, 0, 2, 0, 0, 1, 3
"d:\IDEWORK\lvmen\src\licensedcode\data\rules\gpl_78.yml", "YAML", 0, 0, 0, 4, 0, 0, 1, 5
"d:\IDEWORK\lvmen\src\licensedcode\data\rules\gpl_79.yml", "YAML", 0, 0, 0, 5, 0, 0, 1, 6
"d:\IDEWORK\lvmen\src\licensedcode\data\rules\gpl_8.yml", "YAML", 0, 0, 0, 4, 0, 0, 1, 5
"d:\IDEWORK\lvmen\src\licensedcode\data\rules\gpl_80.yml", "YAML", 0, 0, 0, 3, 0, 0, 1, 4
"d:\IDEWORK\lvmen\src\licensedcode\data\rules\gpl_81.yml", "YAML", 0, 0, 0, 3, 0, 0, 1, 4
"d:\IDEWORK\lvmen\src\licensedcode\data\rules\gpl_82.yml", "YAML", 0, 0, 0, 2, 0, 0, 1, 3
"d:\IDEWORK\lvmen\src\licensedcode\data\rules\gpl_83.yml", "YAML", 0, 0, 0, 3, 0, 0, 1, 4
"d:\IDEWORK\lvmen\src\licensedcode\data\rules\gpl_84.yml", "YAML", 0, 0, 0, 3, 0, 0, 1, 4
"d:\IDEWORK\lvmen\src\licensedcode\data\rules\gpl_85.yml", "YAML", 0, 0, 0, 3, 0, 0, 1, 4
"d:\IDEWORK\lvmen\src\licensedcode\data\rules\gpl_86.yml", "YAML", 0, 0, 0, 3, 0, 0, 1, 4
"d:\IDEWORK\lvmen\src\licensedcode\data\rules\gpl_87.yml", "YAML", 0, 0, 0, 5, 0, 0, 1, 6
"d:\IDEWORK\lvmen\src\licensedcode\data\rules\gpl_88.yml", "YAML", 0, 0, 0, 3, 0, 0, 1, 4
"d:\IDEWORK\lvmen\src\licensedcode\data\rules\gpl_89.yml", "YAML", 0, 0, 0, 3, 0, 0, 1, 4
"d:\IDEWORK\lvmen\src\licensedcode\data\rules\gpl_9.yml", "YAML", 0, 0, 0, 3, 0, 0, 1, 4
"d:\IDEWORK\lvmen\src\licensedcode\data\rules\gpl_90.yml", "YAML", 0, 0, 0, 3, 0, 0, 1, 4
"d:\IDEWORK\lvmen\src\licensedcode\data\rules\gpl_91.yml", "YAML", 0, 0, 0, 2, 0, 0, 1, 3
"d:\IDEWORK\lvmen\src\licensedcode\data\rules\gpl_92.yml", "YAML", 0, 0, 0, 3, 0, 0, 1, 4
"d:\IDEWORK\lvmen\src\licensedcode\data\rules\gpl_93.yml", "YAML", 0, 0, 0, 2, 0, 0, 1, 3
"d:\IDEWORK\lvmen\src\licensedcode\data\rules\gpl_94.yml", "YAML", 0, 0, 0, 5, 0, 0, 1, 6
"d:\IDEWORK\lvmen\src\licensedcode\data\rules\gpl_95.yml", "YAML", 0, 0, 0, 3, 0, 0, 1, 4
"d:\IDEWORK\lvmen\src\licensedcode\data\rules\gpl_96.yml", "YAML", 0, 0, 0, 5, 0, 0, 1, 6
"d:\IDEWORK\lvmen\src\licensedcode\data\rules\gpl_97.yml", "YAML", 0, 0, 0, 3, 0, 0, 1, 4
"d:\IDEWORK\lvmen\src\licensedcode\data\rules\gpl_98.yml", "YAML", 0, 0, 0, 2, 0, 0, 1, 3
"d:\IDEWORK\lvmen\src\licensedcode\data\rules\gpl_99.yml", "YAML", 0, 0, 0, 3, 0, 0, 1, 4
"d:\IDEWORK\lvmen\src\licensedcode\data\rules\gpl_and_crypto-keys-redistribution.yml", "YAML", 0, 0, 0, 3, 0, 0, 1, 4
"d:\IDEWORK\lvmen\src\licensedcode\data\rules\gpl_and_jpeg.yml", "YAML", 0, 0, 0, 8, 0, 0, 1, 9
"d:\IDEWORK\lvmen\src\licensedcode\data\rules\gpl_and_lgpl-2.1-plus.yml", "YAML", 0, 0, 0, 5, 0, 0, 1, 6
"d:\IDEWORK\lvmen\src\licensedcode\data\rules\gpl_and_lgpl-2.1-plus_2.yml", "YAML", 0, 0, 0, 4, 0, 0, 1, 5
"d:\IDEWORK\lvmen\src\licensedcode\data\rules\gpl_and_lgpl_1.yml", "YAML", 0, 0, 0, 3, 0, 0, 1, 4
"d:\IDEWORK\lvmen\src\licensedcode\data\rules\gpl_and_lgpl_10.yml", "YAML", 0, 0, 0, 4, 0, 0, 1, 5
"d:\IDEWORK\lvmen\src\licensedcode\data\rules\gpl_and_lgpl_2.yml", "YAML", 0, 0, 0, 4, 0, 0, 1, 5
"d:\IDEWORK\lvmen\src\licensedcode\data\rules\gpl_and_lgpl_3.yml", "YAML", 0, 0, 0, 3, 0, 0, 1, 4
"d:\IDEWORK\lvmen\src\licensedcode\data\rules\gpl_and_lgpl_4.yml", "YAML", 0, 0, 0, 3, 0, 0, 1, 4
"d:\IDEWORK\lvmen\src\licensedcode\data\rules\gpl_and_lgpl_5.yml", "YAML", 0, 0, 0, 2, 0, 0, 1, 3
"d:\IDEWORK\lvmen\src\licensedcode\data\rules\gpl_and_lgpl_6.yml", "YAML", 0, 0, 0, 2, 0, 0, 1, 3
"d:\IDEWORK\lvmen\src\licensedcode\data\rules\gpl_and_lgpl_and_free-unknown.yml", "YAML", 0, 0, 0, 3, 0, 0, 1, 4
"d:\IDEWORK\lvmen\src\licensedcode\data\rules\gpl_and_lgpl_and_free-unknown2.yml", "YAML", 0, 0, 0, 3, 0, 0, 1, 4
"d:\IDEWORK\lvmen\src\licensedcode\data\rules\gpl_and_lgpl_and_gfdl-1.2.yml", "YAML", 0, 0, 0, 2, 0, 0, 1, 3
"d:\IDEWORK\lvmen\src\licensedcode\data\rules\gpl_and_lgpl_or_bsd-simplified.yml", "YAML", 0, 0, 0, 2, 0, 0, 1, 3
"d:\IDEWORK\lvmen\src\licensedcode\data\rules\gpl_and_ossn-3.0.yml", "YAML", 0, 0, 0, 5, 0, 0, 1, 6
"d:\IDEWORK\lvmen\src\licensedcode\data\rules\gpl_bare_gnu_gpl.yml", "YAML", 0, 0, 0, 3, 0, 0, 1, 4
"d:\IDEWORK\lvmen\src\licensedcode\data\rules\gpl_bare_word_only.yml", "YAML", 0, 0, 0, 3, 0, 0, 1, 4
"d:\IDEWORK\lvmen\src\licensedcode\data\rules\gpl_copying_gpl.yml", "YAML", 0, 0, 0, 3, 0, 0, 1, 4
"d:\IDEWORK\lvmen\src\licensedcode\data\rules\gpl_debian.yml", "YAML", 0, 0, 0, 3, 0, 0, 1, 4
"d:\IDEWORK\lvmen\src\licensedcode\data\rules\gpl_debian2.yml", "YAML", 0, 0, 0, 4, 0, 0, 1, 5
"d:\IDEWORK\lvmen\src\licensedcode\data\rules\gpl_may.yml", "YAML", 0, 0, 0, 3, 0, 0, 1, 4
"d:\IDEWORK\lvmen\src\licensedcode\data\rules\gpl_not_lgpl_lesser.yml", "YAML", 0, 0, 0, 2, 0, 0, 1, 3
"d:\IDEWORK\lvmen\src\licensedcode\data\rules\gpl_not_not-a-license_16.yml", "YAML", 0, 0, 0, 5, 0, 0, 1, 6
"d:\IDEWORK\lvmen\src\licensedcode\data\rules\gpl_or_lgpl_1.yml", "YAML", 0, 0, 0, 3, 0, 0, 1, 4
"d:\IDEWORK\lvmen\src\licensedcode\data\rules\gpl_or_lgpl_10.yml", "YAML", 0, 0, 0, 3, 0, 0, 1, 4
"d:\IDEWORK\lvmen\src\licensedcode\data\rules\gpl_or_lgpl_11.yml", "YAML", 0, 0, 0, 3, 0, 0, 1, 4
"d:\IDEWORK\lvmen\src\licensedcode\data\rules\gpl_or_lgpl_12.yml", "YAML", 0, 0, 0, 3, 0, 0, 1, 4
"d:\IDEWORK\lvmen\src\licensedcode\data\rules\gpl_or_lgpl_2.yml", "YAML", 0, 0, 0, 3, 0, 0, 1, 4
"d:\IDEWORK\lvmen\src\licensedcode\data\rules\gpl_or_lgpl_3.yml", "YAML", 0, 0, 0, 3, 0, 0, 1, 4
"d:\IDEWORK\lvmen\src\licensedcode\data\rules\gpl_or_lgpl_4.yml", "YAML", 0, 0, 0, 3, 0, 0, 1, 4
"d:\IDEWORK\lvmen\src\licensedcode\data\rules\gpl_or_lgpl_5.yml", "YAML", 0, 0, 0, 4, 0, 0, 1, 5
"d:\IDEWORK\lvmen\src\licensedcode\data\rules\gpl_or_lgpl_6.yml", "YAML", 0, 0, 0, 3, 0, 0, 1, 4
"d:\IDEWORK\lvmen\src\licensedcode\data\rules\gpl_or_lgpl_7.yml", "YAML", 0, 0, 0, 3, 0, 0, 1, 4
"d:\IDEWORK\lvmen\src\licensedcode\data\rules\gpl_or_lgpl_8.yml", "YAML", 0, 0, 0, 3, 0, 0, 1, 4
"d:\IDEWORK\lvmen\src\licensedcode\data\rules\gpl_or_lgpl_9.yml", "YAML", 0, 0, 0, 3, 0, 0, 1, 4
"d:\IDEWORK\lvmen\src\licensedcode\data\rules\gpl_or_mit.yml", "YAML", 0, 0, 0, 3, 0, 0, 1, 4
"d:\IDEWORK\lvmen\src\licensedcode\data\rules\gpl_or_mit_1.yml", "YAML", 0, 0, 0, 5, 0, 0, 1, 6
"d:\IDEWORK\lvmen\src\licensedcode\data\rules\gpl_or_mit_2.yml", "YAML", 0, 0, 0, 3, 0, 0, 1, 4
"d:\IDEWORK\lvmen\src\licensedcode\data\rules\gpl_or_mit_3.yml", "YAML", 0, 0, 0, 3, 0, 0, 1, 4
"d:\IDEWORK\lvmen\src\licensedcode\data\rules\gpl_or_mit_4.yml", "YAML", 0, 0, 0, 3, 0, 0, 1, 4
"d:\IDEWORK\lvmen\src\licensedcode\data\rules\gplcc-1.0_brief.yml", "YAML", 0, 0, 0, 3, 0, 0, 1, 4
"d:\IDEWORK\lvmen\src\licensedcode\data\rules\gplcc-1.0_ca.yml", "YAML", 0, 0, 0, 2, 0, 0, 1, 3
"d:\IDEWORK\lvmen\src\licensedcode\data\rules\gplcc-1.0_cisco.yml", "YAML", 0, 0, 0, 2, 0, 0, 1, 3
"d:\IDEWORK\lvmen\src\licensedcode\data\rules\gplcc-1.0_google.yml", "YAML", 0, 0, 0, 2, 0, 0, 1, 3
"d:\IDEWORK\lvmen\src\licensedcode\data\rules\gplcc-1.0_individual.yml", "YAML", 0, 0, 0, 3, 0, 0, 1, 4
"d:\IDEWORK\lvmen\src\licensedcode\data\rules\gplcc-1.0_kernel.yml", "YAML", 0, 0, 0, 3, 0, 0, 1, 4
"d:\IDEWORK\lvmen\src\licensedcode\data\rules\gplcc-1.0_microsoft.yml", "YAML", 0, 0, 0, 2, 0, 0, 1, 3
"d:\IDEWORK\lvmen\src\licensedcode\data\rules\gplcc-1.0_original.yml", "YAML", 0, 0, 0, 2, 0, 0, 1, 3
"d:\IDEWORK\lvmen\src\licensedcode\data\rules\gplcc-1.0_plain.yml", "YAML", 0, 0, 0, 2, 0, 0, 1, 3
"d:\IDEWORK\lvmen\src\licensedcode\data\rules\gplcc-1.0_pulp.yml", "YAML", 0, 0, 0, 2, 0, 0, 1, 3
"d:\IDEWORK\lvmen\src\licensedcode\data\rules\gplcc-1.0_pulp2.yml", "YAML", 0, 0, 0, 2, 0, 0, 1, 3
"d:\IDEWORK\lvmen\src\licensedcode\data\rules\gplcc-1.0_redhat_original.yml", "YAML", 0, 0, 0, 2, 0, 0, 1, 3
"d:\IDEWORK\lvmen\src\licensedcode\data\rules\gplcc-1.0_renamed_gplcc-1.0_1.yml", "YAML", 0, 0, 0, 4, 0, 0, 1, 5
"d:\IDEWORK\lvmen\src\licensedcode\data\rules\gplcc-1.0_suse.yml", "YAML", 0, 0, 0, 2, 0, 0, 1, 3
"d:\IDEWORK\lvmen\src\licensedcode\data\rules\gplcc-1.0_template.yml", "YAML", 0, 0, 0, 2, 0, 0, 1, 3
"d:\IDEWORK\lvmen\src\licensedcode\data\rules\gplcc-1.0_template2.yml", "YAML", 0, 0, 0, 2, 0, 0, 1, 3
"d:\IDEWORK\lvmen\src\licensedcode\data\rules\gplcc-1.0_url_1.yml", "YAML", 0, 0, 0, 5, 0, 0, 1, 6
"d:\IDEWORK\lvmen\src\licensedcode\data\rules\gplcc-1.0_url_2.yml", "YAML", 0, 0, 0, 5, 0, 0, 1, 6
"d:\IDEWORK\lvmen\src\licensedcode\data\rules\greg-roelofs_or_gpl-2.0-plus_1.yml", "YAML", 0, 0, 0, 5, 0, 0, 1, 6
"d:\IDEWORK\lvmen\src\licensedcode\data\rules\greg-roelofs_or_gpl-2.0-plus_2.yml", "YAML", 0, 0, 0, 3, 0, 0, 1, 4
"d:\IDEWORK\lvmen\src\licensedcode\data\rules\gregory-pietsch_1.yml", "YAML", 0, 0, 0, 2, 0, 0, 1, 3
"d:\IDEWORK\lvmen\src\licensedcode\data\rules\gsoap-1.3b_1.yml", "YAML", 0, 0, 0, 11, 0, 0, 1, 12
"d:\IDEWORK\lvmen\src\licensedcode\data\rules\gsoap-1.3b_2.yml", "YAML", 0, 0, 0, 10, 0, 0, 1, 11
"d:\IDEWORK\lvmen\src\licensedcode\data\rules\gsoap-1.3b_3.yml", "YAML", 0, 0, 0, 4, 0, 0, 1, 5
"d:\IDEWORK\lvmen\src\licensedcode\data\rules\gsoap-1.3b_4.yml", "YAML", 0, 0, 0, 3, 0, 0, 1, 4
"d:\IDEWORK\lvmen\src\licensedcode\data\rules\gsoap-1.3b_5.yml", "YAML", 0, 0, 0, 5, 0, 0, 1, 6
"d:\IDEWORK\lvmen\src\licensedcode\data\rules\gsoap-1.3b_url_1.yml", "YAML", 0, 0, 0, 5, 0, 0, 1, 6
"d:\IDEWORK\lvmen\src\licensedcode\data\rules\gsoap-1.3b_url_2.yml", "YAML", 0, 0, 0, 5, 0, 0, 1, 6
"d:\IDEWORK\lvmen\src\licensedcode\data\rules\guile-exception-2.0_1.yml", "YAML", 0, 0, 0, 4, 0, 0, 1, 5
"d:\IDEWORK\lvmen\src\licensedcode\data\rules\gust-font-1.0.yml", "YAML", 0, 0, 0, 8, 0, 0, 1, 9
"d:\IDEWORK\lvmen\src\licensedcode\data\rules\gutenberg-2020_1.yml", "YAML", 0, 0, 0, 3, 0, 0, 1, 4
"d:\IDEWORK\lvmen\src\licensedcode\data\rules\h2-1.0_or_epl-1.0.yml", "YAML", 0, 0, 0, 5, 0, 0, 1, 6
"d:\IDEWORK\lvmen\src\licensedcode\data\rules\h2-1.0_or_epl-1.0_2.yml", "YAML", 0, 0, 0, 5, 0, 0, 1, 6
"d:\IDEWORK\lvmen\src\licensedcode\data\rules\hacos-1.2.yml", "YAML", 0, 0, 0, 5, 0, 0, 1, 6
"d:\IDEWORK\lvmen\src\licensedcode\data\rules\haskell-report_1.yml", "YAML", 0, 0, 0, 3, 0, 0, 1, 4
"d:\IDEWORK\lvmen\src\licensedcode\data\rules\haskell-report_2.yml", "YAML", 0, 0, 0, 3, 0, 0, 1, 4
"d:\IDEWORK\lvmen\src\licensedcode\data\rules\haskell-report_url_1.yml", "YAML", 0, 0, 0, 5, 0, 0, 1, 6
"d:\IDEWORK\lvmen\src\licensedcode\data\rules\haskell-report_url_2.yml", "YAML", 0, 0, 0, 5, 0, 0, 1, 6
"d:\IDEWORK\lvmen\src\licensedcode\data\rules\hdf4_1.yml", "YAML", 0, 0, 0, 7, 0, 0, 1, 8
"d:\IDEWORK\lvmen\src\licensedcode\data\rules\hdf5_1.yml", "YAML", 0, 0, 0, 9, 0, 0, 1, 10
"d:\IDEWORK\lvmen\src\licensedcode\data\rules\hdf5_2.yml", "YAML", 0, 0, 0, 9, 0, 0, 1, 10
"d:\IDEWORK\lvmen\src\licensedcode\data\rules\hdf5_3.yml", "YAML", 0, 0, 0, 10, 0, 0, 1, 11
"d:\IDEWORK\lvmen\src\licensedcode\data\rules\hdf5_4.yml", "YAML", 0, 0, 0, 5, 0, 0, 1, 6
"d:\IDEWORK\lvmen\src\licensedcode\data\rules\hdf5_and_llnl_1.yml", "YAML", 0, 0, 0, 5, 0, 0, 1, 6
"d:\IDEWORK\lvmen\src\licensedcode\data\rules\hdparm_1.yml", "YAML", 0, 0, 0, 3, 0, 0, 1, 4
"d:\IDEWORK\lvmen\src\licensedcode\data\rules\hdparm_2.yml", "YAML", 0, 0, 0, 3, 0, 0, 1, 4
"d:\IDEWORK\lvmen\src\licensedcode\data\rules\helix.yml", "YAML", 0, 0, 0, 5, 0, 0, 1, 6
"d:\IDEWORK\lvmen\src\licensedcode\data\rules\henry-spencer-1999_url_1.yml", "YAML", 0, 0, 0, 5, 0, 0, 1, 6
"d:\IDEWORK\lvmen\src\licensedcode\data\rules\henry-spencer-1999_url_2.yml", "YAML", 0, 0, 0, 5, 0, 0, 1, 6
"d:\IDEWORK\lvmen\src\licensedcode\data\rules\here-proprietary_1.yml", "YAML", 0, 0, 0, 5, 0, 0, 1, 6
"d:\IDEWORK\lvmen\src\licensedcode\data\rules\here-proprietary_2.yml", "YAML", 0, 0, 0, 5, 0, 0, 1, 6
"d:\IDEWORK\lvmen\src\licensedcode\data\rules\here-proprietary_3.yml", "YAML", 0, 0, 0, 4, 0, 0, 1, 5
"d:\IDEWORK\lvmen\src\licensedcode\data\rules\hippocratic-1.1_1.yml", "YAML", 0, 0, 0, 6, 0, 0, 1, 7
"d:\IDEWORK\lvmen\src\licensedcode\data\rules\hippocratic-1.1_2.yml", "YAML", 0, 0, 0, 6, 0, 0, 1, 7
"d:\IDEWORK\lvmen\src\licensedcode\data\rules\hippocratic-1.1_3.yml", "YAML", 0, 0, 0, 3, 0, 0, 1, 4
"d:\IDEWORK\lvmen\src\licensedcode\data\rules\hippocratic-1.1_4.yml", "YAML", 0, 0, 0, 3, 0, 0, 1, 4
"d:\IDEWORK\lvmen\src\licensedcode\data\rules\hippocratic-1.1_5.yml", "YAML", 0, 0, 0, 5, 0, 0, 1, 6
"d:\IDEWORK\lvmen\src\licensedcode\data\rules\hippocratic-1.1_6.yml", "YAML", 0, 0, 0, 5, 0, 0, 1, 6
"d:\IDEWORK\lvmen\src\licensedcode\data\rules\hippocratic-1.2_1.yml", "YAML", 0, 0, 0, 3, 0, 0, 1, 4
"d:\IDEWORK\lvmen\src\licensedcode\data\rules\hippocratic-1.2_10.yml", "YAML", 0, 0, 0, 5, 0, 0, 1, 6
"d:\IDEWORK\lvmen\src\licensedcode\data\rules\hippocratic-1.2_11.yml", "YAML", 0, 0, 0, 5, 0, 0, 1, 6
"d:\IDEWORK\lvmen\src\licensedcode\data\rules\hippocratic-1.2_12.yml", "YAML", 0, 0, 0, 3, 0, 0, 1, 4
"d:\IDEWORK\lvmen\src\licensedcode\data\rules\hippocratic-1.2_13.yml", "YAML", 0, 0, 0, 7, 0, 0, 1, 8
"d:\IDEWORK\lvmen\src\licensedcode\data\rules\hippocratic-1.2_14.yml", "YAML", 0, 0, 0, 5, 0, 0, 1, 6
"d:\IDEWORK\lvmen\src\licensedcode\data\rules\hippocratic-1.2_15.yml", "YAML", 0, 0, 0, 3, 0, 0, 1, 4
"d:\IDEWORK\lvmen\src\licensedcode\data\rules\hippocratic-1.2_16.yml", "YAML", 0, 0, 0, 3, 0, 0, 1, 4
"d:\IDEWORK\lvmen\src\licensedcode\data\rules\hippocratic-1.2_17.yml", "YAML", 0, 0, 0, 3, 0, 0, 1, 4
"d:\IDEWORK\lvmen\src\licensedcode\data\rules\hippocratic-1.2_18.yml", "YAML", 0, 0, 0, 3, 0, 0, 1, 4
"d:\IDEWORK\lvmen\src\licensedcode\data\rules\hippocratic-1.2_19.yml", "YAML", 0, 0, 0, 3, 0, 0, 1, 4
"d:\IDEWORK\lvmen\src\licensedcode\data\rules\hippocratic-1.2_2.yml", "YAML", 0, 0, 0, 3, 0, 0, 1, 4
"d:\IDEWORK\lvmen\src\licensedcode\data\rules\hippocratic-1.2_3.yml", "YAML", 0, 0, 0, 3, 0, 0, 1, 4
"d:\IDEWORK\lvmen\src\licensedcode\data\rules\hippocratic-1.2_4.yml", "YAML", 0, 0, 0, 3, 0, 0, 1, 4
"d:\IDEWORK\lvmen\src\licensedcode\data\rules\hippocratic-1.2_5.yml", "YAML", 0, 0, 0, 3, 0, 0, 1, 4
"d:\IDEWORK\lvmen\src\licensedcode\data\rules\hippocratic-1.2_6.yml", "YAML", 0, 0, 0, 3, 0, 0, 1, 4
"d:\IDEWORK\lvmen\src\licensedcode\data\rules\hippocratic-1.2_7.yml", "YAML", 0, 0, 0, 3, 0, 0, 1, 4
"d:\IDEWORK\lvmen\src\licensedcode\data\rules\hippocratic-1.2_8.yml", "YAML", 0, 0, 0, 5, 0, 0, 1, 6
"d:\IDEWORK\lvmen\src\licensedcode\data\rules\hippocratic-1.2_9.yml", "YAML", 0, 0, 0, 3, 0, 0, 1, 4
"d:\IDEWORK\lvmen\src\licensedcode\data\rules\hippocratic-2.0_1.yml", "YAML", 0, 0, 0, 3, 0, 0, 1, 4
"d:\IDEWORK\lvmen\src\licensedcode\data\rules\hippocratic-2.0_2.yml", "YAML", 0, 0, 0, 3, 0, 0, 1, 4
"d:\IDEWORK\lvmen\src\licensedcode\data\rules\hippocratic-2.1_1.yml", "YAML", 0, 0, 0, 3, 0, 0, 1, 4
"d:\IDEWORK\lvmen\src\licensedcode\data\rules\hippocratic-2.1_2.yml", "YAML", 0, 0, 0, 3, 0, 0, 1, 4
"d:\IDEWORK\lvmen\src\licensedcode\data\rules\hippocratic-2.1_3.yml", "YAML", 0, 0, 0, 5, 0, 0, 1, 6
"d:\IDEWORK\lvmen\src\licensedcode\data\rules\hippocratic-2.1_4.yml", "YAML", 0, 0, 0, 3, 0, 0, 1, 4
"d:\IDEWORK\lvmen\src\licensedcode\data\rules\hippocratic-2.1_5.yml", "YAML", 0, 0, 0, 3, 0, 0, 1, 4
"d:\IDEWORK\lvmen\src\licensedcode\data\rules\hippocratic-2.1_6.yml", "YAML", 0, 0, 0, 5, 0, 0, 1, 6
"d:\IDEWORK\lvmen\src\licensedcode\data\rules\hippocratic-2.1_7.yml", "YAML", 0, 0, 0, 5, 0, 0, 1, 6
"d:\IDEWORK\lvmen\src\licensedcode\data\rules\historical-ntp.yml", "YAML", 0, 0, 0, 2, 0, 0, 1, 3
"d:\IDEWORK\lvmen\src\licensedcode\data\rules\historical_1.yml", "YAML", 0, 0, 0, 3, 0, 0, 1, 4
"d:\IDEWORK\lvmen\src\licensedcode\data\rules\historical_10.yml", "YAML", 0, 0, 0, 2, 0, 0, 1, 3
"d:\IDEWORK\lvmen\src\licensedcode\data\rules\historical_11.yml", "YAML", 0, 0, 0, 2, 0, 0, 1, 3
"d:\IDEWORK\lvmen\src\licensedcode\data\rules\historical_12.yml", "YAML", 0, 0, 0, 2, 0, 0, 1, 3
"d:\IDEWORK\lvmen\src\licensedcode\data\rules\historical_13.yml", "YAML", 0, 0, 0, 2, 0, 0, 1, 3
"d:\IDEWORK\lvmen\src\licensedcode\data\rules\historical_14.yml", "YAML", 0, 0, 0, 2, 0, 0, 1, 3
"d:\IDEWORK\lvmen\src\licensedcode\data\rules\historical_15.yml", "YAML", 0, 0, 0, 3, 0, 0, 1, 4
"d:\IDEWORK\lvmen\src\licensedcode\data\rules\historical_16.yml", "YAML", 0, 0, 0, 3, 0, 0, 1, 4
"d:\IDEWORK\lvmen\src\licensedcode\data\rules\historical_17.yml", "YAML", 0, 0, 0, 3, 0, 0, 1, 4
"d:\IDEWORK\lvmen\src\licensedcode\data\rules\historical_18.yml", "YAML", 0, 0, 0, 2, 0, 0, 1, 3
"d:\IDEWORK\lvmen\src\licensedcode\data\rules\historical_19.yml", "YAML", 0, 0, 0, 2, 0, 0, 1, 3
"d:\IDEWORK\lvmen\src\licensedcode\data\rules\historical_2.yml", "YAML", 0, 0, 0, 2, 0, 0, 1, 3
"d:\IDEWORK\lvmen\src\licensedcode\data\rules\historical_20.yml", "YAML", 0, 0, 0, 2, 0, 0, 1, 3
"d:\IDEWORK\lvmen\src\licensedcode\data\rules\historical_21.yml", "YAML", 0, 0, 0, 3, 0, 0, 1, 4
"d:\IDEWORK\lvmen\src\licensedcode\data\rules\historical_22.yml", "YAML", 0, 0, 0, 4, 0, 0, 1, 5
"d:\IDEWORK\lvmen\src\licensedcode\data\rules\historical_23.yml", "YAML", 0, 0, 0, 3, 0, 0, 1, 4
"d:\IDEWORK\lvmen\src\licensedcode\data\rules\historical_24.yml", "YAML", 0, 0, 0, 4, 0, 0, 1, 5
"d:\IDEWORK\lvmen\src\licensedcode\data\rules\historical_25.yml", "YAML", 0, 0, 0, 4, 0, 0, 1, 5
"d:\IDEWORK\lvmen\src\licensedcode\data\rules\historical_26.yml", "YAML", 0, 0, 0, 4, 0, 0, 1, 5
"d:\IDEWORK\lvmen\src\licensedcode\data\rules\historical_27.yml", "YAML", 0, 0, 0, 4, 0, 0, 1, 5
"d:\IDEWORK\lvmen\src\licensedcode\data\rules\historical_3.yml", "YAML", 0, 0, 0, 3, 0, 0, 1, 4
"d:\IDEWORK\lvmen\src\licensedcode\data\rules\historical_4.yml", "YAML", 0, 0, 0, 4, 0, 0, 1, 5
"d:\IDEWORK\lvmen\src\licensedcode\data\rules\historical_5.yml", "YAML", 0, 0, 0, 2, 0, 0, 1, 3
"d:\IDEWORK\lvmen\src\licensedcode\data\rules\historical_6.yml", "YAML", 0, 0, 0, 5, 0, 0, 1, 6
"d:\IDEWORK\lvmen\src\licensedcode\data\rules\historical_7.yml", "YAML", 0, 0, 0, 3, 0, 0, 1, 4
"d:\IDEWORK\lvmen\src\licensedcode\data\rules\historical_8.yml", "YAML", 0, 0, 0, 3, 0, 0, 1, 4
"d:\IDEWORK\lvmen\src\licensedcode\data\rules\historical_9.yml", "YAML", 0, 0, 0, 2, 0, 0, 1, 3
"d:\IDEWORK\lvmen\src\licensedcode\data\rules\historical_SPDX.yml", "YAML", 0, 0, 0, 4, 0, 0, 1, 5
"d:\IDEWORK\lvmen\src\licensedcode\data\rules\historical_and_warranty-disclaimer_1.yml", "YAML", 0, 0, 0, 3, 0, 0, 1, 4
"d:\IDEWORK\lvmen\src\licensedcode\data\rules\historical_medusa_1.yml", "YAML", 0, 0, 0, 2, 0, 0, 1, 3
"d:\IDEWORK\lvmen\src\licensedcode\data\rules\historical_url_1.yml", "YAML", 0, 0, 0, 5, 0, 0, 1, 6
"d:\IDEWORK\lvmen\src\licensedcode\data\rules\historical_url_2.yml", "YAML", 0, 0, 0, 5, 0, 0, 1, 6
"d:\IDEWORK\lvmen\src\licensedcode\data\rules\historical_url_glc_170.yml", "YAML", 0, 0, 0, 5, 0, 0, 1, 6
"d:\IDEWORK\lvmen\src\licensedcode\data\rules\historical_url_glc_171.yml", "YAML", 0, 0, 0, 5, 0, 0, 1, 6
"d:\IDEWORK\lvmen\src\licensedcode\data\rules\hp-netperf.yml", "YAML", 0, 0, 0, 5, 0, 0, 1, 6
"d:\IDEWORK\lvmen\src\licensedcode\data\rules\hp-ux-java.yml", "YAML", 0, 0, 0, 4, 0, 0, 1, 5
"d:\IDEWORK\lvmen\src\licensedcode\data\rules\hp.yml", "YAML", 0, 0, 0, 5, 0, 0, 1, 6
"d:\IDEWORK\lvmen\src\licensedcode\data\rules\hs-regexp-orig_1.yml", "YAML", 0, 0, 0, 3, 0, 0, 2, 5
"d:\IDEWORK\lvmen\src\licensedcode\data\rules\hs-regexp-orig_2.yml", "YAML", 0, 0, 0, 8, 0, 0, 1, 9
"d:\IDEWORK\lvmen\src\licensedcode\data\rules\hs-regexp-orig_3.yml", "YAML", 0, 0, 0, 4, 0, 0, 2, 6
"d:\IDEWORK\lvmen\src\licensedcode\data\rules\hs-regexp_1.yml", "YAML", 0, 0, 0, 3, 0, 0, 1, 4
"d:\IDEWORK\lvmen\src\licensedcode\data\rules\hs-regexp_2.yml", "YAML", 0, 0, 0, 3, 0, 0, 2, 5
"d:\IDEWORK\lvmen\src\licensedcode\data\rules\hs-regexp_3.yml", "YAML", 0, 0, 0, 3, 0, 0, 1, 4
"d:\IDEWORK\lvmen\src\licensedcode\data\rules\hs-regexp_4.yml", "YAML", 0, 0, 0, 4, 0, 0, 1, 5
"d:\IDEWORK\lvmen\src\licensedcode\data\rules\hs-regexp_5.yml", "YAML", 0, 0, 0, 5, 0, 0, 1, 6
"d:\IDEWORK\lvmen\src\licensedcode\data\rules\hs-regexp_url_1.yml", "YAML", 0, 0, 0, 5, 0, 0, 1, 6
"d:\IDEWORK\lvmen\src\licensedcode\data\rules\hs-regexp_url_2.yml", "YAML", 0, 0, 0, 5, 0, 0, 1, 6
"d:\IDEWORK\lvmen\src\licensedcode\data\rules\html5_1.yml", "YAML", 0, 0, 0, 3, 0, 0, 1, 4
"d:\IDEWORK\lvmen\src\licensedcode\data\rules\html5_2.yml", "YAML", 0, 0, 0, 3, 0, 0, 1, 4
"d:\IDEWORK\lvmen\src\licensedcode\data\rules\i2p-gpl-java-exception_url_1.yml", "YAML", 0, 0, 0, 5, 0, 0, 1, 6
"d:\IDEWORK\lvmen\src\licensedcode\data\rules\i2p-gpl-java-exception_url_2.yml", "YAML", 0, 0, 0, 5, 0, 0, 1, 6
"d:\IDEWORK\lvmen\src\licensedcode\data\rules\ian-piumarta_1.yml", "YAML", 0, 0, 0, 4, 0, 0, 1, 5
"d:\IDEWORK\lvmen\src\licensedcode\data\rules\ibm-dhcp_1.yml", "YAML", 0, 0, 0, 5, 0, 0, 1, 6
"d:\IDEWORK\lvmen\src\licensedcode\data\rules\ibm-jre.yml", "YAML", 0, 0, 0, 5, 0, 0, 1, 6
"d:\IDEWORK\lvmen\src\licensedcode\data\rules\ibm-nwsc.yml", "YAML", 0, 0, 0, 5, 0, 0, 1, 6
"d:\IDEWORK\lvmen\src\licensedcode\data\rules\ibm-pibs_url_1.yml", "YAML", 0, 0, 0, 5, 0, 0, 1, 6
"d:\IDEWORK\lvmen\src\licensedcode\data\rules\ibm-pibs_url_2.yml", "YAML", 0, 0, 0, 5, 0, 0, 1, 6
"d:\IDEWORK\lvmen\src\licensedcode\data\rules\ibmpl-1.0.SPDX.yml", "YAML", 0, 0, 0, 8, 0, 0, 1, 9
"d:\IDEWORK\lvmen\src\licensedcode\data\rules\ibmpl-1.0.yml", "YAML", 0, 0, 0, 6, 0, 0, 1, 7
"d:\IDEWORK\lvmen\src\licensedcode\data\rules\ibmpl-1.0_1.yml", "YAML", 0, 0, 0, 3, 0, 0, 1, 4
"d:\IDEWORK\lvmen\src\licensedcode\data\rules\ibmpl-1.0_10.yml", "YAML", 0, 0, 0, 3, 0, 0, 1, 4
"d:\IDEWORK\lvmen\src\licensedcode\data\rules\ibmpl-1.0_2.yml", "YAML", 0, 0, 0, 5, 0, 0, 1, 6
"d:\IDEWORK\lvmen\src\licensedcode\data\rules\ibmpl-1.0_3.yml", "YAML", 0, 0, 0, 3, 0, 0, 1, 4
"d:\IDEWORK\lvmen\src\licensedcode\data\rules\ibmpl-1.0_4.yml", "YAML", 0, 0, 0, 2, 0, 0, 1, 3
"d:\IDEWORK\lvmen\src\licensedcode\data\rules\ibmpl-1.0_5.yml", "YAML", 0, 0, 0, 6, 0, 0, 1, 7
"d:\IDEWORK\lvmen\src\licensedcode\data\rules\ibmpl-1.0_6.yml", "YAML", 0, 0, 0, 4, 0, 0, 1, 5
"d:\IDEWORK\lvmen\src\licensedcode\data\rules\ibmpl-1.0_7.yml", "YAML", 0, 0, 0, 4, 0, 0, 1, 5
"d:\IDEWORK\lvmen\src\licensedcode\data\rules\ibmpl-1.0_8.yml", "YAML", 0, 0, 0, 5, 0, 0, 1, 6
"d:\IDEWORK\lvmen\src\licensedcode\data\rules\ibmpl-1.0_9.yml", "YAML", 0, 0, 0, 5, 0, 0, 1, 6
"d:\IDEWORK\lvmen\src\licensedcode\data\rules\ibmpl-1.0_and_cpl-1.0_and_gpl-2.0_1.yml", "YAML", 0, 0, 0, 3, 0, 0, 1, 4
"d:\IDEWORK\lvmen\src\licensedcode\data\rules\ibmpl-1.0_and_cpl-1.0_and_gpl-2.0_2.yml", "YAML", 0, 0, 0, 3, 0, 0, 1, 4
"d:\IDEWORK\lvmen\src\licensedcode\data\rules\ibmpl-1.0_and_other-copyleft_1.yml", "YAML", 0, 0, 0, 9, 0, 0, 1, 10
"d:\IDEWORK\lvmen\src\licensedcode\data\rules\ibmpl-1.0_and_other-copyleft_2.yml", "YAML", 0, 0, 0, 5, 0, 0, 1, 6
"d:\IDEWORK\lvmen\src\licensedcode\data\rules\ibmpl-1.0_url_1.yml", "YAML", 0, 0, 0, 5, 0, 0, 1, 6
"d:\IDEWORK\lvmen\src\licensedcode\data\rules\ibmpl-1.0_url_2.yml", "YAML", 0, 0, 0, 5, 0, 0, 1, 6
"d:\IDEWORK\lvmen\src\licensedcode\data\rules\ibmpl-1.0_url_badge.yml", "YAML", 0, 0, 0, 5, 0, 0, 1, 6
"d:\IDEWORK\lvmen\src\licensedcode\data\rules\ibmpl-1.0_url_glc_174.yml", "YAML", 0, 0, 0, 5, 0, 0, 1, 6
"d:\IDEWORK\lvmen\src\licensedcode\data\rules\ibmpl-1.0_url_glc_175.yml", "YAML", 0, 0, 0, 5, 0, 0, 1, 6
"d:\IDEWORK\lvmen\src\licensedcode\data\rules\icann-public_1.yml", "YAML", 0, 0, 0, 3, 0, 0, 1, 4
"d:\IDEWORK\lvmen\src\licensedcode\data\rules\ice-exception-2.0_1.yml", "YAML", 0, 0, 0, 7, 0, 0, 1, 8
"d:\IDEWORK\lvmen\src\licensedcode\data\rules\ietf-trust.yml", "YAML", 0, 0, 0, 6, 0, 0, 1, 7
"d:\IDEWORK\lvmen\src\licensedcode\data\rules\ietf-trust_1.yml", "YAML", 0, 0, 0, 19, 0, 0, 1, 20
"d:\IDEWORK\lvmen\src\licensedcode\data\rules\ietf-trust_10.yml", "YAML", 0, 0, 0, 3, 0, 0, 1, 4
"d:\IDEWORK\lvmen\src\licensedcode\data\rules\ietf-trust_2.yml", "YAML", 0, 0, 0, 6, 0, 0, 1, 7
"d:\IDEWORK\lvmen\src\licensedcode\data\rules\ietf-trust_3.yml", "YAML", 0, 0, 0, 6, 0, 0, 1, 7
"d:\IDEWORK\lvmen\src\licensedcode\data\rules\ietf-trust_4.yml", "YAML", 0, 0, 0, 4, 0, 0, 1, 5
"d:\IDEWORK\lvmen\src\licensedcode\data\rules\ietf-trust_5.yml", "YAML", 0, 0, 0, 2, 0, 0, 1, 3
"d:\IDEWORK\lvmen\src\licensedcode\data\rules\ietf-trust_6.yml", "YAML", 0, 0, 0, 5, 0, 0, 1, 6
"d:\IDEWORK\lvmen\src\licensedcode\data\rules\ietf-trust_7.yml", "YAML", 0, 0, 0, 5, 0, 0, 1, 6
"d:\IDEWORK\lvmen\src\licensedcode\data\rules\ietf-trust_8.yml", "YAML", 0, 0, 0, 5, 0, 0, 1, 6
"d:\IDEWORK\lvmen\src\licensedcode\data\rules\ietf-trust_9.yml", "YAML", 0, 0, 0, 3, 0, 0, 1, 4
"d:\IDEWORK\lvmen\src\licensedcode\data\rules\ietf.yml", "YAML", 0, 0, 0, 3, 0, 0, 1, 4
"d:\IDEWORK\lvmen\src\licensedcode\data\rules\ietf_1.yml", "YAML", 0, 0, 0, 3, 0, 0, 1, 4
"d:\IDEWORK\lvmen\src\licensedcode\data\rules\ietf_2.yml", "YAML", 0, 0, 0, 7, 0, 0, 1, 8
"d:\IDEWORK\lvmen\src\licensedcode\data\rules\ietf_3.yml", "YAML", 0, 0, 0, 7, 0, 0, 1, 8
"d:\IDEWORK\lvmen\src\licensedcode\data\rules\ietf_4.yml", "YAML", 0, 0, 0, 7, 0, 0, 1, 8
"d:\IDEWORK\lvmen\src\licensedcode\data\rules\ietf_5.yml", "YAML", 0, 0, 0, 7, 0, 0, 1, 8
"d:\IDEWORK\lvmen\src\licensedcode\data\rules\ietf_6.yml", "YAML", 0, 0, 0, 3, 0, 0, 1, 4
"d:\IDEWORK\lvmen\src\licensedcode\data\rules\ietf_7.yml", "YAML", 0, 0, 0, 3, 0, 0, 1, 4
"d:\IDEWORK\lvmen\src\licensedcode\data\rules\ijg_1.yml", "YAML", 0, 0, 0, 4, 0, 0, 1, 5
"d:\IDEWORK\lvmen\src\licensedcode\data\rules\ijg_10.yml", "YAML", 0, 0, 0, 3, 0, 0, 1, 4
"d:\IDEWORK\lvmen\src\licensedcode\data\rules\ijg_11.yml", "YAML", 0, 0, 0, 3, 0, 0, 1, 4
"d:\IDEWORK\lvmen\src\licensedcode\data\rules\ijg_12.yml", "YAML", 0, 0, 0, 3, 0, 0, 1, 4
"d:\IDEWORK\lvmen\src\licensedcode\data\rules\ijg_13.yml", "YAML", 0, 0, 0, 4, 0, 0, 1, 5
"d:\IDEWORK\lvmen\src\licensedcode\data\rules\ijg_14.yml", "YAML", 0, 0, 0, 3, 0, 0, 1, 4
"d:\IDEWORK\lvmen\src\licensedcode\data\rules\ijg_15.yml", "YAML", 0, 0, 0, 5, 0, 0, 1, 6
"d:\IDEWORK\lvmen\src\licensedcode\data\rules\ijg_16.yml", "YAML", 0, 0, 0, 3, 0, 0, 1, 4
"d:\IDEWORK\lvmen\src\licensedcode\data\rules\ijg_17.yml", "YAML", 0, 0, 0, 5, 0, 0, 1, 6
"d:\IDEWORK\lvmen\src\licensedcode\data\rules\ijg_18.yml", "YAML", 0, 0, 0, 3, 0, 0, 1, 4
"d:\IDEWORK\lvmen\src\licensedcode\data\rules\ijg_19.yml", "YAML", 0, 0, 0, 3, 0, 0, 1, 4
"d:\IDEWORK\lvmen\src\licensedcode\data\rules\ijg_2.yml", "YAML", 0, 0, 0, 6, 0, 0, 1, 7
"d:\IDEWORK\lvmen\src\licensedcode\data\rules\ijg_20.yml", "YAML", 0, 0, 0, 3, 0, 0, 1, 4
"d:\IDEWORK\lvmen\src\licensedcode\data\rules\ijg_21.yml", "YAML", 0, 0, 0, 3, 0, 0, 1, 4
"d:\IDEWORK\lvmen\src\licensedcode\data\rules\ijg_22.yml", "YAML", 0, 0, 0, 3, 0, 0, 1, 4
"d:\IDEWORK\lvmen\src\licensedcode\data\rules\ijg_23.yml", "YAML", 0, 0, 0, 3, 0, 0, 1, 4
"d:\IDEWORK\lvmen\src\licensedcode\data\rules\ijg_24.yml", "YAML", 0, 0, 0, 3, 0, 0, 1, 4
"d:\IDEWORK\lvmen\src\licensedcode\data\rules\ijg_25.yml", "YAML", 0, 0, 0, 3, 0, 0, 1, 4
"d:\IDEWORK\lvmen\src\licensedcode\data\rules\ijg_26.yml", "YAML", 0, 0, 0, 4, 0, 0, 1, 5
"d:\IDEWORK\lvmen\src\licensedcode\data\rules\ijg_27.yml", "YAML", 0, 0, 0, 3, 0, 0, 1, 4
"d:\IDEWORK\lvmen\src\licensedcode\data\rules\ijg_28.yml", "YAML", 0, 0, 0, 3, 0, 0, 1, 4
"d:\IDEWORK\lvmen\src\licensedcode\data\rules\ijg_29.yml", "YAML", 0, 0, 0, 13, 0, 0, 1, 14
"d:\IDEWORK\lvmen\src\licensedcode\data\rules\ijg_3.yml", "YAML", 0, 0, 0, 6, 0, 0, 1, 7
"d:\IDEWORK\lvmen\src\licensedcode\data\rules\ijg_30.yml", "YAML", 0, 0, 0, 7, 0, 0, 1, 8
"d:\IDEWORK\lvmen\src\licensedcode\data\rules\ijg_4.yml", "YAML", 0, 0, 0, 6, 0, 0, 1, 7
"d:\IDEWORK\lvmen\src\licensedcode\data\rules\ijg_5.yml", "YAML", 0, 0, 0, 3, 0, 0, 1, 4
"d:\IDEWORK\lvmen\src\licensedcode\data\rules\ijg_6.yml", "YAML", 0, 0, 0, 16, 0, 0, 1, 17
"d:\IDEWORK\lvmen\src\licensedcode\data\rules\ijg_7.yml", "YAML", 0, 0, 0, 6, 0, 0, 1, 7
"d:\IDEWORK\lvmen\src\licensedcode\data\rules\ijg_8.yml", "YAML", 0, 0, 0, 2, 0, 0, 1, 3
"d:\IDEWORK\lvmen\src\licensedcode\data\rules\ijg_9.yml", "YAML", 0, 0, 0, 2, 0, 0, 1, 3
"d:\IDEWORK\lvmen\src\licensedcode\data\rules\ijg_url_1.yml", "YAML", 0, 0, 0, 5, 0, 0, 1, 6
"d:\IDEWORK\lvmen\src\licensedcode\data\rules\ijg_url_2.yml", "YAML", 0, 0, 0, 5, 0, 0, 1, 6
"d:\IDEWORK\lvmen\src\licensedcode\data\rules\imagemagick_1.yml", "YAML", 0, 0, 0, 9, 0, 0, 1, 10
"d:\IDEWORK\lvmen\src\licensedcode\data\rules\imagemagick_10.yml", "YAML", 0, 0, 0, 9, 0, 0, 1, 10
"d:\IDEWORK\lvmen\src\licensedcode\data\rules\imagemagick_11.yml", "YAML", 0, 0, 0, 3, 0, 0, 1, 4
"d:\IDEWORK\lvmen\src\licensedcode\data\rules\imagemagick_12.yml", "YAML", 0, 0, 0, 4, 0, 0, 1, 5
"d:\IDEWORK\lvmen\src\licensedcode\data\rules\imagemagick_13.yml", "YAML", 0, 0, 0, 4, 0, 0, 1, 5
"d:\IDEWORK\lvmen\src\licensedcode\data\rules\imagemagick_14.yml", "YAML", 0, 0, 0, 2, 0, 0, 1, 3
"d:\IDEWORK\lvmen\src\licensedcode\data\rules\imagemagick_15.yml", "YAML", 0, 0, 0, 5, 0, 0, 1, 6
"d:\IDEWORK\lvmen\src\licensedcode\data\rules\imagemagick_16.yml", "YAML", 0, 0, 0, 3, 0, 0, 1, 4
"d:\IDEWORK\lvmen\src\licensedcode\data\rules\imagemagick_17.yml", "YAML", 0, 0, 0, 4, 0, 0, 1, 5
"d:\IDEWORK\lvmen\src\licensedcode\data\rules\imagemagick_18.yml", "YAML", 0, 0, 0, 3, 0, 0, 1, 4
"d:\IDEWORK\lvmen\src\licensedcode\data\rules\imagemagick_19.yml", "YAML", 0, 0, 0, 5, 0, 0, 1, 6
"d:\IDEWORK\lvmen\src\licensedcode\data\rules\imagemagick_2.yml", "YAML", 0, 0, 0, 5, 0, 0, 1, 6
"d:\IDEWORK\lvmen\src\licensedcode\data\rules\imagemagick_3.yml", "YAML", 0, 0, 0, 5, 0, 0, 1, 6
"d:\IDEWORK\lvmen\src\licensedcode\data\rules\imagemagick_4.yml", "YAML", 0, 0, 0, 3, 0, 0, 1, 4
"d:\IDEWORK\lvmen\src\licensedcode\data\rules\imagemagick_5.yml", "YAML", 0, 0, 0, 5, 0, 0, 1, 6
"d:\IDEWORK\lvmen\src\licensedcode\data\rules\imagemagick_6.yml", "YAML", 0, 0, 0, 2, 0, 0, 1, 3
"d:\IDEWORK\lvmen\src\licensedcode\data\rules\imagemagick_7.yml", "YAML", 0, 0, 0, 10, 0, 0, 1, 11
"d:\IDEWORK\lvmen\src\licensedcode\data\rules\imagemagick_8.yml", "YAML", 0, 0, 0, 5, 0, 0, 1, 6
"d:\IDEWORK\lvmen\src\licensedcode\data\rules\imagemagick_9.yml", "YAML", 0, 0, 0, 4, 0, 0, 1, 5
"d:\IDEWORK\lvmen\src\licensedcode\data\rules\imagemagick_url_1.yml", "YAML", 0, 0, 0, 5, 0, 0, 1, 6
"d:\IDEWORK\lvmen\src\licensedcode\data\rules\imagemagick_url_2.yml", "YAML", 0, 0, 0, 5, 0, 0, 1, 6
"d:\IDEWORK\lvmen\src\licensedcode\data\rules\imagen_1.yml", "YAML", 0, 0, 0, 4, 0, 0, 1, 5
"d:\IDEWORK\lvmen\src\licensedcode\data\rules\imlib2.yml", "YAML", 0, 0, 0, 5, 0, 0, 1, 6
"d:\IDEWORK\lvmen\src\licensedcode\data\rules\imlib2_url_1.yml", "YAML", 0, 0, 0, 5, 0, 0, 1, 6
"d:\IDEWORK\lvmen\src\licensedcode\data\rules\imlib2_url_2.yml", "YAML", 0, 0, 0, 5, 0, 0, 1, 6
"d:\IDEWORK\lvmen\src\licensedcode\data\rules\independent-module-linking-exception-2.0.yml", "YAML", 0, 0, 0, 4, 0, 0, 1, 5
"d:\IDEWORK\lvmen\src\licensedcode\data\rules\indiana-extreme-1.2.SPDX.yml", "YAML", 0, 0, 0, 12, 0, 0, 1, 13
"d:\IDEWORK\lvmen\src\licensedcode\data\rules\indiana-extreme-1.2_url_1.yml", "YAML", 0, 0, 0, 5, 0, 0, 1, 6
"d:\IDEWORK\lvmen\src\licensedcode\data\rules\indiana-extreme-1.2_url_2.yml", "YAML", 0, 0, 0, 5, 0, 0, 1, 6
"d:\IDEWORK\lvmen\src\licensedcode\data\rules\indiana-extreme.yml", "YAML", 0, 0, 0, 6, 0, 0, 1, 7
"d:\IDEWORK\lvmen\src\licensedcode\data\rules\indiana-extreme2.yml", "YAML", 0, 0, 0, 11, 0, 0, 1, 12
"d:\IDEWORK\lvmen\src\licensedcode\data\rules\indiana-extreme3.yml", "YAML", 0, 0, 0, 10, 0, 0, 1, 11
"d:\IDEWORK\lvmen\src\licensedcode\data\rules\indiana-extreme4.yml", "YAML", 0, 0, 0, 3, 0, 0, 1, 4
"d:\IDEWORK\lvmen\src\licensedcode\data\rules\infineon-free_1.yml", "YAML", 0, 0, 0, 3, 0, 0, 1, 4
"d:\IDEWORK\lvmen\src\licensedcode\data\rules\info-zip-2009-01_1.yml", "YAML", 0, 0, 0, 6, 0, 0, 1, 7
"d:\IDEWORK\lvmen\src\licensedcode\data\rules\info-zip-2009-01_10.yml", "YAML", 0, 0, 0, 3, 0, 0, 1, 4
"d:\IDEWORK\lvmen\src\licensedcode\data\rules\info-zip-2009-01_11.yml", "YAML", 0, 0, 0, 8, 0, 0, 2, 10
"d:\IDEWORK\lvmen\src\licensedcode\data\rules\info-zip-2009-01_12.yml", "YAML", 0, 0, 0, 9, 0, 0, 1, 10
"d:\IDEWORK\lvmen\src\licensedcode\data\rules\info-zip-2009-01_2.yml", "YAML", 0, 0, 0, 5, 0, 0, 1, 6
"d:\IDEWORK\lvmen\src\licensedcode\data\rules\info-zip-2009-01_3.yml", "YAML", 0, 0, 0, 5, 0, 0, 1, 6
"d:\IDEWORK\lvmen\src\licensedcode\data\rules\info-zip-2009-01_4.yml", "YAML", 0, 0, 0, 17, 0, 0, 3, 20
"d:\IDEWORK\lvmen\src\licensedcode\data\rules\info-zip-2009-01_5.yml", "YAML", 0, 0, 0, 3, 0, 0, 1, 4
"d:\IDEWORK\lvmen\src\licensedcode\data\rules\info-zip-2009-01_6.yml", "YAML", 0, 0, 0, 3, 0, 0, 1, 4
"d:\IDEWORK\lvmen\src\licensedcode\data\rules\info-zip-2009-01_7.yml", "YAML", 0, 0, 0, 4, 0, 0, 1, 5
"d:\IDEWORK\lvmen\src\licensedcode\data\rules\info-zip-2009-01_8.yml", "YAML", 0, 0, 0, 3, 0, 0, 1, 4
"d:\IDEWORK\lvmen\src\licensedcode\data\rules\info-zip-2009-01_9.yml", "YAML", 0, 0, 0, 3, 0, 0, 1, 4
"d:\IDEWORK\lvmen\src\licensedcode\data\rules\info-zip-2009-01_and_other-permissive_1.yml", "YAML", 0, 0, 0, 6, 0, 0, 1, 7
"d:\IDEWORK\lvmen\src\licensedcode\data\rules\info-zip-2009-01_and_other-permissive_2.yml", "YAML", 0, 0, 0, 6, 0, 0, 1, 7
"d:\IDEWORK\lvmen\src\licensedcode\data\rules\info-zip-2009-01_and_other-permissive_3.yml", "YAML", 0, 0, 0, 6, 0, 0, 1, 7
"d:\IDEWORK\lvmen\src\licensedcode\data\rules\info-zip_url_1.yml", "YAML", 0, 0, 0, 5, 0, 0, 1, 6
"d:\IDEWORK\lvmen\src\licensedcode\data\rules\info-zip_url_2.yml", "YAML", 0, 0, 0, 5, 0, 0, 1, 6
"d:\IDEWORK\lvmen\src\licensedcode\data\rules\inner-net-2.0_1.yml", "YAML", 0, 0, 0, 2, 0, 0, 1, 3
"d:\IDEWORK\lvmen\src\licensedcode\data\rules\inner-net-2.0_2.yml", "YAML", 0, 0, 0, 2, 0, 0, 1, 3
"d:\IDEWORK\lvmen\src\licensedcode\data\rules\inner-net-2.0_3.yml", "YAML", 0, 0, 0, 3, 0, 0, 1, 4
"d:\IDEWORK\lvmen\src\licensedcode\data\rules\inner-net-2.0_4.yml", "YAML", 0, 0, 0, 3, 0, 0, 1, 4
"d:\IDEWORK\lvmen\src\licensedcode\data\rules\inno-setup_1.yml", "YAML", 0, 0, 0, 9, 0, 0, 1, 10
"d:\IDEWORK\lvmen\src\licensedcode\data\rules\inno-setup_2.yml", "YAML", 0, 0, 0, 3, 0, 0, 1, 4
"d:\IDEWORK\lvmen\src\licensedcode\data\rules\inno-setup_3.yml", "YAML", 0, 0, 0, 5, 0, 0, 1, 6
"d:\IDEWORK\lvmen\src\licensedcode\data\rules\inno-setup_4.yml", "YAML", 0, 0, 0, 2, 0, 0, 1, 3
"d:\IDEWORK\lvmen\src\licensedcode\data\rules\intel-acpi_1.yml", "YAML", 0, 0, 0, 7, 0, 0, 1, 8
"d:\IDEWORK\lvmen\src\licensedcode\data\rules\intel-acpi_2.yml", "YAML", 0, 0, 0, 3, 0, 0, 1, 4
"d:\IDEWORK\lvmen\src\licensedcode\data\rules\intel-acpi_or_intel-bsd_or_gpl-2.0_1.yml", "YAML", 0, 0, 0, 7, 0, 0, 1, 8
"d:\IDEWORK\lvmen\src\licensedcode\data\rules\intel-acpi_or_intel-bsd_or_gpl-2.0_2.yml", "YAML", 0, 0, 0, 7, 0, 0, 1, 8
"d:\IDEWORK\lvmen\src\licensedcode\data\rules\intel-acpi_or_intel-bsd_or_gpl-2.0_3.yml", "YAML", 0, 0, 0, 4, 0, 0, 1, 5
"d:\IDEWORK\lvmen\src\licensedcode\data\rules\intel-acpi_url_1.yml", "YAML", 0, 0, 0, 5, 0, 0, 1, 6
"d:\IDEWORK\lvmen\src\licensedcode\data\rules\intel-acpi_url_2.yml", "YAML", 0, 0, 0, 5, 0, 0, 1, 6
"d:\IDEWORK\lvmen\src\licensedcode\data\rules\intel-bsd-export-control_1.yml", "YAML", 0, 0, 0, 4, 0, 0, 1, 5
"d:\IDEWORK\lvmen\src\licensedcode\data\rules\intel-bsd-export-control_url_1.yml", "YAML", 0, 0, 0, 5, 0, 0, 1, 6
"d:\IDEWORK\lvmen\src\licensedcode\data\rules\intel-bsd-export-control_url_2.yml", "YAML", 0, 0, 0, 5, 0, 0, 1, 6
"d:\IDEWORK\lvmen\src\licensedcode\data\rules\intel-bsd-export-control_url_glc_86.yml", "YAML", 0, 0, 0, 5, 0, 0, 1, 6
"d:\IDEWORK\lvmen\src\licensedcode\data\rules\intel-bsd-export-control_url_glc_87.yml", "YAML", 0, 0, 0, 5, 0, 0, 1, 6
"d:\IDEWORK\lvmen\src\licensedcode\data\rules\intel-bsd_1.yml", "YAML", 0, 0, 0, 2, 0, 0, 1, 3
"d:\IDEWORK\lvmen\src\licensedcode\data\rules\intel-bsd_2.yml", "YAML", 0, 0, 0, 2, 0, 0, 1, 3
"d:\IDEWORK\lvmen\src\licensedcode\data\rules\intel-bsd_3.yml", "YAML", 0, 0, 0, 2, 0, 0, 1, 3
"d:\IDEWORK\lvmen\src\licensedcode\data\rules\intel-bsd_4.yml", "YAML", 0, 0, 0, 3, 0, 0, 1, 4
"d:\IDEWORK\lvmen\src\licensedcode\data\rules\intel-bsd_5.yml", "YAML", 0, 0, 0, 4, 0, 0, 1, 5
"d:\IDEWORK\lvmen\src\licensedcode\data\rules\intel-bsd_or_gpl-2.0_1.yml", "YAML", 0, 0, 0, 3, 0, 0, 1, 4
"d:\IDEWORK\lvmen\src\licensedcode\data\rules\intel-bsd_or_gpl-2.0_2.yml", "YAML", 0, 0, 0, 3, 0, 0, 1, 4
"d:\IDEWORK\lvmen\src\licensedcode\data\rules\intel-bsd_or_gpl-2.0_3.yml", "YAML", 0, 0, 0, 3, 0, 0, 1, 4
"d:\IDEWORK\lvmen\src\licensedcode\data\rules\intel-bsd_or_gpl-2.0_4.yml", "YAML", 0, 0, 0, 4, 0, 0, 1, 5
"d:\IDEWORK\lvmen\src\licensedcode\data\rules\intel-bsd_or_gpl-2.0_5.yml", "YAML", 0, 0, 0, 3, 0, 0, 1, 4
"d:\IDEWORK\lvmen\src\licensedcode\data\rules\intel-bsd_or_gpl_3.yml", "YAML", 0, 0, 0, 3, 0, 0, 1, 4
"d:\IDEWORK\lvmen\src\licensedcode\data\rules\intel-confidential_1.yml", "YAML", 0, 0, 0, 2, 0, 0, 1, 3
"d:\IDEWORK\lvmen\src\licensedcode\data\rules\intel-firmware_1.yml", "YAML", 0, 0, 0, 5, 0, 0, 1, 6
"d:\IDEWORK\lvmen\src\licensedcode\data\rules\intel-material_1.yml", "YAML", 0, 0, 0, 4, 0, 0, 1, 5
"d:\IDEWORK\lvmen\src\licensedcode\data\rules\intel.yml", "YAML", 0, 0, 0, 5, 0, 0, 1, 6
"d:\IDEWORK\lvmen\src\licensedcode\data\rules\intel_1.yml", "YAML", 0, 0, 0, 6, 0, 0, 1, 7
"d:\IDEWORK\lvmen\src\licensedcode\data\rules\intel_2.yml", "YAML", 0, 0, 0, 4, 0, 0, 1, 5
"d:\IDEWORK\lvmen\src\licensedcode\data\rules\intel_3.yml", "YAML", 0, 0, 0, 6, 0, 0, 1, 7
"d:\IDEWORK\lvmen\src\licensedcode\data\rules\intel_4.yml", "YAML", 0, 0, 0, 6, 0, 0, 1, 7
"d:\IDEWORK\lvmen\src\licensedcode\data\rules\interbase-1.0_1.yml", "YAML", 0, 0, 0, 5, 0, 0, 1, 6
"d:\IDEWORK\lvmen\src\licensedcode\data\rules\interbase-1.0_2.yml", "YAML", 0, 0, 0, 4, 0, 0, 1, 5
"d:\IDEWORK\lvmen\src\licensedcode\data\rules\interbase-1.0_url_1.yml", "YAML", 0, 0, 0, 5, 0, 0, 1, 6
"d:\IDEWORK\lvmen\src\licensedcode\data\rules\interbase-1.0_url_2.yml", "YAML", 0, 0, 0, 5, 0, 0, 1, 6
"d:\IDEWORK\lvmen\src\licensedcode\data\rules\iolib-exception-2.0_1.yml", "YAML", 0, 0, 0, 5, 0, 0, 1, 6
"d:\IDEWORK\lvmen\src\licensedcode\data\rules\iolib-exception-2.0_2.yml", "YAML", 0, 0, 0, 5, 0, 0, 1, 6
"d:\IDEWORK\lvmen\src\licensedcode\data\rules\ipa-font.yml", "YAML", 0, 0, 0, 5, 0, 0, 1, 6
"d:\IDEWORK\lvmen\src\licensedcode\data\rules\ipa-font_1.yml", "YAML", 0, 0, 0, 3, 0, 0, 1, 4
"d:\IDEWORK\lvmen\src\licensedcode\data\rules\ipa-font_2.yml", "YAML", 0, 0, 0, 5, 0, 0, 1, 6
"d:\IDEWORK\lvmen\src\licensedcode\data\rules\ipa-font_3.yml", "YAML", 0, 0, 0, 3, 0, 0, 1, 4
"d:\IDEWORK\lvmen\src\licensedcode\data\rules\ipa-font_4.yml", "YAML", 0, 0, 0, 3, 0, 0, 1, 4
"d:\IDEWORK\lvmen\src\licensedcode\data\rules\ipa-font_5.yml", "YAML", 0, 0, 0, 2, 0, 0, 1, 3
"d:\IDEWORK\lvmen\src\licensedcode\data\rules\ipa-font_url_1.yml", "YAML", 0, 0, 0, 5, 0, 0, 1, 6
"d:\IDEWORK\lvmen\src\licensedcode\data\rules\ipa-font_url_2.yml", "YAML", 0, 0, 0, 5, 0, 0, 1, 6
"d:\IDEWORK\lvmen\src\licensedcode\data\rules\ipa-font_url_glc_172.yml", "YAML", 0, 0, 0, 5, 0, 0, 1, 6
"d:\IDEWORK\lvmen\src\licensedcode\data\rules\ipa-font_url_glc_173.yml", "YAML", 0, 0, 0, 5, 0, 0, 1, 6
"d:\IDEWORK\lvmen\src\licensedcode\data\rules\iptc-2006_1.yml", "YAML", 0, 0, 0, 3, 0, 0, 1, 4
"d:\IDEWORK\lvmen\src\licensedcode\data\rules\isc-ormlite_1.yml", "YAML", 0, 0, 0, 5, 0, 0, 1, 6
"d:\IDEWORK\lvmen\src\licensedcode\data\rules\isc-ormlite_2.yml", "YAML", 0, 0, 0, 5, 0, 0, 1, 6
"d:\IDEWORK\lvmen\src\licensedcode\data\rules\isc.yml", "YAML", 0, 0, 0, 5, 0, 0, 1, 6
"d:\IDEWORK\lvmen\src\licensedcode\data\rules\isc_0.yml", "YAML", 0, 0, 0, 3, 0, 0, 1, 4
"d:\IDEWORK\lvmen\src\licensedcode\data\rules\isc_1.yml", "YAML", 0, 0, 0, 5, 0, 0, 1, 6
"d:\IDEWORK\lvmen\src\licensedcode\data\rules\isc_10.yml", "YAML", 0, 0, 0, 3, 0, 0, 1, 4
"d:\IDEWORK\lvmen\src\licensedcode\data\rules\isc_11.yml", "YAML", 0, 0, 0, 3, 0, 0, 1, 4
"d:\IDEWORK\lvmen\src\licensedcode\data\rules\isc_12.yml", "YAML", 0, 0, 0, 3, 0, 0, 1, 4
"d:\IDEWORK\lvmen\src\licensedcode\data\rules\isc_13.yml", "YAML", 0, 0, 0, 3, 0, 0, 1, 4
"d:\IDEWORK\lvmen\src\licensedcode\data\rules\isc_14.yml", "YAML", 0, 0, 0, 2, 0, 0, 1, 3
"d:\IDEWORK\lvmen\src\licensedcode\data\rules\isc_15.yml", "YAML", 0, 0, 0, 5, 0, 0, 1, 6
"d:\IDEWORK\lvmen\src\licensedcode\data\rules\isc_16.yml", "YAML", 0, 0, 0, 5, 0, 0, 1, 6
"d:\IDEWORK\lvmen\src\licensedcode\data\rules\isc_17.yml", "YAML", 0, 0, 0, 3, 0, 0, 1, 4
"d:\IDEWORK\lvmen\src\licensedcode\data\rules\isc_18.yml", "YAML", 0, 0, 0, 5, 0, 0, 1, 6
"d:\IDEWORK\lvmen\src\licensedcode\data\rules\isc_19.yml", "YAML", 0, 0, 0, 2, 0, 0, 1, 3
"d:\IDEWORK\lvmen\src\licensedcode\data\rules\isc_2.yml", "YAML", 0, 0, 0, 5, 0, 0, 1, 6
"d:\IDEWORK\lvmen\src\licensedcode\data\rules\isc_20.yml", "YAML", 0, 0, 0, 2, 0, 0, 1, 3
"d:\IDEWORK\lvmen\src\licensedcode\data\rules\isc_21.yml", "YAML", 0, 0, 0, 5, 0, 0, 1, 6
"d:\IDEWORK\lvmen\src\licensedcode\data\rules\isc_22.yml", "YAML", 0, 0, 0, 3, 0, 0, 1, 4
"d:\IDEWORK\lvmen\src\licensedcode\data\rules\isc_23.yml", "YAML", 0, 0, 0, 3, 0, 0, 1, 4
"d:\IDEWORK\lvmen\src\licensedcode\data\rules\isc_24.yml", "YAML", 0, 0, 0, 5, 0, 0, 1, 6
"d:\IDEWORK\lvmen\src\licensedcode\data\rules\isc_25.yml", "YAML", 0, 0, 0, 3, 0, 0, 1, 4
"d:\IDEWORK\lvmen\src\licensedcode\data\rules\isc_26.yml", "YAML", 0, 0, 0, 3, 0, 0, 1, 4
"d:\IDEWORK\lvmen\src\licensedcode\data\rules\isc_27.yml", "YAML", 0, 0, 0, 3, 0, 0, 1, 4
"d:\IDEWORK\lvmen\src\licensedcode\data\rules\isc_28.yml", "YAML", 0, 0, 0, 3, 0, 0, 1, 4
"d:\IDEWORK\lvmen\src\licensedcode\data\rules\isc_29.yml", "YAML", 0, 0, 0, 3, 0, 0, 1, 4
"d:\IDEWORK\lvmen\src\licensedcode\data\rules\isc_3.yml", "YAML", 0, 0, 0, 5, 0, 0, 1, 6
"d:\IDEWORK\lvmen\src\licensedcode\data\rules\isc_30.yml", "YAML", 0, 0, 0, 5, 0, 0, 1, 6
"d:\IDEWORK\lvmen\src\licensedcode\data\rules\isc_31.yml", "YAML", 0, 0, 0, 5, 0, 0, 1, 6
"d:\IDEWORK\lvmen\src\licensedcode\data\rules\isc_32.yml", "YAML", 0, 0, 0, 2, 0, 0, 1, 3
"d:\IDEWORK\lvmen\src\licensedcode\data\rules\isc_33.yml", "YAML", 0, 0, 0, 3, 0, 0, 1, 4
"d:\IDEWORK\lvmen\src\licensedcode\data\rules\isc_34.yml", "YAML", 0, 0, 0, 2, 0, 0, 1, 3
"d:\IDEWORK\lvmen\src\licensedcode\data\rules\isc_35.yml", "YAML", 0, 0, 0, 5, 0, 0, 1, 6
"d:\IDEWORK\lvmen\src\licensedcode\data\rules\isc_36.yml", "YAML", 0, 0, 0, 5, 0, 0, 1, 6
"d:\IDEWORK\lvmen\src\licensedcode\data\rules\isc_37.yml", "YAML", 0, 0, 0, 5, 0, 0, 1, 6
"d:\IDEWORK\lvmen\src\licensedcode\data\rules\isc_38.yml", "YAML", 0, 0, 0, 3, 0, 0, 1, 4
"d:\IDEWORK\lvmen\src\licensedcode\data\rules\isc_39.yml", "YAML", 0, 0, 0, 7, 0, 0, 1, 8
"d:\IDEWORK\lvmen\src\licensedcode\data\rules\isc_4.yml", "YAML", 0, 0, 0, 5, 0, 0, 1, 6
"d:\IDEWORK\lvmen\src\licensedcode\data\rules\isc_40.yml", "YAML", 0, 0, 0, 5, 0, 0, 1, 6
"d:\IDEWORK\lvmen\src\licensedcode\data\rules\isc_41.yml", "YAML", 0, 0, 0, 5, 0, 0, 1, 6
"d:\IDEWORK\lvmen\src\licensedcode\data\rules\isc_42.yml", "YAML", 0, 0, 0, 5, 0, 0, 1, 6
"d:\IDEWORK\lvmen\src\licensedcode\data\rules\isc_43.yml", "YAML", 0, 0, 0, 5, 0, 0, 1, 6
"d:\IDEWORK\lvmen\src\licensedcode\data\rules\isc_44.yml", "YAML", 0, 0, 0, 3, 0, 0, 1, 4
"d:\IDEWORK\lvmen\src\licensedcode\data\rules\isc_45.yml", "YAML", 0, 0, 0, 3, 0, 0, 1, 4
"d:\IDEWORK\lvmen\src\licensedcode\data\rules\isc_46.yml", "YAML", 0, 0, 0, 4, 0, 0, 1, 5
"d:\IDEWORK\lvmen\src\licensedcode\data\rules\isc_47.yml", "YAML", 0, 0, 0, 3, 0, 0, 1, 4
"d:\IDEWORK\lvmen\src\licensedcode\data\rules\isc_48.yml", "YAML", 0, 0, 0, 4, 0, 0, 1, 5
"d:\IDEWORK\lvmen\src\licensedcode\data\rules\isc_49.yml", "YAML", 0, 0, 0, 3, 0, 0, 1, 4
"d:\IDEWORK\lvmen\src\licensedcode\data\rules\isc_5.yml", "YAML", 0, 0, 0, 6, 0, 0, 1, 7
"d:\IDEWORK\lvmen\src\licensedcode\data\rules\isc_50.yml", "YAML", 0, 0, 0, 5, 0, 0, 1, 6
"d:\IDEWORK\lvmen\src\licensedcode\data\rules\isc_51.yml", "YAML", 0, 0, 0, 6, 0, 0, 1, 7
"d:\IDEWORK\lvmen\src\licensedcode\data\rules\isc_52.yml", "YAML", 0, 0, 0, 7, 0, 0, 1, 8
"d:\IDEWORK\lvmen\src\licensedcode\data\rules\isc_53.yml", "YAML", 0, 0, 0, 5, 0, 0, 1, 6
"d:\IDEWORK\lvmen\src\licensedcode\data\rules\isc_54.yml", "YAML", 0, 0, 0, 4, 0, 0, 1, 5
"d:\IDEWORK\lvmen\src\licensedcode\data\rules\isc_55.yml", "YAML", 0, 0, 0, 5, 0, 0, 1, 6
"d:\IDEWORK\lvmen\src\licensedcode\data\rules\isc_56.yml", "YAML", 0, 0, 0, 5, 0, 0, 1, 6
"d:\IDEWORK\lvmen\src\licensedcode\data\rules\isc_57.yml", "YAML", 0, 0, 0, 5, 0, 0, 1, 6
"d:\IDEWORK\lvmen\src\licensedcode\data\rules\isc_58.yml", "YAML", 0, 0, 0, 3, 0, 0, 1, 4
"d:\IDEWORK\lvmen\src\licensedcode\data\rules\isc_59.yml", "YAML", 0, 0, 0, 5, 0, 0, 1, 6
"d:\IDEWORK\lvmen\src\licensedcode\data\rules\isc_6.yml", "YAML", 0, 0, 0, 3, 0, 0, 1, 4
"d:\IDEWORK\lvmen\src\licensedcode\data\rules\isc_60.yml", "YAML", 0, 0, 0, 5, 0, 0, 1, 6
"d:\IDEWORK\lvmen\src\licensedcode\data\rules\isc_61.yml", "YAML", 0, 0, 0, 5, 0, 0, 1, 6
"d:\IDEWORK\lvmen\src\licensedcode\data\rules\isc_62.yml", "YAML", 0, 0, 0, 5, 0, 0, 1, 6
"d:\IDEWORK\lvmen\src\licensedcode\data\rules\isc_63.yml", "YAML", 0, 0, 0, 5, 0, 0, 1, 6
"d:\IDEWORK\lvmen\src\licensedcode\data\rules\isc_64.yml", "YAML", 0, 0, 0, 5, 0, 0, 1, 6
"d:\IDEWORK\lvmen\src\licensedcode\data\rules\isc_65.yml", "YAML", 0, 0, 0, 3, 0, 0, 1, 4
"d:\IDEWORK\lvmen\src\licensedcode\data\rules\isc_66.yml", "YAML", 0, 0, 0, 3, 0, 0, 1, 4
"d:\IDEWORK\lvmen\src\licensedcode\data\rules\isc_67.yml", "YAML", 0, 0, 0, 3, 0, 0, 1, 4
"d:\IDEWORK\lvmen\src\licensedcode\data\rules\isc_68.yml", "YAML", 0, 0, 0, 5, 0, 0, 1, 6
"d:\IDEWORK\lvmen\src\licensedcode\data\rules\isc_69.yml", "YAML", 0, 0, 0, 3, 0, 0, 1, 4
"d:\IDEWORK\lvmen\src\licensedcode\data\rules\isc_7.yml", "YAML", 0, 0, 0, 2, 0, 0, 1, 3
"d:\IDEWORK\lvmen\src\licensedcode\data\rules\isc_70.yml", "YAML", 0, 0, 0, 3, 0, 0, 1, 4
"d:\IDEWORK\lvmen\src\licensedcode\data\rules\isc_71.yml", "YAML", 0, 0, 0, 5, 0, 0, 1, 6
"d:\IDEWORK\lvmen\src\licensedcode\data\rules\isc_72.yml", "YAML", 0, 0, 0, 5, 0, 0, 1, 6
"d:\IDEWORK\lvmen\src\licensedcode\data\rules\isc_73.yml", "YAML", 0, 0, 0, 5, 0, 0, 1, 6
"d:\IDEWORK\lvmen\src\licensedcode\data\rules\isc_74.yml", "YAML", 0, 0, 0, 3, 0, 0, 1, 4
"d:\IDEWORK\lvmen\src\licensedcode\data\rules\isc_75.yml", "YAML", 0, 0, 0, 5, 0, 0, 1, 6
"d:\IDEWORK\lvmen\src\licensedcode\data\rules\isc_76.yml", "YAML", 0, 0, 0, 3, 0, 0, 1, 4
"d:\IDEWORK\lvmen\src\licensedcode\data\rules\isc_77.yml", "YAML", 0, 0, 0, 3, 0, 0, 1, 4
"d:\IDEWORK\lvmen\src\licensedcode\data\rules\isc_78.yml", "YAML", 0, 0, 0, 3, 0, 0, 1, 4
"d:\IDEWORK\lvmen\src\licensedcode\data\rules\isc_79.yml", "YAML", 0, 0, 0, 3, 0, 0, 1, 4
"d:\IDEWORK\lvmen\src\licensedcode\data\rules\isc_8.yml", "YAML", 0, 0, 0, 2, 0, 0, 1, 3
"d:\IDEWORK\lvmen\src\licensedcode\data\rules\isc_80.yml", "YAML", 0, 0, 0, 3, 0, 0, 1, 4
"d:\IDEWORK\lvmen\src\licensedcode\data\rules\isc_81.yml", "YAML", 0, 0, 0, 3, 0, 0, 1, 4
"d:\IDEWORK\lvmen\src\licensedcode\data\rules\isc_82.yml", "YAML", 0, 0, 0, 5, 0, 0, 1, 6
"d:\IDEWORK\lvmen\src\licensedcode\data\rules\isc_83.yml", "YAML", 0, 0, 0, 3, 0, 0, 1, 4
"d:\IDEWORK\lvmen\src\licensedcode\data\rules\isc_84.yml", "YAML", 0, 0, 0, 3, 0, 0, 1, 4
"d:\IDEWORK\lvmen\src\licensedcode\data\rules\isc_85.yml", "YAML", 0, 0, 0, 6, 0, 0, 1, 7
"d:\IDEWORK\lvmen\src\licensedcode\data\rules\isc_86.yml", "YAML", 0, 0, 0, 3, 0, 0, 1, 4
"d:\IDEWORK\lvmen\src\licensedcode\data\rules\isc_9.yml", "YAML", 0, 0, 0, 2, 0, 0, 1, 3
"d:\IDEWORK\lvmen\src\licensedcode\data\rules\isc_and_free-unknown.yml", "YAML", 0, 0, 0, 2, 0, 0, 1, 3
"d:\IDEWORK\lvmen\src\licensedcode\data\rules\isc_and_free-unknown2.yml", "YAML", 0, 0, 0, 3, 0, 0, 1, 4
"d:\IDEWORK\lvmen\src\licensedcode\data\rules\isc_and_proprietary-license_1.yml", "YAML", 0, 0, 0, 5, 0, 0, 1, 6
"d:\IDEWORK\lvmen\src\licensedcode\data\rules\isc_or_mit_1.yml", "YAML", 0, 0, 0, 3, 0, 0, 1, 4
"d:\IDEWORK\lvmen\src\licensedcode\data\rules\isc_or_mit_2.yml", "YAML", 0, 0, 0, 3, 0, 0, 1, 4
"d:\IDEWORK\lvmen\src\licensedcode\data\rules\isc_truncated.yml", "YAML", 0, 0, 0, 5, 0, 0, 1, 6
"d:\IDEWORK\lvmen\src\licensedcode\data\rules\isc_url_1.yml", "YAML", 0, 0, 0, 5, 0, 0, 1, 6
"d:\IDEWORK\lvmen\src\licensedcode\data\rules\isc_url_2.yml", "YAML", 0, 0, 0, 5, 0, 0, 1, 6
"d:\IDEWORK\lvmen\src\licensedcode\data\rules\isc_url_glc_176.yml", "YAML", 0, 0, 0, 5, 0, 0, 1, 6
"d:\IDEWORK\lvmen\src\licensedcode\data\rules\isc_url_glc_177.yml", "YAML", 0, 0, 0, 5, 0, 0, 1, 6
"d:\IDEWORK\lvmen\src\licensedcode\data\rules\iso-cpp-exception-2.0_1.yml", "YAML", 0, 0, 0, 4, 0, 0, 1, 5
"d:\IDEWORK\lvmen\src\licensedcode\data\rules\iso-cpp-exception-2.0_2.yml", "YAML", 0, 0, 0, 4, 0, 0, 1, 5
"d:\IDEWORK\lvmen\src\licensedcode\data\rules\isotope-cla_1.yml", "YAML", 0, 0, 0, 5, 0, 0, 1, 6
"d:\IDEWORK\lvmen\src\licensedcode\data\rules\itu-t_1.yml", "YAML", 0, 0, 0, 5, 0, 0, 1, 6
"d:\IDEWORK\lvmen\src\licensedcode\data\rules\itu-t_2.yml", "YAML", 0, 0, 0, 5, 0, 0, 1, 6
"d:\IDEWORK\lvmen\src\licensedcode\data\rules\itunes.yml", "YAML", 0, 0, 0, 5, 0, 0, 1, 6
"d:\IDEWORK\lvmen\src\licensedcode\data\rules\jabber.yml", "YAML", 0, 0, 0, 12, 0, 0, 1, 13
"d:\IDEWORK\lvmen\src\licensedcode\data\rules\jahia-1.3.1.yml", "YAML", 0, 0, 0, 5, 0, 0, 1, 6
"d:\IDEWORK\lvmen\src\licensedcode\data\rules\jam.yml", "YAML", 0, 0, 0, 3, 0, 0, 1, 4
"d:\IDEWORK\lvmen\src\licensedcode\data\rules\jasper-2.0_1.yml", "YAML", 0, 0, 0, 3, 0, 0, 1, 4
"d:\IDEWORK\lvmen\src\licensedcode\data\rules\jasper-2.0_2.yml", "YAML", 0, 0, 0, 3, 0, 0, 1, 4
"d:\IDEWORK\lvmen\src\licensedcode\data\rules\jasper-2.0_3.yml", "YAML", 0, 0, 0, 3, 0, 0, 1, 4
"d:\IDEWORK\lvmen\src\licensedcode\data\rules\jasper-2.0_4.yml", "YAML", 0, 0, 0, 3, 0, 0, 1, 4
"d:\IDEWORK\lvmen\src\licensedcode\data\rules\jasper-2.0_5.yml", "YAML", 0, 0, 0, 3, 0, 0, 1, 4
"d:\IDEWORK\lvmen\src\licensedcode\data\rules\jasper-2.0_6.yml", "YAML", 0, 0, 0, 3, 0, 0, 1, 4
"d:\IDEWORK\lvmen\src\licensedcode\data\rules\jasper-2.0_7.yml", "YAML", 0, 0, 0, 3, 0, 0, 1, 4
"d:\IDEWORK\lvmen\src\licensedcode\data\rules\jasper-2.0_url_1.yml", "YAML", 0, 0, 0, 5, 0, 0, 1, 6
"d:\IDEWORK\lvmen\src\licensedcode\data\rules\jasper-2.0_url_2.yml", "YAML", 0, 0, 0, 5, 0, 0, 1, 6
"d:\IDEWORK\lvmen\src\licensedcode\data\rules\javascript-exception-2.0_1.yml", "YAML", 0, 0, 0, 4, 0, 0, 1, 5
"d:\IDEWORK\lvmen\src\licensedcode\data\rules\jboss-eula.yml", "YAML", 0, 0, 0, 5, 0, 0, 1, 6
"d:\IDEWORK\lvmen\src\licensedcode\data\rules\jdom.yml", "YAML", 0, 0, 0, 13, 0, 0, 1, 14
"d:\IDEWORK\lvmen\src\licensedcode\data\rules\jdom_1.yml", "YAML", 0, 0, 0, 3, 0, 0, 1, 4
"d:\IDEWORK\lvmen\src\licensedcode\data\rules\jdom_2.yml", "YAML", 0, 0, 0, 8, 0, 0, 1, 9
"d:\IDEWORK\lvmen\src\licensedcode\data\rules\jdom_3.yml", "YAML", 0, 0, 0, 13, 0, 0, 1, 14
"d:\IDEWORK\lvmen\src\licensedcode\data\rules\jdom_4.yml", "YAML", 0, 0, 0, 3, 0, 0, 1, 4
"d:\IDEWORK\lvmen\src\licensedcode\data\rules\jetty_1.yml", "YAML", 0, 0, 0, 5, 0, 0, 1, 6
"d:\IDEWORK\lvmen\src\licensedcode\data\rules\jetty_2.yml", "YAML", 0, 0, 0, 5, 0, 0, 1, 6
"d:\IDEWORK\lvmen\src\licensedcode\data\rules\jetty_3.yml", "YAML", 0, 0, 0, 13, 0, 0, 1, 14
"d:\IDEWORK\lvmen\src\licensedcode\data\rules\jetty_4.yml", "YAML", 0, 0, 0, 15, 0, 0, 1, 16
"d:\IDEWORK\lvmen\src\licensedcode\data\rules\jgraph-general.yml", "YAML", 0, 0, 0, 2, 0, 0, 1, 3
"d:\IDEWORK\lvmen\src\licensedcode\data\rules\josl-1.0.yml", "YAML", 0, 0, 0, 5, 0, 0, 1, 6
"d:\IDEWORK\lvmen\src\licensedcode\data\rules\josl-1.0_1.yml", "YAML", 0, 0, 0, 5, 0, 0, 1, 6
"d:\IDEWORK\lvmen\src\licensedcode\data\rules\josl-1.0_or_gpl-1.0-plus_1.yml", "YAML", 0, 0, 0, 6, 0, 0, 1, 7
"d:\IDEWORK\lvmen\src\licensedcode\data\rules\josl-1.0_or_gpl-1.0-plus_2.yml", "YAML", 0, 0, 0, 6, 0, 0, 1, 7
"d:\IDEWORK\lvmen\src\licensedcode\data\rules\jpnic-idnkit_url_1.yml", "YAML", 0, 0, 0, 5, 0, 0, 1, 6
"d:\IDEWORK\lvmen\src\licensedcode\data\rules\jpnic-idnkit_url_2.yml", "YAML", 0, 0, 0, 5, 0, 0, 1, 6
"d:\IDEWORK\lvmen\src\licensedcode\data\rules\jpython-1.1.yml", "YAML", 0, 0, 0, 5, 0, 0, 1, 6
"d:\IDEWORK\lvmen\src\licensedcode\data\rules\jpython-1.1_1.yml", "YAML", 0, 0, 0, 8, 0, 0, 1, 9
"d:\IDEWORK\lvmen\src\licensedcode\data\rules\jpython-1.1_2.yml", "YAML", 0, 0, 0, 8, 0, 0, 1, 9
"d:\IDEWORK\lvmen\src\licensedcode\data\rules\jrunner.yml", "YAML", 0, 0, 0, 5, 0, 0, 1, 6
"d:\IDEWORK\lvmen\src\licensedcode\data\rules\jscheme_1.yml", "YAML", 0, 0, 0, 4, 0, 0, 1, 5
"d:\IDEWORK\lvmen\src\licensedcode\data\rules\jscheme_2.yml", "YAML", 0, 0, 0, 4, 0, 0, 1, 5
"d:\IDEWORK\lvmen\src\licensedcode\data\rules\jscheme_3.yml", "YAML", 0, 0, 0, 10, 0, 0, 1, 11
"d:\IDEWORK\lvmen\src\licensedcode\data\rules\jscheme_4.yml", "YAML", 0, 0, 0, 4, 0, 0, 1, 5
"d:\IDEWORK\lvmen\src\licensedcode\data\rules\json-pd_1.yml", "YAML", 0, 0, 0, 5, 0, 0, 1, 6
"d:\IDEWORK\lvmen\src\licensedcode\data\rules\json.yml", "YAML", 0, 0, 0, 5, 0, 0, 1, 6
"d:\IDEWORK\lvmen\src\licensedcode\data\rules\json2.yml", "YAML", 0, 0, 0, 5, 0, 0, 1, 6
"d:\IDEWORK\lvmen\src\licensedcode\data\rules\json3.yml", "YAML", 0, 0, 0, 3, 0, 0, 2, 5
"d:\IDEWORK\lvmen\src\licensedcode\data\rules\json4.yml", "YAML", 0, 0, 0, 3, 0, 0, 1, 4
"d:\IDEWORK\lvmen\src\licensedcode\data\rules\json_1.yml", "YAML", 0, 0, 0, 5, 0, 0, 1, 6
"d:\IDEWORK\lvmen\src\licensedcode\data\rules\json_2.yml", "YAML", 0, 0, 0, 5, 0, 0, 1, 6
"d:\IDEWORK\lvmen\src\licensedcode\data\rules\json_3.yml", "YAML", 0, 0, 0, 3, 0, 0, 1, 4
"d:\IDEWORK\lvmen\src\licensedcode\data\rules\json_url_1.yml", "YAML", 0, 0, 0, 5, 0, 0, 1, 6
"d:\IDEWORK\lvmen\src\licensedcode\data\rules\json_url_2.yml", "YAML", 0, 0, 0, 5, 0, 0, 1, 6
"d:\IDEWORK\lvmen\src\licensedcode\data\rules\jsr-107-jcache-spec-2013_1.yml", "YAML", 0, 0, 0, 5, 0, 0, 1, 6
"d:\IDEWORK\lvmen\src\licensedcode\data\rules\jsr-107-jcache-spec-2013_2.yml", "YAML", 0, 0, 0, 3, 0, 0, 1, 4
"d:\IDEWORK\lvmen\src\licensedcode\data\rules\jsr-107-jcache-spec_1.yml", "YAML", 0, 0, 0, 11, 0, 0, 1, 12
"d:\IDEWORK\lvmen\src\licensedcode\data\rules\jython.yml", "YAML", 0, 0, 0, 5, 0, 0, 1, 6
"d:\IDEWORK\lvmen\src\licensedcode\data\rules\jython2.yml", "YAML", 0, 0, 0, 3, 0, 0, 1, 4
"d:\IDEWORK\lvmen\src\licensedcode\data\rules\jython3.yml", "YAML", 0, 0, 0, 15, 0, 0, 1, 16
"d:\IDEWORK\lvmen\src\licensedcode\data\rules\kalle-kaukonen_5.yml", "YAML", 0, 0, 0, 2, 0, 0, 1, 3
"d:\IDEWORK\lvmen\src\licensedcode\data\rules\kerberos_1.yml", "YAML", 0, 0, 0, 3, 0, 0, 1, 4
"d:\IDEWORK\lvmen\src\licensedcode\data\rules\khronos.yml", "YAML", 0, 0, 0, 5, 0, 0, 1, 6
"d:\IDEWORK\lvmen\src\licensedcode\data\rules\khronos2.yml", "YAML", 0, 0, 0, 2, 0, 0, 1, 3
"d:\IDEWORK\lvmen\src\licensedcode\data\rules\khronos_1.yml", "YAML", 0, 0, 0, 3, 0, 0, 1, 4
"d:\IDEWORK\lvmen\src\licensedcode\data\rules\khronos_2.yml", "YAML", 0, 0, 0, 4, 0, 0, 1, 5
"d:\IDEWORK\lvmen\src\licensedcode\data\rules\khronos_3.yml", "YAML", 0, 0, 0, 3, 0, 0, 1, 4
"d:\IDEWORK\lvmen\src\licensedcode\data\rules\larabie.yml", "YAML", 0, 0, 0, 4, 0, 0, 1, 5
"d:\IDEWORK\lvmen\src\licensedcode\data\rules\latex2e_1.yml", "YAML", 0, 0, 0, 4, 0, 0, 1, 5
"d:\IDEWORK\lvmen\src\licensedcode\data\rules\latex2e_2.yml", "YAML", 0, 0, 0, 4, 0, 0, 1, 5
"d:\IDEWORK\lvmen\src\licensedcode\data\rules\latex2e_3.yml", "YAML", 0, 0, 0, 4, 0, 0, 1, 5
"d:\IDEWORK\lvmen\src\licensedcode\data\rules\latex2e_4.yml", "YAML", 0, 0, 0, 4, 0, 0, 1, 5
"d:\IDEWORK\lvmen\src\licensedcode\data\rules\latex2e_5.yml", "YAML", 0, 0, 0, 4, 0, 0, 1, 5
"d:\IDEWORK\lvmen\src\licensedcode\data\rules\latex2e_6.yml", "YAML", 0, 0, 0, 4, 0, 0, 1, 5
"d:\IDEWORK\lvmen\src\licensedcode\data\rules\latex2e_7.yml", "YAML", 0, 0, 0, 4, 0, 0, 1, 5
"d:\IDEWORK\lvmen\src\licensedcode\data\rules\latex2e_8.yml", "YAML", 0, 0, 0, 4, 0, 0, 2, 6
"d:\IDEWORK\lvmen\src\licensedcode\data\rules\latex2e_and_gpl-1.0-plus_1.yml", "YAML", 0, 0, 0, 4, 0, 0, 1, 5
"d:\IDEWORK\lvmen\src\licensedcode\data\rules\latex2e_url_1.yml", "YAML", 0, 0, 0, 5, 0, 0, 1, 6
"d:\IDEWORK\lvmen\src\licensedcode\data\rules\latex2e_url_2.yml", "YAML", 0, 0, 0, 5, 0, 0, 1, 6
"d:\IDEWORK\lvmen\src\licensedcode\data\rules\lavantech.yml", "YAML", 0, 0, 0, 5, 0, 0, 1, 6
"d:\IDEWORK\lvmen\src\licensedcode\data\rules\lbnl-bsd_1.yml", "YAML", 0, 0, 0, 6, 0, 0, 1, 7
"d:\IDEWORK\lvmen\src\licensedcode\data\rules\lbnl-bsd_2.yml", "YAML", 0, 0, 0, 3, 0, 0, 1, 4
"d:\IDEWORK\lvmen\src\licensedcode\data\rules\lbnl-bsd_3.yml", "YAML", 0, 0, 0, 3, 0, 0, 1, 4
"d:\IDEWORK\lvmen\src\licensedcode\data\rules\lbnl-bsd_4.yml", "YAML", 0, 0, 0, 8, 0, 0, 1, 9
"d:\IDEWORK\lvmen\src\licensedcode\data\rules\lbnl-bsd_5.yml", "YAML", 0, 0, 0, 3, 0, 0, 1, 4
"d:\IDEWORK\lvmen\src\licensedcode\data\rules\lbnl-bsd_url_1.yml", "YAML", 0, 0, 0, 5, 0, 0, 1, 6
"d:\IDEWORK\lvmen\src\licensedcode\data\rules\lbnl-bsd_url_2.yml", "YAML", 0, 0, 0, 5, 0, 0, 1, 6
"d:\IDEWORK\lvmen\src\licensedcode\data\rules\ldpgpl-1_1.yml", "YAML", 0, 0, 0, 3, 0, 0, 1, 4
"d:\IDEWORK\lvmen\src\licensedcode\data\rules\ldpgpl-1a_1.yml", "YAML", 0, 0, 0, 2, 0, 0, 1, 3
"d:\IDEWORK\lvmen\src\licensedcode\data\rules\ldpgpl-1a_2.yml", "YAML", 0, 0, 0, 2, 0, 0, 1, 3
"d:\IDEWORK\lvmen\src\licensedcode\data\rules\ldpgpl-1a_3.yml", "YAML", 0, 0, 0, 3, 0, 0, 1, 4
"d:\IDEWORK\lvmen\src\licensedcode\data\rules\lead-in_unknown_2.yml", "YAML", 0, 0, 0, 3, 0, 0, 1, 4
"d:\IDEWORK\lvmen\src\licensedcode\data\rules\lead-in_unknown_30.yml", "YAML", 0, 0, 0, 3, 0, 0, 1, 4
"d:\IDEWORK\lvmen\src\licensedcode\data\rules\lead-in_unknown_31.yml", "YAML", 0, 0, 0, 3, 0, 0, 1, 4
"d:\IDEWORK\lvmen\src\licensedcode\data\rules\lead-in_unknown_43.yml", "YAML", 0, 0, 0, 4, 0, 0, 1, 5
"d:\IDEWORK\lvmen\src\licensedcode\data\rules\leptonica_url_1.yml", "YAML", 0, 0, 0, 5, 0, 0, 1, 6
"d:\IDEWORK\lvmen\src\licensedcode\data\rules\leptonica_url_2.yml", "YAML", 0, 0, 0, 5, 0, 0, 1, 6
"d:\IDEWORK\lvmen\src\licensedcode\data\rules\lgpl-2.0-plus.yml", "YAML", 0, 0, 0, 3, 0, 0, 1, 4
"d:\IDEWORK\lvmen\src\licensedcode\data\rules\lgpl-2.0-plus_0.yml", "YAML", 0, 0, 0, 3, 0, 0, 1, 4
"d:\IDEWORK\lvmen\src\licensedcode\data\rules\lgpl-2.0-plus_1.yml", "YAML", 0, 0, 0, 4, 0, 0, 2, 6
"d:\IDEWORK\lvmen\src\licensedcode\data\rules\lgpl-2.0-plus_10.yml", "YAML", 0, 0, 0, 2, 0, 0, 1, 3
"d:\IDEWORK\lvmen\src\licensedcode\data\rules\lgpl-2.0-plus_100.yml", "YAML", 0, 0, 0, 5, 0, 0, 1, 6
"d:\IDEWORK\lvmen\src\licensedcode\data\rules\lgpl-2.0-plus_101.yml", "YAML", 0, 0, 0, 3, 0, 0, 1, 4
"d:\IDEWORK\lvmen\src\licensedcode\data\rules\lgpl-2.0-plus_102.yml", "YAML", 0, 0, 0, 5, 0, 0, 1, 6
"d:\IDEWORK\lvmen\src\licensedcode\data\rules\lgpl-2.0-plus_103.yml", "YAML", 0, 0, 0, 3, 0, 0, 1, 4
"d:\IDEWORK\lvmen\src\licensedcode\data\rules\lgpl-2.0-plus_104.yml", "YAML", 0, 0, 0, 3, 0, 0, 1, 4
"d:\IDEWORK\lvmen\src\licensedcode\data\rules\lgpl-2.0-plus_105.yml", "YAML", 0, 0, 0, 3, 0, 0, 1, 4
"d:\IDEWORK\lvmen\src\licensedcode\data\rules\lgpl-2.0-plus_106.yml", "YAML", 0, 0, 0, 3, 0, 0, 1, 4
"d:\IDEWORK\lvmen\src\licensedcode\data\rules\lgpl-2.0-plus_107.yml", "YAML", 0, 0, 0, 3, 0, 0, 1, 4
"d:\IDEWORK\lvmen\src\licensedcode\data\rules\lgpl-2.0-plus_108.yml", "YAML", 0, 0, 0, 3, 0, 0, 1, 4
"d:\IDEWORK\lvmen\src\licensedcode\data\rules\lgpl-2.0-plus_109.yml", "YAML", 0, 0, 0, 3, 0, 0, 1, 4
"d:\IDEWORK\lvmen\src\licensedcode\data\rules\lgpl-2.0-plus_11.yml", "YAML", 0, 0, 0, 2, 0, 0, 1, 3
"d:\IDEWORK\lvmen\src\licensedcode\data\rules\lgpl-2.0-plus_110.yml", "YAML", 0, 0, 0, 3, 0, 0, 1, 4
"d:\IDEWORK\lvmen\src\licensedcode\data\rules\lgpl-2.0-plus_111.yml", "YAML", 0, 0, 0, 3, 0, 0, 1, 4
"d:\IDEWORK\lvmen\src\licensedcode\data\rules\lgpl-2.0-plus_112.yml", "YAML", 0, 0, 0, 3, 0, 0, 1, 4
"d:\IDEWORK\lvmen\src\licensedcode\data\rules\lgpl-2.0-plus_113.yml", "YAML", 0, 0, 0, 3, 0, 0, 1, 4
"d:\IDEWORK\lvmen\src\licensedcode\data\rules\lgpl-2.0-plus_114.yml", "YAML", 0, 0, 0, 3, 0, 0, 1, 4
"d:\IDEWORK\lvmen\src\licensedcode\data\rules\lgpl-2.0-plus_115.yml", "YAML", 0, 0, 0, 3, 0, 0, 1, 4
"d:\IDEWORK\lvmen\src\licensedcode\data\rules\lgpl-2.0-plus_116.yml", "YAML", 0, 0, 0, 3, 0, 0, 1, 4
"d:\IDEWORK\lvmen\src\licensedcode\data\rules\lgpl-2.0-plus_117.yml", "YAML", 0, 0, 0, 3, 0, 0, 1, 4
"d:\IDEWORK\lvmen\src\licensedcode\data\rules\lgpl-2.0-plus_118.yml", "YAML", 0, 0, 0, 3, 0, 0, 1, 4
"d:\IDEWORK\lvmen\src\licensedcode\data\rules\lgpl-2.0-plus_119.yml", "YAML", 0, 0, 0, 3, 0, 0, 1, 4
"d:\IDEWORK\lvmen\src\licensedcode\data\rules\lgpl-2.0-plus_12.yml", "YAML", 0, 0, 0, 5, 0, 0, 1, 6
"d:\IDEWORK\lvmen\src\licensedcode\data\rules\lgpl-2.0-plus_120.yml", "YAML", 0, 0, 0, 3, 0, 0, 1, 4
"d:\IDEWORK\lvmen\src\licensedcode\data\rules\lgpl-2.0-plus_121.yml", "YAML", 0, 0, 0, 3, 0, 0, 1, 4
"d:\IDEWORK\lvmen\src\licensedcode\data\rules\lgpl-2.0-plus_122.yml", "YAML", 0, 0, 0, 3, 0, 0, 1, 4
"d:\IDEWORK\lvmen\src\licensedcode\data\rules\lgpl-2.0-plus_123.yml", "YAML", 0, 0, 0, 3, 0, 0, 1, 4
"d:\IDEWORK\lvmen\src\licensedcode\data\rules\lgpl-2.0-plus_124.yml", "YAML", 0, 0, 0, 3, 0, 0, 1, 4
"d:\IDEWORK\lvmen\src\licensedcode\data\rules\lgpl-2.0-plus_125.yml", "YAML", 0, 0, 0, 3, 0, 0, 1, 4
"d:\IDEWORK\lvmen\src\licensedcode\data\rules\lgpl-2.0-plus_126.yml", "YAML", 0, 0, 0, 3, 0, 0, 1, 4
"d:\IDEWORK\lvmen\src\licensedcode\data\rules\lgpl-2.0-plus_127.yml", "YAML", 0, 0, 0, 3, 0, 0, 1, 4
"d:\IDEWORK\lvmen\src\licensedcode\data\rules\lgpl-2.0-plus_128.yml", "YAML", 0, 0, 0, 3, 0, 0, 1, 4
"d:\IDEWORK\lvmen\src\licensedcode\data\rules\lgpl-2.0-plus_129.yml", "YAML", 0, 0, 0, 3, 0, 0, 1, 4
"d:\IDEWORK\lvmen\src\licensedcode\data\rules\lgpl-2.0-plus_13.yml", "YAML", 0, 0, 0, 2, 0, 0, 1, 3
"d:\IDEWORK\lvmen\src\licensedcode\data\rules\lgpl-2.0-plus_130.yml", "YAML", 0, 0, 0, 3, 0, 0, 1, 4
"d:\IDEWORK\lvmen\src\licensedcode\data\rules\lgpl-2.0-plus_131.yml", "YAML", 0, 0, 0, 3, 0, 0, 1, 4
"d:\IDEWORK\lvmen\src\licensedcode\data\rules\lgpl-2.0-plus_132.yml", "YAML", 0, 0, 0, 3, 0, 0, 1, 4
"d:\IDEWORK\lvmen\src\licensedcode\data\rules\lgpl-2.0-plus_133.yml", "YAML", 0, 0, 0, 3, 0, 0, 1, 4
"d:\IDEWORK\lvmen\src\licensedcode\data\rules\lgpl-2.0-plus_134.yml", "YAML", 0, 0, 0, 3, 0, 0, 1, 4
"d:\IDEWORK\lvmen\src\licensedcode\data\rules\lgpl-2.0-plus_135.yml", "YAML", 0, 0, 0, 3, 0, 0, 1, 4
"d:\IDEWORK\lvmen\src\licensedcode\data\rules\lgpl-2.0-plus_136.yml", "YAML", 0, 0, 0, 3, 0, 0, 1, 4
"d:\IDEWORK\lvmen\src\licensedcode\data\rules\lgpl-2.0-plus_137.yml", "YAML", 0, 0, 0, 3, 0, 0, 1, 4
"d:\IDEWORK\lvmen\src\licensedcode\data\rules\lgpl-2.0-plus_138.yml", "YAML", 0, 0, 0, 3, 0, 0, 1, 4
"d:\IDEWORK\lvmen\src\licensedcode\data\rules\lgpl-2.0-plus_139.yml", "YAML", 0, 0, 0, 3, 0, 0, 1, 4
"d:\IDEWORK\lvmen\src\licensedcode\data\rules\lgpl-2.0-plus_14.yml", "YAML", 0, 0, 0, 2, 0, 0, 1, 3
"d:\IDEWORK\lvmen\src\licensedcode\data\rules\lgpl-2.0-plus_140.yml", "YAML", 0, 0, 0, 3, 0, 0, 1, 4
"d:\IDEWORK\lvmen\src\licensedcode\data\rules\lgpl-2.0-plus_141.yml", "YAML", 0, 0, 0, 3, 0, 0, 1, 4
"d:\IDEWORK\lvmen\src\licensedcode\data\rules\lgpl-2.0-plus_142.yml", "YAML", 0, 0, 0, 3, 0, 0, 1, 4
"d:\IDEWORK\lvmen\src\licensedcode\data\rules\lgpl-2.0-plus_143.yml", "YAML", 0, 0, 0, 3, 0, 0, 1, 4
"d:\IDEWORK\lvmen\src\licensedcode\data\rules\lgpl-2.0-plus_144.yml", "YAML", 0, 0, 0, 3, 0, 0, 1, 4
"d:\IDEWORK\lvmen\src\licensedcode\data\rules\lgpl-2.0-plus_145.yml", "YAML", 0, 0, 0, 3, 0, 0, 1, 4
"d:\IDEWORK\lvmen\src\licensedcode\data\rules\lgpl-2.0-plus_146.yml", "YAML", 0, 0, 0, 3, 0, 0, 1, 4
"d:\IDEWORK\lvmen\src\licensedcode\data\rules\lgpl-2.0-plus_147.yml", "YAML", 0, 0, 0, 3, 0, 0, 1, 4
"d:\IDEWORK\lvmen\src\licensedcode\data\rules\lgpl-2.0-plus_148.yml", "YAML", 0, 0, 0, 3, 0, 0, 1, 4
"d:\IDEWORK\lvmen\src\licensedcode\data\rules\lgpl-2.0-plus_149.yml", "YAML", 0, 0, 0, 3, 0, 0, 1, 4
"d:\IDEWORK\lvmen\src\licensedcode\data\rules\lgpl-2.0-plus_15.yml", "YAML", 0, 0, 0, 2, 0, 0, 1, 3
"d:\IDEWORK\lvmen\src\licensedcode\data\rules\lgpl-2.0-plus_150.yml", "YAML", 0, 0, 0, 3, 0, 0, 1, 4
"d:\IDEWORK\lvmen\src\licensedcode\data\rules\lgpl-2.0-plus_151.yml", "YAML", 0, 0, 0, 3, 0, 0, 1, 4
"d:\IDEWORK\lvmen\src\licensedcode\data\rules\lgpl-2.0-plus_152.yml", "YAML", 0, 0, 0, 3, 0, 0, 1, 4
"d:\IDEWORK\lvmen\src\licensedcode\data\rules\lgpl-2.0-plus_153.yml", "YAML", 0, 0, 0, 3, 0, 0, 1, 4
"d:\IDEWORK\lvmen\src\licensedcode\data\rules\lgpl-2.0-plus_154.yml", "YAML", 0, 0, 0, 3, 0, 0, 1, 4
"d:\IDEWORK\lvmen\src\licensedcode\data\rules\lgpl-2.0-plus_155.yml", "YAML", 0, 0, 0, 3, 0, 0, 1, 4
"d:\IDEWORK\lvmen\src\licensedcode\data\rules\lgpl-2.0-plus_156.yml", "YAML", 0, 0, 0, 3, 0, 0, 1, 4
"d:\IDEWORK\lvmen\src\licensedcode\data\rules\lgpl-2.0-plus_157.yml", "YAML", 0, 0, 0, 3, 0, 0, 1, 4
"d:\IDEWORK\lvmen\src\licensedcode\data\rules\lgpl-2.0-plus_158.yml", "YAML", 0, 0, 0, 3, 0, 0, 1, 4
"d:\IDEWORK\lvmen\src\licensedcode\data\rules\lgpl-2.0-plus_159.yml", "YAML", 0, 0, 0, 3, 0, 0, 1, 4
"d:\IDEWORK\lvmen\src\licensedcode\data\rules\lgpl-2.0-plus_16.yml", "YAML", 0, 0, 0, 2, 0, 0, 1, 3
"d:\IDEWORK\lvmen\src\licensedcode\data\rules\lgpl-2.0-plus_160.yml", "YAML", 0, 0, 0, 3, 0, 0, 1, 4
"d:\IDEWORK\lvmen\src\licensedcode\data\rules\lgpl-2.0-plus_161.yml", "YAML", 0, 0, 0, 3, 0, 0, 1, 4
"d:\IDEWORK\lvmen\src\licensedcode\data\rules\lgpl-2.0-plus_162.yml", "YAML", 0, 0, 0, 3, 0, 0, 1, 4
"d:\IDEWORK\lvmen\src\licensedcode\data\rules\lgpl-2.0-plus_163.yml", "YAML", 0, 0, 0, 3, 0, 0, 1, 4
"d:\IDEWORK\lvmen\src\licensedcode\data\rules\lgpl-2.0-plus_164.yml", "YAML", 0, 0, 0, 3, 0, 0, 1, 4
"d:\IDEWORK\lvmen\src\licensedcode\data\rules\lgpl-2.0-plus_165.yml", "YAML", 0, 0, 0, 3, 0, 0, 1, 4
"d:\IDEWORK\lvmen\src\licensedcode\data\rules\lgpl-2.0-plus_166.yml", "YAML", 0, 0, 0, 3, 0, 0, 1, 4
"d:\IDEWORK\lvmen\src\licensedcode\data\rules\lgpl-2.0-plus_167.yml", "YAML", 0, 0, 0, 3, 0, 0, 1, 4
"d:\IDEWORK\lvmen\src\licensedcode\data\rules\lgpl-2.0-plus_168.yml", "YAML", 0, 0, 0, 3, 0, 0, 1, 4
"d:\IDEWORK\lvmen\src\licensedcode\data\rules\lgpl-2.0-plus_169.yml", "YAML", 0, 0, 0, 3, 0, 0, 1, 4
"d:\IDEWORK\lvmen\src\licensedcode\data\rules\lgpl-2.0-plus_17.yml", "YAML", 0, 0, 0, 6, 0, 0, 1, 7
"d:\IDEWORK\lvmen\src\licensedcode\data\rules\lgpl-2.0-plus_170.yml", "YAML", 0, 0, 0, 3, 0, 0, 1, 4
"d:\IDEWORK\lvmen\src\licensedcode\data\rules\lgpl-2.0-plus_171.yml", "YAML", 0, 0, 0, 3, 0, 0, 1, 4
"d:\IDEWORK\lvmen\src\licensedcode\data\rules\lgpl-2.0-plus_172.yml", "YAML", 0, 0, 0, 5, 0, 0, 1, 6
"d:\IDEWORK\lvmen\src\licensedcode\data\rules\lgpl-2.0-plus_173.yml", "YAML", 0, 0, 0, 5, 0, 0, 1, 6
"d:\IDEWORK\lvmen\src\licensedcode\data\rules\lgpl-2.0-plus_174.yml", "YAML", 0, 0, 0, 3, 0, 0, 1, 4
"d:\IDEWORK\lvmen\src\licensedcode\data\rules\lgpl-2.0-plus_175.yml", "YAML", 0, 0, 0, 3, 0, 0, 1, 4
"d:\IDEWORK\lvmen\src\licensedcode\data\rules\lgpl-2.0-plus_176.yml", "YAML", 0, 0, 0, 5, 0, 0, 1, 6
"d:\IDEWORK\lvmen\src\licensedcode\data\rules\lgpl-2.0-plus_177.yml", "YAML", 0, 0, 0, 3, 0, 0, 1, 4
"d:\IDEWORK\lvmen\src\licensedcode\data\rules\lgpl-2.0-plus_178.yml", "YAML", 0, 0, 0, 5, 0, 0, 1, 6
"d:\IDEWORK\lvmen\src\licensedcode\data\rules\lgpl-2.0-plus_179.yml", "YAML", 0, 0, 0, 5, 0, 0, 1, 6
"d:\IDEWORK\lvmen\src\licensedcode\data\rules\lgpl-2.0-plus_18.yml", "YAML", 0, 0, 0, 2, 0, 0, 1, 3
"d:\IDEWORK\lvmen\src\licensedcode\data\rules\lgpl-2.0-plus_180.yml", "YAML", 0, 0, 0, 3, 0, 0, 1, 4
"d:\IDEWORK\lvmen\src\licensedcode\data\rules\lgpl-2.0-plus_181.yml", "YAML", 0, 0, 0, 5, 0, 0, 1, 6
"d:\IDEWORK\lvmen\src\licensedcode\data\rules\lgpl-2.0-plus_182.yml", "YAML", 0, 0, 0, 5, 0, 0, 1, 6
"d:\IDEWORK\lvmen\src\licensedcode\data\rules\lgpl-2.0-plus_183.yml", "YAML", 0, 0, 0, 5, 0, 0, 1, 6
"d:\IDEWORK\lvmen\src\licensedcode\data\rules\lgpl-2.0-plus_184.yml", "YAML", 0, 0, 0, 6, 0, 0, 1, 7
"d:\IDEWORK\lvmen\src\licensedcode\data\rules\lgpl-2.0-plus_185.yml", "YAML", 0, 0, 0, 3, 0, 0, 1, 4
"d:\IDEWORK\lvmen\src\licensedcode\data\rules\lgpl-2.0-plus_186.yml", "YAML", 0, 0, 0, 3, 0, 0, 1, 4
"d:\IDEWORK\lvmen\src\licensedcode\data\rules\lgpl-2.0-plus_187.yml", "YAML", 0, 0, 0, 3, 0, 0, 1, 4
"d:\IDEWORK\lvmen\src\licensedcode\data\rules\lgpl-2.0-plus_188.yml", "YAML", 0, 0, 0, 5, 0, 0, 1, 6
"d:\IDEWORK\lvmen\src\licensedcode\data\rules\lgpl-2.0-plus_189.yml", "YAML", 0, 0, 0, 3, 0, 0, 1, 4
"d:\IDEWORK\lvmen\src\licensedcode\data\rules\lgpl-2.0-plus_19.yml", "YAML", 0, 0, 0, 2, 0, 0, 1, 3
"d:\IDEWORK\lvmen\src\licensedcode\data\rules\lgpl-2.0-plus_190.yml", "YAML", 0, 0, 0, 3, 0, 0, 1, 4
"d:\IDEWORK\lvmen\src\licensedcode\data\rules\lgpl-2.0-plus_191.yml", "YAML", 0, 0, 0, 7, 0, 0, 1, 8
"d:\IDEWORK\lvmen\src\licensedcode\data\rules\lgpl-2.0-plus_192.yml", "YAML", 0, 0, 0, 5, 0, 0, 1, 6
"d:\IDEWORK\lvmen\src\licensedcode\data\rules\lgpl-2.0-plus_193.yml", "YAML", 0, 0, 0, 5, 0, 0, 1, 6
"d:\IDEWORK\lvmen\src\licensedcode\data\rules\lgpl-2.0-plus_194.yml", "YAML", 0, 0, 0, 5, 0, 0, 1, 6
"d:\IDEWORK\lvmen\src\licensedcode\data\rules\lgpl-2.0-plus_195.yml", "YAML", 0, 0, 0, 5, 0, 0, 1, 6
"d:\IDEWORK\lvmen\src\licensedcode\data\rules\lgpl-2.0-plus_196.yml", "YAML", 0, 0, 0, 3, 0, 0, 1, 4
"d:\IDEWORK\lvmen\src\licensedcode\data\rules\lgpl-2.0-plus_197.yml", "YAML", 0, 0, 0, 3, 0, 0, 1, 4
"d:\IDEWORK\lvmen\src\licensedcode\data\rules\lgpl-2.0-plus_198.yml", "YAML", 0, 0, 0, 5, 0, 0, 1, 6
"d:\IDEWORK\lvmen\src\licensedcode\data\rules\lgpl-2.0-plus_199.yml", "YAML", 0, 0, 0, 5, 0, 0, 1, 6
"d:\IDEWORK\lvmen\src\licensedcode\data\rules\lgpl-2.0-plus_2.yml", "YAML", 0, 0, 0, 3, 0, 0, 1, 4
"d:\IDEWORK\lvmen\src\licensedcode\data\rules\lgpl-2.0-plus_20.yml", "YAML", 0, 0, 0, 2, 0, 0, 1, 3
"d:\IDEWORK\lvmen\src\licensedcode\data\rules\lgpl-2.0-plus_200.yml", "YAML", 0, 0, 0, 5, 0, 0, 1, 6
"d:\IDEWORK\lvmen\src\licensedcode\data\rules\lgpl-2.0-plus_201.yml", "YAML", 0, 0, 0, 5, 0, 0, 1, 6
"d:\IDEWORK\lvmen\src\licensedcode\data\rules\lgpl-2.0-plus_202.yml", "YAML", 0, 0, 0, 5, 0, 0, 1, 6
"d:\IDEWORK\lvmen\src\licensedcode\data\rules\lgpl-2.0-plus_203.yml", "YAML", 0, 0, 0, 5, 0, 0, 1, 6
"d:\IDEWORK\lvmen\src\licensedcode\data\rules\lgpl-2.0-plus_204.yml", "YAML", 0, 0, 0, 5, 0, 0, 1, 6
"d:\IDEWORK\lvmen\src\licensedcode\data\rules\lgpl-2.0-plus_205.yml", "YAML", 0, 0, 0, 5, 0, 0, 1, 6
"d:\IDEWORK\lvmen\src\licensedcode\data\rules\lgpl-2.0-plus_206.yml", "YAML", 0, 0, 0, 5, 0, 0, 1, 6
"d:\IDEWORK\lvmen\src\licensedcode\data\rules\lgpl-2.0-plus_207.yml", "YAML", 0, 0, 0, 5, 0, 0, 1, 6
"d:\IDEWORK\lvmen\src\licensedcode\data\rules\lgpl-2.0-plus_208.yml", "YAML", 0, 0, 0, 5, 0, 0, 1, 6
"d:\IDEWORK\lvmen\src\licensedcode\data\rules\lgpl-2.0-plus_209.yml", "YAML", 0, 0, 0, 3, 0, 0, 1, 4
"d:\IDEWORK\lvmen\src\licensedcode\data\rules\lgpl-2.0-plus_21.yml", "YAML", 0, 0, 0, 6, 0, 0, 1, 7
"d:\IDEWORK\lvmen\src\licensedcode\data\rules\lgpl-2.0-plus_210.yml", "YAML", 0, 0, 0, 5, 0, 0, 1, 6
"d:\IDEWORK\lvmen\src\licensedcode\data\rules\lgpl-2.0-plus_211.yml", "YAML", 0, 0, 0, 3, 0, 0, 1, 4
"d:\IDEWORK\lvmen\src\licensedcode\data\rules\lgpl-2.0-plus_212.yml", "YAML", 0, 0, 0, 5, 0, 0, 1, 6
"d:\IDEWORK\lvmen\src\licensedcode\data\rules\lgpl-2.0-plus_213.yml", "YAML", 0, 0, 0, 3, 0, 0, 1, 4
"d:\IDEWORK\lvmen\src\licensedcode\data\rules\lgpl-2.0-plus_214.yml", "YAML", 0, 0, 0, 5, 0, 0, 1, 6
"d:\IDEWORK\lvmen\src\licensedcode\data\rules\lgpl-2.0-plus_215.yml", "YAML", 0, 0, 0, 3, 0, 0, 1, 4
"d:\IDEWORK\lvmen\src\licensedcode\data\rules\lgpl-2.0-plus_216.yml", "YAML", 0, 0, 0, 3, 0, 0, 1, 4
"d:\IDEWORK\lvmen\src\licensedcode\data\rules\lgpl-2.0-plus_217.yml", "YAML", 0, 0, 0, 3, 0, 0, 1, 4
"d:\IDEWORK\lvmen\src\licensedcode\data\rules\lgpl-2.0-plus_218.yml", "YAML", 0, 0, 0, 3, 0, 0, 1, 4
"d:\IDEWORK\lvmen\src\licensedcode\data\rules\lgpl-2.0-plus_219.yml", "YAML", 0, 0, 0, 3, 0, 0, 1, 4
"d:\IDEWORK\lvmen\src\licensedcode\data\rules\lgpl-2.0-plus_22.yml", "YAML", 0, 0, 0, 6, 0, 0, 1, 7
"d:\IDEWORK\lvmen\src\licensedcode\data\rules\lgpl-2.0-plus_220.yml", "YAML", 0, 0, 0, 3, 0, 0, 1, 4
"d:\IDEWORK\lvmen\src\licensedcode\data\rules\lgpl-2.0-plus_221.yml", "YAML", 0, 0, 0, 3, 0, 0, 1, 4
"d:\IDEWORK\lvmen\src\licensedcode\data\rules\lgpl-2.0-plus_222.yml", "YAML", 0, 0, 0, 5, 0, 0, 1, 6
"d:\IDEWORK\lvmen\src\licensedcode\data\rules\lgpl-2.0-plus_223.yml", "YAML", 0, 0, 0, 5, 0, 0, 1, 6
"d:\IDEWORK\lvmen\src\licensedcode\data\rules\lgpl-2.0-plus_224.yml", "YAML", 0, 0, 0, 3, 0, 0, 1, 4
"d:\IDEWORK\lvmen\src\licensedcode\data\rules\lgpl-2.0-plus_225.yml", "YAML", 0, 0, 0, 6, 0, 0, 1, 7
"d:\IDEWORK\lvmen\src\licensedcode\data\rules\lgpl-2.0-plus_226.yml", "YAML", 0, 0, 0, 5, 0, 0, 1, 6
"d:\IDEWORK\lvmen\src\licensedcode\data\rules\lgpl-2.0-plus_227.yml", "YAML", 0, 0, 0, 3, 0, 0, 1, 4
"d:\IDEWORK\lvmen\src\licensedcode\data\rules\lgpl-2.0-plus_228.yml", "YAML", 0, 0, 0, 3, 0, 0, 1, 4
"d:\IDEWORK\lvmen\src\licensedcode\data\rules\lgpl-2.0-plus_229.yml", "YAML", 0, 0, 0, 3, 0, 0, 1, 4
"d:\IDEWORK\lvmen\src\licensedcode\data\rules\lgpl-2.0-plus_23.yml", "YAML", 0, 0, 0, 4, 0, 0, 1, 5
"d:\IDEWORK\lvmen\src\licensedcode\data\rules\lgpl-2.0-plus_230.yml", "YAML", 0, 0, 0, 5, 0, 0, 1, 6
"d:\IDEWORK\lvmen\src\licensedcode\data\rules\lgpl-2.0-plus_231.yml", "YAML", 0, 0, 0, 3, 0, 0, 1, 4
"d:\IDEWORK\lvmen\src\licensedcode\data\rules\lgpl-2.0-plus_232.yml", "YAML", 0, 0, 0, 3, 0, 0, 1, 4
"d:\IDEWORK\lvmen\src\licensedcode\data\rules\lgpl-2.0-plus_233.yml", "YAML", 0, 0, 0, 3, 0, 0, 1, 4
"d:\IDEWORK\lvmen\src\licensedcode\data\rules\lgpl-2.0-plus_234.yml", "YAML", 0, 0, 0, 5, 0, 0, 1, 6
"d:\IDEWORK\lvmen\src\licensedcode\data\rules\lgpl-2.0-plus_235.yml", "YAML", 0, 0, 0, 5, 0, 0, 1, 6
"d:\IDEWORK\lvmen\src\licensedcode\data\rules\lgpl-2.0-plus_236.yml", "YAML", 0, 0, 0, 6, 0, 0, 1, 7
"d:\IDEWORK\lvmen\src\licensedcode\data\rules\lgpl-2.0-plus_237.yml", "YAML", 0, 0, 0, 3, 0, 0, 1, 4
"d:\IDEWORK\lvmen\src\licensedcode\data\rules\lgpl-2.0-plus_238.yml", "YAML", 0, 0, 0, 5, 0, 0, 1, 6
"d:\IDEWORK\lvmen\src\licensedcode\data\rules\lgpl-2.0-plus_239.yml", "YAML", 0, 0, 0, 5, 0, 0, 1, 6
"d:\IDEWORK\lvmen\src\licensedcode\data\rules\lgpl-2.0-plus_24.yml", "YAML", 0, 0, 0, 5, 0, 0, 1, 6
"d:\IDEWORK\lvmen\src\licensedcode\data\rules\lgpl-2.0-plus_240.yml", "YAML", 0, 0, 0, 3, 0, 0, 1, 4
"d:\IDEWORK\lvmen\src\licensedcode\data\rules\lgpl-2.0-plus_241.yml", "YAML", 0, 0, 0, 3, 0, 0, 1, 4
"d:\IDEWORK\lvmen\src\licensedcode\data\rules\lgpl-2.0-plus_242.yml", "YAML", 0, 0, 0, 3, 0, 0, 1, 4
"d:\IDEWORK\lvmen\src\licensedcode\data\rules\lgpl-2.0-plus_243.yml", "YAML", 0, 0, 0, 3, 0, 0, 1, 4
"d:\IDEWORK\lvmen\src\licensedcode\data\rules\lgpl-2.0-plus_244.yml", "YAML", 0, 0, 0, 3, 0, 0, 1, 4
"d:\IDEWORK\lvmen\src\licensedcode\data\rules\lgpl-2.0-plus_245.yml", "YAML", 0, 0, 0, 3, 0, 0, 1, 4
"d:\IDEWORK\lvmen\src\licensedcode\data\rules\lgpl-2.0-plus_246.yml", "YAML", 0, 0, 0, 3, 0, 0, 1, 4
"d:\IDEWORK\lvmen\src\licensedcode\data\rules\lgpl-2.0-plus_247.yml", "YAML", 0, 0, 0, 3, 0, 0, 1, 4
"d:\IDEWORK\lvmen\src\licensedcode\data\rules\lgpl-2.0-plus_248.yml", "YAML", 0, 0, 0, 3, 0, 0, 1, 4
"d:\IDEWORK\lvmen\src\licensedcode\data\rules\lgpl-2.0-plus_249.yml", "YAML", 0, 0, 0, 3, 0, 0, 1, 4
"d:\IDEWORK\lvmen\src\licensedcode\data\rules\lgpl-2.0-plus_25.yml", "YAML", 0, 0, 0, 2, 0, 0, 1, 3
"d:\IDEWORK\lvmen\src\licensedcode\data\rules\lgpl-2.0-plus_250.yml", "YAML", 0, 0, 0, 3, 0, 0, 1, 4
"d:\IDEWORK\lvmen\src\licensedcode\data\rules\lgpl-2.0-plus_251.yml", "YAML", 0, 0, 0, 3, 0, 0, 1, 4
"d:\IDEWORK\lvmen\src\licensedcode\data\rules\lgpl-2.0-plus_252.yml", "YAML", 0, 0, 0, 3, 0, 0, 1, 4
"d:\IDEWORK\lvmen\src\licensedcode\data\rules\lgpl-2.0-plus_253.yml", "YAML", 0, 0, 0, 3, 0, 0, 1, 4
"d:\IDEWORK\lvmen\src\licensedcode\data\rules\lgpl-2.0-plus_254.yml", "YAML", 0, 0, 0, 3, 0, 0, 1, 4
"d:\IDEWORK\lvmen\src\licensedcode\data\rules\lgpl-2.0-plus_255.yml", "YAML", 0, 0, 0, 3, 0, 0, 1, 4
"d:\IDEWORK\lvmen\src\licensedcode\data\rules\lgpl-2.0-plus_256.yml", "YAML", 0, 0, 0, 3, 0, 0, 1, 4
"d:\IDEWORK\lvmen\src\licensedcode\data\rules\lgpl-2.0-plus_257.yml", "YAML", 0, 0, 0, 3, 0, 0, 1, 4
"d:\IDEWORK\lvmen\src\licensedcode\data\rules\lgpl-2.0-plus_258.yml", "YAML", 0, 0, 0, 3, 0, 0, 1, 4
"d:\IDEWORK\lvmen\src\licensedcode\data\rules\lgpl-2.0-plus_259.yml", "YAML", 0, 0, 0, 3, 0, 0, 1, 4
"d:\IDEWORK\lvmen\src\licensedcode\data\rules\lgpl-2.0-plus_26.yml", "YAML", 0, 0, 0, 3, 0, 0, 1, 4
"d:\IDEWORK\lvmen\src\licensedcode\data\rules\lgpl-2.0-plus_260.yml", "YAML", 0, 0, 0, 3, 0, 0, 1, 4
"d:\IDEWORK\lvmen\src\licensedcode\data\rules\lgpl-2.0-plus_261.yml", "YAML", 0, 0, 0, 3, 0, 0, 1, 4
"d:\IDEWORK\lvmen\src\licensedcode\data\rules\lgpl-2.0-plus_262.yml", "YAML", 0, 0, 0, 3, 0, 0, 1, 4
"d:\IDEWORK\lvmen\src\licensedcode\data\rules\lgpl-2.0-plus_263.yml", "YAML", 0, 0, 0, 3, 0, 0, 1, 4
"d:\IDEWORK\lvmen\src\licensedcode\data\rules\lgpl-2.0-plus_264.yml", "YAML", 0, 0, 0, 3, 0, 0, 1, 4
"d:\IDEWORK\lvmen\src\licensedcode\data\rules\lgpl-2.0-plus_265.yml", "YAML", 0, 0, 0, 3, 0, 0, 1, 4
"d:\IDEWORK\lvmen\src\licensedcode\data\rules\lgpl-2.0-plus_266.yml", "YAML", 0, 0, 0, 3, 0, 0, 1, 4
"d:\IDEWORK\lvmen\src\licensedcode\data\rules\lgpl-2.0-plus_267.yml", "YAML", 0, 0, 0, 3, 0, 0, 1, 4
"d:\IDEWORK\lvmen\src\licensedcode\data\rules\lgpl-2.0-plus_268.yml", "YAML", 0, 0, 0, 3, 0, 0, 1, 4
"d:\IDEWORK\lvmen\src\licensedcode\data\rules\lgpl-2.0-plus_269.yml", "YAML", 0, 0, 0, 3, 0, 0, 1, 4
"d:\IDEWORK\lvmen\src\licensedcode\data\rules\lgpl-2.0-plus_27.yml", "YAML", 0, 0, 0, 4, 0, 0, 1, 5
"d:\IDEWORK\lvmen\src\licensedcode\data\rules\lgpl-2.0-plus_270.yml", "YAML", 0, 0, 0, 3, 0, 0, 1, 4
"d:\IDEWORK\lvmen\src\licensedcode\data\rules\lgpl-2.0-plus_271.yml", "YAML", 0, 0, 0, 3, 0, 0, 1, 4
"d:\IDEWORK\lvmen\src\licensedcode\data\rules\lgpl-2.0-plus_272.yml", "YAML", 0, 0, 0, 3, 0, 0, 1, 4
"d:\IDEWORK\lvmen\src\licensedcode\data\rules\lgpl-2.0-plus_273.yml", "YAML", 0, 0, 0, 3, 0, 0, 1, 4
"d:\IDEWORK\lvmen\src\licensedcode\data\rules\lgpl-2.0-plus_274.yml", "YAML", 0, 0, 0, 3, 0, 0, 1, 4
"d:\IDEWORK\lvmen\src\licensedcode\data\rules\lgpl-2.0-plus_275.yml", "YAML", 0, 0, 0, 3, 0, 0, 1, 4
"d:\IDEWORK\lvmen\src\licensedcode\data\rules\lgpl-2.0-plus_276.yml", "YAML", 0, 0, 0, 3, 0, 0, 1, 4
"d:\IDEWORK\lvmen\src\licensedcode\data\rules\lgpl-2.0-plus_277.yml", "YAML", 0, 0, 0, 3, 0, 0, 1, 4
"d:\IDEWORK\lvmen\src\licensedcode\data\rules\lgpl-2.0-plus_278.yml", "YAML", 0, 0, 0, 3, 0, 0, 1, 4
"d:\IDEWORK\lvmen\src\licensedcode\data\rules\lgpl-2.0-plus_279.yml", "YAML", 0, 0, 0, 3, 0, 0, 1, 4
"d:\IDEWORK\lvmen\src\licensedcode\data\rules\lgpl-2.0-plus_28.yml", "YAML", 0, 0, 0, 2, 0, 0, 1, 3
"d:\IDEWORK\lvmen\src\licensedcode\data\rules\lgpl-2.0-plus_280.yml", "YAML", 0, 0, 0, 3, 0, 0, 1, 4
"d:\IDEWORK\lvmen\src\licensedcode\data\rules\lgpl-2.0-plus_281.yml", "YAML", 0, 0, 0, 3, 0, 0, 1, 4
"d:\IDEWORK\lvmen\src\licensedcode\data\rules\lgpl-2.0-plus_282.yml", "YAML", 0, 0, 0, 3, 0, 0, 1, 4
"d:\IDEWORK\lvmen\src\licensedcode\data\rules\lgpl-2.0-plus_283.yml", "YAML", 0, 0, 0, 3, 0, 0, 1, 4
"d:\IDEWORK\lvmen\src\licensedcode\data\rules\lgpl-2.0-plus_284.yml", "YAML", 0, 0, 0, 3, 0, 0, 1, 4
"d:\IDEWORK\lvmen\src\licensedcode\data\rules\lgpl-2.0-plus_285.yml", "YAML", 0, 0, 0, 3, 0, 0, 1, 4
"d:\IDEWORK\lvmen\src\licensedcode\data\rules\lgpl-2.0-plus_286.yml", "YAML", 0, 0, 0, 3, 0, 0, 1, 4
"d:\IDEWORK\lvmen\src\licensedcode\data\rules\lgpl-2.0-plus_287.yml", "YAML", 0, 0, 0, 3, 0, 0, 1, 4
"d:\IDEWORK\lvmen\src\licensedcode\data\rules\lgpl-2.0-plus_288.yml", "YAML", 0, 0, 0, 3, 0, 0, 1, 4
"d:\IDEWORK\lvmen\src\licensedcode\data\rules\lgpl-2.0-plus_289.yml", "YAML", 0, 0, 0, 3, 0, 0, 1, 4
"d:\IDEWORK\lvmen\src\licensedcode\data\rules\lgpl-2.0-plus_29.yml", "YAML", 0, 0, 0, 6, 0, 0, 1, 7
"d:\IDEWORK\lvmen\src\licensedcode\data\rules\lgpl-2.0-plus_290.yml", "YAML", 0, 0, 0, 3, 0, 0, 1, 4
"d:\IDEWORK\lvmen\src\licensedcode\data\rules\lgpl-2.0-plus_291.yml", "YAML", 0, 0, 0, 3, 0, 0, 1, 4
"d:\IDEWORK\lvmen\src\licensedcode\data\rules\lgpl-2.0-plus_292.yml", "YAML", 0, 0, 0, 3, 0, 0, 1, 4
"d:\IDEWORK\lvmen\src\licensedcode\data\rules\lgpl-2.0-plus_293.yml", "YAML", 0, 0, 0, 3, 0, 0, 1, 4
"d:\IDEWORK\lvmen\src\licensedcode\data\rules\lgpl-2.0-plus_294.yml", "YAML", 0, 0, 0, 3, 0, 0, 1, 4
"d:\IDEWORK\lvmen\src\licensedcode\data\rules\lgpl-2.0-plus_295.yml", "YAML", 0, 0, 0, 3, 0, 0, 1, 4
"d:\IDEWORK\lvmen\src\licensedcode\data\rules\lgpl-2.0-plus_296.yml", "YAML", 0, 0, 0, 3, 0, 0, 1, 4
"d:\IDEWORK\lvmen\src\licensedcode\data\rules\lgpl-2.0-plus_297.yml", "YAML", 0, 0, 0, 3, 0, 0, 1, 4
"d:\IDEWORK\lvmen\src\licensedcode\data\rules\lgpl-2.0-plus_298.yml", "YAML", 0, 0, 0, 3, 0, 0, 1, 4
"d:\IDEWORK\lvmen\src\licensedcode\data\rules\lgpl-2.0-plus_299.yml", "YAML", 0, 0, 0, 3, 0, 0, 1, 4
"d:\IDEWORK\lvmen\src\licensedcode\data\rules\lgpl-2.0-plus_3.yml", "YAML", 0, 0, 0, 5, 0, 0, 1, 6
"d:\IDEWORK\lvmen\src\licensedcode\data\rules\lgpl-2.0-plus_30.yml", "YAML", 0, 0, 0, 4, 0, 0, 1, 5
"d:\IDEWORK\lvmen\src\licensedcode\data\rules\lgpl-2.0-plus_300.yml", "YAML", 0, 0, 0, 3, 0, 0, 1, 4
"d:\IDEWORK\lvmen\src\licensedcode\data\rules\lgpl-2.0-plus_301.yml", "YAML", 0, 0, 0, 3, 0, 0, 1, 4
"d:\IDEWORK\lvmen\src\licensedcode\data\rules\lgpl-2.0-plus_302.yml", "YAML", 0, 0, 0, 3, 0, 0, 1, 4
"d:\IDEWORK\lvmen\src\licensedcode\data\rules\lgpl-2.0-plus_303.yml", "YAML", 0, 0, 0, 3, 0, 0, 1, 4
"d:\IDEWORK\lvmen\src\licensedcode\data\rules\lgpl-2.0-plus_304.yml", "YAML", 0, 0, 0, 3, 0, 0, 1, 4
"d:\IDEWORK\lvmen\src\licensedcode\data\rules\lgpl-2.0-plus_305.yml", "YAML", 0, 0, 0, 3, 0, 0, 1, 4
"d:\IDEWORK\lvmen\src\licensedcode\data\rules\lgpl-2.0-plus_306.yml", "YAML", 0, 0, 0, 3, 0, 0, 1, 4
"d:\IDEWORK\lvmen\src\licensedcode\data\rules\lgpl-2.0-plus_307.yml", "YAML", 0, 0, 0, 3, 0, 0, 1, 4
"d:\IDEWORK\lvmen\src\licensedcode\data\rules\lgpl-2.0-plus_308.yml", "YAML", 0, 0, 0, 3, 0, 0, 1, 4
"d:\IDEWORK\lvmen\src\licensedcode\data\rules\lgpl-2.0-plus_309.yml", "YAML", 0, 0, 0, 3, 0, 0, 1, 4
"d:\IDEWORK\lvmen\src\licensedcode\data\rules\lgpl-2.0-plus_31.yml", "YAML", 0, 0, 0, 3, 0, 0, 1, 4
"d:\IDEWORK\lvmen\src\licensedcode\data\rules\lgpl-2.0-plus_310.yml", "YAML", 0, 0, 0, 3, 0, 0, 1, 4
"d:\IDEWORK\lvmen\src\licensedcode\data\rules\lgpl-2.0-plus_311.yml", "YAML", 0, 0, 0, 3, 0, 0, 1, 4
"d:\IDEWORK\lvmen\src\licensedcode\data\rules\lgpl-2.0-plus_312.yml", "YAML", 0, 0, 0, 3, 0, 0, 1, 4
"d:\IDEWORK\lvmen\src\licensedcode\data\rules\lgpl-2.0-plus_313.yml", "YAML", 0, 0, 0, 3, 0, 0, 1, 4
"d:\IDEWORK\lvmen\src\licensedcode\data\rules\lgpl-2.0-plus_314.yml", "YAML", 0, 0, 0, 3, 0, 0, 1, 4
"d:\IDEWORK\lvmen\src\licensedcode\data\rules\lgpl-2.0-plus_315.yml", "YAML", 0, 0, 0, 5, 0, 0, 1, 6
"d:\IDEWORK\lvmen\src\licensedcode\data\rules\lgpl-2.0-plus_316.yml", "YAML", 0, 0, 0, 5, 0, 0, 1, 6
"d:\IDEWORK\lvmen\src\licensedcode\data\rules\lgpl-2.0-plus_317.yml", "YAML", 0, 0, 0, 3, 0, 0, 1, 4
"d:\IDEWORK\lvmen\src\licensedcode\data\rules\lgpl-2.0-plus_318.yml", "YAML", 0, 0, 0, 3, 0, 0, 1, 4
"d:\IDEWORK\lvmen\src\licensedcode\data\rules\lgpl-2.0-plus_319.yml", "YAML", 0, 0, 0, 3, 0, 0, 1, 4
"d:\IDEWORK\lvmen\src\licensedcode\data\rules\lgpl-2.0-plus_32.yml", "YAML", 0, 0, 0, 2, 0, 0, 1, 3
"d:\IDEWORK\lvmen\src\licensedcode\data\rules\lgpl-2.0-plus_320.yml", "YAML", 0, 0, 0, 3, 0, 0, 1, 4
"d:\IDEWORK\lvmen\src\licensedcode\data\rules\lgpl-2.0-plus_321.yml", "YAML", 0, 0, 0, 3, 0, 0, 1, 4
"d:\IDEWORK\lvmen\src\licensedcode\data\rules\lgpl-2.0-plus_322.yml", "YAML", 0, 0, 0, 3, 0, 0, 1, 4
"d:\IDEWORK\lvmen\src\licensedcode\data\rules\lgpl-2.0-plus_323.yml", "YAML", 0, 0, 0, 3, 0, 0, 1, 4
"d:\IDEWORK\lvmen\src\licensedcode\data\rules\lgpl-2.0-plus_324.yml", "YAML", 0, 0, 0, 5, 0, 0, 1, 6
"d:\IDEWORK\lvmen\src\licensedcode\data\rules\lgpl-2.0-plus_325.yml", "YAML", 0, 0, 0, 3, 0, 0, 1, 4
"d:\IDEWORK\lvmen\src\licensedcode\data\rules\lgpl-2.0-plus_326.yml", "YAML", 0, 0, 0, 5, 0, 0, 1, 6
"d:\IDEWORK\lvmen\src\licensedcode\data\rules\lgpl-2.0-plus_327.yml", "YAML", 0, 0, 0, 3, 0, 0, 1, 4
"d:\IDEWORK\lvmen\src\licensedcode\data\rules\lgpl-2.0-plus_328.yml", "YAML", 0, 0, 0, 4, 0, 0, 1, 5
"d:\IDEWORK\lvmen\src\licensedcode\data\rules\lgpl-2.0-plus_329.yml", "YAML", 0, 0, 0, 3, 0, 0, 1, 4
"d:\IDEWORK\lvmen\src\licensedcode\data\rules\lgpl-2.0-plus_33.yml", "YAML", 0, 0, 0, 2, 0, 0, 1, 3
"d:\IDEWORK\lvmen\src\licensedcode\data\rules\lgpl-2.0-plus_330.yml", "YAML", 0, 0, 0, 3, 0, 0, 1, 4
"d:\IDEWORK\lvmen\src\licensedcode\data\rules\lgpl-2.0-plus_331.yml", "YAML", 0, 0, 0, 6, 0, 0, 1, 7
"d:\IDEWORK\lvmen\src\licensedcode\data\rules\lgpl-2.0-plus_332.yml", "YAML", 0, 0, 0, 5, 0, 0, 1, 6
"d:\IDEWORK\lvmen\src\licensedcode\data\rules\lgpl-2.0-plus_333.yml", "YAML", 0, 0, 0, 5, 0, 0, 1, 6
"d:\IDEWORK\lvmen\src\licensedcode\data\rules\lgpl-2.0-plus_334.yml", "YAML", 0, 0, 0, 5, 0, 0, 1, 6
"d:\IDEWORK\lvmen\src\licensedcode\data\rules\lgpl-2.0-plus_335.yml", "YAML", 0, 0, 0, 3, 0, 0, 1, 4
"d:\IDEWORK\lvmen\src\licensedcode\data\rules\lgpl-2.0-plus_336.yml", "YAML", 0, 0, 0, 5, 0, 0, 1, 6
"d:\IDEWORK\lvmen\src\licensedcode\data\rules\lgpl-2.0-plus_337.yml", "YAML", 0, 0, 0, 3, 0, 0, 1, 4
"d:\IDEWORK\lvmen\src\licensedcode\data\rules\lgpl-2.0-plus_338.yml", "YAML", 0, 0, 0, 5, 0, 0, 1, 6
"d:\IDEWORK\lvmen\src\licensedcode\data\rules\lgpl-2.0-plus_339.yml", "YAML", 0, 0, 0, 5, 0, 0, 1, 6
"d:\IDEWORK\lvmen\src\licensedcode\data\rules\lgpl-2.0-plus_34.yml", "YAML", 0, 0, 0, 4, 0, 0, 1, 5
"d:\IDEWORK\lvmen\src\licensedcode\data\rules\lgpl-2.0-plus_340.yml", "YAML", 0, 0, 0, 3, 0, 0, 1, 4
"d:\IDEWORK\lvmen\src\licensedcode\data\rules\lgpl-2.0-plus_341.yml", "YAML", 0, 0, 0, 3, 0, 0, 1, 4
"d:\IDEWORK\lvmen\src\licensedcode\data\rules\lgpl-2.0-plus_342.yml", "YAML", 0, 0, 0, 3, 0, 0, 1, 4
"d:\IDEWORK\lvmen\src\licensedcode\data\rules\lgpl-2.0-plus_343.yml", "YAML", 0, 0, 0, 3, 0, 0, 1, 4
"d:\IDEWORK\lvmen\src\licensedcode\data\rules\lgpl-2.0-plus_344.yml", "YAML", 0, 0, 0, 3, 0, 0, 1, 4
"d:\IDEWORK\lvmen\src\licensedcode\data\rules\lgpl-2.0-plus_345.yml", "YAML", 0, 0, 0, 3, 0, 0, 1, 4
"d:\IDEWORK\lvmen\src\licensedcode\data\rules\lgpl-2.0-plus_346.yml", "YAML", 0, 0, 0, 3, 0, 0, 1, 4
"d:\IDEWORK\lvmen\src\licensedcode\data\rules\lgpl-2.0-plus_347.yml", "YAML", 0, 0, 0, 3, 0, 0, 1, 4
"d:\IDEWORK\lvmen\src\licensedcode\data\rules\lgpl-2.0-plus_348.yml", "YAML", 0, 0, 0, 3, 0, 0, 1, 4
"d:\IDEWORK\lvmen\src\licensedcode\data\rules\lgpl-2.0-plus_349.yml", "YAML", 0, 0, 0, 5, 0, 0, 1, 6
"d:\IDEWORK\lvmen\src\licensedcode\data\rules\lgpl-2.0-plus_35.yml", "YAML", 0, 0, 0, 5, 0, 0, 1, 6
"d:\IDEWORK\lvmen\src\licensedcode\data\rules\lgpl-2.0-plus_350.yml", "YAML", 0, 0, 0, 4, 0, 0, 1, 5
"d:\IDEWORK\lvmen\src\licensedcode\data\rules\lgpl-2.0-plus_351.yml", "YAML", 0, 0, 0, 4, 0, 0, 1, 5
"d:\IDEWORK\lvmen\src\licensedcode\data\rules\lgpl-2.0-plus_352.yml", "YAML", 0, 0, 0, 3, 0, 0, 1, 4
"d:\IDEWORK\lvmen\src\licensedcode\data\rules\lgpl-2.0-plus_353.yml", "YAML", 0, 0, 0, 3, 0, 0, 1, 4
"d:\IDEWORK\lvmen\src\licensedcode\data\rules\lgpl-2.0-plus_354.yml", "YAML", 0, 0, 0, 4, 0, 0, 1, 5
"d:\IDEWORK\lvmen\src\licensedcode\data\rules\lgpl-2.0-plus_355.yml", "YAML", 0, 0, 0, 4, 0, 0, 1, 5
"d:\IDEWORK\lvmen\src\licensedcode\data\rules\lgpl-2.0-plus_356.yml", "YAML", 0, 0, 0, 3, 0, 0, 1, 4
"d:\IDEWORK\lvmen\src\licensedcode\data\rules\lgpl-2.0-plus_357.yml", "YAML", 0, 0, 0, 4, 0, 0, 1, 5
"d:\IDEWORK\lvmen\src\licensedcode\data\rules\lgpl-2.0-plus_358.yml", "YAML", 0, 0, 0, 4, 0, 0, 1, 5
"d:\IDEWORK\lvmen\src\licensedcode\data\rules\lgpl-2.0-plus_359.yml", "YAML", 0, 0, 0, 4, 0, 0, 1, 5
"d:\IDEWORK\lvmen\src\licensedcode\data\rules\lgpl-2.0-plus_36.yml", "YAML", 0, 0, 0, 2, 0, 0, 1, 3
"d:\IDEWORK\lvmen\src\licensedcode\data\rules\lgpl-2.0-plus_360.yml", "YAML", 0, 0, 0, 4, 0, 0, 1, 5
"d:\IDEWORK\lvmen\src\licensedcode\data\rules\lgpl-2.0-plus_361.yml", "YAML", 0, 0, 0, 4, 0, 0, 1, 5
"d:\IDEWORK\lvmen\src\licensedcode\data\rules\lgpl-2.0-plus_362.yml", "YAML", 0, 0, 0, 4, 0, 0, 1, 5
"d:\IDEWORK\lvmen\src\licensedcode\data\rules\lgpl-2.0-plus_363.yml", "YAML", 0, 0, 0, 6, 0, 0, 1, 7
"d:\IDEWORK\lvmen\src\licensedcode\data\rules\lgpl-2.0-plus_364.yml", "YAML", 0, 0, 0, 4, 0, 0, 1, 5
"d:\IDEWORK\lvmen\src\licensedcode\data\rules\lgpl-2.0-plus_365.yml", "YAML", 0, 0, 0, 6, 0, 0, 1, 7
"d:\IDEWORK\lvmen\src\licensedcode\data\rules\lgpl-2.0-plus_366.yml", "YAML", 0, 0, 0, 6, 0, 0, 1, 7
"d:\IDEWORK\lvmen\src\licensedcode\data\rules\lgpl-2.0-plus_367.yml", "YAML", 0, 0, 0, 6, 0, 0, 1, 7
"d:\IDEWORK\lvmen\src\licensedcode\data\rules\lgpl-2.0-plus_368.yml", "YAML", 0, 0, 0, 4, 0, 0, 1, 5
"d:\IDEWORK\lvmen\src\licensedcode\data\rules\lgpl-2.0-plus_369.yml", "YAML", 0, 0, 0, 4, 0, 0, 1, 5
"d:\IDEWORK\lvmen\src\licensedcode\data\rules\lgpl-2.0-plus_37.yml", "YAML", 0, 0, 0, 4, 0, 0, 1, 5
"d:\IDEWORK\lvmen\src\licensedcode\data\rules\lgpl-2.0-plus_370.yml", "YAML", 0, 0, 0, 5, 0, 0, 1, 6
"d:\IDEWORK\lvmen\src\licensedcode\data\rules\lgpl-2.0-plus_371.yml", "YAML", 0, 0, 0, 3, 0, 0, 1, 4
"d:\IDEWORK\lvmen\src\licensedcode\data\rules\lgpl-2.0-plus_372.yml", "YAML", 0, 0, 0, 4, 0, 0, 1, 5
"d:\IDEWORK\lvmen\src\licensedcode\data\rules\lgpl-2.0-plus_373.yml", "YAML", 0, 0, 0, 5, 0, 0, 1, 6
"d:\IDEWORK\lvmen\src\licensedcode\data\rules\lgpl-2.0-plus_374.yml", "YAML", 0, 0, 0, 3, 0, 0, 1, 4
"d:\IDEWORK\lvmen\src\licensedcode\data\rules\lgpl-2.0-plus_375.yml", "YAML", 0, 0, 0, 3, 0, 0, 1, 4
"d:\IDEWORK\lvmen\src\licensedcode\data\rules\lgpl-2.0-plus_376.yml", "YAML", 0, 0, 0, 3, 0, 0, 1, 4
"d:\IDEWORK\lvmen\src\licensedcode\data\rules\lgpl-2.0-plus_377.yml", "YAML", 0, 0, 0, 3, 0, 0, 1, 4
"d:\IDEWORK\lvmen\src\licensedcode\data\rules\lgpl-2.0-plus_378.yml", "YAML", 0, 0, 0, 3, 0, 0, 1, 4
"d:\IDEWORK\lvmen\src\licensedcode\data\rules\lgpl-2.0-plus_379.yml", "YAML", 0, 0, 0, 3, 0, 0, 1, 4
"d:\IDEWORK\lvmen\src\licensedcode\data\rules\lgpl-2.0-plus_38.yml", "YAML", 0, 0, 0, 2, 0, 0, 1, 3
"d:\IDEWORK\lvmen\src\licensedcode\data\rules\lgpl-2.0-plus_380.yml", "YAML", 0, 0, 0, 3, 0, 0, 1, 4
"d:\IDEWORK\lvmen\src\licensedcode\data\rules\lgpl-2.0-plus_381.yml", "YAML", 0, 0, 0, 3, 0, 0, 1, 4
"d:\IDEWORK\lvmen\src\licensedcode\data\rules\lgpl-2.0-plus_382.yml", "YAML", 0, 0, 0, 3, 0, 0, 1, 4
"d:\IDEWORK\lvmen\src\licensedcode\data\rules\lgpl-2.0-plus_383.yml", "YAML", 0, 0, 0, 3, 0, 0, 1, 4
"d:\IDEWORK\lvmen\src\licensedcode\data\rules\lgpl-2.0-plus_384.yml", "YAML", 0, 0, 0, 3, 0, 0, 1, 4
"d:\IDEWORK\lvmen\src\licensedcode\data\rules\lgpl-2.0-plus_385.yml", "YAML", 0, 0, 0, 3, 0, 0, 1, 4
"d:\IDEWORK\lvmen\src\licensedcode\data\rules\lgpl-2.0-plus_386.yml", "YAML", 0, 0, 0, 3, 0, 0, 1, 4
"d:\IDEWORK\lvmen\src\licensedcode\data\rules\lgpl-2.0-plus_387.yml", "YAML", 0, 0, 0, 3, 0, 0, 1, 4
"d:\IDEWORK\lvmen\src\licensedcode\data\rules\lgpl-2.0-plus_388.yml", "YAML", 0, 0, 0, 3, 0, 0, 1, 4
"d:\IDEWORK\lvmen\src\licensedcode\data\rules\lgpl-2.0-plus_389.yml", "YAML", 0, 0, 0, 3, 0, 0, 1, 4
"d:\IDEWORK\lvmen\src\licensedcode\data\rules\lgpl-2.0-plus_39.yml", "YAML", 0, 0, 0, 4, 0, 0, 1, 5
"d:\IDEWORK\lvmen\src\licensedcode\data\rules\lgpl-2.0-plus_390.yml", "YAML", 0, 0, 0, 3, 0, 0, 1, 4
"d:\IDEWORK\lvmen\src\licensedcode\data\rules\lgpl-2.0-plus_391.yml", "YAML", 0, 0, 0, 3, 0, 0, 1, 4
"d:\IDEWORK\lvmen\src\licensedcode\data\rules\lgpl-2.0-plus_392.yml", "YAML", 0, 0, 0, 3, 0, 0, 1, 4
"d:\IDEWORK\lvmen\src\licensedcode\data\rules\lgpl-2.0-plus_393.yml", "YAML", 0, 0, 0, 3, 0, 0, 1, 4
"d:\IDEWORK\lvmen\src\licensedcode\data\rules\lgpl-2.0-plus_394.yml", "YAML", 0, 0, 0, 6, 0, 0, 1, 7
"d:\IDEWORK\lvmen\src\licensedcode\data\rules\lgpl-2.0-plus_395.yml", "YAML", 0, 0, 0, 6, 0, 0, 1, 7
"d:\IDEWORK\lvmen\src\licensedcode\data\rules\lgpl-2.0-plus_396.yml", "YAML", 0, 0, 0, 3, 0, 0, 1, 4
"d:\IDEWORK\lvmen\src\licensedcode\data\rules\lgpl-2.0-plus_397.yml", "YAML", 0, 0, 0, 3, 0, 0, 1, 4
"d:\IDEWORK\lvmen\src\licensedcode\data\rules\lgpl-2.0-plus_398.yml", "YAML", 0, 0, 0, 3, 0, 0, 1, 4
"d:\IDEWORK\lvmen\src\licensedcode\data\rules\lgpl-2.0-plus_399.yml", "YAML", 0, 0, 0, 3, 0, 0, 1, 4
"d:\IDEWORK\lvmen\src\licensedcode\data\rules\lgpl-2.0-plus_4.yml", "YAML", 0, 0, 0, 2, 0, 0, 1, 3
"d:\IDEWORK\lvmen\src\licensedcode\data\rules\lgpl-2.0-plus_40.yml", "YAML", 0, 0, 0, 2, 0, 0, 1, 3
"d:\IDEWORK\lvmen\src\licensedcode\data\rules\lgpl-2.0-plus_400.yml", "YAML", 0, 0, 0, 3, 0, 0, 1, 4
"d:\IDEWORK\lvmen\src\licensedcode\data\rules\lgpl-2.0-plus_401.yml", "YAML", 0, 0, 0, 3, 0, 0, 1, 4
"d:\IDEWORK\lvmen\src\licensedcode\data\rules\lgpl-2.0-plus_402.yml", "YAML", 0, 0, 0, 3, 0, 0, 1, 4
"d:\IDEWORK\lvmen\src\licensedcode\data\rules\lgpl-2.0-plus_403.yml", "YAML", 0, 0, 0, 3, 0, 0, 1, 4
"d:\IDEWORK\lvmen\src\licensedcode\data\rules\lgpl-2.0-plus_404.yml", "YAML", 0, 0, 0, 5, 0, 0, 1, 6
"d:\IDEWORK\lvmen\src\licensedcode\data\rules\lgpl-2.0-plus_405.yml", "YAML", 0, 0, 0, 3, 0, 0, 1, 4
"d:\IDEWORK\lvmen\src\licensedcode\data\rules\lgpl-2.0-plus_406.yml", "YAML", 0, 0, 0, 3, 0, 0, 1, 4
"d:\IDEWORK\lvmen\src\licensedcode\data\rules\lgpl-2.0-plus_407.yml", "YAML", 0, 0, 0, 3, 0, 0, 1, 4
"d:\IDEWORK\lvmen\src\licensedcode\data\rules\lgpl-2.0-plus_408.yml", "YAML", 0, 0, 0, 3, 0, 0, 1, 4
"d:\IDEWORK\lvmen\src\licensedcode\data\rules\lgpl-2.0-plus_409.yml", "YAML", 0, 0, 0, 5, 0, 0, 1, 6
"d:\IDEWORK\lvmen\src\licensedcode\data\rules\lgpl-2.0-plus_41.yml", "YAML", 0, 0, 0, 3, 0, 0, 1, 4
"d:\IDEWORK\lvmen\src\licensedcode\data\rules\lgpl-2.0-plus_410.yml", "YAML", 0, 0, 0, 5, 0, 0, 1, 6
"d:\IDEWORK\lvmen\src\licensedcode\data\rules\lgpl-2.0-plus_411.yml", "YAML", 0, 0, 0, 3, 0, 0, 1, 4
"d:\IDEWORK\lvmen\src\licensedcode\data\rules\lgpl-2.0-plus_412.yml", "YAML", 0, 0, 0, 3, 0, 0, 1, 4
"d:\IDEWORK\lvmen\src\licensedcode\data\rules\lgpl-2.0-plus_413.yml", "YAML", 0, 0, 0, 5, 0, 0, 1, 6
"d:\IDEWORK\lvmen\src\licensedcode\data\rules\lgpl-2.0-plus_414.yml", "YAML", 0, 0, 0, 5, 0, 0, 1, 6
"d:\IDEWORK\lvmen\src\licensedcode\data\rules\lgpl-2.0-plus_415.yml", "YAML", 0, 0, 0, 3, 0, 0, 1, 4
"d:\IDEWORK\lvmen\src\licensedcode\data\rules\lgpl-2.0-plus_416.yml", "YAML", 0, 0, 0, 3, 0, 0, 1, 4
"d:\IDEWORK\lvmen\src\licensedcode\data\rules\lgpl-2.0-plus_417.yml", "YAML", 0, 0, 0, 3, 0, 0, 1, 4
"d:\IDEWORK\lvmen\src\licensedcode\data\rules\lgpl-2.0-plus_418.yml", "YAML", 0, 0, 0, 5, 0, 0, 1, 6
"d:\IDEWORK\lvmen\src\licensedcode\data\rules\lgpl-2.0-plus_419.yml", "YAML", 0, 0, 0, 3, 0, 0, 1, 4
"d:\IDEWORK\lvmen\src\licensedcode\data\rules\lgpl-2.0-plus_42.yml", "YAML", 0, 0, 0, 2, 0, 0, 1, 3
"d:\IDEWORK\lvmen\src\licensedcode\data\rules\lgpl-2.0-plus_420.yml", "YAML", 0, 0, 0, 3, 0, 0, 1, 4
"d:\IDEWORK\lvmen\src\licensedcode\data\rules\lgpl-2.0-plus_421.yml", "YAML", 0, 0, 0, 3, 0, 0, 1, 4
"d:\IDEWORK\lvmen\src\licensedcode\data\rules\lgpl-2.0-plus_422.yml", "YAML", 0, 0, 0, 3, 0, 0, 1, 4
"d:\IDEWORK\lvmen\src\licensedcode\data\rules\lgpl-2.0-plus_423.yml", "YAML", 0, 0, 0, 3, 0, 0, 1, 4
"d:\IDEWORK\lvmen\src\licensedcode\data\rules\lgpl-2.0-plus_424.yml", "YAML", 0, 0, 0, 3, 0, 0, 1, 4
"d:\IDEWORK\lvmen\src\licensedcode\data\rules\lgpl-2.0-plus_425.yml", "YAML", 0, 0, 0, 3, 0, 0, 1, 4
"d:\IDEWORK\lvmen\src\licensedcode\data\rules\lgpl-2.0-plus_426.yml", "YAML", 0, 0, 0, 5, 0, 0, 1, 6
"d:\IDEWORK\lvmen\src\licensedcode\data\rules\lgpl-2.0-plus_427.yml", "YAML", 0, 0, 0, 3, 0, 0, 1, 4
"d:\IDEWORK\lvmen\src\licensedcode\data\rules\lgpl-2.0-plus_428.yml", "YAML", 0, 0, 0, 3, 0, 0, 1, 4
"d:\IDEWORK\lvmen\src\licensedcode\data\rules\lgpl-2.0-plus_429.yml", "YAML", 0, 0, 0, 3, 0, 0, 1, 4
"d:\IDEWORK\lvmen\src\licensedcode\data\rules\lgpl-2.0-plus_43.yml", "YAML", 0, 0, 0, 4, 0, 0, 1, 5
"d:\IDEWORK\lvmen\src\licensedcode\data\rules\lgpl-2.0-plus_430.yml", "YAML", 0, 0, 0, 3, 0, 0, 1, 4
"d:\IDEWORK\lvmen\src\licensedcode\data\rules\lgpl-2.0-plus_431.yml", "YAML", 0, 0, 0, 3, 0, 0, 1, 4
"d:\IDEWORK\lvmen\src\licensedcode\data\rules\lgpl-2.0-plus_432.yml", "YAML", 0, 0, 0, 3, 0, 0, 1, 4
"d:\IDEWORK\lvmen\src\licensedcode\data\rules\lgpl-2.0-plus_433.yml", "YAML", 0, 0, 0, 3, 0, 0, 1, 4
"d:\IDEWORK\lvmen\src\licensedcode\data\rules\lgpl-2.0-plus_434.yml", "YAML", 0, 0, 0, 3, 0, 0, 1, 4
"d:\IDEWORK\lvmen\src\licensedcode\data\rules\lgpl-2.0-plus_435.yml", "YAML", 0, 0, 0, 5, 0, 0, 1, 6
"d:\IDEWORK\lvmen\src\licensedcode\data\rules\lgpl-2.0-plus_436.yml", "YAML", 0, 0, 0, 5, 0, 0, 1, 6
"d:\IDEWORK\lvmen\src\licensedcode\data\rules\lgpl-2.0-plus_437.yml", "YAML", 0, 0, 0, 5, 0, 0, 1, 6
"d:\IDEWORK\lvmen\src\licensedcode\data\rules\lgpl-2.0-plus_438.yml", "YAML", 0, 0, 0, 6, 0, 0, 1, 7
"d:\IDEWORK\lvmen\src\licensedcode\data\rules\lgpl-2.0-plus_439.yml", "YAML", 0, 0, 0, 4, 0, 0, 1, 5
"d:\IDEWORK\lvmen\src\licensedcode\data\rules\lgpl-2.0-plus_44.yml", "YAML", 0, 0, 0, 4, 0, 0, 1, 5
"d:\IDEWORK\lvmen\src\licensedcode\data\rules\lgpl-2.0-plus_440.yml", "YAML", 0, 0, 0, 3, 0, 0, 1, 4
"d:\IDEWORK\lvmen\src\licensedcode\data\rules\lgpl-2.0-plus_441.yml", "YAML", 0, 0, 0, 3, 0, 0, 1, 4
"d:\IDEWORK\lvmen\src\licensedcode\data\rules\lgpl-2.0-plus_442.yml", "YAML", 0, 0, 0, 3, 0, 0, 1, 4
"d:\IDEWORK\lvmen\src\licensedcode\data\rules\lgpl-2.0-plus_443.yml", "YAML", 0, 0, 0, 3, 0, 0, 1, 4
"d:\IDEWORK\lvmen\src\licensedcode\data\rules\lgpl-2.0-plus_444.yml", "YAML", 0, 0, 0, 3, 0, 0, 1, 4
"d:\IDEWORK\lvmen\src\licensedcode\data\rules\lgpl-2.0-plus_445.yml", "YAML", 0, 0, 0, 5, 0, 0, 1, 6
"d:\IDEWORK\lvmen\src\licensedcode\data\rules\lgpl-2.0-plus_446.yml", "YAML", 0, 0, 0, 3, 0, 0, 1, 4
"d:\IDEWORK\lvmen\src\licensedcode\data\rules\lgpl-2.0-plus_447.yml", "YAML", 0, 0, 0, 3, 0, 0, 1, 4
"d:\IDEWORK\lvmen\src\licensedcode\data\rules\lgpl-2.0-plus_448.yml", "YAML", 0, 0, 0, 5, 0, 0, 1, 6
"d:\IDEWORK\lvmen\src\licensedcode\data\rules\lgpl-2.0-plus_449.yml", "YAML", 0, 0, 0, 3, 0, 0, 1, 4
"d:\IDEWORK\lvmen\src\licensedcode\data\rules\lgpl-2.0-plus_45.yml", "YAML", 0, 0, 0, 4, 0, 0, 1, 5
"d:\IDEWORK\lvmen\src\licensedcode\data\rules\lgpl-2.0-plus_450.yml", "YAML", 0, 0, 0, 3, 0, 0, 1, 4
"d:\IDEWORK\lvmen\src\licensedcode\data\rules\lgpl-2.0-plus_451.yml", "YAML", 0, 0, 0, 2, 0, 0, 1, 3
"d:\IDEWORK\lvmen\src\licensedcode\data\rules\lgpl-2.0-plus_452.yml", "YAML", 0, 0, 0, 4, 0, 0, 1, 5
"d:\IDEWORK\lvmen\src\licensedcode\data\rules\lgpl-2.0-plus_453.yml", "YAML", 0, 0, 0, 3, 0, 0, 1, 4
"d:\IDEWORK\lvmen\src\licensedcode\data\rules\lgpl-2.0-plus_454.yml", "YAML", 0, 0, 0, 3, 0, 0, 1, 4
"d:\IDEWORK\lvmen\src\licensedcode\data\rules\lgpl-2.0-plus_455.yml", "YAML", 0, 0, 0, 3, 0, 0, 1, 4
"d:\IDEWORK\lvmen\src\licensedcode\data\rules\lgpl-2.0-plus_456.yml", "YAML", 0, 0, 0, 2, 0, 0, 1, 3
"d:\IDEWORK\lvmen\src\licensedcode\data\rules\lgpl-2.0-plus_457.yml", "YAML", 0, 0, 0, 4, 0, 0, 1, 5
"d:\IDEWORK\lvmen\src\licensedcode\data\rules\lgpl-2.0-plus_458.yml", "YAML", 0, 0, 0, 5, 0, 0, 1, 6
"d:\IDEWORK\lvmen\src\licensedcode\data\rules\lgpl-2.0-plus_459.yml", "YAML", 0, 0, 0, 2, 0, 0, 1, 3
"d:\IDEWORK\lvmen\src\licensedcode\data\rules\lgpl-2.0-plus_46.yml", "YAML", 0, 0, 0, 4, 0, 0, 1, 5
"d:\IDEWORK\lvmen\src\licensedcode\data\rules\lgpl-2.0-plus_460.yml", "YAML", 0, 0, 0, 4, 0, 0, 1, 5
"d:\IDEWORK\lvmen\src\licensedcode\data\rules\lgpl-2.0-plus_461.yml", "YAML", 0, 0, 0, 2, 0, 0, 1, 3
"d:\IDEWORK\lvmen\src\licensedcode\data\rules\lgpl-2.0-plus_462.yml", "YAML", 0, 0, 0, 4, 0, 0, 1, 5
"d:\IDEWORK\lvmen\src\licensedcode\data\rules\lgpl-2.0-plus_463.yml", "YAML", 0, 0, 0, 6, 0, 0, 1, 7
"d:\IDEWORK\lvmen\src\licensedcode\data\rules\lgpl-2.0-plus_464.yml", "YAML", 0, 0, 0, 6, 0, 0, 1, 7
"d:\IDEWORK\lvmen\src\licensedcode\data\rules\lgpl-2.0-plus_465.yml", "YAML", 0, 0, 0, 3, 0, 0, 1, 4
"d:\IDEWORK\lvmen\src\licensedcode\data\rules\lgpl-2.0-plus_466.yml", "YAML", 0, 0, 0, 4, 0, 0, 1, 5
"d:\IDEWORK\lvmen\src\licensedcode\data\rules\lgpl-2.0-plus_467.yml", "YAML", 0, 0, 0, 3, 0, 0, 1, 4
"d:\IDEWORK\lvmen\src\licensedcode\data\rules\lgpl-2.0-plus_468.yml", "YAML", 0, 0, 0, 4, 0, 0, 1, 5
"d:\IDEWORK\lvmen\src\licensedcode\data\rules\lgpl-2.0-plus_469.yml", "YAML", 0, 0, 0, 2, 0, 0, 1, 3
"d:\IDEWORK\lvmen\src\licensedcode\data\rules\lgpl-2.0-plus_47.yml", "YAML", 0, 0, 0, 6, 0, 0, 1, 7
"d:\IDEWORK\lvmen\src\licensedcode\data\rules\lgpl-2.0-plus_470.yml", "YAML", 0, 0, 0, 6, 0, 0, 1, 7
"d:\IDEWORK\lvmen\src\licensedcode\data\rules\lgpl-2.0-plus_471.yml", "YAML", 0, 0, 0, 5, 0, 0, 1, 6
"d:\IDEWORK\lvmen\src\licensedcode\data\rules\lgpl-2.0-plus_472.yml", "YAML", 0, 0, 0, 5, 0, 0, 1, 6
"d:\IDEWORK\lvmen\src\licensedcode\data\rules\lgpl-2.0-plus_473.yml", "YAML", 0, 0, 0, 3, 0, 0, 1, 4
"d:\IDEWORK\lvmen\src\licensedcode\data\rules\lgpl-2.0-plus_474.yml", "YAML", 0, 0, 0, 6, 0, 0, 1, 7
"d:\IDEWORK\lvmen\src\licensedcode\data\rules\lgpl-2.0-plus_475.yml", "YAML", 0, 0, 0, 5, 0, 0, 1, 6
"d:\IDEWORK\lvmen\src\licensedcode\data\rules\lgpl-2.0-plus_476.yml", "YAML", 0, 0, 0, 7, 0, 0, 1, 8
"d:\IDEWORK\lvmen\src\licensedcode\data\rules\lgpl-2.0-plus_477.yml", "YAML", 0, 0, 0, 6, 0, 0, 1, 7
"d:\IDEWORK\lvmen\src\licensedcode\data\rules\lgpl-2.0-plus_478.yml", "YAML", 0, 0, 0, 5, 0, 0, 1, 6
"d:\IDEWORK\lvmen\src\licensedcode\data\rules\lgpl-2.0-plus_479.yml", "YAML", 0, 0, 0, 6, 0, 0, 1, 7
"d:\IDEWORK\lvmen\src\licensedcode\data\rules\lgpl-2.0-plus_48.yml", "YAML", 0, 0, 0, 4, 0, 0, 1, 5
"d:\IDEWORK\lvmen\src\licensedcode\data\rules\lgpl-2.0-plus_480.yml", "YAML", 0, 0, 0, 5, 0, 0, 1, 6
"d:\IDEWORK\lvmen\src\licensedcode\data\rules\lgpl-2.0-plus_481.yml", "YAML", 0, 0, 0, 5, 0, 0, 1, 6
"d:\IDEWORK\lvmen\src\licensedcode\data\rules\lgpl-2.0-plus_482.yml", "YAML", 0, 0, 0, 6, 0, 0, 1, 7
"d:\IDEWORK\lvmen\src\licensedcode\data\rules\lgpl-2.0-plus_483.yml", "YAML", 0, 0, 0, 6, 0, 0, 1, 7
"d:\IDEWORK\lvmen\src\licensedcode\data\rules\lgpl-2.0-plus_484.yml", "YAML", 0, 0, 0, 5, 0, 0, 1, 6
"d:\IDEWORK\lvmen\src\licensedcode\data\rules\lgpl-2.0-plus_485.yml", "YAML", 0, 0, 0, 6, 0, 0, 1, 7
"d:\IDEWORK\lvmen\src\licensedcode\data\rules\lgpl-2.0-plus_486.yml", "YAML", 0, 0, 0, 5, 0, 0, 1, 6
"d:\IDEWORK\lvmen\src\licensedcode\data\rules\lgpl-2.0-plus_487.yml", "YAML", 0, 0, 0, 5, 0, 0, 1, 6
"d:\IDEWORK\lvmen\src\licensedcode\data\rules\lgpl-2.0-plus_488.yml", "YAML", 0, 0, 0, 5, 0, 0, 1, 6
"d:\IDEWORK\lvmen\src\licensedcode\data\rules\lgpl-2.0-plus_489.yml", "YAML", 0, 0, 0, 7, 0, 0, 1, 8
"d:\IDEWORK\lvmen\src\licensedcode\data\rules\lgpl-2.0-plus_49.yml", "YAML", 0, 0, 0, 4, 0, 0, 1, 5
"d:\IDEWORK\lvmen\src\licensedcode\data\rules\lgpl-2.0-plus_490.yml", "YAML", 0, 0, 0, 5, 0, 0, 1, 6
"d:\IDEWORK\lvmen\src\licensedcode\data\rules\lgpl-2.0-plus_491.yml", "YAML", 0, 0, 0, 5, 0, 0, 1, 6
"d:\IDEWORK\lvmen\src\licensedcode\data\rules\lgpl-2.0-plus_492.yml", "YAML", 0, 0, 0, 6, 0, 0, 1, 7
"d:\IDEWORK\lvmen\src\licensedcode\data\rules\lgpl-2.0-plus_493.yml", "YAML", 0, 0, 0, 5, 0, 0, 1, 6
"d:\IDEWORK\lvmen\src\licensedcode\data\rules\lgpl-2.0-plus_494.yml", "YAML", 0, 0, 0, 5, 0, 0, 1, 6
"d:\IDEWORK\lvmen\src\licensedcode\data\rules\lgpl-2.0-plus_495.yml", "YAML", 0, 0, 0, 5, 0, 0, 1, 6
"d:\IDEWORK\lvmen\src\licensedcode\data\rules\lgpl-2.0-plus_496.yml", "YAML", 0, 0, 0, 5, 0, 0, 1, 6
"d:\IDEWORK\lvmen\src\licensedcode\data\rules\lgpl-2.0-plus_497.yml", "YAML", 0, 0, 0, 5, 0, 0, 1, 6
"d:\IDEWORK\lvmen\src\licensedcode\data\rules\lgpl-2.0-plus_498.yml", "YAML", 0, 0, 0, 5, 0, 0, 1, 6
"d:\IDEWORK\lvmen\src\licensedcode\data\rules\lgpl-2.0-plus_499.yml", "YAML", 0, 0, 0, 5, 0, 0, 1, 6
"d:\IDEWORK\lvmen\src\licensedcode\data\rules\lgpl-2.0-plus_5.yml", "YAML", 0, 0, 0, 3, 0, 0, 1, 4
"d:\IDEWORK\lvmen\src\licensedcode\data\rules\lgpl-2.0-plus_50.yml", "YAML", 0, 0, 0, 2, 0, 0, 1, 3
"d:\IDEWORK\lvmen\src\licensedcode\data\rules\lgpl-2.0-plus_500.yml", "YAML", 0, 0, 0, 6, 0, 0, 1, 7
"d:\IDEWORK\lvmen\src\licensedcode\data\rules\lgpl-2.0-plus_501.yml", "YAML", 0, 0, 0, 7, 0, 0, 1, 8
"d:\IDEWORK\lvmen\src\licensedcode\data\rules\lgpl-2.0-plus_502.yml", "YAML", 0, 0, 0, 5, 0, 0, 1, 6
"d:\IDEWORK\lvmen\src\licensedcode\data\rules\lgpl-2.0-plus_503.yml", "YAML", 0, 0, 0, 5, 0, 0, 1, 6
"d:\IDEWORK\lvmen\src\licensedcode\data\rules\lgpl-2.0-plus_504.yml", "YAML", 0, 0, 0, 6, 0, 0, 1, 7
"d:\IDEWORK\lvmen\src\licensedcode\data\rules\lgpl-2.0-plus_505.yml", "YAML", 0, 0, 0, 6, 0, 0, 1, 7
"d:\IDEWORK\lvmen\src\licensedcode\data\rules\lgpl-2.0-plus_506.yml", "YAML", 0, 0, 0, 5, 0, 0, 1, 6
"d:\IDEWORK\lvmen\src\licensedcode\data\rules\lgpl-2.0-plus_507.yml", "YAML", 0, 0, 0, 7, 0, 0, 1, 8
"d:\IDEWORK\lvmen\src\licensedcode\data\rules\lgpl-2.0-plus_508.yml", "YAML", 0, 0, 0, 5, 0, 0, 1, 6
"d:\IDEWORK\lvmen\src\licensedcode\data\rules\lgpl-2.0-plus_509.yml", "YAML", 0, 0, 0, 5, 0, 0, 1, 6
"d:\IDEWORK\lvmen\src\licensedcode\data\rules\lgpl-2.0-plus_51.yml", "YAML", 0, 0, 0, 3, 0, 0, 1, 4
"d:\IDEWORK\lvmen\src\licensedcode\data\rules\lgpl-2.0-plus_510.yml", "YAML", 0, 0, 0, 7, 0, 0, 1, 8
"d:\IDEWORK\lvmen\src\licensedcode\data\rules\lgpl-2.0-plus_511.yml", "YAML", 0, 0, 0, 5, 0, 0, 1, 6
"d:\IDEWORK\lvmen\src\licensedcode\data\rules\lgpl-2.0-plus_512.yml", "YAML", 0, 0, 0, 6, 0, 0, 1, 7
"d:\IDEWORK\lvmen\src\licensedcode\data\rules\lgpl-2.0-plus_513.yml", "YAML", 0, 0, 0, 5, 0, 0, 1, 6
"d:\IDEWORK\lvmen\src\licensedcode\data\rules\lgpl-2.0-plus_514.yml", "YAML", 0, 0, 0, 7, 0, 0, 1, 8
"d:\IDEWORK\lvmen\src\licensedcode\data\rules\lgpl-2.0-plus_515.yml", "YAML", 0, 0, 0, 3, 0, 0, 1, 4
"d:\IDEWORK\lvmen\src\licensedcode\data\rules\lgpl-2.0-plus_516.yml", "YAML", 0, 0, 0, 3, 0, 0, 1, 4
"d:\IDEWORK\lvmen\src\licensedcode\data\rules\lgpl-2.0-plus_517.yml", "YAML", 0, 0, 0, 6, 0, 0, 1, 7
"d:\IDEWORK\lvmen\src\licensedcode\data\rules\lgpl-2.0-plus_518.yml", "YAML", 0, 0, 0, 6, 0, 0, 1, 7
"d:\IDEWORK\lvmen\src\licensedcode\data\rules\lgpl-2.0-plus_519.yml", "YAML", 0, 0, 0, 3, 0, 0, 1, 4
"d:\IDEWORK\lvmen\src\licensedcode\data\rules\lgpl-2.0-plus_52.yml", "YAML", 0, 0, 0, 4, 0, 0, 1, 5
"d:\IDEWORK\lvmen\src\licensedcode\data\rules\lgpl-2.0-plus_520.yml", "YAML", 0, 0, 0, 5, 0, 0, 1, 6
"d:\IDEWORK\lvmen\src\licensedcode\data\rules\lgpl-2.0-plus_521.yml", "YAML", 0, 0, 0, 3, 0, 0, 1, 4
"d:\IDEWORK\lvmen\src\licensedcode\data\rules\lgpl-2.0-plus_522.yml", "YAML", 0, 0, 0, 7, 0, 0, 1, 8
"d:\IDEWORK\lvmen\src\licensedcode\data\rules\lgpl-2.0-plus_523.yml", "YAML", 0, 0, 0, 6, 0, 0, 1, 7
"d:\IDEWORK\lvmen\src\licensedcode\data\rules\lgpl-2.0-plus_524.yml", "YAML", 0, 0, 0, 7, 0, 0, 1, 8
"d:\IDEWORK\lvmen\src\licensedcode\data\rules\lgpl-2.0-plus_525.yml", "YAML", 0, 0, 0, 5, 0, 0, 1, 6
"d:\IDEWORK\lvmen\src\licensedcode\data\rules\lgpl-2.0-plus_526.yml", "YAML", 0, 0, 0, 4, 0, 0, 1, 5
"d:\IDEWORK\lvmen\src\licensedcode\data\rules\lgpl-2.0-plus_527.yml", "YAML", 0, 0, 0, 4, 0, 0, 1, 5
"d:\IDEWORK\lvmen\src\licensedcode\data\rules\lgpl-2.0-plus_528.yml", "YAML", 0, 0, 0, 4, 0, 0, 1, 5
"d:\IDEWORK\lvmen\src\licensedcode\data\rules\lgpl-2.0-plus_529.yml", "YAML", 0, 0, 0, 4, 0, 0, 1, 5
"d:\IDEWORK\lvmen\src\licensedcode\data\rules\lgpl-2.0-plus_53.yml", "YAML", 0, 0, 0, 4, 0, 0, 1, 5
"d:\IDEWORK\lvmen\src\licensedcode\data\rules\lgpl-2.0-plus_530.yml", "YAML", 0, 0, 0, 2, 0, 0, 1, 3
"d:\IDEWORK\lvmen\src\licensedcode\data\rules\lgpl-2.0-plus_54.yml", "YAML", 0, 0, 0, 4, 0, 0, 1, 5
"d:\IDEWORK\lvmen\src\licensedcode\data\rules\lgpl-2.0-plus_55.yml", "YAML", 0, 0, 0, 2, 0, 0, 1, 3
"d:\IDEWORK\lvmen\src\licensedcode\data\rules\lgpl-2.0-plus_56.yml", "YAML", 0, 0, 0, 2, 0, 0, 1, 3
"d:\IDEWORK\lvmen\src\licensedcode\data\rules\lgpl-2.0-plus_57.yml", "YAML", 0, 0, 0, 2, 0, 0, 1, 3
"d:\IDEWORK\lvmen\src\licensedcode\data\rules\lgpl-2.0-plus_58.yml", "YAML", 0, 0, 0, 4, 0, 0, 1, 5
"d:\IDEWORK\lvmen\src\licensedcode\data\rules\lgpl-2.0-plus_59.yml", "YAML", 0, 0, 0, 4, 0, 0, 1, 5
"d:\IDEWORK\lvmen\src\licensedcode\data\rules\lgpl-2.0-plus_590.yml", "YAML", 0, 0, 0, 3, 0, 0, 1, 4
"d:\IDEWORK\lvmen\src\licensedcode\data\rules\lgpl-2.0-plus_6.yml", "YAML", 0, 0, 0, 3, 0, 0, 1, 4
"d:\IDEWORK\lvmen\src\licensedcode\data\rules\lgpl-2.0-plus_60.yml", "YAML", 0, 0, 0, 5, 0, 0, 1, 6
"d:\IDEWORK\lvmen\src\licensedcode\data\rules\lgpl-2.0-plus_60_1.yml", "YAML", 0, 0, 0, 5, 0, 0, 1, 6
"d:\IDEWORK\lvmen\src\licensedcode\data\rules\lgpl-2.0-plus_60_2.yml", "YAML", 0, 0, 0, 5, 0, 0, 1, 6
"d:\IDEWORK\lvmen\src\licensedcode\data\rules\lgpl-2.0-plus_60_3.yml", "YAML", 0, 0, 0, 4, 0, 0, 1, 5
"d:\IDEWORK\lvmen\src\licensedcode\data\rules\lgpl-2.0-plus_60_4.yml", "YAML", 0, 0, 0, 5, 0, 0, 1, 6
"d:\IDEWORK\lvmen\src\licensedcode\data\rules\lgpl-2.0-plus_61.yml", "YAML", 0, 0, 0, 3, 0, 0, 1, 4
"d:\IDEWORK\lvmen\src\licensedcode\data\rules\lgpl-2.0-plus_62.yml", "YAML", 0, 0, 0, 3, 0, 0, 1, 4
"d:\IDEWORK\lvmen\src\licensedcode\data\rules\lgpl-2.0-plus_63.yml", "YAML", 0, 0, 0, 3, 0, 0, 1, 4
"d:\IDEWORK\lvmen\src\licensedcode\data\rules\lgpl-2.0-plus_64.yml", "YAML", 0, 0, 0, 2, 0, 0, 1, 3
"d:\IDEWORK\lvmen\src\licensedcode\data\rules\lgpl-2.0-plus_65.yml", "YAML", 0, 0, 0, 2, 0, 0, 1, 3
"d:\IDEWORK\lvmen\src\licensedcode\data\rules\lgpl-2.0-plus_66.yml", "YAML", 0, 0, 0, 6, 0, 0, 1, 7
"d:\IDEWORK\lvmen\src\licensedcode\data\rules\lgpl-2.0-plus_67.yml", "YAML", 0, 0, 0, 2, 0, 0, 1, 3
"d:\IDEWORK\lvmen\src\licensedcode\data\rules\lgpl-2.0-plus_68.yml", "YAML", 0, 0, 0, 3, 0, 0, 1, 4
"d:\IDEWORK\lvmen\src\licensedcode\data\rules\lgpl-2.0-plus_69.yml", "YAML", 0, 0, 0, 5, 0, 0, 1, 6
"d:\IDEWORK\lvmen\src\licensedcode\data\rules\lgpl-2.0-plus_7.yml", "YAML", 0, 0, 0, 8, 0, 0, 1, 9
"d:\IDEWORK\lvmen\src\licensedcode\data\rules\lgpl-2.0-plus_70.yml", "YAML", 0, 0, 0, 5, 0, 0, 1, 6
"d:\IDEWORK\lvmen\src\licensedcode\data\rules\lgpl-2.0-plus_71.yml", "YAML", 0, 0, 0, 5, 0, 0, 1, 6
"d:\IDEWORK\lvmen\src\licensedcode\data\rules\lgpl-2.0-plus_72.yml", "YAML", 0, 0, 0, 3, 0, 0, 1, 4
"d:\IDEWORK\lvmen\src\licensedcode\data\rules\lgpl-2.0-plus_73.yml", "YAML", 0, 0, 0, 2, 0, 0, 1, 3
"d:\IDEWORK\lvmen\src\licensedcode\data\rules\lgpl-2.0-plus_74.yml", "YAML", 0, 0, 0, 4, 0, 0, 1, 5
"d:\IDEWORK\lvmen\src\licensedcode\data\rules\lgpl-2.0-plus_75.yml", "YAML", 0, 0, 0, 4, 0, 0, 1, 5
"d:\IDEWORK\lvmen\src\licensedcode\data\rules\lgpl-2.0-plus_76.yml", "YAML", 0, 0, 0, 4, 0, 0, 1, 5
"d:\IDEWORK\lvmen\src\licensedcode\data\rules\lgpl-2.0-plus_77.yml", "YAML", 0, 0, 0, 2, 0, 0, 1, 3
"d:\IDEWORK\lvmen\src\licensedcode\data\rules\lgpl-2.0-plus_78.yml", "YAML", 0, 0, 0, 3, 0, 0, 1, 4
"d:\IDEWORK\lvmen\src\licensedcode\data\rules\lgpl-2.0-plus_79.yml", "YAML", 0, 0, 0, 2, 0, 0, 1, 3
"d:\IDEWORK\lvmen\src\licensedcode\data\rules\lgpl-2.0-plus_8.yml", "YAML", 0, 0, 0, 3, 0, 0, 1, 4
"d:\IDEWORK\lvmen\src\licensedcode\data\rules\lgpl-2.0-plus_80.yml", "YAML", 0, 0, 0, 3, 0, 0, 1, 4
"d:\IDEWORK\lvmen\src\licensedcode\data\rules\lgpl-2.0-plus_81.yml", "YAML", 0, 0, 0, 3, 0, 0, 1, 4
"d:\IDEWORK\lvmen\src\licensedcode\data\rules\lgpl-2.0-plus_82.yml", "YAML", 0, 0, 0, 3, 0, 0, 1, 4
"d:\IDEWORK\lvmen\src\licensedcode\data\rules\lgpl-2.0-plus_83.yml", "YAML", 0, 0, 0, 2, 0, 0, 1, 3
"d:\IDEWORK\lvmen\src\licensedcode\data\rules\lgpl-2.0-plus_84.yml", "YAML", 0, 0, 0, 2, 0, 0, 1, 3
"d:\IDEWORK\lvmen\src\licensedcode\data\rules\lgpl-2.0-plus_85.yml", "YAML", 0, 0, 0, 5, 0, 0, 1, 6
"d:\IDEWORK\lvmen\src\licensedcode\data\rules\lgpl-2.0-plus_86.yml", "YAML", 0, 0, 0, 3, 0, 0, 1, 4
"d:\IDEWORK\lvmen\src\licensedcode\data\rules\lgpl-2.0-plus_87.yml", "YAML", 0, 0, 0, 3, 0, 0, 1, 4
"d:\IDEWORK\lvmen\src\licensedcode\data\rules\lgpl-2.0-plus_88.yml", "YAML", 0, 0, 0, 6, 0, 0, 1, 7
"d:\IDEWORK\lvmen\src\licensedcode\data\rules\lgpl-2.0-plus_89.yml", "YAML", 0, 0, 0, 6, 0, 0, 1, 7
"d:\IDEWORK\lvmen\src\licensedcode\data\rules\lgpl-2.0-plus_9.yml", "YAML", 0, 0, 0, 6, 0, 0, 1, 7
"d:\IDEWORK\lvmen\src\licensedcode\data\rules\lgpl-2.0-plus_90.yml", "YAML", 0, 0, 0, 6, 0, 0, 1, 7
"d:\IDEWORK\lvmen\src\licensedcode\data\rules\lgpl-2.0-plus_91.yml", "YAML", 0, 0, 0, 6, 0, 0, 1, 7
"d:\IDEWORK\lvmen\src\licensedcode\data\rules\lgpl-2.0-plus_92.yml", "YAML", 0, 0, 0, 5, 0, 0, 1, 6
"d:\IDEWORK\lvmen\src\licensedcode\data\rules\lgpl-2.0-plus_93.yml", "YAML", 0, 0, 0, 5, 0, 0, 1, 6
"d:\IDEWORK\lvmen\src\licensedcode\data\rules\lgpl-2.0-plus_94.yml", "YAML", 0, 0, 0, 5, 0, 0, 1, 6
"d:\IDEWORK\lvmen\src\licensedcode\data\rules\lgpl-2.0-plus_95.yml", "YAML", 0, 0, 0, 5, 0, 0, 1, 6
"d:\IDEWORK\lvmen\src\licensedcode\data\rules\lgpl-2.0-plus_96.yml", "YAML", 0, 0, 0, 3, 0, 0, 1, 4
"d:\IDEWORK\lvmen\src\licensedcode\data\rules\lgpl-2.0-plus_97.yml", "YAML", 0, 0, 0, 5, 0, 0, 1, 6
"d:\IDEWORK\lvmen\src\licensedcode\data\rules\lgpl-2.0-plus_98.yml", "YAML", 0, 0, 0, 5, 0, 0, 1, 6
"d:\IDEWORK\lvmen\src\licensedcode\data\rules\lgpl-2.0-plus_99.yml", "YAML", 0, 0, 0, 3, 0, 0, 1, 4
"d:\IDEWORK\lvmen\src\licensedcode\data\rules\lgpl-2.0-plus_and_bsd-new_1.yml", "YAML", 0, 0, 0, 3, 0, 0, 1, 4
"d:\IDEWORK\lvmen\src\licensedcode\data\rules\lgpl-2.0-plus_and_bsd-new_2.yml", "YAML", 0, 0, 0, 3, 0, 0, 1, 4
"d:\IDEWORK\lvmen\src\licensedcode\data\rules\lgpl-2.0-plus_and_bsd-new_and_mit_1.yml", "YAML", 0, 0, 0, 4, 0, 0, 1, 5
"d:\IDEWORK\lvmen\src\licensedcode\data\rules\lgpl-2.0-plus_and_cc-by-sa-3.0_and_other-copyleft_1.yml", "YAML", 0, 0, 0, 3, 0, 0, 1, 4
"d:\IDEWORK\lvmen\src\licensedcode\data\rules\lgpl-2.0-plus_and_gpl-1.0-plus_1.yml", "YAML", 0, 0, 0, 7, 0, 0, 1, 8
"d:\IDEWORK\lvmen\src\licensedcode\data\rules\lgpl-2.0-plus_and_gpl-1.0-plus_2.yml", "YAML", 0, 0, 0, 5, 0, 0, 1, 6
"d:\IDEWORK\lvmen\src\licensedcode\data\rules\lgpl-2.0-plus_and_gpl-1.0-plus_3.yml", "YAML", 0, 0, 0, 3, 0, 0, 1, 4
"d:\IDEWORK\lvmen\src\licensedcode\data\rules\lgpl-2.0-plus_and_gpl-1.0-plus_4.yml", "YAML", 0, 0, 0, 5, 0, 0, 1, 6
"d:\IDEWORK\lvmen\src\licensedcode\data\rules\lgpl-2.0-plus_and_gpl-1.0-plus_5.yml", "YAML", 0, 0, 0, 6, 0, 0, 1, 7
"d:\IDEWORK\lvmen\src\licensedcode\data\rules\lgpl-2.0-plus_and_gpl-1.0-plus_6.yml", "YAML", 0, 0, 0, 6, 0, 0, 1, 7
"d:\IDEWORK\lvmen\src\licensedcode\data\rules\lgpl-2.0-plus_and_gpl-1.0-plus_7.yml", "YAML", 0, 0, 0, 6, 0, 0, 1, 7
"d:\IDEWORK\lvmen\src\licensedcode\data\rules\lgpl-2.0-plus_and_gpl-1.0-plus_and_bsd-new_1.yml", "YAML", 0, 0, 0, 8, 0, 0, 1, 9
"d:\IDEWORK\lvmen\src\licensedcode\data\rules\lgpl-2.0-plus_and_gpl-1.0-plus_and_bsd-new_2.yml", "YAML", 0, 0, 0, 8, 0, 0, 1, 9
"d:\IDEWORK\lvmen\src\licensedcode\data\rules\lgpl-2.0-plus_and_gpl-2.0-plus.yml", "YAML", 0, 0, 0, 7, 0, 0, 1, 8
"d:\IDEWORK\lvmen\src\licensedcode\data\rules\lgpl-2.0-plus_and_gpl-2.0-plus_1.yml", "YAML", 0, 0, 0, 6, 0, 0, 1, 7
"d:\IDEWORK\lvmen\src\licensedcode\data\rules\lgpl-2.0-plus_and_gpl-2.0-plus_10.yml", "YAML", 0, 0, 0, 7, 0, 0, 1, 8
"d:\IDEWORK\lvmen\src\licensedcode\data\rules\lgpl-2.0-plus_and_gpl-2.0-plus_2.yml", "YAML", 0, 0, 0, 3, 0, 0, 1, 4
"d:\IDEWORK\lvmen\src\licensedcode\data\rules\lgpl-2.0-plus_and_gpl-2.0-plus_3.yml", "YAML", 0, 0, 0, 3, 0, 0, 1, 4
"d:\IDEWORK\lvmen\src\licensedcode\data\rules\lgpl-2.0-plus_and_gpl-2.0-plus_4.yml", "YAML", 0, 0, 0, 3, 0, 0, 1, 4
"d:\IDEWORK\lvmen\src\licensedcode\data\rules\lgpl-2.0-plus_and_gpl-2.0-plus_5.yml", "YAML", 0, 0, 0, 3, 0, 0, 1, 4
"d:\IDEWORK\lvmen\src\licensedcode\data\rules\lgpl-2.0-plus_and_gpl-2.0-plus_6.yml", "YAML", 0, 0, 0, 7, 0, 0, 1, 8
"d:\IDEWORK\lvmen\src\licensedcode\data\rules\lgpl-2.0-plus_and_gpl-2.0-plus_7.yml", "YAML", 0, 0, 0, 7, 0, 0, 1, 8
"d:\IDEWORK\lvmen\src\licensedcode\data\rules\lgpl-2.0-plus_and_gpl-2.0-plus_8.yml", "YAML", 0, 0, 0, 7, 0, 0, 1, 8
"d:\IDEWORK\lvmen\src\licensedcode\data\rules\lgpl-2.0-plus_and_gpl-2.0-plus_9.yml", "YAML", 0, 0, 0, 8, 0, 0, 1, 9
"d:\IDEWORK\lvmen\src\licensedcode\data\rules\lgpl-2.0-plus_and_lgpl-2.0-plus_and_gpl-1.0-plus_1.yml", "YAML", 0, 0, 0, 2, 0, 0, 1, 3
"d:\IDEWORK\lvmen\src\licensedcode\data\rules\lgpl-2.0-plus_and_lgpl-2.1.yml", "YAML", 0, 0, 0, 2, 0, 0, 1, 3
"d:\IDEWORK\lvmen\src\licensedcode\data\rules\lgpl-2.0-plus_and_lgpl-2.1_1.yml", "YAML", 0, 0, 0, 3, 0, 0, 1, 4
"d:\IDEWORK\lvmen\src\licensedcode\data\rules\lgpl-2.0-plus_and_lgpl-2.1_2.yml", "YAML", 0, 0, 0, 6, 0, 0, 1, 7
"d:\IDEWORK\lvmen\src\licensedcode\data\rules\lgpl-2.0-plus_and_lgpl-2.1_3.yml", "YAML", 0, 0, 0, 7, 0, 0, 1, 8
"d:\IDEWORK\lvmen\src\licensedcode\data\rules\lgpl-2.0-plus_and_lgpl-2.1_4.yml", "YAML", 0, 0, 0, 3, 0, 0, 1, 4
"d:\IDEWORK\lvmen\src\licensedcode\data\rules\lgpl-2.0-plus_and_lgpl-2.1_5.yml", "YAML", 0, 0, 0, 7, 0, 0, 1, 8
"d:\IDEWORK\lvmen\src\licensedcode\data\rules\lgpl-2.0-plus_and_lgpl-3.0_and_gpl-1.0-plus_and_gpl-3.0_and_gfdl-1.3_1.yml", "YAML", 0, 0, 0, 8, 0, 0, 1, 9
"d:\IDEWORK\lvmen\src\licensedcode\data\rules\lgpl-2.0-plus_and_mit_1.yml", "YAML", 0, 0, 0, 3, 0, 0, 1, 4
"d:\IDEWORK\lvmen\src\licensedcode\data\rules\lgpl-2.0-plus_and_proprietary-license_1.yml", "YAML", 0, 0, 0, 4, 0, 0, 1, 5
"d:\IDEWORK\lvmen\src\licensedcode\data\rules\lgpl-2.0-plus_and_unknown-license-reference_1.yml", "YAML", 0, 0, 0, 6, 0, 0, 1, 7
"d:\IDEWORK\lvmen\src\licensedcode\data\rules\lgpl-2.0-plus_cbcserver.yml", "YAML", 0, 0, 0, 5, 0, 0, 1, 6
"d:\IDEWORK\lvmen\src\licensedcode\data\rules\lgpl-2.0-plus_cbcserver2.yml", "YAML", 0, 0, 0, 3, 0, 0, 1, 4
"d:\IDEWORK\lvmen\src\licensedcode\data\rules\lgpl-2.0-plus_cbcserver3.yml", "YAML", 0, 0, 0, 2, 0, 0, 1, 3
"d:\IDEWORK\lvmen\src\licensedcode\data\rules\lgpl-2.0-plus_debian.yml", "YAML", 0, 0, 0, 2, 0, 0, 1, 3
"d:\IDEWORK\lvmen\src\licensedcode\data\rules\lgpl-2.0-plus_microwin_1.yml", "YAML", 0, 0, 0, 3, 0, 0, 1, 4
"d:\IDEWORK\lvmen\src\licensedcode\data\rules\lgpl-2.0-plus_newlib2.yml", "YAML", 0, 0, 0, 4, 0, 0, 1, 5
"d:\IDEWORK\lvmen\src\licensedcode\data\rules\lgpl-2.0-plus_not_3_1.yml", "YAML", 0, 0, 0, 5, 0, 0, 1, 6
"d:\IDEWORK\lvmen\src\licensedcode\data\rules\lgpl-2.0-plus_not_3_2.yml", "YAML", 0, 0, 0, 3, 0, 0, 1, 4
"d:\IDEWORK\lvmen\src\licensedcode\data\rules\lgpl-2.0-plus_not_gpl_100.yml", "YAML", 0, 0, 0, 2, 0, 0, 1, 3
"d:\IDEWORK\lvmen\src\licensedcode\data\rules\lgpl-2.0-plus_notice_1.yml", "YAML", 0, 0, 0, 4, 0, 0, 1, 5
"d:\IDEWORK\lvmen\src\licensedcode\data\rules\lgpl-2.0-plus_or_afl-3.0_1.yml", "YAML", 0, 0, 0, 3, 0, 0, 1, 4
"d:\IDEWORK\lvmen\src\licensedcode\data\rules\lgpl-2.0-plus_or_bsd-new_1.yml", "YAML", 0, 0, 0, 5, 0, 0, 1, 6
"d:\IDEWORK\lvmen\src\licensedcode\data\rules\lgpl-2.0-plus_or_bsd-new_2.yml", "YAML", 0, 0, 0, 5, 0, 0, 1, 6
"d:\IDEWORK\lvmen\src\licensedcode\data\rules\lgpl-2.0-plus_or_bsd-new_3.yml", "YAML", 0, 0, 0, 3, 0, 0, 1, 4
"d:\IDEWORK\lvmen\src\licensedcode\data\rules\lgpl-2.0-plus_or_bsd-new_4.yml", "YAML", 0, 0, 0, 3, 0, 0, 1, 4
"d:\IDEWORK\lvmen\src\licensedcode\data\rules\lgpl-2.0-plus_or_bsd-new_5.yml", "YAML", 0, 0, 0, 3, 0, 0, 1, 4
"d:\IDEWORK\lvmen\src\licensedcode\data\rules\lgpl-2.0-plus_or_bsd-new_6.yml", "YAML", 0, 0, 0, 6, 0, 0, 1, 7
"d:\IDEWORK\lvmen\src\licensedcode\data\rules\lgpl-2.0-plus_or_bsd-new_7.yml", "YAML", 0, 0, 0, 6, 0, 0, 1, 7
"d:\IDEWORK\lvmen\src\licensedcode\data\rules\lgpl-2.0-plus_or_commercial-license_1.yml", "YAML", 0, 0, 0, 3, 0, 0, 1, 4
"d:\IDEWORK\lvmen\src\licensedcode\data\rules\lgpl-2.0-plus_or_commercial-license_2.yml", "YAML", 0, 0, 0, 3, 0, 0, 1, 4
"d:\IDEWORK\lvmen\src\licensedcode\data\rules\lgpl-2.0-plus_or_gpl-1.0-plus_1.yml", "YAML", 0, 0, 0, 3, 0, 0, 1, 4
"d:\IDEWORK\lvmen\src\licensedcode\data\rules\lgpl-2.0-plus_or_gpl-1.0-plus_2.yml", "YAML", 0, 0, 0, 3, 0, 0, 1, 4
"d:\IDEWORK\lvmen\src\licensedcode\data\rules\lgpl-2.0-plus_or_gpl-1.0-plus_3.yml", "YAML", 0, 0, 0, 3, 0, 0, 1, 4
"d:\IDEWORK\lvmen\src\licensedcode\data\rules\lgpl-2.0-plus_or_gpl-1.0-plus_300.yml", "YAML", 0, 0, 0, 5, 0, 0, 1, 6
"d:\IDEWORK\lvmen\src\licensedcode\data\rules\lgpl-2.0-plus_or_gpl-2.0-plus_or_commercial-license_1.yml", "YAML", 0, 0, 0, 3, 0, 0, 1, 4
"d:\IDEWORK\lvmen\src\licensedcode\data\rules\lgpl-2.0-plus_or_mit_1.yml", "YAML", 0, 0, 0, 3, 0, 0, 1, 4
"d:\IDEWORK\lvmen\src\licensedcode\data\rules\lgpl-2.0-plus_short_tag.yml", "YAML", 0, 0, 0, 3, 0, 0, 1, 4
"d:\IDEWORK\lvmen\src\licensedcode\data\rules\lgpl-2.0-plus_url_1.yml", "YAML", 0, 0, 0, 5, 0, 0, 1, 6
"d:\IDEWORK\lvmen\src\licensedcode\data\rules\lgpl-2.0-plus_url_2.yml", "YAML", 0, 0, 0, 5, 0, 0, 1, 6
"d:\IDEWORK\lvmen\src\licensedcode\data\rules\lgpl-2.0-plus_with_fltk-exception-lgpl-2.0_1.yml", "YAML", 0, 0, 0, 6, 0, 0, 1, 7
"d:\IDEWORK\lvmen\src\licensedcode\data\rules\lgpl-2.0-plus_with_fltk.yml", "YAML", 0, 0, 0, 6, 0, 0, 1, 7
"d:\IDEWORK\lvmen\src\licensedcode\data\rules\lgpl-2.0-plus_with_gcc-linking-exception-2.0_1.yml", "YAML", 0, 0, 0, 7, 0, 0, 1, 8
"d:\IDEWORK\lvmen\src\licensedcode\data\rules\lgpl-2.0-plus_with_generic-exception_1.yml", "YAML", 0, 0, 0, 3, 0, 0, 1, 4
"d:\IDEWORK\lvmen\src\licensedcode\data\rules\lgpl-2.0-plus_with_libtool-exception-2.0_1.yml", "YAML", 0, 0, 0, 7, 0, 0, 1, 8
"d:\IDEWORK\lvmen\src\licensedcode\data\rules\lgpl-2.0-plus_with_libtool-exception-2.0_2.yml", "YAML", 0, 0, 0, 7, 0, 0, 1, 8
"d:\IDEWORK\lvmen\src\licensedcode\data\rules\lgpl-2.0-plus_with_libtool-exception-2.0_3.yml", "YAML", 0, 0, 0, 7, 0, 0, 1, 8
"d:\IDEWORK\lvmen\src\licensedcode\data\rules\lgpl-2.0-plus_with_libtool-exception-2.0_4.yml", "YAML", 0, 0, 0, 2, 0, 0, 1, 3
"d:\IDEWORK\lvmen\src\licensedcode\data\rules\lgpl-2.0-plus_with_libtool-exception-2.0_5.yml", "YAML", 0, 0, 0, 7, 0, 0, 1, 8
"d:\IDEWORK\lvmen\src\licensedcode\data\rules\lgpl-2.0-plus_with_libtool-exception-2.0_6.yml", "YAML", 0, 0, 0, 7, 0, 0, 1, 8
"d:\IDEWORK\lvmen\src\licensedcode\data\rules\lgpl-2.0-plus_with_libtool-exception-2.0_7.yml", "YAML", 0, 0, 0, 8, 0, 0, 1, 9
"d:\IDEWORK\lvmen\src\licensedcode\data\rules\lgpl-2.0-plus_with_ocaml-lgpl-linking-exception_1.yml", "YAML", 0, 0, 0, 5, 0, 0, 1, 6
"d:\IDEWORK\lvmen\src\licensedcode\data\rules\lgpl-2.0-plus_with_ocaml-lgpl-linking-exception_10.yml", "YAML", 0, 0, 0, 4, 0, 0, 1, 5
"d:\IDEWORK\lvmen\src\licensedcode\data\rules\lgpl-2.0-plus_with_ocaml-lgpl-linking-exception_11.yml", "YAML", 0, 0, 0, 5, 0, 0, 1, 6
"d:\IDEWORK\lvmen\src\licensedcode\data\rules\lgpl-2.0-plus_with_ocaml-lgpl-linking-exception_2.yml", "YAML", 0, 0, 0, 3, 0, 0, 1, 4
"d:\IDEWORK\lvmen\src\licensedcode\data\rules\lgpl-2.0-plus_with_ocaml-lgpl-linking-exception_3.yml", "YAML", 0, 0, 0, 3, 0, 0, 1, 4
"d:\IDEWORK\lvmen\src\licensedcode\data\rules\lgpl-2.0-plus_with_ocaml-lgpl-linking-exception_4.yml", "YAML", 0, 0, 0, 3, 0, 0, 1, 4
"d:\IDEWORK\lvmen\src\licensedcode\data\rules\lgpl-2.0-plus_with_ocaml-lgpl-linking-exception_5.yml", "YAML", 0, 0, 0, 3, 0, 0, 1, 4
"d:\IDEWORK\lvmen\src\licensedcode\data\rules\lgpl-2.0-plus_with_ocaml-lgpl-linking-exception_6.yml", "YAML", 0, 0, 0, 3, 0, 0, 1, 4
"d:\IDEWORK\lvmen\src\licensedcode\data\rules\lgpl-2.0-plus_with_ocaml-lgpl-linking-exception_7.yml", "YAML", 0, 0, 0, 6, 0, 0, 1, 7
"d:\IDEWORK\lvmen\src\licensedcode\data\rules\lgpl-2.0-plus_with_ocaml-lgpl-linking-exception_8.yml", "YAML", 0, 0, 0, 6, 0, 0, 1, 7
"d:\IDEWORK\lvmen\src\licensedcode\data\rules\lgpl-2.0-plus_with_ocaml-lgpl-linking-exception_9.yml", "YAML", 0, 0, 0, 4, 0, 0, 1, 5
"d:\IDEWORK\lvmen\src\licensedcode\data\rules\lgpl-2.0-plus_with_unlimited-binary-linking.yml", "YAML", 0, 0, 0, 3, 0, 0, 1, 4
"d:\IDEWORK\lvmen\src\licensedcode\data\rules\lgpl-2.0-plus_with_wxwindows-exception-3.1_1.yml", "YAML", 0, 0, 0, 8, 0, 0, 1, 9
"d:\IDEWORK\lvmen\src\licensedcode\data\rules\lgpl-2.0-plus_with_wxwindows-exception-3.1_10.yml", "YAML", 0, 0, 0, 4, 0, 0, 1, 5
"d:\IDEWORK\lvmen\src\licensedcode\data\rules\lgpl-2.0-plus_with_wxwindows-exception-3.1_2.yml", "YAML", 0, 0, 0, 10, 0, 0, 1, 11
"d:\IDEWORK\lvmen\src\licensedcode\data\rules\lgpl-2.0-plus_with_wxwindows-exception-3.1_3.yml", "YAML", 0, 0, 0, 10, 0, 0, 1, 11
"d:\IDEWORK\lvmen\src\licensedcode\data\rules\lgpl-2.0-plus_with_wxwindows-exception-3.1_4.yml", "YAML", 0, 0, 0, 14, 0, 0, 1, 15
"d:\IDEWORK\lvmen\src\licensedcode\data\rules\lgpl-2.0-plus_with_wxwindows-exception-3.1_5.yml", "YAML", 0, 0, 0, 2, 0, 0, 1, 3
"d:\IDEWORK\lvmen\src\licensedcode\data\rules\lgpl-2.0-plus_with_wxwindows-exception-3.1_6.yml", "YAML", 0, 0, 0, 3, 0, 0, 1, 4
"d:\IDEWORK\lvmen\src\licensedcode\data\rules\lgpl-2.0-plus_with_wxwindows-exception-3.1_7.yml", "YAML", 0, 0, 0, 3, 0, 0, 1, 4
"d:\IDEWORK\lvmen\src\licensedcode\data\rules\lgpl-2.0-plus_with_wxwindows-exception-3.1_8.yml", "YAML", 0, 0, 0, 3, 0, 0, 1, 4
"d:\IDEWORK\lvmen\src\licensedcode\data\rules\lgpl-2.0-plus_with_wxwindows-exception-3.1_9.yml", "YAML", 0, 0, 0, 3, 0, 0, 1, 4
"d:\IDEWORK\lvmen\src\licensedcode\data\rules\lgpl-2.0.SPDX.yml", "YAML", 0, 0, 0, 10, 0, 0, 1, 11
"d:\IDEWORK\lvmen\src\licensedcode\data\rules\lgpl-2.0_1.yml", "YAML", 0, 0, 0, 5, 0, 0, 1, 6
"d:\IDEWORK\lvmen\src\licensedcode\data\rules\lgpl-2.0_10.yml", "YAML", 0, 0, 0, 4, 0, 0, 1, 5
"d:\IDEWORK\lvmen\src\licensedcode\data\rules\lgpl-2.0_100.yml", "YAML", 0, 0, 0, 5, 0, 0, 1, 6
"d:\IDEWORK\lvmen\src\licensedcode\data\rules\lgpl-2.0_101.yml", "YAML", 0, 0, 0, 3, 0, 0, 1, 4
"d:\IDEWORK\lvmen\src\licensedcode\data\rules\lgpl-2.0_102.yml", "YAML", 0, 0, 0, 3, 0, 0, 1, 4
"d:\IDEWORK\lvmen\src\licensedcode\data\rules\lgpl-2.0_103.yml", "YAML", 0, 0, 0, 4, 0, 0, 1, 5
"d:\IDEWORK\lvmen\src\licensedcode\data\rules\lgpl-2.0_104.yml", "YAML", 0, 0, 0, 4, 0, 0, 1, 5
"d:\IDEWORK\lvmen\src\licensedcode\data\rules\lgpl-2.0_105.yml", "YAML", 0, 0, 0, 4, 0, 0, 1, 5
"d:\IDEWORK\lvmen\src\licensedcode\data\rules\lgpl-2.0_106.yml", "YAML", 0, 0, 0, 4, 0, 0, 1, 5
"d:\IDEWORK\lvmen\src\licensedcode\data\rules\lgpl-2.0_107.yml", "YAML", 0, 0, 0, 5, 0, 0, 1, 6
"d:\IDEWORK\lvmen\src\licensedcode\data\rules\lgpl-2.0_108.yml", "YAML", 0, 0, 0, 3, 0, 0, 1, 4
"d:\IDEWORK\lvmen\src\licensedcode\data\rules\lgpl-2.0_109.yml", "YAML", 0, 0, 0, 9, 0, 0, 1, 10
"d:\IDEWORK\lvmen\src\licensedcode\data\rules\lgpl-2.0_11.yml", "YAML", 0, 0, 0, 3, 0, 0, 1, 4
"d:\IDEWORK\lvmen\src\licensedcode\data\rules\lgpl-2.0_110.yml", "YAML", 0, 0, 0, 5, 0, 0, 1, 6
"d:\IDEWORK\lvmen\src\licensedcode\data\rules\lgpl-2.0_111.yml", "YAML", 0, 0, 0, 4, 0, 0, 1, 5
"d:\IDEWORK\lvmen\src\licensedcode\data\rules\lgpl-2.0_112.yml", "YAML", 0, 0, 0, 3, 0, 0, 1, 4
"d:\IDEWORK\lvmen\src\licensedcode\data\rules\lgpl-2.0_113.yml", "YAML", 0, 0, 0, 3, 0, 0, 1, 4
"d:\IDEWORK\lvmen\src\licensedcode\data\rules\lgpl-2.0_114.yml", "YAML", 0, 0, 0, 3, 0, 0, 1, 4
"d:\IDEWORK\lvmen\src\licensedcode\data\rules\lgpl-2.0_115.yml", "YAML", 0, 0, 0, 3, 0, 0, 1, 4
"d:\IDEWORK\lvmen\src\licensedcode\data\rules\lgpl-2.0_116.yml", "YAML", 0, 0, 0, 3, 0, 0, 1, 4
"d:\IDEWORK\lvmen\src\licensedcode\data\rules\lgpl-2.0_117.yml", "YAML", 0, 0, 0, 3, 0, 0, 1, 4
"d:\IDEWORK\lvmen\src\licensedcode\data\rules\lgpl-2.0_118.yml", "YAML", 0, 0, 0, 3, 0, 0, 1, 4
"d:\IDEWORK\lvmen\src\licensedcode\data\rules\lgpl-2.0_119.yml", "YAML", 0, 0, 0, 3, 0, 0, 1, 4
"d:\IDEWORK\lvmen\src\licensedcode\data\rules\lgpl-2.0_12.yml", "YAML", 0, 0, 0, 3, 0, 0, 1, 4
"d:\IDEWORK\lvmen\src\licensedcode\data\rules\lgpl-2.0_120.yml", "YAML", 0, 0, 0, 3, 0, 0, 1, 4
"d:\IDEWORK\lvmen\src\licensedcode\data\rules\lgpl-2.0_121.yml", "YAML", 0, 0, 0, 3, 0, 0, 1, 4
"d:\IDEWORK\lvmen\src\licensedcode\data\rules\lgpl-2.0_122.yml", "YAML", 0, 0, 0, 5, 0, 0, 1, 6
"d:\IDEWORK\lvmen\src\licensedcode\data\rules\lgpl-2.0_123.yml", "YAML", 0, 0, 0, 5, 0, 0, 1, 6
"d:\IDEWORK\lvmen\src\licensedcode\data\rules\lgpl-2.0_124.yml", "YAML", 0, 0, 0, 3, 0, 0, 1, 4
"d:\IDEWORK\lvmen\src\licensedcode\data\rules\lgpl-2.0_125.yml", "YAML", 0, 0, 0, 3, 0, 0, 1, 4
"d:\IDEWORK\lvmen\src\licensedcode\data\rules\lgpl-2.0_126.yml", "YAML", 0, 0, 0, 3, 0, 0, 1, 4
"d:\IDEWORK\lvmen\src\licensedcode\data\rules\lgpl-2.0_127.yml", "YAML", 0, 0, 0, 3, 0, 0, 1, 4
"d:\IDEWORK\lvmen\src\licensedcode\data\rules\lgpl-2.0_128.yml", "YAML", 0, 0, 0, 3, 0, 0, 1, 4
"d:\IDEWORK\lvmen\src\licensedcode\data\rules\lgpl-2.0_129.yml", "YAML", 0, 0, 0, 3, 0, 0, 1, 4
"d:\IDEWORK\lvmen\src\licensedcode\data\rules\lgpl-2.0_13.yml", "YAML", 0, 0, 0, 8, 0, 0, 1, 9
"d:\IDEWORK\lvmen\src\licensedcode\data\rules\lgpl-2.0_130.yml", "YAML", 0, 0, 0, 3, 0, 0, 1, 4
"d:\IDEWORK\lvmen\src\licensedcode\data\rules\lgpl-2.0_131.yml", "YAML", 0, 0, 0, 3, 0, 0, 1, 4
"d:\IDEWORK\lvmen\src\licensedcode\data\rules\lgpl-2.0_132.yml", "YAML", 0, 0, 0, 3, 0, 0, 1, 4
"d:\IDEWORK\lvmen\src\licensedcode\data\rules\lgpl-2.0_133.yml", "YAML", 0, 0, 0, 3, 0, 0, 1, 4
"d:\IDEWORK\lvmen\src\licensedcode\data\rules\lgpl-2.0_134.yml", "YAML", 0, 0, 0, 3, 0, 0, 1, 4
"d:\IDEWORK\lvmen\src\licensedcode\data\rules\lgpl-2.0_135.yml", "YAML", 0, 0, 0, 3, 0, 0, 1, 4
"d:\IDEWORK\lvmen\src\licensedcode\data\rules\lgpl-2.0_136.yml", "YAML", 0, 0, 0, 3, 0, 0, 1, 4
"d:\IDEWORK\lvmen\src\licensedcode\data\rules\lgpl-2.0_137.yml", "YAML", 0, 0, 0, 3, 0, 0, 1, 4
"d:\IDEWORK\lvmen\src\licensedcode\data\rules\lgpl-2.0_138.yml", "YAML", 0, 0, 0, 3, 0, 0, 1, 4
"d:\IDEWORK\lvmen\src\licensedcode\data\rules\lgpl-2.0_139.yml", "YAML", 0, 0, 0, 3, 0, 0, 1, 4
"d:\IDEWORK\lvmen\src\licensedcode\data\rules\lgpl-2.0_14.yml", "YAML", 0, 0, 0, 3, 0, 0, 1, 4
"d:\IDEWORK\lvmen\src\licensedcode\data\rules\lgpl-2.0_140.yml", "YAML", 0, 0, 0, 3, 0, 0, 1, 4
"d:\IDEWORK\lvmen\src\licensedcode\data\rules\lgpl-2.0_141.yml", "YAML", 0, 0, 0, 3, 0, 0, 1, 4
"d:\IDEWORK\lvmen\src\licensedcode\data\rules\lgpl-2.0_142.yml", "YAML", 0, 0, 0, 3, 0, 0, 1, 4
"d:\IDEWORK\lvmen\src\licensedcode\data\rules\lgpl-2.0_143.yml", "YAML", 0, 0, 0, 3, 0, 0, 1, 4
"d:\IDEWORK\lvmen\src\licensedcode\data\rules\lgpl-2.0_144.yml", "YAML", 0, 0, 0, 3, 0, 0, 1, 4
"d:\IDEWORK\lvmen\src\licensedcode\data\rules\lgpl-2.0_145.yml", "YAML", 0, 0, 0, 3, 0, 0, 1, 4
"d:\IDEWORK\lvmen\src\licensedcode\data\rules\lgpl-2.0_146.yml", "YAML", 0, 0, 0, 3, 0, 0, 1, 4
"d:\IDEWORK\lvmen\src\licensedcode\data\rules\lgpl-2.0_147.yml", "YAML", 0, 0, 0, 5, 0, 0, 1, 6
"d:\IDEWORK\lvmen\src\licensedcode\data\rules\lgpl-2.0_148.yml", "YAML", 0, 0, 0, 3, 0, 0, 1, 4
"d:\IDEWORK\lvmen\src\licensedcode\data\rules\lgpl-2.0_149.yml", "YAML", 0, 0, 0, 3, 0, 0, 1, 4
"d:\IDEWORK\lvmen\src\licensedcode\data\rules\lgpl-2.0_15.yml", "YAML", 0, 0, 0, 8, 0, 0, 1, 9
"d:\IDEWORK\lvmen\src\licensedcode\data\rules\lgpl-2.0_150.yml", "YAML", 0, 0, 0, 3, 0, 0, 1, 4
"d:\IDEWORK\lvmen\src\licensedcode\data\rules\lgpl-2.0_151.yml", "YAML", 0, 0, 0, 3, 0, 0, 1, 4
"d:\IDEWORK\lvmen\src\licensedcode\data\rules\lgpl-2.0_152.yml", "YAML", 0, 0, 0, 3, 0, 0, 1, 4
"d:\IDEWORK\lvmen\src\licensedcode\data\rules\lgpl-2.0_153.yml", "YAML", 0, 0, 0, 3, 0, 0, 1, 4
"d:\IDEWORK\lvmen\src\licensedcode\data\rules\lgpl-2.0_154.yml", "YAML", 0, 0, 0, 3, 0, 0, 1, 4
"d:\IDEWORK\lvmen\src\licensedcode\data\rules\lgpl-2.0_155.yml", "YAML", 0, 0, 0, 5, 0, 0, 1, 6
"d:\IDEWORK\lvmen\src\licensedcode\data\rules\lgpl-2.0_156.yml", "YAML", 0, 0, 0, 5, 0, 0, 1, 6
"d:\IDEWORK\lvmen\src\licensedcode\data\rules\lgpl-2.0_157.yml", "YAML", 0, 0, 0, 6, 0, 0, 1, 7
"d:\IDEWORK\lvmen\src\licensedcode\data\rules\lgpl-2.0_158.yml", "YAML", 0, 0, 0, 3, 0, 0, 1, 4
"d:\IDEWORK\lvmen\src\licensedcode\data\rules\lgpl-2.0_159.yml", "YAML", 0, 0, 0, 3, 0, 0, 1, 4
"d:\IDEWORK\lvmen\src\licensedcode\data\rules\lgpl-2.0_16.yml", "YAML", 0, 0, 0, 2, 0, 0, 1, 3
"d:\IDEWORK\lvmen\src\licensedcode\data\rules\lgpl-2.0_160.yml", "YAML", 0, 0, 0, 3, 0, 0, 1, 4
"d:\IDEWORK\lvmen\src\licensedcode\data\rules\lgpl-2.0_161.yml", "YAML", 0, 0, 0, 3, 0, 0, 1, 4
"d:\IDEWORK\lvmen\src\licensedcode\data\rules\lgpl-2.0_162.yml", "YAML", 0, 0, 0, 3, 0, 0, 1, 4
"d:\IDEWORK\lvmen\src\licensedcode\data\rules\lgpl-2.0_163.yml", "YAML", 0, 0, 0, 3, 0, 0, 1, 4
"d:\IDEWORK\lvmen\src\licensedcode\data\rules\lgpl-2.0_164.yml", "YAML", 0, 0, 0, 4, 0, 0, 1, 5
"d:\IDEWORK\lvmen\src\licensedcode\data\rules\lgpl-2.0_165.yml", "YAML", 0, 0, 0, 4, 0, 0, 1, 5
"d:\IDEWORK\lvmen\src\licensedcode\data\rules\lgpl-2.0_166.yml", "YAML", 0, 0, 0, 4, 0, 0, 1, 5
"d:\IDEWORK\lvmen\src\licensedcode\data\rules\lgpl-2.0_167.yml", "YAML", 0, 0, 0, 5, 0, 0, 1, 6
"d:\IDEWORK\lvmen\src\licensedcode\data\rules\lgpl-2.0_168.yml", "YAML", 0, 0, 0, 3, 0, 0, 1, 4
"d:\IDEWORK\lvmen\src\licensedcode\data\rules\lgpl-2.0_169.yml", "YAML", 0, 0, 0, 5, 0, 0, 1, 6
"d:\IDEWORK\lvmen\src\licensedcode\data\rules\lgpl-2.0_17.yml", "YAML", 0, 0, 0, 3, 0, 0, 1, 4
"d:\IDEWORK\lvmen\src\licensedcode\data\rules\lgpl-2.0_170.yml", "YAML", 0, 0, 0, 5, 0, 0, 1, 6
"d:\IDEWORK\lvmen\src\licensedcode\data\rules\lgpl-2.0_171.yml", "YAML", 0, 0, 0, 5, 0, 0, 1, 6
"d:\IDEWORK\lvmen\src\licensedcode\data\rules\lgpl-2.0_172.yml", "YAML", 0, 0, 0, 5, 0, 0, 1, 6
"d:\IDEWORK\lvmen\src\licensedcode\data\rules\lgpl-2.0_173.yml", "YAML", 0, 0, 0, 5, 0, 0, 1, 6
"d:\IDEWORK\lvmen\src\licensedcode\data\rules\lgpl-2.0_174.yml", "YAML", 0, 0, 0, 5, 0, 0, 1, 6
"d:\IDEWORK\lvmen\src\licensedcode\data\rules\lgpl-2.0_175.yml", "YAML", 0, 0, 0, 5, 0, 0, 1, 6
"d:\IDEWORK\lvmen\src\licensedcode\data\rules\lgpl-2.0_176.yml", "YAML", 0, 0, 0, 6, 0, 0, 1, 7
"d:\IDEWORK\lvmen\src\licensedcode\data\rules\lgpl-2.0_177.yml", "YAML", 0, 0, 0, 5, 0, 0, 1, 6
"d:\IDEWORK\lvmen\src\licensedcode\data\rules\lgpl-2.0_178.yml", "YAML", 0, 0, 0, 5, 0, 0, 1, 6
"d:\IDEWORK\lvmen\src\licensedcode\data\rules\lgpl-2.0_179.yml", "YAML", 0, 0, 0, 5, 0, 0, 1, 6
"d:\IDEWORK\lvmen\src\licensedcode\data\rules\lgpl-2.0_18.yml", "YAML", 0, 0, 0, 8, 0, 0, 1, 9
"d:\IDEWORK\lvmen\src\licensedcode\data\rules\lgpl-2.0_180.yml", "YAML", 0, 0, 0, 5, 0, 0, 1, 6
"d:\IDEWORK\lvmen\src\licensedcode\data\rules\lgpl-2.0_181.yml", "YAML", 0, 0, 0, 3, 0, 0, 1, 4
"d:\IDEWORK\lvmen\src\licensedcode\data\rules\lgpl-2.0_182.yml", "YAML", 0, 0, 0, 5, 0, 0, 1, 6
"d:\IDEWORK\lvmen\src\licensedcode\data\rules\lgpl-2.0_183.yml", "YAML", 0, 0, 0, 6, 0, 0, 1, 7
"d:\IDEWORK\lvmen\src\licensedcode\data\rules\lgpl-2.0_184.yml", "YAML", 0, 0, 0, 5, 0, 0, 1, 6
"d:\IDEWORK\lvmen\src\licensedcode\data\rules\lgpl-2.0_185.yml", "YAML", 0, 0, 0, 5, 0, 0, 1, 6
"d:\IDEWORK\lvmen\src\licensedcode\data\rules\lgpl-2.0_186.yml", "YAML", 0, 0, 0, 4, 0, 0, 1, 5
"d:\IDEWORK\lvmen\src\licensedcode\data\rules\lgpl-2.0_187.yml", "YAML", 0, 0, 0, 6, 0, 0, 1, 7
"d:\IDEWORK\lvmen\src\licensedcode\data\rules\lgpl-2.0_188.yml", "YAML", 0, 0, 0, 4, 0, 0, 1, 5
"d:\IDEWORK\lvmen\src\licensedcode\data\rules\lgpl-2.0_189.yml", "YAML", 0, 0, 0, 4, 0, 0, 1, 5
"d:\IDEWORK\lvmen\src\licensedcode\data\rules\lgpl-2.0_19.yml", "YAML", 0, 0, 0, 2, 0, 0, 1, 3
"d:\IDEWORK\lvmen\src\licensedcode\data\rules\lgpl-2.0_190.yml", "YAML", 0, 0, 0, 4, 0, 0, 1, 5
"d:\IDEWORK\lvmen\src\licensedcode\data\rules\lgpl-2.0_191.yml", "YAML", 0, 0, 0, 4, 0, 0, 1, 5
"d:\IDEWORK\lvmen\src\licensedcode\data\rules\lgpl-2.0_2.yml", "YAML", 0, 0, 0, 5, 0, 0, 1, 6
"d:\IDEWORK\lvmen\src\licensedcode\data\rules\lgpl-2.0_20.yml", "YAML", 0, 0, 0, 5, 0, 0, 1, 6
"d:\IDEWORK\lvmen\src\licensedcode\data\rules\lgpl-2.0_21.yml", "YAML", 0, 0, 0, 2, 0, 0, 1, 3
"d:\IDEWORK\lvmen\src\licensedcode\data\rules\lgpl-2.0_22.yml", "YAML", 0, 0, 0, 3, 0, 0, 1, 4
"d:\IDEWORK\lvmen\src\licensedcode\data\rules\lgpl-2.0_23.yml", "YAML", 0, 0, 0, 5, 0, 0, 1, 6
"d:\IDEWORK\lvmen\src\licensedcode\data\rules\lgpl-2.0_24.yml", "YAML", 0, 0, 0, 2, 0, 0, 1, 3
"d:\IDEWORK\lvmen\src\licensedcode\data\rules\lgpl-2.0_25.yml", "YAML", 0, 0, 0, 3, 0, 0, 1, 4
"d:\IDEWORK\lvmen\src\licensedcode\data\rules\lgpl-2.0_26.yml", "YAML", 0, 0, 0, 3, 0, 0, 1, 4
"d:\IDEWORK\lvmen\src\licensedcode\data\rules\lgpl-2.0_27.yml", "YAML", 0, 0, 0, 3, 0, 0, 1, 4
"d:\IDEWORK\lvmen\src\licensedcode\data\rules\lgpl-2.0_28.yml", "YAML", 0, 0, 0, 8, 0, 0, 1, 9
"d:\IDEWORK\lvmen\src\licensedcode\data\rules\lgpl-2.0_29.yml", "YAML", 0, 0, 0, 2, 0, 0, 1, 3
"d:\IDEWORK\lvmen\src\licensedcode\data\rules\lgpl-2.0_3.yml", "YAML", 0, 0, 0, 5, 0, 0, 1, 6
"d:\IDEWORK\lvmen\src\licensedcode\data\rules\lgpl-2.0_30.yml", "YAML", 0, 0, 0, 2, 0, 0, 1, 3
"d:\IDEWORK\lvmen\src\licensedcode\data\rules\lgpl-2.0_31.yml", "YAML", 0, 0, 0, 3, 0, 0, 1, 4
"d:\IDEWORK\lvmen\src\licensedcode\data\rules\lgpl-2.0_32.yml", "YAML", 0, 0, 0, 2, 0, 0, 1, 3
"d:\IDEWORK\lvmen\src\licensedcode\data\rules\lgpl-2.0_33.yml", "YAML", 0, 0, 0, 3, 0, 0, 1, 4
"d:\IDEWORK\lvmen\src\licensedcode\data\rules\lgpl-2.0_34.yml", "YAML", 0, 0, 0, 3, 0, 0, 1, 4
"d:\IDEWORK\lvmen\src\licensedcode\data\rules\lgpl-2.0_35.yml", "YAML", 0, 0, 0, 3, 0, 0, 1, 4
"d:\IDEWORK\lvmen\src\licensedcode\data\rules\lgpl-2.0_36.yml", "YAML", 0, 0, 0, 3, 0, 0, 1, 4
"d:\IDEWORK\lvmen\src\licensedcode\data\rules\lgpl-2.0_37.yml", "YAML", 0, 0, 0, 3, 0, 0, 1, 4
"d:\IDEWORK\lvmen\src\licensedcode\data\rules\lgpl-2.0_38.yml", "YAML", 0, 0, 0, 3, 0, 0, 1, 4
"d:\IDEWORK\lvmen\src\licensedcode\data\rules\lgpl-2.0_39.yml", "YAML", 0, 0, 0, 3, 0, 0, 1, 4
"d:\IDEWORK\lvmen\src\licensedcode\data\rules\lgpl-2.0_4.yml", "YAML", 0, 0, 0, 9, 0, 0, 1, 10
"d:\IDEWORK\lvmen\src\licensedcode\data\rules\lgpl-2.0_40.yml", "YAML", 0, 0, 0, 3, 0, 0, 1, 4
"d:\IDEWORK\lvmen\src\licensedcode\data\rules\lgpl-2.0_41.yml", "YAML", 0, 0, 0, 3, 0, 0, 1, 4
"d:\IDEWORK\lvmen\src\licensedcode\data\rules\lgpl-2.0_42.yml", "YAML", 0, 0, 0, 3, 0, 0, 1, 4
"d:\IDEWORK\lvmen\src\licensedcode\data\rules\lgpl-2.0_43.yml", "YAML", 0, 0, 0, 3, 0, 0, 1, 4
"d:\IDEWORK\lvmen\src\licensedcode\data\rules\lgpl-2.0_44.yml", "YAML", 0, 0, 0, 3, 0, 0, 1, 4
"d:\IDEWORK\lvmen\src\licensedcode\data\rules\lgpl-2.0_45.yml", "YAML", 0, 0, 0, 3, 0, 0, 1, 4
"d:\IDEWORK\lvmen\src\licensedcode\data\rules\lgpl-2.0_46.yml", "YAML", 0, 0, 0, 3, 0, 0, 1, 4
"d:\IDEWORK\lvmen\src\licensedcode\data\rules\lgpl-2.0_47.yml", "YAML", 0, 0, 0, 3, 0, 0, 1, 4
"d:\IDEWORK\lvmen\src\licensedcode\data\rules\lgpl-2.0_48.yml", "YAML", 0, 0, 0, 3, 0, 0, 1, 4
"d:\IDEWORK\lvmen\src\licensedcode\data\rules\lgpl-2.0_49.yml", "YAML", 0, 0, 0, 3, 0, 0, 1, 4
"d:\IDEWORK\lvmen\src\licensedcode\data\rules\lgpl-2.0_5.yml", "YAML", 0, 0, 0, 4, 0, 0, 1, 5
"d:\IDEWORK\lvmen\src\licensedcode\data\rules\lgpl-2.0_50.yml", "YAML", 0, 0, 0, 3, 0, 0, 1, 4
"d:\IDEWORK\lvmen\src\licensedcode\data\rules\lgpl-2.0_51.yml", "YAML", 0, 0, 0, 3, 0, 0, 1, 4
"d:\IDEWORK\lvmen\src\licensedcode\data\rules\lgpl-2.0_52.yml", "YAML", 0, 0, 0, 3, 0, 0, 1, 4
"d:\IDEWORK\lvmen\src\licensedcode\data\rules\lgpl-2.0_53.yml", "YAML", 0, 0, 0, 3, 0, 0, 1, 4
"d:\IDEWORK\lvmen\src\licensedcode\data\rules\lgpl-2.0_54.yml", "YAML", 0, 0, 0, 3, 0, 0, 1, 4
"d:\IDEWORK\lvmen\src\licensedcode\data\rules\lgpl-2.0_55.yml", "YAML", 0, 0, 0, 3, 0, 0, 1, 4
"d:\IDEWORK\lvmen\src\licensedcode\data\rules\lgpl-2.0_56.yml", "YAML", 0, 0, 0, 3, 0, 0, 1, 4
"d:\IDEWORK\lvmen\src\licensedcode\data\rules\lgpl-2.0_57.yml", "YAML", 0, 0, 0, 3, 0, 0, 1, 4
"d:\IDEWORK\lvmen\src\licensedcode\data\rules\lgpl-2.0_58.yml", "YAML", 0, 0, 0, 3, 0, 0, 1, 4
"d:\IDEWORK\lvmen\src\licensedcode\data\rules\lgpl-2.0_59.yml", "YAML", 0, 0, 0, 3, 0, 0, 1, 4
"d:\IDEWORK\lvmen\src\licensedcode\data\rules\lgpl-2.0_6.yml", "YAML", 0, 0, 0, 5, 0, 0, 1, 6
"d:\IDEWORK\lvmen\src\licensedcode\data\rules\lgpl-2.0_60.yml", "YAML", 0, 0, 0, 3, 0, 0, 1, 4
"d:\IDEWORK\lvmen\src\licensedcode\data\rules\lgpl-2.0_61.yml", "YAML", 0, 0, 0, 3, 0, 0, 1, 4
"d:\IDEWORK\lvmen\src\licensedcode\data\rules\lgpl-2.0_62.yml", "YAML", 0, 0, 0, 5, 0, 0, 1, 6
"d:\IDEWORK\lvmen\src\licensedcode\data\rules\lgpl-2.0_63.yml", "YAML", 0, 0, 0, 5, 0, 0, 1, 6
"d:\IDEWORK\lvmen\src\licensedcode\data\rules\lgpl-2.0_64.yml", "YAML", 0, 0, 0, 5, 0, 0, 1, 6
"d:\IDEWORK\lvmen\src\licensedcode\data\rules\lgpl-2.0_65.yml", "YAML", 0, 0, 0, 5, 0, 0, 1, 6
"d:\IDEWORK\lvmen\src\licensedcode\data\rules\lgpl-2.0_66.yml", "YAML", 0, 0, 0, 3, 0, 0, 1, 4
"d:\IDEWORK\lvmen\src\licensedcode\data\rules\lgpl-2.0_67.yml", "YAML", 0, 0, 0, 3, 0, 0, 1, 4
"d:\IDEWORK\lvmen\src\licensedcode\data\rules\lgpl-2.0_68.yml", "YAML", 0, 0, 0, 3, 0, 0, 1, 4
"d:\IDEWORK\lvmen\src\licensedcode\data\rules\lgpl-2.0_69.yml", "YAML", 0, 0, 0, 3, 0, 0, 1, 4
"d:\IDEWORK\lvmen\src\licensedcode\data\rules\lgpl-2.0_7.yml", "YAML", 0, 0, 0, 5, 0, 0, 1, 6
"d:\IDEWORK\lvmen\src\licensedcode\data\rules\lgpl-2.0_70.yml", "YAML", 0, 0, 0, 3, 0, 0, 1, 4
"d:\IDEWORK\lvmen\src\licensedcode\data\rules\lgpl-2.0_71.yml", "YAML", 0, 0, 0, 3, 0, 0, 1, 4
"d:\IDEWORK\lvmen\src\licensedcode\data\rules\lgpl-2.0_72.yml", "YAML", 0, 0, 0, 3, 0, 0, 1, 4
"d:\IDEWORK\lvmen\src\licensedcode\data\rules\lgpl-2.0_73.yml", "YAML", 0, 0, 0, 3, 0, 0, 1, 4
"d:\IDEWORK\lvmen\src\licensedcode\data\rules\lgpl-2.0_74.yml", "YAML", 0, 0, 0, 3, 0, 0, 1, 4
"d:\IDEWORK\lvmen\src\licensedcode\data\rules\lgpl-2.0_75.yml", "YAML", 0, 0, 0, 3, 0, 0, 1, 4
"d:\IDEWORK\lvmen\src\licensedcode\data\rules\lgpl-2.0_76.yml", "YAML", 0, 0, 0, 3, 0, 0, 1, 4
"d:\IDEWORK\lvmen\src\licensedcode\data\rules\lgpl-2.0_77.yml", "YAML", 0, 0, 0, 3, 0, 0, 1, 4
"d:\IDEWORK\lvmen\src\licensedcode\data\rules\lgpl-2.0_78.yml", "YAML", 0, 0, 0, 3, 0, 0, 1, 4
"d:\IDEWORK\lvmen\src\licensedcode\data\rules\lgpl-2.0_79.yml", "YAML", 0, 0, 0, 3, 0, 0, 1, 4
"d:\IDEWORK\lvmen\src\licensedcode\data\rules\lgpl-2.0_8.yml", "YAML", 0, 0, 0, 5, 0, 0, 1, 6
"d:\IDEWORK\lvmen\src\licensedcode\data\rules\lgpl-2.0_80.yml", "YAML", 0, 0, 0, 5, 0, 0, 1, 6
"d:\IDEWORK\lvmen\src\licensedcode\data\rules\lgpl-2.0_81.yml", "YAML", 0, 0, 0, 5, 0, 0, 1, 6
"d:\IDEWORK\lvmen\src\licensedcode\data\rules\lgpl-2.0_82.yml", "YAML", 0, 0, 0, 5, 0, 0, 1, 6
"d:\IDEWORK\lvmen\src\licensedcode\data\rules\lgpl-2.0_83.yml", "YAML", 0, 0, 0, 5, 0, 0, 1, 6
"d:\IDEWORK\lvmen\src\licensedcode\data\rules\lgpl-2.0_84.yml", "YAML", 0, 0, 0, 5, 0, 0, 1, 6
"d:\IDEWORK\lvmen\src\licensedcode\data\rules\lgpl-2.0_85.yml", "YAML", 0, 0, 0, 5, 0, 0, 1, 6
"d:\IDEWORK\lvmen\src\licensedcode\data\rules\lgpl-2.0_86.yml", "YAML", 0, 0, 0, 5, 0, 0, 1, 6
"d:\IDEWORK\lvmen\src\licensedcode\data\rules\lgpl-2.0_87.yml", "YAML", 0, 0, 0, 5, 0, 0, 1, 6
"d:\IDEWORK\lvmen\src\licensedcode\data\rules\lgpl-2.0_88.yml", "YAML", 0, 0, 0, 5, 0, 0, 1, 6
"d:\IDEWORK\lvmen\src\licensedcode\data\rules\lgpl-2.0_89.yml", "YAML", 0, 0, 0, 5, 0, 0, 1, 6
"d:\IDEWORK\lvmen\src\licensedcode\data\rules\lgpl-2.0_9.yml", "YAML", 0, 0, 0, 6, 0, 0, 1, 7
"d:\IDEWORK\lvmen\src\licensedcode\data\rules\lgpl-2.0_90.yml", "YAML", 0, 0, 0, 5, 0, 0, 1, 6
"d:\IDEWORK\lvmen\src\licensedcode\data\rules\lgpl-2.0_91.yml", "YAML", 0, 0, 0, 5, 0, 0, 1, 6
"d:\IDEWORK\lvmen\src\licensedcode\data\rules\lgpl-2.0_92.yml", "YAML", 0, 0, 0, 5, 0, 0, 1, 6
"d:\IDEWORK\lvmen\src\licensedcode\data\rules\lgpl-2.0_93.yml", "YAML", 0, 0, 0, 5, 0, 0, 1, 6
"d:\IDEWORK\lvmen\src\licensedcode\data\rules\lgpl-2.0_94.yml", "YAML", 0, 0, 0, 3, 0, 0, 1, 4
"d:\IDEWORK\lvmen\src\licensedcode\data\rules\lgpl-2.0_95.yml", "YAML", 0, 0, 0, 3, 0, 0, 1, 4
"d:\IDEWORK\lvmen\src\licensedcode\data\rules\lgpl-2.0_96.yml", "YAML", 0, 0, 0, 5, 0, 0, 1, 6
"d:\IDEWORK\lvmen\src\licensedcode\data\rules\lgpl-2.0_97.yml", "YAML", 0, 0, 0, 5, 0, 0, 1, 6
"d:\IDEWORK\lvmen\src\licensedcode\data\rules\lgpl-2.0_98.yml", "YAML", 0, 0, 0, 3, 0, 0, 1, 4
"d:\IDEWORK\lvmen\src\licensedcode\data\rules\lgpl-2.0_99.yml", "YAML", 0, 0, 0, 5, 0, 0, 1, 6
"d:\IDEWORK\lvmen\src\licensedcode\data\rules\lgpl-2.0_and_bsd-new_1.yml", "YAML", 0, 0, 0, 3, 0, 0, 1, 4
"d:\IDEWORK\lvmen\src\licensedcode\data\rules\lgpl-2.0_and_gpl-2.0.yml", "YAML", 0, 0, 0, 2, 0, 0, 1, 3
"d:\IDEWORK\lvmen\src\licensedcode\data\rules\lgpl-2.0_and_gpl-3.0_1.yml", "YAML", 0, 0, 0, 4, 0, 0, 2, 6
"d:\IDEWORK\lvmen\src\licensedcode\data\rules\lgpl-2.0_and_lgpl-2.1_1.yml", "YAML", 0, 0, 0, 7, 0, 0, 1, 8
"d:\IDEWORK\lvmen\src\licensedcode\data\rules\lgpl-2.0_and_lgpl-2.1_2.yml", "YAML", 0, 0, 0, 7, 0, 0, 1, 8
"d:\IDEWORK\lvmen\src\licensedcode\data\rules\lgpl-2.0_and_lgpl-2.1_3.yml", "YAML", 0, 0, 0, 8, 0, 0, 1, 9
"d:\IDEWORK\lvmen\src\licensedcode\data\rules\lgpl-2.0_and_lgpl-2.1_4.yml", "YAML", 0, 0, 0, 8, 0, 0, 1, 9
"d:\IDEWORK\lvmen\src\licensedcode\data\rules\lgpl-2.0_and_lgpl-2.1_5.yml", "YAML", 0, 0, 0, 8, 0, 0, 1, 9
"d:\IDEWORK\lvmen\src\licensedcode\data\rules\lgpl-2.0_and_lgpl-2.1_6.yml", "YAML", 0, 0, 0, 8, 0, 0, 1, 9
"d:\IDEWORK\lvmen\src\licensedcode\data\rules\lgpl-2.0_and_lgpl-3.0_1.yml", "YAML", 0, 0, 0, 3, 0, 0, 1, 4
"d:\IDEWORK\lvmen\src\licensedcode\data\rules\lgpl-2.0_and_mit_1.yml", "YAML", 0, 0, 0, 3, 0, 0, 1, 4
"d:\IDEWORK\lvmen\src\licensedcode\data\rules\lgpl-2.0_and_proprietary.yml", "YAML", 0, 0, 0, 7, 0, 0, 1, 8
"d:\IDEWORK\lvmen\src\licensedcode\data\rules\lgpl-2.0_and_unknown-license-reference_1.yml", "YAML", 0, 0, 0, 4, 0, 0, 1, 5
"d:\IDEWORK\lvmen\src\licensedcode\data\rules\lgpl-2.0_bare_id.yml", "YAML", 0, 0, 0, 3, 0, 0, 1, 4
"d:\IDEWORK\lvmen\src\licensedcode\data\rules\lgpl-2.0_debian.yml", "YAML", 0, 0, 0, 3, 0, 0, 1, 4
"d:\IDEWORK\lvmen\src\licensedcode\data\rules\lgpl-2.0_debian_1.yml", "YAML", 0, 0, 0, 2, 0, 0, 1, 3
"d:\IDEWORK\lvmen\src\licensedcode\data\rules\lgpl-2.0_not_gpl.yml", "YAML", 0, 0, 0, 5, 0, 0, 1, 6
"d:\IDEWORK\lvmen\src\licensedcode\data\rules\lgpl-2.0_or_apache-2.0_1.yml", "YAML", 0, 0, 0, 3, 0, 0, 1, 4
"d:\IDEWORK\lvmen\src\licensedcode\data\rules\lgpl-2.0_or_gpl-2.0_1.yml", "YAML", 0, 0, 0, 3, 0, 0, 1, 4
"d:\IDEWORK\lvmen\src\licensedcode\data\rules\lgpl-2.0_or_lgpl-3.0_or_kde-accepted-lgpl_1.yml", "YAML", 0, 0, 0, 5, 0, 0, 1, 6
"d:\IDEWORK\lvmen\src\licensedcode\data\rules\lgpl-2.0_or_lgpl-3.0_or_kde-accepted-lgpl_2.yml", "YAML", 0, 0, 0, 5, 0, 0, 1, 6
"d:\IDEWORK\lvmen\src\licensedcode\data\rules\lgpl-2.0_or_lgpl-3.0_or_kde-accepted-lgpl_3.yml", "YAML", 0, 0, 0, 5, 0, 0, 1, 6
"d:\IDEWORK\lvmen\src\licensedcode\data\rules\lgpl-2.0_or_mit_1.yml", "YAML", 0, 0, 0, 3, 0, 0, 1, 4
"d:\IDEWORK\lvmen\src\licensedcode\data\rules\lgpl-2.0_or_mulle-kybernetik.yml", "YAML", 0, 0, 0, 2, 0, 0, 1, 3
"d:\IDEWORK\lvmen\src\licensedcode\data\rules\lgpl-2.0_or_mulle-kybernetik2.yml", "YAML", 0, 0, 0, 2, 0, 0, 1, 3
"d:\IDEWORK\lvmen\src\licensedcode\data\rules\lgpl-2.0_or_mulle-kybernetik3.yml", "YAML", 0, 0, 0, 2, 0, 0, 1, 3
"d:\IDEWORK\lvmen\src\licensedcode\data\rules\lgpl-2.0_or_mulle-kybernetik4.yml", "YAML", 0, 0, 0, 2, 0, 0, 1, 3
"d:\IDEWORK\lvmen\src\licensedcode\data\rules\lgpl-2.0_other.yml", "YAML", 0, 0, 0, 5, 0, 0, 1, 6
"d:\IDEWORK\lvmen\src\licensedcode\data\rules\lgpl-2.0_readme.yml", "YAML", 0, 0, 0, 3, 0, 0, 1, 4
"d:\IDEWORK\lvmen\src\licensedcode\data\rules\lgpl-2.0_url_1.yml", "YAML", 0, 0, 0, 5, 0, 0, 1, 6
"d:\IDEWORK\lvmen\src\licensedcode\data\rules\lgpl-2.0_url_2.yml", "YAML", 0, 0, 0, 5, 0, 0, 1, 6
"d:\IDEWORK\lvmen\src\licensedcode\data\rules\lgpl-2.0_url_glc_133.yml", "YAML", 0, 0, 0, 5, 0, 0, 1, 6
"d:\IDEWORK\lvmen\src\licensedcode\data\rules\lgpl-2.0_with_gcc-linking-exception-2.0_1.yml", "YAML", 0, 0, 0, 4, 0, 0, 1, 5
"d:\IDEWORK\lvmen\src\licensedcode\data\rules\lgpl-2.0_with_ocaml-lgpl-linking-exception_1.yml", "YAML", 0, 0, 0, 3, 0, 0, 1, 4
"d:\IDEWORK\lvmen\src\licensedcode\data\rules\lgpl-2.0_with_ocaml-lgpl-linking-exception_2.yml", "YAML", 0, 0, 0, 3, 0, 0, 1, 4
"d:\IDEWORK\lvmen\src\licensedcode\data\rules\lgpl-2.0_with_ocaml-lgpl-linking-exception_3.yml", "YAML", 0, 0, 0, 3, 0, 0, 1, 4
"d:\IDEWORK\lvmen\src\licensedcode\data\rules\lgpl-2.0_with_ocaml-lgpl-linking-exception_4.yml", "YAML", 0, 0, 0, 3, 0, 0, 1, 4
"d:\IDEWORK\lvmen\src\licensedcode\data\rules\lgpl-2.0_with_qt-kde-linking-exception_1.yml", "YAML", 0, 0, 0, 3, 0, 0, 1, 4
"d:\IDEWORK\lvmen\src\licensedcode\data\rules\lgpl-2.1-digia-qt_exception.yml", "YAML", 0, 0, 0, 2, 0, 0, 1, 3
"d:\IDEWORK\lvmen\src\licensedcode\data\rules\lgpl-2.1-nokia-qt_and_others.yml", "YAML", 0, 0, 0, 10, 0, 0, 1, 11
"d:\IDEWORK\lvmen\src\licensedcode\data\rules\lgpl-2.1-nokia-qt_and_others_1.yml", "YAML", 0, 0, 0, 11, 0, 0, 1, 12
"d:\IDEWORK\lvmen\src\licensedcode\data\rules\lgpl-2.1-nokia-qt_and_others_2.yml", "YAML", 0, 0, 0, 9, 0, 0, 1, 10
"d:\IDEWORK\lvmen\src\licensedcode\data\rules\lgpl-2.1-plus-linking.yml", "YAML", 0, 0, 0, 5, 0, 0, 1, 6
"d:\IDEWORK\lvmen\src\licensedcode\data\rules\lgpl-2.1-plus.yml", "YAML", 0, 0, 0, 2, 0, 0, 1, 3
"d:\IDEWORK\lvmen\src\licensedcode\data\rules\lgpl-2.1-plus_1.yml", "YAML", 0, 0, 0, 5, 0, 0, 1, 6
"d:\IDEWORK\lvmen\src\licensedcode\data\rules\lgpl-2.1-plus_10.yml", "YAML", 0, 0, 0, 4, 0, 0, 1, 5
"d:\IDEWORK\lvmen\src\licensedcode\data\rules\lgpl-2.1-plus_100.yml", "YAML", 0, 0, 0, 6, 0, 0, 1, 7
"d:\IDEWORK\lvmen\src\licensedcode\data\rules\lgpl-2.1-plus_101.yml", "YAML", 0, 0, 0, 3, 0, 0, 1, 4
"d:\IDEWORK\lvmen\src\licensedcode\data\rules\lgpl-2.1-plus_102.yml", "YAML", 0, 0, 0, 3, 0, 0, 1, 4
"d:\IDEWORK\lvmen\src\licensedcode\data\rules\lgpl-2.1-plus_103.yml", "YAML", 0, 0, 0, 3, 0, 0, 1, 4
"d:\IDEWORK\lvmen\src\licensedcode\data\rules\lgpl-2.1-plus_104.yml", "YAML", 0, 0, 0, 4, 0, 0, 1, 5
"d:\IDEWORK\lvmen\src\licensedcode\data\rules\lgpl-2.1-plus_105.yml", "YAML", 0, 0, 0, 6, 0, 0, 1, 7
"d:\IDEWORK\lvmen\src\licensedcode\data\rules\lgpl-2.1-plus_106.yml", "YAML", 0, 0, 0, 2, 0, 0, 1, 3
"d:\IDEWORK\lvmen\src\licensedcode\data\rules\lgpl-2.1-plus_107.yml", "YAML", 0, 0, 0, 3, 0, 0, 1, 4
"d:\IDEWORK\lvmen\src\licensedcode\data\rules\lgpl-2.1-plus_108.yml", "YAML", 0, 0, 0, 3, 0, 0, 1, 4
"d:\IDEWORK\lvmen\src\licensedcode\data\rules\lgpl-2.1-plus_109.yml", "YAML", 0, 0, 0, 4, 0, 0, 1, 5
"d:\IDEWORK\lvmen\src\licensedcode\data\rules\lgpl-2.1-plus_11.yml", "YAML", 0, 0, 0, 3, 0, 0, 1, 4
"d:\IDEWORK\lvmen\src\licensedcode\data\rules\lgpl-2.1-plus_110.yml", "YAML", 0, 0, 0, 5, 0, 0, 1, 6
"d:\IDEWORK\lvmen\src\licensedcode\data\rules\lgpl-2.1-plus_111.yml", "YAML", 0, 0, 0, 5, 0, 0, 1, 6
"d:\IDEWORK\lvmen\src\licensedcode\data\rules\lgpl-2.1-plus_112.yml", "YAML", 0, 0, 0, 5, 0, 0, 1, 6
"d:\IDEWORK\lvmen\src\licensedcode\data\rules\lgpl-2.1-plus_113.yml", "YAML", 0, 0, 0, 2, 0, 0, 1, 3
"d:\IDEWORK\lvmen\src\licensedcode\data\rules\lgpl-2.1-plus_114.yml", "YAML", 0, 0, 0, 5, 0, 0, 1, 6
"d:\IDEWORK\lvmen\src\licensedcode\data\rules\lgpl-2.1-plus_115.yml", "YAML", 0, 0, 0, 3, 0, 0, 1, 4
"d:\IDEWORK\lvmen\src\licensedcode\data\rules\lgpl-2.1-plus_116.yml", "YAML", 0, 0, 0, 3, 0, 0, 1, 4
"d:\IDEWORK\lvmen\src\licensedcode\data\rules\lgpl-2.1-plus_117.yml", "YAML", 0, 0, 0, 3, 0, 0, 1, 4
"d:\IDEWORK\lvmen\src\licensedcode\data\rules\lgpl-2.1-plus_118.yml", "YAML", 0, 0, 0, 3, 0, 0, 1, 4
"d:\IDEWORK\lvmen\src\licensedcode\data\rules\lgpl-2.1-plus_119.yml", "YAML", 0, 0, 0, 3, 0, 0, 1, 4
"d:\IDEWORK\lvmen\src\licensedcode\data\rules\lgpl-2.1-plus_12.yml", "YAML", 0, 0, 0, 2, 0, 0, 1, 3
"d:\IDEWORK\lvmen\src\licensedcode\data\rules\lgpl-2.1-plus_120.yml", "YAML", 0, 0, 0, 3, 0, 0, 1, 4
"d:\IDEWORK\lvmen\src\licensedcode\data\rules\lgpl-2.1-plus_121.yml", "YAML", 0, 0, 0, 3, 0, 0, 1, 4
"d:\IDEWORK\lvmen\src\licensedcode\data\rules\lgpl-2.1-plus_122.yml", "YAML", 0, 0, 0, 3, 0, 0, 1, 4
"d:\IDEWORK\lvmen\src\licensedcode\data\rules\lgpl-2.1-plus_123.yml", "YAML", 0, 0, 0, 3, 0, 0, 1, 4
"d:\IDEWORK\lvmen\src\licensedcode\data\rules\lgpl-2.1-plus_124.yml", "YAML", 0, 0, 0, 3, 0, 0, 1, 4
"d:\IDEWORK\lvmen\src\licensedcode\data\rules\lgpl-2.1-plus_125.yml", "YAML", 0, 0, 0, 3, 0, 0, 1, 4
"d:\IDEWORK\lvmen\src\licensedcode\data\rules\lgpl-2.1-plus_126.yml", "YAML", 0, 0, 0, 3, 0, 0, 1, 4
"d:\IDEWORK\lvmen\src\licensedcode\data\rules\lgpl-2.1-plus_127.yml", "YAML", 0, 0, 0, 3, 0, 0, 1, 4
"d:\IDEWORK\lvmen\src\licensedcode\data\rules\lgpl-2.1-plus_128.yml", "YAML", 0, 0, 0, 3, 0, 0, 1, 4
"d:\IDEWORK\lvmen\src\licensedcode\data\rules\lgpl-2.1-plus_129.yml", "YAML", 0, 0, 0, 3, 0, 0, 1, 4
"d:\IDEWORK\lvmen\src\licensedcode\data\rules\lgpl-2.1-plus_13.yml", "YAML", 0, 0, 0, 4, 0, 0, 1, 5
"d:\IDEWORK\lvmen\src\licensedcode\data\rules\lgpl-2.1-plus_130.yml", "YAML", 0, 0, 0, 3, 0, 0, 1, 4
"d:\IDEWORK\lvmen\src\licensedcode\data\rules\lgpl-2.1-plus_131.yml", "YAML", 0, 0, 0, 3, 0, 0, 1, 4
"d:\IDEWORK\lvmen\src\licensedcode\data\rules\lgpl-2.1-plus_132.yml", "YAML", 0, 0, 0, 3, 0, 0, 1, 4
"d:\IDEWORK\lvmen\src\licensedcode\data\rules\lgpl-2.1-plus_133.yml", "YAML", 0, 0, 0, 3, 0, 0, 1, 4
"d:\IDEWORK\lvmen\src\licensedcode\data\rules\lgpl-2.1-plus_134.yml", "YAML", 0, 0, 0, 3, 0, 0, 1, 4
"d:\IDEWORK\lvmen\src\licensedcode\data\rules\lgpl-2.1-plus_135.yml", "YAML", 0, 0, 0, 3, 0, 0, 1, 4
"d:\IDEWORK\lvmen\src\licensedcode\data\rules\lgpl-2.1-plus_136.yml", "YAML", 0, 0, 0, 3, 0, 0, 1, 4
"d:\IDEWORK\lvmen\src\licensedcode\data\rules\lgpl-2.1-plus_137.yml", "YAML", 0, 0, 0, 3, 0, 0, 1, 4
"d:\IDEWORK\lvmen\src\licensedcode\data\rules\lgpl-2.1-plus_138.yml", "YAML", 0, 0, 0, 3, 0, 0, 1, 4
"d:\IDEWORK\lvmen\src\licensedcode\data\rules\lgpl-2.1-plus_139.yml", "YAML", 0, 0, 0, 3, 0, 0, 1, 4
"d:\IDEWORK\lvmen\src\licensedcode\data\rules\lgpl-2.1-plus_14.yml", "YAML", 0, 0, 0, 4, 0, 0, 1, 5
"d:\IDEWORK\lvmen\src\licensedcode\data\rules\lgpl-2.1-plus_140.yml", "YAML", 0, 0, 0, 3, 0, 0, 1, 4
"d:\IDEWORK\lvmen\src\licensedcode\data\rules\lgpl-2.1-plus_141.yml", "YAML", 0, 0, 0, 3, 0, 0, 1, 4
"d:\IDEWORK\lvmen\src\licensedcode\data\rules\lgpl-2.1-plus_142.yml", "YAML", 0, 0, 0, 3, 0, 0, 1, 4
"d:\IDEWORK\lvmen\src\licensedcode\data\rules\lgpl-2.1-plus_143.yml", "YAML", 0, 0, 0, 3, 0, 0, 1, 4
"d:\IDEWORK\lvmen\src\licensedcode\data\rules\lgpl-2.1-plus_144.yml", "YAML", 0, 0, 0, 3, 0, 0, 1, 4
"d:\IDEWORK\lvmen\src\licensedcode\data\rules\lgpl-2.1-plus_145.yml", "YAML", 0, 0, 0, 3, 0, 0, 1, 4
"d:\IDEWORK\lvmen\src\licensedcode\data\rules\lgpl-2.1-plus_146.yml", "YAML", 0, 0, 0, 3, 0, 0, 1, 4
"d:\IDEWORK\lvmen\src\licensedcode\data\rules\lgpl-2.1-plus_147.yml", "YAML", 0, 0, 0, 3, 0, 0, 1, 4
"d:\IDEWORK\lvmen\src\licensedcode\data\rules\lgpl-2.1-plus_148.yml", "YAML", 0, 0, 0, 3, 0, 0, 1, 4
"d:\IDEWORK\lvmen\src\licensedcode\data\rules\lgpl-2.1-plus_149.yml", "YAML", 0, 0, 0, 3, 0, 0, 1, 4
"d:\IDEWORK\lvmen\src\licensedcode\data\rules\lgpl-2.1-plus_15.yml", "YAML", 0, 0, 0, 5, 0, 0, 1, 6
"d:\IDEWORK\lvmen\src\licensedcode\data\rules\lgpl-2.1-plus_150.yml", "YAML", 0, 0, 0, 3, 0, 0, 1, 4
"d:\IDEWORK\lvmen\src\licensedcode\data\rules\lgpl-2.1-plus_151.yml", "YAML", 0, 0, 0, 3, 0, 0, 1, 4
"d:\IDEWORK\lvmen\src\licensedcode\data\rules\lgpl-2.1-plus_152.yml", "YAML", 0, 0, 0, 3, 0, 0, 1, 4
"d:\IDEWORK\lvmen\src\licensedcode\data\rules\lgpl-2.1-plus_153.yml", "YAML", 0, 0, 0, 3, 0, 0, 1, 4
"d:\IDEWORK\lvmen\src\licensedcode\data\rules\lgpl-2.1-plus_154.yml", "YAML", 0, 0, 0, 3, 0, 0, 1, 4
"d:\IDEWORK\lvmen\src\licensedcode\data\rules\lgpl-2.1-plus_155.yml", "YAML", 0, 0, 0, 3, 0, 0, 1, 4
"d:\IDEWORK\lvmen\src\licensedcode\data\rules\lgpl-2.1-plus_156.yml", "YAML", 0, 0, 0, 5, 0, 0, 1, 6
"d:\IDEWORK\lvmen\src\licensedcode\data\rules\lgpl-2.1-plus_157.yml", "YAML", 0, 0, 0, 6, 0, 0, 1, 7
"d:\IDEWORK\lvmen\src\licensedcode\data\rules\lgpl-2.1-plus_158.yml", "YAML", 0, 0, 0, 3, 0, 0, 1, 4
"d:\IDEWORK\lvmen\src\licensedcode\data\rules\lgpl-2.1-plus_159.yml", "YAML", 0, 0, 0, 7, 0, 0, 1, 8
"d:\IDEWORK\lvmen\src\licensedcode\data\rules\lgpl-2.1-plus_16.yml", "YAML", 0, 0, 0, 5, 0, 0, 1, 6
"d:\IDEWORK\lvmen\src\licensedcode\data\rules\lgpl-2.1-plus_160.yml", "YAML", 0, 0, 0, 3, 0, 0, 1, 4
"d:\IDEWORK\lvmen\src\licensedcode\data\rules\lgpl-2.1-plus_161.yml", "YAML", 0, 0, 0, 3, 0, 0, 1, 4
"d:\IDEWORK\lvmen\src\licensedcode\data\rules\lgpl-2.1-plus_162.yml", "YAML", 0, 0, 0, 3, 0, 0, 1, 4
"d:\IDEWORK\lvmen\src\licensedcode\data\rules\lgpl-2.1-plus_163.yml", "YAML", 0, 0, 0, 5, 0, 0, 1, 6
"d:\IDEWORK\lvmen\src\licensedcode\data\rules\lgpl-2.1-plus_164.yml", "YAML", 0, 0, 0, 5, 0, 0, 1, 6
"d:\IDEWORK\lvmen\src\licensedcode\data\rules\lgpl-2.1-plus_165.yml", "YAML", 0, 0, 0, 5, 0, 0, 1, 6
"d:\IDEWORK\lvmen\src\licensedcode\data\rules\lgpl-2.1-plus_166.yml", "YAML", 0, 0, 0, 5, 0, 0, 1, 6
"d:\IDEWORK\lvmen\src\licensedcode\data\rules\lgpl-2.1-plus_167.yml", "YAML", 0, 0, 0, 3, 0, 0, 1, 4
"d:\IDEWORK\lvmen\src\licensedcode\data\rules\lgpl-2.1-plus_168.yml", "YAML", 0, 0, 0, 3, 0, 0, 1, 4
"d:\IDEWORK\lvmen\src\licensedcode\data\rules\lgpl-2.1-plus_169.yml", "YAML", 0, 0, 0, 5, 0, 0, 1, 6
"d:\IDEWORK\lvmen\src\licensedcode\data\rules\lgpl-2.1-plus_17.yml", "YAML", 0, 0, 0, 3, 0, 0, 1, 4
"d:\IDEWORK\lvmen\src\licensedcode\data\rules\lgpl-2.1-plus_170.yml", "YAML", 0, 0, 0, 7, 0, 0, 1, 8
"d:\IDEWORK\lvmen\src\licensedcode\data\rules\lgpl-2.1-plus_171.yml", "YAML", 0, 0, 0, 3, 0, 0, 1, 4
"d:\IDEWORK\lvmen\src\licensedcode\data\rules\lgpl-2.1-plus_172.yml", "YAML", 0, 0, 0, 3, 0, 0, 1, 4
"d:\IDEWORK\lvmen\src\licensedcode\data\rules\lgpl-2.1-plus_173.yml", "YAML", 0, 0, 0, 3, 0, 0, 1, 4
"d:\IDEWORK\lvmen\src\licensedcode\data\rules\lgpl-2.1-plus_174.yml", "YAML", 0, 0, 0, 3, 0, 0, 1, 4
"d:\IDEWORK\lvmen\src\licensedcode\data\rules\lgpl-2.1-plus_175.yml", "YAML", 0, 0, 0, 3, 0, 0, 1, 4
"d:\IDEWORK\lvmen\src\licensedcode\data\rules\lgpl-2.1-plus_176.yml", "YAML", 0, 0, 0, 3, 0, 0, 1, 4
"d:\IDEWORK\lvmen\src\licensedcode\data\rules\lgpl-2.1-plus_177.yml", "YAML", 0, 0, 0, 7, 0, 0, 1, 8
"d:\IDEWORK\lvmen\src\licensedcode\data\rules\lgpl-2.1-plus_178.yml", "YAML", 0, 0, 0, 7, 0, 0, 1, 8
"d:\IDEWORK\lvmen\src\licensedcode\data\rules\lgpl-2.1-plus_179.yml", "YAML", 0, 0, 0, 3, 0, 0, 1, 4
"d:\IDEWORK\lvmen\src\licensedcode\data\rules\lgpl-2.1-plus_18.yml", "YAML", 0, 0, 0, 3, 0, 0, 1, 4
"d:\IDEWORK\lvmen\src\licensedcode\data\rules\lgpl-2.1-plus_180.yml", "YAML", 0, 0, 0, 5, 0, 0, 1, 6
"d:\IDEWORK\lvmen\src\licensedcode\data\rules\lgpl-2.1-plus_181.yml", "YAML", 0, 0, 0, 5, 0, 0, 1, 6
"d:\IDEWORK\lvmen\src\licensedcode\data\rules\lgpl-2.1-plus_182.yml", "YAML", 0, 0, 0, 4, 0, 0, 1, 5
"d:\IDEWORK\lvmen\src\licensedcode\data\rules\lgpl-2.1-plus_183.yml", "YAML", 0, 0, 0, 3, 0, 0, 1, 4
"d:\IDEWORK\lvmen\src\licensedcode\data\rules\lgpl-2.1-plus_184.yml", "YAML", 0, 0, 0, 3, 0, 0, 1, 4
"d:\IDEWORK\lvmen\src\licensedcode\data\rules\lgpl-2.1-plus_185.yml", "YAML", 0, 0, 0, 3, 0, 0, 1, 4
"d:\IDEWORK\lvmen\src\licensedcode\data\rules\lgpl-2.1-plus_186.yml", "YAML", 0, 0, 0, 5, 0, 0, 1, 6
"d:\IDEWORK\lvmen\src\licensedcode\data\rules\lgpl-2.1-plus_187.yml", "YAML", 0, 0, 0, 5, 0, 0, 1, 6
"d:\IDEWORK\lvmen\src\licensedcode\data\rules\lgpl-2.1-plus_188.yml", "YAML", 0, 0, 0, 3, 0, 0, 1, 4
"d:\IDEWORK\lvmen\src\licensedcode\data\rules\lgpl-2.1-plus_189.yml", "YAML", 0, 0, 0, 3, 0, 0, 1, 4
"d:\IDEWORK\lvmen\src\licensedcode\data\rules\lgpl-2.1-plus_19.yml", "YAML", 0, 0, 0, 5, 0, 0, 1, 6
"d:\IDEWORK\lvmen\src\licensedcode\data\rules\lgpl-2.1-plus_190.yml", "YAML", 0, 0, 0, 3, 0, 0, 1, 4
"d:\IDEWORK\lvmen\src\licensedcode\data\rules\lgpl-2.1-plus_191.yml", "YAML", 0, 0, 0, 3, 0, 0, 1, 4
"d:\IDEWORK\lvmen\src\licensedcode\data\rules\lgpl-2.1-plus_192.yml", "YAML", 0, 0, 0, 3, 0, 0, 1, 4
"d:\IDEWORK\lvmen\src\licensedcode\data\rules\lgpl-2.1-plus_193.yml", "YAML", 0, 0, 0, 4, 0, 0, 1, 5
"d:\IDEWORK\lvmen\src\licensedcode\data\rules\lgpl-2.1-plus_194.yml", "YAML", 0, 0, 0, 6, 0, 0, 1, 7
"d:\IDEWORK\lvmen\src\licensedcode\data\rules\lgpl-2.1-plus_195.yml", "YAML", 0, 0, 0, 3, 0, 0, 1, 4
"d:\IDEWORK\lvmen\src\licensedcode\data\rules\lgpl-2.1-plus_196.yml", "YAML", 0, 0, 0, 3, 0, 0, 1, 4
"d:\IDEWORK\lvmen\src\licensedcode\data\rules\lgpl-2.1-plus_197.yml", "YAML", 0, 0, 0, 3, 0, 0, 1, 4
"d:\IDEWORK\lvmen\src\licensedcode\data\rules\lgpl-2.1-plus_198.yml", "YAML", 0, 0, 0, 3, 0, 0, 1, 4
"d:\IDEWORK\lvmen\src\licensedcode\data\rules\lgpl-2.1-plus_199.yml", "YAML", 0, 0, 0, 3, 0, 0, 1, 4
"d:\IDEWORK\lvmen\src\licensedcode\data\rules\lgpl-2.1-plus_2.yml", "YAML", 0, 0, 0, 2, 0, 0, 1, 3
"d:\IDEWORK\lvmen\src\licensedcode\data\rules\lgpl-2.1-plus_20.yml", "YAML", 0, 0, 0, 5, 0, 0, 1, 6
"d:\IDEWORK\lvmen\src\licensedcode\data\rules\lgpl-2.1-plus_200.yml", "YAML", 0, 0, 0, 3, 0, 0, 1, 4
"d:\IDEWORK\lvmen\src\licensedcode\data\rules\lgpl-2.1-plus_201.yml", "YAML", 0, 0, 0, 5, 0, 0, 1, 6
"d:\IDEWORK\lvmen\src\licensedcode\data\rules\lgpl-2.1-plus_202.yml", "YAML", 0, 0, 0, 5, 0, 0, 1, 6
"d:\IDEWORK\lvmen\src\licensedcode\data\rules\lgpl-2.1-plus_203.yml", "YAML", 0, 0, 0, 3, 0, 0, 1, 4
"d:\IDEWORK\lvmen\src\licensedcode\data\rules\lgpl-2.1-plus_204.yml", "YAML", 0, 0, 0, 3, 0, 0, 1, 4
"d:\IDEWORK\lvmen\src\licensedcode\data\rules\lgpl-2.1-plus_205.yml", "YAML", 0, 0, 0, 3, 0, 0, 1, 4
"d:\IDEWORK\lvmen\src\licensedcode\data\rules\lgpl-2.1-plus_206.yml", "YAML", 0, 0, 0, 3, 0, 0, 1, 4
"d:\IDEWORK\lvmen\src\licensedcode\data\rules\lgpl-2.1-plus_207.yml", "YAML", 0, 0, 0, 3, 0, 0, 1, 4
"d:\IDEWORK\lvmen\src\licensedcode\data\rules\lgpl-2.1-plus_208.yml", "YAML", 0, 0, 0, 3, 0, 0, 1, 4
"d:\IDEWORK\lvmen\src\licensedcode\data\rules\lgpl-2.1-plus_209.yml", "YAML", 0, 0, 0, 3, 0, 0, 1, 4
"d:\IDEWORK\lvmen\src\licensedcode\data\rules\lgpl-2.1-plus_21.yml", "YAML", 0, 0, 0, 5, 0, 0, 1, 6
"d:\IDEWORK\lvmen\src\licensedcode\data\rules\lgpl-2.1-plus_210.yml", "YAML", 0, 0, 0, 3, 0, 0, 1, 4
"d:\IDEWORK\lvmen\src\licensedcode\data\rules\lgpl-2.1-plus_211.yml", "YAML", 0, 0, 0, 3, 0, 0, 1, 4
"d:\IDEWORK\lvmen\src\licensedcode\data\rules\lgpl-2.1-plus_212.yml", "YAML", 0, 0, 0, 3, 0, 0, 1, 4
"d:\IDEWORK\lvmen\src\licensedcode\data\rules\lgpl-2.1-plus_213.yml", "YAML", 0, 0, 0, 3, 0, 0, 1, 4
"d:\IDEWORK\lvmen\src\licensedcode\data\rules\lgpl-2.1-plus_214.yml", "YAML", 0, 0, 0, 3, 0, 0, 1, 4
"d:\IDEWORK\lvmen\src\licensedcode\data\rules\lgpl-2.1-plus_215.yml", "YAML", 0, 0, 0, 3, 0, 0, 1, 4
"d:\IDEWORK\lvmen\src\licensedcode\data\rules\lgpl-2.1-plus_216.yml", "YAML", 0, 0, 0, 3, 0, 0, 1, 4
"d:\IDEWORK\lvmen\src\licensedcode\data\rules\lgpl-2.1-plus_217.yml", "YAML", 0, 0, 0, 3, 0, 0, 1, 4
"d:\IDEWORK\lvmen\src\licensedcode\data\rules\lgpl-2.1-plus_218.yml", "YAML", 0, 0, 0, 4, 0, 0, 1, 5
"d:\IDEWORK\lvmen\src\licensedcode\data\rules\lgpl-2.1-plus_219.yml", "YAML", 0, 0, 0, 4, 0, 0, 1, 5
"d:\IDEWORK\lvmen\src\licensedcode\data\rules\lgpl-2.1-plus_22.yml", "YAML", 0, 0, 0, 3, 0, 0, 1, 4
"d:\IDEWORK\lvmen\src\licensedcode\data\rules\lgpl-2.1-plus_220.yml", "YAML", 0, 0, 0, 4, 0, 0, 1, 5
"d:\IDEWORK\lvmen\src\licensedcode\data\rules\lgpl-2.1-plus_221.yml", "YAML", 0, 0, 0, 4, 0, 0, 1, 5
"d:\IDEWORK\lvmen\src\licensedcode\data\rules\lgpl-2.1-plus_222.yml", "YAML", 0, 0, 0, 4, 0, 0, 1, 5
"d:\IDEWORK\lvmen\src\licensedcode\data\rules\lgpl-2.1-plus_223.yml", "YAML", 0, 0, 0, 3, 0, 0, 1, 4
"d:\IDEWORK\lvmen\src\licensedcode\data\rules\lgpl-2.1-plus_224.yml", "YAML", 0, 0, 0, 5, 0, 0, 1, 6
"d:\IDEWORK\lvmen\src\licensedcode\data\rules\lgpl-2.1-plus_225.yml", "YAML", 0, 0, 0, 5, 0, 0, 1, 6
"d:\IDEWORK\lvmen\src\licensedcode\data\rules\lgpl-2.1-plus_226.yml", "YAML", 0, 0, 0, 3, 0, 0, 1, 4
"d:\IDEWORK\lvmen\src\licensedcode\data\rules\lgpl-2.1-plus_227.yml", "YAML", 0, 0, 0, 5, 0, 0, 1, 6
"d:\IDEWORK\lvmen\src\licensedcode\data\rules\lgpl-2.1-plus_228.yml", "YAML", 0, 0, 0, 3, 0, 0, 1, 4
"d:\IDEWORK\lvmen\src\licensedcode\data\rules\lgpl-2.1-plus_229.yml", "YAML", 0, 0, 0, 3, 0, 0, 1, 4
"d:\IDEWORK\lvmen\src\licensedcode\data\rules\lgpl-2.1-plus_23.yml", "YAML", 0, 0, 0, 4, 0, 0, 1, 5
"d:\IDEWORK\lvmen\src\licensedcode\data\rules\lgpl-2.1-plus_230.yml", "YAML", 0, 0, 0, 3, 0, 0, 1, 4
"d:\IDEWORK\lvmen\src\licensedcode\data\rules\lgpl-2.1-plus_231.yml", "YAML", 0, 0, 0, 5, 0, 0, 1, 6
"d:\IDEWORK\lvmen\src\licensedcode\data\rules\lgpl-2.1-plus_232.yml", "YAML", 0, 0, 0, 5, 0, 0, 1, 6
"d:\IDEWORK\lvmen\src\licensedcode\data\rules\lgpl-2.1-plus_233.yml", "YAML", 0, 0, 0, 3, 0, 0, 1, 4
"d:\IDEWORK\lvmen\src\licensedcode\data\rules\lgpl-2.1-plus_234.yml", "YAML", 0, 0, 0, 4, 0, 0, 1, 5
"d:\IDEWORK\lvmen\src\licensedcode\data\rules\lgpl-2.1-plus_235.yml", "YAML", 0, 0, 0, 4, 0, 0, 1, 5
"d:\IDEWORK\lvmen\src\licensedcode\data\rules\lgpl-2.1-plus_236.yml", "YAML", 0, 0, 0, 4, 0, 0, 1, 5
"d:\IDEWORK\lvmen\src\licensedcode\data\rules\lgpl-2.1-plus_237.yml", "YAML", 0, 0, 0, 5, 0, 0, 1, 6
"d:\IDEWORK\lvmen\src\licensedcode\data\rules\lgpl-2.1-plus_238.yml", "YAML", 0, 0, 0, 3, 0, 0, 1, 4
"d:\IDEWORK\lvmen\src\licensedcode\data\rules\lgpl-2.1-plus_239.yml", "YAML", 0, 0, 0, 3, 0, 0, 1, 4
"d:\IDEWORK\lvmen\src\licensedcode\data\rules\lgpl-2.1-plus_24.yml", "YAML", 0, 0, 0, 3, 0, 0, 1, 4
"d:\IDEWORK\lvmen\src\licensedcode\data\rules\lgpl-2.1-plus_240.yml", "YAML", 0, 0, 0, 3, 0, 0, 1, 4
"d:\IDEWORK\lvmen\src\licensedcode\data\rules\lgpl-2.1-plus_241.yml", "YAML", 0, 0, 0, 3, 0, 0, 1, 4
"d:\IDEWORK\lvmen\src\licensedcode\data\rules\lgpl-2.1-plus_242.yml", "YAML", 0, 0, 0, 3, 0, 0, 1, 4
"d:\IDEWORK\lvmen\src\licensedcode\data\rules\lgpl-2.1-plus_243.yml", "YAML", 0, 0, 0, 5, 0, 0, 1, 6
"d:\IDEWORK\lvmen\src\licensedcode\data\rules\lgpl-2.1-plus_244.yml", "YAML", 0, 0, 0, 5, 0, 0, 1, 6
"d:\IDEWORK\lvmen\src\licensedcode\data\rules\lgpl-2.1-plus_245.yml", "YAML", 0, 0, 0, 5, 0, 0, 1, 6
"d:\IDEWORK\lvmen\src\licensedcode\data\rules\lgpl-2.1-plus_246.yml", "YAML", 0, 0, 0, 5, 0, 0, 1, 6
"d:\IDEWORK\lvmen\src\licensedcode\data\rules\lgpl-2.1-plus_247.yml", "YAML", 0, 0, 0, 5, 0, 0, 1, 6
"d:\IDEWORK\lvmen\src\licensedcode\data\rules\lgpl-2.1-plus_248.yml", "YAML", 0, 0, 0, 5, 0, 0, 1, 6
"d:\IDEWORK\lvmen\src\licensedcode\data\rules\lgpl-2.1-plus_249.yml", "YAML", 0, 0, 0, 5, 0, 0, 1, 6
"d:\IDEWORK\lvmen\src\licensedcode\data\rules\lgpl-2.1-plus_25.yml", "YAML", 0, 0, 0, 5, 0, 0, 1, 6
"d:\IDEWORK\lvmen\src\licensedcode\data\rules\lgpl-2.1-plus_250.yml", "YAML", 0, 0, 0, 5, 0, 0, 1, 6
"d:\IDEWORK\lvmen\src\licensedcode\data\rules\lgpl-2.1-plus_251.yml", "YAML", 0, 0, 0, 5, 0, 0, 1, 6
"d:\IDEWORK\lvmen\src\licensedcode\data\rules\lgpl-2.1-plus_252.yml", "YAML", 0, 0, 0, 5, 0, 0, 1, 6
"d:\IDEWORK\lvmen\src\licensedcode\data\rules\lgpl-2.1-plus_253.yml", "YAML", 0, 0, 0, 3, 0, 0, 1, 4
"d:\IDEWORK\lvmen\src\licensedcode\data\rules\lgpl-2.1-plus_254.yml", "YAML", 0, 0, 0, 3, 0, 0, 1, 4
"d:\IDEWORK\lvmen\src\licensedcode\data\rules\lgpl-2.1-plus_255.yml", "YAML", 0, 0, 0, 5, 0, 0, 1, 6
"d:\IDEWORK\lvmen\src\licensedcode\data\rules\lgpl-2.1-plus_256.yml", "YAML", 0, 0, 0, 6, 0, 0, 1, 7
"d:\IDEWORK\lvmen\src\licensedcode\data\rules\lgpl-2.1-plus_257.yml", "YAML", 0, 0, 0, 5, 0, 0, 1, 6
"d:\IDEWORK\lvmen\src\licensedcode\data\rules\lgpl-2.1-plus_258.yml", "YAML", 0, 0, 0, 5, 0, 0, 1, 6
"d:\IDEWORK\lvmen\src\licensedcode\data\rules\lgpl-2.1-plus_259.yml", "YAML", 0, 0, 0, 5, 0, 0, 1, 6
"d:\IDEWORK\lvmen\src\licensedcode\data\rules\lgpl-2.1-plus_26.yml", "YAML", 0, 0, 0, 6, 0, 0, 1, 7
"d:\IDEWORK\lvmen\src\licensedcode\data\rules\lgpl-2.1-plus_260.yml", "YAML", 0, 0, 0, 5, 0, 0, 1, 6
"d:\IDEWORK\lvmen\src\licensedcode\data\rules\lgpl-2.1-plus_261.yml", "YAML", 0, 0, 0, 5, 0, 0, 1, 6
"d:\IDEWORK\lvmen\src\licensedcode\data\rules\lgpl-2.1-plus_262.yml", "YAML", 0, 0, 0, 5, 0, 0, 1, 6
"d:\IDEWORK\lvmen\src\licensedcode\data\rules\lgpl-2.1-plus_263.yml", "YAML", 0, 0, 0, 5, 0, 0, 1, 6
"d:\IDEWORK\lvmen\src\licensedcode\data\rules\lgpl-2.1-plus_264.yml", "YAML", 0, 0, 0, 4, 0, 0, 1, 5
"d:\IDEWORK\lvmen\src\licensedcode\data\rules\lgpl-2.1-plus_265.yml", "YAML", 0, 0, 0, 3, 0, 0, 1, 4
"d:\IDEWORK\lvmen\src\licensedcode\data\rules\lgpl-2.1-plus_266.yml", "YAML", 0, 0, 0, 4, 0, 0, 1, 5
"d:\IDEWORK\lvmen\src\licensedcode\data\rules\lgpl-2.1-plus_267.yml", "YAML", 0, 0, 0, 4, 0, 0, 1, 5
"d:\IDEWORK\lvmen\src\licensedcode\data\rules\lgpl-2.1-plus_268.yml", "YAML", 0, 0, 0, 3, 0, 0, 1, 4
"d:\IDEWORK\lvmen\src\licensedcode\data\rules\lgpl-2.1-plus_269.yml", "YAML", 0, 0, 0, 3, 0, 0, 1, 4
"d:\IDEWORK\lvmen\src\licensedcode\data\rules\lgpl-2.1-plus_27.yml", "YAML", 0, 0, 0, 2, 0, 0, 1, 3
"d:\IDEWORK\lvmen\src\licensedcode\data\rules\lgpl-2.1-plus_270.yml", "YAML", 0, 0, 0, 5, 0, 0, 1, 6
"d:\IDEWORK\lvmen\src\licensedcode\data\rules\lgpl-2.1-plus_271.yml", "YAML", 0, 0, 0, 3, 0, 0, 1, 4
"d:\IDEWORK\lvmen\src\licensedcode\data\rules\lgpl-2.1-plus_272.yml", "YAML", 0, 0, 0, 5, 0, 0, 1, 6
"d:\IDEWORK\lvmen\src\licensedcode\data\rules\lgpl-2.1-plus_273.yml", "YAML", 0, 0, 0, 3, 0, 0, 1, 4
"d:\IDEWORK\lvmen\src\licensedcode\data\rules\lgpl-2.1-plus_274.yml", "YAML", 0, 0, 0, 3, 0, 0, 1, 4
"d:\IDEWORK\lvmen\src\licensedcode\data\rules\lgpl-2.1-plus_275.yml", "YAML", 0, 0, 0, 3, 0, 0, 1, 4
"d:\IDEWORK\lvmen\src\licensedcode\data\rules\lgpl-2.1-plus_276.yml", "YAML", 0, 0, 0, 7, 0, 0, 1, 8
"d:\IDEWORK\lvmen\src\licensedcode\data\rules\lgpl-2.1-plus_277.yml", "YAML", 0, 0, 0, 7, 0, 0, 1, 8
"d:\IDEWORK\lvmen\src\licensedcode\data\rules\lgpl-2.1-plus_278.yml", "YAML", 0, 0, 0, 3, 0, 0, 1, 4
"d:\IDEWORK\lvmen\src\licensedcode\data\rules\lgpl-2.1-plus_279.yml", "YAML", 0, 0, 0, 3, 0, 0, 1, 4
"d:\IDEWORK\lvmen\src\licensedcode\data\rules\lgpl-2.1-plus_28.yml", "YAML", 0, 0, 0, 2, 0, 0, 1, 3
"d:\IDEWORK\lvmen\src\licensedcode\data\rules\lgpl-2.1-plus_280.yml", "YAML", 0, 0, 0, 5, 0, 0, 1, 6
"d:\IDEWORK\lvmen\src\licensedcode\data\rules\lgpl-2.1-plus_281.yml", "YAML", 0, 0, 0, 5, 0, 0, 1, 6
"d:\IDEWORK\lvmen\src\licensedcode\data\rules\lgpl-2.1-plus_282.yml", "YAML", 0, 0, 0, 3, 0, 0, 1, 4
"d:\IDEWORK\lvmen\src\licensedcode\data\rules\lgpl-2.1-plus_283.yml", "YAML", 0, 0, 0, 4, 0, 0, 1, 5
"d:\IDEWORK\lvmen\src\licensedcode\data\rules\lgpl-2.1-plus_284.yml", "YAML", 0, 0, 0, 5, 0, 0, 1, 6
"d:\IDEWORK\lvmen\src\licensedcode\data\rules\lgpl-2.1-plus_285.yml", "YAML", 0, 0, 0, 4, 0, 0, 1, 5
"d:\IDEWORK\lvmen\src\licensedcode\data\rules\lgpl-2.1-plus_286.yml", "YAML", 0, 0, 0, 4, 0, 0, 1, 5
"d:\IDEWORK\lvmen\src\licensedcode\data\rules\lgpl-2.1-plus_287.yml", "YAML", 0, 0, 0, 3, 0, 0, 1, 4
"d:\IDEWORK\lvmen\src\licensedcode\data\rules\lgpl-2.1-plus_288.yml", "YAML", 0, 0, 0, 3, 0, 0, 1, 4
"d:\IDEWORK\lvmen\src\licensedcode\data\rules\lgpl-2.1-plus_289.yml", "YAML", 0, 0, 0, 3, 0, 0, 1, 4
"d:\IDEWORK\lvmen\src\licensedcode\data\rules\lgpl-2.1-plus_29.yml", "YAML", 0, 0, 0, 4, 0, 0, 1, 5
"d:\IDEWORK\lvmen\src\licensedcode\data\rules\lgpl-2.1-plus_290.yml", "YAML", 0, 0, 0, 3, 0, 0, 1, 4
"d:\IDEWORK\lvmen\src\licensedcode\data\rules\lgpl-2.1-plus_291.yml", "YAML", 0, 0, 0, 3, 0, 0, 1, 4
"d:\IDEWORK\lvmen\src\licensedcode\data\rules\lgpl-2.1-plus_292.yml", "YAML", 0, 0, 0, 3, 0, 0, 1, 4
"d:\IDEWORK\lvmen\src\licensedcode\data\rules\lgpl-2.1-plus_293.yml", "YAML", 0, 0, 0, 3, 0, 0, 1, 4
"d:\IDEWORK\lvmen\src\licensedcode\data\rules\lgpl-2.1-plus_294.yml", "YAML", 0, 0, 0, 4, 0, 0, 1, 5
"d:\IDEWORK\lvmen\src\licensedcode\data\rules\lgpl-2.1-plus_295.yml", "YAML", 0, 0, 0, 4, 0, 0, 1, 5
"d:\IDEWORK\lvmen\src\licensedcode\data\rules\lgpl-2.1-plus_296.yml", "YAML", 0, 0, 0, 5, 0, 0, 1, 6
"d:\IDEWORK\lvmen\src\licensedcode\data\rules\lgpl-2.1-plus_297.yml", "YAML", 0, 0, 0, 4, 0, 0, 1, 5
"d:\IDEWORK\lvmen\src\licensedcode\data\rules\lgpl-2.1-plus_298.yml", "YAML", 0, 0, 0, 4, 0, 0, 1, 5
"d:\IDEWORK\lvmen\src\licensedcode\data\rules\lgpl-2.1-plus_299.yml", "YAML", 0, 0, 0, 3, 0, 0, 2, 5
"d:\IDEWORK\lvmen\src\licensedcode\data\rules\lgpl-2.1-plus_3.yml", "YAML", 0, 0, 0, 3, 0, 0, 1, 4
"d:\IDEWORK\lvmen\src\licensedcode\data\rules\lgpl-2.1-plus_30.yml", "YAML", 0, 0, 0, 10, 0, 0, 1, 11
"d:\IDEWORK\lvmen\src\licensedcode\data\rules\lgpl-2.1-plus_300.yml", "YAML", 0, 0, 0, 3, 0, 0, 1, 4
"d:\IDEWORK\lvmen\src\licensedcode\data\rules\lgpl-2.1-plus_301.yml", "YAML", 0, 0, 0, 5, 0, 0, 1, 6
"d:\IDEWORK\lvmen\src\licensedcode\data\rules\lgpl-2.1-plus_302.yml", "YAML", 0, 0, 0, 3, 0, 0, 1, 4
"d:\IDEWORK\lvmen\src\licensedcode\data\rules\lgpl-2.1-plus_303.yml", "YAML", 0, 0, 0, 2, 0, 0, 1, 3
"d:\IDEWORK\lvmen\src\licensedcode\data\rules\lgpl-2.1-plus_304.yml", "YAML", 0, 0, 0, 4, 0, 0, 1, 5
"d:\IDEWORK\lvmen\src\licensedcode\data\rules\lgpl-2.1-plus_305.yml", "YAML", 0, 0, 0, 3, 0, 0, 1, 4
"d:\IDEWORK\lvmen\src\licensedcode\data\rules\lgpl-2.1-plus_306.yml", "YAML", 0, 0, 0, 4, 0, 0, 1, 5
"d:\IDEWORK\lvmen\src\licensedcode\data\rules\lgpl-2.1-plus_307.yml", "YAML", 0, 0, 0, 6, 0, 0, 1, 7
"d:\IDEWORK\lvmen\src\licensedcode\data\rules\lgpl-2.1-plus_308.yml", "YAML", 0, 0, 0, 4, 0, 0, 1, 5
"d:\IDEWORK\lvmen\src\licensedcode\data\rules\lgpl-2.1-plus_309.yml", "YAML", 0, 0, 0, 4, 0, 0, 1, 5
"d:\IDEWORK\lvmen\src\licensedcode\data\rules\lgpl-2.1-plus_31.yml", "YAML", 0, 0, 0, 2, 0, 0, 1, 3
"d:\IDEWORK\lvmen\src\licensedcode\data\rules\lgpl-2.1-plus_310.yml", "YAML", 0, 0, 0, 3, 0, 0, 1, 4
"d:\IDEWORK\lvmen\src\licensedcode\data\rules\lgpl-2.1-plus_311.yml", "YAML", 0, 0, 0, 3, 0, 0, 1, 4
"d:\IDEWORK\lvmen\src\licensedcode\data\rules\lgpl-2.1-plus_312.yml", "YAML", 0, 0, 0, 6, 0, 0, 1, 7
"d:\IDEWORK\lvmen\src\licensedcode\data\rules\lgpl-2.1-plus_313.yml", "YAML", 0, 0, 0, 3, 0, 0, 1, 4
"d:\IDEWORK\lvmen\src\licensedcode\data\rules\lgpl-2.1-plus_314.yml", "YAML", 0, 0, 0, 5, 0, 0, 1, 6
"d:\IDEWORK\lvmen\src\licensedcode\data\rules\lgpl-2.1-plus_315.yml", "YAML", 0, 0, 0, 6, 0, 0, 1, 7
"d:\IDEWORK\lvmen\src\licensedcode\data\rules\lgpl-2.1-plus_316.yml", "YAML", 0, 0, 0, 4, 0, 0, 1, 5
"d:\IDEWORK\lvmen\src\licensedcode\data\rules\lgpl-2.1-plus_317.yml", "YAML", 0, 0, 0, 4, 0, 0, 1, 5
"d:\IDEWORK\lvmen\src\licensedcode\data\rules\lgpl-2.1-plus_318.yml", "YAML", 0, 0, 0, 2, 0, 0, 1, 3
"d:\IDEWORK\lvmen\src\licensedcode\data\rules\lgpl-2.1-plus_319.yml", "YAML", 0, 0, 0, 2, 0, 0, 1, 3
"d:\IDEWORK\lvmen\src\licensedcode\data\rules\lgpl-2.1-plus_32.yml", "YAML", 0, 0, 0, 4, 0, 0, 1, 5
"d:\IDEWORK\lvmen\src\licensedcode\data\rules\lgpl-2.1-plus_320.yml", "YAML", 0, 0, 0, 6, 0, 0, 1, 7
"d:\IDEWORK\lvmen\src\licensedcode\data\rules\lgpl-2.1-plus_321.yml", "YAML", 0, 0, 0, 6, 0, 0, 1, 7
"d:\IDEWORK\lvmen\src\licensedcode\data\rules\lgpl-2.1-plus_322.yml", "YAML", 0, 0, 0, 6, 0, 0, 1, 7
"d:\IDEWORK\lvmen\src\licensedcode\data\rules\lgpl-2.1-plus_323.yml", "YAML", 0, 0, 0, 4, 0, 0, 1, 5
"d:\IDEWORK\lvmen\src\licensedcode\data\rules\lgpl-2.1-plus_324.yml", "YAML", 0, 0, 0, 6, 0, 0, 1, 7
"d:\IDEWORK\lvmen\src\licensedcode\data\rules\lgpl-2.1-plus_325.yml", "YAML", 0, 0, 0, 4, 0, 0, 1, 5
"d:\IDEWORK\lvmen\src\licensedcode\data\rules\lgpl-2.1-plus_326.yml", "YAML", 0, 0, 0, 2, 0, 0, 1, 3
"d:\IDEWORK\lvmen\src\licensedcode\data\rules\lgpl-2.1-plus_327.yml", "YAML", 0, 0, 0, 2, 0, 0, 1, 3
"d:\IDEWORK\lvmen\src\licensedcode\data\rules\lgpl-2.1-plus_328.yml", "YAML", 0, 0, 0, 2, 0, 0, 1, 3
"d:\IDEWORK\lvmen\src\licensedcode\data\rules\lgpl-2.1-plus_329.yml", "YAML", 0, 0, 0, 4, 0, 0, 1, 5
"d:\IDEWORK\lvmen\src\licensedcode\data\rules\lgpl-2.1-plus_33.yml", "YAML", 0, 0, 0, 4, 0, 0, 1, 5
"d:\IDEWORK\lvmen\src\licensedcode\data\rules\lgpl-2.1-plus_330.yml", "YAML", 0, 0, 0, 4, 0, 0, 1, 5
"d:\IDEWORK\lvmen\src\licensedcode\data\rules\lgpl-2.1-plus_331.yml", "YAML", 0, 0, 0, 3, 0, 0, 1, 4
"d:\IDEWORK\lvmen\src\licensedcode\data\rules\lgpl-2.1-plus_332.yml", "YAML", 0, 0, 0, 5, 0, 0, 1, 6
"d:\IDEWORK\lvmen\src\licensedcode\data\rules\lgpl-2.1-plus_333.yml", "YAML", 0, 0, 0, 5, 0, 0, 1, 6
"d:\IDEWORK\lvmen\src\licensedcode\data\rules\lgpl-2.1-plus_334.yml", "YAML", 0, 0, 0, 6, 0, 0, 1, 7
"d:\IDEWORK\lvmen\src\licensedcode\data\rules\lgpl-2.1-plus_335.yml", "YAML", 0, 0, 0, 5, 0, 0, 1, 6
"d:\IDEWORK\lvmen\src\licensedcode\data\rules\lgpl-2.1-plus_336.yml", "YAML", 0, 0, 0, 5, 0, 0, 1, 6
"d:\IDEWORK\lvmen\src\licensedcode\data\rules\lgpl-2.1-plus_337.yml", "YAML", 0, 0, 0, 7, 0, 0, 1, 8
"d:\IDEWORK\lvmen\src\licensedcode\data\rules\lgpl-2.1-plus_338.yml", "YAML", 0, 0, 0, 5, 0, 0, 1, 6
"d:\IDEWORK\lvmen\src\licensedcode\data\rules\lgpl-2.1-plus_339.yml", "YAML", 0, 0, 0, 6, 0, 0, 1, 7
"d:\IDEWORK\lvmen\src\licensedcode\data\rules\lgpl-2.1-plus_34.yml", "YAML", 0, 0, 0, 2, 0, 0, 1, 3
"d:\IDEWORK\lvmen\src\licensedcode\data\rules\lgpl-2.1-plus_340.yml", "YAML", 0, 0, 0, 4, 0, 0, 1, 5
"d:\IDEWORK\lvmen\src\licensedcode\data\rules\lgpl-2.1-plus_341.yml", "YAML", 0, 0, 0, 7, 0, 0, 1, 8
"d:\IDEWORK\lvmen\src\licensedcode\data\rules\lgpl-2.1-plus_342.yml", "YAML", 0, 0, 0, 5, 0, 0, 1, 6
"d:\IDEWORK\lvmen\src\licensedcode\data\rules\lgpl-2.1-plus_343.yml", "YAML", 0, 0, 0, 6, 0, 0, 1, 7
"d:\IDEWORK\lvmen\src\licensedcode\data\rules\lgpl-2.1-plus_344.yml", "YAML", 0, 0, 0, 4, 0, 0, 1, 5
"d:\IDEWORK\lvmen\src\licensedcode\data\rules\lgpl-2.1-plus_345.yml", "YAML", 0, 0, 0, 4, 0, 0, 1, 5
"d:\IDEWORK\lvmen\src\licensedcode\data\rules\lgpl-2.1-plus_346.yml", "YAML", 0, 0, 0, 5, 0, 0, 1, 6
"d:\IDEWORK\lvmen\src\licensedcode\data\rules\lgpl-2.1-plus_347.yml", "YAML", 0, 0, 0, 5, 0, 0, 1, 6
"d:\IDEWORK\lvmen\src\licensedcode\data\rules\lgpl-2.1-plus_348.yml", "YAML", 0, 0, 0, 7, 0, 0, 1, 8
"d:\IDEWORK\lvmen\src\licensedcode\data\rules\lgpl-2.1-plus_349.yml", "YAML", 0, 0, 0, 5, 0, 0, 1, 6
"d:\IDEWORK\lvmen\src\licensedcode\data\rules\lgpl-2.1-plus_35.yml", "YAML", 0, 0, 0, 2, 0, 0, 1, 3
"d:\IDEWORK\lvmen\src\licensedcode\data\rules\lgpl-2.1-plus_350.yml", "YAML", 0, 0, 0, 5, 0, 0, 1, 6
"d:\IDEWORK\lvmen\src\licensedcode\data\rules\lgpl-2.1-plus_351.yml", "YAML", 0, 0, 0, 5, 0, 0, 1, 6
"d:\IDEWORK\lvmen\src\licensedcode\data\rules\lgpl-2.1-plus_352.yml", "YAML", 0, 0, 0, 5, 0, 0, 1, 6
"d:\IDEWORK\lvmen\src\licensedcode\data\rules\lgpl-2.1-plus_353.yml", "YAML", 0, 0, 0, 5, 0, 0, 1, 6
"d:\IDEWORK\lvmen\src\licensedcode\data\rules\lgpl-2.1-plus_354.yml", "YAML", 0, 0, 0, 6, 0, 0, 1, 7
"d:\IDEWORK\lvmen\src\licensedcode\data\rules\lgpl-2.1-plus_355.yml", "YAML", 0, 0, 0, 5, 0, 0, 1, 6
"d:\IDEWORK\lvmen\src\licensedcode\data\rules\lgpl-2.1-plus_356.yml", "YAML", 0, 0, 0, 5, 0, 0, 1, 6
"d:\IDEWORK\lvmen\src\licensedcode\data\rules\lgpl-2.1-plus_357.yml", "YAML", 0, 0, 0, 6, 0, 0, 1, 7
"d:\IDEWORK\lvmen\src\licensedcode\data\rules\lgpl-2.1-plus_358.yml", "YAML", 0, 0, 0, 5, 0, 0, 1, 6
"d:\IDEWORK\lvmen\src\licensedcode\data\rules\lgpl-2.1-plus_359.yml", "YAML", 0, 0, 0, 7, 0, 0, 1, 8
"d:\IDEWORK\lvmen\src\licensedcode\data\rules\lgpl-2.1-plus_36.yml", "YAML", 0, 0, 0, 4, 0, 0, 1, 5
"d:\IDEWORK\lvmen\src\licensedcode\data\rules\lgpl-2.1-plus_360.yml", "YAML", 0, 0, 0, 5, 0, 0, 1, 6
"d:\IDEWORK\lvmen\src\licensedcode\data\rules\lgpl-2.1-plus_361.yml", "YAML", 0, 0, 0, 5, 0, 0, 1, 6
"d:\IDEWORK\lvmen\src\licensedcode\data\rules\lgpl-2.1-plus_362.yml", "YAML", 0, 0, 0, 6, 0, 0, 1, 7
"d:\IDEWORK\lvmen\src\licensedcode\data\rules\lgpl-2.1-plus_363.yml", "YAML", 0, 0, 0, 5, 0, 0, 1, 6
"d:\IDEWORK\lvmen\src\licensedcode\data\rules\lgpl-2.1-plus_364.yml", "YAML", 0, 0, 0, 5, 0, 0, 1, 6
"d:\IDEWORK\lvmen\src\licensedcode\data\rules\lgpl-2.1-plus_365.yml", "YAML", 0, 0, 0, 7, 0, 0, 1, 8
"d:\IDEWORK\lvmen\src\licensedcode\data\rules\lgpl-2.1-plus_366.yml", "YAML", 0, 0, 0, 5, 0, 0, 1, 6
"d:\IDEWORK\lvmen\src\licensedcode\data\rules\lgpl-2.1-plus_367.yml", "YAML", 0, 0, 0, 5, 0, 0, 1, 6
"d:\IDEWORK\lvmen\src\licensedcode\data\rules\lgpl-2.1-plus_368.yml", "YAML", 0, 0, 0, 6, 0, 0, 1, 7
"d:\IDEWORK\lvmen\src\licensedcode\data\rules\lgpl-2.1-plus_369.yml", "YAML", 0, 0, 0, 5, 0, 0, 1, 6
"d:\IDEWORK\lvmen\src\licensedcode\data\rules\lgpl-2.1-plus_37.yml", "YAML", 0, 0, 0, 2, 0, 0, 1, 3
"d:\IDEWORK\lvmen\src\licensedcode\data\rules\lgpl-2.1-plus_370.yml", "YAML", 0, 0, 0, 5, 0, 0, 1, 6
"d:\IDEWORK\lvmen\src\licensedcode\data\rules\lgpl-2.1-plus_371.yml", "YAML", 0, 0, 0, 7, 0, 0, 1, 8
"d:\IDEWORK\lvmen\src\licensedcode\data\rules\lgpl-2.1-plus_372.yml", "YAML", 0, 0, 0, 11, 0, 0, 1, 12
"d:\IDEWORK\lvmen\src\licensedcode\data\rules\lgpl-2.1-plus_373.yml", "YAML", 0, 0, 0, 5, 0, 0, 1, 6
"d:\IDEWORK\lvmen\src\licensedcode\data\rules\lgpl-2.1-plus_374.yml", "YAML", 0, 0, 0, 5, 0, 0, 1, 6
"d:\IDEWORK\lvmen\src\licensedcode\data\rules\lgpl-2.1-plus_375.yml", "YAML", 0, 0, 0, 5, 0, 0, 1, 6
"d:\IDEWORK\lvmen\src\licensedcode\data\rules\lgpl-2.1-plus_376.yml", "YAML", 0, 0, 0, 5, 0, 0, 1, 6
"d:\IDEWORK\lvmen\src\licensedcode\data\rules\lgpl-2.1-plus_377.yml", "YAML", 0, 0, 0, 6, 0, 0, 1, 7
"d:\IDEWORK\lvmen\src\licensedcode\data\rules\lgpl-2.1-plus_378.yml", "YAML", 0, 0, 0, 5, 0, 0, 1, 6
"d:\IDEWORK\lvmen\src\licensedcode\data\rules\lgpl-2.1-plus_379.yml", "YAML", 0, 0, 0, 5, 0, 0, 1, 6
"d:\IDEWORK\lvmen\src\licensedcode\data\rules\lgpl-2.1-plus_38.yml", "YAML", 0, 0, 0, 3, 0, 0, 1, 4
"d:\IDEWORK\lvmen\src\licensedcode\data\rules\lgpl-2.1-plus_380.yml", "YAML", 0, 0, 0, 5, 0, 0, 1, 6
"d:\IDEWORK\lvmen\src\licensedcode\data\rules\lgpl-2.1-plus_381.yml", "YAML", 0, 0, 0, 6, 0, 0, 1, 7
"d:\IDEWORK\lvmen\src\licensedcode\data\rules\lgpl-2.1-plus_382.yml", "YAML", 0, 0, 0, 5, 0, 0, 1, 6
"d:\IDEWORK\lvmen\src\licensedcode\data\rules\lgpl-2.1-plus_383.yml", "YAML", 0, 0, 0, 2, 0, 0, 1, 3
"d:\IDEWORK\lvmen\src\licensedcode\data\rules\lgpl-2.1-plus_384.yml", "YAML", 0, 0, 0, 4, 0, 0, 1, 5
"d:\IDEWORK\lvmen\src\licensedcode\data\rules\lgpl-2.1-plus_385.yml", "YAML", 0, 0, 0, 4, 0, 0, 1, 5
"d:\IDEWORK\lvmen\src\licensedcode\data\rules\lgpl-2.1-plus_386.yml", "YAML", 0, 0, 0, 7, 0, 0, 1, 8
"d:\IDEWORK\lvmen\src\licensedcode\data\rules\lgpl-2.1-plus_387.yml", "YAML", 0, 0, 0, 6, 0, 0, 1, 7
"d:\IDEWORK\lvmen\src\licensedcode\data\rules\lgpl-2.1-plus_388.yml", "YAML", 0, 0, 0, 4, 0, 0, 1, 5
"d:\IDEWORK\lvmen\src\licensedcode\data\rules\lgpl-2.1-plus_389.yml", "YAML", 0, 0, 0, 4, 0, 0, 1, 5
"d:\IDEWORK\lvmen\src\licensedcode\data\rules\lgpl-2.1-plus_39.yml", "YAML", 0, 0, 0, 3, 0, 0, 1, 4
"d:\IDEWORK\lvmen\src\licensedcode\data\rules\lgpl-2.1-plus_390.yml", "YAML", 0, 0, 0, 4, 0, 0, 1, 5
"d:\IDEWORK\lvmen\src\licensedcode\data\rules\lgpl-2.1-plus_391.yml", "YAML", 0, 0, 0, 3, 0, 0, 1, 4
"d:\IDEWORK\lvmen\src\licensedcode\data\rules\lgpl-2.1-plus_392.yml", "YAML", 0, 0, 0, 3, 0, 0, 1, 4
"d:\IDEWORK\lvmen\src\licensedcode\data\rules\lgpl-2.1-plus_393.yml", "YAML", 0, 0, 0, 3, 0, 0, 1, 4
"d:\IDEWORK\lvmen\src\licensedcode\data\rules\lgpl-2.1-plus_394.yml", "YAML", 0, 0, 0, 3, 0, 0, 1, 4
"d:\IDEWORK\lvmen\src\licensedcode\data\rules\lgpl-2.1-plus_395.yml", "YAML", 0, 0, 0, 3, 0, 0, 1, 4
"d:\IDEWORK\lvmen\src\licensedcode\data\rules\lgpl-2.1-plus_396.yml", "YAML", 0, 0, 0, 2, 0, 0, 1, 3
"d:\IDEWORK\lvmen\src\licensedcode\data\rules\lgpl-2.1-plus_397.yml", "YAML", 0, 0, 0, 5, 0, 0, 1, 6
"d:\IDEWORK\lvmen\src\licensedcode\data\rules\lgpl-2.1-plus_398.yml", "YAML", 0, 0, 0, 5, 0, 0, 1, 6
"d:\IDEWORK\lvmen\src\licensedcode\data\rules\lgpl-2.1-plus_399.yml", "YAML", 0, 0, 0, 6, 0, 0, 1, 7
"d:\IDEWORK\lvmen\src\licensedcode\data\rules\lgpl-2.1-plus_4.yml", "YAML", 0, 0, 0, 3, 0, 0, 1, 4
"d:\IDEWORK\lvmen\src\licensedcode\data\rules\lgpl-2.1-plus_40.yml", "YAML", 0, 0, 0, 3, 0, 0, 1, 4
"d:\IDEWORK\lvmen\src\licensedcode\data\rules\lgpl-2.1-plus_400.yml", "YAML", 0, 0, 0, 5, 0, 0, 1, 6
"d:\IDEWORK\lvmen\src\licensedcode\data\rules\lgpl-2.1-plus_401.yml", "YAML", 0, 0, 0, 5, 0, 0, 1, 6
"d:\IDEWORK\lvmen\src\licensedcode\data\rules\lgpl-2.1-plus_402.yml", "YAML", 0, 0, 0, 5, 0, 0, 1, 6
"d:\IDEWORK\lvmen\src\licensedcode\data\rules\lgpl-2.1-plus_403.yml", "YAML", 0, 0, 0, 8, 0, 0, 1, 9
"d:\IDEWORK\lvmen\src\licensedcode\data\rules\lgpl-2.1-plus_404.yml", "YAML", 0, 0, 0, 5, 0, 0, 1, 6
"d:\IDEWORK\lvmen\src\licensedcode\data\rules\lgpl-2.1-plus_405.yml", "YAML", 0, 0, 0, 5, 0, 0, 1, 6
"d:\IDEWORK\lvmen\src\licensedcode\data\rules\lgpl-2.1-plus_406.yml", "YAML", 0, 0, 0, 6, 0, 0, 1, 7
"d:\IDEWORK\lvmen\src\licensedcode\data\rules\lgpl-2.1-plus_407.yml", "YAML", 0, 0, 0, 4, 0, 0, 1, 5
"d:\IDEWORK\lvmen\src\licensedcode\data\rules\lgpl-2.1-plus_408.yml", "YAML", 0, 0, 0, 5, 0, 0, 1, 6
"d:\IDEWORK\lvmen\src\licensedcode\data\rules\lgpl-2.1-plus_409.yml", "YAML", 0, 0, 0, 5, 0, 0, 1, 6
"d:\IDEWORK\lvmen\src\licensedcode\data\rules\lgpl-2.1-plus_41.yml", "YAML", 0, 0, 0, 3, 0, 0, 1, 4
"d:\IDEWORK\lvmen\src\licensedcode\data\rules\lgpl-2.1-plus_410.yml", "YAML", 0, 0, 0, 7, 0, 0, 1, 8
"d:\IDEWORK\lvmen\src\licensedcode\data\rules\lgpl-2.1-plus_411.yml", "YAML", 0, 0, 0, 6, 0, 0, 1, 7
"d:\IDEWORK\lvmen\src\licensedcode\data\rules\lgpl-2.1-plus_412.yml", "YAML", 0, 0, 0, 5, 0, 0, 1, 6
"d:\IDEWORK\lvmen\src\licensedcode\data\rules\lgpl-2.1-plus_413.yml", "YAML", 0, 0, 0, 7, 0, 0, 1, 8
"d:\IDEWORK\lvmen\src\licensedcode\data\rules\lgpl-2.1-plus_414.yml", "YAML", 0, 0, 0, 7, 0, 0, 1, 8
"d:\IDEWORK\lvmen\src\licensedcode\data\rules\lgpl-2.1-plus_415.yml", "YAML", 0, 0, 0, 4, 0, 0, 1, 5
"d:\IDEWORK\lvmen\src\licensedcode\data\rules\lgpl-2.1-plus_416.yml", "YAML", 0, 0, 0, 6, 0, 0, 1, 7
"d:\IDEWORK\lvmen\src\licensedcode\data\rules\lgpl-2.1-plus_417.yml", "YAML", 0, 0, 0, 4, 0, 0, 1, 5
"d:\IDEWORK\lvmen\src\licensedcode\data\rules\lgpl-2.1-plus_418.yml", "YAML", 0, 0, 0, 4, 0, 0, 1, 5
"d:\IDEWORK\lvmen\src\licensedcode\data\rules\lgpl-2.1-plus_419.yml", "YAML", 0, 0, 0, 4, 0, 0, 1, 5
"d:\IDEWORK\lvmen\src\licensedcode\data\rules\lgpl-2.1-plus_42.yml", "YAML", 0, 0, 0, 3, 0, 0, 1, 4
"d:\IDEWORK\lvmen\src\licensedcode\data\rules\lgpl-2.1-plus_420.yml", "YAML", 0, 0, 0, 2, 0, 0, 1, 3
"d:\IDEWORK\lvmen\src\licensedcode\data\rules\lgpl-2.1-plus_43.yml", "YAML", 0, 0, 0, 2, 0, 0, 1, 3
"d:\IDEWORK\lvmen\src\licensedcode\data\rules\lgpl-2.1-plus_44.yml", "YAML", 0, 0, 0, 5, 0, 0, 1, 6
"d:\IDEWORK\lvmen\src\licensedcode\data\rules\lgpl-2.1-plus_45.yml", "YAML", 0, 0, 0, 3, 0, 0, 1, 4
"d:\IDEWORK\lvmen\src\licensedcode\data\rules\lgpl-2.1-plus_46.yml", "YAML", 0, 0, 0, 7, 0, 0, 1, 8
"d:\IDEWORK\lvmen\src\licensedcode\data\rules\lgpl-2.1-plus_47.yml", "YAML", 0, 0, 0, 5, 0, 0, 1, 6
"d:\IDEWORK\lvmen\src\licensedcode\data\rules\lgpl-2.1-plus_48.yml", "YAML", 0, 0, 0, 5, 0, 0, 1, 6
"d:\IDEWORK\lvmen\src\licensedcode\data\rules\lgpl-2.1-plus_49.yml", "YAML", 0, 0, 0, 3, 0, 0, 1, 4
"d:\IDEWORK\lvmen\src\licensedcode\data\rules\lgpl-2.1-plus_5.yml", "YAML", 0, 0, 0, 4, 0, 0, 1, 5
"d:\IDEWORK\lvmen\src\licensedcode\data\rules\lgpl-2.1-plus_50.yml", "YAML", 0, 0, 0, 5, 0, 0, 1, 6
"d:\IDEWORK\lvmen\src\licensedcode\data\rules\lgpl-2.1-plus_51.yml", "YAML", 0, 0, 0, 2, 0, 0, 1, 3
"d:\IDEWORK\lvmen\src\licensedcode\data\rules\lgpl-2.1-plus_52.yml", "YAML", 0, 0, 0, 5, 0, 0, 1, 6
"d:\IDEWORK\lvmen\src\licensedcode\data\rules\lgpl-2.1-plus_53.yml", "YAML", 0, 0, 0, 5, 0, 0, 1, 6
"d:\IDEWORK\lvmen\src\licensedcode\data\rules\lgpl-2.1-plus_54.yml", "YAML", 0, 0, 0, 4, 0, 0, 1, 5
"d:\IDEWORK\lvmen\src\licensedcode\data\rules\lgpl-2.1-plus_55.yml", "YAML", 0, 0, 0, 4, 0, 0, 1, 5
"d:\IDEWORK\lvmen\src\licensedcode\data\rules\lgpl-2.1-plus_56.yml", "YAML", 0, 0, 0, 4, 0, 0, 1, 5
"d:\IDEWORK\lvmen\src\licensedcode\data\rules\lgpl-2.1-plus_57.yml", "YAML", 0, 0, 0, 2, 0, 0, 1, 3
"d:\IDEWORK\lvmen\src\licensedcode\data\rules\lgpl-2.1-plus_58.yml", "YAML", 0, 0, 0, 2, 0, 0, 1, 3
"d:\IDEWORK\lvmen\src\licensedcode\data\rules\lgpl-2.1-plus_59.yml", "YAML", 0, 0, 0, 4, 0, 0, 1, 5
"d:\IDEWORK\lvmen\src\licensedcode\data\rules\lgpl-2.1-plus_6.yml", "YAML", 0, 0, 0, 3, 0, 0, 1, 4
"d:\IDEWORK\lvmen\src\licensedcode\data\rules\lgpl-2.1-plus_60.yml", "YAML", 0, 0, 0, 2, 0, 0, 1, 3
"d:\IDEWORK\lvmen\src\licensedcode\data\rules\lgpl-2.1-plus_61.yml", "YAML", 0, 0, 0, 4, 0, 0, 1, 5
"d:\IDEWORK\lvmen\src\licensedcode\data\rules\lgpl-2.1-plus_62.yml", "YAML", 0, 0, 0, 5, 0, 0, 1, 6
"d:\IDEWORK\lvmen\src\licensedcode\data\rules\lgpl-2.1-plus_63.yml", "YAML", 0, 0, 0, 2, 0, 0, 1, 3
"d:\IDEWORK\lvmen\src\licensedcode\data\rules\lgpl-2.1-plus_64.yml", "YAML", 0, 0, 0, 3, 0, 0, 1, 4
"d:\IDEWORK\lvmen\src\licensedcode\data\rules\lgpl-2.1-plus_65.yml", "YAML", 0, 0, 0, 3, 0, 0, 1, 4
"d:\IDEWORK\lvmen\src\licensedcode\data\rules\lgpl-2.1-plus_66.yml", "YAML", 0, 0, 0, 4, 0, 0, 1, 5
"d:\IDEWORK\lvmen\src\licensedcode\data\rules\lgpl-2.1-plus_67.yml", "YAML", 0, 0, 0, 5, 0, 0, 1, 6
"d:\IDEWORK\lvmen\src\licensedcode\data\rules\lgpl-2.1-plus_68.yml", "YAML", 0, 0, 0, 4, 0, 0, 1, 5
"d:\IDEWORK\lvmen\src\licensedcode\data\rules\lgpl-2.1-plus_69.yml", "YAML", 0, 0, 0, 2, 0, 0, 1, 3
"d:\IDEWORK\lvmen\src\licensedcode\data\rules\lgpl-2.1-plus_7.yml", "YAML", 0, 0, 0, 2, 0, 0, 1, 3
"d:\IDEWORK\lvmen\src\licensedcode\data\rules\lgpl-2.1-plus_70.yml", "YAML", 0, 0, 0, 3, 0, 0, 1, 4
"d:\IDEWORK\lvmen\src\licensedcode\data\rules\lgpl-2.1-plus_71.yml", "YAML", 0, 0, 0, 3, 0, 0, 1, 4
"d:\IDEWORK\lvmen\src\licensedcode\data\rules\lgpl-2.1-plus_72.yml", "YAML", 0, 0, 0, 3, 0, 0, 1, 4
"d:\IDEWORK\lvmen\src\licensedcode\data\rules\lgpl-2.1-plus_73.yml", "YAML", 0, 0, 0, 4, 0, 0, 1, 5
"d:\IDEWORK\lvmen\src\licensedcode\data\rules\lgpl-2.1-plus_74.yml", "YAML", 0, 0, 0, 2, 0, 0, 1, 3
"d:\IDEWORK\lvmen\src\licensedcode\data\rules\lgpl-2.1-plus_75.yml", "YAML", 0, 0, 0, 2, 0, 0, 1, 3
"d:\IDEWORK\lvmen\src\licensedcode\data\rules\lgpl-2.1-plus_76.yml", "YAML", 0, 0, 0, 2, 0, 0, 1, 3
"d:\IDEWORK\lvmen\src\licensedcode\data\rules\lgpl-2.1-plus_77.yml", "YAML", 0, 0, 0, 4, 0, 0, 1, 5
"d:\IDEWORK\lvmen\src\licensedcode\data\rules\lgpl-2.1-plus_78.yml", "YAML", 0, 0, 0, 3, 0, 0, 1, 4
"d:\IDEWORK\lvmen\src\licensedcode\data\rules\lgpl-2.1-plus_79.yml", "YAML", 0, 0, 0, 2, 0, 0, 1, 3
"d:\IDEWORK\lvmen\src\licensedcode\data\rules\lgpl-2.1-plus_8.yml", "YAML", 0, 0, 0, 3, 0, 0, 1, 4
"d:\IDEWORK\lvmen\src\licensedcode\data\rules\lgpl-2.1-plus_80.yml", "YAML", 0, 0, 0, 4, 0, 0, 1, 5
"d:\IDEWORK\lvmen\src\licensedcode\data\rules\lgpl-2.1-plus_81.yml", "YAML", 0, 0, 0, 2, 0, 0, 1, 3
"d:\IDEWORK\lvmen\src\licensedcode\data\rules\lgpl-2.1-plus_82.yml", "YAML", 0, 0, 0, 5, 0, 0, 1, 6
"d:\IDEWORK\lvmen\src\licensedcode\data\rules\lgpl-2.1-plus_83.yml", "YAML", 0, 0, 0, 2, 0, 0, 1, 3
"d:\IDEWORK\lvmen\src\licensedcode\data\rules\lgpl-2.1-plus_83_1.yml", "YAML", 0, 0, 0, 3, 0, 0, 1, 4
"d:\IDEWORK\lvmen\src\licensedcode\data\rules\lgpl-2.1-plus_84.yml", "YAML", 0, 0, 0, 2, 0, 0, 1, 3
"d:\IDEWORK\lvmen\src\licensedcode\data\rules\lgpl-2.1-plus_85.yml", "YAML", 0, 0, 0, 5, 0, 0, 1, 6
"d:\IDEWORK\lvmen\src\licensedcode\data\rules\lgpl-2.1-plus_86.yml", "YAML", 0, 0, 0, 5, 0, 0, 1, 6
"d:\IDEWORK\lvmen\src\licensedcode\data\rules\lgpl-2.1-plus_87.yml", "YAML", 0, 0, 0, 5, 0, 0, 1, 6
"d:\IDEWORK\lvmen\src\licensedcode\data\rules\lgpl-2.1-plus_88.yml", "YAML", 0, 0, 0, 5, 0, 0, 1, 6
"d:\IDEWORK\lvmen\src\licensedcode\data\rules\lgpl-2.1-plus_89.yml", "YAML", 0, 0, 0, 4, 0, 0, 1, 5
"d:\IDEWORK\lvmen\src\licensedcode\data\rules\lgpl-2.1-plus_9.yml", "YAML", 0, 0, 0, 3, 0, 0, 1, 4
"d:\IDEWORK\lvmen\src\licensedcode\data\rules\lgpl-2.1-plus_90.yml", "YAML", 0, 0, 0, 4, 0, 0, 1, 5
"d:\IDEWORK\lvmen\src\licensedcode\data\rules\lgpl-2.1-plus_91.yml", "YAML", 0, 0, 0, 2, 0, 0, 1, 3
"d:\IDEWORK\lvmen\src\licensedcode\data\rules\lgpl-2.1-plus_92.yml", "YAML", 0, 0, 0, 2, 0, 0, 1, 3
"d:\IDEWORK\lvmen\src\licensedcode\data\rules\lgpl-2.1-plus_93.yml", "YAML", 0, 0, 0, 2, 0, 0, 1, 3
"d:\IDEWORK\lvmen\src\licensedcode\data\rules\lgpl-2.1-plus_94.yml", "YAML", 0, 0, 0, 3, 0, 0, 1, 4
"d:\IDEWORK\lvmen\src\licensedcode\data\rules\lgpl-2.1-plus_95.yml", "YAML", 0, 0, 0, 3, 0, 0, 1, 4
"d:\IDEWORK\lvmen\src\licensedcode\data\rules\lgpl-2.1-plus_96.yml", "YAML", 0, 0, 0, 3, 0, 0, 1, 4
"d:\IDEWORK\lvmen\src\licensedcode\data\rules\lgpl-2.1-plus_97.yml", "YAML", 0, 0, 0, 3, 0, 0, 1, 4
"d:\IDEWORK\lvmen\src\licensedcode\data\rules\lgpl-2.1-plus_97_1.yml", "YAML", 0, 0, 0, 3, 0, 0, 1, 4
"d:\IDEWORK\lvmen\src\licensedcode\data\rules\lgpl-2.1-plus_97_2.yml", "YAML", 0, 0, 0, 3, 0, 0, 1, 4
"d:\IDEWORK\lvmen\src\licensedcode\data\rules\lgpl-2.1-plus_98.yml", "YAML", 0, 0, 0, 4, 0, 0, 1, 5
"d:\IDEWORK\lvmen\src\licensedcode\data\rules\lgpl-2.1-plus_99.yml", "YAML", 0, 0, 0, 3, 0, 0, 1, 4
"d:\IDEWORK\lvmen\src\licensedcode\data\rules\lgpl-2.1-plus_and__other-permissive_and_gpl-2.0-plus_1.yml", "YAML", 0, 0, 0, 6, 0, 0, 1, 7
"d:\IDEWORK\lvmen\src\licensedcode\data\rules\lgpl-2.1-plus_and__other-permissive_and_gpl-2.0-plus_2.yml", "YAML", 0, 0, 0, 6, 0, 0, 1, 7
"d:\IDEWORK\lvmen\src\licensedcode\data\rules\lgpl-2.1-plus_and_free-unknown_1.yml", "YAML", 0, 0, 0, 4, 0, 0, 1, 5
"d:\IDEWORK\lvmen\src\licensedcode\data\rules\lgpl-2.1-plus_and_gfdl-1.3_1.yml", "YAML", 0, 0, 0, 5, 0, 0, 1, 6
"d:\IDEWORK\lvmen\src\licensedcode\data\rules\lgpl-2.1-plus_and_gfdl-1.3_2.yml", "YAML", 0, 0, 0, 3, 0, 0, 1, 4
"d:\IDEWORK\lvmen\src\licensedcode\data\rules\lgpl-2.1-plus_and_gpl-2.0-plus_1.yml", "YAML", 0, 0, 0, 6, 0, 0, 1, 7
"d:\IDEWORK\lvmen\src\licensedcode\data\rules\lgpl-2.1-plus_and_gpl-2.0-plus_2.yml", "YAML", 0, 0, 0, 2, 0, 0, 1, 3
"d:\IDEWORK\lvmen\src\licensedcode\data\rules\lgpl-2.1-plus_and_gpl-2.0-plus_3.yml", "YAML", 0, 0, 0, 2, 0, 0, 1, 3
"d:\IDEWORK\lvmen\src\licensedcode\data\rules\lgpl-2.1-plus_and_gpl-2.0_and_proprietary-license_1.yml", "YAML", 0, 0, 0, 6, 0, 0, 1, 7
"d:\IDEWORK\lvmen\src\licensedcode\data\rules\lgpl-2.1-plus_and_gpl-2.0_and_proprietary-license_2.yml", "YAML", 0, 0, 0, 6, 0, 0, 1, 7
"d:\IDEWORK\lvmen\src\licensedcode\data\rules\lgpl-2.1-plus_and_gpl-3.0-plus_1.yml", "YAML", 0, 0, 0, 3, 0, 0, 1, 4
"d:\IDEWORK\lvmen\src\licensedcode\data\rules\lgpl-2.1-plus_and_gpl-3.0-plus_2.yml", "YAML", 0, 0, 0, 2, 0, 0, 1, 3
"d:\IDEWORK\lvmen\src\licensedcode\data\rules\lgpl-2.1-plus_and_gpl-3.0-plus_and_lgpl-3.0-plus_and_gpl-2.0-plus_1.yml", "YAML", 0, 0, 0, 2, 0, 0, 1, 3
"d:\IDEWORK\lvmen\src\licensedcode\data\rules\lgpl-2.1-plus_and_gpl-3.0-plus_and_lgpl-3.0-plus_and_gpl-2.0-plus_2.yml", "YAML", 0, 0, 0, 2, 0, 0, 2, 4
"d:\IDEWORK\lvmen\src\licensedcode\data\rules\lgpl-2.1-plus_and_gpl-3.0_1.yml", "YAML", 0, 0, 0, 3, 0, 0, 1, 4
"d:\IDEWORK\lvmen\src\licensedcode\data\rules\lgpl-2.1-plus_and_other-copyleft_1.yml", "YAML", 0, 0, 0, 5, 0, 0, 1, 6
"d:\IDEWORK\lvmen\src\licensedcode\data\rules\lgpl-2.1-plus_and_other-copyleft_and_other-permissive_1.yml", "YAML", 0, 0, 0, 3, 0, 0, 1, 4
"d:\IDEWORK\lvmen\src\licensedcode\data\rules\lgpl-2.1-plus_and_other-permissive_1.yml", "YAML", 0, 0, 0, 3, 0, 0, 1, 4
"d:\IDEWORK\lvmen\src\licensedcode\data\rules\lgpl-2.1-plus_and_other-permissive_2.yml", "YAML", 0, 0, 0, 3, 0, 0, 1, 4
"d:\IDEWORK\lvmen\src\licensedcode\data\rules\lgpl-2.1-plus_and_proprietary-license_1.yml", "YAML", 0, 0, 0, 4, 0, 0, 1, 5
"d:\IDEWORK\lvmen\src\licensedcode\data\rules\lgpl-2.1-plus_and_proprietary-license_2.yml", "YAML", 0, 0, 0, 5, 0, 0, 1, 6
"d:\IDEWORK\lvmen\src\licensedcode\data\rules\lgpl-2.1-plus_linking_2.yml", "YAML", 0, 0, 0, 5, 0, 0, 1, 6
"d:\IDEWORK\lvmen\src\licensedcode\data\rules\lgpl-2.1-plus_newlib.yml", "YAML", 0, 0, 0, 3, 0, 0, 1, 4
"d:\IDEWORK\lvmen\src\licensedcode\data\rules\lgpl-2.1-plus_or_apache-2.0_1.yml", "YAML", 0, 0, 0, 5, 0, 0, 1, 6
"d:\IDEWORK\lvmen\src\licensedcode\data\rules\lgpl-2.1-plus_or_apache-2.0_2.yml", "YAML", 0, 0, 0, 8, 0, 0, 1, 9
"d:\IDEWORK\lvmen\src\licensedcode\data\rules\lgpl-2.1-plus_or_apache-2.0_3.yml", "YAML", 0, 0, 0, 8, 0, 0, 1, 9
"d:\IDEWORK\lvmen\src\licensedcode\data\rules\lgpl-2.1-plus_or_apache-2.0_4.yml", "YAML", 0, 0, 0, 4, 0, 0, 1, 5
"d:\IDEWORK\lvmen\src\licensedcode\data\rules\lgpl-2.1-plus_or_apache-2.0_5.yml", "YAML", 0, 0, 0, 9, 0, 0, 1, 10
"d:\IDEWORK\lvmen\src\licensedcode\data\rules\lgpl-2.1-plus_or_apache-2.0_6.yml", "YAML", 0, 0, 0, 9, 0, 0, 1, 10
"d:\IDEWORK\lvmen\src\licensedcode\data\rules\lgpl-2.1-plus_or_apache-2.0_or_commercial-license_1.yml", "YAML", 0, 0, 0, 3, 0, 0, 1, 4
"d:\IDEWORK\lvmen\src\licensedcode\data\rules\lgpl-2.1-plus_or_bsd-new_1.yml", "YAML", 0, 0, 0, 7, 0, 0, 1, 8
"d:\IDEWORK\lvmen\src\licensedcode\data\rules\lgpl-2.1-plus_or_commercial-license_1.yml", "YAML", 0, 0, 0, 5, 0, 0, 1, 6
"d:\IDEWORK\lvmen\src\licensedcode\data\rules\lgpl-2.1-plus_or_mpl-1.1_or_gpl-2.0-plus_1.yml", "YAML", 0, 0, 0, 6, 0, 0, 1, 7
"d:\IDEWORK\lvmen\src\licensedcode\data\rules\lgpl-2.1-plus_or_mpl-1.1_or_gpl-2.0.yml", "YAML", 0, 0, 0, 7, 0, 0, 1, 8
"d:\IDEWORK\lvmen\src\licensedcode\data\rules\lgpl-2.1-plus_or_mpl-1.1_or_gpl-2.0_2.yml", "YAML", 0, 0, 0, 7, 0, 0, 1, 8
"d:\IDEWORK\lvmen\src\licensedcode\data\rules\lgpl-2.1-plus_or_proprietary-license_1.yml", "YAML", 0, 0, 0, 5, 0, 0, 1, 6
"d:\IDEWORK\lvmen\src\licensedcode\data\rules\lgpl-2.1-plus_partial.yml", "YAML", 0, 0, 0, 2, 0, 0, 1, 3
"d:\IDEWORK\lvmen\src\licensedcode\data\rules\lgpl-2.1-plus_url_1.yml", "YAML", 0, 0, 0, 5, 0, 0, 1, 6
"d:\IDEWORK\lvmen\src\licensedcode\data\rules\lgpl-2.1-plus_url_2.yml", "YAML", 0, 0, 0, 5, 0, 0, 1, 6
"d:\IDEWORK\lvmen\src\licensedcode\data\rules\lgpl-2.1-plus_with_gcc-exception-3.1_1.yml", "YAML", 0, 0, 0, 2, 0, 0, 1, 3
"d:\IDEWORK\lvmen\src\licensedcode\data\rules\lgpl-2.1-plus_with_linking-exception-2.1-plus_1.yml", "YAML", 0, 0, 0, 6, 0, 0, 1, 7
"d:\IDEWORK\lvmen\src\licensedcode\data\rules\lgpl-2.1-plus_with_ocaml-lgpl-linking-exception_1.yml", "YAML", 0, 0, 0, 3, 0, 0, 1, 4
"d:\IDEWORK\lvmen\src\licensedcode\data\rules\lgpl-2.1-plus_with_ocaml-lgpl-linking-exception_2.yml", "YAML", 0, 0, 0, 3, 0, 0, 1, 4
"d:\IDEWORK\lvmen\src\licensedcode\data\rules\lgpl-2.1-plus_with_ocaml-lgpl-linking-exception_3.yml", "YAML", 0, 0, 0, 3, 0, 0, 1, 4
"d:\IDEWORK\lvmen\src\licensedcode\data\rules\lgpl-2.1-plus_with_openssl-exception-gpl-3.0-plus_1.yml", "YAML", 0, 0, 0, 4, 0, 0, 1, 5
"d:\IDEWORK\lvmen\src\licensedcode\data\rules\lgpl-2.1-plus_with_openssl-exception-gpl-3.0-plus_2.yml", "YAML", 0, 0, 0, 4, 0, 0, 1, 5
"d:\IDEWORK\lvmen\src\licensedcode\data\rules\lgpl-2.1-plus_with_openssl-exception-gpl-3.0-plus_3.yml", "YAML", 0, 0, 0, 5, 0, 0, 1, 6
"d:\IDEWORK\lvmen\src\licensedcode\data\rules\lgpl-2.1-plus_with_openssl-exception-gpl-3.0-plus_4.yml", "YAML", 0, 0, 0, 5, 0, 0, 1, 6
"d:\IDEWORK\lvmen\src\licensedcode\data\rules\lgpl-2.1-plus_with_openssl-exception-gpl-3.0-plus_5.yml", "YAML", 0, 0, 0, 5, 0, 0, 1, 6
"d:\IDEWORK\lvmen\src\licensedcode\data\rules\lgpl-2.1-plus_with_other-copyleft_1.yml", "YAML", 0, 0, 0, 5, 0, 0, 1, 6
"d:\IDEWORK\lvmen\src\licensedcode\data\rules\lgpl-2.1-plus_with_qt-lgpl-exception-1.1_older.yml", "YAML", 0, 0, 0, 3, 0, 0, 1, 4
"d:\IDEWORK\lvmen\src\licensedcode\data\rules\lgpl-2.1-plus_with_rxtx-exception-lgpl-2.1_1.yml", "YAML", 0, 0, 0, 11, 0, 0, 1, 12
"d:\IDEWORK\lvmen\src\licensedcode\data\rules\lgpl-2.1-plus_with_unlimited-linking-exception-lgpl_1.yml", "YAML", 0, 0, 0, 4, 0, 0, 1, 5
"d:\IDEWORK\lvmen\src\licensedcode\data\rules\lgpl-2.1-plus_with_unlimited-linking-exception-lgpl_10.yml", "YAML", 0, 0, 0, 6, 0, 0, 1, 7
"d:\IDEWORK\lvmen\src\licensedcode\data\rules\lgpl-2.1-plus_with_unlimited-linking-exception-lgpl_2.yml", "YAML", 0, 0, 0, 4, 0, 0, 1, 5
"d:\IDEWORK\lvmen\src\licensedcode\data\rules\lgpl-2.1-plus_with_unlimited-linking-exception-lgpl_3.yml", "YAML", 0, 0, 0, 4, 0, 0, 1, 5
"d:\IDEWORK\lvmen\src\licensedcode\data\rules\lgpl-2.1-plus_with_unlimited-linking-exception-lgpl_4.yml", "YAML", 0, 0, 0, 4, 0, 0, 1, 5
"d:\IDEWORK\lvmen\src\licensedcode\data\rules\lgpl-2.1-plus_with_unlimited-linking-exception-lgpl_5.yml", "YAML", 0, 0, 0, 5, 0, 0, 1, 6
"d:\IDEWORK\lvmen\src\licensedcode\data\rules\lgpl-2.1-plus_with_unlimited-linking-exception-lgpl_6.yml", "YAML", 0, 0, 0, 5, 0, 0, 1, 6
"d:\IDEWORK\lvmen\src\licensedcode\data\rules\lgpl-2.1-plus_with_unlimited-linking-exception-lgpl_7.yml", "YAML", 0, 0, 0, 5, 0, 0, 1, 6
"d:\IDEWORK\lvmen\src\licensedcode\data\rules\lgpl-2.1-plus_with_unlimited-linking-exception-lgpl_8.yml", "YAML", 0, 0, 0, 5, 0, 0, 1, 6
"d:\IDEWORK\lvmen\src\licensedcode\data\rules\lgpl-2.1-plus_with_unlimited-linking-exception-lgpl_9.yml", "YAML", 0, 0, 0, 5, 0, 0, 1, 6
"d:\IDEWORK\lvmen\src\licensedcode\data\rules\lgpl-2.1-plus_wubi.yml", "YAML", 0, 0, 0, 4, 0, 0, 1, 5
"d:\IDEWORK\lvmen\src\licensedcode\data\rules\lgpl-2.1-plus_wubi2.yml", "YAML", 0, 0, 0, 4, 0, 0, 1, 5
"d:\IDEWORK\lvmen\src\licensedcode\data\rules\lgpl-2.1-rxtx.yml", "YAML", 0, 0, 0, 5, 0, 0, 1, 6
"d:\IDEWORK\lvmen\src\licensedcode\data\rules\lgpl-2.1-rxtx_1.yml", "YAML", 0, 0, 0, 5, 0, 0, 1, 6
"d:\IDEWORK\lvmen\src\licensedcode\data\rules\lgpl-2.1-rxtx_2.yml", "YAML", 0, 0, 0, 11, 0, 0, 1, 12
"d:\IDEWORK\lvmen\src\licensedcode\data\rules\lgpl-2.1.SPDX.yml", "YAML", 0, 0, 0, 10, 0, 0, 1, 11
"d:\IDEWORK\lvmen\src\licensedcode\data\rules\lgpl-2.1.txt_bare.yml", "YAML", 0, 0, 0, 5, 0, 0, 1, 6
"d:\IDEWORK\lvmen\src\licensedcode\data\rules\lgpl-2.1.yml", "YAML", 0, 0, 0, 4, 0, 0, 1, 5
"d:\IDEWORK\lvmen\src\licensedcode\data\rules\lgpl-2.1_0.yml", "YAML", 0, 0, 0, 3, 0, 0, 1, 4
"d:\IDEWORK\lvmen\src\licensedcode\data\rules\lgpl-2.1_1.yml", "YAML", 0, 0, 0, 5, 0, 0, 1, 6
"d:\IDEWORK\lvmen\src\licensedcode\data\rules\lgpl-2.1_10.yml", "YAML", 0, 0, 0, 5, 0, 0, 1, 6
"d:\IDEWORK\lvmen\src\licensedcode\data\rules\lgpl-2.1_100.yml", "YAML", 0, 0, 0, 2, 0, 0, 1, 3
"d:\IDEWORK\lvmen\src\licensedcode\data\rules\lgpl-2.1_101.yml", "YAML", 0, 0, 0, 9, 0, 0, 1, 10
"d:\IDEWORK\lvmen\src\licensedcode\data\rules\lgpl-2.1_102.yml", "YAML", 0, 0, 0, 9, 0, 0, 1, 10
"d:\IDEWORK\lvmen\src\licensedcode\data\rules\lgpl-2.1_103.yml", "YAML", 0, 0, 0, 9, 0, 0, 1, 10
"d:\IDEWORK\lvmen\src\licensedcode\data\rules\lgpl-2.1_104.yml", "YAML", 0, 0, 0, 8, 0, 0, 1, 9
"d:\IDEWORK\lvmen\src\licensedcode\data\rules\lgpl-2.1_105.yml", "YAML", 0, 0, 0, 3, 0, 0, 1, 4
"d:\IDEWORK\lvmen\src\licensedcode\data\rules\lgpl-2.1_106.yml", "YAML", 0, 0, 0, 3, 0, 0, 1, 4
"d:\IDEWORK\lvmen\src\licensedcode\data\rules\lgpl-2.1_107.yml", "YAML", 0, 0, 0, 5, 0, 0, 1, 6
"d:\IDEWORK\lvmen\src\licensedcode\data\rules\lgpl-2.1_108.yml", "YAML", 0, 0, 0, 3, 0, 0, 1, 4
"d:\IDEWORK\lvmen\src\licensedcode\data\rules\lgpl-2.1_109.yml", "YAML", 0, 0, 0, 3, 0, 0, 1, 4
"d:\IDEWORK\lvmen\src\licensedcode\data\rules\lgpl-2.1_11.yml", "YAML", 0, 0, 0, 3, 0, 0, 1, 4
"d:\IDEWORK\lvmen\src\licensedcode\data\rules\lgpl-2.1_110.yml", "YAML", 0, 0, 0, 4, 0, 0, 1, 5
"d:\IDEWORK\lvmen\src\licensedcode\data\rules\lgpl-2.1_111.yml", "YAML", 0, 0, 0, 5, 0, 0, 1, 6
"d:\IDEWORK\lvmen\src\licensedcode\data\rules\lgpl-2.1_112.yml", "YAML", 0, 0, 0, 3, 0, 0, 1, 4
"d:\IDEWORK\lvmen\src\licensedcode\data\rules\lgpl-2.1_113.yml", "YAML", 0, 0, 0, 3, 0, 0, 1, 4
"d:\IDEWORK\lvmen\src\licensedcode\data\rules\lgpl-2.1_114.yml", "YAML", 0, 0, 0, 5, 0, 0, 1, 6
"d:\IDEWORK\lvmen\src\licensedcode\data\rules\lgpl-2.1_115.yml", "YAML", 0, 0, 0, 5, 0, 0, 1, 6
"d:\IDEWORK\lvmen\src\licensedcode\data\rules\lgpl-2.1_116.yml", "YAML", 0, 0, 0, 6, 0, 0, 1, 7
"d:\IDEWORK\lvmen\src\licensedcode\data\rules\lgpl-2.1_117.yml", "YAML", 0, 0, 0, 5, 0, 0, 1, 6
"d:\IDEWORK\lvmen\src\licensedcode\data\rules\lgpl-2.1_118.yml", "YAML", 0, 0, 0, 3, 0, 0, 1, 4
"d:\IDEWORK\lvmen\src\licensedcode\data\rules\lgpl-2.1_119.yml", "YAML", 0, 0, 0, 3, 0, 0, 1, 4
"d:\IDEWORK\lvmen\src\licensedcode\data\rules\lgpl-2.1_12.yml", "YAML", 0, 0, 0, 5, 0, 0, 1, 6
"d:\IDEWORK\lvmen\src\licensedcode\data\rules\lgpl-2.1_120.yml", "YAML", 0, 0, 0, 3, 0, 0, 1, 4
"d:\IDEWORK\lvmen\src\licensedcode\data\rules\lgpl-2.1_121.yml", "YAML", 0, 0, 0, 5, 0, 0, 1, 6
"d:\IDEWORK\lvmen\src\licensedcode\data\rules\lgpl-2.1_122.yml", "YAML", 0, 0, 0, 5, 0, 0, 1, 6
"d:\IDEWORK\lvmen\src\licensedcode\data\rules\lgpl-2.1_123.yml", "YAML", 0, 0, 0, 3, 0, 0, 1, 4
"d:\IDEWORK\lvmen\src\licensedcode\data\rules\lgpl-2.1_124.yml", "YAML", 0, 0, 0, 3, 0, 0, 1, 4
"d:\IDEWORK\lvmen\src\licensedcode\data\rules\lgpl-2.1_125.yml", "YAML", 0, 0, 0, 3, 0, 0, 1, 4
"d:\IDEWORK\lvmen\src\licensedcode\data\rules\lgpl-2.1_126.yml", "YAML", 0, 0, 0, 3, 0, 0, 1, 4
"d:\IDEWORK\lvmen\src\licensedcode\data\rules\lgpl-2.1_127.yml", "YAML", 0, 0, 0, 3, 0, 0, 1, 4
"d:\IDEWORK\lvmen\src\licensedcode\data\rules\lgpl-2.1_128.yml", "YAML", 0, 0, 0, 3, 0, 0, 1, 4
"d:\IDEWORK\lvmen\src\licensedcode\data\rules\lgpl-2.1_129.yml", "YAML", 0, 0, 0, 3, 0, 0, 1, 4
"d:\IDEWORK\lvmen\src\licensedcode\data\rules\lgpl-2.1_13.yml", "YAML", 0, 0, 0, 6, 0, 0, 1, 7
"d:\IDEWORK\lvmen\src\licensedcode\data\rules\lgpl-2.1_130.yml", "YAML", 0, 0, 0, 3, 0, 0, 1, 4
"d:\IDEWORK\lvmen\src\licensedcode\data\rules\lgpl-2.1_131.yml", "YAML", 0, 0, 0, 3, 0, 0, 1, 4
"d:\IDEWORK\lvmen\src\licensedcode\data\rules\lgpl-2.1_132.yml", "YAML", 0, 0, 0, 3, 0, 0, 1, 4
"d:\IDEWORK\lvmen\src\licensedcode\data\rules\lgpl-2.1_133.yml", "YAML", 0, 0, 0, 3, 0, 0, 1, 4
"d:\IDEWORK\lvmen\src\licensedcode\data\rules\lgpl-2.1_134.yml", "YAML", 0, 0, 0, 3, 0, 0, 1, 4
"d:\IDEWORK\lvmen\src\licensedcode\data\rules\lgpl-2.1_135.yml", "YAML", 0, 0, 0, 3, 0, 0, 1, 4
"d:\IDEWORK\lvmen\src\licensedcode\data\rules\lgpl-2.1_136.yml", "YAML", 0, 0, 0, 3, 0, 0, 1, 4
"d:\IDEWORK\lvmen\src\licensedcode\data\rules\lgpl-2.1_137.yml", "YAML", 0, 0, 0, 3, 0, 0, 1, 4
"d:\IDEWORK\lvmen\src\licensedcode\data\rules\lgpl-2.1_138.yml", "YAML", 0, 0, 0, 3, 0, 0, 1, 4
"d:\IDEWORK\lvmen\src\licensedcode\data\rules\lgpl-2.1_139.yml", "YAML", 0, 0, 0, 3, 0, 0, 1, 4
"d:\IDEWORK\lvmen\src\licensedcode\data\rules\lgpl-2.1_14.yml", "YAML", 0, 0, 0, 5, 0, 0, 1, 6
"d:\IDEWORK\lvmen\src\licensedcode\data\rules\lgpl-2.1_140.yml", "YAML", 0, 0, 0, 3, 0, 0, 1, 4
"d:\IDEWORK\lvmen\src\licensedcode\data\rules\lgpl-2.1_141.yml", "YAML", 0, 0, 0, 3, 0, 0, 1, 4
"d:\IDEWORK\lvmen\src\licensedcode\data\rules\lgpl-2.1_142.yml", "YAML", 0, 0, 0, 3, 0, 0, 1, 4
"d:\IDEWORK\lvmen\src\licensedcode\data\rules\lgpl-2.1_143.yml", "YAML", 0, 0, 0, 5, 0, 0, 1, 6
"d:\IDEWORK\lvmen\src\licensedcode\data\rules\lgpl-2.1_144.yml", "YAML", 0, 0, 0, 5, 0, 0, 1, 6
"d:\IDEWORK\lvmen\src\licensedcode\data\rules\lgpl-2.1_145.yml", "YAML", 0, 0, 0, 5, 0, 0, 1, 6
"d:\IDEWORK\lvmen\src\licensedcode\data\rules\lgpl-2.1_146.yml", "YAML", 0, 0, 0, 5, 0, 0, 1, 6
"d:\IDEWORK\lvmen\src\licensedcode\data\rules\lgpl-2.1_147.yml", "YAML", 0, 0, 0, 5, 0, 0, 1, 6
"d:\IDEWORK\lvmen\src\licensedcode\data\rules\lgpl-2.1_148.yml", "YAML", 0, 0, 0, 5, 0, 0, 1, 6
"d:\IDEWORK\lvmen\src\licensedcode\data\rules\lgpl-2.1_149.yml", "YAML", 0, 0, 0, 5, 0, 0, 1, 6
"d:\IDEWORK\lvmen\src\licensedcode\data\rules\lgpl-2.1_15.yml", "YAML", 0, 0, 0, 7, 0, 0, 1, 8
"d:\IDEWORK\lvmen\src\licensedcode\data\rules\lgpl-2.1_150.yml", "YAML", 0, 0, 0, 3, 0, 0, 1, 4
"d:\IDEWORK\lvmen\src\licensedcode\data\rules\lgpl-2.1_151.yml", "YAML", 0, 0, 0, 5, 0, 0, 1, 6
"d:\IDEWORK\lvmen\src\licensedcode\data\rules\lgpl-2.1_152.yml", "YAML", 0, 0, 0, 5, 0, 0, 1, 6
"d:\IDEWORK\lvmen\src\licensedcode\data\rules\lgpl-2.1_153.yml", "YAML", 0, 0, 0, 3, 0, 0, 1, 4
"d:\IDEWORK\lvmen\src\licensedcode\data\rules\lgpl-2.1_154.yml", "YAML", 0, 0, 0, 5, 0, 0, 1, 6
"d:\IDEWORK\lvmen\src\licensedcode\data\rules\lgpl-2.1_155.yml", "YAML", 0, 0, 0, 5, 0, 0, 1, 6
"d:\IDEWORK\lvmen\src\licensedcode\data\rules\lgpl-2.1_156.yml", "YAML", 0, 0, 0, 3, 0, 0, 1, 4
"d:\IDEWORK\lvmen\src\licensedcode\data\rules\lgpl-2.1_157.yml", "YAML", 0, 0, 0, 3, 0, 0, 1, 4
"d:\IDEWORK\lvmen\src\licensedcode\data\rules\lgpl-2.1_158.yml", "YAML", 0, 0, 0, 3, 0, 0, 1, 4
"d:\IDEWORK\lvmen\src\licensedcode\data\rules\lgpl-2.1_159.yml", "YAML", 0, 0, 0, 3, 0, 0, 1, 4
"d:\IDEWORK\lvmen\src\licensedcode\data\rules\lgpl-2.1_16.yml", "YAML", 0, 0, 0, 8, 0, 0, 1, 9
"d:\IDEWORK\lvmen\src\licensedcode\data\rules\lgpl-2.1_160.yml", "YAML", 0, 0, 0, 3, 0, 0, 1, 4
"d:\IDEWORK\lvmen\src\licensedcode\data\rules\lgpl-2.1_161.yml", "YAML", 0, 0, 0, 3, 0, 0, 1, 4
"d:\IDEWORK\lvmen\src\licensedcode\data\rules\lgpl-2.1_162.yml", "YAML", 0, 0, 0, 3, 0, 0, 1, 4
"d:\IDEWORK\lvmen\src\licensedcode\data\rules\lgpl-2.1_163.yml", "YAML", 0, 0, 0, 5, 0, 0, 1, 6
"d:\IDEWORK\lvmen\src\licensedcode\data\rules\lgpl-2.1_164.yml", "YAML", 0, 0, 0, 5, 0, 0, 1, 6
"d:\IDEWORK\lvmen\src\licensedcode\data\rules\lgpl-2.1_165.yml", "YAML", 0, 0, 0, 5, 0, 0, 1, 6
"d:\IDEWORK\lvmen\src\licensedcode\data\rules\lgpl-2.1_166.yml", "YAML", 0, 0, 0, 5, 0, 0, 1, 6
"d:\IDEWORK\lvmen\src\licensedcode\data\rules\lgpl-2.1_167.yml", "YAML", 0, 0, 0, 5, 0, 0, 1, 6
"d:\IDEWORK\lvmen\src\licensedcode\data\rules\lgpl-2.1_168.yml", "YAML", 0, 0, 0, 5, 0, 0, 1, 6
"d:\IDEWORK\lvmen\src\licensedcode\data\rules\lgpl-2.1_169.yml", "YAML", 0, 0, 0, 5, 0, 0, 1, 6
"d:\IDEWORK\lvmen\src\licensedcode\data\rules\lgpl-2.1_17.yml", "YAML", 0, 0, 0, 3, 0, 0, 1, 4
"d:\IDEWORK\lvmen\src\licensedcode\data\rules\lgpl-2.1_170.yml", "YAML", 0, 0, 0, 5, 0, 0, 1, 6
"d:\IDEWORK\lvmen\src\licensedcode\data\rules\lgpl-2.1_171.yml", "YAML", 0, 0, 0, 5, 0, 0, 1, 6
"d:\IDEWORK\lvmen\src\licensedcode\data\rules\lgpl-2.1_172.yml", "YAML", 0, 0, 0, 5, 0, 0, 1, 6
"d:\IDEWORK\lvmen\src\licensedcode\data\rules\lgpl-2.1_173.yml", "YAML", 0, 0, 0, 5, 0, 0, 1, 6
"d:\IDEWORK\lvmen\src\licensedcode\data\rules\lgpl-2.1_174.yml", "YAML", 0, 0, 0, 5, 0, 0, 1, 6
"d:\IDEWORK\lvmen\src\licensedcode\data\rules\lgpl-2.1_175.yml", "YAML", 0, 0, 0, 5, 0, 0, 1, 6
"d:\IDEWORK\lvmen\src\licensedcode\data\rules\lgpl-2.1_176.yml", "YAML", 0, 0, 0, 5, 0, 0, 1, 6
"d:\IDEWORK\lvmen\src\licensedcode\data\rules\lgpl-2.1_177.yml", "YAML", 0, 0, 0, 5, 0, 0, 1, 6
"d:\IDEWORK\lvmen\src\licensedcode\data\rules\lgpl-2.1_178.yml", "YAML", 0, 0, 0, 3, 0, 0, 1, 4
"d:\IDEWORK\lvmen\src\licensedcode\data\rules\lgpl-2.1_179.yml", "YAML", 0, 0, 0, 3, 0, 0, 1, 4
"d:\IDEWORK\lvmen\src\licensedcode\data\rules\lgpl-2.1_18.yml", "YAML", 0, 0, 0, 5, 0, 0, 1, 6
"d:\IDEWORK\lvmen\src\licensedcode\data\rules\lgpl-2.1_180.yml", "YAML", 0, 0, 0, 5, 0, 0, 1, 6
"d:\IDEWORK\lvmen\src\licensedcode\data\rules\lgpl-2.1_181.yml", "YAML", 0, 0, 0, 3, 0, 0, 1, 4
"d:\IDEWORK\lvmen\src\licensedcode\data\rules\lgpl-2.1_182.yml", "YAML", 0, 0, 0, 5, 0, 0, 1, 6
"d:\IDEWORK\lvmen\src\licensedcode\data\rules\lgpl-2.1_183.yml", "YAML", 0, 0, 0, 5, 0, 0, 1, 6
"d:\IDEWORK\lvmen\src\licensedcode\data\rules\lgpl-2.1_184.yml", "YAML", 0, 0, 0, 6, 0, 0, 1, 7
"d:\IDEWORK\lvmen\src\licensedcode\data\rules\lgpl-2.1_185.yml", "YAML", 0, 0, 0, 3, 0, 0, 1, 4
"d:\IDEWORK\lvmen\src\licensedcode\data\rules\lgpl-2.1_186.yml", "YAML", 0, 0, 0, 5, 0, 0, 1, 6
"d:\IDEWORK\lvmen\src\licensedcode\data\rules\lgpl-2.1_187.yml", "YAML", 0, 0, 0, 3, 0, 0, 1, 4
"d:\IDEWORK\lvmen\src\licensedcode\data\rules\lgpl-2.1_188.yml", "YAML", 0, 0, 0, 3, 0, 0, 1, 4
"d:\IDEWORK\lvmen\src\licensedcode\data\rules\lgpl-2.1_189.yml", "YAML", 0, 0, 0, 3, 0, 0, 1, 4
"d:\IDEWORK\lvmen\src\licensedcode\data\rules\lgpl-2.1_19.yml", "YAML", 0, 0, 0, 4, 0, 0, 1, 5
"d:\IDEWORK\lvmen\src\licensedcode\data\rules\lgpl-2.1_190.yml", "YAML", 0, 0, 0, 9, 0, 0, 1, 10
"d:\IDEWORK\lvmen\src\licensedcode\data\rules\lgpl-2.1_191.yml", "YAML", 0, 0, 0, 3, 0, 0, 1, 4
"d:\IDEWORK\lvmen\src\licensedcode\data\rules\lgpl-2.1_192.yml", "YAML", 0, 0, 0, 3, 0, 0, 1, 4
"d:\IDEWORK\lvmen\src\licensedcode\data\rules\lgpl-2.1_193.yml", "YAML", 0, 0, 0, 3, 0, 0, 1, 4
"d:\IDEWORK\lvmen\src\licensedcode\data\rules\lgpl-2.1_194.yml", "YAML", 0, 0, 0, 3, 0, 0, 1, 4
"d:\IDEWORK\lvmen\src\licensedcode\data\rules\lgpl-2.1_195.yml", "YAML", 0, 0, 0, 3, 0, 0, 1, 4
"d:\IDEWORK\lvmen\src\licensedcode\data\rules\lgpl-2.1_196.yml", "YAML", 0, 0, 0, 4, 0, 0, 1, 5
"d:\IDEWORK\lvmen\src\licensedcode\data\rules\lgpl-2.1_197.yml", "YAML", 0, 0, 0, 3, 0, 0, 1, 4
"d:\IDEWORK\lvmen\src\licensedcode\data\rules\lgpl-2.1_198.yml", "YAML", 0, 0, 0, 3, 0, 0, 1, 4
"d:\IDEWORK\lvmen\src\licensedcode\data\rules\lgpl-2.1_199.yml", "YAML", 0, 0, 0, 5, 0, 0, 1, 6
"d:\IDEWORK\lvmen\src\licensedcode\data\rules\lgpl-2.1_1_xml.yml", "YAML", 0, 0, 0, 5, 0, 0, 1, 6
"d:\IDEWORK\lvmen\src\licensedcode\data\rules\lgpl-2.1_1_xml2.yml", "YAML", 0, 0, 0, 5, 0, 0, 1, 6
"d:\IDEWORK\lvmen\src\licensedcode\data\rules\lgpl-2.1_1_xml3.yml", "YAML", 0, 0, 0, 5, 0, 0, 1, 6
"d:\IDEWORK\lvmen\src\licensedcode\data\rules\lgpl-2.1_1_xml4.yml", "YAML", 0, 0, 0, 5, 0, 0, 1, 6
"d:\IDEWORK\lvmen\src\licensedcode\data\rules\lgpl-2.1_2.yml", "YAML", 0, 0, 0, 3, 0, 0, 1, 4
"d:\IDEWORK\lvmen\src\licensedcode\data\rules\lgpl-2.1_20.yml", "YAML", 0, 0, 0, 5, 0, 0, 1, 6
"d:\IDEWORK\lvmen\src\licensedcode\data\rules\lgpl-2.1_200.yml", "YAML", 0, 0, 0, 3, 0, 0, 1, 4
"d:\IDEWORK\lvmen\src\licensedcode\data\rules\lgpl-2.1_201.yml", "YAML", 0, 0, 0, 3, 0, 0, 1, 4
"d:\IDEWORK\lvmen\src\licensedcode\data\rules\lgpl-2.1_202.yml", "YAML", 0, 0, 0, 3, 0, 0, 1, 4
"d:\IDEWORK\lvmen\src\licensedcode\data\rules\lgpl-2.1_203.yml", "YAML", 0, 0, 0, 5, 0, 0, 1, 6
"d:\IDEWORK\lvmen\src\licensedcode\data\rules\lgpl-2.1_204.yml", "YAML", 0, 0, 0, 5, 0, 0, 1, 6
"d:\IDEWORK\lvmen\src\licensedcode\data\rules\lgpl-2.1_205.yml", "YAML", 0, 0, 0, 6, 0, 0, 1, 7
"d:\IDEWORK\lvmen\src\licensedcode\data\rules\lgpl-2.1_206.yml", "YAML", 0, 0, 0, 6, 0, 0, 1, 7
"d:\IDEWORK\lvmen\src\licensedcode\data\rules\lgpl-2.1_207.yml", "YAML", 0, 0, 0, 5, 0, 0, 1, 6
"d:\IDEWORK\lvmen\src\licensedcode\data\rules\lgpl-2.1_208.yml", "YAML", 0, 0, 0, 5, 0, 0, 1, 6
"d:\IDEWORK\lvmen\src\licensedcode\data\rules\lgpl-2.1_209.yml", "YAML", 0, 0, 0, 5, 0, 0, 1, 6
"d:\IDEWORK\lvmen\src\licensedcode\data\rules\lgpl-2.1_21.yml", "YAML", 0, 0, 0, 5, 0, 0, 1, 6
"d:\IDEWORK\lvmen\src\licensedcode\data\rules\lgpl-2.1_210.yml", "YAML", 0, 0, 0, 5, 0, 0, 1, 6
"d:\IDEWORK\lvmen\src\licensedcode\data\rules\lgpl-2.1_211.yml", "YAML", 0, 0, 0, 5, 0, 0, 1, 6
"d:\IDEWORK\lvmen\src\licensedcode\data\rules\lgpl-2.1_212.yml", "YAML", 0, 0, 0, 6, 0, 0, 1, 7
"d:\IDEWORK\lvmen\src\licensedcode\data\rules\lgpl-2.1_213.yml", "YAML", 0, 0, 0, 6, 0, 0, 1, 7
"d:\IDEWORK\lvmen\src\licensedcode\data\rules\lgpl-2.1_214.yml", "YAML", 0, 0, 0, 4, 0, 0, 1, 5
"d:\IDEWORK\lvmen\src\licensedcode\data\rules\lgpl-2.1_215.yml", "YAML", 0, 0, 0, 5, 0, 0, 1, 6
"d:\IDEWORK\lvmen\src\licensedcode\data\rules\lgpl-2.1_216.yml", "YAML", 0, 0, 0, 5, 0, 0, 1, 6
"d:\IDEWORK\lvmen\src\licensedcode\data\rules\lgpl-2.1_217.yml", "YAML", 0, 0, 0, 5, 0, 0, 1, 6
"d:\IDEWORK\lvmen\src\licensedcode\data\rules\lgpl-2.1_218.yml", "YAML", 0, 0, 0, 3, 0, 0, 1, 4
"d:\IDEWORK\lvmen\src\licensedcode\data\rules\lgpl-2.1_219.yml", "YAML", 0, 0, 0, 3, 0, 0, 1, 4
"d:\IDEWORK\lvmen\src\licensedcode\data\rules\lgpl-2.1_22.yml", "YAML", 0, 0, 0, 2, 0, 0, 1, 3
"d:\IDEWORK\lvmen\src\licensedcode\data\rules\lgpl-2.1_220.yml", "YAML", 0, 0, 0, 5, 0, 0, 1, 6
"d:\IDEWORK\lvmen\src\licensedcode\data\rules\lgpl-2.1_221.yml", "YAML", 0, 0, 0, 3, 0, 0, 1, 4
"d:\IDEWORK\lvmen\src\licensedcode\data\rules\lgpl-2.1_222.yml", "YAML", 0, 0, 0, 3, 0, 0, 1, 4
"d:\IDEWORK\lvmen\src\licensedcode\data\rules\lgpl-2.1_223.yml", "YAML", 0, 0, 0, 5, 0, 0, 1, 6
"d:\IDEWORK\lvmen\src\licensedcode\data\rules\lgpl-2.1_224.yml", "YAML", 0, 0, 0, 3, 0, 0, 1, 4
"d:\IDEWORK\lvmen\src\licensedcode\data\rules\lgpl-2.1_225.yml", "YAML", 0, 0, 0, 3, 0, 0, 1, 4
"d:\IDEWORK\lvmen\src\licensedcode\data\rules\lgpl-2.1_226.yml", "YAML", 0, 0, 0, 3, 0, 0, 1, 4
"d:\IDEWORK\lvmen\src\licensedcode\data\rules\lgpl-2.1_227.yml", "YAML", 0, 0, 0, 4, 0, 0, 1, 5
"d:\IDEWORK\lvmen\src\licensedcode\data\rules\lgpl-2.1_228.yml", "YAML", 0, 0, 0, 11, 0, 0, 1, 12
"d:\IDEWORK\lvmen\src\licensedcode\data\rules\lgpl-2.1_229.yml", "YAML", 0, 0, 0, 3, 0, 0, 1, 4
"d:\IDEWORK\lvmen\src\licensedcode\data\rules\lgpl-2.1_23.yml", "YAML", 0, 0, 0, 9, 0, 0, 1, 10
"d:\IDEWORK\lvmen\src\licensedcode\data\rules\lgpl-2.1_230.yml", "YAML", 0, 0, 0, 3, 0, 0, 1, 4
"d:\IDEWORK\lvmen\src\licensedcode\data\rules\lgpl-2.1_231.yml", "YAML", 0, 0, 0, 3, 0, 0, 1, 4
"d:\IDEWORK\lvmen\src\licensedcode\data\rules\lgpl-2.1_232.yml", "YAML", 0, 0, 0, 3, 0, 0, 1, 4
"d:\IDEWORK\lvmen\src\licensedcode\data\rules\lgpl-2.1_233.yml", "YAML", 0, 0, 0, 3, 0, 0, 1, 4
"d:\IDEWORK\lvmen\src\licensedcode\data\rules\lgpl-2.1_234.yml", "YAML", 0, 0, 0, 3, 0, 0, 1, 4
"d:\IDEWORK\lvmen\src\licensedcode\data\rules\lgpl-2.1_235.yml", "YAML", 0, 0, 0, 3, 0, 0, 1, 4
"d:\IDEWORK\lvmen\src\licensedcode\data\rules\lgpl-2.1_236.yml", "YAML", 0, 0, 0, 3, 0, 0, 1, 4
"d:\IDEWORK\lvmen\src\licensedcode\data\rules\lgpl-2.1_237.yml", "YAML", 0, 0, 0, 3, 0, 0, 1, 4
"d:\IDEWORK\lvmen\src\licensedcode\data\rules\lgpl-2.1_238.yml", "YAML", 0, 0, 0, 3, 0, 0, 1, 4
"d:\IDEWORK\lvmen\src\licensedcode\data\rules\lgpl-2.1_239.yml", "YAML", 0, 0, 0, 3, 0, 0, 1, 4
"d:\IDEWORK\lvmen\src\licensedcode\data\rules\lgpl-2.1_24.yml", "YAML", 0, 0, 0, 3, 0, 0, 1, 4
"d:\IDEWORK\lvmen\src\licensedcode\data\rules\lgpl-2.1_240.yml", "YAML", 0, 0, 0, 3, 0, 0, 1, 4
"d:\IDEWORK\lvmen\src\licensedcode\data\rules\lgpl-2.1_241.yml", "YAML", 0, 0, 0, 3, 0, 0, 1, 4
"d:\IDEWORK\lvmen\src\licensedcode\data\rules\lgpl-2.1_242.yml", "YAML", 0, 0, 0, 3, 0, 0, 1, 4
"d:\IDEWORK\lvmen\src\licensedcode\data\rules\lgpl-2.1_243.yml", "YAML", 0, 0, 0, 3, 0, 0, 1, 4
"d:\IDEWORK\lvmen\src\licensedcode\data\rules\lgpl-2.1_244.yml", "YAML", 0, 0, 0, 6, 0, 0, 1, 7
"d:\IDEWORK\lvmen\src\licensedcode\data\rules\lgpl-2.1_245.yml", "YAML", 0, 0, 0, 3, 0, 0, 1, 4
"d:\IDEWORK\lvmen\src\licensedcode\data\rules\lgpl-2.1_246.yml", "YAML", 0, 0, 0, 5, 0, 0, 1, 6
"d:\IDEWORK\lvmen\src\licensedcode\data\rules\lgpl-2.1_247.yml", "YAML", 0, 0, 0, 3, 0, 0, 1, 4
"d:\IDEWORK\lvmen\src\licensedcode\data\rules\lgpl-2.1_248.yml", "YAML", 0, 0, 0, 3, 0, 0, 1, 4
"d:\IDEWORK\lvmen\src\licensedcode\data\rules\lgpl-2.1_249.yml", "YAML", 0, 0, 0, 3, 0, 0, 1, 4
"d:\IDEWORK\lvmen\src\licensedcode\data\rules\lgpl-2.1_25.yml", "YAML", 0, 0, 0, 5, 0, 0, 1, 6
"d:\IDEWORK\lvmen\src\licensedcode\data\rules\lgpl-2.1_250.yml", "YAML", 0, 0, 0, 5, 0, 0, 1, 6
"d:\IDEWORK\lvmen\src\licensedcode\data\rules\lgpl-2.1_251.yml", "YAML", 0, 0, 0, 3, 0, 0, 1, 4
"d:\IDEWORK\lvmen\src\licensedcode\data\rules\lgpl-2.1_252.yml", "YAML", 0, 0, 0, 3, 0, 0, 1, 4
"d:\IDEWORK\lvmen\src\licensedcode\data\rules\lgpl-2.1_253.yml", "YAML", 0, 0, 0, 3, 0, 0, 1, 4
"d:\IDEWORK\lvmen\src\licensedcode\data\rules\lgpl-2.1_254.yml", "YAML", 0, 0, 0, 3, 0, 0, 1, 4
"d:\IDEWORK\lvmen\src\licensedcode\data\rules\lgpl-2.1_255.yml", "YAML", 0, 0, 0, 3, 0, 0, 1, 4
"d:\IDEWORK\lvmen\src\licensedcode\data\rules\lgpl-2.1_256.yml", "YAML", 0, 0, 0, 3, 0, 0, 1, 4
"d:\IDEWORK\lvmen\src\licensedcode\data\rules\lgpl-2.1_257.yml", "YAML", 0, 0, 0, 3, 0, 0, 1, 4
"d:\IDEWORK\lvmen\src\licensedcode\data\rules\lgpl-2.1_258.yml", "YAML", 0, 0, 0, 3, 0, 0, 1, 4
"d:\IDEWORK\lvmen\src\licensedcode\data\rules\lgpl-2.1_259.yml", "YAML", 0, 0, 0, 3, 0, 0, 1, 4
"d:\IDEWORK\lvmen\src\licensedcode\data\rules\lgpl-2.1_26.yml", "YAML", 0, 0, 0, 8, 0, 0, 1, 9
"d:\IDEWORK\lvmen\src\licensedcode\data\rules\lgpl-2.1_260.yml", "YAML", 0, 0, 0, 3, 0, 0, 1, 4
"d:\IDEWORK\lvmen\src\licensedcode\data\rules\lgpl-2.1_261.yml", "YAML", 0, 0, 0, 3, 0, 0, 1, 4
"d:\IDEWORK\lvmen\src\licensedcode\data\rules\lgpl-2.1_262.yml", "YAML", 0, 0, 0, 3, 0, 0, 1, 4
"d:\IDEWORK\lvmen\src\licensedcode\data\rules\lgpl-2.1_263.yml", "YAML", 0, 0, 0, 3, 0, 0, 1, 4
"d:\IDEWORK\lvmen\src\licensedcode\data\rules\lgpl-2.1_264.yml", "YAML", 0, 0, 0, 3, 0, 0, 1, 4
"d:\IDEWORK\lvmen\src\licensedcode\data\rules\lgpl-2.1_265.yml", "YAML", 0, 0, 0, 3, 0, 0, 1, 4
"d:\IDEWORK\lvmen\src\licensedcode\data\rules\lgpl-2.1_266.yml", "YAML", 0, 0, 0, 3, 0, 0, 1, 4
"d:\IDEWORK\lvmen\src\licensedcode\data\rules\lgpl-2.1_267.yml", "YAML", 0, 0, 0, 3, 0, 0, 1, 4
"d:\IDEWORK\lvmen\src\licensedcode\data\rules\lgpl-2.1_268.yml", "YAML", 0, 0, 0, 3, 0, 0, 1, 4
"d:\IDEWORK\lvmen\src\licensedcode\data\rules\lgpl-2.1_269.yml", "YAML", 0, 0, 0, 3, 0, 0, 1, 4
"d:\IDEWORK\lvmen\src\licensedcode\data\rules\lgpl-2.1_27.yml", "YAML", 0, 0, 0, 9, 0, 0, 1, 10
"d:\IDEWORK\lvmen\src\licensedcode\data\rules\lgpl-2.1_270.yml", "YAML", 0, 0, 0, 3, 0, 0, 1, 4
"d:\IDEWORK\lvmen\src\licensedcode\data\rules\lgpl-2.1_271.yml", "YAML", 0, 0, 0, 3, 0, 0, 1, 4
"d:\IDEWORK\lvmen\src\licensedcode\data\rules\lgpl-2.1_272.yml", "YAML", 0, 0, 0, 3, 0, 0, 1, 4
"d:\IDEWORK\lvmen\src\licensedcode\data\rules\lgpl-2.1_273.yml", "YAML", 0, 0, 0, 3, 0, 0, 1, 4
"d:\IDEWORK\lvmen\src\licensedcode\data\rules\lgpl-2.1_274.yml", "YAML", 0, 0, 0, 3, 0, 0, 1, 4
"d:\IDEWORK\lvmen\src\licensedcode\data\rules\lgpl-2.1_275.yml", "YAML", 0, 0, 0, 3, 0, 0, 1, 4
"d:\IDEWORK\lvmen\src\licensedcode\data\rules\lgpl-2.1_276.yml", "YAML", 0, 0, 0, 3, 0, 0, 1, 4
"d:\IDEWORK\lvmen\src\licensedcode\data\rules\lgpl-2.1_277.yml", "YAML", 0, 0, 0, 3, 0, 0, 1, 4
"d:\IDEWORK\lvmen\src\licensedcode\data\rules\lgpl-2.1_278.yml", "YAML", 0, 0, 0, 3, 0, 0, 1, 4
"d:\IDEWORK\lvmen\src\licensedcode\data\rules\lgpl-2.1_279.yml", "YAML", 0, 0, 0, 3, 0, 0, 1, 4
"d:\IDEWORK\lvmen\src\licensedcode\data\rules\lgpl-2.1_28.yml", "YAML", 0, 0, 0, 6, 0, 0, 1, 7
"d:\IDEWORK\lvmen\src\licensedcode\data\rules\lgpl-2.1_280.yml", "YAML", 0, 0, 0, 3, 0, 0, 1, 4
"d:\IDEWORK\lvmen\src\licensedcode\data\rules\lgpl-2.1_281.yml", "YAML", 0, 0, 0, 3, 0, 0, 1, 4
"d:\IDEWORK\lvmen\src\licensedcode\data\rules\lgpl-2.1_282.yml", "YAML", 0, 0, 0, 3, 0, 0, 1, 4
"d:\IDEWORK\lvmen\src\licensedcode\data\rules\lgpl-2.1_283.yml", "YAML", 0, 0, 0, 3, 0, 0, 1, 4
"d:\IDEWORK\lvmen\src\licensedcode\data\rules\lgpl-2.1_284.yml", "YAML", 0, 0, 0, 3, 0, 0, 1, 4
"d:\IDEWORK\lvmen\src\licensedcode\data\rules\lgpl-2.1_285.yml", "YAML", 0, 0, 0, 3, 0, 0, 1, 4
"d:\IDEWORK\lvmen\src\licensedcode\data\rules\lgpl-2.1_286.yml", "YAML", 0, 0, 0, 5, 0, 0, 1, 6
"d:\IDEWORK\lvmen\src\licensedcode\data\rules\lgpl-2.1_287.yml", "YAML", 0, 0, 0, 3, 0, 0, 1, 4
"d:\IDEWORK\lvmen\src\licensedcode\data\rules\lgpl-2.1_288.yml", "YAML", 0, 0, 0, 3, 0, 0, 1, 4
"d:\IDEWORK\lvmen\src\licensedcode\data\rules\lgpl-2.1_289.yml", "YAML", 0, 0, 0, 3, 0, 0, 1, 4
"d:\IDEWORK\lvmen\src\licensedcode\data\rules\lgpl-2.1_29.yml", "YAML", 0, 0, 0, 5, 0, 0, 1, 6
"d:\IDEWORK\lvmen\src\licensedcode\data\rules\lgpl-2.1_290.yml", "YAML", 0, 0, 0, 3, 0, 0, 1, 4
"d:\IDEWORK\lvmen\src\licensedcode\data\rules\lgpl-2.1_291.yml", "YAML", 0, 0, 0, 3, 0, 0, 1, 4
"d:\IDEWORK\lvmen\src\licensedcode\data\rules\lgpl-2.1_292.yml", "YAML", 0, 0, 0, 6, 0, 0, 1, 7
"d:\IDEWORK\lvmen\src\licensedcode\data\rules\lgpl-2.1_293.yml", "YAML", 0, 0, 0, 5, 0, 0, 1, 6
"d:\IDEWORK\lvmen\src\licensedcode\data\rules\lgpl-2.1_294.yml", "YAML", 0, 0, 0, 5, 0, 0, 1, 6
"d:\IDEWORK\lvmen\src\licensedcode\data\rules\lgpl-2.1_295.yml", "YAML", 0, 0, 0, 3, 0, 0, 1, 4
"d:\IDEWORK\lvmen\src\licensedcode\data\rules\lgpl-2.1_296.yml", "YAML", 0, 0, 0, 10, 0, 0, 1, 11
"d:\IDEWORK\lvmen\src\licensedcode\data\rules\lgpl-2.1_297.yml", "YAML", 0, 0, 0, 3, 0, 0, 1, 4
"d:\IDEWORK\lvmen\src\licensedcode\data\rules\lgpl-2.1_298.yml", "YAML", 0, 0, 0, 3, 0, 0, 1, 4
"d:\IDEWORK\lvmen\src\licensedcode\data\rules\lgpl-2.1_299.yml", "YAML", 0, 0, 0, 3, 0, 0, 1, 4
"d:\IDEWORK\lvmen\src\licensedcode\data\rules\lgpl-2.1_3.yml", "YAML", 0, 0, 0, 4, 0, 0, 1, 5
"d:\IDEWORK\lvmen\src\licensedcode\data\rules\lgpl-2.1_30.yml", "YAML", 0, 0, 0, 6, 0, 0, 1, 7
"d:\IDEWORK\lvmen\src\licensedcode\data\rules\lgpl-2.1_300.yml", "YAML", 0, 0, 0, 3, 0, 0, 1, 4
"d:\IDEWORK\lvmen\src\licensedcode\data\rules\lgpl-2.1_301.yml", "YAML", 0, 0, 0, 3, 0, 0, 1, 4
"d:\IDEWORK\lvmen\src\licensedcode\data\rules\lgpl-2.1_302.yml", "YAML", 0, 0, 0, 2, 0, 0, 1, 3
"d:\IDEWORK\lvmen\src\licensedcode\data\rules\lgpl-2.1_303.yml", "YAML", 0, 0, 0, 2, 0, 0, 1, 3
"d:\IDEWORK\lvmen\src\licensedcode\data\rules\lgpl-2.1_304.yml", "YAML", 0, 0, 0, 4, 0, 0, 1, 5
"d:\IDEWORK\lvmen\src\licensedcode\data\rules\lgpl-2.1_305.yml", "YAML", 0, 0, 0, 3, 0, 0, 1, 4
"d:\IDEWORK\lvmen\src\licensedcode\data\rules\lgpl-2.1_306.yml", "YAML", 0, 0, 0, 4, 0, 0, 1, 5
"d:\IDEWORK\lvmen\src\licensedcode\data\rules\lgpl-2.1_307.yml", "YAML", 0, 0, 0, 4, 0, 0, 1, 5
"d:\IDEWORK\lvmen\src\licensedcode\data\rules\lgpl-2.1_308.yml", "YAML", 0, 0, 0, 4, 0, 0, 1, 5
"d:\IDEWORK\lvmen\src\licensedcode\data\rules\lgpl-2.1_309.yml", "YAML", 0, 0, 0, 3, 0, 0, 1, 4
"d:\IDEWORK\lvmen\src\licensedcode\data\rules\lgpl-2.1_31.yml", "YAML", 0, 0, 0, 6, 0, 0, 1, 7
"d:\IDEWORK\lvmen\src\licensedcode\data\rules\lgpl-2.1_310.yml", "YAML", 0, 0, 0, 3, 0, 0, 1, 4
"d:\IDEWORK\lvmen\src\licensedcode\data\rules\lgpl-2.1_311.yml", "YAML", 0, 0, 0, 2, 0, 0, 1, 3
"d:\IDEWORK\lvmen\src\licensedcode\data\rules\lgpl-2.1_312.yml", "YAML", 0, 0, 0, 4, 0, 0, 1, 5
"d:\IDEWORK\lvmen\src\licensedcode\data\rules\lgpl-2.1_313.yml", "YAML", 0, 0, 0, 7, 0, 0, 1, 8
"d:\IDEWORK\lvmen\src\licensedcode\data\rules\lgpl-2.1_314.yml", "YAML", 0, 0, 0, 4, 0, 0, 1, 5
"d:\IDEWORK\lvmen\src\licensedcode\data\rules\lgpl-2.1_315.yml", "YAML", 0, 0, 0, 3, 0, 0, 1, 4
"d:\IDEWORK\lvmen\src\licensedcode\data\rules\lgpl-2.1_316.yml", "YAML", 0, 0, 0, 4, 0, 0, 1, 5
"d:\IDEWORK\lvmen\src\licensedcode\data\rules\lgpl-2.1_317.yml", "YAML", 0, 0, 0, 5, 0, 0, 1, 6
"d:\IDEWORK\lvmen\src\licensedcode\data\rules\lgpl-2.1_318.yml", "YAML", 0, 0, 0, 3, 0, 0, 1, 4
"d:\IDEWORK\lvmen\src\licensedcode\data\rules\lgpl-2.1_319.yml", "YAML", 0, 0, 0, 6, 0, 0, 1, 7
"d:\IDEWORK\lvmen\src\licensedcode\data\rules\lgpl-2.1_32.yml", "YAML", 0, 0, 0, 2, 0, 0, 1, 3
"d:\IDEWORK\lvmen\src\licensedcode\data\rules\lgpl-2.1_320.yml", "YAML", 0, 0, 0, 5, 0, 0, 1, 6
"d:\IDEWORK\lvmen\src\licensedcode\data\rules\lgpl-2.1_321.yml", "YAML", 0, 0, 0, 6, 0, 0, 1, 7
"d:\IDEWORK\lvmen\src\licensedcode\data\rules\lgpl-2.1_322.yml", "YAML", 0, 0, 0, 5, 0, 0, 1, 6
"d:\IDEWORK\lvmen\src\licensedcode\data\rules\lgpl-2.1_323.yml", "YAML", 0, 0, 0, 5, 0, 0, 1, 6
"d:\IDEWORK\lvmen\src\licensedcode\data\rules\lgpl-2.1_324.yml", "YAML", 0, 0, 0, 8, 0, 0, 1, 9
"d:\IDEWORK\lvmen\src\licensedcode\data\rules\lgpl-2.1_325.yml", "YAML", 0, 0, 0, 3, 0, 0, 1, 4
"d:\IDEWORK\lvmen\src\licensedcode\data\rules\lgpl-2.1_326.yml", "YAML", 0, 0, 0, 5, 0, 0, 1, 6
"d:\IDEWORK\lvmen\src\licensedcode\data\rules\lgpl-2.1_327.yml", "YAML", 0, 0, 0, 5, 0, 0, 1, 6
"d:\IDEWORK\lvmen\src\licensedcode\data\rules\lgpl-2.1_328.yml", "YAML", 0, 0, 0, 5, 0, 0, 1, 6
"d:\IDEWORK\lvmen\src\licensedcode\data\rules\lgpl-2.1_329.yml", "YAML", 0, 0, 0, 6, 0, 0, 1, 7
"d:\IDEWORK\lvmen\src\licensedcode\data\rules\lgpl-2.1_33.yml", "YAML", 0, 0, 0, 8, 0, 0, 1, 9
"d:\IDEWORK\lvmen\src\licensedcode\data\rules\lgpl-2.1_330.yml", "YAML", 0, 0, 0, 6, 0, 0, 1, 7
"d:\IDEWORK\lvmen\src\licensedcode\data\rules\lgpl-2.1_331.yml", "YAML", 0, 0, 0, 5, 0, 0, 1, 6
"d:\IDEWORK\lvmen\src\licensedcode\data\rules\lgpl-2.1_332.yml", "YAML", 0, 0, 0, 8, 0, 0, 1, 9
"d:\IDEWORK\lvmen\src\licensedcode\data\rules\lgpl-2.1_333.yml", "YAML", 0, 0, 0, 5, 0, 0, 1, 6
"d:\IDEWORK\lvmen\src\licensedcode\data\rules\lgpl-2.1_334.yml", "YAML", 0, 0, 0, 5, 0, 0, 1, 6
"d:\IDEWORK\lvmen\src\licensedcode\data\rules\lgpl-2.1_335.yml", "YAML", 0, 0, 0, 5, 0, 0, 1, 6
"d:\IDEWORK\lvmen\src\licensedcode\data\rules\lgpl-2.1_336.yml", "YAML", 0, 0, 0, 7, 0, 0, 1, 8
"d:\IDEWORK\lvmen\src\licensedcode\data\rules\lgpl-2.1_337.yml", "YAML", 0, 0, 0, 6, 0, 0, 1, 7
"d:\IDEWORK\lvmen\src\licensedcode\data\rules\lgpl-2.1_338.yml", "YAML", 0, 0, 0, 6, 0, 0, 1, 7
"d:\IDEWORK\lvmen\src\licensedcode\data\rules\lgpl-2.1_339.yml", "YAML", 0, 0, 0, 5, 0, 0, 1, 6
"d:\IDEWORK\lvmen\src\licensedcode\data\rules\lgpl-2.1_34.yml", "YAML", 0, 0, 0, 4, 0, 0, 1, 5
"d:\IDEWORK\lvmen\src\licensedcode\data\rules\lgpl-2.1_340.yml", "YAML", 0, 0, 0, 5, 0, 0, 1, 6
"d:\IDEWORK\lvmen\src\licensedcode\data\rules\lgpl-2.1_341.yml", "YAML", 0, 0, 0, 5, 0, 0, 1, 6
"d:\IDEWORK\lvmen\src\licensedcode\data\rules\lgpl-2.1_342.yml", "YAML", 0, 0, 0, 5, 0, 0, 1, 6
"d:\IDEWORK\lvmen\src\licensedcode\data\rules\lgpl-2.1_343.yml", "YAML", 0, 0, 0, 6, 0, 0, 1, 7
"d:\IDEWORK\lvmen\src\licensedcode\data\rules\lgpl-2.1_344.yml", "YAML", 0, 0, 0, 6, 0, 0, 1, 7
"d:\IDEWORK\lvmen\src\licensedcode\data\rules\lgpl-2.1_345.yml", "YAML", 0, 0, 0, 5, 0, 0, 1, 6
"d:\IDEWORK\lvmen\src\licensedcode\data\rules\lgpl-2.1_346.yml", "YAML", 0, 0, 0, 5, 0, 0, 1, 6
"d:\IDEWORK\lvmen\src\licensedcode\data\rules\lgpl-2.1_347.yml", "YAML", 0, 0, 0, 8, 0, 0, 1, 9
"d:\IDEWORK\lvmen\src\licensedcode\data\rules\lgpl-2.1_348.yml", "YAML", 0, 0, 0, 6, 0, 0, 1, 7
"d:\IDEWORK\lvmen\src\licensedcode\data\rules\lgpl-2.1_349.yml", "YAML", 0, 0, 0, 8, 0, 0, 1, 9
"d:\IDEWORK\lvmen\src\licensedcode\data\rules\lgpl-2.1_35.yml", "YAML", 0, 0, 0, 4, 0, 0, 1, 5
"d:\IDEWORK\lvmen\src\licensedcode\data\rules\lgpl-2.1_350.yml", "YAML", 0, 0, 0, 5, 0, 0, 1, 6
"d:\IDEWORK\lvmen\src\licensedcode\data\rules\lgpl-2.1_351.yml", "YAML", 0, 0, 0, 5, 0, 0, 1, 6
"d:\IDEWORK\lvmen\src\licensedcode\data\rules\lgpl-2.1_352.yml", "YAML", 0, 0, 0, 5, 0, 0, 1, 6
"d:\IDEWORK\lvmen\src\licensedcode\data\rules\lgpl-2.1_353.yml", "YAML", 0, 0, 0, 5, 0, 0, 1, 6
"d:\IDEWORK\lvmen\src\licensedcode\data\rules\lgpl-2.1_354.yml", "YAML", 0, 0, 0, 6, 0, 0, 1, 7
"d:\IDEWORK\lvmen\src\licensedcode\data\rules\lgpl-2.1_355.yml", "YAML", 0, 0, 0, 5, 0, 0, 1, 6
"d:\IDEWORK\lvmen\src\licensedcode\data\rules\lgpl-2.1_356.yml", "YAML", 0, 0, 0, 9, 0, 0, 1, 10
"d:\IDEWORK\lvmen\src\licensedcode\data\rules\lgpl-2.1_357.yml", "YAML", 0, 0, 0, 5, 0, 0, 1, 6
"d:\IDEWORK\lvmen\src\licensedcode\data\rules\lgpl-2.1_358.yml", "YAML", 0, 0, 0, 6, 0, 0, 1, 7
"d:\IDEWORK\lvmen\src\licensedcode\data\rules\lgpl-2.1_359.yml", "YAML", 0, 0, 0, 5, 0, 0, 1, 6
"d:\IDEWORK\lvmen\src\licensedcode\data\rules\lgpl-2.1_36.yml", "YAML", 0, 0, 0, 4, 0, 0, 1, 5
"d:\IDEWORK\lvmen\src\licensedcode\data\rules\lgpl-2.1_360.yml", "YAML", 0, 0, 0, 5, 0, 0, 1, 6
"d:\IDEWORK\lvmen\src\licensedcode\data\rules\lgpl-2.1_361.yml", "YAML", 0, 0, 0, 5, 0, 0, 1, 6
"d:\IDEWORK\lvmen\src\licensedcode\data\rules\lgpl-2.1_362.yml", "YAML", 0, 0, 0, 6, 0, 0, 1, 7
"d:\IDEWORK\lvmen\src\licensedcode\data\rules\lgpl-2.1_363.yml", "YAML", 0, 0, 0, 5, 0, 0, 1, 6
"d:\IDEWORK\lvmen\src\licensedcode\data\rules\lgpl-2.1_364.yml", "YAML", 0, 0, 0, 5, 0, 0, 1, 6
"d:\IDEWORK\lvmen\src\licensedcode\data\rules\lgpl-2.1_365.yml", "YAML", 0, 0, 0, 5, 0, 0, 1, 6
"d:\IDEWORK\lvmen\src\licensedcode\data\rules\lgpl-2.1_366.yml", "YAML", 0, 0, 0, 6, 0, 0, 1, 7
"d:\IDEWORK\lvmen\src\licensedcode\data\rules\lgpl-2.1_367.yml", "YAML", 0, 0, 0, 4, 0, 0, 1, 5
"d:\IDEWORK\lvmen\src\licensedcode\data\rules\lgpl-2.1_368.yml", "YAML", 0, 0, 0, 6, 0, 0, 1, 7
"d:\IDEWORK\lvmen\src\licensedcode\data\rules\lgpl-2.1_369.yml", "YAML", 0, 0, 0, 7, 0, 0, 1, 8
"d:\IDEWORK\lvmen\src\licensedcode\data\rules\lgpl-2.1_37.yml", "YAML", 0, 0, 0, 5, 0, 0, 1, 6
"d:\IDEWORK\lvmen\src\licensedcode\data\rules\lgpl-2.1_370.yml", "YAML", 0, 0, 0, 5, 0, 0, 1, 6
"d:\IDEWORK\lvmen\src\licensedcode\data\rules\lgpl-2.1_371.yml", "YAML", 0, 0, 0, 4, 0, 0, 1, 5
"d:\IDEWORK\lvmen\src\licensedcode\data\rules\lgpl-2.1_372.yml", "YAML", 0, 0, 0, 4, 0, 0, 1, 5
"d:\IDEWORK\lvmen\src\licensedcode\data\rules\lgpl-2.1_373.yml", "YAML", 0, 0, 0, 3, 0, 0, 1, 4
"d:\IDEWORK\lvmen\src\licensedcode\data\rules\lgpl-2.1_374.yml", "YAML", 0, 0, 0, 3, 0, 0, 1, 4
"d:\IDEWORK\lvmen\src\licensedcode\data\rules\lgpl-2.1_375.yml", "YAML", 0, 0, 0, 6, 0, 0, 1, 7
"d:\IDEWORK\lvmen\src\licensedcode\data\rules\lgpl-2.1_376.yml", "YAML", 0, 0, 0, 8, 0, 0, 1, 9
"d:\IDEWORK\lvmen\src\licensedcode\data\rules\lgpl-2.1_377.yml", "YAML", 0, 0, 0, 5, 0, 0, 1, 6
"d:\IDEWORK\lvmen\src\licensedcode\data\rules\lgpl-2.1_378.yml", "YAML", 0, 0, 0, 7, 0, 0, 1, 8
"d:\IDEWORK\lvmen\src\licensedcode\data\rules\lgpl-2.1_379.yml", "YAML", 0, 0, 0, 5, 0, 0, 1, 6
"d:\IDEWORK\lvmen\src\licensedcode\data\rules\lgpl-2.1_38.yml", "YAML", 0, 0, 0, 3, 0, 0, 1, 4
"d:\IDEWORK\lvmen\src\licensedcode\data\rules\lgpl-2.1_380.yml", "YAML", 0, 0, 0, 5, 0, 0, 1, 6
"d:\IDEWORK\lvmen\src\licensedcode\data\rules\lgpl-2.1_381.yml", "YAML", 0, 0, 0, 6, 0, 0, 1, 7
"d:\IDEWORK\lvmen\src\licensedcode\data\rules\lgpl-2.1_382.yml", "YAML", 0, 0, 0, 4, 0, 0, 1, 5
"d:\IDEWORK\lvmen\src\licensedcode\data\rules\lgpl-2.1_383.yml", "YAML", 0, 0, 0, 6, 0, 0, 1, 7
"d:\IDEWORK\lvmen\src\licensedcode\data\rules\lgpl-2.1_384.yml", "YAML", 0, 0, 0, 4, 0, 0, 1, 5
"d:\IDEWORK\lvmen\src\licensedcode\data\rules\lgpl-2.1_385.yml", "YAML", 0, 0, 0, 4, 0, 0, 1, 5
"d:\IDEWORK\lvmen\src\licensedcode\data\rules\lgpl-2.1_386.yml", "YAML", 0, 0, 0, 2, 0, 0, 1, 3
"d:\IDEWORK\lvmen\src\licensedcode\data\rules\lgpl-2.1_39.yml", "YAML", 0, 0, 0, 2, 0, 0, 1, 3
"d:\IDEWORK\lvmen\src\licensedcode\data\rules\lgpl-2.1_4.yml", "YAML", 0, 0, 0, 5, 0, 0, 1, 6
"d:\IDEWORK\lvmen\src\licensedcode\data\rules\lgpl-2.1_40.yml", "YAML", 0, 0, 0, 5, 0, 0, 1, 6
"d:\IDEWORK\lvmen\src\licensedcode\data\rules\lgpl-2.1_41.yml", "YAML", 0, 0, 0, 4, 0, 0, 1, 5
"d:\IDEWORK\lvmen\src\licensedcode\data\rules\lgpl-2.1_42.yml", "YAML", 0, 0, 0, 8, 0, 0, 1, 9
"d:\IDEWORK\lvmen\src\licensedcode\data\rules\lgpl-2.1_43.yml", "YAML", 0, 0, 0, 8, 0, 0, 1, 9
"d:\IDEWORK\lvmen\src\licensedcode\data\rules\lgpl-2.1_44.yml", "YAML", 0, 0, 0, 5, 0, 0, 1, 6
"d:\IDEWORK\lvmen\src\licensedcode\data\rules\lgpl-2.1_45.yml", "YAML", 0, 0, 0, 8, 0, 0, 1, 9
"d:\IDEWORK\lvmen\src\licensedcode\data\rules\lgpl-2.1_46.yml", "YAML", 0, 0, 0, 3, 0, 0, 1, 4
"d:\IDEWORK\lvmen\src\licensedcode\data\rules\lgpl-2.1_47.yml", "YAML", 0, 0, 0, 3, 0, 0, 1, 4
"d:\IDEWORK\lvmen\src\licensedcode\data\rules\lgpl-2.1_48.yml", "YAML", 0, 0, 0, 5, 0, 0, 1, 6
"d:\IDEWORK\lvmen\src\licensedcode\data\rules\lgpl-2.1_49.yml", "YAML", 0, 0, 0, 3, 0, 0, 1, 4
"d:\IDEWORK\lvmen\src\licensedcode\data\rules\lgpl-2.1_5.yml", "YAML", 0, 0, 0, 5, 0, 0, 1, 6
"d:\IDEWORK\lvmen\src\licensedcode\data\rules\lgpl-2.1_50.yml", "YAML", 0, 0, 0, 4, 0, 0, 1, 5
"d:\IDEWORK\lvmen\src\licensedcode\data\rules\lgpl-2.1_51.yml", "YAML", 0, 0, 0, 2, 0, 0, 1, 3
"d:\IDEWORK\lvmen\src\licensedcode\data\rules\lgpl-2.1_52.yml", "YAML", 0, 0, 0, 4, 0, 0, 1, 5
"d:\IDEWORK\lvmen\src\licensedcode\data\rules\lgpl-2.1_53.yml", "YAML", 0, 0, 0, 2, 0, 0, 1, 3
"d:\IDEWORK\lvmen\src\licensedcode\data\rules\lgpl-2.1_54.yml", "YAML", 0, 0, 0, 3, 0, 0, 1, 4
"d:\IDEWORK\lvmen\src\licensedcode\data\rules\lgpl-2.1_55.yml", "YAML", 0, 0, 0, 5, 0, 0, 1, 6
"d:\IDEWORK\lvmen\src\licensedcode\data\rules\lgpl-2.1_56.yml", "YAML", 0, 0, 0, 2, 0, 0, 1, 3
"d:\IDEWORK\lvmen\src\licensedcode\data\rules\lgpl-2.1_57.yml", "YAML", 0, 0, 0, 2, 0, 0, 1, 3
"d:\IDEWORK\lvmen\src\licensedcode\data\rules\lgpl-2.1_58.yml", "YAML", 0, 0, 0, 4, 0, 0, 1, 5
"d:\IDEWORK\lvmen\src\licensedcode\data\rules\lgpl-2.1_59.yml", "YAML", 0, 0, 0, 2, 0, 0, 1, 3
"d:\IDEWORK\lvmen\src\licensedcode\data\rules\lgpl-2.1_6.yml", "YAML", 0, 0, 0, 8, 0, 0, 1, 9
"d:\IDEWORK\lvmen\src\licensedcode\data\rules\lgpl-2.1_60.yml", "YAML", 0, 0, 0, 2, 0, 0, 1, 3
"d:\IDEWORK\lvmen\src\licensedcode\data\rules\lgpl-2.1_61.yml", "YAML", 0, 0, 0, 3, 0, 0, 1, 4
"d:\IDEWORK\lvmen\src\licensedcode\data\rules\lgpl-2.1_62.yml", "YAML", 0, 0, 0, 4, 0, 0, 1, 5
"d:\IDEWORK\lvmen\src\licensedcode\data\rules\lgpl-2.1_63.yml", "YAML", 0, 0, 0, 4, 0, 0, 1, 5
"d:\IDEWORK\lvmen\src\licensedcode\data\rules\lgpl-2.1_64.yml", "YAML", 0, 0, 0, 2, 0, 0, 1, 3
"d:\IDEWORK\lvmen\src\licensedcode\data\rules\lgpl-2.1_65.yml", "YAML", 0, 0, 0, 2, 0, 0, 1, 3
"d:\IDEWORK\lvmen\src\licensedcode\data\rules\lgpl-2.1_66.yml", "YAML", 0, 0, 0, 4, 0, 0, 1, 5
"d:\IDEWORK\lvmen\src\licensedcode\data\rules\lgpl-2.1_67.yml", "YAML", 0, 0, 0, 5, 0, 0, 1, 6
"d:\IDEWORK\lvmen\src\licensedcode\data\rules\lgpl-2.1_68.yml", "YAML", 0, 0, 0, 6, 0, 0, 1, 7
"d:\IDEWORK\lvmen\src\licensedcode\data\rules\lgpl-2.1_69.yml", "YAML", 0, 0, 0, 6, 0, 0, 1, 7
"d:\IDEWORK\lvmen\src\licensedcode\data\rules\lgpl-2.1_7.yml", "YAML", 0, 0, 0, 6, 0, 0, 1, 7
"d:\IDEWORK\lvmen\src\licensedcode\data\rules\lgpl-2.1_70.yml", "YAML", 0, 0, 0, 5, 0, 0, 1, 6
"d:\IDEWORK\lvmen\src\licensedcode\data\rules\lgpl-2.1_71.yml", "YAML", 0, 0, 0, 5, 0, 0, 1, 6
"d:\IDEWORK\lvmen\src\licensedcode\data\rules\lgpl-2.1_72.yml", "YAML", 0, 0, 0, 5, 0, 0, 1, 6
"d:\IDEWORK\lvmen\src\licensedcode\data\rules\lgpl-2.1_73.yml", "YAML", 0, 0, 0, 5, 0, 0, 1, 6
"d:\IDEWORK\lvmen\src\licensedcode\data\rules\lgpl-2.1_74.yml", "YAML", 0, 0, 0, 5, 0, 0, 1, 6
"d:\IDEWORK\lvmen\src\licensedcode\data\rules\lgpl-2.1_75.yml", "YAML", 0, 0, 0, 5, 0, 0, 1, 6
"d:\IDEWORK\lvmen\src\licensedcode\data\rules\lgpl-2.1_76.yml", "YAML", 0, 0, 0, 5, 0, 0, 1, 6
"d:\IDEWORK\lvmen\src\licensedcode\data\rules\lgpl-2.1_77.yml", "YAML", 0, 0, 0, 5, 0, 0, 1, 6
"d:\IDEWORK\lvmen\src\licensedcode\data\rules\lgpl-2.1_78.yml", "YAML", 0, 0, 0, 3, 0, 0, 1, 4
"d:\IDEWORK\lvmen\src\licensedcode\data\rules\lgpl-2.1_79.yml", "YAML", 0, 0, 0, 2, 0, 0, 1, 3
"d:\IDEWORK\lvmen\src\licensedcode\data\rules\lgpl-2.1_8.yml", "YAML", 0, 0, 0, 5, 0, 0, 1, 6
"d:\IDEWORK\lvmen\src\licensedcode\data\rules\lgpl-2.1_80.yml", "YAML", 0, 0, 0, 2, 0, 0, 1, 3
"d:\IDEWORK\lvmen\src\licensedcode\data\rules\lgpl-2.1_81.yml", "YAML", 0, 0, 0, 3, 0, 0, 1, 4
"d:\IDEWORK\lvmen\src\licensedcode\data\rules\lgpl-2.1_82.yml", "YAML", 0, 0, 0, 5, 0, 0, 1, 6
"d:\IDEWORK\lvmen\src\licensedcode\data\rules\lgpl-2.1_83.yml", "YAML", 0, 0, 0, 8, 0, 0, 1, 9
"d:\IDEWORK\lvmen\src\licensedcode\data\rules\lgpl-2.1_84.yml", "YAML", 0, 0, 0, 3, 0, 0, 1, 4
"d:\IDEWORK\lvmen\src\licensedcode\data\rules\lgpl-2.1_85.yml", "YAML", 0, 0, 0, 3, 0, 0, 1, 4
"d:\IDEWORK\lvmen\src\licensedcode\data\rules\lgpl-2.1_86.yml", "YAML", 0, 0, 0, 5, 0, 0, 1, 6
"d:\IDEWORK\lvmen\src\licensedcode\data\rules\lgpl-2.1_87.yml", "YAML", 0, 0, 0, 3, 0, 0, 1, 4
"d:\IDEWORK\lvmen\src\licensedcode\data\rules\lgpl-2.1_88.yml", "YAML", 0, 0, 0, 3, 0, 0, 1, 4
"d:\IDEWORK\lvmen\src\licensedcode\data\rules\lgpl-2.1_89.yml", "YAML", 0, 0, 0, 2, 0, 0, 1, 3
"d:\IDEWORK\lvmen\src\licensedcode\data\rules\lgpl-2.1_9.yml", "YAML", 0, 0, 0, 5, 0, 0, 1, 6
"d:\IDEWORK\lvmen\src\licensedcode\data\rules\lgpl-2.1_90.yml", "YAML", 0, 0, 0, 2, 0, 0, 1, 3
"d:\IDEWORK\lvmen\src\licensedcode\data\rules\lgpl-2.1_91.yml", "YAML", 0, 0, 0, 3, 0, 0, 1, 4
"d:\IDEWORK\lvmen\src\licensedcode\data\rules\lgpl-2.1_92.yml", "YAML", 0, 0, 0, 2, 0, 0, 1, 3
"d:\IDEWORK\lvmen\src\licensedcode\data\rules\lgpl-2.1_93.yml", "YAML", 0, 0, 0, 2, 0, 0, 1, 3
"d:\IDEWORK\lvmen\src\licensedcode\data\rules\lgpl-2.1_94.yml", "YAML", 0, 0, 0, 8, 0, 0, 1, 9
"d:\IDEWORK\lvmen\src\licensedcode\data\rules\lgpl-2.1_95.yml", "YAML", 0, 0, 0, 2, 0, 0, 1, 3
"d:\IDEWORK\lvmen\src\licensedcode\data\rules\lgpl-2.1_96.yml", "YAML", 0, 0, 0, 3, 0, 0, 1, 4
"d:\IDEWORK\lvmen\src\licensedcode\data\rules\lgpl-2.1_97.yml", "YAML", 0, 0, 0, 5, 0, 0, 1, 6
"d:\IDEWORK\lvmen\src\licensedcode\data\rules\lgpl-2.1_98.yml", "YAML", 0, 0, 0, 4, 0, 0, 1, 5
"d:\IDEWORK\lvmen\src\licensedcode\data\rules\lgpl-2.1_99.yml", "YAML", 0, 0, 0, 7, 0, 0, 1, 8
"d:\IDEWORK\lvmen\src\licensedcode\data\rules\lgpl-2.1_alternative.yml", "YAML", 0, 0, 0, 8, 0, 0, 1, 9
"d:\IDEWORK\lvmen\src\licensedcode\data\rules\lgpl-2.1_and_apache-2.0.yml", "YAML", 0, 0, 0, 2, 0, 0, 1, 3
"d:\IDEWORK\lvmen\src\licensedcode\data\rules\lgpl-2.1_and_gpl-2.0_1.yml", "YAML", 0, 0, 0, 3, 0, 0, 1, 4
"d:\IDEWORK\lvmen\src\licensedcode\data\rules\lgpl-2.1_and_gpl-2.0_2.yml", "YAML", 0, 0, 0, 4, 0, 0, 1, 5
"d:\IDEWORK\lvmen\src\licensedcode\data\rules\lgpl-2.1_and_gpl-2.0_3.yml", "YAML", 0, 0, 0, 4, 0, 0, 1, 5
"d:\IDEWORK\lvmen\src\licensedcode\data\rules\lgpl-2.1_and_gpl-2.0_4.yml", "YAML", 0, 0, 0, 5, 0, 0, 1, 6
"d:\IDEWORK\lvmen\src\licensedcode\data\rules\lgpl-2.1_and_gpl-2.0_5.yml", "YAML", 0, 0, 0, 5, 0, 0, 1, 6
"d:\IDEWORK\lvmen\src\licensedcode\data\rules\lgpl-2.1_and_gpl-2.0_and_gpl-3.0.yml", "YAML", 0, 0, 0, 6, 0, 0, 1, 7
"d:\IDEWORK\lvmen\src\licensedcode\data\rules\lgpl-2.1_and_gpl-2.0_and_gpl-3.0_1.yml", "YAML", 0, 0, 0, 3, 0, 0, 1, 4
"d:\IDEWORK\lvmen\src\licensedcode\data\rules\lgpl-2.1_and_gpl-2.0_and_gpl-3.0_2.yml", "YAML", 0, 0, 0, 6, 0, 0, 1, 7
"d:\IDEWORK\lvmen\src\licensedcode\data\rules\lgpl-2.1_and_gpl-2.0_and_gpl-3.0_3.yml", "YAML", 0, 0, 0, 6, 0, 0, 1, 7
"d:\IDEWORK\lvmen\src\licensedcode\data\rules\lgpl-2.1_and_gpl-2.0_and_gpl-3.0_4.yml", "YAML", 0, 0, 0, 7, 0, 0, 1, 8
"d:\IDEWORK\lvmen\src\licensedcode\data\rules\lgpl-2.1_and_gpl-2.0_and_gpl-3.0_5.yml", "YAML", 0, 0, 0, 7, 0, 0, 1, 8
"d:\IDEWORK\lvmen\src\licensedcode\data\rules\lgpl-2.1_and_gpl-2.0_and_gpl-3.0_6.yml", "YAML", 0, 0, 0, 7, 0, 0, 1, 8
"d:\IDEWORK\lvmen\src\licensedcode\data\rules\lgpl-2.1_and_gpl-2.0_with_ecos-exception-2.0_1.yml", "YAML", 0, 0, 0, 3, 0, 0, 1, 4
"d:\IDEWORK\lvmen\src\licensedcode\data\rules\lgpl-2.1_and_gpl-2.0_with_generic-exception_1.yml", "YAML", 0, 0, 0, 3, 0, 0, 1, 4
"d:\IDEWORK\lvmen\src\licensedcode\data\rules\lgpl-2.1_and_gpl-2.0_with_generic-exception_2.yml", "YAML", 0, 0, 0, 3, 0, 0, 1, 4
"d:\IDEWORK\lvmen\src\licensedcode\data\rules\lgpl-2.1_and_lgpl-3.0_1.yml", "YAML", 0, 0, 0, 4, 0, 0, 1, 5
"d:\IDEWORK\lvmen\src\licensedcode\data\rules\lgpl-2.1_and_lgpl-3.0_and_gpl-3.0_1.yml", "YAML", 0, 0, 0, 4, 0, 0, 1, 5
"d:\IDEWORK\lvmen\src\licensedcode\data\rules\lgpl-2.1_and_patent-disclaimer.yml", "YAML", 0, 0, 0, 2, 0, 0, 1, 3
"d:\IDEWORK\lvmen\src\licensedcode\data\rules\lgpl-2.1_and_proprietary-license_1.yml", "YAML", 0, 0, 0, 4, 0, 0, 1, 5
"d:\IDEWORK\lvmen\src\licensedcode\data\rules\lgpl-2.1_and_proprietary-license_2.yml", "YAML", 0, 0, 0, 4, 0, 0, 1, 5
"d:\IDEWORK\lvmen\src\licensedcode\data\rules\lgpl-2.1_and_public-domain.yml", "YAML", 0, 0, 0, 2, 0, 0, 1, 3
"d:\IDEWORK\lvmen\src\licensedcode\data\rules\lgpl-2.1_and_public-domain2.yml", "YAML", 0, 0, 0, 2, 0, 0, 1, 3
"d:\IDEWORK\lvmen\src\licensedcode\data\rules\lgpl-2.1_f2fs_1.yml", "YAML", 0, 0, 0, 3, 0, 0, 1, 4
"d:\IDEWORK\lvmen\src\licensedcode\data\rules\lgpl-2.1_jna.yml", "YAML", 0, 0, 0, 6, 0, 0, 1, 7
"d:\IDEWORK\lvmen\src\licensedcode\data\rules\lgpl-2.1_licensebutton.yml", "YAML", 0, 0, 0, 5, 0, 0, 1, 6
"d:\IDEWORK\lvmen\src\licensedcode\data\rules\lgpl-2.1_notice.yml", "YAML", 0, 0, 0, 4, 0, 0, 1, 5
"d:\IDEWORK\lvmen\src\licensedcode\data\rules\lgpl-2.1_nuget_url_1.yml", "YAML", 0, 0, 0, 5, 0, 0, 1, 6
"d:\IDEWORK\lvmen\src\licensedcode\data\rules\lgpl-2.1_nuget_url_2.yml", "YAML", 0, 0, 0, 5, 0, 0, 1, 6
"d:\IDEWORK\lvmen\src\licensedcode\data\rules\lgpl-2.1_nuget_url_3.yml", "YAML", 0, 0, 0, 5, 0, 0, 1, 6
"d:\IDEWORK\lvmen\src\licensedcode\data\rules\lgpl-2.1_nuget_url_4.yml", "YAML", 0, 0, 0, 5, 0, 0, 1, 6
"d:\IDEWORK\lvmen\src\licensedcode\data\rules\lgpl-2.1_only_qt_2.yml", "YAML", 0, 0, 0, 5, 0, 0, 1, 6
"d:\IDEWORK\lvmen\src\licensedcode\data\rules\lgpl-2.1_only_qt_3.yml", "YAML", 0, 0, 0, 5, 0, 0, 1, 6
"d:\IDEWORK\lvmen\src\licensedcode\data\rules\lgpl-2.1_or_apache-2.0_1.yml", "YAML", 0, 0, 0, 7, 0, 0, 1, 8
"d:\IDEWORK\lvmen\src\licensedcode\data\rules\lgpl-2.1_or_apache-2.0_2.yml", "YAML", 0, 0, 0, 7, 0, 0, 1, 8
"d:\IDEWORK\lvmen\src\licensedcode\data\rules\lgpl-2.1_or_bsd-simplified_1.yml", "YAML", 0, 0, 0, 3, 0, 0, 1, 4
"d:\IDEWORK\lvmen\src\licensedcode\data\rules\lgpl-2.1_or_bsd-simplified_2.yml", "YAML", 0, 0, 0, 3, 0, 0, 1, 4
"d:\IDEWORK\lvmen\src\licensedcode\data\rules\lgpl-2.1_or_cddl-1.0_1.yml", "YAML", 0, 0, 0, 5, 0, 0, 1, 6
"d:\IDEWORK\lvmen\src\licensedcode\data\rules\lgpl-2.1_or_epl-2.0_1.yml", "YAML", 0, 0, 0, 8, 0, 0, 1, 9
"d:\IDEWORK\lvmen\src\licensedcode\data\rules\lgpl-2.1_or_epl-2.0_2.yml", "YAML", 0, 0, 0, 8, 0, 0, 1, 9
"d:\IDEWORK\lvmen\src\licensedcode\data\rules\lgpl-2.1_or_lgpl-3.0_1.yml", "YAML", 0, 0, 0, 5, 0, 0, 1, 6
"d:\IDEWORK\lvmen\src\licensedcode\data\rules\lgpl-2.1_or_lgpl-3.0_2.yml", "YAML", 0, 0, 0, 5, 0, 0, 1, 6
"d:\IDEWORK\lvmen\src\licensedcode\data\rules\lgpl-2.1_or_lgpl-3.0_3.yml", "YAML", 0, 0, 0, 3, 0, 0, 1, 4
"d:\IDEWORK\lvmen\src\licensedcode\data\rules\lgpl-2.1_or_lgpl-3.0_4.yml", "YAML", 0, 0, 0, 5, 0, 0, 1, 6
"d:\IDEWORK\lvmen\src\licensedcode\data\rules\lgpl-2.1_or_lgpl-3.0_5.yml", "YAML", 0, 0, 0, 6, 0, 0, 1, 7
"d:\IDEWORK\lvmen\src\licensedcode\data\rules\lgpl-2.1_or_lgpl-3.0_6.yml", "YAML", 0, 0, 0, 5, 0, 0, 1, 6
"d:\IDEWORK\lvmen\src\licensedcode\data\rules\lgpl-2.1_or_lgpl-3.0_7.yml", "YAML", 0, 0, 0, 6, 0, 0, 1, 7
"d:\IDEWORK\lvmen\src\licensedcode\data\rules\lgpl-2.1_or_lgpl-3.0_or_kde-accepted-lgpl_1.yml", "YAML", 0, 0, 0, 6, 0, 0, 1, 7
"d:\IDEWORK\lvmen\src\licensedcode\data\rules\lgpl-2.1_or_mpl-1.0.yml", "YAML", 0, 0, 0, 5, 0, 0, 1, 6
"d:\IDEWORK\lvmen\src\licensedcode\data\rules\lgpl-2.1_or_mpl-1.1_1.yml", "YAML", 0, 0, 0, 7, 0, 0, 1, 8
"d:\IDEWORK\lvmen\src\licensedcode\data\rules\lgpl-2.1_or_mpl-1.1_2.yml", "YAML", 0, 0, 0, 7, 0, 0, 1, 8
"d:\IDEWORK\lvmen\src\licensedcode\data\rules\lgpl-2.1_or_mpl-1.1_3.yml", "YAML", 0, 0, 0, 8, 0, 0, 1, 9
"d:\IDEWORK\lvmen\src\licensedcode\data\rules\lgpl-2.1_or_mpl-1.1_and_other-permissive_1.yml", "YAML", 0, 0, 0, 6, 0, 0, 1, 7
"d:\IDEWORK\lvmen\src\licensedcode\data\rules\lgpl-2.1_or_proprietary-license_1.yml", "YAML", 0, 0, 0, 3, 0, 0, 1, 4
"d:\IDEWORK\lvmen\src\licensedcode\data\rules\lgpl-2.1_qt.yml", "YAML", 0, 0, 0, 12, 0, 0, 1, 13
"d:\IDEWORK\lvmen\src\licensedcode\data\rules\lgpl-2.1_released.yml", "YAML", 0, 0, 0, 3, 0, 0, 1, 4
"d:\IDEWORK\lvmen\src\licensedcode\data\rules\lgpl-2.1_url_1.yml", "YAML", 0, 0, 0, 5, 0, 0, 1, 6
"d:\IDEWORK\lvmen\src\licensedcode\data\rules\lgpl-2.1_url_2.yml", "YAML", 0, 0, 0, 5, 0, 0, 1, 6
"d:\IDEWORK\lvmen\src\licensedcode\data\rules\lgpl-2.1_url_glc_135.yml", "YAML", 0, 0, 0, 5, 0, 0, 1, 6
"d:\IDEWORK\lvmen\src\licensedcode\data\rules\lgpl-2.1_url_glc_179.yml", "YAML", 0, 0, 0, 5, 0, 0, 1, 6
"d:\IDEWORK\lvmen\src\licensedcode\data\rules\lgpl-2.1_with_broadcom-linking-exception-2.0_1.yml", "YAML", 0, 0, 0, 5, 0, 0, 1, 6
"d:\IDEWORK\lvmen\src\licensedcode\data\rules\lgpl-2.1_with_broadcom-linking-exception-2.0_2.yml", "YAML", 0, 0, 0, 5, 0, 0, 1, 6
"d:\IDEWORK\lvmen\src\licensedcode\data\rules\lgpl-2.1_with_broadcom-linking-exception-2.0_3.yml", "YAML", 0, 0, 0, 6, 0, 0, 1, 7
"d:\IDEWORK\lvmen\src\licensedcode\data\rules\lgpl-2.1_with_broadcom-linking-exception-2.0_4.yml", "YAML", 0, 0, 0, 7, 0, 0, 1, 8
"d:\IDEWORK\lvmen\src\licensedcode\data\rules\lgpl-2.1_with_gplcc-1.0_1.yml", "YAML", 0, 0, 0, 5, 0, 0, 1, 6
"d:\IDEWORK\lvmen\src\licensedcode\data\rules\lgpl-2.1_with_gplcc-1.0_2.yml", "YAML", 0, 0, 0, 8, 0, 0, 1, 9
"d:\IDEWORK\lvmen\src\licensedcode\data\rules\lgpl-2.1_with_gplcc-1.0_3.yml", "YAML", 0, 0, 0, 6, 0, 0, 1, 7
"d:\IDEWORK\lvmen\src\licensedcode\data\rules\lgpl-2.1_with_gplcc-1.0_4.yml", "YAML", 0, 0, 0, 8, 0, 0, 1, 9
"d:\IDEWORK\lvmen\src\licensedcode\data\rules\lgpl-2.1_with_lgpl-2.1-digia-qt_exception.yml", "YAML", 0, 0, 0, 5, 0, 0, 1, 6
"d:\IDEWORK\lvmen\src\licensedcode\data\rules\lgpl-2.1_with_libwebsockets-exception_1.yml", "YAML", 0, 0, 0, 3, 0, 0, 1, 4
"d:\IDEWORK\lvmen\src\licensedcode\data\rules\lgpl-2.1_with_libwebsockets-exception_2.yml", "YAML", 0, 0, 0, 3, 0, 0, 1, 4
"d:\IDEWORK\lvmen\src\licensedcode\data\rules\lgpl-2.1_with_libwebsockets-exception_3.yml", "YAML", 0, 0, 0, 3, 0, 0, 1, 4
"d:\IDEWORK\lvmen\src\licensedcode\data\rules\lgpl-2.1_with_libwebsockets-exception_4.yml", "YAML", 0, 0, 0, 5, 0, 0, 1, 6
"d:\IDEWORK\lvmen\src\licensedcode\data\rules\lgpl-2.1_with_libwebsockets-exception_5.yml", "YAML", 0, 0, 0, 3, 0, 0, 1, 4
"d:\IDEWORK\lvmen\src\licensedcode\data\rules\lgpl-2.1_with_libwebsockets-exception_6.yml", "YAML", 0, 0, 0, 3, 0, 0, 1, 4
"d:\IDEWORK\lvmen\src\licensedcode\data\rules\lgpl-2.1_with_libwebsockets-exception_7.yml", "YAML", 0, 0, 0, 3, 0, 0, 1, 4
"d:\IDEWORK\lvmen\src\licensedcode\data\rules\lgpl-2.1_with_linking-exception-lgpl-2.0-plus_1.yml", "YAML", 0, 0, 0, 6, 0, 0, 1, 7
"d:\IDEWORK\lvmen\src\licensedcode\data\rules\lgpl-2.1_with_ocaml-lgpl-linking-exception_1.yml", "YAML", 0, 0, 0, 5, 0, 0, 1, 6
"d:\IDEWORK\lvmen\src\licensedcode\data\rules\lgpl-2.1_with_ocaml-lgpl-linking-exception_2.yml", "YAML", 0, 0, 0, 3, 0, 0, 1, 4
"d:\IDEWORK\lvmen\src\licensedcode\data\rules\lgpl-2.1_with_ocaml-lgpl-linking-exception_3.yml", "YAML", 0, 0, 0, 5, 0, 0, 1, 6
"d:\IDEWORK\lvmen\src\licensedcode\data\rules\lgpl-2.1_with_ocaml-lgpl-linking-exception_4.yml", "YAML", 0, 0, 0, 5, 0, 0, 1, 6
"d:\IDEWORK\lvmen\src\licensedcode\data\rules\lgpl-2.1_with_ocaml-lgpl-linking-exception_5.yml", "YAML", 0, 0, 0, 5, 0, 0, 1, 6
"d:\IDEWORK\lvmen\src\licensedcode\data\rules\lgpl-2.1_with_ocaml-lgpl-linking-exception_6.yml", "YAML", 0, 0, 0, 2, 0, 0, 1, 3
"d:\IDEWORK\lvmen\src\licensedcode\data\rules\lgpl-2.1_with_ocaml-lgpl-linking-exception_7.yml", "YAML", 0, 0, 0, 5, 0, 0, 1, 6
"d:\IDEWORK\lvmen\src\licensedcode\data\rules\lgpl-2.1_with_occt-exception-1.0_or_commercial-license_1.yml", "YAML", 0, 0, 0, 6, 0, 0, 1, 7
"d:\IDEWORK\lvmen\src\licensedcode\data\rules\lgpl-2.1_with_occt-exception-1.0_or_commercial-license_2.yml", "YAML", 0, 0, 0, 6, 0, 0, 1, 7
"d:\IDEWORK\lvmen\src\licensedcode\data\rules\lgpl-2.1_with_openssl-exception-lgpl-2.0-plus_1.yml", "YAML", 0, 0, 0, 4, 0, 0, 1, 5
"d:\IDEWORK\lvmen\src\licensedcode\data\rules\lgpl-2.1_with_qt-lgpl-exception-1.1_1.yml", "YAML", 0, 0, 0, 6, 0, 0, 1, 7
"d:\IDEWORK\lvmen\src\licensedcode\data\rules\lgpl-2.1_with_qt-lgpl-exception-1.1_older.yml", "YAML", 0, 0, 0, 2, 0, 0, 1, 3
"d:\IDEWORK\lvmen\src\licensedcode\data\rules\lgpl-2.1_with_qt-lgpl-exception-1.1_or_gpl-3.0_or_commercial-license_1.yml", "YAML", 0, 0, 0, 10, 0, 0, 1, 11
"d:\IDEWORK\lvmen\src\licensedcode\data\rules\lgpl-2.1_with_unlimited-linking-exception-lgpl_1.yml", "YAML", 0, 0, 0, 3, 0, 0, 1, 4
"d:\IDEWORK\lvmen\src\licensedcode\data\rules\lgpl-3-plus-linking2.yml", "YAML", 0, 0, 0, 8, 0, 0, 1, 9
"d:\IDEWORK\lvmen\src\licensedcode\data\rules\lgpl-3-plus-linking_3.yml", "YAML", 0, 0, 0, 4, 0, 0, 1, 5
"d:\IDEWORK\lvmen\src\licensedcode\data\rules\lgpl-3.0-plus_1.yml", "YAML", 0, 0, 0, 3, 0, 0, 1, 4
"d:\IDEWORK\lvmen\src\licensedcode\data\rules\lgpl-3.0-plus_10.yml", "YAML", 0, 0, 0, 4, 0, 0, 1, 5
"d:\IDEWORK\lvmen\src\licensedcode\data\rules\lgpl-3.0-plus_100.yml", "YAML", 0, 0, 0, 5, 0, 0, 1, 6
"d:\IDEWORK\lvmen\src\licensedcode\data\rules\lgpl-3.0-plus_101.yml", "YAML", 0, 0, 0, 5, 0, 0, 1, 6
"d:\IDEWORK\lvmen\src\licensedcode\data\rules\lgpl-3.0-plus_102.yml", "YAML", 0, 0, 0, 6, 0, 0, 1, 7
"d:\IDEWORK\lvmen\src\licensedcode\data\rules\lgpl-3.0-plus_103.yml", "YAML", 0, 0, 0, 3, 0, 0, 1, 4
"d:\IDEWORK\lvmen\src\licensedcode\data\rules\lgpl-3.0-plus_104.yml", "YAML", 0, 0, 0, 6, 0, 0, 1, 7
"d:\IDEWORK\lvmen\src\licensedcode\data\rules\lgpl-3.0-plus_105.yml", "YAML", 0, 0, 0, 3, 0, 0, 1, 4
"d:\IDEWORK\lvmen\src\licensedcode\data\rules\lgpl-3.0-plus_106.yml", "YAML", 0, 0, 0, 5, 0, 0, 1, 6
"d:\IDEWORK\lvmen\src\licensedcode\data\rules\lgpl-3.0-plus_107.yml", "YAML", 0, 0, 0, 3, 0, 0, 1, 4
"d:\IDEWORK\lvmen\src\licensedcode\data\rules\lgpl-3.0-plus_108.yml", "YAML", 0, 0, 0, 3, 0, 0, 1, 4
"d:\IDEWORK\lvmen\src\licensedcode\data\rules\lgpl-3.0-plus_109.yml", "YAML", 0, 0, 0, 3, 0, 0, 1, 4
"d:\IDEWORK\lvmen\src\licensedcode\data\rules\lgpl-3.0-plus_11.yml", "YAML", 0, 0, 0, 4, 0, 0, 1, 5
"d:\IDEWORK\lvmen\src\licensedcode\data\rules\lgpl-3.0-plus_110.yml", "YAML", 0, 0, 0, 3, 0, 0, 1, 4
"d:\IDEWORK\lvmen\src\licensedcode\data\rules\lgpl-3.0-plus_111.yml", "YAML", 0, 0, 0, 3, 0, 0, 1, 4
"d:\IDEWORK\lvmen\src\licensedcode\data\rules\lgpl-3.0-plus_112.yml", "YAML", 0, 0, 0, 3, 0, 0, 1, 4
"d:\IDEWORK\lvmen\src\licensedcode\data\rules\lgpl-3.0-plus_113.yml", "YAML", 0, 0, 0, 3, 0, 0, 1, 4
"d:\IDEWORK\lvmen\src\licensedcode\data\rules\lgpl-3.0-plus_114.yml", "YAML", 0, 0, 0, 3, 0, 0, 1, 4
"d:\IDEWORK\lvmen\src\licensedcode\data\rules\lgpl-3.0-plus_115.yml", "YAML", 0, 0, 0, 3, 0, 0, 1, 4
"d:\IDEWORK\lvmen\src\licensedcode\data\rules\lgpl-3.0-plus_116.yml", "YAML", 0, 0, 0, 3, 0, 0, 1, 4
"d:\IDEWORK\lvmen\src\licensedcode\data\rules\lgpl-3.0-plus_117.yml", "YAML", 0, 0, 0, 3, 0, 0, 1, 4
"d:\IDEWORK\lvmen\src\licensedcode\data\rules\lgpl-3.0-plus_118.yml", "YAML", 0, 0, 0, 5, 0, 0, 1, 6
"d:\IDEWORK\lvmen\src\licensedcode\data\rules\lgpl-3.0-plus_119.yml", "YAML", 0, 0, 0, 5, 0, 0, 1, 6
"d:\IDEWORK\lvmen\src\licensedcode\data\rules\lgpl-3.0-plus_12.yml", "YAML", 0, 0, 0, 2, 0, 0, 1, 3
"d:\IDEWORK\lvmen\src\licensedcode\data\rules\lgpl-3.0-plus_120.yml", "YAML", 0, 0, 0, 3, 0, 0, 1, 4
"d:\IDEWORK\lvmen\src\licensedcode\data\rules\lgpl-3.0-plus_121.yml", "YAML", 0, 0, 0, 3, 0, 0, 1, 4
"d:\IDEWORK\lvmen\src\licensedcode\data\rules\lgpl-3.0-plus_122.yml", "YAML", 0, 0, 0, 3, 0, 0, 1, 4
"d:\IDEWORK\lvmen\src\licensedcode\data\rules\lgpl-3.0-plus_123.yml", "YAML", 0, 0, 0, 3, 0, 0, 1, 4
"d:\IDEWORK\lvmen\src\licensedcode\data\rules\lgpl-3.0-plus_124.yml", "YAML", 0, 0, 0, 3, 0, 0, 1, 4
"d:\IDEWORK\lvmen\src\licensedcode\data\rules\lgpl-3.0-plus_125.yml", "YAML", 0, 0, 0, 3, 0, 0, 1, 4
"d:\IDEWORK\lvmen\src\licensedcode\data\rules\lgpl-3.0-plus_126.yml", "YAML", 0, 0, 0, 3, 0, 0, 1, 4
"d:\IDEWORK\lvmen\src\licensedcode\data\rules\lgpl-3.0-plus_127.yml", "YAML", 0, 0, 0, 3, 0, 0, 1, 4
"d:\IDEWORK\lvmen\src\licensedcode\data\rules\lgpl-3.0-plus_128.yml", "YAML", 0, 0, 0, 3, 0, 0, 1, 4
"d:\IDEWORK\lvmen\src\licensedcode\data\rules\lgpl-3.0-plus_129.yml", "YAML", 0, 0, 0, 4, 0, 0, 1, 5
"d:\IDEWORK\lvmen\src\licensedcode\data\rules\lgpl-3.0-plus_13.yml", "YAML", 0, 0, 0, 3, 0, 0, 1, 4
"d:\IDEWORK\lvmen\src\licensedcode\data\rules\lgpl-3.0-plus_130.yml", "YAML", 0, 0, 0, 4, 0, 0, 1, 5
"d:\IDEWORK\lvmen\src\licensedcode\data\rules\lgpl-3.0-plus_131.yml", "YAML", 0, 0, 0, 6, 0, 0, 1, 7
"d:\IDEWORK\lvmen\src\licensedcode\data\rules\lgpl-3.0-plus_132.yml", "YAML", 0, 0, 0, 4, 0, 0, 1, 5
"d:\IDEWORK\lvmen\src\licensedcode\data\rules\lgpl-3.0-plus_133.yml", "YAML", 0, 0, 0, 3, 0, 0, 1, 4
"d:\IDEWORK\lvmen\src\licensedcode\data\rules\lgpl-3.0-plus_134.yml", "YAML", 0, 0, 0, 3, 0, 0, 1, 4
"d:\IDEWORK\lvmen\src\licensedcode\data\rules\lgpl-3.0-plus_135.yml", "YAML", 0, 0, 0, 3, 0, 0, 1, 4
"d:\IDEWORK\lvmen\src\licensedcode\data\rules\lgpl-3.0-plus_136.yml", "YAML", 0, 0, 0, 3, 0, 0, 1, 4
"d:\IDEWORK\lvmen\src\licensedcode\data\rules\lgpl-3.0-plus_137.yml", "YAML", 0, 0, 0, 3, 0, 0, 1, 4
"d:\IDEWORK\lvmen\src\licensedcode\data\rules\lgpl-3.0-plus_138.yml", "YAML", 0, 0, 0, 5, 0, 0, 1, 6
"d:\IDEWORK\lvmen\src\licensedcode\data\rules\lgpl-3.0-plus_139.yml", "YAML", 0, 0, 0, 5, 0, 0, 1, 6
"d:\IDEWORK\lvmen\src\licensedcode\data\rules\lgpl-3.0-plus_14.yml", "YAML", 0, 0, 0, 3, 0, 0, 1, 4
"d:\IDEWORK\lvmen\src\licensedcode\data\rules\lgpl-3.0-plus_140.yml", "YAML", 0, 0, 0, 5, 0, 0, 1, 6
"d:\IDEWORK\lvmen\src\licensedcode\data\rules\lgpl-3.0-plus_141.yml", "YAML", 0, 0, 0, 3, 0, 0, 1, 4
"d:\IDEWORK\lvmen\src\licensedcode\data\rules\lgpl-3.0-plus_142.yml", "YAML", 0, 0, 0, 3, 0, 0, 1, 4
"d:\IDEWORK\lvmen\src\licensedcode\data\rules\lgpl-3.0-plus_143.yml", "YAML", 0, 0, 0, 3, 0, 0, 1, 4
"d:\IDEWORK\lvmen\src\licensedcode\data\rules\lgpl-3.0-plus_144.yml", "YAML", 0, 0, 0, 3, 0, 0, 1, 4
"d:\IDEWORK\lvmen\src\licensedcode\data\rules\lgpl-3.0-plus_145.yml", "YAML", 0, 0, 0, 3, 0, 0, 1, 4
"d:\IDEWORK\lvmen\src\licensedcode\data\rules\lgpl-3.0-plus_146.yml", "YAML", 0, 0, 0, 5, 0, 0, 1, 6
"d:\IDEWORK\lvmen\src\licensedcode\data\rules\lgpl-3.0-plus_147.yml", "YAML", 0, 0, 0, 5, 0, 0, 1, 6
"d:\IDEWORK\lvmen\src\licensedcode\data\rules\lgpl-3.0-plus_148.yml", "YAML", 0, 0, 0, 5, 0, 0, 1, 6
"d:\IDEWORK\lvmen\src\licensedcode\data\rules\lgpl-3.0-plus_149.yml", "YAML", 0, 0, 0, 5, 0, 0, 1, 6
"d:\IDEWORK\lvmen\src\licensedcode\data\rules\lgpl-3.0-plus_15.yml", "YAML", 0, 0, 0, 4, 0, 0, 1, 5
"d:\IDEWORK\lvmen\src\licensedcode\data\rules\lgpl-3.0-plus_150.yml", "YAML", 0, 0, 0, 7, 0, 0, 1, 8
"d:\IDEWORK\lvmen\src\licensedcode\data\rules\lgpl-3.0-plus_151.yml", "YAML", 0, 0, 0, 7, 0, 0, 1, 8
"d:\IDEWORK\lvmen\src\licensedcode\data\rules\lgpl-3.0-plus_152.yml", "YAML", 0, 0, 0, 7, 0, 0, 1, 8
"d:\IDEWORK\lvmen\src\licensedcode\data\rules\lgpl-3.0-plus_153.yml", "YAML", 0, 0, 0, 3, 0, 0, 1, 4
"d:\IDEWORK\lvmen\src\licensedcode\data\rules\lgpl-3.0-plus_154.yml", "YAML", 0, 0, 0, 3, 0, 0, 1, 4
"d:\IDEWORK\lvmen\src\licensedcode\data\rules\lgpl-3.0-plus_155.yml", "YAML", 0, 0, 0, 3, 0, 0, 1, 4
"d:\IDEWORK\lvmen\src\licensedcode\data\rules\lgpl-3.0-plus_156.yml", "YAML", 0, 0, 0, 3, 0, 0, 1, 4
"d:\IDEWORK\lvmen\src\licensedcode\data\rules\lgpl-3.0-plus_157.yml", "YAML", 0, 0, 0, 3, 0, 0, 1, 4
"d:\IDEWORK\lvmen\src\licensedcode\data\rules\lgpl-3.0-plus_158.yml", "YAML", 0, 0, 0, 3, 0, 0, 1, 4
"d:\IDEWORK\lvmen\src\licensedcode\data\rules\lgpl-3.0-plus_159.yml", "YAML", 0, 0, 0, 3, 0, 0, 1, 4
"d:\IDEWORK\lvmen\src\licensedcode\data\rules\lgpl-3.0-plus_16.yml", "YAML", 0, 0, 0, 5, 0, 0, 1, 6
"d:\IDEWORK\lvmen\src\licensedcode\data\rules\lgpl-3.0-plus_160.yml", "YAML", 0, 0, 0, 3, 0, 0, 1, 4
"d:\IDEWORK\lvmen\src\licensedcode\data\rules\lgpl-3.0-plus_161.yml", "YAML", 0, 0, 0, 5, 0, 0, 1, 6
"d:\IDEWORK\lvmen\src\licensedcode\data\rules\lgpl-3.0-plus_162.yml", "YAML", 0, 0, 0, 5, 0, 0, 1, 6
"d:\IDEWORK\lvmen\src\licensedcode\data\rules\lgpl-3.0-plus_163.yml", "YAML", 0, 0, 0, 5, 0, 0, 1, 6
"d:\IDEWORK\lvmen\src\licensedcode\data\rules\lgpl-3.0-plus_164.yml", "YAML", 0, 0, 0, 5, 0, 0, 1, 6
"d:\IDEWORK\lvmen\src\licensedcode\data\rules\lgpl-3.0-plus_165.yml", "YAML", 0, 0, 0, 3, 0, 0, 1, 4
"d:\IDEWORK\lvmen\src\licensedcode\data\rules\lgpl-3.0-plus_166.yml", "YAML", 0, 0, 0, 3, 0, 0, 1, 4
"d:\IDEWORK\lvmen\src\licensedcode\data\rules\lgpl-3.0-plus_167.yml", "YAML", 0, 0, 0, 7, 0, 0, 1, 8
"d:\IDEWORK\lvmen\src\licensedcode\data\rules\lgpl-3.0-plus_168.yml", "YAML", 0, 0, 0, 5, 0, 0, 1, 6
"d:\IDEWORK\lvmen\src\licensedcode\data\rules\lgpl-3.0-plus_169.yml", "YAML", 0, 0, 0, 7, 0, 0, 1, 8
"d:\IDEWORK\lvmen\src\licensedcode\data\rules\lgpl-3.0-plus_17.yml", "YAML", 0, 0, 0, 3, 0, 0, 1, 4
"d:\IDEWORK\lvmen\src\licensedcode\data\rules\lgpl-3.0-plus_170.yml", "YAML", 0, 0, 0, 5, 0, 0, 1, 6
"d:\IDEWORK\lvmen\src\licensedcode\data\rules\lgpl-3.0-plus_171.yml", "YAML", 0, 0, 0, 7, 0, 0, 1, 8
"d:\IDEWORK\lvmen\src\licensedcode\data\rules\lgpl-3.0-plus_172.yml", "YAML", 0, 0, 0, 5, 0, 0, 1, 6
"d:\IDEWORK\lvmen\src\licensedcode\data\rules\lgpl-3.0-plus_173.yml", "YAML", 0, 0, 0, 7, 0, 0, 1, 8
"d:\IDEWORK\lvmen\src\licensedcode\data\rules\lgpl-3.0-plus_174.yml", "YAML", 0, 0, 0, 5, 0, 0, 1, 6
"d:\IDEWORK\lvmen\src\licensedcode\data\rules\lgpl-3.0-plus_175.yml", "YAML", 0, 0, 0, 3, 0, 0, 1, 4
"d:\IDEWORK\lvmen\src\licensedcode\data\rules\lgpl-3.0-plus_176.yml", "YAML", 0, 0, 0, 3, 0, 0, 1, 4
"d:\IDEWORK\lvmen\src\licensedcode\data\rules\lgpl-3.0-plus_177.yml", "YAML", 0, 0, 0, 5, 0, 0, 1, 6
"d:\IDEWORK\lvmen\src\licensedcode\data\rules\lgpl-3.0-plus_178.yml", "YAML", 0, 0, 0, 6, 0, 0, 1, 7
"d:\IDEWORK\lvmen\src\licensedcode\data\rules\lgpl-3.0-plus_179.yml", "YAML", 0, 0, 0, 3, 0, 0, 1, 4
"d:\IDEWORK\lvmen\src\licensedcode\data\rules\lgpl-3.0-plus_18.yml", "YAML", 0, 0, 0, 6, 0, 0, 2, 8
"d:\IDEWORK\lvmen\src\licensedcode\data\rules\lgpl-3.0-plus_180.yml", "YAML", 0, 0, 0, 6, 0, 0, 1, 7
"d:\IDEWORK\lvmen\src\licensedcode\data\rules\lgpl-3.0-plus_181.yml", "YAML", 0, 0, 0, 3, 0, 0, 1, 4
"d:\IDEWORK\lvmen\src\licensedcode\data\rules\lgpl-3.0-plus_182.yml", "YAML", 0, 0, 0, 3, 0, 0, 1, 4
"d:\IDEWORK\lvmen\src\licensedcode\data\rules\lgpl-3.0-plus_183.yml", "YAML", 0, 0, 0, 3, 0, 0, 1, 4
"d:\IDEWORK\lvmen\src\licensedcode\data\rules\lgpl-3.0-plus_184.yml", "YAML", 0, 0, 0, 5, 0, 0, 1, 6
"d:\IDEWORK\lvmen\src\licensedcode\data\rules\lgpl-3.0-plus_185.yml", "YAML", 0, 0, 0, 5, 0, 0, 1, 6
"d:\IDEWORK\lvmen\src\licensedcode\data\rules\lgpl-3.0-plus_186.yml", "YAML", 0, 0, 0, 3, 0, 0, 1, 4
"d:\IDEWORK\lvmen\src\licensedcode\data\rules\lgpl-3.0-plus_187.yml", "YAML", 0, 0, 0, 7, 0, 0, 1, 8
"d:\IDEWORK\lvmen\src\licensedcode\data\rules\lgpl-3.0-plus_188.yml", "YAML", 0, 0, 0, 2, 0, 0, 1, 3
"d:\IDEWORK\lvmen\src\licensedcode\data\rules\lgpl-3.0-plus_189.yml", "YAML", 0, 0, 0, 4, 0, 0, 1, 5
"d:\IDEWORK\lvmen\src\licensedcode\data\rules\lgpl-3.0-plus_19.yml", "YAML", 0, 0, 0, 5, 0, 0, 1, 6
"d:\IDEWORK\lvmen\src\licensedcode\data\rules\lgpl-3.0-plus_190.yml", "YAML", 0, 0, 0, 4, 0, 0, 1, 5
"d:\IDEWORK\lvmen\src\licensedcode\data\rules\lgpl-3.0-plus_191.yml", "YAML", 0, 0, 0, 6, 0, 0, 1, 7
"d:\IDEWORK\lvmen\src\licensedcode\data\rules\lgpl-3.0-plus_192.yml", "YAML", 0, 0, 0, 4, 0, 0, 1, 5
"d:\IDEWORK\lvmen\src\licensedcode\data\rules\lgpl-3.0-plus_193.yml", "YAML", 0, 0, 0, 6, 0, 0, 1, 7
"d:\IDEWORK\lvmen\src\licensedcode\data\rules\lgpl-3.0-plus_194.yml", "YAML", 0, 0, 0, 4, 0, 0, 1, 5
"d:\IDEWORK\lvmen\src\licensedcode\data\rules\lgpl-3.0-plus_195.yml", "YAML", 0, 0, 0, 4, 0, 0, 1, 5
"d:\IDEWORK\lvmen\src\licensedcode\data\rules\lgpl-3.0-plus_196.yml", "YAML", 0, 0, 0, 6, 0, 0, 1, 7
"d:\IDEWORK\lvmen\src\licensedcode\data\rules\lgpl-3.0-plus_197.yml", "YAML", 0, 0, 0, 7, 0, 0, 1, 8
"d:\IDEWORK\lvmen\src\licensedcode\data\rules\lgpl-3.0-plus_198.yml", "YAML", 0, 0, 0, 7, 0, 0, 1, 8
"d:\IDEWORK\lvmen\src\licensedcode\data\rules\lgpl-3.0-plus_199.yml", "YAML", 0, 0, 0, 7, 0, 0, 1, 8
"d:\IDEWORK\lvmen\src\licensedcode\data\rules\lgpl-3.0-plus_2.yml", "YAML", 0, 0, 0, 2, 0, 0, 1, 3
"d:\IDEWORK\lvmen\src\licensedcode\data\rules\lgpl-3.0-plus_20.yml", "YAML", 0, 0, 0, 2, 0, 0, 1, 3
"d:\IDEWORK\lvmen\src\licensedcode\data\rules\lgpl-3.0-plus_200.yml", "YAML", 0, 0, 0, 7, 0, 0, 1, 8
"d:\IDEWORK\lvmen\src\licensedcode\data\rules\lgpl-3.0-plus_201.yml", "YAML", 0, 0, 0, 7, 0, 0, 1, 8
"d:\IDEWORK\lvmen\src\licensedcode\data\rules\lgpl-3.0-plus_202.yml", "YAML", 0, 0, 0, 5, 0, 0, 1, 6
"d:\IDEWORK\lvmen\src\licensedcode\data\rules\lgpl-3.0-plus_203.yml", "YAML", 0, 0, 0, 7, 0, 0, 1, 8
"d:\IDEWORK\lvmen\src\licensedcode\data\rules\lgpl-3.0-plus_204.yml", "YAML", 0, 0, 0, 5, 0, 0, 1, 6
"d:\IDEWORK\lvmen\src\licensedcode\data\rules\lgpl-3.0-plus_205.yml", "YAML", 0, 0, 0, 5, 0, 0, 1, 6
"d:\IDEWORK\lvmen\src\licensedcode\data\rules\lgpl-3.0-plus_206.yml", "YAML", 0, 0, 0, 6, 0, 0, 1, 7
"d:\IDEWORK\lvmen\src\licensedcode\data\rules\lgpl-3.0-plus_207.yml", "YAML", 0, 0, 0, 6, 0, 0, 1, 7
"d:\IDEWORK\lvmen\src\licensedcode\data\rules\lgpl-3.0-plus_208.yml", "YAML", 0, 0, 0, 8, 0, 0, 1, 9
"d:\IDEWORK\lvmen\src\licensedcode\data\rules\lgpl-3.0-plus_209.yml", "YAML", 0, 0, 0, 5, 0, 0, 1, 6
"d:\IDEWORK\lvmen\src\licensedcode\data\rules\lgpl-3.0-plus_21.yml", "YAML", 0, 0, 0, 4, 0, 0, 1, 5
"d:\IDEWORK\lvmen\src\licensedcode\data\rules\lgpl-3.0-plus_210.yml", "YAML", 0, 0, 0, 5, 0, 0, 1, 6
"d:\IDEWORK\lvmen\src\licensedcode\data\rules\lgpl-3.0-plus_211.yml", "YAML", 0, 0, 0, 5, 0, 0, 1, 6
"d:\IDEWORK\lvmen\src\licensedcode\data\rules\lgpl-3.0-plus_212.yml", "YAML", 0, 0, 0, 5, 0, 0, 1, 6
"d:\IDEWORK\lvmen\src\licensedcode\data\rules\lgpl-3.0-plus_213.yml", "YAML", 0, 0, 0, 5, 0, 0, 1, 6
"d:\IDEWORK\lvmen\src\licensedcode\data\rules\lgpl-3.0-plus_214.yml", "YAML", 0, 0, 0, 5, 0, 0, 1, 6
"d:\IDEWORK\lvmen\src\licensedcode\data\rules\lgpl-3.0-plus_215.yml", "YAML", 0, 0, 0, 6, 0, 0, 1, 7
"d:\IDEWORK\lvmen\src\licensedcode\data\rules\lgpl-3.0-plus_216.yml", "YAML", 0, 0, 0, 6, 0, 0, 1, 7
"d:\IDEWORK\lvmen\src\licensedcode\data\rules\lgpl-3.0-plus_217.yml", "YAML", 0, 0, 0, 7, 0, 0, 1, 8
"d:\IDEWORK\lvmen\src\licensedcode\data\rules\lgpl-3.0-plus_218.yml", "YAML", 0, 0, 0, 5, 0, 0, 1, 6
"d:\IDEWORK\lvmen\src\licensedcode\data\rules\lgpl-3.0-plus_219.yml", "YAML", 0, 0, 0, 5, 0, 0, 1, 6
"d:\IDEWORK\lvmen\src\licensedcode\data\rules\lgpl-3.0-plus_22.yml", "YAML", 0, 0, 0, 5, 0, 0, 1, 6
"d:\IDEWORK\lvmen\src\licensedcode\data\rules\lgpl-3.0-plus_220.yml", "YAML", 0, 0, 0, 5, 0, 0, 1, 6
"d:\IDEWORK\lvmen\src\licensedcode\data\rules\lgpl-3.0-plus_221.yml", "YAML", 0, 0, 0, 7, 0, 0, 1, 8
"d:\IDEWORK\lvmen\src\licensedcode\data\rules\lgpl-3.0-plus_222.yml", "YAML", 0, 0, 0, 5, 0, 0, 1, 6
"d:\IDEWORK\lvmen\src\licensedcode\data\rules\lgpl-3.0-plus_223.yml", "YAML", 0, 0, 0, 5, 0, 0, 1, 6
"d:\IDEWORK\lvmen\src\licensedcode\data\rules\lgpl-3.0-plus_224.yml", "YAML", 0, 0, 0, 7, 0, 0, 1, 8
"d:\IDEWORK\lvmen\src\licensedcode\data\rules\lgpl-3.0-plus_225.yml", "YAML", 0, 0, 0, 5, 0, 0, 1, 6
"d:\IDEWORK\lvmen\src\licensedcode\data\rules\lgpl-3.0-plus_226.yml", "YAML", 0, 0, 0, 7, 0, 0, 1, 8
"d:\IDEWORK\lvmen\src\licensedcode\data\rules\lgpl-3.0-plus_227.yml", "YAML", 0, 0, 0, 7, 0, 0, 1, 8
"d:\IDEWORK\lvmen\src\licensedcode\data\rules\lgpl-3.0-plus_228.yml", "YAML", 0, 0, 0, 5, 0, 0, 1, 6
"d:\IDEWORK\lvmen\src\licensedcode\data\rules\lgpl-3.0-plus_229.yml", "YAML", 0, 0, 0, 5, 0, 0, 1, 6
"d:\IDEWORK\lvmen\src\licensedcode\data\rules\lgpl-3.0-plus_23.yml", "YAML", 0, 0, 0, 3, 0, 0, 1, 4
"d:\IDEWORK\lvmen\src\licensedcode\data\rules\lgpl-3.0-plus_230.yml", "YAML", 0, 0, 0, 5, 0, 0, 1, 6
"d:\IDEWORK\lvmen\src\licensedcode\data\rules\lgpl-3.0-plus_231.yml", "YAML", 0, 0, 0, 5, 0, 0, 1, 6
"d:\IDEWORK\lvmen\src\licensedcode\data\rules\lgpl-3.0-plus_232.yml", "YAML", 0, 0, 0, 5, 0, 0, 1, 6
"d:\IDEWORK\lvmen\src\licensedcode\data\rules\lgpl-3.0-plus_233.yml", "YAML", 0, 0, 0, 5, 0, 0, 1, 6
"d:\IDEWORK\lvmen\src\licensedcode\data\rules\lgpl-3.0-plus_234.yml", "YAML", 0, 0, 0, 5, 0, 0, 1, 6
"d:\IDEWORK\lvmen\src\licensedcode\data\rules\lgpl-3.0-plus_235.yml", "YAML", 0, 0, 0, 5, 0, 0, 1, 6
"d:\IDEWORK\lvmen\src\licensedcode\data\rules\lgpl-3.0-plus_236.yml", "YAML", 0, 0, 0, 5, 0, 0, 1, 6
"d:\IDEWORK\lvmen\src\licensedcode\data\rules\lgpl-3.0-plus_237.yml", "YAML", 0, 0, 0, 5, 0, 0, 1, 6
"d:\IDEWORK\lvmen\src\licensedcode\data\rules\lgpl-3.0-plus_238.yml", "YAML", 0, 0, 0, 6, 0, 0, 1, 7
"d:\IDEWORK\lvmen\src\licensedcode\data\rules\lgpl-3.0-plus_239.yml", "YAML", 0, 0, 0, 5, 0, 0, 1, 6
"d:\IDEWORK\lvmen\src\licensedcode\data\rules\lgpl-3.0-plus_24.yml", "YAML", 0, 0, 0, 4, 0, 0, 1, 5
"d:\IDEWORK\lvmen\src\licensedcode\data\rules\lgpl-3.0-plus_240.yml", "YAML", 0, 0, 0, 5, 0, 0, 1, 6
"d:\IDEWORK\lvmen\src\licensedcode\data\rules\lgpl-3.0-plus_241.yml", "YAML", 0, 0, 0, 6, 0, 0, 1, 7
"d:\IDEWORK\lvmen\src\licensedcode\data\rules\lgpl-3.0-plus_242.yml", "YAML", 0, 0, 0, 6, 0, 0, 1, 7
"d:\IDEWORK\lvmen\src\licensedcode\data\rules\lgpl-3.0-plus_243.yml", "YAML", 0, 0, 0, 4, 0, 0, 1, 5
"d:\IDEWORK\lvmen\src\licensedcode\data\rules\lgpl-3.0-plus_244.yml", "YAML", 0, 0, 0, 6, 0, 0, 1, 7
"d:\IDEWORK\lvmen\src\licensedcode\data\rules\lgpl-3.0-plus_245.yml", "YAML", 0, 0, 0, 7, 0, 0, 1, 8
"d:\IDEWORK\lvmen\src\licensedcode\data\rules\lgpl-3.0-plus_246.yml", "YAML", 0, 0, 0, 7, 0, 0, 1, 8
"d:\IDEWORK\lvmen\src\licensedcode\data\rules\lgpl-3.0-plus_247.yml", "YAML", 0, 0, 0, 7, 0, 0, 1, 8
"d:\IDEWORK\lvmen\src\licensedcode\data\rules\lgpl-3.0-plus_248.yml", "YAML", 0, 0, 0, 7, 0, 0, 1, 8
"d:\IDEWORK\lvmen\src\licensedcode\data\rules\lgpl-3.0-plus_249.yml", "YAML", 0, 0, 0, 7, 0, 0, 1, 8
"d:\IDEWORK\lvmen\src\licensedcode\data\rules\lgpl-3.0-plus_25.yml", "YAML", 0, 0, 0, 4, 0, 0, 1, 5
"d:\IDEWORK\lvmen\src\licensedcode\data\rules\lgpl-3.0-plus_250.yml", "YAML", 0, 0, 0, 7, 0, 0, 1, 8
"d:\IDEWORK\lvmen\src\licensedcode\data\rules\lgpl-3.0-plus_251.yml", "YAML", 0, 0, 0, 7, 0, 0, 1, 8
"d:\IDEWORK\lvmen\src\licensedcode\data\rules\lgpl-3.0-plus_252.yml", "YAML", 0, 0, 0, 7, 0, 0, 1, 8
"d:\IDEWORK\lvmen\src\licensedcode\data\rules\lgpl-3.0-plus_253.yml", "YAML", 0, 0, 0, 5, 0, 0, 1, 6
"d:\IDEWORK\lvmen\src\licensedcode\data\rules\lgpl-3.0-plus_254.yml", "YAML", 0, 0, 0, 7, 0, 0, 1, 8
"d:\IDEWORK\lvmen\src\licensedcode\data\rules\lgpl-3.0-plus_255.yml", "YAML", 0, 0, 0, 5, 0, 0, 1, 6
"d:\IDEWORK\lvmen\src\licensedcode\data\rules\lgpl-3.0-plus_256.yml", "YAML", 0, 0, 0, 5, 0, 0, 1, 6
"d:\IDEWORK\lvmen\src\licensedcode\data\rules\lgpl-3.0-plus_257.yml", "YAML", 0, 0, 0, 5, 0, 0, 1, 6
"d:\IDEWORK\lvmen\src\licensedcode\data\rules\lgpl-3.0-plus_26.yml", "YAML", 0, 0, 0, 2, 0, 0, 1, 3
"d:\IDEWORK\lvmen\src\licensedcode\data\rules\lgpl-3.0-plus_27.yml", "YAML", 0, 0, 0, 5, 0, 0, 1, 6
"d:\IDEWORK\lvmen\src\licensedcode\data\rules\lgpl-3.0-plus_28.yml", "YAML", 0, 0, 0, 5, 0, 0, 1, 6
"d:\IDEWORK\lvmen\src\licensedcode\data\rules\lgpl-3.0-plus_29.yml", "YAML", 0, 0, 0, 3, 0, 0, 1, 4
"d:\IDEWORK\lvmen\src\licensedcode\data\rules\lgpl-3.0-plus_3.yml", "YAML", 0, 0, 0, 9, 0, 0, 1, 10
"d:\IDEWORK\lvmen\src\licensedcode\data\rules\lgpl-3.0-plus_30.yml", "YAML", 0, 0, 0, 3, 0, 0, 1, 4
"d:\IDEWORK\lvmen\src\licensedcode\data\rules\lgpl-3.0-plus_31.yml", "YAML", 0, 0, 0, 3, 0, 0, 1, 4
"d:\IDEWORK\lvmen\src\licensedcode\data\rules\lgpl-3.0-plus_32.yml", "YAML", 0, 0, 0, 3, 0, 0, 1, 4
"d:\IDEWORK\lvmen\src\licensedcode\data\rules\lgpl-3.0-plus_33.yml", "YAML", 0, 0, 0, 3, 0, 0, 1, 4
"d:\IDEWORK\lvmen\src\licensedcode\data\rules\lgpl-3.0-plus_34.yml", "YAML", 0, 0, 0, 3, 0, 0, 1, 4
"d:\IDEWORK\lvmen\src\licensedcode\data\rules\lgpl-3.0-plus_35.yml", "YAML", 0, 0, 0, 3, 0, 0, 1, 4
"d:\IDEWORK\lvmen\src\licensedcode\data\rules\lgpl-3.0-plus_36.yml", "YAML", 0, 0, 0, 3, 0, 0, 1, 4
"d:\IDEWORK\lvmen\src\licensedcode\data\rules\lgpl-3.0-plus_37.yml", "YAML", 0, 0, 0, 3, 0, 0, 1, 4
"d:\IDEWORK\lvmen\src\licensedcode\data\rules\lgpl-3.0-plus_38.yml", "YAML", 0, 0, 0, 3, 0, 0, 1, 4
"d:\IDEWORK\lvmen\src\licensedcode\data\rules\lgpl-3.0-plus_39.yml", "YAML", 0, 0, 0, 3, 0, 0, 1, 4
"d:\IDEWORK\lvmen\src\licensedcode\data\rules\lgpl-3.0-plus_4.yml", "YAML", 0, 0, 0, 4, 0, 0, 1, 5
"d:\IDEWORK\lvmen\src\licensedcode\data\rules\lgpl-3.0-plus_40.yml", "YAML", 0, 0, 0, 3, 0, 0, 1, 4
"d:\IDEWORK\lvmen\src\licensedcode\data\rules\lgpl-3.0-plus_41.yml", "YAML", 0, 0, 0, 3, 0, 0, 1, 4
"d:\IDEWORK\lvmen\src\licensedcode\data\rules\lgpl-3.0-plus_42.yml", "YAML", 0, 0, 0, 3, 0, 0, 1, 4
"d:\IDEWORK\lvmen\src\licensedcode\data\rules\lgpl-3.0-plus_43.yml", "YAML", 0, 0, 0, 3, 0, 0, 1, 4
"d:\IDEWORK\lvmen\src\licensedcode\data\rules\lgpl-3.0-plus_44.yml", "YAML", 0, 0, 0, 3, 0, 0, 1, 4
"d:\IDEWORK\lvmen\src\licensedcode\data\rules\lgpl-3.0-plus_45.yml", "YAML", 0, 0, 0, 3, 0, 0, 1, 4
"d:\IDEWORK\lvmen\src\licensedcode\data\rules\lgpl-3.0-plus_46.yml", "YAML", 0, 0, 0, 3, 0, 0, 1, 4
"d:\IDEWORK\lvmen\src\licensedcode\data\rules\lgpl-3.0-plus_47.yml", "YAML", 0, 0, 0, 3, 0, 0, 1, 4
"d:\IDEWORK\lvmen\src\licensedcode\data\rules\lgpl-3.0-plus_48.yml", "YAML", 0, 0, 0, 3, 0, 0, 1, 4
"d:\IDEWORK\lvmen\src\licensedcode\data\rules\lgpl-3.0-plus_49.yml", "YAML", 0, 0, 0, 3, 0, 0, 1, 4
"d:\IDEWORK\lvmen\src\licensedcode\data\rules\lgpl-3.0-plus_5.yml", "YAML", 0, 0, 0, 4, 0, 0, 1, 5
"d:\IDEWORK\lvmen\src\licensedcode\data\rules\lgpl-3.0-plus_50.yml", "YAML", 0, 0, 0, 3, 0, 0, 1, 4
"d:\IDEWORK\lvmen\src\licensedcode\data\rules\lgpl-3.0-plus_51.yml", "YAML", 0, 0, 0, 3, 0, 0, 1, 4
"d:\IDEWORK\lvmen\src\licensedcode\data\rules\lgpl-3.0-plus_52.yml", "YAML", 0, 0, 0, 3, 0, 0, 1, 4
"d:\IDEWORK\lvmen\src\licensedcode\data\rules\lgpl-3.0-plus_53.yml", "YAML", 0, 0, 0, 3, 0, 0, 1, 4
"d:\IDEWORK\lvmen\src\licensedcode\data\rules\lgpl-3.0-plus_54.yml", "YAML", 0, 0, 0, 3, 0, 0, 1, 4
"d:\IDEWORK\lvmen\src\licensedcode\data\rules\lgpl-3.0-plus_55.yml", "YAML", 0, 0, 0, 3, 0, 0, 1, 4
"d:\IDEWORK\lvmen\src\licensedcode\data\rules\lgpl-3.0-plus_56.yml", "YAML", 0, 0, 0, 3, 0, 0, 1, 4
"d:\IDEWORK\lvmen\src\licensedcode\data\rules\lgpl-3.0-plus_57.yml", "YAML", 0, 0, 0, 3, 0, 0, 1, 4
"d:\IDEWORK\lvmen\src\licensedcode\data\rules\lgpl-3.0-plus_58.yml", "YAML", 0, 0, 0, 3, 0, 0, 1, 4
"d:\IDEWORK\lvmen\src\licensedcode\data\rules\lgpl-3.0-plus_59.yml", "YAML", 0, 0, 0, 3, 0, 0, 1, 4
"d:\IDEWORK\lvmen\src\licensedcode\data\rules\lgpl-3.0-plus_5_1.yml", "YAML", 0, 0, 0, 5, 0, 0, 1, 6
"d:\IDEWORK\lvmen\src\licensedcode\data\rules\lgpl-3.0-plus_6.yml", "YAML", 0, 0, 0, 4, 0, 0, 1, 5
"d:\IDEWORK\lvmen\src\licensedcode\data\rules\lgpl-3.0-plus_60.yml", "YAML", 0, 0, 0, 3, 0, 0, 1, 4
"d:\IDEWORK\lvmen\src\licensedcode\data\rules\lgpl-3.0-plus_61.yml", "YAML", 0, 0, 0, 3, 0, 0, 1, 4
"d:\IDEWORK\lvmen\src\licensedcode\data\rules\lgpl-3.0-plus_62.yml", "YAML", 0, 0, 0, 3, 0, 0, 1, 4
"d:\IDEWORK\lvmen\src\licensedcode\data\rules\lgpl-3.0-plus_63.yml", "YAML", 0, 0, 0, 3, 0, 0, 1, 4
"d:\IDEWORK\lvmen\src\licensedcode\data\rules\lgpl-3.0-plus_64.yml", "YAML", 0, 0, 0, 3, 0, 0, 1, 4
"d:\IDEWORK\lvmen\src\licensedcode\data\rules\lgpl-3.0-plus_65.yml", "YAML", 0, 0, 0, 3, 0, 0, 1, 4
"d:\IDEWORK\lvmen\src\licensedcode\data\rules\lgpl-3.0-plus_66.yml", "YAML", 0, 0, 0, 3, 0, 0, 1, 4
"d:\IDEWORK\lvmen\src\licensedcode\data\rules\lgpl-3.0-plus_67.yml", "YAML", 0, 0, 0, 3, 0, 0, 1, 4
"d:\IDEWORK\lvmen\src\licensedcode\data\rules\lgpl-3.0-plus_68.yml", "YAML", 0, 0, 0, 3, 0, 0, 1, 4
"d:\IDEWORK\lvmen\src\licensedcode\data\rules\lgpl-3.0-plus_69.yml", "YAML", 0, 0, 0, 3, 0, 0, 1, 4
"d:\IDEWORK\lvmen\src\licensedcode\data\rules\lgpl-3.0-plus_7.yml", "YAML", 0, 0, 0, 4, 0, 0, 1, 5
"d:\IDEWORK\lvmen\src\licensedcode\data\rules\lgpl-3.0-plus_70.yml", "YAML", 0, 0, 0, 3, 0, 0, 1, 4
"d:\IDEWORK\lvmen\src\licensedcode\data\rules\lgpl-3.0-plus_71.yml", "YAML", 0, 0, 0, 3, 0, 0, 1, 4
"d:\IDEWORK\lvmen\src\licensedcode\data\rules\lgpl-3.0-plus_72.yml", "YAML", 0, 0, 0, 3, 0, 0, 1, 4
"d:\IDEWORK\lvmen\src\licensedcode\data\rules\lgpl-3.0-plus_73.yml", "YAML", 0, 0, 0, 3, 0, 0, 1, 4
"d:\IDEWORK\lvmen\src\licensedcode\data\rules\lgpl-3.0-plus_74.yml", "YAML", 0, 0, 0, 3, 0, 0, 1, 4
"d:\IDEWORK\lvmen\src\licensedcode\data\rules\lgpl-3.0-plus_75.yml", "YAML", 0, 0, 0, 3, 0, 0, 1, 4
"d:\IDEWORK\lvmen\src\licensedcode\data\rules\lgpl-3.0-plus_76.yml", "YAML", 0, 0, 0, 3, 0, 0, 1, 4
"d:\IDEWORK\lvmen\src\licensedcode\data\rules\lgpl-3.0-plus_77.yml", "YAML", 0, 0, 0, 3, 0, 0, 1, 4
"d:\IDEWORK\lvmen\src\licensedcode\data\rules\lgpl-3.0-plus_78.yml", "YAML", 0, 0, 0, 3, 0, 0, 1, 4
"d:\IDEWORK\lvmen\src\licensedcode\data\rules\lgpl-3.0-plus_79.yml", "YAML", 0, 0, 0, 3, 0, 0, 1, 4
"d:\IDEWORK\lvmen\src\licensedcode\data\rules\lgpl-3.0-plus_8.yml", "YAML", 0, 0, 0, 4, 0, 0, 1, 5
"d:\IDEWORK\lvmen\src\licensedcode\data\rules\lgpl-3.0-plus_80.yml", "YAML", 0, 0, 0, 3, 0, 0, 1, 4
"d:\IDEWORK\lvmen\src\licensedcode\data\rules\lgpl-3.0-plus_81.yml", "YAML", 0, 0, 0, 3, 0, 0, 1, 4
"d:\IDEWORK\lvmen\src\licensedcode\data\rules\lgpl-3.0-plus_82.yml", "YAML", 0, 0, 0, 3, 0, 0, 1, 4
"d:\IDEWORK\lvmen\src\licensedcode\data\rules\lgpl-3.0-plus_83.yml", "YAML", 0, 0, 0, 3, 0, 0, 1, 4
"d:\IDEWORK\lvmen\src\licensedcode\data\rules\lgpl-3.0-plus_84.yml", "YAML", 0, 0, 0, 3, 0, 0, 1, 4
"d:\IDEWORK\lvmen\src\licensedcode\data\rules\lgpl-3.0-plus_85.yml", "YAML", 0, 0, 0, 3, 0, 0, 1, 4
"d:\IDEWORK\lvmen\src\licensedcode\data\rules\lgpl-3.0-plus_86.yml", "YAML", 0, 0, 0, 3, 0, 0, 1, 4
"d:\IDEWORK\lvmen\src\licensedcode\data\rules\lgpl-3.0-plus_87.yml", "YAML", 0, 0, 0, 3, 0, 0, 1, 4
"d:\IDEWORK\lvmen\src\licensedcode\data\rules\lgpl-3.0-plus_88.yml", "YAML", 0, 0, 0, 3, 0, 0, 1, 4
"d:\IDEWORK\lvmen\src\licensedcode\data\rules\lgpl-3.0-plus_89.yml", "YAML", 0, 0, 0, 3, 0, 0, 1, 4
"d:\IDEWORK\lvmen\src\licensedcode\data\rules\lgpl-3.0-plus_9.yml", "YAML", 0, 0, 0, 4, 0, 0, 1, 5
"d:\IDEWORK\lvmen\src\licensedcode\data\rules\lgpl-3.0-plus_90.yml", "YAML", 0, 0, 0, 3, 0, 0, 1, 4
"d:\IDEWORK\lvmen\src\licensedcode\data\rules\lgpl-3.0-plus_91.yml", "YAML", 0, 0, 0, 3, 0, 0, 1, 4
"d:\IDEWORK\lvmen\src\licensedcode\data\rules\lgpl-3.0-plus_92.yml", "YAML", 0, 0, 0, 3, 0, 0, 1, 4
"d:\IDEWORK\lvmen\src\licensedcode\data\rules\lgpl-3.0-plus_93.yml", "YAML", 0, 0, 0, 5, 0, 0, 1, 6
"d:\IDEWORK\lvmen\src\licensedcode\data\rules\lgpl-3.0-plus_94.yml", "YAML", 0, 0, 0, 5, 0, 0, 1, 6
"d:\IDEWORK\lvmen\src\licensedcode\data\rules\lgpl-3.0-plus_95.yml", "YAML", 0, 0, 0, 3, 0, 0, 1, 4
"d:\IDEWORK\lvmen\src\licensedcode\data\rules\lgpl-3.0-plus_96.yml", "YAML", 0, 0, 0, 5, 0, 0, 1, 6
"d:\IDEWORK\lvmen\src\licensedcode\data\rules\lgpl-3.0-plus_97.yml", "YAML", 0, 0, 0, 4, 0, 0, 1, 5
"d:\IDEWORK\lvmen\src\licensedcode\data\rules\lgpl-3.0-plus_98.yml", "YAML", 0, 0, 0, 5, 0, 0, 1, 6
"d:\IDEWORK\lvmen\src\licensedcode\data\rules\lgpl-3.0-plus_99.yml", "YAML", 0, 0, 0, 5, 0, 0, 1, 6
"d:\IDEWORK\lvmen\src\licensedcode\data\rules\lgpl-3.0-plus_and_gpl-2.0-plus_1.yml", "YAML", 0, 0, 0, 3, 0, 0, 1, 4
"d:\IDEWORK\lvmen\src\licensedcode\data\rules\lgpl-3.0-plus_and_gpl-3.0-plus_1.yml", "YAML", 0, 0, 0, 3, 0, 0, 1, 4
"d:\IDEWORK\lvmen\src\licensedcode\data\rules\lgpl-3.0-plus_and_lgpl-2.0-plus_and_apache-2.0_and_bsd-new_and_cc-by-4.0_1.yml", "YAML", 0, 0, 0, 3, 0, 0, 1, 4
"d:\IDEWORK\lvmen\src\licensedcode\data\rules\lgpl-3.0-plus_and_proprietary-license_1.yml", "YAML", 0, 0, 0, 2, 0, 0, 1, 3
"d:\IDEWORK\lvmen\src\licensedcode\data\rules\lgpl-3.0-plus_and_proprietary-license_2.yml", "YAML", 0, 0, 0, 2, 0, 0, 1, 3
"d:\IDEWORK\lvmen\src\licensedcode\data\rules\lgpl-3.0-plus_and_proprietary-license_3.yml", "YAML", 0, 0, 0, 4, 0, 0, 1, 5
"d:\IDEWORK\lvmen\src\licensedcode\data\rules\lgpl-3.0-plus_and_proprietary-license_4.yml", "YAML", 0, 0, 0, 5, 0, 0, 1, 6
"d:\IDEWORK\lvmen\src\licensedcode\data\rules\lgpl-3.0-plus_or_apache-2.0_1.yml", "YAML", 0, 0, 0, 5, 0, 0, 1, 6
"d:\IDEWORK\lvmen\src\licensedcode\data\rules\lgpl-3.0-plus_or_apache-2.0_2.yml", "YAML", 0, 0, 0, 5, 0, 0, 1, 6
"d:\IDEWORK\lvmen\src\licensedcode\data\rules\lgpl-3.0-plus_or_apache-2.0_3.yml", "YAML", 0, 0, 0, 6, 0, 0, 1, 7
"d:\IDEWORK\lvmen\src\licensedcode\data\rules\lgpl-3.0-plus_or_apache-2.0_4.yml", "YAML", 0, 0, 0, 7, 0, 0, 1, 8
"d:\IDEWORK\lvmen\src\licensedcode\data\rules\lgpl-3.0-plus_or_apache-2.0_5.yml", "YAML", 0, 0, 0, 6, 0, 0, 1, 7
"d:\IDEWORK\lvmen\src\licensedcode\data\rules\lgpl-3.0-plus_or_apache-2.0_6.yml", "YAML", 0, 0, 0, 7, 0, 0, 1, 8
"d:\IDEWORK\lvmen\src\licensedcode\data\rules\lgpl-3.0-plus_or_apache-2.0_7.yml", "YAML", 0, 0, 0, 7, 0, 0, 1, 8
"d:\IDEWORK\lvmen\src\licensedcode\data\rules\lgpl-3.0-plus_or_apache-2.0_8.yml", "YAML", 0, 0, 0, 7, 0, 0, 1, 8
"d:\IDEWORK\lvmen\src\licensedcode\data\rules\lgpl-3.0-plus_or_bsd-new.yml", "YAML", 0, 0, 0, 6, 0, 0, 1, 7
"d:\IDEWORK\lvmen\src\licensedcode\data\rules\lgpl-3.0-plus_or_bsd-new2.yml", "YAML", 0, 0, 0, 5, 0, 0, 1, 6
"d:\IDEWORK\lvmen\src\licensedcode\data\rules\lgpl-3.0-plus_or_bsd-new3.yml", "YAML", 0, 0, 0, 5, 0, 0, 1, 6
"d:\IDEWORK\lvmen\src\licensedcode\data\rules\lgpl-3.0-plus_or_bsd-new4.yml", "YAML", 0, 0, 0, 6, 0, 0, 1, 7
"d:\IDEWORK\lvmen\src\licensedcode\data\rules\lgpl-3.0-plus_or_bsd-new5.yml", "YAML", 0, 0, 0, 6, 0, 0, 1, 7
"d:\IDEWORK\lvmen\src\licensedcode\data\rules\lgpl-3.0-plus_or_bsd-new_1.yml", "YAML", 0, 0, 0, 7, 0, 0, 1, 8
"d:\IDEWORK\lvmen\src\licensedcode\data\rules\lgpl-3.0-plus_or_cc-by-sa-3.0_1.yml", "YAML", 0, 0, 0, 3, 0, 0, 1, 4
"d:\IDEWORK\lvmen\src\licensedcode\data\rules\lgpl-3.0-plus_or_gpl-2.0-plus_1.yml", "YAML", 0, 0, 0, 5, 0, 0, 1, 6
"d:\IDEWORK\lvmen\src\licensedcode\data\rules\lgpl-3.0-plus_or_gpl-2.0-plus_10.yml", "YAML", 0, 0, 0, 5, 0, 0, 1, 6
"d:\IDEWORK\lvmen\src\licensedcode\data\rules\lgpl-3.0-plus_or_gpl-2.0-plus_11.yml", "YAML", 0, 0, 0, 3, 0, 0, 1, 4
"d:\IDEWORK\lvmen\src\licensedcode\data\rules\lgpl-3.0-plus_or_gpl-2.0-plus_12.yml", "YAML", 0, 0, 0, 6, 0, 0, 1, 7
"d:\IDEWORK\lvmen\src\licensedcode\data\rules\lgpl-3.0-plus_or_gpl-2.0-plus_13.yml", "YAML", 0, 0, 0, 4, 0, 0, 1, 5
"d:\IDEWORK\lvmen\src\licensedcode\data\rules\lgpl-3.0-plus_or_gpl-2.0-plus_14.yml", "YAML", 0, 0, 0, 6, 0, 0, 1, 7
"d:\IDEWORK\lvmen\src\licensedcode\data\rules\lgpl-3.0-plus_or_gpl-2.0-plus_15.yml", "YAML", 0, 0, 0, 4, 0, 0, 1, 5
"d:\IDEWORK\lvmen\src\licensedcode\data\rules\lgpl-3.0-plus_or_gpl-2.0-plus_16.yml", "YAML", 0, 0, 0, 5, 0, 0, 1, 6
"d:\IDEWORK\lvmen\src\licensedcode\data\rules\lgpl-3.0-plus_or_gpl-2.0-plus_17.yml", "YAML", 0, 0, 0, 6, 0, 0, 1, 7
"d:\IDEWORK\lvmen\src\licensedcode\data\rules\lgpl-3.0-plus_or_gpl-2.0-plus_18.yml", "YAML", 0, 0, 0, 5, 0, 0, 1, 6
"d:\IDEWORK\lvmen\src\licensedcode\data\rules\lgpl-3.0-plus_or_gpl-2.0-plus_19.yml", "YAML", 0, 0, 0, 6, 0, 0, 1, 7
"d:\IDEWORK\lvmen\src\licensedcode\data\rules\lgpl-3.0-plus_or_gpl-2.0-plus_2.yml", "YAML", 0, 0, 0, 4, 0, 0, 1, 5
"d:\IDEWORK\lvmen\src\licensedcode\data\rules\lgpl-3.0-plus_or_gpl-2.0-plus_20.yml", "YAML", 0, 0, 0, 6, 0, 0, 1, 7
"d:\IDEWORK\lvmen\src\licensedcode\data\rules\lgpl-3.0-plus_or_gpl-2.0-plus_21.yml", "YAML", 0, 0, 0, 5, 0, 0, 1, 6
"d:\IDEWORK\lvmen\src\licensedcode\data\rules\lgpl-3.0-plus_or_gpl-2.0-plus_22.yml", "YAML", 0, 0, 0, 6, 0, 0, 1, 7
"d:\IDEWORK\lvmen\src\licensedcode\data\rules\lgpl-3.0-plus_or_gpl-2.0-plus_23.yml", "YAML", 0, 0, 0, 4, 0, 0, 1, 5
"d:\IDEWORK\lvmen\src\licensedcode\data\rules\lgpl-3.0-plus_or_gpl-2.0-plus_24.yml", "YAML", 0, 0, 0, 3, 0, 0, 1, 4
"d:\IDEWORK\lvmen\src\licensedcode\data\rules\lgpl-3.0-plus_or_gpl-2.0-plus_25.yml", "YAML", 0, 0, 0, 3, 0, 0, 1, 4
"d:\IDEWORK\lvmen\src\licensedcode\data\rules\lgpl-3.0-plus_or_gpl-2.0-plus_26.yml", "YAML", 0, 0, 0, 2, 0, 0, 1, 3
"d:\IDEWORK\lvmen\src\licensedcode\data\rules\lgpl-3.0-plus_or_gpl-2.0-plus_27.yml", "YAML", 0, 0, 0, 4, 0, 0, 1, 5
"d:\IDEWORK\lvmen\src\licensedcode\data\rules\lgpl-3.0-plus_or_gpl-2.0-plus_3.yml", "YAML", 0, 0, 0, 5, 0, 0, 1, 6
"d:\IDEWORK\lvmen\src\licensedcode\data\rules\lgpl-3.0-plus_or_gpl-2.0-plus_4.yml", "YAML", 0, 0, 0, 3, 0, 0, 1, 4
"d:\IDEWORK\lvmen\src\licensedcode\data\rules\lgpl-3.0-plus_or_gpl-2.0-plus_5.yml", "YAML", 0, 0, 0, 4, 0, 0, 1, 5
"d:\IDEWORK\lvmen\src\licensedcode\data\rules\lgpl-3.0-plus_or_gpl-2.0-plus_6.yml", "YAML", 0, 0, 0, 5, 0, 0, 1, 6
"d:\IDEWORK\lvmen\src\licensedcode\data\rules\lgpl-3.0-plus_or_gpl-2.0-plus_7.yml", "YAML", 0, 0, 0, 5, 0, 0, 1, 6
"d:\IDEWORK\lvmen\src\licensedcode\data\rules\lgpl-3.0-plus_or_gpl-2.0-plus_8.yml", "YAML", 0, 0, 0, 5, 0, 0, 1, 6
"d:\IDEWORK\lvmen\src\licensedcode\data\rules\lgpl-3.0-plus_or_gpl-2.0-plus_9.yml", "YAML", 0, 0, 0, 3, 0, 0, 1, 4
"d:\IDEWORK\lvmen\src\licensedcode\data\rules\lgpl-3.0-plus_or_gpl-2.0-plus_elfutils.yml", "YAML", 0, 0, 0, 5, 0, 0, 1, 6
"d:\IDEWORK\lvmen\src\licensedcode\data\rules\lgpl-3.0-plus_url_1.yml", "YAML", 0, 0, 0, 5, 0, 0, 1, 6
"d:\IDEWORK\lvmen\src\licensedcode\data\rules\lgpl-3.0-plus_url_2.yml", "YAML", 0, 0, 0, 5, 0, 0, 1, 6
"d:\IDEWORK\lvmen\src\licensedcode\data\rules\lgpl-3.0-plus_with_cygwin-exception_and_gpl-3.0_and_other-permissive_1.yml", "YAML", 0, 0, 0, 5, 0, 0, 1, 6
"d:\IDEWORK\lvmen\src\licensedcode\data\rules\lgpl-3.0-plus_with_independent-module-linking-exception_1.yml", "YAML", 0, 0, 0, 6, 0, 0, 1, 7
"d:\IDEWORK\lvmen\src\licensedcode\data\rules\lgpl-3.0-plus_with_independent-module-linking-exception_and_free-unknown_1.yml", "YAML", 0, 0, 0, 6, 0, 0, 1, 7
"d:\IDEWORK\lvmen\src\licensedcode\data\rules\lgpl-3.0-plus_with_independent-module-linking-exception_and_free-unknown_2.yml", "YAML", 0, 0, 0, 6, 0, 0, 1, 7
"d:\IDEWORK\lvmen\src\licensedcode\data\rules\lgpl-3.0-plus_with_linking_exception_4.yml", "YAML", 0, 0, 0, 5, 0, 0, 1, 6
"d:\IDEWORK\lvmen\src\licensedcode\data\rules\lgpl-3.0-plus_with_linking_exception_and_other3.yml", "YAML", 0, 0, 0, 5, 0, 0, 1, 6
"d:\IDEWORK\lvmen\src\licensedcode\data\rules\lgpl-3.0-plus_with_linking_exception_and_other4.yml", "YAML", 0, 0, 0, 5, 0, 0, 1, 6
"d:\IDEWORK\lvmen\src\licensedcode\data\rules\lgpl-3.0-plus_with_ocaml-lgpl-linking-exception_1.yml", "YAML", 0, 0, 0, 5, 0, 0, 1, 6
"d:\IDEWORK\lvmen\src\licensedcode\data\rules\lgpl-3.0-plus_with_openssl-exception-lgpl-3.0-plus_1.yml", "YAML", 0, 0, 0, 4, 0, 0, 1, 5
"d:\IDEWORK\lvmen\src\licensedcode\data\rules\lgpl-3.0-plus_with_openssl-exception-lgpl-3.0-plus_2.yml", "YAML", 0, 0, 0, 5, 0, 0, 1, 6
"d:\IDEWORK\lvmen\src\licensedcode\data\rules\lgpl-3.0-plus_with_openssl-exception-lgpl-3.0-plus_3.yml", "YAML", 0, 0, 0, 4, 0, 0, 1, 5
"d:\IDEWORK\lvmen\src\licensedcode\data\rules\lgpl-3.0-plus_with_openssl-exception-lgpl-3.0-plus_4.yml", "YAML", 0, 0, 0, 4, 0, 0, 1, 5
"d:\IDEWORK\lvmen\src\licensedcode\data\rules\lgpl-3.0-plus_with_openssl-exception-lgpl-3.0-plus_5.yml", "YAML", 0, 0, 0, 4, 0, 0, 1, 5
"d:\IDEWORK\lvmen\src\licensedcode\data\rules\lgpl-3.0-plus_with_openssl-exception-lgpl-3.0-plus_and_zpl-2.0_and_zlib_1.yml", "YAML", 0, 0, 0, 4, 0, 0, 1, 5
"d:\IDEWORK\lvmen\src\licensedcode\data\rules\lgpl-3.0-plus_with_zeromq-exception-lgpl-3.0_1.yml", "YAML", 0, 0, 0, 5, 0, 0, 1, 6
"d:\IDEWORK\lvmen\src\licensedcode\data\rules\lgpl-3.0-plus_with_zeromq-exception-lgpl-3.0_2.yml", "YAML", 0, 0, 0, 5, 0, 0, 1, 6
"d:\IDEWORK\lvmen\src\licensedcode\data\rules\lgpl-3.0.SPDX.yml", "YAML", 0, 0, 0, 10, 0, 0, 1, 11
"d:\IDEWORK\lvmen\src\licensedcode\data\rules\lgpl-3.0.yml", "YAML", 0, 0, 0, 5, 0, 0, 1, 6
"d:\IDEWORK\lvmen\src\licensedcode\data\rules\lgpl-3.0_1.yml", "YAML", 0, 0, 0, 5, 0, 0, 1, 6
"d:\IDEWORK\lvmen\src\licensedcode\data\rules\lgpl-3.0_10.yml", "YAML", 0, 0, 0, 5, 0, 0, 1, 6
"d:\IDEWORK\lvmen\src\licensedcode\data\rules\lgpl-3.0_100.yml", "YAML", 0, 0, 0, 5, 0, 0, 1, 6
"d:\IDEWORK\lvmen\src\licensedcode\data\rules\lgpl-3.0_101.yml", "YAML", 0, 0, 0, 5, 0, 0, 1, 6
"d:\IDEWORK\lvmen\src\licensedcode\data\rules\lgpl-3.0_102.yml", "YAML", 0, 0, 0, 5, 0, 0, 1, 6
"d:\IDEWORK\lvmen\src\licensedcode\data\rules\lgpl-3.0_103.yml", "YAML", 0, 0, 0, 5, 0, 0, 1, 6
"d:\IDEWORK\lvmen\src\licensedcode\data\rules\lgpl-3.0_104.yml", "YAML", 0, 0, 0, 5, 0, 0, 1, 6
"d:\IDEWORK\lvmen\src\licensedcode\data\rules\lgpl-3.0_105.yml", "YAML", 0, 0, 0, 5, 0, 0, 1, 6
"d:\IDEWORK\lvmen\src\licensedcode\data\rules\lgpl-3.0_106.yml", "YAML", 0, 0, 0, 5, 0, 0, 1, 6
"d:\IDEWORK\lvmen\src\licensedcode\data\rules\lgpl-3.0_107.yml", "YAML", 0, 0, 0, 5, 0, 0, 1, 6
"d:\IDEWORK\lvmen\src\licensedcode\data\rules\lgpl-3.0_108.yml", "YAML", 0, 0, 0, 5, 0, 0, 1, 6
"d:\IDEWORK\lvmen\src\licensedcode\data\rules\lgpl-3.0_109.yml", "YAML", 0, 0, 0, 5, 0, 0, 1, 6
"d:\IDEWORK\lvmen\src\licensedcode\data\rules\lgpl-3.0_11.yml", "YAML", 0, 0, 0, 3, 0, 0, 1, 4
"d:\IDEWORK\lvmen\src\licensedcode\data\rules\lgpl-3.0_110.yml", "YAML", 0, 0, 0, 5, 0, 0, 1, 6
"d:\IDEWORK\lvmen\src\licensedcode\data\rules\lgpl-3.0_111.yml", "YAML", 0, 0, 0, 3, 0, 0, 1, 4
"d:\IDEWORK\lvmen\src\licensedcode\data\rules\lgpl-3.0_112.yml", "YAML", 0, 0, 0, 5, 0, 0, 1, 6
"d:\IDEWORK\lvmen\src\licensedcode\data\rules\lgpl-3.0_113.yml", "YAML", 0, 0, 0, 3, 0, 0, 1, 4
"d:\IDEWORK\lvmen\src\licensedcode\data\rules\lgpl-3.0_114.yml", "YAML", 0, 0, 0, 5, 0, 0, 1, 6
"d:\IDEWORK\lvmen\src\licensedcode\data\rules\lgpl-3.0_115.yml", "YAML", 0, 0, 0, 3, 0, 0, 1, 4
"d:\IDEWORK\lvmen\src\licensedcode\data\rules\lgpl-3.0_116.yml", "YAML", 0, 0, 0, 5, 0, 0, 1, 6
"d:\IDEWORK\lvmen\src\licensedcode\data\rules\lgpl-3.0_117.yml", "YAML", 0, 0, 0, 3, 0, 0, 1, 4
"d:\IDEWORK\lvmen\src\licensedcode\data\rules\lgpl-3.0_118.yml", "YAML", 0, 0, 0, 5, 0, 0, 1, 6
"d:\IDEWORK\lvmen\src\licensedcode\data\rules\lgpl-3.0_119.yml", "YAML", 0, 0, 0, 3, 0, 0, 1, 4
"d:\IDEWORK\lvmen\src\licensedcode\data\rules\lgpl-3.0_12.yml", "YAML", 0, 0, 0, 3, 0, 0, 1, 4
"d:\IDEWORK\lvmen\src\licensedcode\data\rules\lgpl-3.0_120.yml", "YAML", 0, 0, 0, 5, 0, 0, 1, 6
"d:\IDEWORK\lvmen\src\licensedcode\data\rules\lgpl-3.0_121.yml", "YAML", 0, 0, 0, 5, 0, 0, 1, 6
"d:\IDEWORK\lvmen\src\licensedcode\data\rules\lgpl-3.0_122.yml", "YAML", 0, 0, 0, 5, 0, 0, 1, 6
"d:\IDEWORK\lvmen\src\licensedcode\data\rules\lgpl-3.0_123.yml", "YAML", 0, 0, 0, 5, 0, 0, 1, 6
"d:\IDEWORK\lvmen\src\licensedcode\data\rules\lgpl-3.0_124.yml", "YAML", 0, 0, 0, 5, 0, 0, 1, 6
"d:\IDEWORK\lvmen\src\licensedcode\data\rules\lgpl-3.0_125.yml", "YAML", 0, 0, 0, 5, 0, 0, 1, 6
"d:\IDEWORK\lvmen\src\licensedcode\data\rules\lgpl-3.0_126.yml", "YAML", 0, 0, 0, 5, 0, 0, 1, 6
"d:\IDEWORK\lvmen\src\licensedcode\data\rules\lgpl-3.0_127.yml", "YAML", 0, 0, 0, 5, 0, 0, 1, 6
"d:\IDEWORK\lvmen\src\licensedcode\data\rules\lgpl-3.0_128.yml", "YAML", 0, 0, 0, 5, 0, 0, 1, 6
"d:\IDEWORK\lvmen\src\licensedcode\data\rules\lgpl-3.0_129.yml", "YAML", 0, 0, 0, 5, 0, 0, 1, 6
"d:\IDEWORK\lvmen\src\licensedcode\data\rules\lgpl-3.0_13.yml", "YAML", 0, 0, 0, 5, 0, 0, 1, 6
"d:\IDEWORK\lvmen\src\licensedcode\data\rules\lgpl-3.0_130.yml", "YAML", 0, 0, 0, 3, 0, 0, 1, 4
"d:\IDEWORK\lvmen\src\licensedcode\data\rules\lgpl-3.0_131.yml", "YAML", 0, 0, 0, 3, 0, 0, 1, 4
"d:\IDEWORK\lvmen\src\licensedcode\data\rules\lgpl-3.0_132.yml", "YAML", 0, 0, 0, 4, 0, 0, 1, 5
"d:\IDEWORK\lvmen\src\licensedcode\data\rules\lgpl-3.0_133.yml", "YAML", 0, 0, 0, 3, 0, 0, 1, 4
"d:\IDEWORK\lvmen\src\licensedcode\data\rules\lgpl-3.0_134.yml", "YAML", 0, 0, 0, 3, 0, 0, 1, 4
"d:\IDEWORK\lvmen\src\licensedcode\data\rules\lgpl-3.0_135.yml", "YAML", 0, 0, 0, 3, 0, 0, 1, 4
"d:\IDEWORK\lvmen\src\licensedcode\data\rules\lgpl-3.0_136.yml", "YAML", 0, 0, 0, 3, 0, 0, 1, 4
"d:\IDEWORK\lvmen\src\licensedcode\data\rules\lgpl-3.0_137.yml", "YAML", 0, 0, 0, 3, 0, 0, 1, 4
"d:\IDEWORK\lvmen\src\licensedcode\data\rules\lgpl-3.0_138.yml", "YAML", 0, 0, 0, 3, 0, 0, 1, 4
"d:\IDEWORK\lvmen\src\licensedcode\data\rules\lgpl-3.0_139.yml", "YAML", 0, 0, 0, 5, 0, 0, 1, 6
"d:\IDEWORK\lvmen\src\licensedcode\data\rules\lgpl-3.0_14.yml", "YAML", 0, 0, 0, 5, 0, 0, 1, 6
"d:\IDEWORK\lvmen\src\licensedcode\data\rules\lgpl-3.0_140.yml", "YAML", 0, 0, 0, 3, 0, 0, 1, 4
"d:\IDEWORK\lvmen\src\licensedcode\data\rules\lgpl-3.0_141.yml", "YAML", 0, 0, 0, 3, 0, 0, 1, 4
"d:\IDEWORK\lvmen\src\licensedcode\data\rules\lgpl-3.0_142.yml", "YAML", 0, 0, 0, 5, 0, 0, 1, 6
"d:\IDEWORK\lvmen\src\licensedcode\data\rules\lgpl-3.0_143.yml", "YAML", 0, 0, 0, 8, 0, 0, 1, 9
"d:\IDEWORK\lvmen\src\licensedcode\data\rules\lgpl-3.0_144.yml", "YAML", 0, 0, 0, 6, 0, 0, 1, 7
"d:\IDEWORK\lvmen\src\licensedcode\data\rules\lgpl-3.0_145.yml", "YAML", 0, 0, 0, 6, 0, 0, 1, 7
"d:\IDEWORK\lvmen\src\licensedcode\data\rules\lgpl-3.0_146.yml", "YAML", 0, 0, 0, 5, 0, 0, 1, 6
"d:\IDEWORK\lvmen\src\licensedcode\data\rules\lgpl-3.0_147.yml", "YAML", 0, 0, 0, 4, 0, 0, 1, 5
"d:\IDEWORK\lvmen\src\licensedcode\data\rules\lgpl-3.0_148.yml", "YAML", 0, 0, 0, 4, 0, 0, 1, 5
"d:\IDEWORK\lvmen\src\licensedcode\data\rules\lgpl-3.0_149.yml", "YAML", 0, 0, 0, 4, 0, 0, 1, 5
"d:\IDEWORK\lvmen\src\licensedcode\data\rules\lgpl-3.0_15.yml", "YAML", 0, 0, 0, 3, 0, 0, 1, 4
"d:\IDEWORK\lvmen\src\licensedcode\data\rules\lgpl-3.0_150.yml", "YAML", 0, 0, 0, 4, 0, 0, 1, 5
"d:\IDEWORK\lvmen\src\licensedcode\data\rules\lgpl-3.0_151.yml", "YAML", 0, 0, 0, 4, 0, 0, 1, 5
"d:\IDEWORK\lvmen\src\licensedcode\data\rules\lgpl-3.0_152.yml", "YAML", 0, 0, 0, 3, 0, 0, 1, 4
"d:\IDEWORK\lvmen\src\licensedcode\data\rules\lgpl-3.0_153.yml", "YAML", 0, 0, 0, 3, 0, 0, 1, 4
"d:\IDEWORK\lvmen\src\licensedcode\data\rules\lgpl-3.0_154.yml", "YAML", 0, 0, 0, 3, 0, 0, 1, 4
"d:\IDEWORK\lvmen\src\licensedcode\data\rules\lgpl-3.0_155.yml", "YAML", 0, 0, 0, 3, 0, 0, 1, 4
"d:\IDEWORK\lvmen\src\licensedcode\data\rules\lgpl-3.0_156.yml", "YAML", 0, 0, 0, 3, 0, 0, 1, 4
"d:\IDEWORK\lvmen\src\licensedcode\data\rules\lgpl-3.0_157.yml", "YAML", 0, 0, 0, 5, 0, 0, 1, 6
"d:\IDEWORK\lvmen\src\licensedcode\data\rules\lgpl-3.0_158.yml", "YAML", 0, 0, 0, 6, 0, 0, 1, 7
"d:\IDEWORK\lvmen\src\licensedcode\data\rules\lgpl-3.0_159.yml", "YAML", 0, 0, 0, 3, 0, 0, 1, 4
"d:\IDEWORK\lvmen\src\licensedcode\data\rules\lgpl-3.0_16.yml", "YAML", 0, 0, 0, 2, 0, 0, 1, 3
"d:\IDEWORK\lvmen\src\licensedcode\data\rules\lgpl-3.0_160.yml", "YAML", 0, 0, 0, 4, 0, 0, 1, 5
"d:\IDEWORK\lvmen\src\licensedcode\data\rules\lgpl-3.0_161.yml", "YAML", 0, 0, 0, 5, 0, 0, 1, 6
"d:\IDEWORK\lvmen\src\licensedcode\data\rules\lgpl-3.0_162.yml", "YAML", 0, 0, 0, 5, 0, 0, 1, 6
"d:\IDEWORK\lvmen\src\licensedcode\data\rules\lgpl-3.0_163.yml", "YAML", 0, 0, 0, 5, 0, 0, 1, 6
"d:\IDEWORK\lvmen\src\licensedcode\data\rules\lgpl-3.0_164.yml", "YAML", 0, 0, 0, 5, 0, 0, 1, 6
"d:\IDEWORK\lvmen\src\licensedcode\data\rules\lgpl-3.0_165.yml", "YAML", 0, 0, 0, 5, 0, 0, 1, 6
"d:\IDEWORK\lvmen\src\licensedcode\data\rules\lgpl-3.0_166.yml", "YAML", 0, 0, 0, 4, 0, 0, 1, 5
"d:\IDEWORK\lvmen\src\licensedcode\data\rules\lgpl-3.0_167.yml", "YAML", 0, 0, 0, 3, 0, 0, 1, 4
"d:\IDEWORK\lvmen\src\licensedcode\data\rules\lgpl-3.0_168.yml", "YAML", 0, 0, 0, 3, 0, 0, 1, 4
"d:\IDEWORK\lvmen\src\licensedcode\data\rules\lgpl-3.0_169.yml", "YAML", 0, 0, 0, 5, 0, 0, 1, 6
"d:\IDEWORK\lvmen\src\licensedcode\data\rules\lgpl-3.0_17.yml", "YAML", 0, 0, 0, 5, 0, 0, 1, 6
"d:\IDEWORK\lvmen\src\licensedcode\data\rules\lgpl-3.0_170.yml", "YAML", 0, 0, 0, 5, 0, 0, 1, 6
"d:\IDEWORK\lvmen\src\licensedcode\data\rules\lgpl-3.0_171.yml", "YAML", 0, 0, 0, 3, 0, 0, 1, 4
"d:\IDEWORK\lvmen\src\licensedcode\data\rules\lgpl-3.0_172.yml", "YAML", 0, 0, 0, 3, 0, 0, 1, 4
"d:\IDEWORK\lvmen\src\licensedcode\data\rules\lgpl-3.0_173.yml", "YAML", 0, 0, 0, 3, 0, 0, 1, 4
"d:\IDEWORK\lvmen\src\licensedcode\data\rules\lgpl-3.0_174.yml", "YAML", 0, 0, 0, 3, 0, 0, 1, 4
"d:\IDEWORK\lvmen\src\licensedcode\data\rules\lgpl-3.0_175.yml", "YAML", 0, 0, 0, 3, 0, 0, 1, 4
"d:\IDEWORK\lvmen\src\licensedcode\data\rules\lgpl-3.0_176.yml", "YAML", 0, 0, 0, 3, 0, 0, 1, 4
"d:\IDEWORK\lvmen\src\licensedcode\data\rules\lgpl-3.0_177.yml", "YAML", 0, 0, 0, 3, 0, 0, 1, 4
"d:\IDEWORK\lvmen\src\licensedcode\data\rules\lgpl-3.0_178.yml", "YAML", 0, 0, 0, 3, 0, 0, 1, 4
"d:\IDEWORK\lvmen\src\licensedcode\data\rules\lgpl-3.0_179.yml", "YAML", 0, 0, 0, 3, 0, 0, 1, 4
"d:\IDEWORK\lvmen\src\licensedcode\data\rules\lgpl-3.0_18.yml", "YAML", 0, 0, 0, 5, 0, 0, 1, 6
"d:\IDEWORK\lvmen\src\licensedcode\data\rules\lgpl-3.0_180.yml", "YAML", 0, 0, 0, 3, 0, 0, 1, 4
"d:\IDEWORK\lvmen\src\licensedcode\data\rules\lgpl-3.0_181.yml", "YAML", 0, 0, 0, 3, 0, 0, 1, 4
"d:\IDEWORK\lvmen\src\licensedcode\data\rules\lgpl-3.0_182.yml", "YAML", 0, 0, 0, 3, 0, 0, 1, 4
"d:\IDEWORK\lvmen\src\licensedcode\data\rules\lgpl-3.0_183.yml", "YAML", 0, 0, 0, 3, 0, 0, 1, 4
"d:\IDEWORK\lvmen\src\licensedcode\data\rules\lgpl-3.0_184.yml", "YAML", 0, 0, 0, 3, 0, 0, 1, 4
"d:\IDEWORK\lvmen\src\licensedcode\data\rules\lgpl-3.0_185.yml", "YAML", 0, 0, 0, 3, 0, 0, 1, 4
"d:\IDEWORK\lvmen\src\licensedcode\data\rules\lgpl-3.0_186.yml", "YAML", 0, 0, 0, 3, 0, 0, 1, 4
"d:\IDEWORK\lvmen\src\licensedcode\data\rules\lgpl-3.0_187.yml", "YAML", 0, 0, 0, 3, 0, 0, 1, 4
"d:\IDEWORK\lvmen\src\licensedcode\data\rules\lgpl-3.0_188.yml", "YAML", 0, 0, 0, 3, 0, 0, 1, 4
"d:\IDEWORK\lvmen\src\licensedcode\data\rules\lgpl-3.0_189.yml", "YAML", 0, 0, 0, 3, 0, 0, 1, 4
"d:\IDEWORK\lvmen\src\licensedcode\data\rules\lgpl-3.0_19.yml", "YAML", 0, 0, 0, 2, 0, 0, 1, 3
"d:\IDEWORK\lvmen\src\licensedcode\data\rules\lgpl-3.0_190.yml", "YAML", 0, 0, 0, 3, 0, 0, 1, 4
"d:\IDEWORK\lvmen\src\licensedcode\data\rules\lgpl-3.0_191.yml", "YAML", 0, 0, 0, 3, 0, 0, 1, 4
"d:\IDEWORK\lvmen\src\licensedcode\data\rules\lgpl-3.0_192.yml", "YAML", 0, 0, 0, 3, 0, 0, 1, 4
"d:\IDEWORK\lvmen\src\licensedcode\data\rules\lgpl-3.0_193.yml", "YAML", 0, 0, 0, 3, 0, 0, 1, 4
"d:\IDEWORK\lvmen\src\licensedcode\data\rules\lgpl-3.0_194.yml", "YAML", 0, 0, 0, 3, 0, 0, 1, 4
"d:\IDEWORK\lvmen\src\licensedcode\data\rules\lgpl-3.0_195.yml", "YAML", 0, 0, 0, 3, 0, 0, 1, 4
"d:\IDEWORK\lvmen\src\licensedcode\data\rules\lgpl-3.0_196.yml", "YAML", 0, 0, 0, 3, 0, 0, 1, 4
"d:\IDEWORK\lvmen\src\licensedcode\data\rules\lgpl-3.0_197.yml", "YAML", 0, 0, 0, 3, 0, 0, 1, 4
"d:\IDEWORK\lvmen\src\licensedcode\data\rules\lgpl-3.0_198.yml", "YAML", 0, 0, 0, 3, 0, 0, 1, 4
"d:\IDEWORK\lvmen\src\licensedcode\data\rules\lgpl-3.0_199.yml", "YAML", 0, 0, 0, 3, 0, 0, 1, 4
"d:\IDEWORK\lvmen\src\licensedcode\data\rules\lgpl-3.0_2.yml", "YAML", 0, 0, 0, 3, 0, 0, 1, 4
"d:\IDEWORK\lvmen\src\licensedcode\data\rules\lgpl-3.0_20.yml", "YAML", 0, 0, 0, 5, 0, 0, 1, 6
"d:\IDEWORK\lvmen\src\licensedcode\data\rules\lgpl-3.0_200.yml", "YAML", 0, 0, 0, 3, 0, 0, 1, 4
"d:\IDEWORK\lvmen\src\licensedcode\data\rules\lgpl-3.0_201.yml", "YAML", 0, 0, 0, 3, 0, 0, 1, 4
"d:\IDEWORK\lvmen\src\licensedcode\data\rules\lgpl-3.0_202.yml", "YAML", 0, 0, 0, 3, 0, 0, 1, 4
"d:\IDEWORK\lvmen\src\licensedcode\data\rules\lgpl-3.0_203.yml", "YAML", 0, 0, 0, 3, 0, 0, 1, 4
"d:\IDEWORK\lvmen\src\licensedcode\data\rules\lgpl-3.0_204.yml", "YAML", 0, 0, 0, 3, 0, 0, 1, 4
"d:\IDEWORK\lvmen\src\licensedcode\data\rules\lgpl-3.0_205.yml", "YAML", 0, 0, 0, 3, 0, 0, 1, 4
"d:\IDEWORK\lvmen\src\licensedcode\data\rules\lgpl-3.0_206.yml", "YAML", 0, 0, 0, 3, 0, 0, 1, 4
"d:\IDEWORK\lvmen\src\licensedcode\data\rules\lgpl-3.0_207.yml", "YAML", 0, 0, 0, 3, 0, 0, 1, 4
"d:\IDEWORK\lvmen\src\licensedcode\data\rules\lgpl-3.0_208.yml", "YAML", 0, 0, 0, 3, 0, 0, 1, 4
"d:\IDEWORK\lvmen\src\licensedcode\data\rules\lgpl-3.0_209.yml", "YAML", 0, 0, 0, 3, 0, 0, 1, 4
"d:\IDEWORK\lvmen\src\licensedcode\data\rules\lgpl-3.0_21.yml", "YAML", 0, 0, 0, 3, 0, 0, 1, 4
"d:\IDEWORK\lvmen\src\licensedcode\data\rules\lgpl-3.0_210.yml", "YAML", 0, 0, 0, 3, 0, 0, 1, 4
"d:\IDEWORK\lvmen\src\licensedcode\data\rules\lgpl-3.0_211.yml", "YAML", 0, 0, 0, 3, 0, 0, 1, 4
"d:\IDEWORK\lvmen\src\licensedcode\data\rules\lgpl-3.0_212.yml", "YAML", 0, 0, 0, 3, 0, 0, 1, 4
"d:\IDEWORK\lvmen\src\licensedcode\data\rules\lgpl-3.0_213.yml", "YAML", 0, 0, 0, 3, 0, 0, 1, 4
"d:\IDEWORK\lvmen\src\licensedcode\data\rules\lgpl-3.0_214.yml", "YAML", 0, 0, 0, 3, 0, 0, 1, 4
"d:\IDEWORK\lvmen\src\licensedcode\data\rules\lgpl-3.0_215.yml", "YAML", 0, 0, 0, 3, 0, 0, 1, 4
"d:\IDEWORK\lvmen\src\licensedcode\data\rules\lgpl-3.0_216.yml", "YAML", 0, 0, 0, 3, 0, 0, 1, 4
"d:\IDEWORK\lvmen\src\licensedcode\data\rules\lgpl-3.0_217.yml", "YAML", 0, 0, 0, 3, 0, 0, 1, 4
"d:\IDEWORK\lvmen\src\licensedcode\data\rules\lgpl-3.0_218.yml", "YAML", 0, 0, 0, 3, 0, 0, 1, 4
"d:\IDEWORK\lvmen\src\licensedcode\data\rules\lgpl-3.0_219.yml", "YAML", 0, 0, 0, 3, 0, 0, 1, 4
"d:\IDEWORK\lvmen\src\licensedcode\data\rules\lgpl-3.0_22.yml", "YAML", 0, 0, 0, 5, 0, 0, 1, 6
"d:\IDEWORK\lvmen\src\licensedcode\data\rules\lgpl-3.0_220.yml", "YAML", 0, 0, 0, 3, 0, 0, 1, 4
"d:\IDEWORK\lvmen\src\licensedcode\data\rules\lgpl-3.0_221.yml", "YAML", 0, 0, 0, 3, 0, 0, 1, 4
"d:\IDEWORK\lvmen\src\licensedcode\data\rules\lgpl-3.0_222.yml", "YAML", 0, 0, 0, 3, 0, 0, 1, 4
"d:\IDEWORK\lvmen\src\licensedcode\data\rules\lgpl-3.0_223.yml", "YAML", 0, 0, 0, 3, 0, 0, 1, 4
"d:\IDEWORK\lvmen\src\licensedcode\data\rules\lgpl-3.0_224.yml", "YAML", 0, 0, 0, 3, 0, 0, 1, 4
"d:\IDEWORK\lvmen\src\licensedcode\data\rules\lgpl-3.0_225.yml", "YAML", 0, 0, 0, 3, 0, 0, 1, 4
"d:\IDEWORK\lvmen\src\licensedcode\data\rules\lgpl-3.0_226.yml", "YAML", 0, 0, 0, 3, 0, 0, 1, 4
"d:\IDEWORK\lvmen\src\licensedcode\data\rules\lgpl-3.0_227.yml", "YAML", 0, 0, 0, 3, 0, 0, 1, 4
"d:\IDEWORK\lvmen\src\licensedcode\data\rules\lgpl-3.0_228.yml", "YAML", 0, 0, 0, 3, 0, 0, 1, 4
"d:\IDEWORK\lvmen\src\licensedcode\data\rules\lgpl-3.0_229.yml", "YAML", 0, 0, 0, 3, 0, 0, 1, 4
"d:\IDEWORK\lvmen\src\licensedcode\data\rules\lgpl-3.0_23.yml", "YAML", 0, 0, 0, 8, 0, 0, 1, 9
"d:\IDEWORK\lvmen\src\licensedcode\data\rules\lgpl-3.0_230.yml", "YAML", 0, 0, 0, 3, 0, 0, 1, 4
"d:\IDEWORK\lvmen\src\licensedcode\data\rules\lgpl-3.0_231.yml", "YAML", 0, 0, 0, 3, 0, 0, 1, 4
"d:\IDEWORK\lvmen\src\licensedcode\data\rules\lgpl-3.0_232.yml", "YAML", 0, 0, 0, 3, 0, 0, 1, 4
"d:\IDEWORK\lvmen\src\licensedcode\data\rules\lgpl-3.0_233.yml", "YAML", 0, 0, 0, 3, 0, 0, 1, 4
"d:\IDEWORK\lvmen\src\licensedcode\data\rules\lgpl-3.0_234.yml", "YAML", 0, 0, 0, 3, 0, 0, 1, 4
"d:\IDEWORK\lvmen\src\licensedcode\data\rules\lgpl-3.0_235.yml", "YAML", 0, 0, 0, 7, 0, 0, 1, 8
"d:\IDEWORK\lvmen\src\licensedcode\data\rules\lgpl-3.0_236.yml", "YAML", 0, 0, 0, 5, 0, 0, 1, 6
"d:\IDEWORK\lvmen\src\licensedcode\data\rules\lgpl-3.0_237.yml", "YAML", 0, 0, 0, 6, 0, 0, 1, 7
"d:\IDEWORK\lvmen\src\licensedcode\data\rules\lgpl-3.0_238.yml", "YAML", 0, 0, 0, 3, 0, 0, 1, 4
"d:\IDEWORK\lvmen\src\licensedcode\data\rules\lgpl-3.0_239.yml", "YAML", 0, 0, 0, 3, 0, 0, 1, 4
"d:\IDEWORK\lvmen\src\licensedcode\data\rules\lgpl-3.0_24.yml", "YAML", 0, 0, 0, 2, 0, 0, 1, 3
"d:\IDEWORK\lvmen\src\licensedcode\data\rules\lgpl-3.0_240.yml", "YAML", 0, 0, 0, 3, 0, 0, 1, 4
"d:\IDEWORK\lvmen\src\licensedcode\data\rules\lgpl-3.0_241.yml", "YAML", 0, 0, 0, 5, 0, 0, 1, 6
"d:\IDEWORK\lvmen\src\licensedcode\data\rules\lgpl-3.0_242.yml", "YAML", 0, 0, 0, 4, 0, 0, 1, 5
"d:\IDEWORK\lvmen\src\licensedcode\data\rules\lgpl-3.0_243.yml", "YAML", 0, 0, 0, 4, 0, 0, 1, 5
"d:\IDEWORK\lvmen\src\licensedcode\data\rules\lgpl-3.0_244.yml", "YAML", 0, 0, 0, 5, 0, 0, 1, 6
"d:\IDEWORK\lvmen\src\licensedcode\data\rules\lgpl-3.0_245.yml", "YAML", 0, 0, 0, 5, 0, 0, 1, 6
"d:\IDEWORK\lvmen\src\licensedcode\data\rules\lgpl-3.0_246.yml", "YAML", 0, 0, 0, 4, 0, 0, 1, 5
"d:\IDEWORK\lvmen\src\licensedcode\data\rules\lgpl-3.0_247.yml", "YAML", 0, 0, 0, 3, 0, 0, 1, 4
"d:\IDEWORK\lvmen\src\licensedcode\data\rules\lgpl-3.0_248.yml", "YAML", 0, 0, 0, 6, 0, 0, 1, 7
"d:\IDEWORK\lvmen\src\licensedcode\data\rules\lgpl-3.0_249.yml", "YAML", 0, 0, 0, 6, 0, 0, 1, 7
"d:\IDEWORK\lvmen\src\licensedcode\data\rules\lgpl-3.0_25.yml", "YAML", 0, 0, 0, 3, 0, 0, 1, 4
"d:\IDEWORK\lvmen\src\licensedcode\data\rules\lgpl-3.0_250.yml", "YAML", 0, 0, 0, 6, 0, 0, 1, 7
"d:\IDEWORK\lvmen\src\licensedcode\data\rules\lgpl-3.0_251.yml", "YAML", 0, 0, 0, 5, 0, 0, 1, 6
"d:\IDEWORK\lvmen\src\licensedcode\data\rules\lgpl-3.0_252.yml", "YAML", 0, 0, 0, 5, 0, 0, 1, 6
"d:\IDEWORK\lvmen\src\licensedcode\data\rules\lgpl-3.0_253.yml", "YAML", 0, 0, 0, 5, 0, 0, 1, 6
"d:\IDEWORK\lvmen\src\licensedcode\data\rules\lgpl-3.0_254.yml", "YAML", 0, 0, 0, 5, 0, 0, 1, 6
"d:\IDEWORK\lvmen\src\licensedcode\data\rules\lgpl-3.0_255.yml", "YAML", 0, 0, 0, 5, 0, 0, 1, 6
"d:\IDEWORK\lvmen\src\licensedcode\data\rules\lgpl-3.0_256.yml", "YAML", 0, 0, 0, 5, 0, 0, 1, 6
"d:\IDEWORK\lvmen\src\licensedcode\data\rules\lgpl-3.0_257.yml", "YAML", 0, 0, 0, 5, 0, 0, 1, 6
"d:\IDEWORK\lvmen\src\licensedcode\data\rules\lgpl-3.0_258.yml", "YAML", 0, 0, 0, 5, 0, 0, 1, 6
"d:\IDEWORK\lvmen\src\licensedcode\data\rules\lgpl-3.0_259.yml", "YAML", 0, 0, 0, 5, 0, 0, 1, 6
"d:\IDEWORK\lvmen\src\licensedcode\data\rules\lgpl-3.0_26.yml", "YAML", 0, 0, 0, 3, 0, 0, 1, 4
"d:\IDEWORK\lvmen\src\licensedcode\data\rules\lgpl-3.0_260.yml", "YAML", 0, 0, 0, 6, 0, 0, 1, 7
"d:\IDEWORK\lvmen\src\licensedcode\data\rules\lgpl-3.0_261.yml", "YAML", 0, 0, 0, 5, 0, 0, 1, 6
"d:\IDEWORK\lvmen\src\licensedcode\data\rules\lgpl-3.0_262.yml", "YAML", 0, 0, 0, 5, 0, 0, 1, 6
"d:\IDEWORK\lvmen\src\licensedcode\data\rules\lgpl-3.0_263.yml", "YAML", 0, 0, 0, 5, 0, 0, 1, 6
"d:\IDEWORK\lvmen\src\licensedcode\data\rules\lgpl-3.0_264.yml", "YAML", 0, 0, 0, 5, 0, 0, 1, 6
"d:\IDEWORK\lvmen\src\licensedcode\data\rules\lgpl-3.0_265.yml", "YAML", 0, 0, 0, 5, 0, 0, 1, 6
"d:\IDEWORK\lvmen\src\licensedcode\data\rules\lgpl-3.0_266.yml", "YAML", 0, 0, 0, 5, 0, 0, 1, 6
"d:\IDEWORK\lvmen\src\licensedcode\data\rules\lgpl-3.0_267.yml", "YAML", 0, 0, 0, 5, 0, 0, 1, 6
"d:\IDEWORK\lvmen\src\licensedcode\data\rules\lgpl-3.0_268.yml", "YAML", 0, 0, 0, 5, 0, 0, 1, 6
"d:\IDEWORK\lvmen\src\licensedcode\data\rules\lgpl-3.0_269.yml", "YAML", 0, 0, 0, 3, 0, 0, 1, 4
"d:\IDEWORK\lvmen\src\licensedcode\data\rules\lgpl-3.0_27.yml", "YAML", 0, 0, 0, 3, 0, 0, 1, 4
"d:\IDEWORK\lvmen\src\licensedcode\data\rules\lgpl-3.0_270.yml", "YAML", 0, 0, 0, 3, 0, 0, 1, 4
"d:\IDEWORK\lvmen\src\licensedcode\data\rules\lgpl-3.0_271.yml", "YAML", 0, 0, 0, 3, 0, 0, 1, 4
"d:\IDEWORK\lvmen\src\licensedcode\data\rules\lgpl-3.0_272.yml", "YAML", 0, 0, 0, 5, 0, 0, 1, 6
"d:\IDEWORK\lvmen\src\licensedcode\data\rules\lgpl-3.0_273.yml", "YAML", 0, 0, 0, 6, 0, 0, 1, 7
"d:\IDEWORK\lvmen\src\licensedcode\data\rules\lgpl-3.0_274.yml", "YAML", 0, 0, 0, 5, 0, 0, 1, 6
"d:\IDEWORK\lvmen\src\licensedcode\data\rules\lgpl-3.0_275.yml", "YAML", 0, 0, 0, 5, 0, 0, 1, 6
"d:\IDEWORK\lvmen\src\licensedcode\data\rules\lgpl-3.0_28.yml", "YAML", 0, 0, 0, 3, 0, 0, 1, 4
"d:\IDEWORK\lvmen\src\licensedcode\data\rules\lgpl-3.0_29.yml", "YAML", 0, 0, 0, 3, 0, 0, 1, 4
"d:\IDEWORK\lvmen\src\licensedcode\data\rules\lgpl-3.0_3.yml", "YAML", 0, 0, 0, 3, 0, 0, 1, 4
"d:\IDEWORK\lvmen\src\licensedcode\data\rules\lgpl-3.0_30.yml", "YAML", 0, 0, 0, 3, 0, 0, 1, 4
"d:\IDEWORK\lvmen\src\licensedcode\data\rules\lgpl-3.0_31.yml", "YAML", 0, 0, 0, 5, 0, 0, 1, 6
"d:\IDEWORK\lvmen\src\licensedcode\data\rules\lgpl-3.0_32.yml", "YAML", 0, 0, 0, 6, 0, 0, 1, 7
"d:\IDEWORK\lvmen\src\licensedcode\data\rules\lgpl-3.0_33.yml", "YAML", 0, 0, 0, 3, 0, 0, 1, 4
"d:\IDEWORK\lvmen\src\licensedcode\data\rules\lgpl-3.0_34.yml", "YAML", 0, 0, 0, 3, 0, 0, 1, 4
"d:\IDEWORK\lvmen\src\licensedcode\data\rules\lgpl-3.0_35.yml", "YAML", 0, 0, 0, 4, 0, 0, 1, 5
"d:\IDEWORK\lvmen\src\licensedcode\data\rules\lgpl-3.0_36.yml", "YAML", 0, 0, 0, 3, 0, 0, 1, 4
"d:\IDEWORK\lvmen\src\licensedcode\data\rules\lgpl-3.0_37.yml", "YAML", 0, 0, 0, 3, 0, 0, 1, 4
"d:\IDEWORK\lvmen\src\licensedcode\data\rules\lgpl-3.0_38.yml", "YAML", 0, 0, 0, 3, 0, 0, 1, 4
"d:\IDEWORK\lvmen\src\licensedcode\data\rules\lgpl-3.0_39.yml", "YAML", 0, 0, 0, 3, 0, 0, 1, 4
"d:\IDEWORK\lvmen\src\licensedcode\data\rules\lgpl-3.0_4.yml", "YAML", 0, 0, 0, 4, 0, 0, 1, 5
"d:\IDEWORK\lvmen\src\licensedcode\data\rules\lgpl-3.0_40.yml", "YAML", 0, 0, 0, 5, 0, 0, 1, 6
"d:\IDEWORK\lvmen\src\licensedcode\data\rules\lgpl-3.0_41.yml", "YAML", 0, 0, 0, 5, 0, 0, 1, 6
"d:\IDEWORK\lvmen\src\licensedcode\data\rules\lgpl-3.0_42.yml", "YAML", 0, 0, 0, 3, 0, 0, 1, 4
"d:\IDEWORK\lvmen\src\licensedcode\data\rules\lgpl-3.0_43.yml", "YAML", 0, 0, 0, 5, 0, 0, 1, 6
"d:\IDEWORK\lvmen\src\licensedcode\data\rules\lgpl-3.0_44.yml", "YAML", 0, 0, 0, 5, 0, 0, 1, 6
"d:\IDEWORK\lvmen\src\licensedcode\data\rules\lgpl-3.0_45.yml", "YAML", 0, 0, 0, 5, 0, 0, 1, 6
"d:\IDEWORK\lvmen\src\licensedcode\data\rules\lgpl-3.0_46.yml", "YAML", 0, 0, 0, 3, 0, 0, 1, 4
"d:\IDEWORK\lvmen\src\licensedcode\data\rules\lgpl-3.0_47.yml", "YAML", 0, 0, 0, 5, 0, 0, 1, 6
"d:\IDEWORK\lvmen\src\licensedcode\data\rules\lgpl-3.0_48.yml", "YAML", 0, 0, 0, 3, 0, 0, 1, 4
"d:\IDEWORK\lvmen\src\licensedcode\data\rules\lgpl-3.0_49.yml", "YAML", 0, 0, 0, 3, 0, 0, 1, 4
"d:\IDEWORK\lvmen\src\licensedcode\data\rules\lgpl-3.0_5.yml", "YAML", 0, 0, 0, 5, 0, 0, 1, 6
"d:\IDEWORK\lvmen\src\licensedcode\data\rules\lgpl-3.0_50.yml", "YAML", 0, 0, 0, 3, 0, 0, 1, 4
"d:\IDEWORK\lvmen\src\licensedcode\data\rules\lgpl-3.0_500.yml", "YAML", 0, 0, 0, 5, 0, 0, 1, 6
"d:\IDEWORK\lvmen\src\licensedcode\data\rules\lgpl-3.0_51.yml", "YAML", 0, 0, 0, 3, 0, 0, 1, 4
"d:\IDEWORK\lvmen\src\licensedcode\data\rules\lgpl-3.0_52.yml", "YAML", 0, 0, 0, 3, 0, 0, 1, 4
"d:\IDEWORK\lvmen\src\licensedcode\data\rules\lgpl-3.0_53.yml", "YAML", 0, 0, 0, 3, 0, 0, 1, 4
"d:\IDEWORK\lvmen\src\licensedcode\data\rules\lgpl-3.0_54.yml", "YAML", 0, 0, 0, 3, 0, 0, 1, 4
"d:\IDEWORK\lvmen\src\licensedcode\data\rules\lgpl-3.0_55.yml", "YAML", 0, 0, 0, 3, 0, 0, 1, 4
"d:\IDEWORK\lvmen\src\licensedcode\data\rules\lgpl-3.0_56.yml", "YAML", 0, 0, 0, 3, 0, 0, 1, 4
"d:\IDEWORK\lvmen\src\licensedcode\data\rules\lgpl-3.0_57.yml", "YAML", 0, 0, 0, 3, 0, 0, 1, 4
"d:\IDEWORK\lvmen\src\licensedcode\data\rules\lgpl-3.0_58.yml", "YAML", 0, 0, 0, 3, 0, 0, 1, 4
"d:\IDEWORK\lvmen\src\licensedcode\data\rules\lgpl-3.0_59.yml", "YAML", 0, 0, 0, 3, 0, 0, 1, 4
"d:\IDEWORK\lvmen\src\licensedcode\data\rules\lgpl-3.0_6.yml", "YAML", 0, 0, 0, 2, 0, 0, 1, 3
"d:\IDEWORK\lvmen\src\licensedcode\data\rules\lgpl-3.0_60.yml", "YAML", 0, 0, 0, 3, 0, 0, 1, 4
"d:\IDEWORK\lvmen\src\licensedcode\data\rules\lgpl-3.0_61.yml", "YAML", 0, 0, 0, 3, 0, 0, 1, 4
"d:\IDEWORK\lvmen\src\licensedcode\data\rules\lgpl-3.0_62.yml", "YAML", 0, 0, 0, 3, 0, 0, 1, 4
"d:\IDEWORK\lvmen\src\licensedcode\data\rules\lgpl-3.0_63.yml", "YAML", 0, 0, 0, 3, 0, 0, 1, 4
"d:\IDEWORK\lvmen\src\licensedcode\data\rules\lgpl-3.0_64.yml", "YAML", 0, 0, 0, 3, 0, 0, 1, 4
"d:\IDEWORK\lvmen\src\licensedcode\data\rules\lgpl-3.0_65.yml", "YAML", 0, 0, 0, 3, 0, 0, 1, 4
"d:\IDEWORK\lvmen\src\licensedcode\data\rules\lgpl-3.0_66.yml", "YAML", 0, 0, 0, 3, 0, 0, 1, 4
"d:\IDEWORK\lvmen\src\licensedcode\data\rules\lgpl-3.0_67.yml", "YAML", 0, 0, 0, 3, 0, 0, 1, 4
"d:\IDEWORK\lvmen\src\licensedcode\data\rules\lgpl-3.0_68.yml", "YAML", 0, 0, 0, 3, 0, 0, 1, 4
"d:\IDEWORK\lvmen\src\licensedcode\data\rules\lgpl-3.0_69.yml", "YAML", 0, 0, 0, 3, 0, 0, 1, 4
"d:\IDEWORK\lvmen\src\licensedcode\data\rules\lgpl-3.0_7.yml", "YAML", 0, 0, 0, 5, 0, 0, 1, 6
"d:\IDEWORK\lvmen\src\licensedcode\data\rules\lgpl-3.0_70.yml", "YAML", 0, 0, 0, 3, 0, 0, 1, 4
"d:\IDEWORK\lvmen\src\licensedcode\data\rules\lgpl-3.0_71.yml", "YAML", 0, 0, 0, 3, 0, 0, 1, 4
"d:\IDEWORK\lvmen\src\licensedcode\data\rules\lgpl-3.0_72.yml", "YAML", 0, 0, 0, 3, 0, 0, 1, 4
"d:\IDEWORK\lvmen\src\licensedcode\data\rules\lgpl-3.0_73.yml", "YAML", 0, 0, 0, 3, 0, 0, 1, 4
"d:\IDEWORK\lvmen\src\licensedcode\data\rules\lgpl-3.0_74.yml", "YAML", 0, 0, 0, 3, 0, 0, 1, 4
"d:\IDEWORK\lvmen\src\licensedcode\data\rules\lgpl-3.0_75.yml", "YAML", 0, 0, 0, 3, 0, 0, 1, 4
"d:\IDEWORK\lvmen\src\licensedcode\data\rules\lgpl-3.0_76.yml", "YAML", 0, 0, 0, 3, 0, 0, 1, 4
"d:\IDEWORK\lvmen\src\licensedcode\data\rules\lgpl-3.0_77.yml", "YAML", 0, 0, 0, 3, 0, 0, 1, 4
"d:\IDEWORK\lvmen\src\licensedcode\data\rules\lgpl-3.0_78.yml", "YAML", 0, 0, 0, 3, 0, 0, 1, 4
"d:\IDEWORK\lvmen\src\licensedcode\data\rules\lgpl-3.0_79.yml", "YAML", 0, 0, 0, 3, 0, 0, 1, 4
"d:\IDEWORK\lvmen\src\licensedcode\data\rules\lgpl-3.0_8.yml", "YAML", 0, 0, 0, 3, 0, 0, 1, 4
"d:\IDEWORK\lvmen\src\licensedcode\data\rules\lgpl-3.0_80.yml", "YAML", 0, 0, 0, 3, 0, 0, 1, 4
"d:\IDEWORK\lvmen\src\licensedcode\data\rules\lgpl-3.0_81.yml", "YAML", 0, 0, 0, 3, 0, 0, 1, 4
"d:\IDEWORK\lvmen\src\licensedcode\data\rules\lgpl-3.0_82.yml", "YAML", 0, 0, 0, 3, 0, 0, 1, 4
"d:\IDEWORK\lvmen\src\licensedcode\data\rules\lgpl-3.0_83.yml", "YAML", 0, 0, 0, 3, 0, 0, 1, 4
"d:\IDEWORK\lvmen\src\licensedcode\data\rules\lgpl-3.0_84.yml", "YAML", 0, 0, 0, 3, 0, 0, 1, 4
"d:\IDEWORK\lvmen\src\licensedcode\data\rules\lgpl-3.0_85.yml", "YAML", 0, 0, 0, 5, 0, 0, 1, 6
"d:\IDEWORK\lvmen\src\licensedcode\data\rules\lgpl-3.0_86.yml", "YAML", 0, 0, 0, 5, 0, 0, 1, 6
"d:\IDEWORK\lvmen\src\licensedcode\data\rules\lgpl-3.0_87.yml", "YAML", 0, 0, 0, 5, 0, 0, 1, 6
"d:\IDEWORK\lvmen\src\licensedcode\data\rules\lgpl-3.0_88.yml", "YAML", 0, 0, 0, 5, 0, 0, 1, 6
"d:\IDEWORK\lvmen\src\licensedcode\data\rules\lgpl-3.0_89.yml", "YAML", 0, 0, 0, 3, 0, 0, 1, 4
"d:\IDEWORK\lvmen\src\licensedcode\data\rules\lgpl-3.0_9.yml", "YAML", 0, 0, 0, 5, 0, 0, 1, 6
"d:\IDEWORK\lvmen\src\licensedcode\data\rules\lgpl-3.0_90.yml", "YAML", 0, 0, 0, 3, 0, 0, 1, 4
"d:\IDEWORK\lvmen\src\licensedcode\data\rules\lgpl-3.0_91.yml", "YAML", 0, 0, 0, 5, 0, 0, 1, 6
"d:\IDEWORK\lvmen\src\licensedcode\data\rules\lgpl-3.0_92.yml", "YAML", 0, 0, 0, 5, 0, 0, 1, 6
"d:\IDEWORK\lvmen\src\licensedcode\data\rules\lgpl-3.0_93.yml", "YAML", 0, 0, 0, 3, 0, 0, 1, 4
"d:\IDEWORK\lvmen\src\licensedcode\data\rules\lgpl-3.0_94.yml", "YAML", 0, 0, 0, 3, 0, 0, 1, 4
"d:\IDEWORK\lvmen\src\licensedcode\data\rules\lgpl-3.0_95.yml", "YAML", 0, 0, 0, 3, 0, 0, 1, 4
"d:\IDEWORK\lvmen\src\licensedcode\data\rules\lgpl-3.0_96.yml", "YAML", 0, 0, 0, 3, 0, 0, 1, 4
"d:\IDEWORK\lvmen\src\licensedcode\data\rules\lgpl-3.0_97.yml", "YAML", 0, 0, 0, 3, 0, 0, 1, 4
"d:\IDEWORK\lvmen\src\licensedcode\data\rules\lgpl-3.0_98.yml", "YAML", 0, 0, 0, 3, 0, 0, 1, 4
"d:\IDEWORK\lvmen\src\licensedcode\data\rules\lgpl-3.0_99.yml", "YAML", 0, 0, 0, 3, 0, 0, 1, 4
"d:\IDEWORK\lvmen\src\licensedcode\data\rules\lgpl-3.0_and_bsd-new_1.yml", "YAML", 0, 0, 0, 3, 0, 0, 1, 4
"d:\IDEWORK\lvmen\src\licensedcode\data\rules\lgpl-3.0_and_gpl-3.0_1.yml", "YAML", 0, 0, 0, 5, 0, 0, 1, 6
"d:\IDEWORK\lvmen\src\licensedcode\data\rules\lgpl-3.0_and_gpl-3.0_2.yml", "YAML", 0, 0, 0, 6, 0, 0, 1, 7
"d:\IDEWORK\lvmen\src\licensedcode\data\rules\lgpl-3.0_and_gpl-3.0_3.yml", "YAML", 0, 0, 0, 4, 0, 0, 1, 5
"d:\IDEWORK\lvmen\src\licensedcode\data\rules\lgpl-3.0_and_lgpl-2.1_1.yml", "YAML", 0, 0, 0, 3, 0, 0, 1, 4
"d:\IDEWORK\lvmen\src\licensedcode\data\rules\lgpl-3.0_and_lgpl-2.1_2.yml", "YAML", 0, 0, 0, 3, 0, 0, 1, 4
"d:\IDEWORK\lvmen\src\licensedcode\data\rules\lgpl-3.0_and_unknown-license-reference_1.yml", "YAML", 0, 0, 0, 6, 0, 0, 1, 7
"d:\IDEWORK\lvmen\src\licensedcode\data\rules\lgpl-3.0_copying_lgplv3.yml", "YAML", 0, 0, 0, 3, 0, 0, 1, 4
"d:\IDEWORK\lvmen\src\licensedcode\data\rules\lgpl-3.0_not_plus_18.yml", "YAML", 0, 0, 0, 5, 0, 0, 1, 6
"d:\IDEWORK\lvmen\src\licensedcode\data\rules\lgpl-3.0_nuget_url_1.yml", "YAML", 0, 0, 0, 4, 0, 0, 1, 5
"d:\IDEWORK\lvmen\src\licensedcode\data\rules\lgpl-3.0_nuget_url_2.yml", "YAML", 0, 0, 0, 5, 0, 0, 1, 6
"d:\IDEWORK\lvmen\src\licensedcode\data\rules\lgpl-3.0_nuget_url_not_unknown_1.yml", "YAML", 0, 0, 0, 5, 0, 0, 1, 6
"d:\IDEWORK\lvmen\src\licensedcode\data\rules\lgpl-3.0_only.yml", "YAML", 0, 0, 0, 3, 0, 0, 1, 4
"d:\IDEWORK\lvmen\src\licensedcode\data\rules\lgpl-3.0_or_apache-2.0_1.yml", "YAML", 0, 0, 0, 6, 0, 0, 1, 7
"d:\IDEWORK\lvmen\src\licensedcode\data\rules\lgpl-3.0_or_apache-2.0_2.yml", "YAML", 0, 0, 0, 3, 0, 0, 1, 4
"d:\IDEWORK\lvmen\src\licensedcode\data\rules\lgpl-3.0_or_apache-2.0_3.yml", "YAML", 0, 0, 0, 6, 0, 0, 1, 7
"d:\IDEWORK\lvmen\src\licensedcode\data\rules\lgpl-3.0_or_apache-2.0_4.yml", "YAML", 0, 0, 0, 6, 0, 0, 1, 7
"d:\IDEWORK\lvmen\src\licensedcode\data\rules\lgpl-3.0_or_apache-2.0_5.yml", "YAML", 0, 0, 0, 3, 0, 0, 1, 4
"d:\IDEWORK\lvmen\src\licensedcode\data\rules\lgpl-3.0_or_apache-2.0_6.yml", "YAML", 0, 0, 0, 6, 0, 0, 1, 7
"d:\IDEWORK\lvmen\src\licensedcode\data\rules\lgpl-3.0_or_apache-2.0_7.yml", "YAML", 0, 0, 0, 6, 0, 0, 1, 7
"d:\IDEWORK\lvmen\src\licensedcode\data\rules\lgpl-3.0_or_commercial-license_1.yml", "YAML", 0, 0, 0, 8, 0, 0, 1, 9
"d:\IDEWORK\lvmen\src\licensedcode\data\rules\lgpl-3.0_or_commercial-license_2.yml", "YAML", 0, 0, 0, 8, 0, 0, 1, 9
"d:\IDEWORK\lvmen\src\licensedcode\data\rules\lgpl-3.0_or_gpl-2.0_1.yml", "YAML", 0, 0, 0, 3, 0, 0, 1, 4
"d:\IDEWORK\lvmen\src\licensedcode\data\rules\lgpl-3.0_or_gpl-2.0_2.yml", "YAML", 0, 0, 0, 3, 0, 0, 1, 4
"d:\IDEWORK\lvmen\src\licensedcode\data\rules\lgpl-3.0_or_lgpl-2.1_1.yml", "YAML", 0, 0, 0, 3, 0, 0, 1, 4
"d:\IDEWORK\lvmen\src\licensedcode\data\rules\lgpl-3.0_prep.ai.mit.edu.yml", "YAML", 0, 0, 0, 8, 0, 0, 1, 9
"d:\IDEWORK\lvmen\src\licensedcode\data\rules\lgpl-3.0_qt.yml", "YAML", 0, 0, 0, 11, 0, 0, 1, 12
"d:\IDEWORK\lvmen\src\licensedcode\data\rules\lgpl-3.0_url_1.yml", "YAML", 0, 0, 0, 5, 0, 0, 1, 6
"d:\IDEWORK\lvmen\src\licensedcode\data\rules\lgpl-3.0_url_2.yml", "YAML", 0, 0, 0, 5, 0, 0, 1, 6
"d:\IDEWORK\lvmen\src\licensedcode\data\rules\lgpl-3.0_url_badge.yml", "YAML", 0, 0, 0, 5, 0, 0, 1, 6
"d:\IDEWORK\lvmen\src\licensedcode\data\rules\lgpl-3.0_url_glc_125.yml", "YAML", 0, 0, 0, 5, 0, 0, 1, 6
"d:\IDEWORK\lvmen\src\licensedcode\data\rules\lgpl-3.0_url_glc_180.yml", "YAML", 0, 0, 0, 5, 0, 0, 1, 6
"d:\IDEWORK\lvmen\src\licensedcode\data\rules\lgpl-3.0_url_glc_181.yml", "YAML", 0, 0, 0, 5, 0, 0, 1, 6
"d:\IDEWORK\lvmen\src\licensedcode\data\rules\lgpl-3.0_with_linking-exception-lgpl-3.0_1.yml", "YAML", 0, 0, 0, 3, 0, 0, 1, 4
"d:\IDEWORK\lvmen\src\licensedcode\data\rules\lgpl-3.0_with_linking-exception-lgpl-3.0_2.yml", "YAML", 0, 0, 0, 3, 0, 0, 1, 4
"d:\IDEWORK\lvmen\src\licensedcode\data\rules\lgpl-3.0_with_linking_exception_1.yml", "YAML", 0, 0, 0, 5, 0, 0, 1, 6
"d:\IDEWORK\lvmen\src\licensedcode\data\rules\lgpl-3.0_with_linking_exception_2.yml", "YAML", 0, 0, 0, 5, 0, 0, 1, 6
"d:\IDEWORK\lvmen\src\licensedcode\data\rules\lgpl-3.0_with_linking_exception_3.yml", "YAML", 0, 0, 0, 5, 0, 0, 1, 6
"d:\IDEWORK\lvmen\src\licensedcode\data\rules\lgpl-3.0_with_linking_exception_and_other.yml", "YAML", 0, 0, 0, 4, 0, 0, 1, 5
"d:\IDEWORK\lvmen\src\licensedcode\data\rules\lgpl-3.0_with_linking_exception_and_other2.yml", "YAML", 0, 0, 0, 4, 0, 0, 1, 5
"d:\IDEWORK\lvmen\src\licensedcode\data\rules\lgpl-doctrine.yml", "YAML", 0, 0, 0, 5, 0, 0, 1, 6
"d:\IDEWORK\lvmen\src\licensedcode\data\rules\lgpl.yml", "YAML", 0, 0, 0, 3, 0, 0, 1, 4
"d:\IDEWORK\lvmen\src\licensedcode\data\rules\lgpl_1.yml", "YAML", 0, 0, 0, 2, 0, 0, 1, 3
"d:\IDEWORK\lvmen\src\licensedcode\data\rules\lgpl_10.yml", "YAML", 0, 0, 0, 4, 0, 0, 1, 5
"d:\IDEWORK\lvmen\src\licensedcode\data\rules\lgpl_11.yml", "YAML", 0, 0, 0, 5, 0, 0, 1, 6
"d:\IDEWORK\lvmen\src\licensedcode\data\rules\lgpl_12.yml", "YAML", 0, 0, 0, 3, 0, 0, 1, 4
"d:\IDEWORK\lvmen\src\licensedcode\data\rules\lgpl_13.yml", "YAML", 0, 0, 0, 3, 0, 0, 1, 4
"d:\IDEWORK\lvmen\src\licensedcode\data\rules\lgpl_14.yml", "YAML", 0, 0, 0, 3, 0, 0, 1, 4
"d:\IDEWORK\lvmen\src\licensedcode\data\rules\lgpl_15.yml", "YAML", 0, 0, 0, 4, 0, 0, 1, 5
"d:\IDEWORK\lvmen\src\licensedcode\data\rules\lgpl_16.yml", "YAML", 0, 0, 0, 3, 0, 0, 1, 4
"d:\IDEWORK\lvmen\src\licensedcode\data\rules\lgpl_17.yml", "YAML", 0, 0, 0, 4, 0, 0, 1, 5
"d:\IDEWORK\lvmen\src\licensedcode\data\rules\lgpl_18.yml", "YAML", 0, 0, 0, 3, 0, 0, 1, 4
"d:\IDEWORK\lvmen\src\licensedcode\data\rules\lgpl_19.yml", "YAML", 0, 0, 0, 3, 0, 0, 1, 4
"d:\IDEWORK\lvmen\src\licensedcode\data\rules\lgpl_2.yml", "YAML", 0, 0, 0, 3, 0, 0, 1, 4
"d:\IDEWORK\lvmen\src\licensedcode\data\rules\lgpl_20.yml", "YAML", 0, 0, 0, 3, 0, 0, 1, 4
"d:\IDEWORK\lvmen\src\licensedcode\data\rules\lgpl_20_tag.yml", "YAML", 0, 0, 0, 4, 0, 0, 2, 6
"d:\IDEWORK\lvmen\src\licensedcode\data\rules\lgpl_21.yml", "YAML", 0, 0, 0, 3, 0, 0, 1, 4
"d:\IDEWORK\lvmen\src\licensedcode\data\rules\lgpl_22.yml", "YAML", 0, 0, 0, 3, 0, 0, 1, 4
"d:\IDEWORK\lvmen\src\licensedcode\data\rules\lgpl_223.yml", "YAML", 0, 0, 0, 3, 0, 0, 1, 4
"d:\IDEWORK\lvmen\src\licensedcode\data\rules\lgpl_23.yml", "YAML", 0, 0, 0, 5, 0, 0, 1, 6
"d:\IDEWORK\lvmen\src\licensedcode\data\rules\lgpl_24.yml", "YAML", 0, 0, 0, 4, 0, 0, 1, 5
"d:\IDEWORK\lvmen\src\licensedcode\data\rules\lgpl_25.yml", "YAML", 0, 0, 0, 5, 0, 0, 1, 6
"d:\IDEWORK\lvmen\src\licensedcode\data\rules\lgpl_26.yml", "YAML", 0, 0, 0, 6, 0, 0, 1, 7
"d:\IDEWORK\lvmen\src\licensedcode\data\rules\lgpl_27.yml", "YAML", 0, 0, 0, 6, 0, 0, 1, 7
"d:\IDEWORK\lvmen\src\licensedcode\data\rules\lgpl_28.yml", "YAML", 0, 0, 0, 4, 0, 0, 1, 5
"d:\IDEWORK\lvmen\src\licensedcode\data\rules\lgpl_29.yml", "YAML", 0, 0, 0, 4, 0, 0, 1, 5
"d:\IDEWORK\lvmen\src\licensedcode\data\rules\lgpl_3.yml", "YAML", 0, 0, 0, 5, 0, 0, 1, 6
"d:\IDEWORK\lvmen\src\licensedcode\data\rules\lgpl_30.yml", "YAML", 0, 0, 0, 5, 0, 0, 1, 6
"d:\IDEWORK\lvmen\src\licensedcode\data\rules\lgpl_31.yml", "YAML", 0, 0, 0, 6, 0, 0, 1, 7
"d:\IDEWORK\lvmen\src\licensedcode\data\rules\lgpl_32.yml", "YAML", 0, 0, 0, 3, 0, 0, 1, 4
"d:\IDEWORK\lvmen\src\licensedcode\data\rules\lgpl_33.yml", "YAML", 0, 0, 0, 3, 0, 0, 1, 4
"d:\IDEWORK\lvmen\src\licensedcode\data\rules\lgpl_34.yml", "YAML", 0, 0, 0, 4, 0, 0, 1, 5
"d:\IDEWORK\lvmen\src\licensedcode\data\rules\lgpl_35.yml", "YAML", 0, 0, 0, 4, 0, 0, 1, 5
"d:\IDEWORK\lvmen\src\licensedcode\data\rules\lgpl_36.yml", "YAML", 0, 0, 0, 4, 0, 0, 1, 5
"d:\IDEWORK\lvmen\src\licensedcode\data\rules\lgpl_37.yml", "YAML", 0, 0, 0, 4, 0, 0, 1, 5
"d:\IDEWORK\lvmen\src\licensedcode\data\rules\lgpl_38.yml", "YAML", 0, 0, 0, 3, 0, 0, 1, 4
"d:\IDEWORK\lvmen\src\licensedcode\data\rules\lgpl_39.yml", "YAML", 0, 0, 0, 3, 0, 0, 1, 4
"d:\IDEWORK\lvmen\src\licensedcode\data\rules\lgpl_4.yml", "YAML", 0, 0, 0, 4, 0, 0, 1, 5
"d:\IDEWORK\lvmen\src\licensedcode\data\rules\lgpl_40.yml", "YAML", 0, 0, 0, 4, 0, 0, 1, 5
"d:\IDEWORK\lvmen\src\licensedcode\data\rules\lgpl_41.yml", "YAML", 0, 0, 0, 5, 0, 0, 1, 6
"d:\IDEWORK\lvmen\src\licensedcode\data\rules\lgpl_42.yml", "YAML", 0, 0, 0, 5, 0, 0, 1, 6
"d:\IDEWORK\lvmen\src\licensedcode\data\rules\lgpl_43.yml", "YAML", 0, 0, 0, 3, 0, 0, 1, 4
"d:\IDEWORK\lvmen\src\licensedcode\data\rules\lgpl_44.yml", "YAML", 0, 0, 0, 3, 0, 0, 1, 4
"d:\IDEWORK\lvmen\src\licensedcode\data\rules\lgpl_45.yml", "YAML", 0, 0, 0, 3, 0, 0, 1, 4
"d:\IDEWORK\lvmen\src\licensedcode\data\rules\lgpl_46.yml", "YAML", 0, 0, 0, 3, 0, 0, 1, 4
"d:\IDEWORK\lvmen\src\licensedcode\data\rules\lgpl_47.yml", "YAML", 0, 0, 0, 3, 0, 0, 1, 4
"d:\IDEWORK\lvmen\src\licensedcode\data\rules\lgpl_48.yml", "YAML", 0, 0, 0, 3, 0, 0, 1, 4
"d:\IDEWORK\lvmen\src\licensedcode\data\rules\lgpl_49.yml", "YAML", 0, 0, 0, 4, 0, 0, 1, 5
"d:\IDEWORK\lvmen\src\licensedcode\data\rules\lgpl_5.yml", "YAML", 0, 0, 0, 5, 0, 0, 1, 6
"d:\IDEWORK\lvmen\src\licensedcode\data\rules\lgpl_50.yml", "YAML", 0, 0, 0, 5, 0, 0, 1, 6
"d:\IDEWORK\lvmen\src\licensedcode\data\rules\lgpl_51.yml", "YAML", 0, 0, 0, 3, 0, 0, 1, 4
"d:\IDEWORK\lvmen\src\licensedcode\data\rules\lgpl_6.yml", "YAML", 0, 0, 0, 4, 0, 0, 1, 5
"d:\IDEWORK\lvmen\src\licensedcode\data\rules\lgpl_7.yml", "YAML", 0, 0, 0, 7, 0, 0, 1, 8
"d:\IDEWORK\lvmen\src\licensedcode\data\rules\lgpl_8.yml", "YAML", 0, 0, 0, 4, 0, 0, 1, 5
"d:\IDEWORK\lvmen\src\licensedcode\data\rules\lgpl_9.yml", "YAML", 0, 0, 0, 7, 0, 0, 1, 8
"d:\IDEWORK\lvmen\src\licensedcode\data\rules\lgpl_and_gpl.yml", "YAML", 0, 0, 0, 4, 0, 0, 1, 5
"d:\IDEWORK\lvmen\src\licensedcode\data\rules\lgpl_and_sun-bcl.yml", "YAML", 0, 0, 0, 3, 0, 0, 1, 4
"d:\IDEWORK\lvmen\src\licensedcode\data\rules\lgpl_bare_single_word.yml", "YAML", 0, 0, 0, 3, 0, 0, 1, 4
"d:\IDEWORK\lvmen\src\licensedcode\data\rules\lgpl_copying_lgpl.yml", "YAML", 0, 0, 0, 3, 0, 0, 1, 4
"d:\IDEWORK\lvmen\src\licensedcode\data\rules\lgpl_lesser_33.yml", "YAML", 0, 0, 0, 2, 0, 0, 1, 3
"d:\IDEWORK\lvmen\src\licensedcode\data\rules\lgpl_lesser_34.yml", "YAML", 0, 0, 0, 2, 0, 0, 1, 3
"d:\IDEWORK\lvmen\src\licensedcode\data\rules\lgpl_or_gpl-2.0-plus.yml", "YAML", 0, 0, 0, 3, 0, 0, 1, 4
"d:\IDEWORK\lvmen\src\licensedcode\data\rules\lgpl_or_mpl-1.1_or_bsd-new.yml", "YAML", 0, 0, 0, 4, 0, 0, 1, 5
"d:\IDEWORK\lvmen\src\licensedcode\data\rules\lgpl_or_mpl-1.1_or_bsd-new_1.yml", "YAML", 0, 0, 0, 6, 0, 0, 1, 7
"d:\IDEWORK\lvmen\src\licensedcode\data\rules\lgpl_or_mpl-1.1_or_bsd-new_2.yml", "YAML", 0, 0, 0, 7, 0, 0, 1, 8
"d:\IDEWORK\lvmen\src\licensedcode\data\rules\lgpl_with_wxwindows.yml", "YAML", 0, 0, 0, 2, 0, 0, 1, 3
"d:\IDEWORK\lvmen\src\licensedcode\data\rules\lgpllr_url_1.yml", "YAML", 0, 0, 0, 5, 0, 0, 1, 6
"d:\IDEWORK\lvmen\src\licensedcode\data\rules\lgpllr_url_2.yml", "YAML", 0, 0, 0, 5, 0, 0, 1, 6
"d:\IDEWORK\lvmen\src\licensedcode\data\rules\liberation-font-exception_1.yml", "YAML", 0, 0, 0, 6, 0, 0, 1, 7
"d:\IDEWORK\lvmen\src\licensedcode\data\rules\liberation-font-exception_2.yml", "YAML", 0, 0, 0, 7, 0, 0, 1, 8
"d:\IDEWORK\lvmen\src\licensedcode\data\rules\libpbm_1.yml", "YAML", 0, 0, 0, 5, 0, 0, 1, 6
"d:\IDEWORK\lvmen\src\licensedcode\data\rules\libpbm_2.yml", "YAML", 0, 0, 0, 3, 0, 0, 1, 4
"d:\IDEWORK\lvmen\src\licensedcode\data\rules\libpbm_3.yml", "YAML", 0, 0, 0, 3, 0, 0, 1, 4
"d:\IDEWORK\lvmen\src\licensedcode\data\rules\libpng-v2_url_1.yml", "YAML", 0, 0, 0, 5, 0, 0, 1, 6
"d:\IDEWORK\lvmen\src\licensedcode\data\rules\libpng-v2_url_2.yml", "YAML", 0, 0, 0, 5, 0, 0, 1, 6
"d:\IDEWORK\lvmen\src\licensedcode\data\rules\libpng.SPDX.yml", "YAML", 0, 0, 0, 14, 0, 0, 1, 15
"d:\IDEWORK\lvmen\src\licensedcode\data\rules\libpng_1.yml", "YAML", 0, 0, 0, 3, 0, 0, 1, 4
"d:\IDEWORK\lvmen\src\licensedcode\data\rules\libpng_10.yml", "YAML", 0, 0, 0, 6, 0, 0, 1, 7
"d:\IDEWORK\lvmen\src\licensedcode\data\rules\libpng_11.yml", "YAML", 0, 0, 0, 2, 0, 0, 1, 3
"d:\IDEWORK\lvmen\src\licensedcode\data\rules\libpng_12.yml", "YAML", 0, 0, 0, 6, 0, 0, 1, 7
"d:\IDEWORK\lvmen\src\licensedcode\data\rules\libpng_13.yml", "YAML", 0, 0, 0, 3, 0, 0, 1, 4
"d:\IDEWORK\lvmen\src\licensedcode\data\rules\libpng_14.yml", "YAML", 0, 0, 0, 5, 0, 0, 1, 6
"d:\IDEWORK\lvmen\src\licensedcode\data\rules\libpng_15.yml", "YAML", 0, 0, 0, 4, 0, 0, 1, 5
"d:\IDEWORK\lvmen\src\licensedcode\data\rules\libpng_16.yml", "YAML", 0, 0, 0, 3, 0, 0, 1, 4
"d:\IDEWORK\lvmen\src\licensedcode\data\rules\libpng_17.yml", "YAML", 0, 0, 0, 3, 0, 0, 1, 4
"d:\IDEWORK\lvmen\src\licensedcode\data\rules\libpng_18.yml", "YAML", 0, 0, 0, 5, 0, 0, 1, 6
"d:\IDEWORK\lvmen\src\licensedcode\data\rules\libpng_19.yml", "YAML", 0, 0, 0, 5, 0, 0, 1, 6
"d:\IDEWORK\lvmen\src\licensedcode\data\rules\libpng_2.yml", "YAML", 0, 0, 0, 5, 0, 0, 1, 6
"d:\IDEWORK\lvmen\src\licensedcode\data\rules\libpng_20.yml", "YAML", 0, 0, 0, 3, 0, 0, 1, 4
"d:\IDEWORK\lvmen\src\licensedcode\data\rules\libpng_21.yml", "YAML", 0, 0, 0, 3, 0, 0, 1, 4
"d:\IDEWORK\lvmen\src\licensedcode\data\rules\libpng_22.yml", "YAML", 0, 0, 0, 3, 0, 0, 1, 4
"d:\IDEWORK\lvmen\src\licensedcode\data\rules\libpng_23.yml", "YAML", 0, 0, 0, 3, 0, 0, 1, 4
"d:\IDEWORK\lvmen\src\licensedcode\data\rules\libpng_24.yml", "YAML", 0, 0, 0, 4, 0, 0, 1, 5
"d:\IDEWORK\lvmen\src\licensedcode\data\rules\libpng_25.yml", "YAML", 0, 0, 0, 3, 0, 0, 1, 4
"d:\IDEWORK\lvmen\src\licensedcode\data\rules\libpng_26.yml", "YAML", 0, 0, 0, 3, 0, 0, 1, 4
"d:\IDEWORK\lvmen\src\licensedcode\data\rules\libpng_27.yml", "YAML", 0, 0, 0, 3, 0, 0, 1, 4
"d:\IDEWORK\lvmen\src\licensedcode\data\rules\libpng_28.yml", "YAML", 0, 0, 0, 5, 0, 0, 1, 6
"d:\IDEWORK\lvmen\src\licensedcode\data\rules\libpng_29.yml", "YAML", 0, 0, 0, 5, 0, 0, 1, 6
"d:\IDEWORK\lvmen\src\licensedcode\data\rules\libpng_3.yml", "YAML", 0, 0, 0, 5, 0, 0, 1, 6
"d:\IDEWORK\lvmen\src\licensedcode\data\rules\libpng_30.yml", "YAML", 0, 0, 0, 3, 0, 0, 1, 4
"d:\IDEWORK\lvmen\src\licensedcode\data\rules\libpng_31.yml", "YAML", 0, 0, 0, 12, 0, 0, 1, 13
"d:\IDEWORK\lvmen\src\licensedcode\data\rules\libpng_4.yml", "YAML", 0, 0, 0, 12, 0, 0, 1, 13
"d:\IDEWORK\lvmen\src\licensedcode\data\rules\libpng_5.yml", "YAML", 0, 0, 0, 2, 0, 0, 1, 3
"d:\IDEWORK\lvmen\src\licensedcode\data\rules\libpng_6.yml", "YAML", 0, 0, 0, 2, 0, 0, 1, 3
"d:\IDEWORK\lvmen\src\licensedcode\data\rules\libpng_7.yml", "YAML", 0, 0, 0, 2, 0, 0, 1, 3
"d:\IDEWORK\lvmen\src\licensedcode\data\rules\libpng_8.yml", "YAML", 0, 0, 0, 3, 0, 0, 1, 4
"d:\IDEWORK\lvmen\src\licensedcode\data\rules\libpng_9.yml", "YAML", 0, 0, 0, 3, 0, 0, 1, 4
"d:\IDEWORK\lvmen\src\licensedcode\data\rules\libpng_and_apache-2.0_and_bsd-new_1.yml", "YAML", 0, 0, 0, 12, 0, 0, 1, 13
"d:\IDEWORK\lvmen\src\licensedcode\data\rules\libpng_and_apache-2.0_and_bsd-new_2.yml", "YAML", 0, 0, 0, 12, 0, 0, 1, 13
"d:\IDEWORK\lvmen\src\licensedcode\data\rules\libpng_and_cc0-1.0_1.yml", "YAML", 0, 0, 0, 5, 0, 0, 1, 6
"d:\IDEWORK\lvmen\src\licensedcode\data\rules\libpng_url_1.yml", "YAML", 0, 0, 0, 5, 0, 0, 1, 6
"d:\IDEWORK\lvmen\src\licensedcode\data\rules\libpng_url_2.yml", "YAML", 0, 0, 0, 5, 0, 0, 1, 6
"d:\IDEWORK\lvmen\src\licensedcode\data\rules\librejs_apache-2.0_1.yml", "YAML", 0, 0, 0, 4, 0, 0, 1, 5
"d:\IDEWORK\lvmen\src\licensedcode\data\rules\librejs_apache-2.0_2.yml", "YAML", 0, 0, 0, 4, 0, 0, 1, 5
"d:\IDEWORK\lvmen\src\licensedcode\data\rules\librejs_gpl-2.0-plus_1.yml", "YAML", 0, 0, 0, 4, 0, 0, 1, 5
"d:\IDEWORK\lvmen\src\licensedcode\data\rules\librejs_gpl-2.0-plus_3.yml", "YAML", 0, 0, 0, 4, 0, 0, 1, 5
"d:\IDEWORK\lvmen\src\licensedcode\data\rules\librejs_gpl-3.0-plus_1.yml", "YAML", 0, 0, 0, 4, 0, 0, 1, 5
"d:\IDEWORK\lvmen\src\licensedcode\data\rules\librejs_gpl-3.0-plus_3.yml", "YAML", 0, 0, 0, 4, 0, 0, 1, 5
"d:\IDEWORK\lvmen\src\licensedcode\data\rules\libselinux-pd_1.yml", "YAML", 0, 0, 0, 2, 0, 0, 1, 3
"d:\IDEWORK\lvmen\src\licensedcode\data\rules\libtool-exception-2.0_1.yml", "YAML", 0, 0, 0, 4, 0, 0, 1, 5
"d:\IDEWORK\lvmen\src\licensedcode\data\rules\libtool-exception-2.0_url_1.yml", "YAML", 0, 0, 0, 5, 0, 0, 1, 6
"d:\IDEWORK\lvmen\src\licensedcode\data\rules\libtool-exception-2.0_url_2.yml", "YAML", 0, 0, 0, 5, 0, 0, 1, 6
"d:\IDEWORK\lvmen\src\licensedcode\data\rules\license-intro_1.yml", "YAML", 0, 0, 0, 2, 0, 0, 1, 3
"d:\IDEWORK\lvmen\src\licensedcode\data\rules\license-intro_10.yml", "YAML", 0, 0, 0, 3, 0, 0, 1, 4
"d:\IDEWORK\lvmen\src\licensedcode\data\rules\license-intro_11.yml", "YAML", 0, 0, 0, 3, 0, 0, 2, 5
"d:\IDEWORK\lvmen\src\licensedcode\data\rules\license-intro_12.yml", "YAML", 0, 0, 0, 3, 0, 0, 1, 4
"d:\IDEWORK\lvmen\src\licensedcode\data\rules\license-intro_13.yml", "YAML", 0, 0, 0, 3, 0, 0, 1, 4
"d:\IDEWORK\lvmen\src\licensedcode\data\rules\license-intro_14.yml", "YAML", 0, 0, 0, 3, 0, 0, 1, 4
"d:\IDEWORK\lvmen\src\licensedcode\data\rules\license-intro_15.yml", "YAML", 0, 0, 0, 3, 0, 0, 1, 4
"d:\IDEWORK\lvmen\src\licensedcode\data\rules\license-intro_16.yml", "YAML", 0, 0, 0, 3, 0, 0, 1, 4
"d:\IDEWORK\lvmen\src\licensedcode\data\rules\license-intro_17.yml", "YAML", 0, 0, 0, 3, 0, 0, 1, 4
"d:\IDEWORK\lvmen\src\licensedcode\data\rules\license-intro_18.yml", "YAML", 0, 0, 0, 3, 0, 0, 1, 4
"d:\IDEWORK\lvmen\src\licensedcode\data\rules\license-intro_19.yml", "YAML", 0, 0, 0, 3, 0, 0, 1, 4
"d:\IDEWORK\lvmen\src\licensedcode\data\rules\license-intro_2.yml", "YAML", 0, 0, 0, 3, 0, 0, 1, 4
"d:\IDEWORK\lvmen\src\licensedcode\data\rules\license-intro_20.yml", "YAML", 0, 0, 0, 3, 0, 0, 1, 4
"d:\IDEWORK\lvmen\src\licensedcode\data\rules\license-intro_21.yml", "YAML", 0, 0, 0, 3, 0, 0, 1, 4
"d:\IDEWORK\lvmen\src\licensedcode\data\rules\license-intro_22.yml", "YAML", 0, 0, 0, 3, 0, 0, 1, 4
"d:\IDEWORK\lvmen\src\licensedcode\data\rules\license-intro_23.yml", "YAML", 0, 0, 0, 3, 0, 0, 1, 4
"d:\IDEWORK\lvmen\src\licensedcode\data\rules\license-intro_24.yml", "YAML", 0, 0, 0, 3, 0, 0, 1, 4
"d:\IDEWORK\lvmen\src\licensedcode\data\rules\license-intro_25.yml", "YAML", 0, 0, 0, 3, 0, 0, 1, 4
"d:\IDEWORK\lvmen\src\licensedcode\data\rules\license-intro_26.yml", "YAML", 0, 0, 0, 3, 0, 0, 1, 4
"d:\IDEWORK\lvmen\src\licensedcode\data\rules\license-intro_27.yml", "YAML", 0, 0, 0, 3, 0, 0, 1, 4
"d:\IDEWORK\lvmen\src\licensedcode\data\rules\license-intro_28.yml", "YAML", 0, 0, 0, 3, 0, 0, 1, 4
"d:\IDEWORK\lvmen\src\licensedcode\data\rules\license-intro_29.yml", "YAML", 0, 0, 0, 3, 0, 0, 1, 4
"d:\IDEWORK\lvmen\src\licensedcode\data\rules\license-intro_3.yml", "YAML", 0, 0, 0, 3, 0, 0, 1, 4
"d:\IDEWORK\lvmen\src\licensedcode\data\rules\license-intro_30.yml", "YAML", 0, 0, 0, 3, 0, 0, 1, 4
"d:\IDEWORK\lvmen\src\licensedcode\data\rules\license-intro_31.yml", "YAML", 0, 0, 0, 3, 0, 0, 1, 4
"d:\IDEWORK\lvmen\src\licensedcode\data\rules\license-intro_32.yml", "YAML", 0, 0, 0, 3, 0, 0, 1, 4
"d:\IDEWORK\lvmen\src\licensedcode\data\rules\license-intro_33.yml", "YAML", 0, 0, 0, 3, 0, 0, 1, 4
"d:\IDEWORK\lvmen\src\licensedcode\data\rules\license-intro_34.yml", "YAML", 0, 0, 0, 3, 0, 0, 1, 4
"d:\IDEWORK\lvmen\src\licensedcode\data\rules\license-intro_35.yml", "YAML", 0, 0, 0, 3, 0, 0, 1, 4
"d:\IDEWORK\lvmen\src\licensedcode\data\rules\license-intro_36.yml", "YAML", 0, 0, 0, 4, 0, 0, 1, 5
"d:\IDEWORK\lvmen\src\licensedcode\data\rules\license-intro_37.yml", "YAML", 0, 0, 0, 3, 0, 0, 1, 4
"d:\IDEWORK\lvmen\src\licensedcode\data\rules\license-intro_38.yml", "YAML", 0, 0, 0, 3, 0, 0, 1, 4
"d:\IDEWORK\lvmen\src\licensedcode\data\rules\license-intro_39.yml", "YAML", 0, 0, 0, 3, 0, 0, 1, 4
"d:\IDEWORK\lvmen\src\licensedcode\data\rules\license-intro_4.yml", "YAML", 0, 0, 0, 4, 0, 0, 1, 5
"d:\IDEWORK\lvmen\src\licensedcode\data\rules\license-intro_40.yml", "YAML", 0, 0, 0, 3, 0, 0, 1, 4
"d:\IDEWORK\lvmen\src\licensedcode\data\rules\license-intro_41.yml", "YAML", 0, 0, 0, 3, 0, 0, 1, 4
"d:\IDEWORK\lvmen\src\licensedcode\data\rules\license-intro_42.yml", "YAML", 0, 0, 0, 3, 0, 0, 1, 4
"d:\IDEWORK\lvmen\src\licensedcode\data\rules\license-intro_43.yml", "YAML", 0, 0, 0, 3, 0, 0, 1, 4
"d:\IDEWORK\lvmen\src\licensedcode\data\rules\license-intro_44.yml", "YAML", 0, 0, 0, 3, 0, 0, 1, 4
"d:\IDEWORK\lvmen\src\licensedcode\data\rules\license-intro_45.yml", "YAML", 0, 0, 0, 2, 0, 0, 1, 3
"d:\IDEWORK\lvmen\src\licensedcode\data\rules\license-intro_46.yml", "YAML", 0, 0, 0, 3, 0, 0, 1, 4
"d:\IDEWORK\lvmen\src\licensedcode\data\rules\license-intro_47.yml", "YAML", 0, 0, 0, 3, 0, 0, 1, 4
"d:\IDEWORK\lvmen\src\licensedcode\data\rules\license-intro_48.yml", "YAML", 0, 0, 0, 3, 0, 0, 1, 4
"d:\IDEWORK\lvmen\src\licensedcode\data\rules\license-intro_49.yml", "YAML", 0, 0, 0, 3, 0, 0, 1, 4
"d:\IDEWORK\lvmen\src\licensedcode\data\rules\license-intro_5.yml", "YAML", 0, 0, 0, 3, 0, 0, 1, 4
"d:\IDEWORK\lvmen\src\licensedcode\data\rules\license-intro_50.yml", "YAML", 0, 0, 0, 3, 0, 0, 1, 4
"d:\IDEWORK\lvmen\src\licensedcode\data\rules\license-intro_51.yml", "YAML", 0, 0, 0, 3, 0, 0, 1, 4
"d:\IDEWORK\lvmen\src\licensedcode\data\rules\license-intro_52.yml", "YAML", 0, 0, 0, 2, 0, 0, 1, 3
"d:\IDEWORK\lvmen\src\licensedcode\data\rules\license-intro_6.yml", "YAML", 0, 0, 0, 3, 0, 0, 1, 4
"d:\IDEWORK\lvmen\src\licensedcode\data\rules\license-intro_7.yml", "YAML", 0, 0, 0, 3, 0, 0, 1, 4
"d:\IDEWORK\lvmen\src\licensedcode\data\rules\license-intro_8.yml", "YAML", 0, 0, 0, 3, 0, 0, 1, 4
"d:\IDEWORK\lvmen\src\licensedcode\data\rules\license-intro_9.yml", "YAML", 0, 0, 0, 3, 0, 0, 1, 4
"d:\IDEWORK\lvmen\src\licensedcode\data\rules\lil-1_1.yml", "YAML", 0, 0, 0, 2, 0, 0, 1, 3
"d:\IDEWORK\lvmen\src\licensedcode\data\rules\lil-1_2.yml", "YAML", 0, 0, 0, 3, 0, 0, 1, 4
"d:\IDEWORK\lvmen\src\licensedcode\data\rules\lil-1_3.yml", "YAML", 0, 0, 0, 3, 0, 0, 1, 4
"d:\IDEWORK\lvmen\src\licensedcode\data\rules\lilo_2.yml", "YAML", 0, 0, 0, 6, 0, 0, 1, 7
"d:\IDEWORK\lvmen\src\licensedcode\data\rules\lilo_4.yml", "YAML", 0, 0, 0, 4, 0, 0, 1, 5
"d:\IDEWORK\lvmen\src\licensedcode\data\rules\linking-exception-2.0-plus_1.yml", "YAML", 0, 0, 0, 2, 0, 0, 1, 3
"d:\IDEWORK\lvmen\src\licensedcode\data\rules\linking-exception-lgpl-3.0-plus_1.yml", "YAML", 0, 0, 0, 2, 0, 0, 1, 3
"d:\IDEWORK\lvmen\src\licensedcode\data\rules\linotype-eula.yml", "YAML", 0, 0, 0, 5, 0, 0, 1, 6
"d:\IDEWORK\lvmen\src\licensedcode\data\rules\linux-openib_1.yml", "YAML", 0, 0, 0, 3, 0, 0, 1, 4
"d:\IDEWORK\lvmen\src\licensedcode\data\rules\linux-openib_2.yml", "YAML", 0, 0, 0, 3, 0, 0, 1, 4
"d:\IDEWORK\lvmen\src\licensedcode\data\rules\linux-openib_3.yml", "YAML", 0, 0, 0, 3, 0, 0, 1, 4
"d:\IDEWORK\lvmen\src\licensedcode\data\rules\linux-openib_4.yml", "YAML", 0, 0, 0, 2, 0, 0, 1, 3
"d:\IDEWORK\lvmen\src\licensedcode\data\rules\linux-openib_5.yml", "YAML", 0, 0, 0, 4, 0, 0, 2, 6
"d:\IDEWORK\lvmen\src\licensedcode\data\rules\linux-openib_6.yml", "YAML", 0, 0, 0, 3, 0, 0, 1, 4
"d:\IDEWORK\lvmen\src\licensedcode\data\rules\linux-openib_7.yml", "YAML", 0, 0, 0, 2, 0, 0, 1, 3
"d:\IDEWORK\lvmen\src\licensedcode\data\rules\linux-openib_8.yml", "YAML", 0, 0, 0, 3, 0, 0, 1, 4
"d:\IDEWORK\lvmen\src\licensedcode\data\rules\linux-openib_or_gpl-2.0_11.yml", "YAML", 0, 0, 0, 6, 0, 0, 1, 7
"d:\IDEWORK\lvmen\src\licensedcode\data\rules\linux-openib_url_1.yml", "YAML", 0, 0, 0, 5, 0, 0, 1, 6
"d:\IDEWORK\lvmen\src\licensedcode\data\rules\linux-openib_url_2.yml", "YAML", 0, 0, 0, 5, 0, 0, 1, 6
"d:\IDEWORK\lvmen\src\licensedcode\data\rules\linux-syscall-exception-gpl_1.yml", "YAML", 0, 0, 0, 10, 0, 0, 1, 11
"d:\IDEWORK\lvmen\src\licensedcode\data\rules\linux-syscall-exception-gpl_2.yml", "YAML", 0, 0, 0, 10, 0, 0, 1, 11
"d:\IDEWORK\lvmen\src\licensedcode\data\rules\linux-syscall-exception-gpl_url_1.yml", "YAML", 0, 0, 0, 5, 0, 0, 1, 6
"d:\IDEWORK\lvmen\src\licensedcode\data\rules\linux-syscall-exception-gpl_url_2.yml", "YAML", 0, 0, 0, 5, 0, 0, 1, 6
"d:\IDEWORK\lvmen\src\licensedcode\data\rules\llgpl_1.yml", "YAML", 0, 0, 0, 3, 0, 0, 1, 4
"d:\IDEWORK\lvmen\src\licensedcode\data\rules\llgpl_2.yml", "YAML", 0, 0, 0, 3, 0, 0, 1, 4
"d:\IDEWORK\lvmen\src\licensedcode\data\rules\llgpl_3.yml", "YAML", 0, 0, 0, 3, 0, 0, 1, 4
"d:\IDEWORK\lvmen\src\licensedcode\data\rules\llgpl_4.yml", "YAML", 0, 0, 0, 2, 0, 0, 1, 3
"d:\IDEWORK\lvmen\src\licensedcode\data\rules\llgpl_5.yml", "YAML", 0, 0, 0, 2, 0, 0, 1, 3
"d:\IDEWORK\lvmen\src\licensedcode\data\rules\llgpl_6.yml", "YAML", 0, 0, 0, 5, 0, 0, 1, 6
"d:\IDEWORK\lvmen\src\licensedcode\data\rules\llnl_1.yml", "YAML", 0, 0, 0, 3, 0, 0, 1, 4
"d:\IDEWORK\lvmen\src\licensedcode\data\rules\llvm-exception_url_1.yml", "YAML", 0, 0, 0, 5, 0, 0, 1, 6
"d:\IDEWORK\lvmen\src\licensedcode\data\rules\llvm-exception_url_2.yml", "YAML", 0, 0, 0, 5, 0, 0, 1, 6
"d:\IDEWORK\lvmen\src\licensedcode\data\rules\logica-1.0.yml", "YAML", 0, 0, 0, 5, 0, 0, 1, 6
"d:\IDEWORK\lvmen\src\licensedcode\data\rules\lppl-1.0.yml", "YAML", 0, 0, 0, 5, 0, 0, 1, 6
"d:\IDEWORK\lvmen\src\licensedcode\data\rules\lppl-1.0_1.yml", "YAML", 0, 0, 0, 2, 0, 0, 1, 3
"d:\IDEWORK\lvmen\src\licensedcode\data\rules\lppl-1.0_2.yml", "YAML", 0, 0, 0, 3, 0, 0, 1, 4
"d:\IDEWORK\lvmen\src\licensedcode\data\rules\lppl-1.0_url_1.yml", "YAML", 0, 0, 0, 5, 0, 0, 1, 6
"d:\IDEWORK\lvmen\src\licensedcode\data\rules\lppl-1.0_url_2.yml", "YAML", 0, 0, 0, 5, 0, 0, 1, 6
"d:\IDEWORK\lvmen\src\licensedcode\data\rules\lppl-1.1.yml", "YAML", 0, 0, 0, 4, 0, 0, 1, 5
"d:\IDEWORK\lvmen\src\licensedcode\data\rules\lppl-1.1_1.yml", "YAML", 0, 0, 0, 5, 0, 0, 1, 6
"d:\IDEWORK\lvmen\src\licensedcode\data\rules\lppl-1.1_url_1.yml", "YAML", 0, 0, 0, 5, 0, 0, 1, 6
"d:\IDEWORK\lvmen\src\licensedcode\data\rules\lppl-1.1_url_2.yml", "YAML", 0, 0, 0, 5, 0, 0, 1, 6
"d:\IDEWORK\lvmen\src\licensedcode\data\rules\lppl-1.2.yml", "YAML", 0, 0, 0, 5, 0, 0, 1, 6
"d:\IDEWORK\lvmen\src\licensedcode\data\rules\lppl-1.2_1.yml", "YAML", 0, 0, 0, 4, 0, 0, 1, 5
"d:\IDEWORK\lvmen\src\licensedcode\data\rules\lppl-1.2_2.yml", "YAML", 0, 0, 0, 4, 0, 0, 1, 5
"d:\IDEWORK\lvmen\src\licensedcode\data\rules\lppl-1.2_url_1.yml", "YAML", 0, 0, 0, 5, 0, 0, 1, 6
"d:\IDEWORK\lvmen\src\licensedcode\data\rules\lppl-1.2_url_2.yml", "YAML", 0, 0, 0, 5, 0, 0, 1, 6
"d:\IDEWORK\lvmen\src\licensedcode\data\rules\lppl-1.3a.yml", "YAML", 0, 0, 0, 5, 0, 0, 1, 6
"d:\IDEWORK\lvmen\src\licensedcode\data\rules\lppl-1.3a_1.yml", "YAML", 0, 0, 0, 4, 0, 0, 1, 5
"d:\IDEWORK\lvmen\src\licensedcode\data\rules\lppl-1.3a_2.yml", "YAML", 0, 0, 0, 10, 0, 0, 1, 11
"d:\IDEWORK\lvmen\src\licensedcode\data\rules\lppl-1.3a_url_1.yml", "YAML", 0, 0, 0, 5, 0, 0, 1, 6
"d:\IDEWORK\lvmen\src\licensedcode\data\rules\lppl-1.3a_url_2.yml", "YAML", 0, 0, 0, 5, 0, 0, 1, 6
"d:\IDEWORK\lvmen\src\licensedcode\data\rules\lppl-1.3c_1.yml", "YAML", 0, 0, 0, 4, 0, 0, 1, 5
"d:\IDEWORK\lvmen\src\licensedcode\data\rules\lppl-1.3c_10.yml", "YAML", 0, 0, 0, 5, 0, 0, 1, 6
"d:\IDEWORK\lvmen\src\licensedcode\data\rules\lppl-1.3c_11.yml", "YAML", 0, 0, 0, 5, 0, 0, 1, 6
"d:\IDEWORK\lvmen\src\licensedcode\data\rules\lppl-1.3c_12.yml", "YAML", 0, 0, 0, 5, 0, 0, 1, 6
"d:\IDEWORK\lvmen\src\licensedcode\data\rules\lppl-1.3c_13.yml", "YAML", 0, 0, 0, 5, 0, 0, 1, 6
"d:\IDEWORK\lvmen\src\licensedcode\data\rules\lppl-1.3c_14.yml", "YAML", 0, 0, 0, 5, 0, 0, 1, 6
"d:\IDEWORK\lvmen\src\licensedcode\data\rules\lppl-1.3c_15.yml", "YAML", 0, 0, 0, 5, 0, 0, 1, 6
"d:\IDEWORK\lvmen\src\licensedcode\data\rules\lppl-1.3c_16.yml", "YAML", 0, 0, 0, 5, 0, 0, 1, 6
"d:\IDEWORK\lvmen\src\licensedcode\data\rules\lppl-1.3c_17.yml", "YAML", 0, 0, 0, 3, 0, 0, 1, 4
"d:\IDEWORK\lvmen\src\licensedcode\data\rules\lppl-1.3c_18.yml", "YAML", 0, 0, 0, 6, 0, 0, 1, 7
"d:\IDEWORK\lvmen\src\licensedcode\data\rules\lppl-1.3c_19.yml", "YAML", 0, 0, 0, 4, 0, 0, 1, 5
"d:\IDEWORK\lvmen\src\licensedcode\data\rules\lppl-1.3c_2.yml", "YAML", 0, 0, 0, 5, 0, 0, 1, 6
"d:\IDEWORK\lvmen\src\licensedcode\data\rules\lppl-1.3c_3.yml", "YAML", 0, 0, 0, 5, 0, 0, 1, 6
"d:\IDEWORK\lvmen\src\licensedcode\data\rules\lppl-1.3c_4.yml", "YAML", 0, 0, 0, 3, 0, 0, 1, 4
"d:\IDEWORK\lvmen\src\licensedcode\data\rules\lppl-1.3c_5.yml", "YAML", 0, 0, 0, 8, 0, 0, 1, 9
"d:\IDEWORK\lvmen\src\licensedcode\data\rules\lppl-1.3c_6.yml", "YAML", 0, 0, 0, 3, 0, 0, 1, 4
"d:\IDEWORK\lvmen\src\licensedcode\data\rules\lppl-1.3c_7.yml", "YAML", 0, 0, 0, 3, 0, 0, 1, 4
"d:\IDEWORK\lvmen\src\licensedcode\data\rules\lppl-1.3c_8.yml", "YAML", 0, 0, 0, 10, 0, 0, 1, 11
"d:\IDEWORK\lvmen\src\licensedcode\data\rules\lppl-1.3c_9.yml", "YAML", 0, 0, 0, 6, 0, 0, 1, 7
"d:\IDEWORK\lvmen\src\licensedcode\data\rules\lppl-1.3c_url_1.yml", "YAML", 0, 0, 0, 5, 0, 0, 1, 6
"d:\IDEWORK\lvmen\src\licensedcode\data\rules\lppl-1.3c_url_2.yml", "YAML", 0, 0, 0, 5, 0, 0, 1, 6
"d:\IDEWORK\lvmen\src\licensedcode\data\rules\lppl-1.3c_url_glc_184.yml", "YAML", 0, 0, 0, 5, 0, 0, 1, 6
"d:\IDEWORK\lvmen\src\licensedcode\data\rules\lppl-1.3c_url_glc_185.yml", "YAML", 0, 0, 0, 5, 0, 0, 1, 6
"d:\IDEWORK\lvmen\src\licensedcode\data\rules\lucent-pl-1.0.yml", "YAML", 0, 0, 0, 5, 0, 0, 1, 6
"d:\IDEWORK\lvmen\src\licensedcode\data\rules\lucent-pl-1.02.SPDX.yml", "YAML", 0, 0, 0, 8, 0, 0, 1, 9
"d:\IDEWORK\lvmen\src\licensedcode\data\rules\lucent-pl-1.02.yml", "YAML", 0, 0, 0, 5, 0, 0, 1, 6
"d:\IDEWORK\lvmen\src\licensedcode\data\rules\lucent-pl-1.02_1.yml", "YAML", 0, 0, 0, 3, 0, 0, 1, 4
"d:\IDEWORK\lvmen\src\licensedcode\data\rules\lucent-pl-1.02_2.yml", "YAML", 0, 0, 0, 3, 0, 0, 1, 4
"d:\IDEWORK\lvmen\src\licensedcode\data\rules\lucent-pl-1.02_3.yml", "YAML", 0, 0, 0, 4, 0, 0, 1, 5
"d:\IDEWORK\lvmen\src\licensedcode\data\rules\lucent-pl-1.02_4.yml", "YAML", 0, 0, 0, 3, 0, 0, 1, 4
"d:\IDEWORK\lvmen\src\licensedcode\data\rules\lucent-pl-1.02_5.yml", "YAML", 0, 0, 0, 8, 0, 0, 1, 9
"d:\IDEWORK\lvmen\src\licensedcode\data\rules\lucent-pl-1.02_6.yml", "YAML", 0, 0, 0, 5, 0, 0, 1, 6
"d:\IDEWORK\lvmen\src\licensedcode\data\rules\lucent-pl-1.02_7.yml", "YAML", 0, 0, 0, 5, 0, 0, 1, 6
"d:\IDEWORK\lvmen\src\licensedcode\data\rules\lucent-pl-1.02_8.yml", "YAML", 0, 0, 0, 6, 0, 0, 1, 7
"d:\IDEWORK\lvmen\src\licensedcode\data\rules\lucent-pl-1.02_and_gpl-1.0-plus_and_proprietary-license_and_afpl-9.0_and_other-copyleft_and_other-permissive_1.yml", "YAML", 0, 0, 0, 13, 0, 0, 1, 14
"d:\IDEWORK\lvmen\src\licensedcode\data\rules\lucent-pl-1.02_or_mit_1.yml", "YAML", 0, 0, 0, 4, 0, 0, 1, 5
"d:\IDEWORK\lvmen\src\licensedcode\data\rules\lucent-pl-1.02_url_1.yml", "YAML", 0, 0, 0, 5, 0, 0, 1, 6
"d:\IDEWORK\lvmen\src\licensedcode\data\rules\lucent-pl-1.02_url_2.yml", "YAML", 0, 0, 0, 5, 0, 0, 1, 6
"d:\IDEWORK\lvmen\src\licensedcode\data\rules\lucent-pl-1.02_url_glc_182.yml", "YAML", 0, 0, 0, 5, 0, 0, 1, 6
"d:\IDEWORK\lvmen\src\licensedcode\data\rules\lucent-pl-1.02_url_glc_183.yml", "YAML", 0, 0, 0, 5, 0, 0, 1, 6
"d:\IDEWORK\lvmen\src\licensedcode\data\rules\lucent-pl-1.0_1.yml", "YAML", 0, 0, 0, 5, 0, 0, 1, 6
"d:\IDEWORK\lvmen\src\licensedcode\data\rules\lucent-pl-1.0_2.yml", "YAML", 0, 0, 0, 3, 0, 0, 1, 4
"d:\IDEWORK\lvmen\src\licensedcode\data\rules\lucent-pl-1.0_url_1.yml", "YAML", 0, 0, 0, 5, 0, 0, 1, 6
"d:\IDEWORK\lvmen\src\licensedcode\data\rules\lucent-pl-1.0_url_2.yml", "YAML", 0, 0, 0, 5, 0, 0, 1, 6
"d:\IDEWORK\lvmen\src\licensedcode\data\rules\lucent-pl-1.0_url_glc_88.yml", "YAML", 0, 0, 0, 5, 0, 0, 1, 6
"d:\IDEWORK\lvmen\src\licensedcode\data\rules\lucent-pl-1.0_url_glc_89.yml", "YAML", 0, 0, 0, 5, 0, 0, 1, 6
"d:\IDEWORK\lvmen\src\licensedcode\data\rules\lzma-cpl-exception.yml", "YAML", 0, 0, 0, 2, 0, 0, 1, 3
"d:\IDEWORK\lvmen\src\licensedcode\data\rules\lzma-cpl-exception_url_1.yml", "YAML", 0, 0, 0, 5, 0, 0, 1, 6
"d:\IDEWORK\lvmen\src\licensedcode\data\rules\lzma-cpl-exception_url_2.yml", "YAML", 0, 0, 0, 5, 0, 0, 1, 6
"d:\IDEWORK\lvmen\src\licensedcode\data\rules\lzma-sdk-pd.yml", "YAML", 0, 0, 0, 2, 0, 0, 1, 3
"d:\IDEWORK\lvmen\src\licensedcode\data\rules\m-plus_1.yml", "YAML", 0, 0, 0, 3, 0, 0, 1, 4
"d:\IDEWORK\lvmen\src\licensedcode\data\rules\m-plus_2.yml", "YAML", 0, 0, 0, 2, 0, 0, 1, 3
"d:\IDEWORK\lvmen\src\licensedcode\data\rules\m-plus_3.yml", "YAML", 0, 0, 0, 2, 0, 0, 1, 3
"d:\IDEWORK\lvmen\src\licensedcode\data\rules\m-plus_4.yml", "YAML", 0, 0, 0, 9, 0, 0, 1, 10
"d:\IDEWORK\lvmen\src\licensedcode\data\rules\m-plus_5.yml", "YAML", 0, 0, 0, 4, 0, 0, 1, 5
"d:\IDEWORK\lvmen\src\licensedcode\data\rules\makeindex2.yml", "YAML", 0, 0, 0, 3, 0, 0, 1, 4
"d:\IDEWORK\lvmen\src\licensedcode\data\rules\makeindex_url_1.yml", "YAML", 0, 0, 0, 5, 0, 0, 1, 6
"d:\IDEWORK\lvmen\src\licensedcode\data\rules\makeindex_url_2.yml", "YAML", 0, 0, 0, 5, 0, 0, 1, 6
"d:\IDEWORK\lvmen\src\licensedcode\data\rules\mattkruse.yml", "YAML", 0, 0, 0, 5, 0, 0, 1, 6
"d:\IDEWORK\lvmen\src\licensedcode\data\rules\mattkruse_1.yml", "YAML", 0, 0, 0, 5, 0, 0, 1, 6
"d:\IDEWORK\lvmen\src\licensedcode\data\rules\maven_pom_1.yml", "YAML", 0, 0, 0, 5, 0, 0, 1, 6
"d:\IDEWORK\lvmen\src\licensedcode\data\rules\maven_pom_10.yml", "YAML", 0, 0, 0, 5, 0, 0, 1, 6
"d:\IDEWORK\lvmen\src\licensedcode\data\rules\maven_pom_11.yml", "YAML", 0, 0, 0, 5, 0, 0, 1, 6
"d:\IDEWORK\lvmen\src\licensedcode\data\rules\maven_pom_12.yml", "YAML", 0, 0, 0, 3, 0, 0, 1, 4
"d:\IDEWORK\lvmen\src\licensedcode\data\rules\maven_pom_13.yml", "YAML", 0, 0, 0, 5, 0, 0, 1, 6
"d:\IDEWORK\lvmen\src\licensedcode\data\rules\maven_pom_14.yml", "YAML", 0, 0, 0, 5, 0, 0, 1, 6
"d:\IDEWORK\lvmen\src\licensedcode\data\rules\maven_pom_16.yml", "YAML", 0, 0, 0, 5, 0, 0, 1, 6
"d:\IDEWORK\lvmen\src\licensedcode\data\rules\maven_pom_161.yml", "YAML", 0, 0, 0, 5, 0, 0, 1, 6
"d:\IDEWORK\lvmen\src\licensedcode\data\rules\maven_pom_18.yml", "YAML", 0, 0, 0, 5, 0, 0, 1, 6
"d:\IDEWORK\lvmen\src\licensedcode\data\rules\maven_pom_20.yml", "YAML", 0, 0, 0, 4, 0, 0, 1, 5
"d:\IDEWORK\lvmen\src\licensedcode\data\rules\maven_pom_21.yml", "YAML", 0, 0, 0, 5, 0, 0, 1, 6
"d:\IDEWORK\lvmen\src\licensedcode\data\rules\maven_pom_22.yml", "YAML", 0, 0, 0, 9, 0, 0, 1, 10
"d:\IDEWORK\lvmen\src\licensedcode\data\rules\maven_pom_24.yml", "YAML", 0, 0, 0, 4, 0, 0, 1, 5
"d:\IDEWORK\lvmen\src\licensedcode\data\rules\maven_pom_25.yml", "YAML", 0, 0, 0, 3, 0, 0, 1, 4
"d:\IDEWORK\lvmen\src\licensedcode\data\rules\maven_pom_27.yml", "YAML", 0, 0, 0, 3, 0, 0, 1, 4
"d:\IDEWORK\lvmen\src\licensedcode\data\rules\maven_pom_28.yml", "YAML", 0, 0, 0, 3, 0, 0, 1, 4
"d:\IDEWORK\lvmen\src\licensedcode\data\rules\maven_pom_29.yml", "YAML", 0, 0, 0, 5, 0, 0, 1, 6
"d:\IDEWORK\lvmen\src\licensedcode\data\rules\maven_pom_3.yml", "YAML", 0, 0, 0, 5, 0, 0, 1, 6
"d:\IDEWORK\lvmen\src\licensedcode\data\rules\maven_pom_30.yml", "YAML", 0, 0, 0, 5, 0, 0, 1, 6
"d:\IDEWORK\lvmen\src\licensedcode\data\rules\maven_pom_31.yml", "YAML", 0, 0, 0, 5, 0, 0, 1, 6
"d:\IDEWORK\lvmen\src\licensedcode\data\rules\maven_pom_32.yml", "YAML", 0, 0, 0, 5, 0, 0, 1, 6
"d:\IDEWORK\lvmen\src\licensedcode\data\rules\maven_pom_34.yml", "YAML", 0, 0, 0, 5, 0, 0, 1, 6
"d:\IDEWORK\lvmen\src\licensedcode\data\rules\maven_pom_35.yml", "YAML", 0, 0, 0, 5, 0, 0, 1, 6
"d:\IDEWORK\lvmen\src\licensedcode\data\rules\maven_pom_36.yml", "YAML", 0, 0, 0, 5, 0, 0, 1, 6
"d:\IDEWORK\lvmen\src\licensedcode\data\rules\maven_pom_4.yml", "YAML", 0, 0, 0, 5, 0, 0, 1, 6
"d:\IDEWORK\lvmen\src\licensedcode\data\rules\maven_pom_5.yml", "YAML", 0, 0, 0, 5, 0, 0, 1, 6
"d:\IDEWORK\lvmen\src\licensedcode\data\rules\maven_pom_6.yml", "YAML", 0, 0, 0, 5, 0, 0, 1, 6
"d:\IDEWORK\lvmen\src\licensedcode\data\rules\maven_pom_7.yml", "YAML", 0, 0, 0, 5, 0, 0, 1, 6
"d:\IDEWORK\lvmen\src\licensedcode\data\rules\maven_pom_8.yml", "YAML", 0, 0, 0, 5, 0, 0, 1, 6
"d:\IDEWORK\lvmen\src\licensedcode\data\rules\maven_pom_9.yml", "YAML", 0, 0, 0, 5, 0, 0, 1, 6
"d:\IDEWORK\lvmen\src\licensedcode\data\rules\maxmind-odl_1.yml", "YAML", 0, 0, 0, 4, 0, 0, 1, 5
"d:\IDEWORK\lvmen\src\licensedcode\data\rules\maxmind-odl_2.yml", "YAML", 0, 0, 0, 5, 0, 0, 1, 6
"d:\IDEWORK\lvmen\src\licensedcode\data\rules\maxmind-odl_3.yml", "YAML", 0, 0, 0, 8, 0, 0, 1, 9
"d:\IDEWORK\lvmen\src\licensedcode\data\rules\maxmind-odl_4.yml", "YAML", 0, 0, 0, 3, 0, 0, 1, 4
"d:\IDEWORK\lvmen\src\licensedcode\data\rules\maxmind-odl_5.yml", "YAML", 0, 0, 0, 8, 0, 0, 1, 9
"d:\IDEWORK\lvmen\src\licensedcode\data\rules\maxmind-odl_6.yml", "YAML", 0, 0, 0, 4, 0, 0, 1, 5
"d:\IDEWORK\lvmen\src\licensedcode\data\rules\mediainfo-lib.yml", "YAML", 0, 0, 0, 5, 0, 0, 1, 6
"d:\IDEWORK\lvmen\src\licensedcode\data\rules\mentalis_1.yml", "YAML", 0, 0, 0, 3, 0, 0, 1, 4
"d:\IDEWORK\lvmen\src\licensedcode\data\rules\mentalis_2.yml", "YAML", 0, 0, 0, 2, 0, 0, 1, 3
"d:\IDEWORK\lvmen\src\licensedcode\data\rules\mentalis_3.yml", "YAML", 0, 0, 0, 2, 0, 0, 1, 3
"d:\IDEWORK\lvmen\src\licensedcode\data\rules\mentalis_4.yml", "YAML", 0, 0, 0, 2, 0, 0, 1, 3
"d:\IDEWORK\lvmen\src\licensedcode\data\rules\mentalis_5.yml", "YAML", 0, 0, 0, 2, 0, 0, 1, 3
"d:\IDEWORK\lvmen\src\licensedcode\data\rules\mgopen-font-license.yml", "YAML", 0, 0, 0, 10, 0, 0, 1, 11
"d:\IDEWORK\lvmen\src\licensedcode\data\rules\michigan-disclaimer.yml", "YAML", 0, 0, 0, 2, 0, 0, 1, 3
"d:\IDEWORK\lvmen\src\licensedcode\data\rules\michigan-disclaimer2.yml", "YAML", 0, 0, 0, 3, 0, 0, 1, 4
"d:\IDEWORK\lvmen\src\licensedcode\data\rules\microsoft-enterprise-library-eula.yml", "YAML", 0, 0, 0, 5, 0, 0, 1, 6
"d:\IDEWORK\lvmen\src\licensedcode\data\rules\mif-exception_url_1.yml", "YAML", 0, 0, 0, 5, 0, 0, 1, 6
"d:\IDEWORK\lvmen\src\licensedcode\data\rules\mif-exception_url_2.yml", "YAML", 0, 0, 0, 5, 0, 0, 1, 6
"d:\IDEWORK\lvmen\src\licensedcode\data\rules\mini-xml_1.yml", "YAML", 0, 0, 0, 5, 0, 0, 1, 6
"d:\IDEWORK\lvmen\src\licensedcode\data\rules\minpack_1.yml", "YAML", 0, 0, 0, 4, 0, 0, 1, 5
"d:\IDEWORK\lvmen\src\licensedcode\data\rules\mir-os.SPDX.yml", "YAML", 0, 0, 0, 15, 0, 0, 1, 16
"d:\IDEWORK\lvmen\src\licensedcode\data\rules\mir-os.yml", "YAML", 0, 0, 0, 5, 0, 0, 1, 6
"d:\IDEWORK\lvmen\src\licensedcode\data\rules\mir-os_1.yml", "YAML", 0, 0, 0, 5, 0, 0, 1, 6
"d:\IDEWORK\lvmen\src\licensedcode\data\rules\mir-os_2.yml", "YAML", 0, 0, 0, 3, 0, 0, 1, 4
"d:\IDEWORK\lvmen\src\licensedcode\data\rules\mir-os_3.yml", "YAML", 0, 0, 0, 3, 0, 0, 1, 4
"d:\IDEWORK\lvmen\src\licensedcode\data\rules\mir-os_4.yml", "YAML", 0, 0, 0, 4, 0, 0, 1, 5
"d:\IDEWORK\lvmen\src\licensedcode\data\rules\mir-os_5.yml", "YAML", 0, 0, 0, 5, 0, 0, 1, 6
"d:\IDEWORK\lvmen\src\licensedcode\data\rules\mir-os_6.yml", "YAML", 0, 0, 0, 5, 0, 0, 1, 6
"d:\IDEWORK\lvmen\src\licensedcode\data\rules\mir-os_7.yml", "YAML", 0, 0, 0, 16, 0, 0, 1, 17
"d:\IDEWORK\lvmen\src\licensedcode\data\rules\mir-os_url_1.yml", "YAML", 0, 0, 0, 5, 0, 0, 1, 6
"d:\IDEWORK\lvmen\src\licensedcode\data\rules\mir-os_url_2.yml", "YAML", 0, 0, 0, 5, 0, 0, 1, 6
"d:\IDEWORK\lvmen\src\licensedcode\data\rules\mir-os_url_glc_194.yml", "YAML", 0, 0, 0, 5, 0, 0, 1, 6
"d:\IDEWORK\lvmen\src\licensedcode\data\rules\mir-os_url_glc_195.yml", "YAML", 0, 0, 0, 5, 0, 0, 1, 6
"d:\IDEWORK\lvmen\src\licensedcode\data\rules\mit-0_1.yml", "YAML", 0, 0, 0, 3, 0, 0, 1, 4
"d:\IDEWORK\lvmen\src\licensedcode\data\rules\mit-0_2.yml", "YAML", 0, 0, 0, 3, 0, 0, 1, 4
"d:\IDEWORK\lvmen\src\licensedcode\data\rules\mit-0_3.yml", "YAML", 0, 0, 0, 3, 0, 0, 1, 4
"d:\IDEWORK\lvmen\src\licensedcode\data\rules\mit-0_4.yml", "YAML", 0, 0, 0, 5, 0, 0, 1, 6
"d:\IDEWORK\lvmen\src\licensedcode\data\rules\mit-0_5.yml", "YAML", 0, 0, 0, 3, 0, 0, 1, 4
"d:\IDEWORK\lvmen\src\licensedcode\data\rules\mit-0_6.yml", "YAML", 0, 0, 0, 3, 0, 0, 1, 4
"d:\IDEWORK\lvmen\src\licensedcode\data\rules\mit-0_7.yml", "YAML", 0, 0, 0, 3, 0, 0, 1, 4
"d:\IDEWORK\lvmen\src\licensedcode\data\rules\mit-0_url_1.yml", "YAML", 0, 0, 0, 5, 0, 0, 1, 6
"d:\IDEWORK\lvmen\src\licensedcode\data\rules\mit-0_url_2.yml", "YAML", 0, 0, 0, 5, 0, 0, 1, 6
"d:\IDEWORK\lvmen\src\licensedcode\data\rules\mit-ack_url_1.yml", "YAML", 0, 0, 0, 5, 0, 0, 1, 6
"d:\IDEWORK\lvmen\src\licensedcode\data\rules\mit-ack_url_2.yml", "YAML", 0, 0, 0, 5, 0, 0, 1, 6
"d:\IDEWORK\lvmen\src\licensedcode\data\rules\mit-addition_1.yml", "YAML", 0, 0, 0, 5, 0, 0, 1, 6
"d:\IDEWORK\lvmen\src\licensedcode\data\rules\mit-export-control.SPDX.yml", "YAML", 0, 0, 0, 4, 0, 0, 1, 5
"d:\IDEWORK\lvmen\src\licensedcode\data\rules\mit-export-control_url_1.yml", "YAML", 0, 0, 0, 5, 0, 0, 1, 6
"d:\IDEWORK\lvmen\src\licensedcode\data\rules\mit-export-control_url_2.yml", "YAML", 0, 0, 0, 5, 0, 0, 1, 6
"d:\IDEWORK\lvmen\src\licensedcode\data\rules\mit-license-1998.yml", "YAML", 0, 0, 0, 2, 0, 0, 1, 3
"d:\IDEWORK\lvmen\src\licensedcode\data\rules\mit-modern.yml", "YAML", 0, 0, 0, 5, 0, 0, 1, 6
"d:\IDEWORK\lvmen\src\licensedcode\data\rules\mit-modern_1.yml", "YAML", 0, 0, 0, 3, 0, 0, 1, 4
"d:\IDEWORK\lvmen\src\licensedcode\data\rules\mit-modern_2.yml", "YAML", 0, 0, 0, 2, 0, 0, 1, 3
"d:\IDEWORK\lvmen\src\licensedcode\data\rules\mit-modern_3.yml", "YAML", 0, 0, 0, 2, 0, 0, 1, 3
"d:\IDEWORK\lvmen\src\licensedcode\data\rules\mit-modern_4.yml", "YAML", 0, 0, 0, 3, 0, 0, 1, 4
"d:\IDEWORK\lvmen\src\licensedcode\data\rules\mit-modern_5.yml", "YAML", 0, 0, 0, 3, 0, 0, 1, 4
"d:\IDEWORK\lvmen\src\licensedcode\data\rules\mit-modern_6.yml", "YAML", 0, 0, 0, 2, 0, 0, 1, 3
"d:\IDEWORK\lvmen\src\licensedcode\data\rules\mit-modern_7.yml", "YAML", 0, 0, 0, 2, 0, 0, 1, 3
"d:\IDEWORK\lvmen\src\licensedcode\data\rules\mit-modern_8.yml", "YAML", 0, 0, 0, 2, 0, 0, 1, 3
"d:\IDEWORK\lvmen\src\licensedcode\data\rules\mit-modern_9.yml", "YAML", 0, 0, 0, 2, 0, 0, 1, 3
"d:\IDEWORK\lvmen\src\licensedcode\data\rules\mit-modern_and_other-permissive_1.yml", "YAML", 0, 0, 0, 5, 0, 0, 1, 6
"d:\IDEWORK\lvmen\src\licensedcode\data\rules\mit-no-advert-export-control_1.yml", "YAML", 0, 0, 0, 3, 0, 0, 1, 4
"d:\IDEWORK\lvmen\src\licensedcode\data\rules\mit-no-advert-export-control_2.yml", "YAML", 0, 0, 0, 3, 0, 0, 1, 4
"d:\IDEWORK\lvmen\src\licensedcode\data\rules\mit-no-advert-export-control_3.yml", "YAML", 0, 0, 0, 3, 0, 0, 1, 4
"d:\IDEWORK\lvmen\src\licensedcode\data\rules\mit-no-advert-export-control_4.yml", "YAML", 0, 0, 0, 4, 0, 0, 1, 5
"d:\IDEWORK\lvmen\src\licensedcode\data\rules\mit-no-advert-export-control_5.yml", "YAML", 0, 0, 0, 4, 0, 0, 1, 5
"d:\IDEWORK\lvmen\src\licensedcode\data\rules\mit-no-advert-export-control_6.yml", "YAML", 0, 0, 0, 4, 0, 0, 1, 5
"d:\IDEWORK\lvmen\src\licensedcode\data\rules\mit-no-advert-export-control_7.yml", "YAML", 0, 0, 0, 3, 0, 0, 1, 4
"d:\IDEWORK\lvmen\src\licensedcode\data\rules\mit-no-advert-export-control_8.yml", "YAML", 0, 0, 0, 5, 0, 0, 1, 6
"d:\IDEWORK\lvmen\src\licensedcode\data\rules\mit-no-advert-export-control_and_proprietary-license_1.yml", "YAML", 0, 0, 0, 9, 0, 0, 1, 10
"d:\IDEWORK\lvmen\src\licensedcode\data\rules\mit-no-false-attribs_1.yml", "YAML", 0, 0, 0, 3, 0, 0, 1, 4
"d:\IDEWORK\lvmen\src\licensedcode\data\rules\mit-no-false-attribs_url_1.yml", "YAML", 0, 0, 0, 5, 0, 0, 1, 6
"d:\IDEWORK\lvmen\src\licensedcode\data\rules\mit-no-false-attribs_url_2.yml", "YAML", 0, 0, 0, 5, 0, 0, 1, 6
"d:\IDEWORK\lvmen\src\licensedcode\data\rules\mit-old-style-no-advert_1.yml", "YAML", 0, 0, 0, 2, 0, 0, 1, 3
"d:\IDEWORK\lvmen\src\licensedcode\data\rules\mit-old-style-no-advert_10.yml", "YAML", 0, 0, 0, 6, 0, 0, 1, 7
"d:\IDEWORK\lvmen\src\licensedcode\data\rules\mit-old-style-no-advert_11.yml", "YAML", 0, 0, 0, 6, 0, 0, 1, 7
"d:\IDEWORK\lvmen\src\licensedcode\data\rules\mit-old-style-no-advert_12.yml", "YAML", 0, 0, 0, 3, 0, 0, 1, 4
"d:\IDEWORK\lvmen\src\licensedcode\data\rules\mit-old-style-no-advert_13.yml", "YAML", 0, 0, 0, 4, 0, 0, 1, 5
"d:\IDEWORK\lvmen\src\licensedcode\data\rules\mit-old-style-no-advert_14.yml", "YAML", 0, 0, 0, 4, 0, 0, 1, 5
"d:\IDEWORK\lvmen\src\licensedcode\data\rules\mit-old-style-no-advert_15.yml", "YAML", 0, 0, 0, 4, 0, 0, 1, 5
"d:\IDEWORK\lvmen\src\licensedcode\data\rules\mit-old-style-no-advert_16.yml", "YAML", 0, 0, 0, 3, 0, 0, 1, 4
"d:\IDEWORK\lvmen\src\licensedcode\data\rules\mit-old-style-no-advert_17.yml", "YAML", 0, 0, 0, 3, 0, 0, 1, 4
"d:\IDEWORK\lvmen\src\licensedcode\data\rules\mit-old-style-no-advert_18.yml", "YAML", 0, 0, 0, 3, 0, 0, 1, 4
"d:\IDEWORK\lvmen\src\licensedcode\data\rules\mit-old-style-no-advert_19.yml", "YAML", 0, 0, 0, 3, 0, 0, 1, 4
"d:\IDEWORK\lvmen\src\licensedcode\data\rules\mit-old-style-no-advert_2.yml", "YAML", 0, 0, 0, 5, 0, 0, 1, 6
"d:\IDEWORK\lvmen\src\licensedcode\data\rules\mit-old-style-no-advert_3.yml", "YAML", 0, 0, 0, 3, 0, 0, 1, 4
"d:\IDEWORK\lvmen\src\licensedcode\data\rules\mit-old-style-no-advert_4.yml", "YAML", 0, 0, 0, 3, 0, 0, 1, 4
"d:\IDEWORK\lvmen\src\licensedcode\data\rules\mit-old-style-no-advert_5.yml", "YAML", 0, 0, 0, 2, 0, 0, 1, 3
"d:\IDEWORK\lvmen\src\licensedcode\data\rules\mit-old-style-no-advert_6.yml", "YAML", 0, 0, 0, 3, 0, 0, 1, 4
"d:\IDEWORK\lvmen\src\licensedcode\data\rules\mit-old-style-no-advert_7.yml", "YAML", 0, 0, 0, 3, 0, 0, 1, 4
"d:\IDEWORK\lvmen\src\licensedcode\data\rules\mit-old-style-no-advert_8.yml", "YAML", 0, 0, 0, 3, 0, 0, 1, 4
"d:\IDEWORK\lvmen\src\licensedcode\data\rules\mit-old-style-no-advert_9.yml", "YAML", 0, 0, 0, 4, 0, 0, 1, 5
"d:\IDEWORK\lvmen\src\licensedcode\data\rules\mit-old-style-no-advert_and_warranty-disclaimer_1.yml", "YAML", 0, 0, 0, 2, 0, 0, 1, 3
"d:\IDEWORK\lvmen\src\licensedcode\data\rules\mit-old-style-no-advert_ntpl.yml", "YAML", 0, 0, 0, 5, 0, 0, 1, 6
"d:\IDEWORK\lvmen\src\licensedcode\data\rules\mit-old-style-no-advert_ntpl_1.yml", "YAML", 0, 0, 0, 3, 0, 0, 1, 4
"d:\IDEWORK\lvmen\src\licensedcode\data\rules\mit-old-style-no-advert_ntpl_10.yml", "YAML", 0, 0, 0, 2, 0, 0, 1, 3
"d:\IDEWORK\lvmen\src\licensedcode\data\rules\mit-old-style-no-advert_ntpl_11.yml", "YAML", 0, 0, 0, 5, 0, 0, 1, 6
"d:\IDEWORK\lvmen\src\licensedcode\data\rules\mit-old-style-no-advert_ntpl_12.yml", "YAML", 0, 0, 0, 5, 0, 0, 1, 6
"d:\IDEWORK\lvmen\src\licensedcode\data\rules\mit-old-style-no-advert_ntpl_13.yml", "YAML", 0, 0, 0, 5, 0, 0, 1, 6
"d:\IDEWORK\lvmen\src\licensedcode\data\rules\mit-old-style-no-advert_ntpl_14.yml", "YAML", 0, 0, 0, 2, 0, 0, 1, 3
"d:\IDEWORK\lvmen\src\licensedcode\data\rules\mit-old-style-no-advert_ntpl_15.yml", "YAML", 0, 0, 0, 5, 0, 0, 1, 6
"d:\IDEWORK\lvmen\src\licensedcode\data\rules\mit-old-style-no-advert_ntpl_16.yml", "YAML", 0, 0, 0, 5, 0, 0, 1, 6
"d:\IDEWORK\lvmen\src\licensedcode\data\rules\mit-old-style-no-advert_ntpl_17.yml", "YAML", 0, 0, 0, 3, 0, 0, 1, 4
"d:\IDEWORK\lvmen\src\licensedcode\data\rules\mit-old-style-no-advert_ntpl_18.yml", "YAML", 0, 0, 0, 5, 0, 0, 1, 6
"d:\IDEWORK\lvmen\src\licensedcode\data\rules\mit-old-style-no-advert_ntpl_19.yml", "YAML", 0, 0, 0, 3, 0, 0, 1, 4
"d:\IDEWORK\lvmen\src\licensedcode\data\rules\mit-old-style-no-advert_ntpl_2.yml", "YAML", 0, 0, 0, 3, 0, 0, 1, 4
"d:\IDEWORK\lvmen\src\licensedcode\data\rules\mit-old-style-no-advert_ntpl_3.yml", "YAML", 0, 0, 0, 3, 0, 0, 2, 5
"d:\IDEWORK\lvmen\src\licensedcode\data\rules\mit-old-style-no-advert_ntpl_4.yml", "YAML", 0, 0, 0, 2, 0, 0, 1, 3
"d:\IDEWORK\lvmen\src\licensedcode\data\rules\mit-old-style-no-advert_ntpl_6.yml", "YAML", 0, 0, 0, 5, 0, 0, 1, 6
"d:\IDEWORK\lvmen\src\licensedcode\data\rules\mit-old-style-no-advert_ntpl_7.yml", "YAML", 0, 0, 0, 5, 0, 0, 1, 6
"d:\IDEWORK\lvmen\src\licensedcode\data\rules\mit-old-style-no-advert_ntpl_8.yml", "YAML", 0, 0, 0, 5, 0, 0, 1, 6
"d:\IDEWORK\lvmen\src\licensedcode\data\rules\mit-old-style-no-advert_ntpl_9.yml", "YAML", 0, 0, 0, 2, 0, 0, 1, 3
"d:\IDEWORK\lvmen\src\licensedcode\data\rules\mit-old-style-no-advert_url_1.yml", "YAML", 0, 0, 0, 5, 0, 0, 1, 6
"d:\IDEWORK\lvmen\src\licensedcode\data\rules\mit-old-style-no-advert_url_2.yml", "YAML", 0, 0, 0, 5, 0, 0, 1, 6
"d:\IDEWORK\lvmen\src\licensedcode\data\rules\mit-old-style-no-advert_url_glc_208.yml", "YAML", 0, 0, 0, 5, 0, 0, 1, 6
"d:\IDEWORK\lvmen\src\licensedcode\data\rules\mit-old-style-no-advert_url_glc_209.yml", "YAML", 0, 0, 0, 5, 0, 0, 1, 6
"d:\IDEWORK\lvmen\src\licensedcode\data\rules\mit-old-style-sparse_1.yml", "YAML", 0, 0, 0, 3, 0, 0, 1, 4
"d:\IDEWORK\lvmen\src\licensedcode\data\rules\mit-old-style-sparse_2.yml", "YAML", 0, 0, 0, 3, 0, 0, 1, 4
"d:\IDEWORK\lvmen\src\licensedcode\data\rules\mit-old-style_1.yml", "YAML", 0, 0, 0, 5, 0, 0, 1, 6
"d:\IDEWORK\lvmen\src\licensedcode\data\rules\mit-old-style_10.yml", "YAML", 0, 0, 0, 3, 0, 0, 1, 4
"d:\IDEWORK\lvmen\src\licensedcode\data\rules\mit-old-style_11.yml", "YAML", 0, 0, 0, 3, 0, 0, 1, 4
"d:\IDEWORK\lvmen\src\licensedcode\data\rules\mit-old-style_12.yml", "YAML", 0, 0, 0, 2, 0, 0, 1, 3
"d:\IDEWORK\lvmen\src\licensedcode\data\rules\mit-old-style_13.yml", "YAML", 0, 0, 0, 3, 0, 0, 1, 4
"d:\IDEWORK\lvmen\src\licensedcode\data\rules\mit-old-style_14.yml", "YAML", 0, 0, 0, 2, 0, 0, 1, 3
"d:\IDEWORK\lvmen\src\licensedcode\data\rules\mit-old-style_15.yml", "YAML", 0, 0, 0, 3, 0, 0, 1, 4
"d:\IDEWORK\lvmen\src\licensedcode\data\rules\mit-old-style_16.yml", "YAML", 0, 0, 0, 3, 0, 0, 1, 4
"d:\IDEWORK\lvmen\src\licensedcode\data\rules\mit-old-style_17.yml", "YAML", 0, 0, 0, 3, 0, 0, 1, 4
"d:\IDEWORK\lvmen\src\licensedcode\data\rules\mit-old-style_18.yml", "YAML", 0, 0, 0, 4, 0, 0, 1, 5
"d:\IDEWORK\lvmen\src\licensedcode\data\rules\mit-old-style_19.yml", "YAML", 0, 0, 0, 4, 0, 0, 1, 5
"d:\IDEWORK\lvmen\src\licensedcode\data\rules\mit-old-style_2.yml", "YAML", 0, 0, 0, 2, 0, 0, 1, 3
"d:\IDEWORK\lvmen\src\licensedcode\data\rules\mit-old-style_20.yml", "YAML", 0, 0, 0, 4, 0, 0, 1, 5
"d:\IDEWORK\lvmen\src\licensedcode\data\rules\mit-old-style_21.yml", "YAML", 0, 0, 0, 4, 0, 0, 1, 5
"d:\IDEWORK\lvmen\src\licensedcode\data\rules\mit-old-style_22.yml", "YAML", 0, 0, 0, 4, 0, 0, 1, 5
"d:\IDEWORK\lvmen\src\licensedcode\data\rules\mit-old-style_23.yml", "YAML", 0, 0, 0, 4, 0, 0, 1, 5
"d:\IDEWORK\lvmen\src\licensedcode\data\rules\mit-old-style_24.yml", "YAML", 0, 0, 0, 2, 0, 0, 1, 3
"d:\IDEWORK\lvmen\src\licensedcode\data\rules\mit-old-style_25.yml", "YAML", 0, 0, 0, 2, 0, 0, 1, 3
"d:\IDEWORK\lvmen\src\licensedcode\data\rules\mit-old-style_3.yml", "YAML", 0, 0, 0, 2, 0, 0, 1, 3
"d:\IDEWORK\lvmen\src\licensedcode\data\rules\mit-old-style_4.yml", "YAML", 0, 0, 0, 2, 0, 0, 1, 3
"d:\IDEWORK\lvmen\src\licensedcode\data\rules\mit-old-style_5.yml", "YAML", 0, 0, 0, 2, 0, 0, 1, 3
"d:\IDEWORK\lvmen\src\licensedcode\data\rules\mit-old-style_6.yml", "YAML", 0, 0, 0, 2, 0, 0, 1, 3
"d:\IDEWORK\lvmen\src\licensedcode\data\rules\mit-old-style_7.yml", "YAML", 0, 0, 0, 3, 0, 0, 1, 4
"d:\IDEWORK\lvmen\src\licensedcode\data\rules\mit-old-style_8.yml", "YAML", 0, 0, 0, 7, 0, 0, 1, 8
"d:\IDEWORK\lvmen\src\licensedcode\data\rules\mit-old-style_9.yml", "YAML", 0, 0, 0, 5, 0, 0, 1, 6
"d:\IDEWORK\lvmen\src\licensedcode\data\rules\mit-old-style_and_warranty-disclaimer_1.yml", "YAML", 0, 0, 0, 2, 0, 0, 1, 3
"d:\IDEWORK\lvmen\src\licensedcode\data\rules\mit-old-style_cmr-no_1.yml", "YAML", 0, 0, 0, 2, 0, 0, 1, 3
"d:\IDEWORK\lvmen\src\licensedcode\data\rules\mit-old-style_dr-john-maddock.yml", "YAML", 0, 0, 0, 2, 0, 0, 1, 3
"d:\IDEWORK\lvmen\src\licensedcode\data\rules\mit-old-style_mit-open-group_1.yml", "YAML", 0, 0, 0, 3, 0, 0, 1, 4
"d:\IDEWORK\lvmen\src\licensedcode\data\rules\mit-old-style_mit-open-group_2.yml", "YAML", 0, 0, 0, 2, 0, 0, 1, 3
"d:\IDEWORK\lvmen\src\licensedcode\data\rules\mit-old-style_mit-open-group_4.yml", "YAML", 0, 0, 0, 2, 0, 0, 1, 3
"d:\IDEWORK\lvmen\src\licensedcode\data\rules\mit-specification-disclaimer_1.yml", "YAML", 0, 0, 0, 2, 0, 0, 1, 3
"d:\IDEWORK\lvmen\src\licensedcode\data\rules\mit-synopsys.yml", "YAML", 0, 0, 0, 3, 0, 0, 1, 4
"d:\IDEWORK\lvmen\src\licensedcode\data\rules\mit-taylor-variant_1.yml", "YAML", 0, 0, 0, 3, 0, 0, 1, 4
"d:\IDEWORK\lvmen\src\licensedcode\data\rules\mit-taylor-variant_2.yml", "YAML", 0, 0, 0, 3, 0, 0, 1, 4
"d:\IDEWORK\lvmen\src\licensedcode\data\rules\mit-taylor-variant_3.yml", "YAML", 0, 0, 0, 4, 0, 0, 1, 5
"d:\IDEWORK\lvmen\src\licensedcode\data\rules\mit-with-modification-obligations_1.yml", "YAML", 0, 0, 0, 2, 0, 0, 1, 3
"d:\IDEWORK\lvmen\src\licensedcode\data\rules\mit-with-modification-obligations_2.yml", "YAML", 0, 0, 0, 4, 0, 0, 1, 5
"d:\IDEWORK\lvmen\src\licensedcode\data\rules\mit-with-modification-obligations_3.yml", "YAML", 0, 0, 0, 3, 0, 0, 1, 4
"d:\IDEWORK\lvmen\src\licensedcode\data\rules\mit-with-modification-obligations_4.yml", "YAML", 0, 0, 0, 3, 0, 0, 1, 4
"d:\IDEWORK\lvmen\src\licensedcode\data\rules\mit-xfig_1.yml", "YAML", 0, 0, 0, 4, 0, 0, 1, 5
"d:\IDEWORK\lvmen\src\licensedcode\data\rules\mit-xfig_2.yml", "YAML", 0, 0, 0, 4, 0, 0, 1, 5
"d:\IDEWORK\lvmen\src\licensedcode\data\rules\mit-xfig_3.yml", "YAML", 0, 0, 0, 2, 0, 0, 1, 3
"d:\IDEWORK\lvmen\src\licensedcode\data\rules\mit_0.yml", "YAML", 0, 0, 0, 5, 0, 0, 1, 6
"d:\IDEWORK\lvmen\src\licensedcode\data\rules\mit_1.yml", "YAML", 0, 0, 0, 2, 0, 0, 1, 3
"d:\IDEWORK\lvmen\src\licensedcode\data\rules\mit_10.yml", "YAML", 0, 0, 0, 6, 0, 0, 1, 7
"d:\IDEWORK\lvmen\src\licensedcode\data\rules\mit_100.yml", "YAML", 0, 0, 0, 5, 0, 0, 1, 6
"d:\IDEWORK\lvmen\src\licensedcode\data\rules\mit_1000.yml", "YAML", 0, 0, 0, 3, 0, 0, 1, 4
"d:\IDEWORK\lvmen\src\licensedcode\data\rules\mit_1001.yml", "YAML", 0, 0, 0, 3, 0, 0, 1, 4
"d:\IDEWORK\lvmen\src\licensedcode\data\rules\mit_1002.yml", "YAML", 0, 0, 0, 5, 0, 0, 1, 6
"d:\IDEWORK\lvmen\src\licensedcode\data\rules\mit_1003.yml", "YAML", 0, 0, 0, 3, 0, 0, 1, 4
"d:\IDEWORK\lvmen\src\licensedcode\data\rules\mit_1004.yml", "YAML", 0, 0, 0, 3, 0, 0, 1, 4
"d:\IDEWORK\lvmen\src\licensedcode\data\rules\mit_1005.yml", "YAML", 0, 0, 0, 3, 0, 0, 1, 4
"d:\IDEWORK\lvmen\src\licensedcode\data\rules\mit_1006.yml", "YAML", 0, 0, 0, 3, 0, 0, 1, 4
"d:\IDEWORK\lvmen\src\licensedcode\data\rules\mit_1007.yml", "YAML", 0, 0, 0, 3, 0, 0, 1, 4
"d:\IDEWORK\lvmen\src\licensedcode\data\rules\mit_1008.yml", "YAML", 0, 0, 0, 3, 0, 0, 1, 4
"d:\IDEWORK\lvmen\src\licensedcode\data\rules\mit_1009.yml", "YAML", 0, 0, 0, 5, 0, 0, 1, 6
"d:\IDEWORK\lvmen\src\licensedcode\data\rules\mit_101.yml", "YAML", 0, 0, 0, 5, 0, 0, 1, 6
"d:\IDEWORK\lvmen\src\licensedcode\data\rules\mit_1010.yml", "YAML", 0, 0, 0, 3, 0, 0, 1, 4
"d:\IDEWORK\lvmen\src\licensedcode\data\rules\mit_1011.yml", "YAML", 0, 0, 0, 3, 0, 0, 1, 4
"d:\IDEWORK\lvmen\src\licensedcode\data\rules\mit_1012.yml", "YAML", 0, 0, 0, 3, 0, 0, 1, 4
"d:\IDEWORK\lvmen\src\licensedcode\data\rules\mit_1013.yml", "YAML", 0, 0, 0, 3, 0, 0, 1, 4
"d:\IDEWORK\lvmen\src\licensedcode\data\rules\mit_1014.yml", "YAML", 0, 0, 0, 3, 0, 0, 1, 4
"d:\IDEWORK\lvmen\src\licensedcode\data\rules\mit_1015.yml", "YAML", 0, 0, 0, 3, 0, 0, 1, 4
"d:\IDEWORK\lvmen\src\licensedcode\data\rules\mit_1016.yml", "YAML", 0, 0, 0, 3, 0, 0, 1, 4
"d:\IDEWORK\lvmen\src\licensedcode\data\rules\mit_1017.yml", "YAML", 0, 0, 0, 3, 0, 0, 1, 4
"d:\IDEWORK\lvmen\src\licensedcode\data\rules\mit_1018.yml", "YAML", 0, 0, 0, 3, 0, 0, 1, 4
"d:\IDEWORK\lvmen\src\licensedcode\data\rules\mit_1019.yml", "YAML", 0, 0, 0, 3, 0, 0, 1, 4
"d:\IDEWORK\lvmen\src\licensedcode\data\rules\mit_102.yml", "YAML", 0, 0, 0, 3, 0, 0, 1, 4
"d:\IDEWORK\lvmen\src\licensedcode\data\rules\mit_1020.yml", "YAML", 0, 0, 0, 3, 0, 0, 1, 4
"d:\IDEWORK\lvmen\src\licensedcode\data\rules\mit_1021.yml", "YAML", 0, 0, 0, 3, 0, 0, 1, 4
"d:\IDEWORK\lvmen\src\licensedcode\data\rules\mit_1022.yml", "YAML", 0, 0, 0, 3, 0, 0, 1, 4
"d:\IDEWORK\lvmen\src\licensedcode\data\rules\mit_1023.yml", "YAML", 0, 0, 0, 5, 0, 0, 1, 6
"d:\IDEWORK\lvmen\src\licensedcode\data\rules\mit_1024.yml", "YAML", 0, 0, 0, 5, 0, 0, 1, 6
"d:\IDEWORK\lvmen\src\licensedcode\data\rules\mit_1025.yml", "YAML", 0, 0, 0, 5, 0, 0, 1, 6
"d:\IDEWORK\lvmen\src\licensedcode\data\rules\mit_1026.yml", "YAML", 0, 0, 0, 5, 0, 0, 1, 6
"d:\IDEWORK\lvmen\src\licensedcode\data\rules\mit_1027.yml", "YAML", 0, 0, 0, 5, 0, 0, 1, 6
"d:\IDEWORK\lvmen\src\licensedcode\data\rules\mit_1028.yml", "YAML", 0, 0, 0, 5, 0, 0, 1, 6
"d:\IDEWORK\lvmen\src\licensedcode\data\rules\mit_1029.yml", "YAML", 0, 0, 0, 3, 0, 0, 1, 4
"d:\IDEWORK\lvmen\src\licensedcode\data\rules\mit_103.yml", "YAML", 0, 0, 0, 6, 0, 0, 1, 7
"d:\IDEWORK\lvmen\src\licensedcode\data\rules\mit_1030.yml", "YAML", 0, 0, 0, 3, 0, 0, 1, 4
"d:\IDEWORK\lvmen\src\licensedcode\data\rules\mit_1031.yml", "YAML", 0, 0, 0, 3, 0, 0, 1, 4
"d:\IDEWORK\lvmen\src\licensedcode\data\rules\mit_1032.yml", "YAML", 0, 0, 0, 3, 0, 0, 1, 4
"d:\IDEWORK\lvmen\src\licensedcode\data\rules\mit_1033.yml", "YAML", 0, 0, 0, 3, 0, 0, 1, 4
"d:\IDEWORK\lvmen\src\licensedcode\data\rules\mit_1034.yml", "YAML", 0, 0, 0, 5, 0, 0, 1, 6
"d:\IDEWORK\lvmen\src\licensedcode\data\rules\mit_1035.yml", "YAML", 0, 0, 0, 5, 0, 0, 1, 6
"d:\IDEWORK\lvmen\src\licensedcode\data\rules\mit_1036.yml", "YAML", 0, 0, 0, 3, 0, 0, 1, 4
"d:\IDEWORK\lvmen\src\licensedcode\data\rules\mit_1037.yml", "YAML", 0, 0, 0, 3, 0, 0, 1, 4
"d:\IDEWORK\lvmen\src\licensedcode\data\rules\mit_1038.yml", "YAML", 0, 0, 0, 3, 0, 0, 1, 4
"d:\IDEWORK\lvmen\src\licensedcode\data\rules\mit_1039.yml", "YAML", 0, 0, 0, 3, 0, 0, 1, 4
"d:\IDEWORK\lvmen\src\licensedcode\data\rules\mit_104.yml", "YAML", 0, 0, 0, 3, 0, 0, 1, 4
"d:\IDEWORK\lvmen\src\licensedcode\data\rules\mit_1040.yml", "YAML", 0, 0, 0, 6, 0, 0, 1, 7
"d:\IDEWORK\lvmen\src\licensedcode\data\rules\mit_1041.yml", "YAML", 0, 0, 0, 5, 0, 0, 1, 6
"d:\IDEWORK\lvmen\src\licensedcode\data\rules\mit_1042.yml", "YAML", 0, 0, 0, 3, 0, 0, 1, 4
"d:\IDEWORK\lvmen\src\licensedcode\data\rules\mit_1043.yml", "YAML", 0, 0, 0, 3, 0, 0, 1, 4
"d:\IDEWORK\lvmen\src\licensedcode\data\rules\mit_1044.yml", "YAML", 0, 0, 0, 4, 0, 0, 1, 5
"d:\IDEWORK\lvmen\src\licensedcode\data\rules\mit_1045.yml", "YAML", 0, 0, 0, 6, 0, 0, 1, 7
"d:\IDEWORK\lvmen\src\licensedcode\data\rules\mit_1046.yml", "YAML", 0, 0, 0, 3, 0, 0, 1, 4
"d:\IDEWORK\lvmen\src\licensedcode\data\rules\mit_1047.yml", "YAML", 0, 0, 0, 6, 0, 0, 1, 7
"d:\IDEWORK\lvmen\src\licensedcode\data\rules\mit_1048.yml", "YAML", 0, 0, 0, 7, 0, 0, 1, 8
"d:\IDEWORK\lvmen\src\licensedcode\data\rules\mit_1049.yml", "YAML", 0, 0, 0, 4, 0, 0, 1, 5
"d:\IDEWORK\lvmen\src\licensedcode\data\rules\mit_105.yml", "YAML", 0, 0, 0, 3, 0, 0, 1, 4
"d:\IDEWORK\lvmen\src\licensedcode\data\rules\mit_1050.yml", "YAML", 0, 0, 0, 3, 0, 0, 1, 4
"d:\IDEWORK\lvmen\src\licensedcode\data\rules\mit_1051.yml", "YAML", 0, 0, 0, 5, 0, 0, 1, 6
"d:\IDEWORK\lvmen\src\licensedcode\data\rules\mit_1052.yml", "YAML", 0, 0, 0, 5, 0, 0, 1, 6
"d:\IDEWORK\lvmen\src\licensedcode\data\rules\mit_1053.yml", "YAML", 0, 0, 0, 4, 0, 0, 1, 5
"d:\IDEWORK\lvmen\src\licensedcode\data\rules\mit_1054.yml", "YAML", 0, 0, 0, 3, 0, 0, 1, 4
"d:\IDEWORK\lvmen\src\licensedcode\data\rules\mit_1055.yml", "YAML", 0, 0, 0, 4, 0, 0, 1, 5
"d:\IDEWORK\lvmen\src\licensedcode\data\rules\mit_1056.yml", "YAML", 0, 0, 0, 4, 0, 0, 1, 5
"d:\IDEWORK\lvmen\src\licensedcode\data\rules\mit_1057.yml", "YAML", 0, 0, 0, 8, 0, 0, 2, 10
"d:\IDEWORK\lvmen\src\licensedcode\data\rules\mit_1058.yml", "YAML", 0, 0, 0, 3, 0, 0, 1, 4
"d:\IDEWORK\lvmen\src\licensedcode\data\rules\mit_1059.yml", "YAML", 0, 0, 0, 2, 0, 0, 1, 3
"d:\IDEWORK\lvmen\src\licensedcode\data\rules\mit_106.yml", "YAML", 0, 0, 0, 3, 0, 0, 1, 4
"d:\IDEWORK\lvmen\src\licensedcode\data\rules\mit_1060.yml", "YAML", 0, 0, 0, 3, 0, 0, 1, 4
"d:\IDEWORK\lvmen\src\licensedcode\data\rules\mit_1061.yml", "YAML", 0, 0, 0, 3, 0, 0, 1, 4
"d:\IDEWORK\lvmen\src\licensedcode\data\rules\mit_1062.yml", "YAML", 0, 0, 0, 4, 0, 0, 1, 5
"d:\IDEWORK\lvmen\src\licensedcode\data\rules\mit_1063.yml", "YAML", 0, 0, 0, 3, 0, 0, 1, 4
"d:\IDEWORK\lvmen\src\licensedcode\data\rules\mit_1064.yml", "YAML", 0, 0, 0, 3, 0, 0, 1, 4
"d:\IDEWORK\lvmen\src\licensedcode\data\rules\mit_1065.yml", "YAML", 0, 0, 0, 3, 0, 0, 1, 4
"d:\IDEWORK\lvmen\src\licensedcode\data\rules\mit_1066.yml", "YAML", 0, 0, 0, 3, 0, 0, 1, 4
"d:\IDEWORK\lvmen\src\licensedcode\data\rules\mit_1067.yml", "YAML", 0, 0, 0, 3, 0, 0, 1, 4
"d:\IDEWORK\lvmen\src\licensedcode\data\rules\mit_1068.yml", "YAML", 0, 0, 0, 5, 0, 0, 1, 6
"d:\IDEWORK\lvmen\src\licensedcode\data\rules\mit_1069.yml", "YAML", 0, 0, 0, 5, 0, 0, 1, 6
"d:\IDEWORK\lvmen\src\licensedcode\data\rules\mit_107.yml", "YAML", 0, 0, 0, 3, 0, 0, 1, 4
"d:\IDEWORK\lvmen\src\licensedcode\data\rules\mit_1070.yml", "YAML", 0, 0, 0, 3, 0, 0, 1, 4
"d:\IDEWORK\lvmen\src\licensedcode\data\rules\mit_1071.yml", "YAML", 0, 0, 0, 4, 0, 0, 1, 5
"d:\IDEWORK\lvmen\src\licensedcode\data\rules\mit_1072.yml", "YAML", 0, 0, 0, 3, 0, 0, 1, 4
"d:\IDEWORK\lvmen\src\licensedcode\data\rules\mit_1073.yml", "YAML", 0, 0, 0, 3, 0, 0, 1, 4
"d:\IDEWORK\lvmen\src\licensedcode\data\rules\mit_1074.yml", "YAML", 0, 0, 0, 5, 0, 0, 1, 6
"d:\IDEWORK\lvmen\src\licensedcode\data\rules\mit_1075.yml", "YAML", 0, 0, 0, 5, 0, 0, 1, 6
"d:\IDEWORK\lvmen\src\licensedcode\data\rules\mit_1076.yml", "YAML", 0, 0, 0, 4, 0, 0, 1, 5
"d:\IDEWORK\lvmen\src\licensedcode\data\rules\mit_1077.yml", "YAML", 0, 0, 0, 4, 0, 0, 1, 5
"d:\IDEWORK\lvmen\src\licensedcode\data\rules\mit_1078.yml", "YAML", 0, 0, 0, 2, 0, 0, 1, 3
"d:\IDEWORK\lvmen\src\licensedcode\data\rules\mit_1079.yml", "YAML", 0, 0, 0, 2, 0, 0, 1, 3
"d:\IDEWORK\lvmen\src\licensedcode\data\rules\mit_108.yml", "YAML", 0, 0, 0, 3, 0, 0, 1, 4
"d:\IDEWORK\lvmen\src\licensedcode\data\rules\mit_1080.yml", "YAML", 0, 0, 0, 3, 0, 0, 1, 4
"d:\IDEWORK\lvmen\src\licensedcode\data\rules\mit_1081.yml", "YAML", 0, 0, 0, 3, 0, 0, 1, 4
"d:\IDEWORK\lvmen\src\licensedcode\data\rules\mit_1082.yml", "YAML", 0, 0, 0, 3, 0, 0, 1, 4
"d:\IDEWORK\lvmen\src\licensedcode\data\rules\mit_1083.yml", "YAML", 0, 0, 0, 3, 0, 0, 1, 4
"d:\IDEWORK\lvmen\src\licensedcode\data\rules\mit_1084.yml", "YAML", 0, 0, 0, 3, 0, 0, 1, 4
"d:\IDEWORK\lvmen\src\licensedcode\data\rules\mit_1085.yml", "YAML", 0, 0, 0, 3, 0, 0, 1, 4
"d:\IDEWORK\lvmen\src\licensedcode\data\rules\mit_1086.yml", "YAML", 0, 0, 0, 5, 0, 0, 1, 6
"d:\IDEWORK\lvmen\src\licensedcode\data\rules\mit_1087.yml", "YAML", 0, 0, 0, 4, 0, 0, 1, 5
"d:\IDEWORK\lvmen\src\licensedcode\data\rules\mit_1088.yml", "YAML", 0, 0, 0, 5, 0, 0, 1, 6
"d:\IDEWORK\lvmen\src\licensedcode\data\rules\mit_1089.yml", "YAML", 0, 0, 0, 2, 0, 0, 1, 3
"d:\IDEWORK\lvmen\src\licensedcode\data\rules\mit_109.yml", "YAML", 0, 0, 0, 5, 0, 0, 1, 6
"d:\IDEWORK\lvmen\src\licensedcode\data\rules\mit_1090.yml", "YAML", 0, 0, 0, 3, 0, 0, 1, 4
"d:\IDEWORK\lvmen\src\licensedcode\data\rules\mit_1091.yml", "YAML", 0, 0, 0, 5, 0, 0, 1, 6
"d:\IDEWORK\lvmen\src\licensedcode\data\rules\mit_11.yml", "YAML", 0, 0, 0, 3, 0, 0, 1, 4
"d:\IDEWORK\lvmen\src\licensedcode\data\rules\mit_110.yml", "YAML", 0, 0, 0, 3, 0, 0, 1, 4
"d:\IDEWORK\lvmen\src\licensedcode\data\rules\mit_111.yml", "YAML", 0, 0, 0, 5, 0, 0, 1, 6
"d:\IDEWORK\lvmen\src\licensedcode\data\rules\mit_112.yml", "YAML", 0, 0, 0, 5, 0, 0, 1, 6
"d:\IDEWORK\lvmen\src\licensedcode\data\rules\mit_113.yml", "YAML", 0, 0, 0, 3, 0, 0, 1, 4
"d:\IDEWORK\lvmen\src\licensedcode\data\rules\mit_114.yml", "YAML", 0, 0, 0, 5, 0, 0, 1, 6
"d:\IDEWORK\lvmen\src\licensedcode\data\rules\mit_115.yml", "YAML", 0, 0, 0, 5, 0, 0, 1, 6
"d:\IDEWORK\lvmen\src\licensedcode\data\rules\mit_116.yml", "YAML", 0, 0, 0, 5, 0, 0, 1, 6
"d:\IDEWORK\lvmen\src\licensedcode\data\rules\mit_117.yml", "YAML", 0, 0, 0, 3, 0, 0, 1, 4
"d:\IDEWORK\lvmen\src\licensedcode\data\rules\mit_118.yml", "YAML", 0, 0, 0, 3, 0, 0, 1, 4
"d:\IDEWORK\lvmen\src\licensedcode\data\rules\mit_119.yml", "YAML", 0, 0, 0, 2, 0, 0, 1, 3
"d:\IDEWORK\lvmen\src\licensedcode\data\rules\mit_11_1.yml", "YAML", 0, 0, 0, 3, 0, 0, 1, 4
"d:\IDEWORK\lvmen\src\licensedcode\data\rules\mit_12.yml", "YAML", 0, 0, 0, 3, 0, 0, 1, 4
"d:\IDEWORK\lvmen\src\licensedcode\data\rules\mit_120.yml", "YAML", 0, 0, 0, 5, 0, 0, 1, 6
"d:\IDEWORK\lvmen\src\licensedcode\data\rules\mit_121.yml", "YAML", 0, 0, 0, 5, 0, 0, 1, 6
"d:\IDEWORK\lvmen\src\licensedcode\data\rules\mit_122.yml", "YAML", 0, 0, 0, 5, 0, 0, 1, 6
"d:\IDEWORK\lvmen\src\licensedcode\data\rules\mit_123.yml", "YAML", 0, 0, 0, 5, 0, 0, 1, 6
"d:\IDEWORK\lvmen\src\licensedcode\data\rules\mit_124.yml", "YAML", 0, 0, 0, 5, 0, 0, 1, 6
"d:\IDEWORK\lvmen\src\licensedcode\data\rules\mit_125.yml", "YAML", 0, 0, 0, 3, 0, 0, 1, 4
"d:\IDEWORK\lvmen\src\licensedcode\data\rules\mit_126.yml", "YAML", 0, 0, 0, 3, 0, 0, 1, 4
"d:\IDEWORK\lvmen\src\licensedcode\data\rules\mit_127.yml", "YAML", 0, 0, 0, 3, 0, 0, 1, 4
"d:\IDEWORK\lvmen\src\licensedcode\data\rules\mit_127_1.yml", "YAML", 0, 0, 0, 3, 0, 0, 1, 4
"d:\IDEWORK\lvmen\src\licensedcode\data\rules\mit_128.yml", "YAML", 0, 0, 0, 5, 0, 0, 1, 6
"d:\IDEWORK\lvmen\src\licensedcode\data\rules\mit_129.yml", "YAML", 0, 0, 0, 8, 0, 0, 1, 9
"d:\IDEWORK\lvmen\src\licensedcode\data\rules\mit_13.yml", "YAML", 0, 0, 0, 5, 0, 0, 1, 6
"d:\IDEWORK\lvmen\src\licensedcode\data\rules\mit_130.yml", "YAML", 0, 0, 0, 5, 0, 0, 1, 6
"d:\IDEWORK\lvmen\src\licensedcode\data\rules\mit_131.yml", "YAML", 0, 0, 0, 3, 0, 0, 1, 4
"d:\IDEWORK\lvmen\src\licensedcode\data\rules\mit_132.yml", "YAML", 0, 0, 0, 5, 0, 0, 1, 6
"d:\IDEWORK\lvmen\src\licensedcode\data\rules\mit_133.yml", "YAML", 0, 0, 0, 5, 0, 0, 1, 6
"d:\IDEWORK\lvmen\src\licensedcode\data\rules\mit_134.yml", "YAML", 0, 0, 0, 3, 0, 0, 1, 4
"d:\IDEWORK\lvmen\src\licensedcode\data\rules\mit_135.yml", "YAML", 0, 0, 0, 3, 0, 0, 1, 4
"d:\IDEWORK\lvmen\src\licensedcode\data\rules\mit_136.yml", "YAML", 0, 0, 0, 7, 0, 0, 1, 8
"d:\IDEWORK\lvmen\src\licensedcode\data\rules\mit_137.yml", "YAML", 0, 0, 0, 3, 0, 0, 1, 4
"d:\IDEWORK\lvmen\src\licensedcode\data\rules\mit_138.yml", "YAML", 0, 0, 0, 3, 0, 0, 1, 4
"d:\IDEWORK\lvmen\src\licensedcode\data\rules\mit_139.yml", "YAML", 0, 0, 0, 5, 0, 0, 1, 6
"d:\IDEWORK\lvmen\src\licensedcode\data\rules\mit_14.yml", "YAML", 0, 0, 0, 4, 0, 0, 1, 5
"d:\IDEWORK\lvmen\src\licensedcode\data\rules\mit_140.yml", "YAML", 0, 0, 0, 3, 0, 0, 1, 4
"d:\IDEWORK\lvmen\src\licensedcode\data\rules\mit_141.yml", "YAML", 0, 0, 0, 3, 0, 0, 1, 4
"d:\IDEWORK\lvmen\src\licensedcode\data\rules\mit_142.yml", "YAML", 0, 0, 0, 5, 0, 0, 1, 6
"d:\IDEWORK\lvmen\src\licensedcode\data\rules\mit_143.yml", "YAML", 0, 0, 0, 3, 0, 0, 1, 4
"d:\IDEWORK\lvmen\src\licensedcode\data\rules\mit_144.yml", "YAML", 0, 0, 0, 3, 0, 0, 1, 4
"d:\IDEWORK\lvmen\src\licensedcode\data\rules\mit_145.yml", "YAML", 0, 0, 0, 3, 0, 0, 1, 4
"d:\IDEWORK\lvmen\src\licensedcode\data\rules\mit_146.yml", "YAML", 0, 0, 0, 4, 0, 0, 1, 5
"d:\IDEWORK\lvmen\src\licensedcode\data\rules\mit_147.yml", "YAML", 0, 0, 0, 4, 0, 0, 1, 5
"d:\IDEWORK\lvmen\src\licensedcode\data\rules\mit_148.yml", "YAML", 0, 0, 0, 5, 0, 0, 1, 6
"d:\IDEWORK\lvmen\src\licensedcode\data\rules\mit_149.yml", "YAML", 0, 0, 0, 5, 0, 0, 1, 6
"d:\IDEWORK\lvmen\src\licensedcode\data\rules\mit_15.yml", "YAML", 0, 0, 0, 4, 0, 0, 1, 5
"d:\IDEWORK\lvmen\src\licensedcode\data\rules\mit_150.yml", "YAML", 0, 0, 0, 5, 0, 0, 1, 6
"d:\IDEWORK\lvmen\src\licensedcode\data\rules\mit_151.yml", "YAML", 0, 0, 0, 5, 0, 0, 1, 6
"d:\IDEWORK\lvmen\src\licensedcode\data\rules\mit_152.yml", "YAML", 0, 0, 0, 3, 0, 0, 1, 4
"d:\IDEWORK\lvmen\src\licensedcode\data\rules\mit_153.yml", "YAML", 0, 0, 0, 5, 0, 0, 1, 6
"d:\IDEWORK\lvmen\src\licensedcode\data\rules\mit_154.yml", "YAML", 0, 0, 0, 3, 0, 0, 1, 4
"d:\IDEWORK\lvmen\src\licensedcode\data\rules\mit_155.yml", "YAML", 0, 0, 0, 5, 0, 0, 1, 6
"d:\IDEWORK\lvmen\src\licensedcode\data\rules\mit_156.yml", "YAML", 0, 0, 0, 3, 0, 0, 1, 4
"d:\IDEWORK\lvmen\src\licensedcode\data\rules\mit_157.yml", "YAML", 0, 0, 0, 3, 0, 0, 1, 4
"d:\IDEWORK\lvmen\src\licensedcode\data\rules\mit_158.yml", "YAML", 0, 0, 0, 3, 0, 0, 1, 4
"d:\IDEWORK\lvmen\src\licensedcode\data\rules\mit_159.yml", "YAML", 0, 0, 0, 5, 0, 0, 1, 6
"d:\IDEWORK\lvmen\src\licensedcode\data\rules\mit_15_1.yml", "YAML", 0, 0, 0, 3, 0, 0, 1, 4
"d:\IDEWORK\lvmen\src\licensedcode\data\rules\mit_16.yml", "YAML", 0, 0, 0, 3, 0, 0, 1, 4
"d:\IDEWORK\lvmen\src\licensedcode\data\rules\mit_160.yml", "YAML", 0, 0, 0, 5, 0, 0, 1, 6
"d:\IDEWORK\lvmen\src\licensedcode\data\rules\mit_161.yml", "YAML", 0, 0, 0, 5, 0, 0, 1, 6
"d:\IDEWORK\lvmen\src\licensedcode\data\rules\mit_162.yml", "YAML", 0, 0, 0, 5, 0, 0, 1, 6
"d:\IDEWORK\lvmen\src\licensedcode\data\rules\mit_163.yml", "YAML", 0, 0, 0, 3, 0, 0, 1, 4
"d:\IDEWORK\lvmen\src\licensedcode\data\rules\mit_164.yml", "YAML", 0, 0, 0, 5, 0, 0, 1, 6
"d:\IDEWORK\lvmen\src\licensedcode\data\rules\mit_165.yml", "YAML", 0, 0, 0, 3, 0, 0, 1, 4
"d:\IDEWORK\lvmen\src\licensedcode\data\rules\mit_166.yml", "YAML", 0, 0, 0, 5, 0, 0, 1, 6
"d:\IDEWORK\lvmen\src\licensedcode\data\rules\mit_167.yml", "YAML", 0, 0, 0, 5, 0, 0, 1, 6
"d:\IDEWORK\lvmen\src\licensedcode\data\rules\mit_168.yml", "YAML", 0, 0, 0, 5, 0, 0, 1, 6
"d:\IDEWORK\lvmen\src\licensedcode\data\rules\mit_168_1.yml", "YAML", 0, 0, 0, 5, 0, 0, 1, 6
"d:\IDEWORK\lvmen\src\licensedcode\data\rules\mit_169.yml", "YAML", 0, 0, 0, 5, 0, 0, 1, 6
"d:\IDEWORK\lvmen\src\licensedcode\data\rules\mit_17.yml", "YAML", 0, 0, 0, 5, 0, 0, 1, 6
"d:\IDEWORK\lvmen\src\licensedcode\data\rules\mit_170.yml", "YAML", 0, 0, 0, 5, 0, 0, 1, 6
"d:\IDEWORK\lvmen\src\licensedcode\data\rules\mit_171.yml", "YAML", 0, 0, 0, 3, 0, 0, 1, 4
"d:\IDEWORK\lvmen\src\licensedcode\data\rules\mit_172.yml", "YAML", 0, 0, 0, 3, 0, 0, 1, 4
"d:\IDEWORK\lvmen\src\licensedcode\data\rules\mit_173.yml", "YAML", 0, 0, 0, 2, 0, 0, 1, 3
"d:\IDEWORK\lvmen\src\licensedcode\data\rules\mit_174.yml", "YAML", 0, 0, 0, 3, 0, 0, 1, 4
"d:\IDEWORK\lvmen\src\licensedcode\data\rules\mit_175.yml", "YAML", 0, 0, 0, 5, 0, 0, 1, 6
"d:\IDEWORK\lvmen\src\licensedcode\data\rules\mit_176.yml", "YAML", 0, 0, 0, 3, 0, 0, 1, 4
"d:\IDEWORK\lvmen\src\licensedcode\data\rules\mit_177.yml", "YAML", 0, 0, 0, 3, 0, 0, 1, 4
"d:\IDEWORK\lvmen\src\licensedcode\data\rules\mit_178.yml", "YAML", 0, 0, 0, 5, 0, 0, 1, 6
"d:\IDEWORK\lvmen\src\licensedcode\data\rules\mit_179.yml", "YAML", 0, 0, 0, 5, 0, 0, 1, 6
"d:\IDEWORK\lvmen\src\licensedcode\data\rules\mit_18.yml", "YAML", 0, 0, 0, 3, 0, 0, 1, 4
"d:\IDEWORK\lvmen\src\licensedcode\data\rules\mit_180.yml", "YAML", 0, 0, 0, 6, 0, 0, 1, 7
"d:\IDEWORK\lvmen\src\licensedcode\data\rules\mit_181.yml", "YAML", 0, 0, 0, 5, 0, 0, 1, 6
"d:\IDEWORK\lvmen\src\licensedcode\data\rules\mit_182.yml", "YAML", 0, 0, 0, 3, 0, 0, 1, 4
"d:\IDEWORK\lvmen\src\licensedcode\data\rules\mit_183.yml", "YAML", 0, 0, 0, 5, 0, 0, 1, 6
"d:\IDEWORK\lvmen\src\licensedcode\data\rules\mit_184.yml", "YAML", 0, 0, 0, 3, 0, 0, 1, 4
"d:\IDEWORK\lvmen\src\licensedcode\data\rules\mit_185.yml", "YAML", 0, 0, 0, 5, 0, 0, 1, 6
"d:\IDEWORK\lvmen\src\licensedcode\data\rules\mit_186.yml", "YAML", 0, 0, 0, 4, 0, 0, 1, 5
"d:\IDEWORK\lvmen\src\licensedcode\data\rules\mit_187.yml", "YAML", 0, 0, 0, 5, 0, 0, 1, 6
"d:\IDEWORK\lvmen\src\licensedcode\data\rules\mit_188.yml", "YAML", 0, 0, 0, 3, 0, 0, 1, 4
"d:\IDEWORK\lvmen\src\licensedcode\data\rules\mit_189.yml", "YAML", 0, 0, 0, 5, 0, 0, 1, 6
"d:\IDEWORK\lvmen\src\licensedcode\data\rules\mit_18_1.yml", "YAML", 0, 0, 0, 3, 0, 0, 1, 4
"d:\IDEWORK\lvmen\src\licensedcode\data\rules\mit_19.yml", "YAML", 0, 0, 0, 3, 0, 0, 1, 4
"d:\IDEWORK\lvmen\src\licensedcode\data\rules\mit_190.yml", "YAML", 0, 0, 0, 3, 0, 0, 1, 4
"d:\IDEWORK\lvmen\src\licensedcode\data\rules\mit_191.yml", "YAML", 0, 0, 0, 3, 0, 0, 1, 4
"d:\IDEWORK\lvmen\src\licensedcode\data\rules\mit_192.yml", "YAML", 0, 0, 0, 5, 0, 0, 1, 6
"d:\IDEWORK\lvmen\src\licensedcode\data\rules\mit_193.yml", "YAML", 0, 0, 0, 5, 0, 0, 1, 6
"d:\IDEWORK\lvmen\src\licensedcode\data\rules\mit_194.yml", "YAML", 0, 0, 0, 5, 0, 0, 1, 6
"d:\IDEWORK\lvmen\src\licensedcode\data\rules\mit_195.yml", "YAML", 0, 0, 0, 5, 0, 0, 1, 6
"d:\IDEWORK\lvmen\src\licensedcode\data\rules\mit_196.yml", "YAML", 0, 0, 0, 5, 0, 0, 1, 6
"d:\IDEWORK\lvmen\src\licensedcode\data\rules\mit_197.yml", "YAML", 0, 0, 0, 5, 0, 0, 1, 6
"d:\IDEWORK\lvmen\src\licensedcode\data\rules\mit_198.yml", "YAML", 0, 0, 0, 4, 0, 0, 1, 5
"d:\IDEWORK\lvmen\src\licensedcode\data\rules\mit_199.yml", "YAML", 0, 0, 0, 2, 0, 0, 1, 3
"d:\IDEWORK\lvmen\src\licensedcode\data\rules\mit_2.yml", "YAML", 0, 0, 0, 3, 0, 0, 1, 4
"d:\IDEWORK\lvmen\src\licensedcode\data\rules\mit_20.yml", "YAML", 0, 0, 0, 3, 0, 0, 1, 4
"d:\IDEWORK\lvmen\src\licensedcode\data\rules\mit_200.yml", "YAML", 0, 0, 0, 3, 0, 0, 1, 4
"d:\IDEWORK\lvmen\src\licensedcode\data\rules\mit_201.yml", "YAML", 0, 0, 0, 3, 0, 0, 1, 4
"d:\IDEWORK\lvmen\src\licensedcode\data\rules\mit_202.yml", "YAML", 0, 0, 0, 5, 0, 0, 1, 6
"d:\IDEWORK\lvmen\src\licensedcode\data\rules\mit_203.yml", "YAML", 0, 0, 0, 8, 0, 0, 1, 9
"d:\IDEWORK\lvmen\src\licensedcode\data\rules\mit_204.yml", "YAML", 0, 0, 0, 4, 0, 0, 1, 5
"d:\IDEWORK\lvmen\src\licensedcode\data\rules\mit_205.yml", "YAML", 0, 0, 0, 3, 0, 0, 1, 4
"d:\IDEWORK\lvmen\src\licensedcode\data\rules\mit_206.yml", "YAML", 0, 0, 0, 4, 0, 0, 1, 5
"d:\IDEWORK\lvmen\src\licensedcode\data\rules\mit_207.yml", "YAML", 0, 0, 0, 5, 0, 0, 1, 6
"d:\IDEWORK\lvmen\src\licensedcode\data\rules\mit_208.yml", "YAML", 0, 0, 0, 5, 0, 0, 1, 6
"d:\IDEWORK\lvmen\src\licensedcode\data\rules\mit_209.yml", "YAML", 0, 0, 0, 6, 0, 0, 1, 7
"d:\IDEWORK\lvmen\src\licensedcode\data\rules\mit_21.yml", "YAML", 0, 0, 0, 5, 0, 0, 1, 6
"d:\IDEWORK\lvmen\src\licensedcode\data\rules\mit_210.yml", "YAML", 0, 0, 0, 3, 0, 0, 1, 4
"d:\IDEWORK\lvmen\src\licensedcode\data\rules\mit_211.yml", "YAML", 0, 0, 0, 6, 0, 0, 1, 7
"d:\IDEWORK\lvmen\src\licensedcode\data\rules\mit_212.yml", "YAML", 0, 0, 0, 3, 0, 0, 1, 4
"d:\IDEWORK\lvmen\src\licensedcode\data\rules\mit_213.yml", "YAML", 0, 0, 0, 5, 0, 0, 1, 6
"d:\IDEWORK\lvmen\src\licensedcode\data\rules\mit_214.yml", "YAML", 0, 0, 0, 5, 0, 0, 1, 6
"d:\IDEWORK\lvmen\src\licensedcode\data\rules\mit_215.yml", "YAML", 0, 0, 0, 5, 0, 0, 1, 6
"d:\IDEWORK\lvmen\src\licensedcode\data\rules\mit_216.yml", "YAML", 0, 0, 0, 3, 0, 0, 1, 4
"d:\IDEWORK\lvmen\src\licensedcode\data\rules\mit_217.yml", "YAML", 0, 0, 0, 5, 0, 0, 1, 6
"d:\IDEWORK\lvmen\src\licensedcode\data\rules\mit_218.yml", "YAML", 0, 0, 0, 5, 0, 0, 1, 6
"d:\IDEWORK\lvmen\src\licensedcode\data\rules\mit_219.yml", "YAML", 0, 0, 0, 3, 0, 0, 1, 4
"d:\IDEWORK\lvmen\src\licensedcode\data\rules\mit_22.yml", "YAML", 0, 0, 0, 3, 0, 0, 1, 4
"d:\IDEWORK\lvmen\src\licensedcode\data\rules\mit_220.yml", "YAML", 0, 0, 0, 5, 0, 0, 1, 6
"d:\IDEWORK\lvmen\src\licensedcode\data\rules\mit_221.yml", "YAML", 0, 0, 0, 3, 0, 0, 1, 4
"d:\IDEWORK\lvmen\src\licensedcode\data\rules\mit_222.yml", "YAML", 0, 0, 0, 3, 0, 0, 1, 4
"d:\IDEWORK\lvmen\src\licensedcode\data\rules\mit_223.yml", "YAML", 0, 0, 0, 5, 0, 0, 1, 6
"d:\IDEWORK\lvmen\src\licensedcode\data\rules\mit_224.yml", "YAML", 0, 0, 0, 5, 0, 0, 1, 6
"d:\IDEWORK\lvmen\src\licensedcode\data\rules\mit_225.yml", "YAML", 0, 0, 0, 3, 0, 0, 1, 4
"d:\IDEWORK\lvmen\src\licensedcode\data\rules\mit_226.yml", "YAML", 0, 0, 0, 5, 0, 0, 1, 6
"d:\IDEWORK\lvmen\src\licensedcode\data\rules\mit_227.yml", "YAML", 0, 0, 0, 3, 0, 0, 1, 4
"d:\IDEWORK\lvmen\src\licensedcode\data\rules\mit_228.yml", "YAML", 0, 0, 0, 3, 0, 0, 1, 4
"d:\IDEWORK\lvmen\src\licensedcode\data\rules\mit_229.yml", "YAML", 0, 0, 0, 3, 0, 0, 1, 4
"d:\IDEWORK\lvmen\src\licensedcode\data\rules\mit_23.yml", "YAML", 0, 0, 0, 5, 0, 0, 1, 6
"d:\IDEWORK\lvmen\src\licensedcode\data\rules\mit_230.yml", "YAML", 0, 0, 0, 5, 0, 0, 1, 6
"d:\IDEWORK\lvmen\src\licensedcode\data\rules\mit_231.yml", "YAML", 0, 0, 0, 3, 0, 0, 1, 4
"d:\IDEWORK\lvmen\src\licensedcode\data\rules\mit_232.yml", "YAML", 0, 0, 0, 5, 0, 0, 1, 6
"d:\IDEWORK\lvmen\src\licensedcode\data\rules\mit_233.yml", "YAML", 0, 0, 0, 5, 0, 0, 1, 6
"d:\IDEWORK\lvmen\src\licensedcode\data\rules\mit_234.yml", "YAML", 0, 0, 0, 5, 0, 0, 1, 6
"d:\IDEWORK\lvmen\src\licensedcode\data\rules\mit_235.yml", "YAML", 0, 0, 0, 5, 0, 0, 1, 6
"d:\IDEWORK\lvmen\src\licensedcode\data\rules\mit_236.yml", "YAML", 0, 0, 0, 5, 0, 0, 1, 6
"d:\IDEWORK\lvmen\src\licensedcode\data\rules\mit_237.yml", "YAML", 0, 0, 0, 5, 0, 0, 1, 6
"d:\IDEWORK\lvmen\src\licensedcode\data\rules\mit_238.yml", "YAML", 0, 0, 0, 5, 0, 0, 1, 6
"d:\IDEWORK\lvmen\src\licensedcode\data\rules\mit_239.yml", "YAML", 0, 0, 0, 3, 0, 0, 1, 4
"d:\IDEWORK\lvmen\src\licensedcode\data\rules\mit_24.yml", "YAML", 0, 0, 0, 3, 0, 0, 1, 4
"d:\IDEWORK\lvmen\src\licensedcode\data\rules\mit_240.yml", "YAML", 0, 0, 0, 3, 0, 0, 1, 4
"d:\IDEWORK\lvmen\src\licensedcode\data\rules\mit_241.yml", "YAML", 0, 0, 0, 3, 0, 0, 1, 4
"d:\IDEWORK\lvmen\src\licensedcode\data\rules\mit_242.yml", "YAML", 0, 0, 0, 3, 0, 0, 1, 4
"d:\IDEWORK\lvmen\src\licensedcode\data\rules\mit_243.yml", "YAML", 0, 0, 0, 5, 0, 0, 1, 6
"d:\IDEWORK\lvmen\src\licensedcode\data\rules\mit_244.yml", "YAML", 0, 0, 0, 3, 0, 0, 1, 4
"d:\IDEWORK\lvmen\src\licensedcode\data\rules\mit_245.yml", "YAML", 0, 0, 0, 5, 0, 0, 1, 6
"d:\IDEWORK\lvmen\src\licensedcode\data\rules\mit_246.yml", "YAML", 0, 0, 0, 5, 0, 0, 1, 6
"d:\IDEWORK\lvmen\src\licensedcode\data\rules\mit_247.yml", "YAML", 0, 0, 0, 3, 0, 0, 1, 4
"d:\IDEWORK\lvmen\src\licensedcode\data\rules\mit_248.yml", "YAML", 0, 0, 0, 3, 0, 0, 1, 4
"d:\IDEWORK\lvmen\src\licensedcode\data\rules\mit_249.yml", "YAML", 0, 0, 0, 5, 0, 0, 1, 6
"d:\IDEWORK\lvmen\src\licensedcode\data\rules\mit_25.yml", "YAML", 0, 0, 0, 4, 0, 0, 1, 5
"d:\IDEWORK\lvmen\src\licensedcode\data\rules\mit_250.yml", "YAML", 0, 0, 0, 3, 0, 0, 1, 4
"d:\IDEWORK\lvmen\src\licensedcode\data\rules\mit_251.yml", "YAML", 0, 0, 0, 3, 0, 0, 1, 4
"d:\IDEWORK\lvmen\src\licensedcode\data\rules\mit_252.yml", "YAML", 0, 0, 0, 3, 0, 0, 1, 4
"d:\IDEWORK\lvmen\src\licensedcode\data\rules\mit_253.yml", "YAML", 0, 0, 0, 5, 0, 0, 1, 6
"d:\IDEWORK\lvmen\src\licensedcode\data\rules\mit_254.yml", "YAML", 0, 0, 0, 5, 0, 0, 1, 6
"d:\IDEWORK\lvmen\src\licensedcode\data\rules\mit_255.yml", "YAML", 0, 0, 0, 5, 0, 0, 1, 6
"d:\IDEWORK\lvmen\src\licensedcode\data\rules\mit_256.yml", "YAML", 0, 0, 0, 5, 0, 0, 1, 6
"d:\IDEWORK\lvmen\src\licensedcode\data\rules\mit_257.yml", "YAML", 0, 0, 0, 5, 0, 0, 1, 6
"d:\IDEWORK\lvmen\src\licensedcode\data\rules\mit_258.yml", "YAML", 0, 0, 0, 3, 0, 0, 1, 4
"d:\IDEWORK\lvmen\src\licensedcode\data\rules\mit_259.yml", "YAML", 0, 0, 0, 3, 0, 0, 1, 4
"d:\IDEWORK\lvmen\src\licensedcode\data\rules\mit_26.yml", "YAML", 0, 0, 0, 3, 0, 0, 1, 4
"d:\IDEWORK\lvmen\src\licensedcode\data\rules\mit_260.yml", "YAML", 0, 0, 0, 3, 0, 0, 1, 4
"d:\IDEWORK\lvmen\src\licensedcode\data\rules\mit_261.yml", "YAML", 0, 0, 0, 3, 0, 0, 1, 4
"d:\IDEWORK\lvmen\src\licensedcode\data\rules\mit_262.yml", "YAML", 0, 0, 0, 3, 0, 0, 1, 4
"d:\IDEWORK\lvmen\src\licensedcode\data\rules\mit_263.yml", "YAML", 0, 0, 0, 3, 0, 0, 1, 4
"d:\IDEWORK\lvmen\src\licensedcode\data\rules\mit_264.yml", "YAML", 0, 0, 0, 5, 0, 0, 1, 6
"d:\IDEWORK\lvmen\src\licensedcode\data\rules\mit_265.yml", "YAML", 0, 0, 0, 5, 0, 0, 1, 6
"d:\IDEWORK\lvmen\src\licensedcode\data\rules\mit_266.yml", "YAML", 0, 0, 0, 5, 0, 0, 1, 6
"d:\IDEWORK\lvmen\src\licensedcode\data\rules\mit_267.yml", "YAML", 0, 0, 0, 5, 0, 0, 1, 6
"d:\IDEWORK\lvmen\src\licensedcode\data\rules\mit_268.yml", "YAML", 0, 0, 0, 5, 0, 0, 1, 6
"d:\IDEWORK\lvmen\src\licensedcode\data\rules\mit_269.yml", "YAML", 0, 0, 0, 3, 0, 0, 1, 4
"d:\IDEWORK\lvmen\src\licensedcode\data\rules\mit_27.yml", "YAML", 0, 0, 0, 3, 0, 0, 1, 4
"d:\IDEWORK\lvmen\src\licensedcode\data\rules\mit_270.yml", "YAML", 0, 0, 0, 3, 0, 0, 1, 4
"d:\IDEWORK\lvmen\src\licensedcode\data\rules\mit_271.yml", "YAML", 0, 0, 0, 3, 0, 0, 1, 4
"d:\IDEWORK\lvmen\src\licensedcode\data\rules\mit_272.yml", "YAML", 0, 0, 0, 3, 0, 0, 1, 4
"d:\IDEWORK\lvmen\src\licensedcode\data\rules\mit_273.yml", "YAML", 0, 0, 0, 3, 0, 0, 1, 4
"d:\IDEWORK\lvmen\src\licensedcode\data\rules\mit_274.yml", "YAML", 0, 0, 0, 5, 0, 0, 1, 6
"d:\IDEWORK\lvmen\src\licensedcode\data\rules\mit_275.yml", "YAML", 0, 0, 0, 5, 0, 0, 1, 6
"d:\IDEWORK\lvmen\src\licensedcode\data\rules\mit_276.yml", "YAML", 0, 0, 0, 5, 0, 0, 1, 6
"d:\IDEWORK\lvmen\src\licensedcode\data\rules\mit_277.yml", "YAML", 0, 0, 0, 5, 0, 0, 1, 6
"d:\IDEWORK\lvmen\src\licensedcode\data\rules\mit_278.yml", "YAML", 0, 0, 0, 3, 0, 0, 1, 4
"d:\IDEWORK\lvmen\src\licensedcode\data\rules\mit_279.yml", "YAML", 0, 0, 0, 5, 0, 0, 1, 6
"d:\IDEWORK\lvmen\src\licensedcode\data\rules\mit_28.yml", "YAML", 0, 0, 0, 5, 0, 0, 1, 6
"d:\IDEWORK\lvmen\src\licensedcode\data\rules\mit_280.yml", "YAML", 0, 0, 0, 5, 0, 0, 1, 6
"d:\IDEWORK\lvmen\src\licensedcode\data\rules\mit_281.yml", "YAML", 0, 0, 0, 5, 0, 0, 1, 6
"d:\IDEWORK\lvmen\src\licensedcode\data\rules\mit_282.yml", "YAML", 0, 0, 0, 5, 0, 0, 1, 6
"d:\IDEWORK\lvmen\src\licensedcode\data\rules\mit_283.yml", "YAML", 0, 0, 0, 5, 0, 0, 1, 6
"d:\IDEWORK\lvmen\src\licensedcode\data\rules\mit_284.yml", "YAML", 0, 0, 0, 5, 0, 0, 1, 6
"d:\IDEWORK\lvmen\src\licensedcode\data\rules\mit_285.yml", "YAML", 0, 0, 0, 5, 0, 0, 1, 6
"d:\IDEWORK\lvmen\src\licensedcode\data\rules\mit_286.yml", "YAML", 0, 0, 0, 5, 0, 0, 1, 6
"d:\IDEWORK\lvmen\src\licensedcode\data\rules\mit_287.yml", "YAML", 0, 0, 0, 5, 0, 0, 1, 6
"d:\IDEWORK\lvmen\src\licensedcode\data\rules\mit_288.yml", "YAML", 0, 0, 0, 5, 0, 0, 1, 6
"d:\IDEWORK\lvmen\src\licensedcode\data\rules\mit_289.yml", "YAML", 0, 0, 0, 5, 0, 0, 1, 6
"d:\IDEWORK\lvmen\src\licensedcode\data\rules\mit_29.yml", "YAML", 0, 0, 0, 3, 0, 0, 1, 4
"d:\IDEWORK\lvmen\src\licensedcode\data\rules\mit_290.yml", "YAML", 0, 0, 0, 5, 0, 0, 1, 6
"d:\IDEWORK\lvmen\src\licensedcode\data\rules\mit_291.yml", "YAML", 0, 0, 0, 5, 0, 0, 1, 6
"d:\IDEWORK\lvmen\src\licensedcode\data\rules\mit_292.yml", "YAML", 0, 0, 0, 5, 0, 0, 1, 6
"d:\IDEWORK\lvmen\src\licensedcode\data\rules\mit_293.yml", "YAML", 0, 0, 0, 5, 0, 0, 1, 6
"d:\IDEWORK\lvmen\src\licensedcode\data\rules\mit_294.yml", "YAML", 0, 0, 0, 5, 0, 0, 1, 6
"d:\IDEWORK\lvmen\src\licensedcode\data\rules\mit_295.yml", "YAML", 0, 0, 0, 5, 0, 0, 1, 6
"d:\IDEWORK\lvmen\src\licensedcode\data\rules\mit_296.yml", "YAML", 0, 0, 0, 5, 0, 0, 1, 6
"d:\IDEWORK\lvmen\src\licensedcode\data\rules\mit_297.yml", "YAML", 0, 0, 0, 5, 0, 0, 1, 6
"d:\IDEWORK\lvmen\src\licensedcode\data\rules\mit_298.yml", "YAML", 0, 0, 0, 5, 0, 0, 1, 6
"d:\IDEWORK\lvmen\src\licensedcode\data\rules\mit_299.yml", "YAML", 0, 0, 0, 3, 0, 0, 1, 4
"d:\IDEWORK\lvmen\src\licensedcode\data\rules\mit_3.yml", "YAML", 0, 0, 0, 4, 0, 0, 1, 5
"d:\IDEWORK\lvmen\src\licensedcode\data\rules\mit_30.yml", "YAML", 0, 0, 0, 3, 0, 0, 1, 4
"d:\IDEWORK\lvmen\src\licensedcode\data\rules\mit_300.yml", "YAML", 0, 0, 0, 3, 0, 0, 1, 4
"d:\IDEWORK\lvmen\src\licensedcode\data\rules\mit_301.yml", "YAML", 0, 0, 0, 5, 0, 0, 1, 6
"d:\IDEWORK\lvmen\src\licensedcode\data\rules\mit_302.yml", "YAML", 0, 0, 0, 5, 0, 0, 1, 6
"d:\IDEWORK\lvmen\src\licensedcode\data\rules\mit_303.yml", "YAML", 0, 0, 0, 5, 0, 0, 1, 6
"d:\IDEWORK\lvmen\src\licensedcode\data\rules\mit_304.yml", "YAML", 0, 0, 0, 5, 0, 0, 1, 6
"d:\IDEWORK\lvmen\src\licensedcode\data\rules\mit_305.yml", "YAML", 0, 0, 0, 5, 0, 0, 1, 6
"d:\IDEWORK\lvmen\src\licensedcode\data\rules\mit_306.yml", "YAML", 0, 0, 0, 5, 0, 0, 1, 6
"d:\IDEWORK\lvmen\src\licensedcode\data\rules\mit_307.yml", "YAML", 0, 0, 0, 3, 0, 0, 1, 4
"d:\IDEWORK\lvmen\src\licensedcode\data\rules\mit_308.yml", "YAML", 0, 0, 0, 5, 0, 0, 1, 6
"d:\IDEWORK\lvmen\src\licensedcode\data\rules\mit_309.yml", "YAML", 0, 0, 0, 5, 0, 0, 1, 6
"d:\IDEWORK\lvmen\src\licensedcode\data\rules\mit_31.yml", "YAML", 0, 0, 0, 3, 0, 0, 1, 4
"d:\IDEWORK\lvmen\src\licensedcode\data\rules\mit_310.yml", "YAML", 0, 0, 0, 5, 0, 0, 1, 6
"d:\IDEWORK\lvmen\src\licensedcode\data\rules\mit_311.yml", "YAML", 0, 0, 0, 5, 0, 0, 1, 6
"d:\IDEWORK\lvmen\src\licensedcode\data\rules\mit_312.yml", "YAML", 0, 0, 0, 5, 0, 0, 1, 6
"d:\IDEWORK\lvmen\src\licensedcode\data\rules\mit_313.yml", "YAML", 0, 0, 0, 5, 0, 0, 1, 6
"d:\IDEWORK\lvmen\src\licensedcode\data\rules\mit_314.yml", "YAML", 0, 0, 0, 5, 0, 0, 1, 6
"d:\IDEWORK\lvmen\src\licensedcode\data\rules\mit_315.yml", "YAML", 0, 0, 0, 5, 0, 0, 1, 6
"d:\IDEWORK\lvmen\src\licensedcode\data\rules\mit_316.yml", "YAML", 0, 0, 0, 5, 0, 0, 1, 6
"d:\IDEWORK\lvmen\src\licensedcode\data\rules\mit_317.yml", "YAML", 0, 0, 0, 5, 0, 0, 1, 6
"d:\IDEWORK\lvmen\src\licensedcode\data\rules\mit_318.yml", "YAML", 0, 0, 0, 5, 0, 0, 1, 6
"d:\IDEWORK\lvmen\src\licensedcode\data\rules\mit_319.yml", "YAML", 0, 0, 0, 5, 0, 0, 1, 6
"d:\IDEWORK\lvmen\src\licensedcode\data\rules\mit_32.yml", "YAML", 0, 0, 0, 6, 0, 0, 1, 7
"d:\IDEWORK\lvmen\src\licensedcode\data\rules\mit_320.yml", "YAML", 0, 0, 0, 5, 0, 0, 1, 6
"d:\IDEWORK\lvmen\src\licensedcode\data\rules\mit_321.yml", "YAML", 0, 0, 0, 5, 0, 0, 1, 6
"d:\IDEWORK\lvmen\src\licensedcode\data\rules\mit_322.yml", "YAML", 0, 0, 0, 5, 0, 0, 1, 6
"d:\IDEWORK\lvmen\src\licensedcode\data\rules\mit_323.yml", "YAML", 0, 0, 0, 5, 0, 0, 1, 6
"d:\IDEWORK\lvmen\src\licensedcode\data\rules\mit_324.yml", "YAML", 0, 0, 0, 5, 0, 0, 1, 6
"d:\IDEWORK\lvmen\src\licensedcode\data\rules\mit_325.yml", "YAML", 0, 0, 0, 5, 0, 0, 1, 6
"d:\IDEWORK\lvmen\src\licensedcode\data\rules\mit_326.yml", "YAML", 0, 0, 0, 5, 0, 0, 1, 6
"d:\IDEWORK\lvmen\src\licensedcode\data\rules\mit_327.yml", "YAML", 0, 0, 0, 5, 0, 0, 1, 6
"d:\IDEWORK\lvmen\src\licensedcode\data\rules\mit_328.yml", "YAML", 0, 0, 0, 6, 0, 0, 1, 7
"d:\IDEWORK\lvmen\src\licensedcode\data\rules\mit_329.yml", "YAML", 0, 0, 0, 5, 0, 0, 1, 6
"d:\IDEWORK\lvmen\src\licensedcode\data\rules\mit_33.yml", "YAML", 0, 0, 0, 3, 0, 0, 1, 4
"d:\IDEWORK\lvmen\src\licensedcode\data\rules\mit_330.yml", "YAML", 0, 0, 0, 6, 0, 0, 1, 7
"d:\IDEWORK\lvmen\src\licensedcode\data\rules\mit_331.yml", "YAML", 0, 0, 0, 5, 0, 0, 1, 6
"d:\IDEWORK\lvmen\src\licensedcode\data\rules\mit_332.yml", "YAML", 0, 0, 0, 3, 0, 0, 1, 4
"d:\IDEWORK\lvmen\src\licensedcode\data\rules\mit_333.yml", "YAML", 0, 0, 0, 5, 0, 0, 1, 6
"d:\IDEWORK\lvmen\src\licensedcode\data\rules\mit_334.yml", "YAML", 0, 0, 0, 5, 0, 0, 1, 6
"d:\IDEWORK\lvmen\src\licensedcode\data\rules\mit_335.yml", "YAML", 0, 0, 0, 3, 0, 0, 1, 4
"d:\IDEWORK\lvmen\src\licensedcode\data\rules\mit_336.yml", "YAML", 0, 0, 0, 3, 0, 0, 1, 4
"d:\IDEWORK\lvmen\src\licensedcode\data\rules\mit_337.yml", "YAML", 0, 0, 0, 5, 0, 0, 1, 6
"d:\IDEWORK\lvmen\src\licensedcode\data\rules\mit_338.yml", "YAML", 0, 0, 0, 6, 0, 0, 1, 7
"d:\IDEWORK\lvmen\src\licensedcode\data\rules\mit_339.yml", "YAML", 0, 0, 0, 5, 0, 0, 1, 6
"d:\IDEWORK\lvmen\src\licensedcode\data\rules\mit_34.yml", "YAML", 0, 0, 0, 7, 0, 0, 1, 8
"d:\IDEWORK\lvmen\src\licensedcode\data\rules\mit_340.yml", "YAML", 0, 0, 0, 3, 0, 0, 1, 4
"d:\IDEWORK\lvmen\src\licensedcode\data\rules\mit_341.yml", "YAML", 0, 0, 0, 5, 0, 0, 1, 6
"d:\IDEWORK\lvmen\src\licensedcode\data\rules\mit_342.yml", "YAML", 0, 0, 0, 7, 0, 0, 1, 8
"d:\IDEWORK\lvmen\src\licensedcode\data\rules\mit_343.yml", "YAML", 0, 0, 0, 3, 0, 0, 1, 4
"d:\IDEWORK\lvmen\src\licensedcode\data\rules\mit_344.yml", "YAML", 0, 0, 0, 3, 0, 0, 1, 4
"d:\IDEWORK\lvmen\src\licensedcode\data\rules\mit_345.yml", "YAML", 0, 0, 0, 3, 0, 0, 1, 4
"d:\IDEWORK\lvmen\src\licensedcode\data\rules\mit_346.yml", "YAML", 0, 0, 0, 4, 0, 0, 1, 5
"d:\IDEWORK\lvmen\src\licensedcode\data\rules\mit_347.yml", "YAML", 0, 0, 0, 3, 0, 0, 1, 4
"d:\IDEWORK\lvmen\src\licensedcode\data\rules\mit_348.yml", "YAML", 0, 0, 0, 5, 0, 0, 1, 6
"d:\IDEWORK\lvmen\src\licensedcode\data\rules\mit_349.yml", "YAML", 0, 0, 0, 3, 0, 0, 1, 4
"d:\IDEWORK\lvmen\src\licensedcode\data\rules\mit_35.yml", "YAML", 0, 0, 0, 4, 0, 0, 1, 5
"d:\IDEWORK\lvmen\src\licensedcode\data\rules\mit_350.yml", "YAML", 0, 0, 0, 3, 0, 0, 1, 4
"d:\IDEWORK\lvmen\src\licensedcode\data\rules\mit_351.yml", "YAML", 0, 0, 0, 5, 0, 0, 1, 6
"d:\IDEWORK\lvmen\src\licensedcode\data\rules\mit_352.yml", "YAML", 0, 0, 0, 5, 0, 0, 1, 6
"d:\IDEWORK\lvmen\src\licensedcode\data\rules\mit_353.yml", "YAML", 0, 0, 0, 5, 0, 0, 1, 6
"d:\IDEWORK\lvmen\src\licensedcode\data\rules\mit_354.yml", "YAML", 0, 0, 0, 6, 0, 0, 1, 7
"d:\IDEWORK\lvmen\src\licensedcode\data\rules\mit_355.yml", "YAML", 0, 0, 0, 5, 0, 0, 1, 6
"d:\IDEWORK\lvmen\src\licensedcode\data\rules\mit_356.yml", "YAML", 0, 0, 0, 5, 0, 0, 1, 6
"d:\IDEWORK\lvmen\src\licensedcode\data\rules\mit_357.yml", "YAML", 0, 0, 0, 5, 0, 0, 1, 6
"d:\IDEWORK\lvmen\src\licensedcode\data\rules\mit_358.yml", "YAML", 0, 0, 0, 5, 0, 0, 1, 6
"d:\IDEWORK\lvmen\src\licensedcode\data\rules\mit_359.yml", "YAML", 0, 0, 0, 5, 0, 0, 1, 6
"d:\IDEWORK\lvmen\src\licensedcode\data\rules\mit_36.yml", "YAML", 0, 0, 0, 4, 0, 0, 1, 5
"d:\IDEWORK\lvmen\src\licensedcode\data\rules\mit_360.yml", "YAML", 0, 0, 0, 3, 0, 0, 1, 4
"d:\IDEWORK\lvmen\src\licensedcode\data\rules\mit_361.yml", "YAML", 0, 0, 0, 5, 0, 0, 1, 6
"d:\IDEWORK\lvmen\src\licensedcode\data\rules\mit_362.yml", "YAML", 0, 0, 0, 5, 0, 0, 1, 6
"d:\IDEWORK\lvmen\src\licensedcode\data\rules\mit_363.yml", "YAML", 0, 0, 0, 7, 0, 0, 1, 8
"d:\IDEWORK\lvmen\src\licensedcode\data\rules\mit_364.yml", "YAML", 0, 0, 0, 3, 0, 0, 1, 4
"d:\IDEWORK\lvmen\src\licensedcode\data\rules\mit_365.yml", "YAML", 0, 0, 0, 3, 0, 0, 1, 4
"d:\IDEWORK\lvmen\src\licensedcode\data\rules\mit_366.yml", "YAML", 0, 0, 0, 3, 0, 0, 1, 4
"d:\IDEWORK\lvmen\src\licensedcode\data\rules\mit_367.yml", "YAML", 0, 0, 0, 3, 0, 0, 1, 4
"d:\IDEWORK\lvmen\src\licensedcode\data\rules\mit_368.yml", "YAML", 0, 0, 0, 3, 0, 0, 1, 4
"d:\IDEWORK\lvmen\src\licensedcode\data\rules\mit_369.yml", "YAML", 0, 0, 0, 5, 0, 0, 1, 6
"d:\IDEWORK\lvmen\src\licensedcode\data\rules\mit_37.yml", "YAML", 0, 0, 0, 4, 0, 0, 1, 5
"d:\IDEWORK\lvmen\src\licensedcode\data\rules\mit_370.yml", "YAML", 0, 0, 0, 5, 0, 0, 1, 6
"d:\IDEWORK\lvmen\src\licensedcode\data\rules\mit_371.yml", "YAML", 0, 0, 0, 5, 0, 0, 1, 6
"d:\IDEWORK\lvmen\src\licensedcode\data\rules\mit_372.yml", "YAML", 0, 0, 0, 3, 0, 0, 1, 4
"d:\IDEWORK\lvmen\src\licensedcode\data\rules\mit_373.yml", "YAML", 0, 0, 0, 5, 0, 0, 1, 6
"d:\IDEWORK\lvmen\src\licensedcode\data\rules\mit_374.yml", "YAML", 0, 0, 0, 5, 0, 0, 1, 6
"d:\IDEWORK\lvmen\src\licensedcode\data\rules\mit_375.yml", "YAML", 0, 0, 0, 5, 0, 0, 1, 6
"d:\IDEWORK\lvmen\src\licensedcode\data\rules\mit_376.yml", "YAML", 0, 0, 0, 3, 0, 0, 1, 4
"d:\IDEWORK\lvmen\src\licensedcode\data\rules\mit_377.yml", "YAML", 0, 0, 0, 3, 0, 0, 1, 4
"d:\IDEWORK\lvmen\src\licensedcode\data\rules\mit_378.yml", "YAML", 0, 0, 0, 3, 0, 0, 1, 4
"d:\IDEWORK\lvmen\src\licensedcode\data\rules\mit_379.yml", "YAML", 0, 0, 0, 3, 0, 0, 1, 4
"d:\IDEWORK\lvmen\src\licensedcode\data\rules\mit_38.yml", "YAML", 0, 0, 0, 4, 0, 0, 1, 5
"d:\IDEWORK\lvmen\src\licensedcode\data\rules\mit_380.yml", "YAML", 0, 0, 0, 3, 0, 0, 1, 4
"d:\IDEWORK\lvmen\src\licensedcode\data\rules\mit_381.yml", "YAML", 0, 0, 0, 5, 0, 0, 1, 6
"d:\IDEWORK\lvmen\src\licensedcode\data\rules\mit_382.yml", "YAML", 0, 0, 0, 3, 0, 0, 1, 4
"d:\IDEWORK\lvmen\src\licensedcode\data\rules\mit_383.yml", "YAML", 0, 0, 0, 3, 0, 0, 1, 4
"d:\IDEWORK\lvmen\src\licensedcode\data\rules\mit_384.yml", "YAML", 0, 0, 0, 3, 0, 0, 1, 4
"d:\IDEWORK\lvmen\src\licensedcode\data\rules\mit_385.yml", "YAML", 0, 0, 0, 4, 0, 0, 1, 5
"d:\IDEWORK\lvmen\src\licensedcode\data\rules\mit_386.yml", "YAML", 0, 0, 0, 5, 0, 0, 1, 6
"d:\IDEWORK\lvmen\src\licensedcode\data\rules\mit_387.yml", "YAML", 0, 0, 0, 3, 0, 0, 1, 4
"d:\IDEWORK\lvmen\src\licensedcode\data\rules\mit_388.yml", "YAML", 0, 0, 0, 3, 0, 0, 1, 4
"d:\IDEWORK\lvmen\src\licensedcode\data\rules\mit_389.yml", "YAML", 0, 0, 0, 5, 0, 0, 1, 6
"d:\IDEWORK\lvmen\src\licensedcode\data\rules\mit_39.yml", "YAML", 0, 0, 0, 4, 0, 0, 1, 5
"d:\IDEWORK\lvmen\src\licensedcode\data\rules\mit_390.yml", "YAML", 0, 0, 0, 5, 0, 0, 1, 6
"d:\IDEWORK\lvmen\src\licensedcode\data\rules\mit_391.yml", "YAML", 0, 0, 0, 3, 0, 0, 1, 4
"d:\IDEWORK\lvmen\src\licensedcode\data\rules\mit_392.yml", "YAML", 0, 0, 0, 7, 0, 0, 1, 8
"d:\IDEWORK\lvmen\src\licensedcode\data\rules\mit_393.yml", "YAML", 0, 0, 0, 7, 0, 0, 1, 8
"d:\IDEWORK\lvmen\src\licensedcode\data\rules\mit_394.yml", "YAML", 0, 0, 0, 5, 0, 0, 1, 6
"d:\IDEWORK\lvmen\src\licensedcode\data\rules\mit_395.yml", "YAML", 0, 0, 0, 3, 0, 0, 1, 4
"d:\IDEWORK\lvmen\src\licensedcode\data\rules\mit_396.yml", "YAML", 0, 0, 0, 5, 0, 0, 1, 6
"d:\IDEWORK\lvmen\src\licensedcode\data\rules\mit_397.yml", "YAML", 0, 0, 0, 7, 0, 0, 1, 8
"d:\IDEWORK\lvmen\src\licensedcode\data\rules\mit_398.yml", "YAML", 0, 0, 0, 3, 0, 0, 1, 4
"d:\IDEWORK\lvmen\src\licensedcode\data\rules\mit_399.yml", "YAML", 0, 0, 0, 5, 0, 0, 1, 6
"d:\IDEWORK\lvmen\src\licensedcode\data\rules\mit_4.yml", "YAML", 0, 0, 0, 3, 0, 0, 1, 4
"d:\IDEWORK\lvmen\src\licensedcode\data\rules\mit_40.yml", "YAML", 0, 0, 0, 4, 0, 0, 1, 5
"d:\IDEWORK\lvmen\src\licensedcode\data\rules\mit_400.yml", "YAML", 0, 0, 0, 5, 0, 0, 1, 6
"d:\IDEWORK\lvmen\src\licensedcode\data\rules\mit_401.yml", "YAML", 0, 0, 0, 5, 0, 0, 1, 6
"d:\IDEWORK\lvmen\src\licensedcode\data\rules\mit_402.yml", "YAML", 0, 0, 0, 7, 0, 0, 1, 8
"d:\IDEWORK\lvmen\src\licensedcode\data\rules\mit_403.yml", "YAML", 0, 0, 0, 5, 0, 0, 1, 6
"d:\IDEWORK\lvmen\src\licensedcode\data\rules\mit_404.yml", "YAML", 0, 0, 0, 5, 0, 0, 1, 6
"d:\IDEWORK\lvmen\src\licensedcode\data\rules\mit_405.yml", "YAML", 0, 0, 0, 7, 0, 0, 1, 8
"d:\IDEWORK\lvmen\src\licensedcode\data\rules\mit_406.yml", "YAML", 0, 0, 0, 7, 0, 0, 1, 8
"d:\IDEWORK\lvmen\src\licensedcode\data\rules\mit_407.yml", "YAML", 0, 0, 0, 5, 0, 0, 1, 6
"d:\IDEWORK\lvmen\src\licensedcode\data\rules\mit_408.yml", "YAML", 0, 0, 0, 5, 0, 0, 1, 6
"d:\IDEWORK\lvmen\src\licensedcode\data\rules\mit_409.yml", "YAML", 0, 0, 0, 5, 0, 0, 1, 6
"d:\IDEWORK\lvmen\src\licensedcode\data\rules\mit_41.yml", "YAML", 0, 0, 0, 5, 0, 0, 1, 6
"d:\IDEWORK\lvmen\src\licensedcode\data\rules\mit_410.yml", "YAML", 0, 0, 0, 5, 0, 0, 1, 6
"d:\IDEWORK\lvmen\src\licensedcode\data\rules\mit_411.yml", "YAML", 0, 0, 0, 3, 0, 0, 1, 4
"d:\IDEWORK\lvmen\src\licensedcode\data\rules\mit_412.yml", "YAML", 0, 0, 0, 5, 0, 0, 1, 6
"d:\IDEWORK\lvmen\src\licensedcode\data\rules\mit_413.yml", "YAML", 0, 0, 0, 3, 0, 0, 1, 4
"d:\IDEWORK\lvmen\src\licensedcode\data\rules\mit_414.yml", "YAML", 0, 0, 0, 3, 0, 0, 1, 4
"d:\IDEWORK\lvmen\src\licensedcode\data\rules\mit_415.yml", "YAML", 0, 0, 0, 3, 0, 0, 1, 4
"d:\IDEWORK\lvmen\src\licensedcode\data\rules\mit_416.yml", "YAML", 0, 0, 0, 3, 0, 0, 1, 4
"d:\IDEWORK\lvmen\src\licensedcode\data\rules\mit_417.yml", "YAML", 0, 0, 0, 3, 0, 0, 1, 4
"d:\IDEWORK\lvmen\src\licensedcode\data\rules\mit_418.yml", "YAML", 0, 0, 0, 3, 0, 0, 1, 4
"d:\IDEWORK\lvmen\src\licensedcode\data\rules\mit_419.yml", "YAML", 0, 0, 0, 3, 0, 0, 1, 4
"d:\IDEWORK\lvmen\src\licensedcode\data\rules\mit_42.yml", "YAML", 0, 0, 0, 3, 0, 0, 1, 4
"d:\IDEWORK\lvmen\src\licensedcode\data\rules\mit_420.yml", "YAML", 0, 0, 0, 3, 0, 0, 1, 4
"d:\IDEWORK\lvmen\src\licensedcode\data\rules\mit_421.yml", "YAML", 0, 0, 0, 3, 0, 0, 1, 4
"d:\IDEWORK\lvmen\src\licensedcode\data\rules\mit_422.yml", "YAML", 0, 0, 0, 3, 0, 0, 1, 4
"d:\IDEWORK\lvmen\src\licensedcode\data\rules\mit_423.yml", "YAML", 0, 0, 0, 3, 0, 0, 1, 4
"d:\IDEWORK\lvmen\src\licensedcode\data\rules\mit_424.yml", "YAML", 0, 0, 0, 3, 0, 0, 1, 4
"d:\IDEWORK\lvmen\src\licensedcode\data\rules\mit_425.yml", "YAML", 0, 0, 0, 3, 0, 0, 1, 4
"d:\IDEWORK\lvmen\src\licensedcode\data\rules\mit_426.yml", "YAML", 0, 0, 0, 3, 0, 0, 1, 4
"d:\IDEWORK\lvmen\src\licensedcode\data\rules\mit_427.yml", "YAML", 0, 0, 0, 3, 0, 0, 1, 4
"d:\IDEWORK\lvmen\src\licensedcode\data\rules\mit_428.yml", "YAML", 0, 0, 0, 5, 0, 0, 1, 6
"d:\IDEWORK\lvmen\src\licensedcode\data\rules\mit_429.yml", "YAML", 0, 0, 0, 5, 0, 0, 1, 6
"d:\IDEWORK\lvmen\src\licensedcode\data\rules\mit_43.yml", "YAML", 0, 0, 0, 3, 0, 0, 1, 4
"d:\IDEWORK\lvmen\src\licensedcode\data\rules\mit_430.yml", "YAML", 0, 0, 0, 3, 0, 0, 1, 4
"d:\IDEWORK\lvmen\src\licensedcode\data\rules\mit_431.yml", "YAML", 0, 0, 0, 5, 0, 0, 1, 6
"d:\IDEWORK\lvmen\src\licensedcode\data\rules\mit_432.yml", "YAML", 0, 0, 0, 5, 0, 0, 1, 6
"d:\IDEWORK\lvmen\src\licensedcode\data\rules\mit_433.yml", "YAML", 0, 0, 0, 5, 0, 0, 1, 6
"d:\IDEWORK\lvmen\src\licensedcode\data\rules\mit_434.yml", "YAML", 0, 0, 0, 5, 0, 0, 1, 6
"d:\IDEWORK\lvmen\src\licensedcode\data\rules\mit_435.yml", "YAML", 0, 0, 0, 5, 0, 0, 1, 6
"d:\IDEWORK\lvmen\src\licensedcode\data\rules\mit_436.yml", "YAML", 0, 0, 0, 5, 0, 0, 1, 6
"d:\IDEWORK\lvmen\src\licensedcode\data\rules\mit_437.yml", "YAML", 0, 0, 0, 3, 0, 0, 1, 4
"d:\IDEWORK\lvmen\src\licensedcode\data\rules\mit_438.yml", "YAML", 0, 0, 0, 5, 0, 0, 1, 6
"d:\IDEWORK\lvmen\src\licensedcode\data\rules\mit_439.yml", "YAML", 0, 0, 0, 5, 0, 0, 1, 6
"d:\IDEWORK\lvmen\src\licensedcode\data\rules\mit_44.yml", "YAML", 0, 0, 0, 5, 0, 0, 1, 6
"d:\IDEWORK\lvmen\src\licensedcode\data\rules\mit_440.yml", "YAML", 0, 0, 0, 5, 0, 0, 1, 6
"d:\IDEWORK\lvmen\src\licensedcode\data\rules\mit_441.yml", "YAML", 0, 0, 0, 5, 0, 0, 1, 6
"d:\IDEWORK\lvmen\src\licensedcode\data\rules\mit_442.yml", "YAML", 0, 0, 0, 5, 0, 0, 1, 6
"d:\IDEWORK\lvmen\src\licensedcode\data\rules\mit_443.yml", "YAML", 0, 0, 0, 5, 0, 0, 1, 6
"d:\IDEWORK\lvmen\src\licensedcode\data\rules\mit_444.yml", "YAML", 0, 0, 0, 5, 0, 0, 1, 6
"d:\IDEWORK\lvmen\src\licensedcode\data\rules\mit_445.yml", "YAML", 0, 0, 0, 5, 0, 0, 1, 6
"d:\IDEWORK\lvmen\src\licensedcode\data\rules\mit_446.yml", "YAML", 0, 0, 0, 5, 0, 0, 1, 6
"d:\IDEWORK\lvmen\src\licensedcode\data\rules\mit_447.yml", "YAML", 0, 0, 0, 5, 0, 0, 1, 6
"d:\IDEWORK\lvmen\src\licensedcode\data\rules\mit_448.yml", "YAML", 0, 0, 0, 5, 0, 0, 1, 6
"d:\IDEWORK\lvmen\src\licensedcode\data\rules\mit_449.yml", "YAML", 0, 0, 0, 5, 0, 0, 1, 6
"d:\IDEWORK\lvmen\src\licensedcode\data\rules\mit_45.yml", "YAML", 0, 0, 0, 5, 0, 0, 1, 6
"d:\IDEWORK\lvmen\src\licensedcode\data\rules\mit_450.yml", "YAML", 0, 0, 0, 5, 0, 0, 1, 6
"d:\IDEWORK\lvmen\src\licensedcode\data\rules\mit_451.yml", "YAML", 0, 0, 0, 5, 0, 0, 1, 6
"d:\IDEWORK\lvmen\src\licensedcode\data\rules\mit_452.yml", "YAML", 0, 0, 0, 5, 0, 0, 1, 6
"d:\IDEWORK\lvmen\src\licensedcode\data\rules\mit_453.yml", "YAML", 0, 0, 0, 5, 0, 0, 1, 6
"d:\IDEWORK\lvmen\src\licensedcode\data\rules\mit_454.yml", "YAML", 0, 0, 0, 5, 0, 0, 1, 6
"d:\IDEWORK\lvmen\src\licensedcode\data\rules\mit_455.yml", "YAML", 0, 0, 0, 5, 0, 0, 1, 6
"d:\IDEWORK\lvmen\src\licensedcode\data\rules\mit_456.yml", "YAML", 0, 0, 0, 5, 0, 0, 1, 6
"d:\IDEWORK\lvmen\src\licensedcode\data\rules\mit_457.yml", "YAML", 0, 0, 0, 5, 0, 0, 1, 6
"d:\IDEWORK\lvmen\src\licensedcode\data\rules\mit_458.yml", "YAML", 0, 0, 0, 5, 0, 0, 1, 6
"d:\IDEWORK\lvmen\src\licensedcode\data\rules\mit_459.yml", "YAML", 0, 0, 0, 5, 0, 0, 1, 6
"d:\IDEWORK\lvmen\src\licensedcode\data\rules\mit_46.yml", "YAML", 0, 0, 0, 5, 0, 0, 1, 6
"d:\IDEWORK\lvmen\src\licensedcode\data\rules\mit_460.yml", "YAML", 0, 0, 0, 5, 0, 0, 1, 6
"d:\IDEWORK\lvmen\src\licensedcode\data\rules\mit_461.yml", "YAML", 0, 0, 0, 5, 0, 0, 1, 6
"d:\IDEWORK\lvmen\src\licensedcode\data\rules\mit_462.yml", "YAML", 0, 0, 0, 5, 0, 0, 1, 6
"d:\IDEWORK\lvmen\src\licensedcode\data\rules\mit_463.yml", "YAML", 0, 0, 0, 5, 0, 0, 1, 6
"d:\IDEWORK\lvmen\src\licensedcode\data\rules\mit_464.yml", "YAML", 0, 0, 0, 6, 0, 0, 1, 7
"d:\IDEWORK\lvmen\src\licensedcode\data\rules\mit_465.yml", "YAML", 0, 0, 0, 3, 0, 0, 1, 4
"d:\IDEWORK\lvmen\src\licensedcode\data\rules\mit_466.yml", "YAML", 0, 0, 0, 6, 0, 0, 1, 7
"d:\IDEWORK\lvmen\src\licensedcode\data\rules\mit_467.yml", "YAML", 0, 0, 0, 6, 0, 0, 1, 7
"d:\IDEWORK\lvmen\src\licensedcode\data\rules\mit_468.yml", "YAML", 0, 0, 0, 3, 0, 0, 1, 4
"d:\IDEWORK\lvmen\src\licensedcode\data\rules\mit_469.yml", "YAML", 0, 0, 0, 5, 0, 0, 1, 6
"d:\IDEWORK\lvmen\src\licensedcode\data\rules\mit_47.yml", "YAML", 0, 0, 0, 4, 0, 0, 1, 5
"d:\IDEWORK\lvmen\src\licensedcode\data\rules\mit_470.yml", "YAML", 0, 0, 0, 5, 0, 0, 1, 6
"d:\IDEWORK\lvmen\src\licensedcode\data\rules\mit_471.yml", "YAML", 0, 0, 0, 5, 0, 0, 1, 6
"d:\IDEWORK\lvmen\src\licensedcode\data\rules\mit_472.yml", "YAML", 0, 0, 0, 5, 0, 0, 1, 6
"d:\IDEWORK\lvmen\src\licensedcode\data\rules\mit_473.yml", "YAML", 0, 0, 0, 5, 0, 0, 1, 6
"d:\IDEWORK\lvmen\src\licensedcode\data\rules\mit_474.yml", "YAML", 0, 0, 0, 5, 0, 0, 1, 6
"d:\IDEWORK\lvmen\src\licensedcode\data\rules\mit_475.yml", "YAML", 0, 0, 0, 5, 0, 0, 1, 6
"d:\IDEWORK\lvmen\src\licensedcode\data\rules\mit_476.yml", "YAML", 0, 0, 0, 3, 0, 0, 1, 4
"d:\IDEWORK\lvmen\src\licensedcode\data\rules\mit_477.yml", "YAML", 0, 0, 0, 5, 0, 0, 1, 6
"d:\IDEWORK\lvmen\src\licensedcode\data\rules\mit_478.yml", "YAML", 0, 0, 0, 5, 0, 0, 1, 6
"d:\IDEWORK\lvmen\src\licensedcode\data\rules\mit_479.yml", "YAML", 0, 0, 0, 5, 0, 0, 1, 6
"d:\IDEWORK\lvmen\src\licensedcode\data\rules\mit_48.yml", "YAML", 0, 0, 0, 3, 0, 0, 1, 4
"d:\IDEWORK\lvmen\src\licensedcode\data\rules\mit_480.yml", "YAML", 0, 0, 0, 5, 0, 0, 1, 6
"d:\IDEWORK\lvmen\src\licensedcode\data\rules\mit_481.yml", "YAML", 0, 0, 0, 3, 0, 0, 1, 4
"d:\IDEWORK\lvmen\src\licensedcode\data\rules\mit_482.yml", "YAML", 0, 0, 0, 3, 0, 0, 1, 4
"d:\IDEWORK\lvmen\src\licensedcode\data\rules\mit_483.yml", "YAML", 0, 0, 0, 4, 0, 0, 1, 5
"d:\IDEWORK\lvmen\src\licensedcode\data\rules\mit_484.yml", "YAML", 0, 0, 0, 3, 0, 0, 1, 4
"d:\IDEWORK\lvmen\src\licensedcode\data\rules\mit_485.yml", "YAML", 0, 0, 0, 7, 0, 0, 1, 8
"d:\IDEWORK\lvmen\src\licensedcode\data\rules\mit_486.yml", "YAML", 0, 0, 0, 5, 0, 0, 1, 6
"d:\IDEWORK\lvmen\src\licensedcode\data\rules\mit_487.yml", "YAML", 0, 0, 0, 6, 0, 0, 1, 7
"d:\IDEWORK\lvmen\src\licensedcode\data\rules\mit_488.yml", "YAML", 0, 0, 0, 5, 0, 0, 1, 6
"d:\IDEWORK\lvmen\src\licensedcode\data\rules\mit_489.yml", "YAML", 0, 0, 0, 5, 0, 0, 1, 6
"d:\IDEWORK\lvmen\src\licensedcode\data\rules\mit_49.yml", "YAML", 0, 0, 0, 5, 0, 0, 1, 6
"d:\IDEWORK\lvmen\src\licensedcode\data\rules\mit_490.yml", "YAML", 0, 0, 0, 5, 0, 0, 1, 6
"d:\IDEWORK\lvmen\src\licensedcode\data\rules\mit_491.yml", "YAML", 0, 0, 0, 3, 0, 0, 1, 4
"d:\IDEWORK\lvmen\src\licensedcode\data\rules\mit_492.yml", "YAML", 0, 0, 0, 3, 0, 0, 1, 4
"d:\IDEWORK\lvmen\src\licensedcode\data\rules\mit_493.yml", "YAML", 0, 0, 0, 3, 0, 0, 1, 4
"d:\IDEWORK\lvmen\src\licensedcode\data\rules\mit_494.yml", "YAML", 0, 0, 0, 5, 0, 0, 1, 6
"d:\IDEWORK\lvmen\src\licensedcode\data\rules\mit_495.yml", "YAML", 0, 0, 0, 3, 0, 0, 1, 4
"d:\IDEWORK\lvmen\src\licensedcode\data\rules\mit_496.yml", "YAML", 0, 0, 0, 5, 0, 0, 1, 6
"d:\IDEWORK\lvmen\src\licensedcode\data\rules\mit_497.yml", "YAML", 0, 0, 0, 3, 0, 0, 1, 4
"d:\IDEWORK\lvmen\src\licensedcode\data\rules\mit_498.yml", "YAML", 0, 0, 0, 3, 0, 0, 1, 4
"d:\IDEWORK\lvmen\src\licensedcode\data\rules\mit_499.yml", "YAML", 0, 0, 0, 3, 0, 0, 1, 4
"d:\IDEWORK\lvmen\src\licensedcode\data\rules\mit_5.yml", "YAML", 0, 0, 0, 4, 0, 0, 1, 5
"d:\IDEWORK\lvmen\src\licensedcode\data\rules\mit_50.yml", "YAML", 0, 0, 0, 5, 0, 0, 1, 6
"d:\IDEWORK\lvmen\src\licensedcode\data\rules\mit_500.yml", "YAML", 0, 0, 0, 3, 0, 0, 1, 4
"d:\IDEWORK\lvmen\src\licensedcode\data\rules\mit_501.yml", "YAML", 0, 0, 0, 3, 0, 0, 1, 4
"d:\IDEWORK\lvmen\src\licensedcode\data\rules\mit_502.yml", "YAML", 0, 0, 0, 3, 0, 0, 1, 4
"d:\IDEWORK\lvmen\src\licensedcode\data\rules\mit_503.yml", "YAML", 0, 0, 0, 3, 0, 0, 1, 4
"d:\IDEWORK\lvmen\src\licensedcode\data\rules\mit_504.yml", "YAML", 0, 0, 0, 4, 0, 0, 1, 5
"d:\IDEWORK\lvmen\src\licensedcode\data\rules\mit_505.yml", "YAML", 0, 0, 0, 3, 0, 0, 1, 4
"d:\IDEWORK\lvmen\src\licensedcode\data\rules\mit_506.yml", "YAML", 0, 0, 0, 3, 0, 0, 1, 4
"d:\IDEWORK\lvmen\src\licensedcode\data\rules\mit_507.yml", "YAML", 0, 0, 0, 3, 0, 0, 1, 4
"d:\IDEWORK\lvmen\src\licensedcode\data\rules\mit_508.yml", "YAML", 0, 0, 0, 3, 0, 0, 1, 4
"d:\IDEWORK\lvmen\src\licensedcode\data\rules\mit_509.yml", "YAML", 0, 0, 0, 3, 0, 0, 1, 4
"d:\IDEWORK\lvmen\src\licensedcode\data\rules\mit_51.yml", "YAML", 0, 0, 0, 5, 0, 0, 1, 6
"d:\IDEWORK\lvmen\src\licensedcode\data\rules\mit_510.yml", "YAML", 0, 0, 0, 3, 0, 0, 1, 4
"d:\IDEWORK\lvmen\src\licensedcode\data\rules\mit_511.yml", "YAML", 0, 0, 0, 3, 0, 0, 1, 4
"d:\IDEWORK\lvmen\src\licensedcode\data\rules\mit_512.yml", "YAML", 0, 0, 0, 3, 0, 0, 1, 4
"d:\IDEWORK\lvmen\src\licensedcode\data\rules\mit_513.yml", "YAML", 0, 0, 0, 3, 0, 0, 1, 4
"d:\IDEWORK\lvmen\src\licensedcode\data\rules\mit_514.yml", "YAML", 0, 0, 0, 3, 0, 0, 1, 4
"d:\IDEWORK\lvmen\src\licensedcode\data\rules\mit_515.yml", "YAML", 0, 0, 0, 3, 0, 0, 1, 4
"d:\IDEWORK\lvmen\src\licensedcode\data\rules\mit_516.yml", "YAML", 0, 0, 0, 3, 0, 0, 1, 4
"d:\IDEWORK\lvmen\src\licensedcode\data\rules\mit_517.yml", "YAML", 0, 0, 0, 3, 0, 0, 1, 4
"d:\IDEWORK\lvmen\src\licensedcode\data\rules\mit_518.yml", "YAML", 0, 0, 0, 8, 0, 0, 1, 9
"d:\IDEWORK\lvmen\src\licensedcode\data\rules\mit_519.yml", "YAML", 0, 0, 0, 3, 0, 0, 1, 4
"d:\IDEWORK\lvmen\src\licensedcode\data\rules\mit_52.yml", "YAML", 0, 0, 0, 3, 0, 0, 1, 4
"d:\IDEWORK\lvmen\src\licensedcode\data\rules\mit_520.yml", "YAML", 0, 0, 0, 5, 0, 0, 1, 6
"d:\IDEWORK\lvmen\src\licensedcode\data\rules\mit_521.yml", "YAML", 0, 0, 0, 5, 0, 0, 1, 6
"d:\IDEWORK\lvmen\src\licensedcode\data\rules\mit_522.yml", "YAML", 0, 0, 0, 3, 0, 0, 1, 4
"d:\IDEWORK\lvmen\src\licensedcode\data\rules\mit_523.yml", "YAML", 0, 0, 0, 3, 0, 0, 1, 4
"d:\IDEWORK\lvmen\src\licensedcode\data\rules\mit_524.yml", "YAML", 0, 0, 0, 3, 0, 0, 1, 4
"d:\IDEWORK\lvmen\src\licensedcode\data\rules\mit_525.yml", "YAML", 0, 0, 0, 3, 0, 0, 1, 4
"d:\IDEWORK\lvmen\src\licensedcode\data\rules\mit_526.yml", "YAML", 0, 0, 0, 5, 0, 0, 1, 6
"d:\IDEWORK\lvmen\src\licensedcode\data\rules\mit_527.yml", "YAML", 0, 0, 0, 3, 0, 0, 1, 4
"d:\IDEWORK\lvmen\src\licensedcode\data\rules\mit_528.yml", "YAML", 0, 0, 0, 3, 0, 0, 1, 4
"d:\IDEWORK\lvmen\src\licensedcode\data\rules\mit_529.yml", "YAML", 0, 0, 0, 3, 0, 0, 1, 4
"d:\IDEWORK\lvmen\src\licensedcode\data\rules\mit_53.yml", "YAML", 0, 0, 0, 3, 0, 0, 1, 4
"d:\IDEWORK\lvmen\src\licensedcode\data\rules\mit_530.yml", "YAML", 0, 0, 0, 3, 0, 0, 1, 4
"d:\IDEWORK\lvmen\src\licensedcode\data\rules\mit_531.yml", "YAML", 0, 0, 0, 3, 0, 0, 1, 4
"d:\IDEWORK\lvmen\src\licensedcode\data\rules\mit_532.yml", "YAML", 0, 0, 0, 3, 0, 0, 1, 4
"d:\IDEWORK\lvmen\src\licensedcode\data\rules\mit_533.yml", "YAML", 0, 0, 0, 3, 0, 0, 1, 4
"d:\IDEWORK\lvmen\src\licensedcode\data\rules\mit_534.yml", "YAML", 0, 0, 0, 3, 0, 0, 1, 4
"d:\IDEWORK\lvmen\src\licensedcode\data\rules\mit_535.yml", "YAML", 0, 0, 0, 3, 0, 0, 1, 4
"d:\IDEWORK\lvmen\src\licensedcode\data\rules\mit_536.yml", "YAML", 0, 0, 0, 3, 0, 0, 1, 4
"d:\IDEWORK\lvmen\src\licensedcode\data\rules\mit_537.yml", "YAML", 0, 0, 0, 3, 0, 0, 1, 4
"d:\IDEWORK\lvmen\src\licensedcode\data\rules\mit_538.yml", "YAML", 0, 0, 0, 3, 0, 0, 1, 4
"d:\IDEWORK\lvmen\src\licensedcode\data\rules\mit_539.yml", "YAML", 0, 0, 0, 3, 0, 0, 1, 4
"d:\IDEWORK\lvmen\src\licensedcode\data\rules\mit_54.yml", "YAML", 0, 0, 0, 3, 0, 0, 1, 4
"d:\IDEWORK\lvmen\src\licensedcode\data\rules\mit_540.yml", "YAML", 0, 0, 0, 3, 0, 0, 1, 4
"d:\IDEWORK\lvmen\src\licensedcode\data\rules\mit_541.yml", "YAML", 0, 0, 0, 3, 0, 0, 1, 4
"d:\IDEWORK\lvmen\src\licensedcode\data\rules\mit_542.yml", "YAML", 0, 0, 0, 3, 0, 0, 1, 4
"d:\IDEWORK\lvmen\src\licensedcode\data\rules\mit_543.yml", "YAML", 0, 0, 0, 3, 0, 0, 1, 4
"d:\IDEWORK\lvmen\src\licensedcode\data\rules\mit_544.yml", "YAML", 0, 0, 0, 3, 0, 0, 1, 4
"d:\IDEWORK\lvmen\src\licensedcode\data\rules\mit_545.yml", "YAML", 0, 0, 0, 3, 0, 0, 1, 4
"d:\IDEWORK\lvmen\src\licensedcode\data\rules\mit_546.yml", "YAML", 0, 0, 0, 3, 0, 0, 1, 4
"d:\IDEWORK\lvmen\src\licensedcode\data\rules\mit_547.yml", "YAML", 0, 0, 0, 3, 0, 0, 1, 4
"d:\IDEWORK\lvmen\src\licensedcode\data\rules\mit_548.yml", "YAML", 0, 0, 0, 3, 0, 0, 1, 4
"d:\IDEWORK\lvmen\src\licensedcode\data\rules\mit_549.yml", "YAML", 0, 0, 0, 3, 0, 0, 1, 4
"d:\IDEWORK\lvmen\src\licensedcode\data\rules\mit_55.yml", "YAML", 0, 0, 0, 6, 0, 0, 1, 7
"d:\IDEWORK\lvmen\src\licensedcode\data\rules\mit_550.yml", "YAML", 0, 0, 0, 3, 0, 0, 1, 4
"d:\IDEWORK\lvmen\src\licensedcode\data\rules\mit_551.yml", "YAML", 0, 0, 0, 5, 0, 0, 1, 6
"d:\IDEWORK\lvmen\src\licensedcode\data\rules\mit_552.yml", "YAML", 0, 0, 0, 3, 0, 0, 1, 4
"d:\IDEWORK\lvmen\src\licensedcode\data\rules\mit_553.yml", "YAML", 0, 0, 0, 3, 0, 0, 1, 4
"d:\IDEWORK\lvmen\src\licensedcode\data\rules\mit_554.yml", "YAML", 0, 0, 0, 3, 0, 0, 1, 4
"d:\IDEWORK\lvmen\src\licensedcode\data\rules\mit_555.yml", "YAML", 0, 0, 0, 3, 0, 0, 1, 4
"d:\IDEWORK\lvmen\src\licensedcode\data\rules\mit_556.yml", "YAML", 0, 0, 0, 5, 0, 0, 1, 6
"d:\IDEWORK\lvmen\src\licensedcode\data\rules\mit_557.yml", "YAML", 0, 0, 0, 3, 0, 0, 1, 4
"d:\IDEWORK\lvmen\src\licensedcode\data\rules\mit_558.yml", "YAML", 0, 0, 0, 3, 0, 0, 1, 4
"d:\IDEWORK\lvmen\src\licensedcode\data\rules\mit_559.yml", "YAML", 0, 0, 0, 3, 0, 0, 1, 4
"d:\IDEWORK\lvmen\src\licensedcode\data\rules\mit_56.yml", "YAML", 0, 0, 0, 5, 0, 0, 1, 6
"d:\IDEWORK\lvmen\src\licensedcode\data\rules\mit_560.yml", "YAML", 0, 0, 0, 3, 0, 0, 1, 4
"d:\IDEWORK\lvmen\src\licensedcode\data\rules\mit_561.yml", "YAML", 0, 0, 0, 3, 0, 0, 1, 4
"d:\IDEWORK\lvmen\src\licensedcode\data\rules\mit_562.yml", "YAML", 0, 0, 0, 3, 0, 0, 1, 4
"d:\IDEWORK\lvmen\src\licensedcode\data\rules\mit_563.yml", "YAML", 0, 0, 0, 3, 0, 0, 1, 4
"d:\IDEWORK\lvmen\src\licensedcode\data\rules\mit_564.yml", "YAML", 0, 0, 0, 3, 0, 0, 1, 4
"d:\IDEWORK\lvmen\src\licensedcode\data\rules\mit_565.yml", "YAML", 0, 0, 0, 3, 0, 0, 1, 4
"d:\IDEWORK\lvmen\src\licensedcode\data\rules\mit_566.yml", "YAML", 0, 0, 0, 5, 0, 0, 1, 6
"d:\IDEWORK\lvmen\src\licensedcode\data\rules\mit_567.yml", "YAML", 0, 0, 0, 5, 0, 0, 1, 6
"d:\IDEWORK\lvmen\src\licensedcode\data\rules\mit_568.yml", "YAML", 0, 0, 0, 4, 0, 0, 1, 5
"d:\IDEWORK\lvmen\src\licensedcode\data\rules\mit_569.yml", "YAML", 0, 0, 0, 3, 0, 0, 1, 4
"d:\IDEWORK\lvmen\src\licensedcode\data\rules\mit_57.yml", "YAML", 0, 0, 0, 2, 0, 0, 1, 3
"d:\IDEWORK\lvmen\src\licensedcode\data\rules\mit_570.yml", "YAML", 0, 0, 0, 6, 0, 0, 1, 7
"d:\IDEWORK\lvmen\src\licensedcode\data\rules\mit_571.yml", "YAML", 0, 0, 0, 5, 0, 0, 1, 6
"d:\IDEWORK\lvmen\src\licensedcode\data\rules\mit_572.yml", "YAML", 0, 0, 0, 6, 0, 0, 1, 7
"d:\IDEWORK\lvmen\src\licensedcode\data\rules\mit_573.yml", "YAML", 0, 0, 0, 3, 0, 0, 1, 4
"d:\IDEWORK\lvmen\src\licensedcode\data\rules\mit_574.yml", "YAML", 0, 0, 0, 5, 0, 0, 1, 6
"d:\IDEWORK\lvmen\src\licensedcode\data\rules\mit_575.yml", "YAML", 0, 0, 0, 5, 0, 0, 1, 6
"d:\IDEWORK\lvmen\src\licensedcode\data\rules\mit_576.yml", "YAML", 0, 0, 0, 3, 0, 0, 1, 4
"d:\IDEWORK\lvmen\src\licensedcode\data\rules\mit_577.yml", "YAML", 0, 0, 0, 3, 0, 0, 1, 4
"d:\IDEWORK\lvmen\src\licensedcode\data\rules\mit_578.yml", "YAML", 0, 0, 0, 3, 0, 0, 1, 4
"d:\IDEWORK\lvmen\src\licensedcode\data\rules\mit_579.yml", "YAML", 0, 0, 0, 5, 0, 0, 1, 6
"d:\IDEWORK\lvmen\src\licensedcode\data\rules\mit_58.yml", "YAML", 0, 0, 0, 7, 0, 0, 1, 8
"d:\IDEWORK\lvmen\src\licensedcode\data\rules\mit_580.yml", "YAML", 0, 0, 0, 3, 0, 0, 1, 4
"d:\IDEWORK\lvmen\src\licensedcode\data\rules\mit_581.yml", "YAML", 0, 0, 0, 3, 0, 0, 1, 4
"d:\IDEWORK\lvmen\src\licensedcode\data\rules\mit_582.yml", "YAML", 0, 0, 0, 3, 0, 0, 1, 4
"d:\IDEWORK\lvmen\src\licensedcode\data\rules\mit_583.yml", "YAML", 0, 0, 0, 3, 0, 0, 1, 4
"d:\IDEWORK\lvmen\src\licensedcode\data\rules\mit_584.yml", "YAML", 0, 0, 0, 3, 0, 0, 1, 4
"d:\IDEWORK\lvmen\src\licensedcode\data\rules\mit_585.yml", "YAML", 0, 0, 0, 3, 0, 0, 1, 4
"d:\IDEWORK\lvmen\src\licensedcode\data\rules\mit_586.yml", "YAML", 0, 0, 0, 4, 0, 0, 1, 5
"d:\IDEWORK\lvmen\src\licensedcode\data\rules\mit_587.yml", "YAML", 0, 0, 0, 3, 0, 0, 1, 4
"d:\IDEWORK\lvmen\src\licensedcode\data\rules\mit_588.yml", "YAML", 0, 0, 0, 5, 0, 0, 1, 6
"d:\IDEWORK\lvmen\src\licensedcode\data\rules\mit_589.yml", "YAML", 0, 0, 0, 4, 0, 0, 1, 5
"d:\IDEWORK\lvmen\src\licensedcode\data\rules\mit_59.yml", "YAML", 0, 0, 0, 2, 0, 0, 1, 3
"d:\IDEWORK\lvmen\src\licensedcode\data\rules\mit_590.yml", "YAML", 0, 0, 0, 4, 0, 0, 1, 5
"d:\IDEWORK\lvmen\src\licensedcode\data\rules\mit_591.yml", "YAML", 0, 0, 0, 5, 0, 0, 1, 6
"d:\IDEWORK\lvmen\src\licensedcode\data\rules\mit_592.yml", "YAML", 0, 0, 0, 5, 0, 0, 1, 6
"d:\IDEWORK\lvmen\src\licensedcode\data\rules\mit_593.yml", "YAML", 0, 0, 0, 3, 0, 0, 1, 4
"d:\IDEWORK\lvmen\src\licensedcode\data\rules\mit_594.yml", "YAML", 0, 0, 0, 3, 0, 0, 1, 4
"d:\IDEWORK\lvmen\src\licensedcode\data\rules\mit_595.yml", "YAML", 0, 0, 0, 6, 0, 0, 1, 7
"d:\IDEWORK\lvmen\src\licensedcode\data\rules\mit_596.yml", "YAML", 0, 0, 0, 3, 0, 0, 1, 4
"d:\IDEWORK\lvmen\src\licensedcode\data\rules\mit_597.yml", "YAML", 0, 0, 0, 3, 0, 0, 1, 4
"d:\IDEWORK\lvmen\src\licensedcode\data\rules\mit_598.yml", "YAML", 0, 0, 0, 5, 0, 0, 1, 6
"d:\IDEWORK\lvmen\src\licensedcode\data\rules\mit_599.yml", "YAML", 0, 0, 0, 3, 0, 0, 1, 4
"d:\IDEWORK\lvmen\src\licensedcode\data\rules\mit_6.yml", "YAML", 0, 0, 0, 3, 0, 0, 1, 4
"d:\IDEWORK\lvmen\src\licensedcode\data\rules\mit_60.yml", "YAML", 0, 0, 0, 5, 0, 0, 1, 6
"d:\IDEWORK\lvmen\src\licensedcode\data\rules\mit_600.yml", "YAML", 0, 0, 0, 5, 0, 0, 1, 6
"d:\IDEWORK\lvmen\src\licensedcode\data\rules\mit_601.yml", "YAML", 0, 0, 0, 5, 0, 0, 1, 6
"d:\IDEWORK\lvmen\src\licensedcode\data\rules\mit_602.yml", "YAML", 0, 0, 0, 3, 0, 0, 1, 4
"d:\IDEWORK\lvmen\src\licensedcode\data\rules\mit_603.yml", "YAML", 0, 0, 0, 4, 0, 0, 1, 5
"d:\IDEWORK\lvmen\src\licensedcode\data\rules\mit_604.yml", "YAML", 0, 0, 0, 4, 0, 0, 1, 5
"d:\IDEWORK\lvmen\src\licensedcode\data\rules\mit_605.yml", "YAML", 0, 0, 0, 4, 0, 0, 1, 5
"d:\IDEWORK\lvmen\src\licensedcode\data\rules\mit_606.yml", "YAML", 0, 0, 0, 4, 0, 0, 1, 5
"d:\IDEWORK\lvmen\src\licensedcode\data\rules\mit_607.yml", "YAML", 0, 0, 0, 4, 0, 0, 1, 5
"d:\IDEWORK\lvmen\src\licensedcode\data\rules\mit_608.yml", "YAML", 0, 0, 0, 4, 0, 0, 1, 5
"d:\IDEWORK\lvmen\src\licensedcode\data\rules\mit_609.yml", "YAML", 0, 0, 0, 6, 0, 0, 1, 7
"d:\IDEWORK\lvmen\src\licensedcode\data\rules\mit_61.yml", "YAML", 0, 0, 0, 3, 0, 0, 1, 4
"d:\IDEWORK\lvmen\src\licensedcode\data\rules\mit_610.yml", "YAML", 0, 0, 0, 6, 0, 0, 1, 7
"d:\IDEWORK\lvmen\src\licensedcode\data\rules\mit_611.yml", "YAML", 0, 0, 0, 6, 0, 0, 1, 7
"d:\IDEWORK\lvmen\src\licensedcode\data\rules\mit_612.yml", "YAML", 0, 0, 0, 6, 0, 0, 1, 7
"d:\IDEWORK\lvmen\src\licensedcode\data\rules\mit_613.yml", "YAML", 0, 0, 0, 6, 0, 0, 1, 7
"d:\IDEWORK\lvmen\src\licensedcode\data\rules\mit_614.yml", "YAML", 0, 0, 0, 6, 0, 0, 1, 7
"d:\IDEWORK\lvmen\src\licensedcode\data\rules\mit_615.yml", "YAML", 0, 0, 0, 7, 0, 0, 1, 8
"d:\IDEWORK\lvmen\src\licensedcode\data\rules\mit_616.yml", "YAML", 0, 0, 0, 6, 0, 0, 1, 7
"d:\IDEWORK\lvmen\src\licensedcode\data\rules\mit_617.yml", "YAML", 0, 0, 0, 7, 0, 0, 1, 8
"d:\IDEWORK\lvmen\src\licensedcode\data\rules\mit_618.yml", "YAML", 0, 0, 0, 7, 0, 0, 1, 8
"d:\IDEWORK\lvmen\src\licensedcode\data\rules\mit_619.yml", "YAML", 0, 0, 0, 6, 0, 0, 1, 7
"d:\IDEWORK\lvmen\src\licensedcode\data\rules\mit_62.yml", "YAML", 0, 0, 0, 6, 0, 0, 1, 7
"d:\IDEWORK\lvmen\src\licensedcode\data\rules\mit_620.yml", "YAML", 0, 0, 0, 6, 0, 0, 1, 7
"d:\IDEWORK\lvmen\src\licensedcode\data\rules\mit_621.yml", "YAML", 0, 0, 0, 6, 0, 0, 1, 7
"d:\IDEWORK\lvmen\src\licensedcode\data\rules\mit_622.yml", "YAML", 0, 0, 0, 5, 0, 0, 1, 6
"d:\IDEWORK\lvmen\src\licensedcode\data\rules\mit_623.yml", "YAML", 0, 0, 0, 3, 0, 0, 1, 4
"d:\IDEWORK\lvmen\src\licensedcode\data\rules\mit_624.yml", "YAML", 0, 0, 0, 5, 0, 0, 1, 6
"d:\IDEWORK\lvmen\src\licensedcode\data\rules\mit_625.yml", "YAML", 0, 0, 0, 3, 0, 0, 1, 4
"d:\IDEWORK\lvmen\src\licensedcode\data\rules\mit_626.yml", "YAML", 0, 0, 0, 5, 0, 0, 1, 6
"d:\IDEWORK\lvmen\src\licensedcode\data\rules\mit_627.yml", "YAML", 0, 0, 0, 5, 0, 0, 1, 6
"d:\IDEWORK\lvmen\src\licensedcode\data\rules\mit_628.yml", "YAML", 0, 0, 0, 3, 0, 0, 1, 4
"d:\IDEWORK\lvmen\src\licensedcode\data\rules\mit_629.yml", "YAML", 0, 0, 0, 5, 0, 0, 1, 6
"d:\IDEWORK\lvmen\src\licensedcode\data\rules\mit_63.yml", "YAML", 0, 0, 0, 3, 0, 0, 1, 4
"d:\IDEWORK\lvmen\src\licensedcode\data\rules\mit_630.yml", "YAML", 0, 0, 0, 5, 0, 0, 1, 6
"d:\IDEWORK\lvmen\src\licensedcode\data\rules\mit_631.yml", "YAML", 0, 0, 0, 5, 0, 0, 1, 6
"d:\IDEWORK\lvmen\src\licensedcode\data\rules\mit_632.yml", "YAML", 0, 0, 0, 3, 0, 0, 1, 4
"d:\IDEWORK\lvmen\src\licensedcode\data\rules\mit_633.yml", "YAML", 0, 0, 0, 5, 0, 0, 1, 6
"d:\IDEWORK\lvmen\src\licensedcode\data\rules\mit_634.yml", "YAML", 0, 0, 0, 5, 0, 0, 1, 6
"d:\IDEWORK\lvmen\src\licensedcode\data\rules\mit_635.yml", "YAML", 0, 0, 0, 5, 0, 0, 1, 6
"d:\IDEWORK\lvmen\src\licensedcode\data\rules\mit_636.yml", "YAML", 0, 0, 0, 5, 0, 0, 1, 6
"d:\IDEWORK\lvmen\src\licensedcode\data\rules\mit_637.yml", "YAML", 0, 0, 0, 5, 0, 0, 1, 6
"d:\IDEWORK\lvmen\src\licensedcode\data\rules\mit_638.yml", "YAML", 0, 0, 0, 5, 0, 0, 1, 6
"d:\IDEWORK\lvmen\src\licensedcode\data\rules\mit_639.yml", "YAML", 0, 0, 0, 6, 0, 0, 1, 7
"d:\IDEWORK\lvmen\src\licensedcode\data\rules\mit_64.yml", "YAML", 0, 0, 0, 5, 0, 0, 1, 6
"d:\IDEWORK\lvmen\src\licensedcode\data\rules\mit_640.yml", "YAML", 0, 0, 0, 5, 0, 0, 1, 6
"d:\IDEWORK\lvmen\src\licensedcode\data\rules\mit_641.yml", "YAML", 0, 0, 0, 5, 0, 0, 1, 6
"d:\IDEWORK\lvmen\src\licensedcode\data\rules\mit_642.yml", "YAML", 0, 0, 0, 5, 0, 0, 1, 6
"d:\IDEWORK\lvmen\src\licensedcode\data\rules\mit_643.yml", "YAML", 0, 0, 0, 3, 0, 0, 1, 4
"d:\IDEWORK\lvmen\src\licensedcode\data\rules\mit_644.yml", "YAML", 0, 0, 0, 4, 0, 0, 1, 5
"d:\IDEWORK\lvmen\src\licensedcode\data\rules\mit_645.yml", "YAML", 0, 0, 0, 4, 0, 0, 1, 5
"d:\IDEWORK\lvmen\src\licensedcode\data\rules\mit_646.yml", "YAML", 0, 0, 0, 5, 0, 0, 1, 6
"d:\IDEWORK\lvmen\src\licensedcode\data\rules\mit_647.yml", "YAML", 0, 0, 0, 5, 0, 0, 1, 6
"d:\IDEWORK\lvmen\src\licensedcode\data\rules\mit_648.yml", "YAML", 0, 0, 0, 6, 0, 0, 1, 7
"d:\IDEWORK\lvmen\src\licensedcode\data\rules\mit_649.yml", "YAML", 0, 0, 0, 3, 0, 0, 1, 4
"d:\IDEWORK\lvmen\src\licensedcode\data\rules\mit_65.yml", "YAML", 0, 0, 0, 5, 0, 0, 1, 6
"d:\IDEWORK\lvmen\src\licensedcode\data\rules\mit_650.yml", "YAML", 0, 0, 0, 3, 0, 0, 1, 4
"d:\IDEWORK\lvmen\src\licensedcode\data\rules\mit_651.yml", "YAML", 0, 0, 0, 3, 0, 0, 1, 4
"d:\IDEWORK\lvmen\src\licensedcode\data\rules\mit_652.yml", "YAML", 0, 0, 0, 5, 0, 0, 1, 6
"d:\IDEWORK\lvmen\src\licensedcode\data\rules\mit_653.yml", "YAML", 0, 0, 0, 5, 0, 0, 1, 6
"d:\IDEWORK\lvmen\src\licensedcode\data\rules\mit_654.yml", "YAML", 0, 0, 0, 5, 0, 0, 1, 6
"d:\IDEWORK\lvmen\src\licensedcode\data\rules\mit_655.yml", "YAML", 0, 0, 0, 5, 0, 0, 1, 6
"d:\IDEWORK\lvmen\src\licensedcode\data\rules\mit_656.yml", "YAML", 0, 0, 0, 5, 0, 0, 1, 6
"d:\IDEWORK\lvmen\src\licensedcode\data\rules\mit_657.yml", "YAML", 0, 0, 0, 5, 0, 0, 1, 6
"d:\IDEWORK\lvmen\src\licensedcode\data\rules\mit_658.yml", "YAML", 0, 0, 0, 5, 0, 0, 1, 6
"d:\IDEWORK\lvmen\src\licensedcode\data\rules\mit_659.yml", "YAML", 0, 0, 0, 5, 0, 0, 1, 6
"d:\IDEWORK\lvmen\src\licensedcode\data\rules\mit_66.yml", "YAML", 0, 0, 0, 5, 0, 0, 1, 6
"d:\IDEWORK\lvmen\src\licensedcode\data\rules\mit_660.yml", "YAML", 0, 0, 0, 5, 0, 0, 1, 6
"d:\IDEWORK\lvmen\src\licensedcode\data\rules\mit_661.yml", "YAML", 0, 0, 0, 6, 0, 0, 1, 7
"d:\IDEWORK\lvmen\src\licensedcode\data\rules\mit_662.yml", "YAML", 0, 0, 0, 6, 0, 0, 1, 7
"d:\IDEWORK\lvmen\src\licensedcode\data\rules\mit_663.yml", "YAML", 0, 0, 0, 5, 0, 0, 1, 6
"d:\IDEWORK\lvmen\src\licensedcode\data\rules\mit_664.yml", "YAML", 0, 0, 0, 3, 0, 0, 1, 4
"d:\IDEWORK\lvmen\src\licensedcode\data\rules\mit_665.yml", "YAML", 0, 0, 0, 5, 0, 0, 1, 6
"d:\IDEWORK\lvmen\src\licensedcode\data\rules\mit_666.yml", "YAML", 0, 0, 0, 5, 0, 0, 1, 6
"d:\IDEWORK\lvmen\src\licensedcode\data\rules\mit_667.yml", "YAML", 0, 0, 0, 5, 0, 0, 1, 6
"d:\IDEWORK\lvmen\src\licensedcode\data\rules\mit_668.yml", "YAML", 0, 0, 0, 3, 0, 0, 1, 4
"d:\IDEWORK\lvmen\src\licensedcode\data\rules\mit_669.yml", "YAML", 0, 0, 0, 6, 0, 0, 1, 7
"d:\IDEWORK\lvmen\src\licensedcode\data\rules\mit_67.yml", "YAML", 0, 0, 0, 5, 0, 0, 1, 6
"d:\IDEWORK\lvmen\src\licensedcode\data\rules\mit_670.yml", "YAML", 0, 0, 0, 5, 0, 0, 1, 6
"d:\IDEWORK\lvmen\src\licensedcode\data\rules\mit_671.yml", "YAML", 0, 0, 0, 3, 0, 0, 1, 4
"d:\IDEWORK\lvmen\src\licensedcode\data\rules\mit_672.yml", "YAML", 0, 0, 0, 3, 0, 0, 1, 4
"d:\IDEWORK\lvmen\src\licensedcode\data\rules\mit_673.yml", "YAML", 0, 0, 0, 4, 0, 0, 1, 5
"d:\IDEWORK\lvmen\src\licensedcode\data\rules\mit_674.yml", "YAML", 0, 0, 0, 5, 0, 0, 1, 6
"d:\IDEWORK\lvmen\src\licensedcode\data\rules\mit_675.yml", "YAML", 0, 0, 0, 5, 0, 0, 1, 6
"d:\IDEWORK\lvmen\src\licensedcode\data\rules\mit_676.yml", "YAML", 0, 0, 0, 5, 0, 0, 1, 6
"d:\IDEWORK\lvmen\src\licensedcode\data\rules\mit_677.yml", "YAML", 0, 0, 0, 3, 0, 0, 1, 4
"d:\IDEWORK\lvmen\src\licensedcode\data\rules\mit_678.yml", "YAML", 0, 0, 0, 3, 0, 0, 1, 4
"d:\IDEWORK\lvmen\src\licensedcode\data\rules\mit_679.yml", "YAML", 0, 0, 0, 3, 0, 0, 1, 4
"d:\IDEWORK\lvmen\src\licensedcode\data\rules\mit_68.yml", "YAML", 0, 0, 0, 2, 0, 0, 1, 3
"d:\IDEWORK\lvmen\src\licensedcode\data\rules\mit_680.yml", "YAML", 0, 0, 0, 3, 0, 0, 1, 4
"d:\IDEWORK\lvmen\src\licensedcode\data\rules\mit_681.yml", "YAML", 0, 0, 0, 3, 0, 0, 1, 4
"d:\IDEWORK\lvmen\src\licensedcode\data\rules\mit_682.yml", "YAML", 0, 0, 0, 5, 0, 0, 1, 6
"d:\IDEWORK\lvmen\src\licensedcode\data\rules\mit_683.yml", "YAML", 0, 0, 0, 3, 0, 0, 1, 4
"d:\IDEWORK\lvmen\src\licensedcode\data\rules\mit_684.yml", "YAML", 0, 0, 0, 3, 0, 0, 1, 4
"d:\IDEWORK\lvmen\src\licensedcode\data\rules\mit_685.yml", "YAML", 0, 0, 0, 3, 0, 0, 1, 4
"d:\IDEWORK\lvmen\src\licensedcode\data\rules\mit_686.yml", "YAML", 0, 0, 0, 3, 0, 0, 1, 4
"d:\IDEWORK\lvmen\src\licensedcode\data\rules\mit_687.yml", "YAML", 0, 0, 0, 7, 0, 0, 1, 8
"d:\IDEWORK\lvmen\src\licensedcode\data\rules\mit_688.yml", "YAML", 0, 0, 0, 3, 0, 0, 1, 4
"d:\IDEWORK\lvmen\src\licensedcode\data\rules\mit_689.yml", "YAML", 0, 0, 0, 5, 0, 0, 1, 6
"d:\IDEWORK\lvmen\src\licensedcode\data\rules\mit_69.yml", "YAML", 0, 0, 0, 5, 0, 0, 1, 6
"d:\IDEWORK\lvmen\src\licensedcode\data\rules\mit_690.yml", "YAML", 0, 0, 0, 5, 0, 0, 1, 6
"d:\IDEWORK\lvmen\src\licensedcode\data\rules\mit_691.yml", "YAML", 0, 0, 0, 3, 0, 0, 1, 4
"d:\IDEWORK\lvmen\src\licensedcode\data\rules\mit_692.yml", "YAML", 0, 0, 0, 5, 0, 0, 1, 6
"d:\IDEWORK\lvmen\src\licensedcode\data\rules\mit_693.yml", "YAML", 0, 0, 0, 3, 0, 0, 1, 4
"d:\IDEWORK\lvmen\src\licensedcode\data\rules\mit_694.yml", "YAML", 0, 0, 0, 5, 0, 0, 1, 6
"d:\IDEWORK\lvmen\src\licensedcode\data\rules\mit_695.yml", "YAML", 0, 0, 0, 5, 0, 0, 1, 6
"d:\IDEWORK\lvmen\src\licensedcode\data\rules\mit_696.yml", "YAML", 0, 0, 0, 5, 0, 0, 1, 6
"d:\IDEWORK\lvmen\src\licensedcode\data\rules\mit_697.yml", "YAML", 0, 0, 0, 5, 0, 0, 1, 6
"d:\IDEWORK\lvmen\src\licensedcode\data\rules\mit_698.yml", "YAML", 0, 0, 0, 5, 0, 0, 1, 6
"d:\IDEWORK\lvmen\src\licensedcode\data\rules\mit_699.yml", "YAML", 0, 0, 0, 5, 0, 0, 1, 6
"d:\IDEWORK\lvmen\src\licensedcode\data\rules\mit_7.yml", "YAML", 0, 0, 0, 3, 0, 0, 1, 4
"d:\IDEWORK\lvmen\src\licensedcode\data\rules\mit_70.yml", "YAML", 0, 0, 0, 5, 0, 0, 1, 6
"d:\IDEWORK\lvmen\src\licensedcode\data\rules\mit_700.yml", "YAML", 0, 0, 0, 3, 0, 0, 1, 4
"d:\IDEWORK\lvmen\src\licensedcode\data\rules\mit_701.yml", "YAML", 0, 0, 0, 5, 0, 0, 1, 6
"d:\IDEWORK\lvmen\src\licensedcode\data\rules\mit_702.yml", "YAML", 0, 0, 0, 3, 0, 0, 1, 4
"d:\IDEWORK\lvmen\src\licensedcode\data\rules\mit_703.yml", "YAML", 0, 0, 0, 3, 0, 0, 1, 4
"d:\IDEWORK\lvmen\src\licensedcode\data\rules\mit_704.yml", "YAML", 0, 0, 0, 3, 0, 0, 1, 4
"d:\IDEWORK\lvmen\src\licensedcode\data\rules\mit_705.yml", "YAML", 0, 0, 0, 3, 0, 0, 1, 4
"d:\IDEWORK\lvmen\src\licensedcode\data\rules\mit_706.yml", "YAML", 0, 0, 0, 3, 0, 0, 1, 4
"d:\IDEWORK\lvmen\src\licensedcode\data\rules\mit_707.yml", "YAML", 0, 0, 0, 5, 0, 0, 1, 6
"d:\IDEWORK\lvmen\src\licensedcode\data\rules\mit_708.yml", "YAML", 0, 0, 0, 5, 0, 0, 1, 6
"d:\IDEWORK\lvmen\src\licensedcode\data\rules\mit_709.yml", "YAML", 0, 0, 0, 3, 0, 0, 1, 4
"d:\IDEWORK\lvmen\src\licensedcode\data\rules\mit_71.yml", "YAML", 0, 0, 0, 2, 0, 0, 1, 3
"d:\IDEWORK\lvmen\src\licensedcode\data\rules\mit_710.yml", "YAML", 0, 0, 0, 5, 0, 0, 1, 6
"d:\IDEWORK\lvmen\src\licensedcode\data\rules\mit_711.yml", "YAML", 0, 0, 0, 5, 0, 0, 1, 6
"d:\IDEWORK\lvmen\src\licensedcode\data\rules\mit_712.yml", "YAML", 0, 0, 0, 3, 0, 0, 1, 4
"d:\IDEWORK\lvmen\src\licensedcode\data\rules\mit_713.yml", "YAML", 0, 0, 0, 5, 0, 0, 1, 6
"d:\IDEWORK\lvmen\src\licensedcode\data\rules\mit_714.yml", "YAML", 0, 0, 0, 6, 0, 0, 1, 7
"d:\IDEWORK\lvmen\src\licensedcode\data\rules\mit_715.yml", "YAML", 0, 0, 0, 3, 0, 0, 1, 4
"d:\IDEWORK\lvmen\src\licensedcode\data\rules\mit_716.yml", "YAML", 0, 0, 0, 3, 0, 0, 1, 4
"d:\IDEWORK\lvmen\src\licensedcode\data\rules\mit_717.yml", "YAML", 0, 0, 0, 5, 0, 0, 1, 6
"d:\IDEWORK\lvmen\src\licensedcode\data\rules\mit_718.yml", "YAML", 0, 0, 0, 3, 0, 0, 1, 4
"d:\IDEWORK\lvmen\src\licensedcode\data\rules\mit_719.yml", "YAML", 0, 0, 0, 4, 0, 0, 1, 5
"d:\IDEWORK\lvmen\src\licensedcode\data\rules\mit_72.yml", "YAML", 0, 0, 0, 3, 0, 0, 1, 4
"d:\IDEWORK\lvmen\src\licensedcode\data\rules\mit_720.yml", "YAML", 0, 0, 0, 4, 0, 0, 1, 5
"d:\IDEWORK\lvmen\src\licensedcode\data\rules\mit_721.yml", "YAML", 0, 0, 0, 4, 0, 0, 1, 5
"d:\IDEWORK\lvmen\src\licensedcode\data\rules\mit_722.yml", "YAML", 0, 0, 0, 4, 0, 0, 1, 5
"d:\IDEWORK\lvmen\src\licensedcode\data\rules\mit_723.yml", "YAML", 0, 0, 0, 3, 0, 0, 1, 4
"d:\IDEWORK\lvmen\src\licensedcode\data\rules\mit_724.yml", "YAML", 0, 0, 0, 3, 0, 0, 1, 4
"d:\IDEWORK\lvmen\src\licensedcode\data\rules\mit_725.yml", "YAML", 0, 0, 0, 5, 0, 0, 1, 6
"d:\IDEWORK\lvmen\src\licensedcode\data\rules\mit_726.yml", "YAML", 0, 0, 0, 3, 0, 0, 1, 4
"d:\IDEWORK\lvmen\src\licensedcode\data\rules\mit_727.yml", "YAML", 0, 0, 0, 3, 0, 0, 1, 4
"d:\IDEWORK\lvmen\src\licensedcode\data\rules\mit_728.yml", "YAML", 0, 0, 0, 5, 0, 0, 1, 6
"d:\IDEWORK\lvmen\src\licensedcode\data\rules\mit_729.yml", "YAML", 0, 0, 0, 3, 0, 0, 1, 4
"d:\IDEWORK\lvmen\src\licensedcode\data\rules\mit_73.yml", "YAML", 0, 0, 0, 5, 0, 0, 1, 6
"d:\IDEWORK\lvmen\src\licensedcode\data\rules\mit_730.yml", "YAML", 0, 0, 0, 3, 0, 0, 1, 4
"d:\IDEWORK\lvmen\src\licensedcode\data\rules\mit_731.yml", "YAML", 0, 0, 0, 3, 0, 0, 1, 4
"d:\IDEWORK\lvmen\src\licensedcode\data\rules\mit_732.yml", "YAML", 0, 0, 0, 3, 0, 0, 1, 4
"d:\IDEWORK\lvmen\src\licensedcode\data\rules\mit_733.yml", "YAML", 0, 0, 0, 5, 0, 0, 1, 6
"d:\IDEWORK\lvmen\src\licensedcode\data\rules\mit_734.yml", "YAML", 0, 0, 0, 6, 0, 0, 1, 7
"d:\IDEWORK\lvmen\src\licensedcode\data\rules\mit_735.yml", "YAML", 0, 0, 0, 5, 0, 0, 1, 6
"d:\IDEWORK\lvmen\src\licensedcode\data\rules\mit_736.yml", "YAML", 0, 0, 0, 5, 0, 0, 1, 6
"d:\IDEWORK\lvmen\src\licensedcode\data\rules\mit_737.yml", "YAML", 0, 0, 0, 3, 0, 0, 1, 4
"d:\IDEWORK\lvmen\src\licensedcode\data\rules\mit_738.yml", "YAML", 0, 0, 0, 5, 0, 0, 1, 6
"d:\IDEWORK\lvmen\src\licensedcode\data\rules\mit_739.yml", "YAML", 0, 0, 0, 3, 0, 0, 1, 4
"d:\IDEWORK\lvmen\src\licensedcode\data\rules\mit_74.yml", "YAML", 0, 0, 0, 2, 0, 0, 1, 3
"d:\IDEWORK\lvmen\src\licensedcode\data\rules\mit_740.yml", "YAML", 0, 0, 0, 3, 0, 0, 1, 4
"d:\IDEWORK\lvmen\src\licensedcode\data\rules\mit_741.yml", "YAML", 0, 0, 0, 3, 0, 0, 1, 4
"d:\IDEWORK\lvmen\src\licensedcode\data\rules\mit_742.yml", "YAML", 0, 0, 0, 5, 0, 0, 1, 6
"d:\IDEWORK\lvmen\src\licensedcode\data\rules\mit_743.yml", "YAML", 0, 0, 0, 4, 0, 0, 1, 5
"d:\IDEWORK\lvmen\src\licensedcode\data\rules\mit_744.yml", "YAML", 0, 0, 0, 7, 0, 0, 1, 8
"d:\IDEWORK\lvmen\src\licensedcode\data\rules\mit_745.yml", "YAML", 0, 0, 0, 4, 0, 0, 2, 6
"d:\IDEWORK\lvmen\src\licensedcode\data\rules\mit_746.yml", "YAML", 0, 0, 0, 5, 0, 0, 1, 6
"d:\IDEWORK\lvmen\src\licensedcode\data\rules\mit_747.yml", "YAML", 0, 0, 0, 3, 0, 0, 1, 4
"d:\IDEWORK\lvmen\src\licensedcode\data\rules\mit_748.yml", "YAML", 0, 0, 0, 3, 0, 0, 1, 4
"d:\IDEWORK\lvmen\src\licensedcode\data\rules\mit_749.yml", "YAML", 0, 0, 0, 3, 0, 0, 1, 4
"d:\IDEWORK\lvmen\src\licensedcode\data\rules\mit_75.yml", "YAML", 0, 0, 0, 5, 0, 0, 1, 6
"d:\IDEWORK\lvmen\src\licensedcode\data\rules\mit_750.yml", "YAML", 0, 0, 0, 3, 0, 0, 1, 4
"d:\IDEWORK\lvmen\src\licensedcode\data\rules\mit_751.yml", "YAML", 0, 0, 0, 3, 0, 0, 1, 4
"d:\IDEWORK\lvmen\src\licensedcode\data\rules\mit_752.yml", "YAML", 0, 0, 0, 5, 0, 0, 1, 6
"d:\IDEWORK\lvmen\src\licensedcode\data\rules\mit_753.yml", "YAML", 0, 0, 0, 5, 0, 0, 1, 6
"d:\IDEWORK\lvmen\src\licensedcode\data\rules\mit_754.yml", "YAML", 0, 0, 0, 5, 0, 0, 1, 6
"d:\IDEWORK\lvmen\src\licensedcode\data\rules\mit_755.yml", "YAML", 0, 0, 0, 5, 0, 0, 1, 6
"d:\IDEWORK\lvmen\src\licensedcode\data\rules\mit_756.yml", "YAML", 0, 0, 0, 5, 0, 0, 1, 6
"d:\IDEWORK\lvmen\src\licensedcode\data\rules\mit_757.yml", "YAML", 0, 0, 0, 5, 0, 0, 1, 6
"d:\IDEWORK\lvmen\src\licensedcode\data\rules\mit_758.yml", "YAML", 0, 0, 0, 3, 0, 0, 1, 4
"d:\IDEWORK\lvmen\src\licensedcode\data\rules\mit_759.yml", "YAML", 0, 0, 0, 7, 0, 0, 1, 8
"d:\IDEWORK\lvmen\src\licensedcode\data\rules\mit_76.yml", "YAML", 0, 0, 0, 3, 0, 0, 1, 4
"d:\IDEWORK\lvmen\src\licensedcode\data\rules\mit_760.yml", "YAML", 0, 0, 0, 5, 0, 0, 1, 6
"d:\IDEWORK\lvmen\src\licensedcode\data\rules\mit_761.yml", "YAML", 0, 0, 0, 3, 0, 0, 1, 4
"d:\IDEWORK\lvmen\src\licensedcode\data\rules\mit_762.yml", "YAML", 0, 0, 0, 3, 0, 0, 1, 4
"d:\IDEWORK\lvmen\src\licensedcode\data\rules\mit_763.yml", "YAML", 0, 0, 0, 3, 0, 0, 1, 4
"d:\IDEWORK\lvmen\src\licensedcode\data\rules\mit_764.yml", "YAML", 0, 0, 0, 3, 0, 0, 1, 4
"d:\IDEWORK\lvmen\src\licensedcode\data\rules\mit_765.yml", "YAML", 0, 0, 0, 3, 0, 0, 1, 4
"d:\IDEWORK\lvmen\src\licensedcode\data\rules\mit_766.yml", "YAML", 0, 0, 0, 3, 0, 0, 1, 4
"d:\IDEWORK\lvmen\src\licensedcode\data\rules\mit_767.yml", "YAML", 0, 0, 0, 3, 0, 0, 1, 4
"d:\IDEWORK\lvmen\src\licensedcode\data\rules\mit_768.yml", "YAML", 0, 0, 0, 3, 0, 0, 1, 4
"d:\IDEWORK\lvmen\src\licensedcode\data\rules\mit_769.yml", "YAML", 0, 0, 0, 5, 0, 0, 1, 6
"d:\IDEWORK\lvmen\src\licensedcode\data\rules\mit_77.yml", "YAML", 0, 0, 0, 3, 0, 0, 1, 4
"d:\IDEWORK\lvmen\src\licensedcode\data\rules\mit_770.yml", "YAML", 0, 0, 0, 3, 0, 0, 1, 4
"d:\IDEWORK\lvmen\src\licensedcode\data\rules\mit_771.yml", "YAML", 0, 0, 0, 3, 0, 0, 1, 4
"d:\IDEWORK\lvmen\src\licensedcode\data\rules\mit_772.yml", "YAML", 0, 0, 0, 4, 0, 0, 1, 5
"d:\IDEWORK\lvmen\src\licensedcode\data\rules\mit_773.yml", "YAML", 0, 0, 0, 4, 0, 0, 1, 5
"d:\IDEWORK\lvmen\src\licensedcode\data\rules\mit_774.yml", "YAML", 0, 0, 0, 5, 0, 0, 1, 6
"d:\IDEWORK\lvmen\src\licensedcode\data\rules\mit_775.yml", "YAML", 0, 0, 0, 5, 0, 0, 1, 6
"d:\IDEWORK\lvmen\src\licensedcode\data\rules\mit_776.yml", "YAML", 0, 0, 0, 5, 0, 0, 1, 6
"d:\IDEWORK\lvmen\src\licensedcode\data\rules\mit_777.yml", "YAML", 0, 0, 0, 5, 0, 0, 1, 6
"d:\IDEWORK\lvmen\src\licensedcode\data\rules\mit_778.yml", "YAML", 0, 0, 0, 5, 0, 0, 1, 6
"d:\IDEWORK\lvmen\src\licensedcode\data\rules\mit_779.yml", "YAML", 0, 0, 0, 5, 0, 0, 1, 6
"d:\IDEWORK\lvmen\src\licensedcode\data\rules\mit_78.yml", "YAML", 0, 0, 0, 5, 0, 0, 1, 6
"d:\IDEWORK\lvmen\src\licensedcode\data\rules\mit_780.yml", "YAML", 0, 0, 0, 5, 0, 0, 1, 6
"d:\IDEWORK\lvmen\src\licensedcode\data\rules\mit_781.yml", "YAML", 0, 0, 0, 5, 0, 0, 1, 6
"d:\IDEWORK\lvmen\src\licensedcode\data\rules\mit_782.yml", "YAML", 0, 0, 0, 5, 0, 0, 1, 6
"d:\IDEWORK\lvmen\src\licensedcode\data\rules\mit_783.yml", "YAML", 0, 0, 0, 5, 0, 0, 1, 6
"d:\IDEWORK\lvmen\src\licensedcode\data\rules\mit_784.yml", "YAML", 0, 0, 0, 5, 0, 0, 1, 6
"d:\IDEWORK\lvmen\src\licensedcode\data\rules\mit_785.yml", "YAML", 0, 0, 0, 5, 0, 0, 1, 6
"d:\IDEWORK\lvmen\src\licensedcode\data\rules\mit_786.yml", "YAML", 0, 0, 0, 5, 0, 0, 1, 6
"d:\IDEWORK\lvmen\src\licensedcode\data\rules\mit_787.yml", "YAML", 0, 0, 0, 5, 0, 0, 1, 6
"d:\IDEWORK\lvmen\src\licensedcode\data\rules\mit_788.yml", "YAML", 0, 0, 0, 5, 0, 0, 1, 6
"d:\IDEWORK\lvmen\src\licensedcode\data\rules\mit_789.yml", "YAML", 0, 0, 0, 5, 0, 0, 1, 6
"d:\IDEWORK\lvmen\src\licensedcode\data\rules\mit_79.yml", "YAML", 0, 0, 0, 5, 0, 0, 1, 6
"d:\IDEWORK\lvmen\src\licensedcode\data\rules\mit_790.yml", "YAML", 0, 0, 0, 5, 0, 0, 1, 6
"d:\IDEWORK\lvmen\src\licensedcode\data\rules\mit_791.yml", "YAML", 0, 0, 0, 5, 0, 0, 1, 6
"d:\IDEWORK\lvmen\src\licensedcode\data\rules\mit_792.yml", "YAML", 0, 0, 0, 5, 0, 0, 1, 6
"d:\IDEWORK\lvmen\src\licensedcode\data\rules\mit_793.yml", "YAML", 0, 0, 0, 5, 0, 0, 1, 6
"d:\IDEWORK\lvmen\src\licensedcode\data\rules\mit_794.yml", "YAML", 0, 0, 0, 5, 0, 0, 1, 6
"d:\IDEWORK\lvmen\src\licensedcode\data\rules\mit_795.yml", "YAML", 0, 0, 0, 5, 0, 0, 1, 6
"d:\IDEWORK\lvmen\src\licensedcode\data\rules\mit_796.yml", "YAML", 0, 0, 0, 5, 0, 0, 1, 6
"d:\IDEWORK\lvmen\src\licensedcode\data\rules\mit_797.yml", "YAML", 0, 0, 0, 5, 0, 0, 1, 6
"d:\IDEWORK\lvmen\src\licensedcode\data\rules\mit_798.yml", "YAML", 0, 0, 0, 5, 0, 0, 1, 6
"d:\IDEWORK\lvmen\src\licensedcode\data\rules\mit_799.yml", "YAML", 0, 0, 0, 5, 0, 0, 1, 6
"d:\IDEWORK\lvmen\src\licensedcode\data\rules\mit_8.yml", "YAML", 0, 0, 0, 3, 0, 0, 1, 4
"d:\IDEWORK\lvmen\src\licensedcode\data\rules\mit_80.yml", "YAML", 0, 0, 0, 3, 0, 0, 1, 4
"d:\IDEWORK\lvmen\src\licensedcode\data\rules\mit_800.yml", "YAML", 0, 0, 0, 5, 0, 0, 1, 6
"d:\IDEWORK\lvmen\src\licensedcode\data\rules\mit_801.yml", "YAML", 0, 0, 0, 5, 0, 0, 1, 6
"d:\IDEWORK\lvmen\src\licensedcode\data\rules\mit_802.yml", "YAML", 0, 0, 0, 5, 0, 0, 1, 6
"d:\IDEWORK\lvmen\src\licensedcode\data\rules\mit_803.yml", "YAML", 0, 0, 0, 5, 0, 0, 1, 6
"d:\IDEWORK\lvmen\src\licensedcode\data\rules\mit_804.yml", "YAML", 0, 0, 0, 5, 0, 0, 1, 6
"d:\IDEWORK\lvmen\src\licensedcode\data\rules\mit_805.yml", "YAML", 0, 0, 0, 5, 0, 0, 1, 6
"d:\IDEWORK\lvmen\src\licensedcode\data\rules\mit_806.yml", "YAML", 0, 0, 0, 5, 0, 0, 1, 6
"d:\IDEWORK\lvmen\src\licensedcode\data\rules\mit_807.yml", "YAML", 0, 0, 0, 5, 0, 0, 1, 6
"d:\IDEWORK\lvmen\src\licensedcode\data\rules\mit_808.yml", "YAML", 0, 0, 0, 5, 0, 0, 1, 6
"d:\IDEWORK\lvmen\src\licensedcode\data\rules\mit_809.yml", "YAML", 0, 0, 0, 5, 0, 0, 1, 6
"d:\IDEWORK\lvmen\src\licensedcode\data\rules\mit_81.yml", "YAML", 0, 0, 0, 3, 0, 0, 1, 4
"d:\IDEWORK\lvmen\src\licensedcode\data\rules\mit_810.yml", "YAML", 0, 0, 0, 5, 0, 0, 1, 6
"d:\IDEWORK\lvmen\src\licensedcode\data\rules\mit_811.yml", "YAML", 0, 0, 0, 5, 0, 0, 1, 6
"d:\IDEWORK\lvmen\src\licensedcode\data\rules\mit_812.yml", "YAML", 0, 0, 0, 5, 0, 0, 1, 6
"d:\IDEWORK\lvmen\src\licensedcode\data\rules\mit_813.yml", "YAML", 0, 0, 0, 4, 0, 0, 1, 5
"d:\IDEWORK\lvmen\src\licensedcode\data\rules\mit_814.yml", "YAML", 0, 0, 0, 3, 0, 0, 1, 4
"d:\IDEWORK\lvmen\src\licensedcode\data\rules\mit_815.yml", "YAML", 0, 0, 0, 3, 0, 0, 1, 4
"d:\IDEWORK\lvmen\src\licensedcode\data\rules\mit_816.yml", "YAML", 0, 0, 0, 7, 0, 0, 1, 8
"d:\IDEWORK\lvmen\src\licensedcode\data\rules\mit_817.yml", "YAML", 0, 0, 0, 3, 0, 0, 1, 4
"d:\IDEWORK\lvmen\src\licensedcode\data\rules\mit_818.yml", "YAML", 0, 0, 0, 4, 0, 0, 1, 5
"d:\IDEWORK\lvmen\src\licensedcode\data\rules\mit_819.yml", "YAML", 0, 0, 0, 4, 0, 0, 1, 5
"d:\IDEWORK\lvmen\src\licensedcode\data\rules\mit_82.yml", "YAML", 0, 0, 0, 3, 0, 0, 1, 4
"d:\IDEWORK\lvmen\src\licensedcode\data\rules\mit_820.yml", "YAML", 0, 0, 0, 5, 0, 0, 1, 6
"d:\IDEWORK\lvmen\src\licensedcode\data\rules\mit_821.yml", "YAML", 0, 0, 0, 5, 0, 0, 1, 6
"d:\IDEWORK\lvmen\src\licensedcode\data\rules\mit_822.yml", "YAML", 0, 0, 0, 3, 0, 0, 1, 4
"d:\IDEWORK\lvmen\src\licensedcode\data\rules\mit_823.yml", "YAML", 0, 0, 0, 4, 0, 0, 1, 5
"d:\IDEWORK\lvmen\src\licensedcode\data\rules\mit_824.yml", "YAML", 0, 0, 0, 3, 0, 0, 1, 4
"d:\IDEWORK\lvmen\src\licensedcode\data\rules\mit_825.yml", "YAML", 0, 0, 0, 5, 0, 0, 1, 6
"d:\IDEWORK\lvmen\src\licensedcode\data\rules\mit_826.yml", "YAML", 0, 0, 0, 4, 0, 0, 1, 5
"d:\IDEWORK\lvmen\src\licensedcode\data\rules\mit_827.yml", "YAML", 0, 0, 0, 5, 0, 0, 2, 7
"d:\IDEWORK\lvmen\src\licensedcode\data\rules\mit_828.yml", "YAML", 0, 0, 0, 4, 0, 0, 1, 5
"d:\IDEWORK\lvmen\src\licensedcode\data\rules\mit_829.yml", "YAML", 0, 0, 0, 3, 0, 0, 1, 4
"d:\IDEWORK\lvmen\src\licensedcode\data\rules\mit_83.yml", "YAML", 0, 0, 0, 3, 0, 0, 1, 4
"d:\IDEWORK\lvmen\src\licensedcode\data\rules\mit_830.yml", "YAML", 0, 0, 0, 3, 0, 0, 1, 4
"d:\IDEWORK\lvmen\src\licensedcode\data\rules\mit_831.yml", "YAML", 0, 0, 0, 3, 0, 0, 1, 4
"d:\IDEWORK\lvmen\src\licensedcode\data\rules\mit_832.yml", "YAML", 0, 0, 0, 4, 0, 0, 1, 5
"d:\IDEWORK\lvmen\src\licensedcode\data\rules\mit_833.yml", "YAML", 0, 0, 0, 5, 0, 0, 1, 6
"d:\IDEWORK\lvmen\src\licensedcode\data\rules\mit_834.yml", "YAML", 0, 0, 0, 5, 0, 0, 1, 6
"d:\IDEWORK\lvmen\src\licensedcode\data\rules\mit_835.yml", "YAML", 0, 0, 0, 3, 0, 0, 1, 4
"d:\IDEWORK\lvmen\src\licensedcode\data\rules\mit_836.yml", "YAML", 0, 0, 0, 5, 0, 0, 1, 6
"d:\IDEWORK\lvmen\src\licensedcode\data\rules\mit_837.yml", "YAML", 0, 0, 0, 5, 0, 0, 1, 6
"d:\IDEWORK\lvmen\src\licensedcode\data\rules\mit_838.yml", "YAML", 0, 0, 0, 5, 0, 0, 1, 6
"d:\IDEWORK\lvmen\src\licensedcode\data\rules\mit_839.yml", "YAML", 0, 0, 0, 5, 0, 0, 1, 6
"d:\IDEWORK\lvmen\src\licensedcode\data\rules\mit_84.yml", "YAML", 0, 0, 0, 4, 0, 0, 1, 5
"d:\IDEWORK\lvmen\src\licensedcode\data\rules\mit_840.yml", "YAML", 0, 0, 0, 5, 0, 0, 1, 6
"d:\IDEWORK\lvmen\src\licensedcode\data\rules\mit_841.yml", "YAML", 0, 0, 0, 5, 0, 0, 1, 6
"d:\IDEWORK\lvmen\src\licensedcode\data\rules\mit_842.yml", "YAML", 0, 0, 0, 5, 0, 0, 1, 6
"d:\IDEWORK\lvmen\src\licensedcode\data\rules\mit_843.yml", "YAML", 0, 0, 0, 5, 0, 0, 1, 6
"d:\IDEWORK\lvmen\src\licensedcode\data\rules\mit_844.yml", "YAML", 0, 0, 0, 5, 0, 0, 1, 6
"d:\IDEWORK\lvmen\src\licensedcode\data\rules\mit_845.yml", "YAML", 0, 0, 0, 5, 0, 0, 1, 6
"d:\IDEWORK\lvmen\src\licensedcode\data\rules\mit_846.yml", "YAML", 0, 0, 0, 5, 0, 0, 1, 6
"d:\IDEWORK\lvmen\src\licensedcode\data\rules\mit_847.yml", "YAML", 0, 0, 0, 5, 0, 0, 1, 6
"d:\IDEWORK\lvmen\src\licensedcode\data\rules\mit_848.yml", "YAML", 0, 0, 0, 5, 0, 0, 1, 6
"d:\IDEWORK\lvmen\src\licensedcode\data\rules\mit_849.yml", "YAML", 0, 0, 0, 5, 0, 0, 1, 6
"d:\IDEWORK\lvmen\src\licensedcode\data\rules\mit_85.yml", "YAML", 0, 0, 0, 5, 0, 0, 1, 6
"d:\IDEWORK\lvmen\src\licensedcode\data\rules\mit_850.yml", "YAML", 0, 0, 0, 5, 0, 0, 1, 6
"d:\IDEWORK\lvmen\src\licensedcode\data\rules\mit_851.yml", "YAML", 0, 0, 0, 5, 0, 0, 1, 6
"d:\IDEWORK\lvmen\src\licensedcode\data\rules\mit_852.yml", "YAML", 0, 0, 0, 5, 0, 0, 1, 6
"d:\IDEWORK\lvmen\src\licensedcode\data\rules\mit_853.yml", "YAML", 0, 0, 0, 5, 0, 0, 1, 6
"d:\IDEWORK\lvmen\src\licensedcode\data\rules\mit_854.yml", "YAML", 0, 0, 0, 5, 0, 0, 1, 6
"d:\IDEWORK\lvmen\src\licensedcode\data\rules\mit_855.yml", "YAML", 0, 0, 0, 5, 0, 0, 1, 6
"d:\IDEWORK\lvmen\src\licensedcode\data\rules\mit_856.yml", "YAML", 0, 0, 0, 5, 0, 0, 1, 6
"d:\IDEWORK\lvmen\src\licensedcode\data\rules\mit_857.yml", "YAML", 0, 0, 0, 5, 0, 0, 1, 6
"d:\IDEWORK\lvmen\src\licensedcode\data\rules\mit_858.yml", "YAML", 0, 0, 0, 5, 0, 0, 1, 6
"d:\IDEWORK\lvmen\src\licensedcode\data\rules\mit_859.yml", "YAML", 0, 0, 0, 5, 0, 0, 1, 6
"d:\IDEWORK\lvmen\src\licensedcode\data\rules\mit_86.yml", "YAML", 0, 0, 0, 5, 0, 0, 1, 6
"d:\IDEWORK\lvmen\src\licensedcode\data\rules\mit_860.yml", "YAML", 0, 0, 0, 5, 0, 0, 1, 6
"d:\IDEWORK\lvmen\src\licensedcode\data\rules\mit_861.yml", "YAML", 0, 0, 0, 3, 0, 0, 1, 4
"d:\IDEWORK\lvmen\src\licensedcode\data\rules\mit_862.yml", "YAML", 0, 0, 0, 5, 0, 0, 1, 6
"d:\IDEWORK\lvmen\src\licensedcode\data\rules\mit_863.yml", "YAML", 0, 0, 0, 3, 0, 0, 1, 4
"d:\IDEWORK\lvmen\src\licensedcode\data\rules\mit_864.yml", "YAML", 0, 0, 0, 5, 0, 0, 1, 6
"d:\IDEWORK\lvmen\src\licensedcode\data\rules\mit_865.yml", "YAML", 0, 0, 0, 5, 0, 0, 1, 6
"d:\IDEWORK\lvmen\src\licensedcode\data\rules\mit_866.yml", "YAML", 0, 0, 0, 5, 0, 0, 1, 6
"d:\IDEWORK\lvmen\src\licensedcode\data\rules\mit_867.yml", "YAML", 0, 0, 0, 5, 0, 0, 1, 6
"d:\IDEWORK\lvmen\src\licensedcode\data\rules\mit_868.yml", "YAML", 0, 0, 0, 5, 0, 0, 1, 6
"d:\IDEWORK\lvmen\src\licensedcode\data\rules\mit_869.yml", "YAML", 0, 0, 0, 5, 0, 0, 1, 6
"d:\IDEWORK\lvmen\src\licensedcode\data\rules\mit_87.yml", "YAML", 0, 0, 0, 4, 0, 0, 1, 5
"d:\IDEWORK\lvmen\src\licensedcode\data\rules\mit_870.yml", "YAML", 0, 0, 0, 5, 0, 0, 1, 6
"d:\IDEWORK\lvmen\src\licensedcode\data\rules\mit_871.yml", "YAML", 0, 0, 0, 5, 0, 0, 1, 6
"d:\IDEWORK\lvmen\src\licensedcode\data\rules\mit_872.yml", "YAML", 0, 0, 0, 3, 0, 0, 1, 4
"d:\IDEWORK\lvmen\src\licensedcode\data\rules\mit_873.yml", "YAML", 0, 0, 0, 3, 0, 0, 1, 4
"d:\IDEWORK\lvmen\src\licensedcode\data\rules\mit_874.yml", "YAML", 0, 0, 0, 3, 0, 0, 1, 4
"d:\IDEWORK\lvmen\src\licensedcode\data\rules\mit_875.yml", "YAML", 0, 0, 0, 3, 0, 0, 1, 4
"d:\IDEWORK\lvmen\src\licensedcode\data\rules\mit_876.yml", "YAML", 0, 0, 0, 3, 0, 0, 1, 4
"d:\IDEWORK\lvmen\src\licensedcode\data\rules\mit_877.yml", "YAML", 0, 0, 0, 3, 0, 0, 1, 4
"d:\IDEWORK\lvmen\src\licensedcode\data\rules\mit_878.yml", "YAML", 0, 0, 0, 3, 0, 0, 1, 4
"d:\IDEWORK\lvmen\src\licensedcode\data\rules\mit_879.yml", "YAML", 0, 0, 0, 3, 0, 0, 1, 4
"d:\IDEWORK\lvmen\src\licensedcode\data\rules\mit_88.yml", "YAML", 0, 0, 0, 3, 0, 0, 1, 4
"d:\IDEWORK\lvmen\src\licensedcode\data\rules\mit_880.yml", "YAML", 0, 0, 0, 3, 0, 0, 1, 4
"d:\IDEWORK\lvmen\src\licensedcode\data\rules\mit_881.yml", "YAML", 0, 0, 0, 3, 0, 0, 1, 4
"d:\IDEWORK\lvmen\src\licensedcode\data\rules\mit_882.yml", "YAML", 0, 0, 0, 3, 0, 0, 1, 4
"d:\IDEWORK\lvmen\src\licensedcode\data\rules\mit_883.yml", "YAML", 0, 0, 0, 3, 0, 0, 1, 4
"d:\IDEWORK\lvmen\src\licensedcode\data\rules\mit_884.yml", "YAML", 0, 0, 0, 5, 0, 0, 1, 6
"d:\IDEWORK\lvmen\src\licensedcode\data\rules\mit_885.yml", "YAML", 0, 0, 0, 5, 0, 0, 1, 6
"d:\IDEWORK\lvmen\src\licensedcode\data\rules\mit_886.yml", "YAML", 0, 0, 0, 5, 0, 0, 1, 6
"d:\IDEWORK\lvmen\src\licensedcode\data\rules\mit_887.yml", "YAML", 0, 0, 0, 3, 0, 0, 1, 4
"d:\IDEWORK\lvmen\src\licensedcode\data\rules\mit_888.yml", "YAML", 0, 0, 0, 3, 0, 0, 1, 4
"d:\IDEWORK\lvmen\src\licensedcode\data\rules\mit_889.yml", "YAML", 0, 0, 0, 5, 0, 0, 1, 6
"d:\IDEWORK\lvmen\src\licensedcode\data\rules\mit_89.yml", "YAML", 0, 0, 0, 3, 0, 0, 1, 4
"d:\IDEWORK\lvmen\src\licensedcode\data\rules\mit_890.yml", "YAML", 0, 0, 0, 5, 0, 0, 1, 6
"d:\IDEWORK\lvmen\src\licensedcode\data\rules\mit_891.yml", "YAML", 0, 0, 0, 5, 0, 0, 1, 6
"d:\IDEWORK\lvmen\src\licensedcode\data\rules\mit_892.yml", "YAML", 0, 0, 0, 5, 0, 0, 1, 6
"d:\IDEWORK\lvmen\src\licensedcode\data\rules\mit_893.yml", "YAML", 0, 0, 0, 5, 0, 0, 1, 6
"d:\IDEWORK\lvmen\src\licensedcode\data\rules\mit_894.yml", "YAML", 0, 0, 0, 5, 0, 0, 1, 6
"d:\IDEWORK\lvmen\src\licensedcode\data\rules\mit_895.yml", "YAML", 0, 0, 0, 5, 0, 0, 1, 6
"d:\IDEWORK\lvmen\src\licensedcode\data\rules\mit_896.yml", "YAML", 0, 0, 0, 3, 0, 0, 1, 4
"d:\IDEWORK\lvmen\src\licensedcode\data\rules\mit_897.yml", "YAML", 0, 0, 0, 3, 0, 0, 1, 4
"d:\IDEWORK\lvmen\src\licensedcode\data\rules\mit_898.yml", "YAML", 0, 0, 0, 5, 0, 0, 1, 6
"d:\IDEWORK\lvmen\src\licensedcode\data\rules\mit_899.yml", "YAML", 0, 0, 0, 3, 0, 0, 1, 4
"d:\IDEWORK\lvmen\src\licensedcode\data\rules\mit_89_2.yml", "YAML", 0, 0, 0, 3, 0, 0, 1, 4
"d:\IDEWORK\lvmen\src\licensedcode\data\rules\mit_9.yml", "YAML", 0, 0, 0, 5, 0, 0, 1, 6
"d:\IDEWORK\lvmen\src\licensedcode\data\rules\mit_90.yml", "YAML", 0, 0, 0, 4, 0, 0, 1, 5
"d:\IDEWORK\lvmen\src\licensedcode\data\rules\mit_900.yml", "YAML", 0, 0, 0, 3, 0, 0, 1, 4
"d:\IDEWORK\lvmen\src\licensedcode\data\rules\mit_901.yml", "YAML", 0, 0, 0, 3, 0, 0, 1, 4
"d:\IDEWORK\lvmen\src\licensedcode\data\rules\mit_902.yml", "YAML", 0, 0, 0, 3, 0, 0, 1, 4
"d:\IDEWORK\lvmen\src\licensedcode\data\rules\mit_903.yml", "YAML", 0, 0, 0, 3, 0, 0, 1, 4
"d:\IDEWORK\lvmen\src\licensedcode\data\rules\mit_904.yml", "YAML", 0, 0, 0, 5, 0, 0, 1, 6
"d:\IDEWORK\lvmen\src\licensedcode\data\rules\mit_905.yml", "YAML", 0, 0, 0, 3, 0, 0, 1, 4
"d:\IDEWORK\lvmen\src\licensedcode\data\rules\mit_906.yml", "YAML", 0, 0, 0, 3, 0, 0, 1, 4
"d:\IDEWORK\lvmen\src\licensedcode\data\rules\mit_907.yml", "YAML", 0, 0, 0, 3, 0, 0, 1, 4
"d:\IDEWORK\lvmen\src\licensedcode\data\rules\mit_908.yml", "YAML", 0, 0, 0, 5, 0, 0, 1, 6
"d:\IDEWORK\lvmen\src\licensedcode\data\rules\mit_909.yml", "YAML", 0, 0, 0, 5, 0, 0, 1, 6
"d:\IDEWORK\lvmen\src\licensedcode\data\rules\mit_91.yml", "YAML", 0, 0, 0, 5, 0, 0, 1, 6
"d:\IDEWORK\lvmen\src\licensedcode\data\rules\mit_910.yml", "YAML", 0, 0, 0, 5, 0, 0, 1, 6
"d:\IDEWORK\lvmen\src\licensedcode\data\rules\mit_911.yml", "YAML", 0, 0, 0, 3, 0, 0, 1, 4
"d:\IDEWORK\lvmen\src\licensedcode\data\rules\mit_912.yml", "YAML", 0, 0, 0, 5, 0, 0, 1, 6
"d:\IDEWORK\lvmen\src\licensedcode\data\rules\mit_913.yml", "YAML", 0, 0, 0, 3, 0, 0, 1, 4
"d:\IDEWORK\lvmen\src\licensedcode\data\rules\mit_914.yml", "YAML", 0, 0, 0, 5, 0, 0, 1, 6
"d:\IDEWORK\lvmen\src\licensedcode\data\rules\mit_915.yml", "YAML", 0, 0, 0, 7, 0, 0, 1, 8
"d:\IDEWORK\lvmen\src\licensedcode\data\rules\mit_916.yml", "YAML", 0, 0, 0, 7, 0, 0, 1, 8
"d:\IDEWORK\lvmen\src\licensedcode\data\rules\mit_917.yml", "YAML", 0, 0, 0, 4, 0, 0, 1, 5
"d:\IDEWORK\lvmen\src\licensedcode\data\rules\mit_918.yml", "YAML", 0, 0, 0, 7, 0, 0, 1, 8
"d:\IDEWORK\lvmen\src\licensedcode\data\rules\mit_919.yml", "YAML", 0, 0, 0, 3, 0, 0, 1, 4
"d:\IDEWORK\lvmen\src\licensedcode\data\rules\mit_92.yml", "YAML", 0, 0, 0, 5, 0, 0, 1, 6
"d:\IDEWORK\lvmen\src\licensedcode\data\rules\mit_920.yml", "YAML", 0, 0, 0, 3, 0, 0, 1, 4
"d:\IDEWORK\lvmen\src\licensedcode\data\rules\mit_921.yml", "YAML", 0, 0, 0, 5, 0, 0, 1, 6
"d:\IDEWORK\lvmen\src\licensedcode\data\rules\mit_922.yml", "YAML", 0, 0, 0, 3, 0, 0, 1, 4
"d:\IDEWORK\lvmen\src\licensedcode\data\rules\mit_923.yml", "YAML", 0, 0, 0, 5, 0, 0, 1, 6
"d:\IDEWORK\lvmen\src\licensedcode\data\rules\mit_924.yml", "YAML", 0, 0, 0, 5, 0, 0, 1, 6
"d:\IDEWORK\lvmen\src\licensedcode\data\rules\mit_925.yml", "YAML", 0, 0, 0, 3, 0, 0, 1, 4
"d:\IDEWORK\lvmen\src\licensedcode\data\rules\mit_926.yml", "YAML", 0, 0, 0, 5, 0, 0, 1, 6
"d:\IDEWORK\lvmen\src\licensedcode\data\rules\mit_927.yml", "YAML", 0, 0, 0, 6, 0, 0, 1, 7
"d:\IDEWORK\lvmen\src\licensedcode\data\rules\mit_928.yml", "YAML", 0, 0, 0, 3, 0, 0, 1, 4
"d:\IDEWORK\lvmen\src\licensedcode\data\rules\mit_929.yml", "YAML", 0, 0, 0, 6, 0, 0, 1, 7
"d:\IDEWORK\lvmen\src\licensedcode\data\rules\mit_93.yml", "YAML", 0, 0, 0, 5, 0, 0, 1, 6
"d:\IDEWORK\lvmen\src\licensedcode\data\rules\mit_930.yml", "YAML", 0, 0, 0, 5, 0, 0, 1, 6
"d:\IDEWORK\lvmen\src\licensedcode\data\rules\mit_931.yml", "YAML", 0, 0, 0, 5, 0, 0, 1, 6
"d:\IDEWORK\lvmen\src\licensedcode\data\rules\mit_932.yml", "YAML", 0, 0, 0, 5, 0, 0, 1, 6
"d:\IDEWORK\lvmen\src\licensedcode\data\rules\mit_933.yml", "YAML", 0, 0, 0, 6, 0, 0, 1, 7
"d:\IDEWORK\lvmen\src\licensedcode\data\rules\mit_934.yml", "YAML", 0, 0, 0, 3, 0, 0, 1, 4
"d:\IDEWORK\lvmen\src\licensedcode\data\rules\mit_935.yml", "YAML", 0, 0, 0, 3, 0, 0, 1, 4
"d:\IDEWORK\lvmen\src\licensedcode\data\rules\mit_936.yml", "YAML", 0, 0, 0, 3, 0, 0, 1, 4
"d:\IDEWORK\lvmen\src\licensedcode\data\rules\mit_937.yml", "YAML", 0, 0, 0, 3, 0, 0, 1, 4
"d:\IDEWORK\lvmen\src\licensedcode\data\rules\mit_938.yml", "YAML", 0, 0, 0, 3, 0, 0, 1, 4
"d:\IDEWORK\lvmen\src\licensedcode\data\rules\mit_939.yml", "YAML", 0, 0, 0, 5, 0, 0, 1, 6
"d:\IDEWORK\lvmen\src\licensedcode\data\rules\mit_94.yml", "YAML", 0, 0, 0, 5, 0, 0, 1, 6
"d:\IDEWORK\lvmen\src\licensedcode\data\rules\mit_940.yml", "YAML", 0, 0, 0, 5, 0, 0, 1, 6
"d:\IDEWORK\lvmen\src\licensedcode\data\rules\mit_941.yml", "YAML", 0, 0, 0, 5, 0, 0, 1, 6
"d:\IDEWORK\lvmen\src\licensedcode\data\rules\mit_942.yml", "YAML", 0, 0, 0, 5, 0, 0, 1, 6
"d:\IDEWORK\lvmen\src\licensedcode\data\rules\mit_943.yml", "YAML", 0, 0, 0, 5, 0, 0, 1, 6
"d:\IDEWORK\lvmen\src\licensedcode\data\rules\mit_944.yml", "YAML", 0, 0, 0, 5, 0, 0, 1, 6
"d:\IDEWORK\lvmen\src\licensedcode\data\rules\mit_945.yml", "YAML", 0, 0, 0, 5, 0, 0, 1, 6
"d:\IDEWORK\lvmen\src\licensedcode\data\rules\mit_946.yml", "YAML", 0, 0, 0, 5, 0, 0, 1, 6
"d:\IDEWORK\lvmen\src\licensedcode\data\rules\mit_947.yml", "YAML", 0, 0, 0, 5, 0, 0, 1, 6
"d:\IDEWORK\lvmen\src\licensedcode\data\rules\mit_948.yml", "YAML", 0, 0, 0, 5, 0, 0, 1, 6
"d:\IDEWORK\lvmen\src\licensedcode\data\rules\mit_949.yml", "YAML", 0, 0, 0, 5, 0, 0, 1, 6
"d:\IDEWORK\lvmen\src\licensedcode\data\rules\mit_95.yml", "YAML", 0, 0, 0, 5, 0, 0, 1, 6
"d:\IDEWORK\lvmen\src\licensedcode\data\rules\mit_950.yml", "YAML", 0, 0, 0, 5, 0, 0, 1, 6
"d:\IDEWORK\lvmen\src\licensedcode\data\rules\mit_951.yml", "YAML", 0, 0, 0, 8, 0, 0, 1, 9
"d:\IDEWORK\lvmen\src\licensedcode\data\rules\mit_952.yml", "YAML", 0, 0, 0, 5, 0, 0, 1, 6
"d:\IDEWORK\lvmen\src\licensedcode\data\rules\mit_953.yml", "YAML", 0, 0, 0, 5, 0, 0, 1, 6
"d:\IDEWORK\lvmen\src\licensedcode\data\rules\mit_954.yml", "YAML", 0, 0, 0, 5, 0, 0, 1, 6
"d:\IDEWORK\lvmen\src\licensedcode\data\rules\mit_955.yml", "YAML", 0, 0, 0, 5, 0, 0, 1, 6
"d:\IDEWORK\lvmen\src\licensedcode\data\rules\mit_956.yml", "YAML", 0, 0, 0, 5, 0, 0, 1, 6
"d:\IDEWORK\lvmen\src\licensedcode\data\rules\mit_957.yml", "YAML", 0, 0, 0, 3, 0, 0, 1, 4
"d:\IDEWORK\lvmen\src\licensedcode\data\rules\mit_958.yml", "YAML", 0, 0, 0, 3, 0, 0, 1, 4
"d:\IDEWORK\lvmen\src\licensedcode\data\rules\mit_959.yml", "YAML", 0, 0, 0, 3, 0, 0, 1, 4
"d:\IDEWORK\lvmen\src\licensedcode\data\rules\mit_96.yml", "YAML", 0, 0, 0, 5, 0, 0, 1, 6
"d:\IDEWORK\lvmen\src\licensedcode\data\rules\mit_960.yml", "YAML", 0, 0, 0, 3, 0, 0, 1, 4
"d:\IDEWORK\lvmen\src\licensedcode\data\rules\mit_961.yml", "YAML", 0, 0, 0, 3, 0, 0, 1, 4
"d:\IDEWORK\lvmen\src\licensedcode\data\rules\mit_962.yml", "YAML", 0, 0, 0, 3, 0, 0, 1, 4
"d:\IDEWORK\lvmen\src\licensedcode\data\rules\mit_963.yml", "YAML", 0, 0, 0, 3, 0, 0, 1, 4
"d:\IDEWORK\lvmen\src\licensedcode\data\rules\mit_964.yml", "YAML", 0, 0, 0, 3, 0, 0, 1, 4
"d:\IDEWORK\lvmen\src\licensedcode\data\rules\mit_965.yml", "YAML", 0, 0, 0, 3, 0, 0, 1, 4
"d:\IDEWORK\lvmen\src\licensedcode\data\rules\mit_966.yml", "YAML", 0, 0, 0, 4, 0, 0, 1, 5
"d:\IDEWORK\lvmen\src\licensedcode\data\rules\mit_967.yml", "YAML", 0, 0, 0, 3, 0, 0, 1, 4
"d:\IDEWORK\lvmen\src\licensedcode\data\rules\mit_968.yml", "YAML", 0, 0, 0, 3, 0, 0, 1, 4
"d:\IDEWORK\lvmen\src\licensedcode\data\rules\mit_969.yml", "YAML", 0, 0, 0, 4, 0, 0, 1, 5
"d:\IDEWORK\lvmen\src\licensedcode\data\rules\mit_97.yml", "YAML", 0, 0, 0, 3, 0, 0, 1, 4
"d:\IDEWORK\lvmen\src\licensedcode\data\rules\mit_970.yml", "YAML", 0, 0, 0, 9, 0, 0, 1, 10
"d:\IDEWORK\lvmen\src\licensedcode\data\rules\mit_971.yml", "YAML", 0, 0, 0, 5, 0, 0, 1, 6
"d:\IDEWORK\lvmen\src\licensedcode\data\rules\mit_972.yml", "YAML", 0, 0, 0, 3, 0, 0, 1, 4
"d:\IDEWORK\lvmen\src\licensedcode\data\rules\mit_973.yml", "YAML", 0, 0, 0, 3, 0, 0, 1, 4
"d:\IDEWORK\lvmen\src\licensedcode\data\rules\mit_974.yml", "YAML", 0, 0, 0, 3, 0, 0, 1, 4
"d:\IDEWORK\lvmen\src\licensedcode\data\rules\mit_975.yml", "YAML", 0, 0, 0, 3, 0, 0, 1, 4
"d:\IDEWORK\lvmen\src\licensedcode\data\rules\mit_976.yml", "YAML", 0, 0, 0, 6, 0, 0, 1, 7
"d:\IDEWORK\lvmen\src\licensedcode\data\rules\mit_977.yml", "YAML", 0, 0, 0, 5, 0, 0, 1, 6
"d:\IDEWORK\lvmen\src\licensedcode\data\rules\mit_978.yml", "YAML", 0, 0, 0, 3, 0, 0, 1, 4
"d:\IDEWORK\lvmen\src\licensedcode\data\rules\mit_979.yml", "YAML", 0, 0, 0, 5, 0, 0, 1, 6
"d:\IDEWORK\lvmen\src\licensedcode\data\rules\mit_98.yml", "YAML", 0, 0, 0, 3, 0, 0, 1, 4
"d:\IDEWORK\lvmen\src\licensedcode\data\rules\mit_980.yml", "YAML", 0, 0, 0, 5, 0, 0, 1, 6
"d:\IDEWORK\lvmen\src\licensedcode\data\rules\mit_981.yml", "YAML", 0, 0, 0, 3, 0, 0, 1, 4
"d:\IDEWORK\lvmen\src\licensedcode\data\rules\mit_982.yml", "YAML", 0, 0, 0, 4, 0, 0, 1, 5
"d:\IDEWORK\lvmen\src\licensedcode\data\rules\mit_983.yml", "YAML", 0, 0, 0, 5, 0, 0, 1, 6
"d:\IDEWORK\lvmen\src\licensedcode\data\rules\mit_984.yml", "YAML", 0, 0, 0, 5, 0, 0, 1, 6
"d:\IDEWORK\lvmen\src\licensedcode\data\rules\mit_985.yml", "YAML", 0, 0, 0, 3, 0, 0, 1, 4
"d:\IDEWORK\lvmen\src\licensedcode\data\rules\mit_986.yml", "YAML", 0, 0, 0, 5, 0, 0, 1, 6
"d:\IDEWORK\lvmen\src\licensedcode\data\rules\mit_987.yml", "YAML", 0, 0, 0, 5, 0, 0, 1, 6
"d:\IDEWORK\lvmen\src\licensedcode\data\rules\mit_988.yml", "YAML", 0, 0, 0, 5, 0, 0, 1, 6
"d:\IDEWORK\lvmen\src\licensedcode\data\rules\mit_989.yml", "YAML", 0, 0, 0, 5, 0, 0, 1, 6
"d:\IDEWORK\lvmen\src\licensedcode\data\rules\mit_99.yml", "YAML", 0, 0, 0, 3, 0, 0, 1, 4
"d:\IDEWORK\lvmen\src\licensedcode\data\rules\mit_990.yml", "YAML", 0, 0, 0, 5, 0, 0, 1, 6
"d:\IDEWORK\lvmen\src\licensedcode\data\rules\mit_991.yml", "YAML", 0, 0, 0, 3, 0, 0, 1, 4
"d:\IDEWORK\lvmen\src\licensedcode\data\rules\mit_992.yml", "YAML", 0, 0, 0, 5, 0, 0, 1, 6
"d:\IDEWORK\lvmen\src\licensedcode\data\rules\mit_993.yml", "YAML", 0, 0, 0, 3, 0, 0, 1, 4
"d:\IDEWORK\lvmen\src\licensedcode\data\rules\mit_994.yml", "YAML", 0, 0, 0, 3, 0, 0, 1, 4
"d:\IDEWORK\lvmen\src\licensedcode\data\rules\mit_995.yml", "YAML", 0, 0, 0, 3, 0, 0, 1, 4
"d:\IDEWORK\lvmen\src\licensedcode\data\rules\mit_996.yml", "YAML", 0, 0, 0, 3, 0, 0, 1, 4
"d:\IDEWORK\lvmen\src\licensedcode\data\rules\mit_997.yml", "YAML", 0, 0, 0, 5, 0, 0, 1, 6
"d:\IDEWORK\lvmen\src\licensedcode\data\rules\mit_998.yml", "YAML", 0, 0, 0, 3, 0, 0, 1, 4
"d:\IDEWORK\lvmen\src\licensedcode\data\rules\mit_999.yml", "YAML", 0, 0, 0, 3, 0, 0, 1, 4
"d:\IDEWORK\lvmen\src\licensedcode\data\rules\mit_an2.yml", "YAML", 0, 0, 0, 5, 0, 0, 1, 6
"d:\IDEWORK\lvmen\src\licensedcode\data\rules\mit_and_apache-2.0_and_agpl-3.0_1.yml", "YAML", 0, 0, 0, 3, 0, 0, 1, 4
"d:\IDEWORK\lvmen\src\licensedcode\data\rules\mit_and_apache-2.0_and_agpl-3.0_2.yml", "YAML", 0, 0, 0, 5, 0, 0, 1, 6
"d:\IDEWORK\lvmen\src\licensedcode\data\rules\mit_and_apache-2.0_and_agpl-3.0_3.yml", "YAML", 0, 0, 0, 5, 0, 0, 1, 6
"d:\IDEWORK\lvmen\src\licensedcode\data\rules\mit_and_artistic-2.0_1.yml", "YAML", 0, 0, 0, 4, 0, 0, 1, 5
"d:\IDEWORK\lvmen\src\licensedcode\data\rules\mit_and_bitstream_1.yml", "YAML", 0, 0, 0, 3, 0, 0, 1, 4
"d:\IDEWORK\lvmen\src\licensedcode\data\rules\mit_and_bsd-new_1.yml", "YAML", 0, 0, 0, 5, 0, 0, 1, 6
"d:\IDEWORK\lvmen\src\licensedcode\data\rules\mit_and_bsd-new_2.yml", "YAML", 0, 0, 0, 3, 0, 0, 1, 4
"d:\IDEWORK\lvmen\src\licensedcode\data\rules\mit_and_bsd-new_3.yml", "YAML", 0, 0, 0, 4, 0, 0, 1, 5
"d:\IDEWORK\lvmen\src\licensedcode\data\rules\mit_and_bsd-new_and_apache-2.0_nuget_url_1.yml", "YAML", 0, 0, 0, 5, 0, 0, 1, 6
"d:\IDEWORK\lvmen\src\licensedcode\data\rules\mit_and_bsd-new_modernizr_1.yml", "YAML", 0, 0, 0, 3, 0, 0, 1, 4
"d:\IDEWORK\lvmen\src\licensedcode\data\rules\mit_and_bsd-new_modernizr_2.yml", "YAML", 0, 0, 0, 3, 0, 0, 1, 4
"d:\IDEWORK\lvmen\src\licensedcode\data\rules\mit_and_bsd-simplified_and_isc_1.yml", "YAML", 0, 0, 0, 6, 0, 0, 1, 7
"d:\IDEWORK\lvmen\src\licensedcode\data\rules\mit_and_bsd-simplified_and_isc_2.yml", "YAML", 0, 0, 0, 4, 0, 0, 1, 5
"d:\IDEWORK\lvmen\src\licensedcode\data\rules\mit_and_cc-by-4.0_1.yml", "YAML", 0, 0, 0, 3, 0, 0, 1, 4
"d:\IDEWORK\lvmen\src\licensedcode\data\rules\mit_and_cc-by-4.0_2.yml", "YAML", 0, 0, 0, 3, 0, 0, 1, 4
"d:\IDEWORK\lvmen\src\licensedcode\data\rules\mit_and_cc-by-4.0_3.yml", "YAML", 0, 0, 0, 6, 0, 0, 1, 7
"d:\IDEWORK\lvmen\src\licensedcode\data\rules\mit_and_cc-by-4.0_4.yml", "YAML", 0, 0, 0, 6, 0, 0, 1, 7
"d:\IDEWORK\lvmen\src\licensedcode\data\rules\mit_and_cc-by-4.0_5.yml", "YAML", 0, 0, 0, 6, 0, 0, 1, 7
"d:\IDEWORK\lvmen\src\licensedcode\data\rules\mit_and_cc-by-4.0_6.yml", "YAML", 0, 0, 0, 6, 0, 0, 1, 7
"d:\IDEWORK\lvmen\src\licensedcode\data\rules\mit_and_cc-by-4.0_7.yml", "YAML", 0, 0, 0, 6, 0, 0, 1, 7
"d:\IDEWORK\lvmen\src\licensedcode\data\rules\mit_and_cc-by-sa-4.0_1.yml", "YAML", 0, 0, 0, 6, 0, 0, 1, 7
"d:\IDEWORK\lvmen\src\licensedcode\data\rules\mit_and_commercial-license.yml", "YAML", 0, 0, 0, 5, 0, 0, 1, 6
"d:\IDEWORK\lvmen\src\licensedcode\data\rules\mit_and_commercial-license2.yml", "YAML", 0, 0, 0, 13, 0, 0, 1, 14
"d:\IDEWORK\lvmen\src\licensedcode\data\rules\mit_and_free-unknown.yml", "YAML", 0, 0, 0, 4, 0, 0, 1, 5
"d:\IDEWORK\lvmen\src\licensedcode\data\rules\mit_and_gpl-2.0_1.yml", "YAML", 0, 0, 0, 5, 0, 0, 1, 6
"d:\IDEWORK\lvmen\src\licensedcode\data\rules\mit_and_isc_1.yml", "YAML", 0, 0, 0, 4, 0, 0, 1, 5
"d:\IDEWORK\lvmen\src\licensedcode\data\rules\mit_and_json_1.yml", "YAML", 0, 0, 0, 6, 0, 0, 1, 7
"d:\IDEWORK\lvmen\src\licensedcode\data\rules\mit_and_json_2.yml", "YAML", 0, 0, 0, 3, 0, 0, 1, 4
"d:\IDEWORK\lvmen\src\licensedcode\data\rules\mit_and_json_and_other-permissive.yml", "YAML", 0, 0, 0, 3, 0, 0, 1, 4
"d:\IDEWORK\lvmen\src\licensedcode\data\rules\mit_and_mpl-2.0_1.yml", "YAML", 0, 0, 0, 3, 0, 0, 1, 4
"d:\IDEWORK\lvmen\src\licensedcode\data\rules\mit_and_mpl-2.0_2.yml", "YAML", 0, 0, 0, 3, 0, 0, 1, 4
"d:\IDEWORK\lvmen\src\licensedcode\data\rules\mit_and_ofl-1.1_1.yml", "YAML", 0, 0, 0, 3, 0, 0, 1, 4
"d:\IDEWORK\lvmen\src\licensedcode\data\rules\mit_and_ofl-1.1_and_cc-by-4.0_1.yml", "YAML", 0, 0, 0, 5, 0, 0, 1, 6
"d:\IDEWORK\lvmen\src\licensedcode\data\rules\mit_and_ofl-1.1_and_cc-by-4.0_2.yml", "YAML", 0, 0, 0, 5, 0, 0, 1, 6
"d:\IDEWORK\lvmen\src\licensedcode\data\rules\mit_and_ofl-1.1_and_cc-by-4.0_3.yml", "YAML", 0, 0, 0, 8, 0, 0, 1, 9
"d:\IDEWORK\lvmen\src\licensedcode\data\rules\mit_and_other-permissive_1.yml", "YAML", 0, 0, 0, 4, 0, 0, 1, 5
"d:\IDEWORK\lvmen\src\licensedcode\data\rules\mit_and_other-permissive_2.yml", "YAML", 0, 0, 0, 4, 0, 0, 1, 5
"d:\IDEWORK\lvmen\src\licensedcode\data\rules\mit_and_other-permissive_and_other-copyleft_1.yml", "YAML", 0, 0, 0, 4, 0, 0, 1, 5
"d:\IDEWORK\lvmen\src\licensedcode\data\rules\mit_and_proprietary-license_1.yml", "YAML", 0, 0, 0, 3, 0, 0, 1, 4
"d:\IDEWORK\lvmen\src\licensedcode\data\rules\mit_and_proprietary-license_2.yml", "YAML", 0, 0, 0, 8, 0, 0, 1, 9
"d:\IDEWORK\lvmen\src\licensedcode\data\rules\mit_and_proprietary-license_3.yml", "YAML", 0, 0, 0, 7, 0, 0, 1, 8
"d:\IDEWORK\lvmen\src\licensedcode\data\rules\mit_and_proprietary-license_4.yml", "YAML", 0, 0, 0, 7, 0, 0, 1, 8
"d:\IDEWORK\lvmen\src\licensedcode\data\rules\mit_and_proprietary-license_5.yml", "YAML", 0, 0, 0, 2, 0, 0, 1, 3
"d:\IDEWORK\lvmen\src\licensedcode\data\rules\mit_and_ruby_or_gpl-2.0_1.yml", "YAML", 0, 0, 0, 7, 0, 0, 1, 8
"d:\IDEWORK\lvmen\src\licensedcode\data\rules\mit_and_unicode_1.yml", "YAML", 0, 0, 0, 8, 0, 0, 1, 9
"d:\IDEWORK\lvmen\src\licensedcode\data\rules\mit_and_unknown-license-reference_1.yml", "YAML", 0, 0, 0, 3, 0, 0, 1, 4
"d:\IDEWORK\lvmen\src\licensedcode\data\rules\mit_and_unknown-license-reference_2.yml", "YAML", 0, 0, 0, 4, 0, 0, 1, 5
"d:\IDEWORK\lvmen\src\licensedcode\data\rules\mit_and_unknown_nuget_url_1.yml", "YAML", 0, 0, 0, 5, 0, 0, 1, 6
"d:\IDEWORK\lvmen\src\licensedcode\data\rules\mit_and_wtfpl-2.0_1.yml", "YAML", 0, 0, 0, 5, 0, 0, 1, 6
"d:\IDEWORK\lvmen\src\licensedcode\data\rules\mit_and_zlib_1.yml", "YAML", 0, 0, 0, 3, 0, 0, 1, 4
"d:\IDEWORK\lvmen\src\licensedcode\data\rules\mit_and_zlib_2.yml", "YAML", 0, 0, 0, 3, 0, 0, 1, 4
"d:\IDEWORK\lvmen\src\licensedcode\data\rules\mit_and_zlib_nuget_url_1.yml", "YAML", 0, 0, 0, 5, 0, 0, 1, 6
"d:\IDEWORK\lvmen\src\licensedcode\data\rules\mit_atomic.yml", "YAML", 0, 0, 0, 5, 0, 0, 1, 6
"d:\IDEWORK\lvmen\src\licensedcode\data\rules\mit_augur.yml", "YAML", 0, 0, 0, 5, 0, 0, 1, 6
"d:\IDEWORK\lvmen\src\licensedcode\data\rules\mit_by_request.yml", "YAML", 0, 0, 0, 3, 0, 0, 1, 4
"d:\IDEWORK\lvmen\src\licensedcode\data\rules\mit_choice_from_mit_or_gpl-2.0_1.yml", "YAML", 0, 0, 0, 2, 0, 0, 1, 3
"d:\IDEWORK\lvmen\src\licensedcode\data\rules\mit_dist.yml", "YAML", 0, 0, 0, 3, 0, 0, 1, 4
"d:\IDEWORK\lvmen\src\licensedcode\data\rules\mit_doctrine.yml", "YAML", 0, 0, 0, 5, 0, 0, 1, 6
"d:\IDEWORK\lvmen\src\licensedcode\data\rules\mit_file.yml", "YAML", 0, 0, 0, 5, 0, 0, 1, 6
"d:\IDEWORK\lvmen\src\licensedcode\data\rules\mit_file2.yml", "YAML", 0, 0, 0, 5, 0, 0, 1, 6
"d:\IDEWORK\lvmen\src\licensedcode\data\rules\mit_fluendo.yml", "YAML", 0, 0, 0, 3, 0, 0, 1, 4
"d:\IDEWORK\lvmen\src\licensedcode\data\rules\mit_fluendo1.yml", "YAML", 0, 0, 0, 3, 0, 0, 1, 4
"d:\IDEWORK\lvmen\src\licensedcode\data\rules\mit_fluendo2.yml", "YAML", 0, 0, 0, 3, 0, 0, 1, 4
"d:\IDEWORK\lvmen\src\licensedcode\data\rules\mit_fluendo4.yml", "YAML", 0, 0, 0, 7, 0, 0, 1, 8
"d:\IDEWORK\lvmen\src\licensedcode\data\rules\mit_freely.yml", "YAML", 0, 0, 0, 3, 0, 0, 1, 4
"d:\IDEWORK\lvmen\src\licensedcode\data\rules\mit_ibm2.yml", "YAML", 0, 0, 0, 3, 0, 0, 1, 4
"d:\IDEWORK\lvmen\src\licensedcode\data\rules\mit_ibm3.yml", "YAML", 0, 0, 0, 3, 0, 0, 1, 4
"d:\IDEWORK\lvmen\src\licensedcode\data\rules\mit_in_npm_1.yml", "YAML", 0, 0, 0, 5, 0, 0, 1, 6
"d:\IDEWORK\lvmen\src\licensedcode\data\rules\mit_jquery_url.yml", "YAML", 0, 0, 0, 6, 0, 0, 1, 7
"d:\IDEWORK\lvmen\src\licensedcode\data\rules\mit_jquery_url2.yml", "YAML", 0, 0, 0, 6, 0, 0, 1, 7
"d:\IDEWORK\lvmen\src\licensedcode\data\rules\mit_k.yml", "YAML", 0, 0, 0, 3, 0, 0, 1, 4
"d:\IDEWORK\lvmen\src\licensedcode\data\rules\mit_license-reference_58.yml", "YAML", 0, 0, 0, 6, 0, 0, 1, 7
"d:\IDEWORK\lvmen\src\licensedcode\data\rules\mit_license.yml", "YAML", 0, 0, 0, 5, 0, 0, 1, 6
"d:\IDEWORK\lvmen\src\licensedcode\data\rules\mit_licensed.yml", "YAML", 0, 0, 0, 3, 0, 0, 1, 4
"d:\IDEWORK\lvmen\src\licensedcode\data\rules\mit_licensed2.yml", "YAML", 0, 0, 0, 5, 0, 0, 1, 6
"d:\IDEWORK\lvmen\src\licensedcode\data\rules\mit_nfa.yml", "YAML", 0, 0, 0, 2, 0, 0, 1, 3
"d:\IDEWORK\lvmen\src\licensedcode\data\rules\mit_not_apache-2.0.yml", "YAML", 0, 0, 0, 5, 0, 0, 1, 6
"d:\IDEWORK\lvmen\src\licensedcode\data\rules\mit_not_unknown_1.yml", "YAML", 0, 0, 0, 6, 0, 0, 0, 6
"d:\IDEWORK\lvmen\src\licensedcode\data\rules\mit_nuget_url_1.yml", "YAML", 0, 0, 0, 5, 0, 0, 1, 6
"d:\IDEWORK\lvmen\src\licensedcode\data\rules\mit_nuget_url_10.yml", "YAML", 0, 0, 0, 5, 0, 0, 1, 6
"d:\IDEWORK\lvmen\src\licensedcode\data\rules\mit_nuget_url_100.yml", "YAML", 0, 0, 0, 5, 0, 0, 1, 6
"d:\IDEWORK\lvmen\src\licensedcode\data\rules\mit_nuget_url_101.yml", "YAML", 0, 0, 0, 5, 0, 0, 1, 6
"d:\IDEWORK\lvmen\src\licensedcode\data\rules\mit_nuget_url_102.yml", "YAML", 0, 0, 0, 5, 0, 0, 1, 6
"d:\IDEWORK\lvmen\src\licensedcode\data\rules\mit_nuget_url_103.yml", "YAML", 0, 0, 0, 5, 0, 0, 1, 6
"d:\IDEWORK\lvmen\src\licensedcode\data\rules\mit_nuget_url_104.yml", "YAML", 0, 0, 0, 5, 0, 0, 1, 6
"d:\IDEWORK\lvmen\src\licensedcode\data\rules\mit_nuget_url_105.yml", "YAML", 0, 0, 0, 5, 0, 0, 1, 6
"d:\IDEWORK\lvmen\src\licensedcode\data\rules\mit_nuget_url_106.yml", "YAML", 0, 0, 0, 5, 0, 0, 1, 6
"d:\IDEWORK\lvmen\src\licensedcode\data\rules\mit_nuget_url_107.yml", "YAML", 0, 0, 0, 5, 0, 0, 1, 6
"d:\IDEWORK\lvmen\src\licensedcode\data\rules\mit_nuget_url_108.yml", "YAML", 0, 0, 0, 5, 0, 0, 1, 6
"d:\IDEWORK\lvmen\src\licensedcode\data\rules\mit_nuget_url_109.yml", "YAML", 0, 0, 0, 5, 0, 0, 1, 6
"d:\IDEWORK\lvmen\src\licensedcode\data\rules\mit_nuget_url_11.yml", "YAML", 0, 0, 0, 5, 0, 0, 1, 6
"d:\IDEWORK\lvmen\src\licensedcode\data\rules\mit_nuget_url_110.yml", "YAML", 0, 0, 0, 5, 0, 0, 1, 6
"d:\IDEWORK\lvmen\src\licensedcode\data\rules\mit_nuget_url_111.yml", "YAML", 0, 0, 0, 5, 0, 0, 1, 6
"d:\IDEWORK\lvmen\src\licensedcode\data\rules\mit_nuget_url_112.yml", "YAML", 0, 0, 0, 5, 0, 0, 1, 6
"d:\IDEWORK\lvmen\src\licensedcode\data\rules\mit_nuget_url_113.yml", "YAML", 0, 0, 0, 5, 0, 0, 1, 6
"d:\IDEWORK\lvmen\src\licensedcode\data\rules\mit_nuget_url_114.yml", "YAML", 0, 0, 0, 5, 0, 0, 1, 6
"d:\IDEWORK\lvmen\src\licensedcode\data\rules\mit_nuget_url_115.yml", "YAML", 0, 0, 0, 5, 0, 0, 1, 6
"d:\IDEWORK\lvmen\src\licensedcode\data\rules\mit_nuget_url_116.yml", "YAML", 0, 0, 0, 5, 0, 0, 1, 6
"d:\IDEWORK\lvmen\src\licensedcode\data\rules\mit_nuget_url_117.yml", "YAML", 0, 0, 0, 5, 0, 0, 1, 6
"d:\IDEWORK\lvmen\src\licensedcode\data\rules\mit_nuget_url_118.yml", "YAML", 0, 0, 0, 5, 0, 0, 1, 6
"d:\IDEWORK\lvmen\src\licensedcode\data\rules\mit_nuget_url_119.yml", "YAML", 0, 0, 0, 5, 0, 0, 1, 6
"d:\IDEWORK\lvmen\src\licensedcode\data\rules\mit_nuget_url_12.yml", "YAML", 0, 0, 0, 5, 0, 0, 1, 6
"d:\IDEWORK\lvmen\src\licensedcode\data\rules\mit_nuget_url_120.yml", "YAML", 0, 0, 0, 5, 0, 0, 1, 6
"d:\IDEWORK\lvmen\src\licensedcode\data\rules\mit_nuget_url_121.yml", "YAML", 0, 0, 0, 5, 0, 0, 1, 6
"d:\IDEWORK\lvmen\src\licensedcode\data\rules\mit_nuget_url_122.yml", "YAML", 0, 0, 0, 5, 0, 0, 1, 6
"d:\IDEWORK\lvmen\src\licensedcode\data\rules\mit_nuget_url_123.yml", "YAML", 0, 0, 0, 5, 0, 0, 1, 6
"d:\IDEWORK\lvmen\src\licensedcode\data\rules\mit_nuget_url_124.yml", "YAML", 0, 0, 0, 5, 0, 0, 1, 6
"d:\IDEWORK\lvmen\src\licensedcode\data\rules\mit_nuget_url_125.yml", "YAML", 0, 0, 0, 5, 0, 0, 1, 6
"d:\IDEWORK\lvmen\src\licensedcode\data\rules\mit_nuget_url_126.yml", "YAML", 0, 0, 0, 5, 0, 0, 1, 6
"d:\IDEWORK\lvmen\src\licensedcode\data\rules\mit_nuget_url_127.yml", "YAML", 0, 0, 0, 5, 0, 0, 1, 6
"d:\IDEWORK\lvmen\src\licensedcode\data\rules\mit_nuget_url_128.yml", "YAML", 0, 0, 0, 5, 0, 0, 1, 6
"d:\IDEWORK\lvmen\src\licensedcode\data\rules\mit_nuget_url_129.yml", "YAML", 0, 0, 0, 5, 0, 0, 1, 6
"d:\IDEWORK\lvmen\src\licensedcode\data\rules\mit_nuget_url_13.yml", "YAML", 0, 0, 0, 5, 0, 0, 1, 6
"d:\IDEWORK\lvmen\src\licensedcode\data\rules\mit_nuget_url_130.yml", "YAML", 0, 0, 0, 5, 0, 0, 1, 6
"d:\IDEWORK\lvmen\src\licensedcode\data\rules\mit_nuget_url_14.yml", "YAML", 0, 0, 0, 5, 0, 0, 1, 6
"d:\IDEWORK\lvmen\src\licensedcode\data\rules\mit_nuget_url_15.yml", "YAML", 0, 0, 0, 5, 0, 0, 1, 6
"d:\IDEWORK\lvmen\src\licensedcode\data\rules\mit_nuget_url_16.yml", "YAML", 0, 0, 0, 5, 0, 0, 1, 6
"d:\IDEWORK\lvmen\src\licensedcode\data\rules\mit_nuget_url_17.yml", "YAML", 0, 0, 0, 5, 0, 0, 1, 6
"d:\IDEWORK\lvmen\src\licensedcode\data\rules\mit_nuget_url_18.yml", "YAML", 0, 0, 0, 5, 0, 0, 1, 6
"d:\IDEWORK\lvmen\src\licensedcode\data\rules\mit_nuget_url_19.yml", "YAML", 0, 0, 0, 5, 0, 0, 1, 6
"d:\IDEWORK\lvmen\src\licensedcode\data\rules\mit_nuget_url_2.yml", "YAML", 0, 0, 0, 5, 0, 0, 1, 6
"d:\IDEWORK\lvmen\src\licensedcode\data\rules\mit_nuget_url_20.yml", "YAML", 0, 0, 0, 5, 0, 0, 1, 6
"d:\IDEWORK\lvmen\src\licensedcode\data\rules\mit_nuget_url_21.yml", "YAML", 0, 0, 0, 5, 0, 0, 1, 6
"d:\IDEWORK\lvmen\src\licensedcode\data\rules\mit_nuget_url_22.yml", "YAML", 0, 0, 0, 5, 0, 0, 1, 6
"d:\IDEWORK\lvmen\src\licensedcode\data\rules\mit_nuget_url_23.yml", "YAML", 0, 0, 0, 5, 0, 0, 1, 6
"d:\IDEWORK\lvmen\src\licensedcode\data\rules\mit_nuget_url_24.yml", "YAML", 0, 0, 0, 5, 0, 0, 1, 6
"d:\IDEWORK\lvmen\src\licensedcode\data\rules\mit_nuget_url_25.yml", "YAML", 0, 0, 0, 5, 0, 0, 1, 6
"d:\IDEWORK\lvmen\src\licensedcode\data\rules\mit_nuget_url_26.yml", "YAML", 0, 0, 0, 5, 0, 0, 1, 6
"d:\IDEWORK\lvmen\src\licensedcode\data\rules\mit_nuget_url_27.yml", "YAML", 0, 0, 0, 5, 0, 0, 1, 6
"d:\IDEWORK\lvmen\src\licensedcode\data\rules\mit_nuget_url_28.yml", "YAML", 0, 0, 0, 5, 0, 0, 1, 6
"d:\IDEWORK\lvmen\src\licensedcode\data\rules\mit_nuget_url_29.yml", "YAML", 0, 0, 0, 5, 0, 0, 1, 6
"d:\IDEWORK\lvmen\src\licensedcode\data\rules\mit_nuget_url_3.yml", "YAML", 0, 0, 0, 5, 0, 0, 1, 6
"d:\IDEWORK\lvmen\src\licensedcode\data\rules\mit_nuget_url_30.yml", "YAML", 0, 0, 0, 5, 0, 0, 1, 6
"d:\IDEWORK\lvmen\src\licensedcode\data\rules\mit_nuget_url_31.yml", "YAML", 0, 0, 0, 5, 0, 0, 1, 6
"d:\IDEWORK\lvmen\src\licensedcode\data\rules\mit_nuget_url_32.yml", "YAML", 0, 0, 0, 5, 0, 0, 1, 6
"d:\IDEWORK\lvmen\src\licensedcode\data\rules\mit_nuget_url_33.yml", "YAML", 0, 0, 0, 5, 0, 0, 1, 6
"d:\IDEWORK\lvmen\src\licensedcode\data\rules\mit_nuget_url_34.yml", "YAML", 0, 0, 0, 5, 0, 0, 1, 6
"d:\IDEWORK\lvmen\src\licensedcode\data\rules\mit_nuget_url_35.yml", "YAML", 0, 0, 0, 5, 0, 0, 1, 6
"d:\IDEWORK\lvmen\src\licensedcode\data\rules\mit_nuget_url_36.yml", "YAML", 0, 0, 0, 5, 0, 0, 1, 6
"d:\IDEWORK\lvmen\src\licensedcode\data\rules\mit_nuget_url_37.yml", "YAML", 0, 0, 0, 5, 0, 0, 1, 6
"d:\IDEWORK\lvmen\src\licensedcode\data\rules\mit_nuget_url_38.yml", "YAML", 0, 0, 0, 5, 0, 0, 1, 6
"d:\IDEWORK\lvmen\src\licensedcode\data\rules\mit_nuget_url_39.yml", "YAML", 0, 0, 0, 5, 0, 0, 1, 6
"d:\IDEWORK\lvmen\src\licensedcode\data\rules\mit_nuget_url_4.yml", "YAML", 0, 0, 0, 5, 0, 0, 1, 6
"d:\IDEWORK\lvmen\src\licensedcode\data\rules\mit_nuget_url_40.yml", "YAML", 0, 0, 0, 5, 0, 0, 1, 6
"d:\IDEWORK\lvmen\src\licensedcode\data\rules\mit_nuget_url_41.yml", "YAML", 0, 0, 0, 5, 0, 0, 1, 6
"d:\IDEWORK\lvmen\src\licensedcode\data\rules\mit_nuget_url_42.yml", "YAML", 0, 0, 0, 5, 0, 0, 1, 6
"d:\IDEWORK\lvmen\src\licensedcode\data\rules\mit_nuget_url_43.yml", "YAML", 0, 0, 0, 5, 0, 0, 1, 6
"d:\IDEWORK\lvmen\src\licensedcode\data\rules\mit_nuget_url_44.yml", "YAML", 0, 0, 0, 5, 0, 0, 1, 6
"d:\IDEWORK\lvmen\src\licensedcode\data\rules\mit_nuget_url_45.yml", "YAML", 0, 0, 0, 5, 0, 0, 1, 6
"d:\IDEWORK\lvmen\src\licensedcode\data\rules\mit_nuget_url_46.yml", "YAML", 0, 0, 0, 5, 0, 0, 1, 6
"d:\IDEWORK\lvmen\src\licensedcode\data\rules\mit_nuget_url_47.yml", "YAML", 0, 0, 0, 5, 0, 0, 1, 6
"d:\IDEWORK\lvmen\src\licensedcode\data\rules\mit_nuget_url_48.yml", "YAML", 0, 0, 0, 5, 0, 0, 1, 6
"d:\IDEWORK\lvmen\src\licensedcode\data\rules\mit_nuget_url_49.yml", "YAML", 0, 0, 0, 5, 0, 0, 1, 6
"d:\IDEWORK\lvmen\src\licensedcode\data\rules\mit_nuget_url_5.yml", "YAML", 0, 0, 0, 5, 0, 0, 1, 6
"d:\IDEWORK\lvmen\src\licensedcode\data\rules\mit_nuget_url_50.yml", "YAML", 0, 0, 0, 5, 0, 0, 1, 6
"d:\IDEWORK\lvmen\src\licensedcode\data\rules\mit_nuget_url_51.yml", "YAML", 0, 0, 0, 5, 0, 0, 1, 6
"d:\IDEWORK\lvmen\src\licensedcode\data\rules\mit_nuget_url_52.yml", "YAML", 0, 0, 0, 5, 0, 0, 1, 6
"d:\IDEWORK\lvmen\src\licensedcode\data\rules\mit_nuget_url_53.yml", "YAML", 0, 0, 0, 5, 0, 0, 1, 6
"d:\IDEWORK\lvmen\src\licensedcode\data\rules\mit_nuget_url_54.yml", "YAML", 0, 0, 0, 5, 0, 0, 1, 6
"d:\IDEWORK\lvmen\src\licensedcode\data\rules\mit_nuget_url_55.yml", "YAML", 0, 0, 0, 5, 0, 0, 1, 6
"d:\IDEWORK\lvmen\src\licensedcode\data\rules\mit_nuget_url_56.yml", "YAML", 0, 0, 0, 5, 0, 0, 1, 6
"d:\IDEWORK\lvmen\src\licensedcode\data\rules\mit_nuget_url_57.yml", "YAML", 0, 0, 0, 5, 0, 0, 1, 6
"d:\IDEWORK\lvmen\src\licensedcode\data\rules\mit_nuget_url_58.yml", "YAML", 0, 0, 0, 5, 0, 0, 1, 6
"d:\IDEWORK\lvmen\src\licensedcode\data\rules\mit_nuget_url_59.yml", "YAML", 0, 0, 0, 5, 0, 0, 1, 6
"d:\IDEWORK\lvmen\src\licensedcode\data\rules\mit_nuget_url_6.yml", "YAML", 0, 0, 0, 5, 0, 0, 1, 6
"d:\IDEWORK\lvmen\src\licensedcode\data\rules\mit_nuget_url_60.yml", "YAML", 0, 0, 0, 5, 0, 0, 1, 6
"d:\IDEWORK\lvmen\src\licensedcode\data\rules\mit_nuget_url_61.yml", "YAML", 0, 0, 0, 5, 0, 0, 1, 6
"d:\IDEWORK\lvmen\src\licensedcode\data\rules\mit_nuget_url_62.yml", "YAML", 0, 0, 0, 5, 0, 0, 1, 6
"d:\IDEWORK\lvmen\src\licensedcode\data\rules\mit_nuget_url_63.yml", "YAML", 0, 0, 0, 5, 0, 0, 1, 6
"d:\IDEWORK\lvmen\src\licensedcode\data\rules\mit_nuget_url_64.yml", "YAML", 0, 0, 0, 5, 0, 0, 1, 6
"d:\IDEWORK\lvmen\src\licensedcode\data\rules\mit_nuget_url_65.yml", "YAML", 0, 0, 0, 5, 0, 0, 1, 6
"d:\IDEWORK\lvmen\src\licensedcode\data\rules\mit_nuget_url_66.yml", "YAML", 0, 0, 0, 5, 0, 0, 1, 6
"d:\IDEWORK\lvmen\src\licensedcode\data\rules\mit_nuget_url_67.yml", "YAML", 0, 0, 0, 5, 0, 0, 1, 6
"d:\IDEWORK\lvmen\src\licensedcode\data\rules\mit_nuget_url_68.yml", "YAML", 0, 0, 0, 5, 0, 0, 1, 6
"d:\IDEWORK\lvmen\src\licensedcode\data\rules\mit_nuget_url_69.yml", "YAML", 0, 0, 0, 5, 0, 0, 1, 6
"d:\IDEWORK\lvmen\src\licensedcode\data\rules\mit_nuget_url_7.yml", "YAML", 0, 0, 0, 5, 0, 0, 1, 6
"d:\IDEWORK\lvmen\src\licensedcode\data\rules\mit_nuget_url_70.yml", "YAML", 0, 0, 0, 5, 0, 0, 1, 6
"d:\IDEWORK\lvmen\src\licensedcode\data\rules\mit_nuget_url_71.yml", "YAML", 0, 0, 0, 5, 0, 0, 1, 6
"d:\IDEWORK\lvmen\src\licensedcode\data\rules\mit_nuget_url_72.yml", "YAML", 0, 0, 0, 5, 0, 0, 1, 6
"d:\IDEWORK\lvmen\src\licensedcode\data\rules\mit_nuget_url_73.yml", "YAML", 0, 0, 0, 5, 0, 0, 1, 6
"d:\IDEWORK\lvmen\src\licensedcode\data\rules\mit_nuget_url_74.yml", "YAML", 0, 0, 0, 5, 0, 0, 1, 6
"d:\IDEWORK\lvmen\src\licensedcode\data\rules\mit_nuget_url_75.yml", "YAML", 0, 0, 0, 5, 0, 0, 1, 6
"d:\IDEWORK\lvmen\src\licensedcode\data\rules\mit_nuget_url_76.yml", "YAML", 0, 0, 0, 5, 0, 0, 1, 6
"d:\IDEWORK\lvmen\src\licensedcode\data\rules\mit_nuget_url_77.yml", "YAML", 0, 0, 0, 5, 0, 0, 1, 6
"d:\IDEWORK\lvmen\src\licensedcode\data\rules\mit_nuget_url_78.yml", "YAML", 0, 0, 0, 5, 0, 0, 1, 6
"d:\IDEWORK\lvmen\src\licensedcode\data\rules\mit_nuget_url_79.yml", "YAML", 0, 0, 0, 5, 0, 0, 1, 6
"d:\IDEWORK\lvmen\src\licensedcode\data\rules\mit_nuget_url_8.yml", "YAML", 0, 0, 0, 5, 0, 0, 1, 6
"d:\IDEWORK\lvmen\src\licensedcode\data\rules\mit_nuget_url_80.yml", "YAML", 0, 0, 0, 5, 0, 0, 1, 6
"d:\IDEWORK\lvmen\src\licensedcode\data\rules\mit_nuget_url_81.yml", "YAML", 0, 0, 0, 5, 0, 0, 1, 6
"d:\IDEWORK\lvmen\src\licensedcode\data\rules\mit_nuget_url_82.yml", "YAML", 0, 0, 0, 5, 0, 0, 1, 6
"d:\IDEWORK\lvmen\src\licensedcode\data\rules\mit_nuget_url_83.yml", "YAML", 0, 0, 0, 5, 0, 0, 1, 6
"d:\IDEWORK\lvmen\src\licensedcode\data\rules\mit_nuget_url_84.yml", "YAML", 0, 0, 0, 5, 0, 0, 1, 6
"d:\IDEWORK\lvmen\src\licensedcode\data\rules\mit_nuget_url_85.yml", "YAML", 0, 0, 0, 5, 0, 0, 1, 6
"d:\IDEWORK\lvmen\src\licensedcode\data\rules\mit_nuget_url_86.yml", "YAML", 0, 0, 0, 5, 0, 0, 1, 6
"d:\IDEWORK\lvmen\src\licensedcode\data\rules\mit_nuget_url_87.yml", "YAML", 0, 0, 0, 5, 0, 0, 1, 6
"d:\IDEWORK\lvmen\src\licensedcode\data\rules\mit_nuget_url_88.yml", "YAML", 0, 0, 0, 5, 0, 0, 1, 6
"d:\IDEWORK\lvmen\src\licensedcode\data\rules\mit_nuget_url_89.yml", "YAML", 0, 0, 0, 5, 0, 0, 1, 6
"d:\IDEWORK\lvmen\src\licensedcode\data\rules\mit_nuget_url_9.yml", "YAML", 0, 0, 0, 5, 0, 0, 1, 6
"d:\IDEWORK\lvmen\src\licensedcode\data\rules\mit_nuget_url_90.yml", "YAML", 0, 0, 0, 5, 0, 0, 1, 6
"d:\IDEWORK\lvmen\src\licensedcode\data\rules\mit_nuget_url_91.yml", "YAML", 0, 0, 0, 5, 0, 0, 1, 6
"d:\IDEWORK\lvmen\src\licensedcode\data\rules\mit_nuget_url_92.yml", "YAML", 0, 0, 0, 5, 0, 0, 1, 6
"d:\IDEWORK\lvmen\src\licensedcode\data\rules\mit_nuget_url_93.yml", "YAML", 0, 0, 0, 5, 0, 0, 1, 6
"d:\IDEWORK\lvmen\src\licensedcode\data\rules\mit_nuget_url_94.yml", "YAML", 0, 0, 0, 5, 0, 0, 1, 6
"d:\IDEWORK\lvmen\src\licensedcode\data\rules\mit_nuget_url_95.yml", "YAML", 0, 0, 0, 5, 0, 0, 1, 6
"d:\IDEWORK\lvmen\src\licensedcode\data\rules\mit_nuget_url_96.yml", "YAML", 0, 0, 0, 5, 0, 0, 1, 6
"d:\IDEWORK\lvmen\src\licensedcode\data\rules\mit_nuget_url_97.yml", "YAML", 0, 0, 0, 5, 0, 0, 1, 6
"d:\IDEWORK\lvmen\src\licensedcode\data\rules\mit_nuget_url_98.yml", "YAML", 0, 0, 0, 5, 0, 0, 1, 6
"d:\IDEWORK\lvmen\src\licensedcode\data\rules\mit_nuget_url_99.yml", "YAML", 0, 0, 0, 5, 0, 0, 1, 6
"d:\IDEWORK\lvmen\src\licensedcode\data\rules\mit_or_afl-2.1_or_python_1.yml", "YAML", 0, 0, 0, 3, 0, 0, 1, 4
"d:\IDEWORK\lvmen\src\licensedcode\data\rules\mit_or_agpl-1.0_1.yml", "YAML", 0, 0, 0, 5, 0, 0, 1, 6
"d:\IDEWORK\lvmen\src\licensedcode\data\rules\mit_or_agpl-1.0_2.yml", "YAML", 0, 0, 0, 6, 0, 0, 1, 7
"d:\IDEWORK\lvmen\src\licensedcode\data\rules\mit_or_apache-2.0_1.yml", "YAML", 0, 0, 0, 3, 0, 0, 1, 4
"d:\IDEWORK\lvmen\src\licensedcode\data\rules\mit_or_apache-2.0_10.yml", "YAML", 0, 0, 0, 3, 0, 0, 1, 4
"d:\IDEWORK\lvmen\src\licensedcode\data\rules\mit_or_apache-2.0_11.yml", "YAML", 0, 0, 0, 3, 0, 0, 1, 4
"d:\IDEWORK\lvmen\src\licensedcode\data\rules\mit_or_apache-2.0_12.yml", "YAML", 0, 0, 0, 3, 0, 0, 1, 4
"d:\IDEWORK\lvmen\src\licensedcode\data\rules\mit_or_apache-2.0_13.yml", "YAML", 0, 0, 0, 3, 0, 0, 1, 4
"d:\IDEWORK\lvmen\src\licensedcode\data\rules\mit_or_apache-2.0_14.yml", "YAML", 0, 0, 0, 3, 0, 0, 1, 4
"d:\IDEWORK\lvmen\src\licensedcode\data\rules\mit_or_apache-2.0_15.yml", "YAML", 0, 0, 0, 3, 0, 0, 1, 4
"d:\IDEWORK\lvmen\src\licensedcode\data\rules\mit_or_apache-2.0_16.yml", "YAML", 0, 0, 0, 5, 0, 0, 1, 6
"d:\IDEWORK\lvmen\src\licensedcode\data\rules\mit_or_apache-2.0_17.yml", "YAML", 0, 0, 0, 10, 0, 0, 1, 11
"d:\IDEWORK\lvmen\src\licensedcode\data\rules\mit_or_apache-2.0_18.yml", "YAML", 0, 0, 0, 10, 0, 0, 1, 11
"d:\IDEWORK\lvmen\src\licensedcode\data\rules\mit_or_apache-2.0_19.yml", "YAML", 0, 0, 0, 10, 0, 0, 1, 11
"d:\IDEWORK\lvmen\src\licensedcode\data\rules\mit_or_apache-2.0_2.yml", "YAML", 0, 0, 0, 10, 0, 0, 1, 11
"d:\IDEWORK\lvmen\src\licensedcode\data\rules\mit_or_apache-2.0_20.yml", "YAML", 0, 0, 0, 10, 0, 0, 1, 11
"d:\IDEWORK\lvmen\src\licensedcode\data\rules\mit_or_apache-2.0_21.yml", "YAML", 0, 0, 0, 7, 0, 0, 1, 8
"d:\IDEWORK\lvmen\src\licensedcode\data\rules\mit_or_apache-2.0_3.yml", "YAML", 0, 0, 0, 4, 0, 0, 1, 5
"d:\IDEWORK\lvmen\src\licensedcode\data\rules\mit_or_apache-2.0_4.yml", "YAML", 0, 0, 0, 10, 0, 0, 1, 11
"d:\IDEWORK\lvmen\src\licensedcode\data\rules\mit_or_apache-2.0_5.yml", "YAML", 0, 0, 0, 6, 0, 0, 1, 7
"d:\IDEWORK\lvmen\src\licensedcode\data\rules\mit_or_apache-2.0_6.yml", "YAML", 0, 0, 0, 10, 0, 0, 1, 11
"d:\IDEWORK\lvmen\src\licensedcode\data\rules\mit_or_apache-2.0_7.yml", "YAML", 0, 0, 0, 10, 0, 0, 1, 11
"d:\IDEWORK\lvmen\src\licensedcode\data\rules\mit_or_apache-2.0_8.yml", "YAML", 0, 0, 0, 4, 0, 0, 1, 5
"d:\IDEWORK\lvmen\src\licensedcode\data\rules\mit_or_apache-2.0_9.yml", "YAML", 0, 0, 0, 6, 0, 0, 1, 7
"d:\IDEWORK\lvmen\src\licensedcode\data\rules\mit_or_apache-2.0_and_other-permissive_1.yml", "YAML", 0, 0, 0, 7, 0, 0, 1, 8
"d:\IDEWORK\lvmen\src\licensedcode\data\rules\mit_or_apache-2.0_and_other-permissive_2.yml", "YAML", 0, 0, 0, 4, 0, 0, 1, 5
"d:\IDEWORK\lvmen\src\licensedcode\data\rules\mit_or_apache-2.0_and_other-permissive_3.yml", "YAML", 0, 0, 0, 8, 0, 0, 1, 9
"d:\IDEWORK\lvmen\src\licensedcode\data\rules\mit_or_apache-2.0_and_other-permissive_4.yml", "YAML", 0, 0, 0, 8, 0, 0, 1, 9
"d:\IDEWORK\lvmen\src\licensedcode\data\rules\mit_or_artistic-perl-1.0_or_gpl-1.0-plus_1.yml", "YAML", 0, 0, 0, 4, 0, 0, 1, 5
"d:\IDEWORK\lvmen\src\licensedcode\data\rules\mit_or_beerware_1.yml", "YAML", 0, 0, 0, 3, 0, 0, 1, 4
"d:\IDEWORK\lvmen\src\licensedcode\data\rules\mit_or_boost-1.0_1.yml", "YAML", 0, 0, 0, 8, 0, 0, 1, 9
"d:\IDEWORK\lvmen\src\licensedcode\data\rules\mit_or_bsd-new_1.yml", "YAML", 0, 0, 0, 3, 0, 0, 1, 4
"d:\IDEWORK\lvmen\src\licensedcode\data\rules\mit_or_bsd-new_or_gpl-1.0-plus_1.yml", "YAML", 0, 0, 0, 4, 0, 0, 1, 5
"d:\IDEWORK\lvmen\src\licensedcode\data\rules\mit_or_bsd-new_or_gpl-1.0-plus_2.yml", "YAML", 0, 0, 0, 3, 0, 0, 1, 4
"d:\IDEWORK\lvmen\src\licensedcode\data\rules\mit_or_bsd-zero_or_cc0-1.0_1.yml", "YAML", 0, 0, 0, 3, 0, 0, 1, 4
"d:\IDEWORK\lvmen\src\licensedcode\data\rules\mit_or_cc0-1.0_1.yml", "YAML", 0, 0, 0, 3, 0, 0, 1, 4
"d:\IDEWORK\lvmen\src\licensedcode\data\rules\mit_or_cddl-1.0_1.yml", "YAML", 0, 0, 0, 3, 0, 0, 1, 4
"d:\IDEWORK\lvmen\src\licensedcode\data\rules\mit_or_commercial-option.yml", "YAML", 0, 0, 0, 2, 0, 0, 1, 3
"d:\IDEWORK\lvmen\src\licensedcode\data\rules\mit_or_commercial-option_1.yml", "YAML", 0, 0, 0, 5, 0, 0, 1, 6
"d:\IDEWORK\lvmen\src\licensedcode\data\rules\mit_or_gpl-1.0-plus_1.yml", "YAML", 0, 0, 0, 6, 0, 0, 1, 7
"d:\IDEWORK\lvmen\src\licensedcode\data\rules\mit_or_gpl-1.0-plus_10.yml", "YAML", 0, 0, 0, 6, 0, 0, 1, 7
"d:\IDEWORK\lvmen\src\licensedcode\data\rules\mit_or_gpl-1.0-plus_11.yml", "YAML", 0, 0, 0, 6, 0, 0, 1, 7
"d:\IDEWORK\lvmen\src\licensedcode\data\rules\mit_or_gpl-1.0-plus_12.yml", "YAML", 0, 0, 0, 6, 0, 0, 1, 7
"d:\IDEWORK\lvmen\src\licensedcode\data\rules\mit_or_gpl-1.0-plus_13.yml", "YAML", 0, 0, 0, 6, 0, 0, 1, 7
"d:\IDEWORK\lvmen\src\licensedcode\data\rules\mit_or_gpl-1.0-plus_14.yml", "YAML", 0, 0, 0, 3, 0, 0, 1, 4
"d:\IDEWORK\lvmen\src\licensedcode\data\rules\mit_or_gpl-1.0-plus_15.yml", "YAML", 0, 0, 0, 3, 0, 0, 1, 4
"d:\IDEWORK\lvmen\src\licensedcode\data\rules\mit_or_gpl-1.0-plus_16.yml", "YAML", 0, 0, 0, 3, 0, 0, 1, 4
"d:\IDEWORK\lvmen\src\licensedcode\data\rules\mit_or_gpl-1.0-plus_17.yml", "YAML", 0, 0, 0, 3, 0, 0, 1, 4
"d:\IDEWORK\lvmen\src\licensedcode\data\rules\mit_or_gpl-1.0-plus_18.yml", "YAML", 0, 0, 0, 3, 0, 0, 1, 4
"d:\IDEWORK\lvmen\src\licensedcode\data\rules\mit_or_gpl-1.0-plus_19.yml", "YAML", 0, 0, 0, 3, 0, 0, 1, 4
"d:\IDEWORK\lvmen\src\licensedcode\data\rules\mit_or_gpl-1.0-plus_2.yml", "YAML", 0, 0, 0, 6, 0, 0, 1, 7
"d:\IDEWORK\lvmen\src\licensedcode\data\rules\mit_or_gpl-1.0-plus_20.yml", "YAML", 0, 0, 0, 3, 0, 0, 1, 4
"d:\IDEWORK\lvmen\src\licensedcode\data\rules\mit_or_gpl-1.0-plus_21.yml", "YAML", 0, 0, 0, 6, 0, 0, 1, 7
"d:\IDEWORK\lvmen\src\licensedcode\data\rules\mit_or_gpl-1.0-plus_22.yml", "YAML", 0, 0, 0, 6, 0, 0, 1, 7
"d:\IDEWORK\lvmen\src\licensedcode\data\rules\mit_or_gpl-1.0-plus_23.yml", "YAML", 0, 0, 0, 6, 0, 0, 1, 7
"d:\IDEWORK\lvmen\src\licensedcode\data\rules\mit_or_gpl-1.0-plus_24.yml", "YAML", 0, 0, 0, 6, 0, 0, 1, 7
"d:\IDEWORK\lvmen\src\licensedcode\data\rules\mit_or_gpl-1.0-plus_25.yml", "YAML", 0, 0, 0, 6, 0, 0, 1, 7
"d:\IDEWORK\lvmen\src\licensedcode\data\rules\mit_or_gpl-1.0-plus_26.yml", "YAML", 0, 0, 0, 6, 0, 0, 1, 7
"d:\IDEWORK\lvmen\src\licensedcode\data\rules\mit_or_gpl-1.0-plus_27.yml", "YAML", 0, 0, 0, 7, 0, 0, 1, 8
"d:\IDEWORK\lvmen\src\licensedcode\data\rules\mit_or_gpl-1.0-plus_28.yml", "YAML", 0, 0, 0, 6, 0, 0, 1, 7
"d:\IDEWORK\lvmen\src\licensedcode\data\rules\mit_or_gpl-1.0-plus_3.yml", "YAML", 0, 0, 0, 3, 0, 0, 1, 4
"d:\IDEWORK\lvmen\src\licensedcode\data\rules\mit_or_gpl-1.0-plus_4.yml", "YAML", 0, 0, 0, 5, 0, 0, 1, 6
"d:\IDEWORK\lvmen\src\licensedcode\data\rules\mit_or_gpl-1.0-plus_5.yml", "YAML", 0, 0, 0, 5, 0, 0, 1, 6
"d:\IDEWORK\lvmen\src\licensedcode\data\rules\mit_or_gpl-1.0-plus_6.yml", "YAML", 0, 0, 0, 5, 0, 0, 1, 6
"d:\IDEWORK\lvmen\src\licensedcode\data\rules\mit_or_gpl-1.0-plus_7.yml", "YAML", 0, 0, 0, 5, 0, 0, 1, 6
"d:\IDEWORK\lvmen\src\licensedcode\data\rules\mit_or_gpl-1.0-plus_8.yml", "YAML", 0, 0, 0, 6, 0, 0, 1, 7
"d:\IDEWORK\lvmen\src\licensedcode\data\rules\mit_or_gpl-1.0-plus_9.yml", "YAML", 0, 0, 0, 6, 0, 0, 1, 7
"d:\IDEWORK\lvmen\src\licensedcode\data\rules\mit_or_gpl-1.0-plus_or_artistic-perl-1.0_1.yml", "YAML", 0, 0, 0, 3, 0, 0, 1, 4
"d:\IDEWORK\lvmen\src\licensedcode\data\rules\mit_or_gpl-2.0-plus.yml", "YAML", 0, 0, 0, 3, 0, 0, 1, 4
"d:\IDEWORK\lvmen\src\licensedcode\data\rules\mit_or_gpl-2.0-plus_1.yml", "YAML", 0, 0, 0, 3, 0, 0, 1, 4
"d:\IDEWORK\lvmen\src\licensedcode\data\rules\mit_or_gpl-2.0-plus_or_lgpl-2.0-plus_1.yml", "YAML", 0, 0, 0, 7, 0, 0, 1, 8
"d:\IDEWORK\lvmen\src\licensedcode\data\rules\mit_or_gpl-2.0-plus_or_lgpl-2.0-plus_2.yml", "YAML", 0, 0, 0, 6, 0, 0, 1, 7
"d:\IDEWORK\lvmen\src\licensedcode\data\rules\mit_or_gpl-2.0-plus_or_lgpl-2.0-plus_3.yml", "YAML", 0, 0, 0, 6, 0, 0, 1, 7
"d:\IDEWORK\lvmen\src\licensedcode\data\rules\mit_or_gpl-2.0-plus_or_lgpl-2.0-plus_4.yml", "YAML", 0, 0, 0, 6, 0, 0, 1, 7
"d:\IDEWORK\lvmen\src\licensedcode\data\rules\mit_or_gpl-2.0-plus_or_lgpl-2.0-plus_5.yml", "YAML", 0, 0, 0, 7, 0, 0, 1, 8
"d:\IDEWORK\lvmen\src\licensedcode\data\rules\mit_or_gpl-2.0.yml", "YAML", 0, 0, 0, 5, 0, 0, 1, 6
"d:\IDEWORK\lvmen\src\licensedcode\data\rules\mit_or_gpl-2.0_1.yml", "YAML", 0, 0, 0, 6, 0, 0, 1, 7
"d:\IDEWORK\lvmen\src\licensedcode\data\rules\mit_or_gpl-2.0_10.yml", "YAML", 0, 0, 0, 7, 0, 0, 1, 8
"d:\IDEWORK\lvmen\src\licensedcode\data\rules\mit_or_gpl-2.0_11.yml", "YAML", 0, 0, 0, 7, 0, 0, 1, 8
"d:\IDEWORK\lvmen\src\licensedcode\data\rules\mit_or_gpl-2.0_12.yml", "YAML", 0, 0, 0, 7, 0, 0, 1, 8
"d:\IDEWORK\lvmen\src\licensedcode\data\rules\mit_or_gpl-2.0_13.yml", "YAML", 0, 0, 0, 6, 0, 0, 1, 7
"d:\IDEWORK\lvmen\src\licensedcode\data\rules\mit_or_gpl-2.0_14.yml", "YAML", 0, 0, 0, 6, 0, 0, 1, 7
"d:\IDEWORK\lvmen\src\licensedcode\data\rules\mit_or_gpl-2.0_15.yml", "YAML", 0, 0, 0, 3, 0, 0, 1, 4
"d:\IDEWORK\lvmen\src\licensedcode\data\rules\mit_or_gpl-2.0_16.yml", "YAML", 0, 0, 0, 3, 0, 0, 1, 4
"d:\IDEWORK\lvmen\src\licensedcode\data\rules\mit_or_gpl-2.0_17.yml", "YAML", 0, 0, 0, 3, 0, 0, 1, 4
"d:\IDEWORK\lvmen\src\licensedcode\data\rules\mit_or_gpl-2.0_18.yml", "YAML", 0, 0, 0, 3, 0, 0, 1, 4
"d:\IDEWORK\lvmen\src\licensedcode\data\rules\mit_or_gpl-2.0_19.yml", "YAML", 0, 0, 0, 6, 0, 0, 1, 7
"d:\IDEWORK\lvmen\src\licensedcode\data\rules\mit_or_gpl-2.0_2.yml", "YAML", 0, 0, 0, 6, 0, 0, 1, 7
"d:\IDEWORK\lvmen\src\licensedcode\data\rules\mit_or_gpl-2.0_20.yml", "YAML", 0, 0, 0, 6, 0, 0, 1, 7
"d:\IDEWORK\lvmen\src\licensedcode\data\rules\mit_or_gpl-2.0_21.yml", "YAML", 0, 0, 0, 3, 0, 0, 1, 4
"d:\IDEWORK\lvmen\src\licensedcode\data\rules\mit_or_gpl-2.0_22.yml", "YAML", 0, 0, 0, 3, 0, 0, 1, 4
"d:\IDEWORK\lvmen\src\licensedcode\data\rules\mit_or_gpl-2.0_23.yml", "YAML", 0, 0, 0, 3, 0, 0, 1, 4
"d:\IDEWORK\lvmen\src\licensedcode\data\rules\mit_or_gpl-2.0_24.yml", "YAML", 0, 0, 0, 3, 0, 0, 1, 4
"d:\IDEWORK\lvmen\src\licensedcode\data\rules\mit_or_gpl-2.0_25.yml", "YAML", 0, 0, 0, 3, 0, 0, 1, 4
"d:\IDEWORK\lvmen\src\licensedcode\data\rules\mit_or_gpl-2.0_26.yml", "YAML", 0, 0, 0, 3, 0, 0, 1, 4
"d:\IDEWORK\lvmen\src\licensedcode\data\rules\mit_or_gpl-2.0_27.yml", "YAML", 0, 0, 0, 3, 0, 0, 1, 4
"d:\IDEWORK\lvmen\src\licensedcode\data\rules\mit_or_gpl-2.0_28.yml", "YAML", 0, 0, 0, 3, 0, 0, 1, 4
"d:\IDEWORK\lvmen\src\licensedcode\data\rules\mit_or_gpl-2.0_29.yml", "YAML", 0, 0, 0, 3, 0, 0, 1, 4
"d:\IDEWORK\lvmen\src\licensedcode\data\rules\mit_or_gpl-2.0_3.yml", "YAML", 0, 0, 0, 6, 0, 0, 1, 7
"d:\IDEWORK\lvmen\src\licensedcode\data\rules\mit_or_gpl-2.0_30.yml", "YAML", 0, 0, 0, 3, 0, 0, 1, 4
"d:\IDEWORK\lvmen\src\licensedcode\data\rules\mit_or_gpl-2.0_31.yml", "YAML", 0, 0, 0, 3, 0, 0, 1, 4
"d:\IDEWORK\lvmen\src\licensedcode\data\rules\mit_or_gpl-2.0_32.yml", "YAML", 0, 0, 0, 3, 0, 0, 1, 4
"d:\IDEWORK\lvmen\src\licensedcode\data\rules\mit_or_gpl-2.0_33.yml", "YAML", 0, 0, 0, 3, 0, 0, 1, 4
"d:\IDEWORK\lvmen\src\licensedcode\data\rules\mit_or_gpl-2.0_34.yml", "YAML", 0, 0, 0, 3, 0, 0, 1, 4
"d:\IDEWORK\lvmen\src\licensedcode\data\rules\mit_or_gpl-2.0_35.yml", "YAML", 0, 0, 0, 3, 0, 0, 1, 4
"d:\IDEWORK\lvmen\src\licensedcode\data\rules\mit_or_gpl-2.0_36.yml", "YAML", 0, 0, 0, 3, 0, 0, 1, 4
"d:\IDEWORK\lvmen\src\licensedcode\data\rules\mit_or_gpl-2.0_37.yml", "YAML", 0, 0, 0, 3, 0, 0, 1, 4
"d:\IDEWORK\lvmen\src\licensedcode\data\rules\mit_or_gpl-2.0_38.yml", "YAML", 0, 0, 0, 3, 0, 0, 1, 4
"d:\IDEWORK\lvmen\src\licensedcode\data\rules\mit_or_gpl-2.0_39.yml", "YAML", 0, 0, 0, 3, 0, 0, 1, 4
"d:\IDEWORK\lvmen\src\licensedcode\data\rules\mit_or_gpl-2.0_4.yml", "YAML", 0, 0, 0, 5, 0, 0, 1, 6
"d:\IDEWORK\lvmen\src\licensedcode\data\rules\mit_or_gpl-2.0_40.yml", "YAML", 0, 0, 0, 3, 0, 0, 1, 4
"d:\IDEWORK\lvmen\src\licensedcode\data\rules\mit_or_gpl-2.0_41.yml", "YAML", 0, 0, 0, 3, 0, 0, 1, 4
"d:\IDEWORK\lvmen\src\licensedcode\data\rules\mit_or_gpl-2.0_42.yml", "YAML", 0, 0, 0, 3, 0, 0, 1, 4
"d:\IDEWORK\lvmen\src\licensedcode\data\rules\mit_or_gpl-2.0_43.yml", "YAML", 0, 0, 0, 3, 0, 0, 1, 4
"d:\IDEWORK\lvmen\src\licensedcode\data\rules\mit_or_gpl-2.0_44.yml", "YAML", 0, 0, 0, 5, 0, 0, 1, 6
"d:\IDEWORK\lvmen\src\licensedcode\data\rules\mit_or_gpl-2.0_45.yml", "YAML", 0, 0, 0, 3, 0, 0, 1, 4
"d:\IDEWORK\lvmen\src\licensedcode\data\rules\mit_or_gpl-2.0_46.yml", "YAML", 0, 0, 0, 7, 0, 0, 1, 8
"d:\IDEWORK\lvmen\src\licensedcode\data\rules\mit_or_gpl-2.0_47.yml", "YAML", 0, 0, 0, 7, 0, 0, 1, 8
"d:\IDEWORK\lvmen\src\licensedcode\data\rules\mit_or_gpl-2.0_48.yml", "YAML", 0, 0, 0, 5, 0, 0, 1, 6
"d:\IDEWORK\lvmen\src\licensedcode\data\rules\mit_or_gpl-2.0_49.yml", "YAML", 0, 0, 0, 3, 0, 0, 1, 4
"d:\IDEWORK\lvmen\src\licensedcode\data\rules\mit_or_gpl-2.0_5.yml", "YAML", 0, 0, 0, 5, 0, 0, 1, 6
"d:\IDEWORK\lvmen\src\licensedcode\data\rules\mit_or_gpl-2.0_50.yml", "YAML", 0, 0, 0, 3, 0, 0, 1, 4
"d:\IDEWORK\lvmen\src\licensedcode\data\rules\mit_or_gpl-2.0_51.yml", "YAML", 0, 0, 0, 3, 0, 0, 1, 4
"d:\IDEWORK\lvmen\src\licensedcode\data\rules\mit_or_gpl-2.0_52.yml", "YAML", 0, 0, 0, 3, 0, 0, 1, 4
"d:\IDEWORK\lvmen\src\licensedcode\data\rules\mit_or_gpl-2.0_53.yml", "YAML", 0, 0, 0, 5, 0, 0, 1, 6
"d:\IDEWORK\lvmen\src\licensedcode\data\rules\mit_or_gpl-2.0_54.yml", "YAML", 0, 0, 0, 3, 0, 0, 1, 4
"d:\IDEWORK\lvmen\src\licensedcode\data\rules\mit_or_gpl-2.0_55.yml", "YAML", 0, 0, 0, 4, 0, 0, 1, 5
"d:\IDEWORK\lvmen\src\licensedcode\data\rules\mit_or_gpl-2.0_56.yml", "YAML", 0, 0, 0, 3, 0, 0, 1, 4
"d:\IDEWORK\lvmen\src\licensedcode\data\rules\mit_or_gpl-2.0_57.yml", "YAML", 0, 0, 0, 5, 0, 0, 1, 6
"d:\IDEWORK\lvmen\src\licensedcode\data\rules\mit_or_gpl-2.0_58.yml", "YAML", 0, 0, 0, 3, 0, 0, 1, 4
"d:\IDEWORK\lvmen\src\licensedcode\data\rules\mit_or_gpl-2.0_59.yml", "YAML", 0, 0, 0, 3, 0, 0, 1, 4
"d:\IDEWORK\lvmen\src\licensedcode\data\rules\mit_or_gpl-2.0_6.yml", "YAML", 0, 0, 0, 5, 0, 0, 1, 6
"d:\IDEWORK\lvmen\src\licensedcode\data\rules\mit_or_gpl-2.0_60.yml", "YAML", 0, 0, 0, 3, 0, 0, 1, 4
"d:\IDEWORK\lvmen\src\licensedcode\data\rules\mit_or_gpl-2.0_61.yml", "YAML", 0, 0, 0, 3, 0, 0, 1, 4
"d:\IDEWORK\lvmen\src\licensedcode\data\rules\mit_or_gpl-2.0_62.yml", "YAML", 0, 0, 0, 3, 0, 0, 1, 4
"d:\IDEWORK\lvmen\src\licensedcode\data\rules\mit_or_gpl-2.0_63.yml", "YAML", 0, 0, 0, 7, 0, 0, 1, 8
"d:\IDEWORK\lvmen\src\licensedcode\data\rules\mit_or_gpl-2.0_64.yml", "YAML", 0, 0, 0, 7, 0, 0, 1, 8
"d:\IDEWORK\lvmen\src\licensedcode\data\rules\mit_or_gpl-2.0_65.yml", "YAML", 0, 0, 0, 6, 0, 0, 1, 7
"d:\IDEWORK\lvmen\src\licensedcode\data\rules\mit_or_gpl-2.0_7.yml", "YAML", 0, 0, 0, 6, 0, 0, 1, 7
"d:\IDEWORK\lvmen\src\licensedcode\data\rules\mit_or_gpl-2.0_8.yml", "YAML", 0, 0, 0, 7, 0, 0, 1, 8
"d:\IDEWORK\lvmen\src\licensedcode\data\rules\mit_or_gpl-2.0_9.yml", "YAML", 0, 0, 0, 7, 0, 0, 1, 8
"d:\IDEWORK\lvmen\src\licensedcode\data\rules\mit_or_gpl-2.0_html5.yml", "YAML", 0, 0, 0, 10, 0, 0, 1, 11
"d:\IDEWORK\lvmen\src\licensedcode\data\rules\mit_or_gpl-2.0_html5_2.yml", "YAML", 0, 0, 0, 3, 0, 0, 2, 5
"d:\IDEWORK\lvmen\src\licensedcode\data\rules\mit_or_gpl-2.0_with_gcc-linking-exception-2.0_1.yml", "YAML", 0, 0, 0, 3, 0, 0, 1, 4
"d:\IDEWORK\lvmen\src\licensedcode\data\rules\mit_or_gpl-3.0_1.yml", "YAML", 0, 0, 0, 3, 0, 0, 1, 4
"d:\IDEWORK\lvmen\src\licensedcode\data\rules\mit_or_gpl-3.0_10.yml", "YAML", 0, 0, 0, 5, 0, 0, 1, 6
"d:\IDEWORK\lvmen\src\licensedcode\data\rules\mit_or_gpl-3.0_11.yml", "YAML", 0, 0, 0, 5, 0, 0, 1, 6
"d:\IDEWORK\lvmen\src\licensedcode\data\rules\mit_or_gpl-3.0_12.yml", "YAML", 0, 0, 0, 6, 0, 0, 1, 7
"d:\IDEWORK\lvmen\src\licensedcode\data\rules\mit_or_gpl-3.0_13.yml", "YAML", 0, 0, 0, 6, 0, 0, 1, 7
"d:\IDEWORK\lvmen\src\licensedcode\data\rules\mit_or_gpl-3.0_14.yml", "YAML", 0, 0, 0, 5, 0, 0, 1, 6
"d:\IDEWORK\lvmen\src\licensedcode\data\rules\mit_or_gpl-3.0_15.yml", "YAML", 0, 0, 0, 5, 0, 0, 1, 6
"d:\IDEWORK\lvmen\src\licensedcode\data\rules\mit_or_gpl-3.0_2.yml", "YAML", 0, 0, 0, 5, 0, 0, 1, 6
"d:\IDEWORK\lvmen\src\licensedcode\data\rules\mit_or_gpl-3.0_3.yml", "YAML", 0, 0, 0, 3, 0, 0, 1, 4
"d:\IDEWORK\lvmen\src\licensedcode\data\rules\mit_or_gpl-3.0_4.yml", "YAML", 0, 0, 0, 3, 0, 0, 1, 4
"d:\IDEWORK\lvmen\src\licensedcode\data\rules\mit_or_gpl-3.0_5.yml", "YAML", 0, 0, 0, 5, 0, 0, 1, 6
"d:\IDEWORK\lvmen\src\licensedcode\data\rules\mit_or_gpl-3.0_6.yml", "YAML", 0, 0, 0, 3, 0, 0, 1, 4
"d:\IDEWORK\lvmen\src\licensedcode\data\rules\mit_or_gpl-3.0_7.yml", "YAML", 0, 0, 0, 3, 0, 0, 1, 4
"d:\IDEWORK\lvmen\src\licensedcode\data\rules\mit_or_gpl-3.0_8.yml", "YAML", 0, 0, 0, 3, 0, 0, 1, 4
"d:\IDEWORK\lvmen\src\licensedcode\data\rules\mit_or_gpl-3.0_9.yml", "YAML", 0, 0, 0, 6, 0, 0, 1, 7
"d:\IDEWORK\lvmen\src\licensedcode\data\rules\mit_or_gpl.yml", "YAML", 0, 0, 0, 5, 0, 0, 1, 6
"d:\IDEWORK\lvmen\src\licensedcode\data\rules\mit_or_gpl_10.yml", "YAML", 0, 0, 0, 3, 0, 0, 1, 4
"d:\IDEWORK\lvmen\src\licensedcode\data\rules\mit_or_gpl_11.yml", "YAML", 0, 0, 0, 3, 0, 0, 1, 4
"d:\IDEWORK\lvmen\src\licensedcode\data\rules\mit_or_gpl_12.yml", "YAML", 0, 0, 0, 6, 0, 0, 1, 7
"d:\IDEWORK\lvmen\src\licensedcode\data\rules\mit_or_gpl_3.yml", "YAML", 0, 0, 0, 4, 0, 0, 1, 5
"d:\IDEWORK\lvmen\src\licensedcode\data\rules\mit_or_gpl_7.yml", "YAML", 0, 0, 0, 4, 0, 0, 1, 5
"d:\IDEWORK\lvmen\src\licensedcode\data\rules\mit_or_gpl_8.yml", "YAML", 0, 0, 0, 5, 0, 0, 1, 6
"d:\IDEWORK\lvmen\src\licensedcode\data\rules\mit_or_gpl_9.yml", "YAML", 0, 0, 0, 3, 0, 0, 1, 4
"d:\IDEWORK\lvmen\src\licensedcode\data\rules\mit_or_gpl_syntax_highlighter.yml", "YAML", 0, 0, 0, 3, 0, 0, 1, 4
"d:\IDEWORK\lvmen\src\licensedcode\data\rules\mit_or_gpl_syntax_highlighter_2.yml", "YAML", 0, 0, 0, 3, 0, 0, 1, 4
"d:\IDEWORK\lvmen\src\licensedcode\data\rules\mit_or_gpl_syntax_highlighter_3.yml", "YAML", 0, 0, 0, 6, 0, 0, 1, 7
"d:\IDEWORK\lvmen\src\licensedcode\data\rules\mit_or_lgpl-2.0-plus_1.yml", "YAML", 0, 0, 0, 6, 0, 0, 1, 7
"d:\IDEWORK\lvmen\src\licensedcode\data\rules\mit_or_lgpl-2.0-plus_2.yml", "YAML", 0, 0, 0, 6, 0, 0, 1, 7
"d:\IDEWORK\lvmen\src\licensedcode\data\rules\mit_or_lgpl-3.0_1.yml", "YAML", 0, 0, 0, 5, 0, 0, 1, 6
"d:\IDEWORK\lvmen\src\licensedcode\data\rules\mit_or_lgpl-3.0_2.yml", "YAML", 0, 0, 0, 3, 0, 0, 1, 4
"d:\IDEWORK\lvmen\src\licensedcode\data\rules\mit_or_psf-2.0_1.yml", "YAML", 0, 0, 0, 3, 0, 0, 1, 4
"d:\IDEWORK\lvmen\src\licensedcode\data\rules\mit_or_ruby_1.yml", "YAML", 0, 0, 0, 6, 0, 0, 1, 7
"d:\IDEWORK\lvmen\src\licensedcode\data\rules\mit_or_unlicense_1.yml", "YAML", 0, 0, 0, 2, 0, 0, 1, 3
"d:\IDEWORK\lvmen\src\licensedcode\data\rules\mit_or_unlicense_2.yml", "YAML", 0, 0, 0, 3, 0, 0, 1, 4
"d:\IDEWORK\lvmen\src\licensedcode\data\rules\mit_or_unlicense_3.yml", "YAML", 0, 0, 0, 5, 0, 0, 1, 6
"d:\IDEWORK\lvmen\src\licensedcode\data\rules\mit_or_unlicense_4.yml", "YAML", 0, 0, 0, 3, 0, 0, 1, 4
"d:\IDEWORK\lvmen\src\licensedcode\data\rules\mit_or_unlicense_5.yml", "YAML", 0, 0, 0, 6, 0, 0, 1, 7
"d:\IDEWORK\lvmen\src\licensedcode\data\rules\mit_or_unlicense_6.yml", "YAML", 0, 0, 0, 3, 0, 0, 1, 4
"d:\IDEWORK\lvmen\src\licensedcode\data\rules\mit_or_unlicense_7.yml", "YAML", 0, 0, 0, 3, 0, 0, 1, 4
"d:\IDEWORK\lvmen\src\licensedcode\data\rules\mit_or_unlicense_8.yml", "YAML", 0, 0, 0, 4, 0, 0, 1, 5
"d:\IDEWORK\lvmen\src\licensedcode\data\rules\mit_or_uoi-ncsa.yml", "YAML", 0, 0, 0, 2, 0, 0, 1, 3
"d:\IDEWORK\lvmen\src\licensedcode\data\rules\mit_or_uoi-ncsa_1.yml", "YAML", 0, 0, 0, 3, 0, 0, 1, 4
"d:\IDEWORK\lvmen\src\licensedcode\data\rules\mit_or_uoi-ncsa_2.yml", "YAML", 0, 0, 0, 5, 0, 0, 1, 6
"d:\IDEWORK\lvmen\src\licensedcode\data\rules\mit_or_uoi-ncsa_3.yml", "YAML", 0, 0, 0, 3, 0, 0, 1, 4
"d:\IDEWORK\lvmen\src\licensedcode\data\rules\mit_or_uoi-ncsa_4.yml", "YAML", 0, 0, 0, 5, 0, 0, 1, 6
"d:\IDEWORK\lvmen\src\licensedcode\data\rules\mit_or_uoi-ncsa_5.yml", "YAML", 0, 0, 0, 3, 0, 0, 1, 4
"d:\IDEWORK\lvmen\src\licensedcode\data\rules\mit_tag.yml", "YAML", 0, 0, 0, 3, 0, 0, 1, 4
"d:\IDEWORK\lvmen\src\licensedcode\data\rules\mit_under_1.yml", "YAML", 0, 0, 0, 3, 0, 0, 1, 4
"d:\IDEWORK\lvmen\src\licensedcode\data\rules\mit_under_2.yml", "YAML", 0, 0, 0, 3, 0, 0, 1, 4
"d:\IDEWORK\lvmen\src\licensedcode\data\rules\mit_url.yml", "YAML", 0, 0, 0, 5, 0, 0, 1, 6
"d:\IDEWORK\lvmen\src\licensedcode\data\rules\mit_url_1.yml", "YAML", 0, 0, 0, 5, 0, 0, 1, 6
"d:\IDEWORK\lvmen\src\licensedcode\data\rules\mit_url_2.yml", "YAML", 0, 0, 0, 5, 0, 0, 1, 6
"d:\IDEWORK\lvmen\src\licensedcode\data\rules\mit_url_3.yml", "YAML", 0, 0, 0, 5, 0, 0, 1, 6
"d:\IDEWORK\lvmen\src\licensedcode\data\rules\mit_url_4.yml", "YAML", 0, 0, 0, 5, 0, 0, 1, 6
"d:\IDEWORK\lvmen\src\licensedcode\data\rules\mit_url_5.yml", "YAML", 0, 0, 0, 5, 0, 0, 1, 6
"d:\IDEWORK\lvmen\src\licensedcode\data\rules\mit_url_6.yml", "YAML", 0, 0, 0, 5, 0, 0, 1, 6
"d:\IDEWORK\lvmen\src\licensedcode\data\rules\mit_url_badge.yml", "YAML", 0, 0, 0, 6, 0, 0, 1, 7
"d:\IDEWORK\lvmen\src\licensedcode\data\rules\mit_url_glc_187.yml", "YAML", 0, 0, 0, 5, 0, 0, 1, 6
"d:\IDEWORK\lvmen\src\licensedcode\data\rules\mit_with_generic-exception_or_gpl-2.0_with_generic-exception_1.yml", "YAML", 0, 0, 0, 3, 0, 0, 1, 4
"d:\IDEWORK\lvmen\src\licensedcode\data\rules\mit_x11-r75_1.yml", "YAML", 0, 0, 0, 2, 0, 0, 1, 3
"d:\IDEWORK\lvmen\src\licensedcode\data\rules\mit_x11-r75_2.yml", "YAML", 0, 0, 0, 2, 0, 0, 1, 3
"d:\IDEWORK\lvmen\src\licensedcode\data\rules\mit_x11-r75_3.yml", "YAML", 0, 0, 0, 2, 0, 0, 1, 3
"d:\IDEWORK\lvmen\src\licensedcode\data\rules\mit_x11-r75_56.yml", "YAML", 0, 0, 0, 2, 0, 0, 1, 3
"d:\IDEWORK\lvmen\src\licensedcode\data\rules\mit_x11-r75_58.yml", "YAML", 0, 0, 0, 2, 0, 0, 1, 3
"d:\IDEWORK\lvmen\src\licensedcode\data\rules\mit_x11-r75_60.yml", "YAML", 0, 0, 0, 3, 0, 0, 1, 4
"d:\IDEWORK\lvmen\src\licensedcode\data\rules\mit_x11-r75_61.yml", "YAML", 0, 0, 0, 2, 0, 0, 1, 3
"d:\IDEWORK\lvmen\src\licensedcode\data\rules\mit_x11-r75_62.yml", "YAML", 0, 0, 0, 3, 0, 0, 1, 4
"d:\IDEWORK\lvmen\src\licensedcode\data\rules\mit_x11-r75_63.yml", "YAML", 0, 0, 0, 3, 0, 0, 1, 4
"d:\IDEWORK\lvmen\src\licensedcode\data\rules\mit_x11-r75_64.yml", "YAML", 0, 0, 0, 2, 0, 0, 1, 3
"d:\IDEWORK\lvmen\src\licensedcode\data\rules\mit_x11-r75_65.yml", "YAML", 0, 0, 0, 2, 0, 0, 1, 3
"d:\IDEWORK\lvmen\src\licensedcode\data\rules\mit_x11-r75_66.yml", "YAML", 0, 0, 0, 2, 0, 0, 1, 3
"d:\IDEWORK\lvmen\src\licensedcode\data\rules\mit_x11-r75_67.yml", "YAML", 0, 0, 0, 2, 0, 0, 1, 3
"d:\IDEWORK\lvmen\src\licensedcode\data\rules\mit_x11-r75_69.yml", "YAML", 0, 0, 0, 2, 0, 0, 1, 3
"d:\IDEWORK\lvmen\src\licensedcode\data\rules\mit_x11-r75_70.yml", "YAML", 0, 0, 0, 2, 0, 0, 1, 3
"d:\IDEWORK\lvmen\src\licensedcode\data\rules\mit_x11-r75_72.yml", "YAML", 0, 0, 0, 2, 0, 0, 1, 3
"d:\IDEWORK\lvmen\src\licensedcode\data\rules\mit_x11-r75_75.yml", "YAML", 0, 0, 0, 6, 0, 0, 2, 8
"d:\IDEWORK\lvmen\src\licensedcode\data\rules\mit_x11-r75_76.yml", "YAML", 0, 0, 0, 2, 0, 0, 1, 3
"d:\IDEWORK\lvmen\src\licensedcode\data\rules\mit_x11-r75_77.yml", "YAML", 0, 0, 0, 2, 0, 0, 1, 3
"d:\IDEWORK\lvmen\src\licensedcode\data\rules\mit_x11-r75_78.yml", "YAML", 0, 0, 0, 2, 0, 0, 1, 3
"d:\IDEWORK\lvmen\src\licensedcode\data\rules\mit_x11-r75_79.yml", "YAML", 0, 0, 0, 2, 0, 0, 1, 3
"d:\IDEWORK\lvmen\src\licensedcode\data\rules\mit_x11-r75_80.yml", "YAML", 0, 0, 0, 2, 0, 0, 1, 3
"d:\IDEWORK\lvmen\src\licensedcode\data\rules\mit_x_1.yml", "YAML", 0, 0, 0, 4, 0, 0, 2, 6
"d:\IDEWORK\lvmen\src\licensedcode\data\rules\mod-dav-1.0.yml", "YAML", 0, 0, 0, 5, 0, 0, 1, 6
"d:\IDEWORK\lvmen\src\licensedcode\data\rules\mod-dav-1.1.yml", "YAML", 0, 0, 0, 5, 0, 0, 1, 6
"d:\IDEWORK\lvmen\src\licensedcode\data\rules\monetdb-1.1.yml", "YAML", 0, 0, 0, 8, 0, 0, 1, 9
"d:\IDEWORK\lvmen\src\licensedcode\data\rules\monetdb-1.1_1.yml", "YAML", 0, 0, 0, 5, 0, 0, 1, 6
"d:\IDEWORK\lvmen\src\licensedcode\data\rules\mongodb-sspl-1.0_1.yml", "YAML", 0, 0, 0, 4, 0, 0, 1, 5
"d:\IDEWORK\lvmen\src\licensedcode\data\rules\mongodb-sspl-1.0_10.yml", "YAML", 0, 0, 0, 3, 0, 0, 1, 4
"d:\IDEWORK\lvmen\src\licensedcode\data\rules\mongodb-sspl-1.0_11.yml", "YAML", 0, 0, 0, 3, 0, 0, 1, 4
"d:\IDEWORK\lvmen\src\licensedcode\data\rules\mongodb-sspl-1.0_2.yml", "YAML", 0, 0, 0, 2, 0, 0, 1, 3
"d:\IDEWORK\lvmen\src\licensedcode\data\rules\mongodb-sspl-1.0_3.yml", "YAML", 0, 0, 0, 5, 0, 0, 1, 6
"d:\IDEWORK\lvmen\src\licensedcode\data\rules\mongodb-sspl-1.0_4.yml", "YAML", 0, 0, 0, 3, 0, 0, 1, 4
"d:\IDEWORK\lvmen\src\licensedcode\data\rules\mongodb-sspl-1.0_5.yml", "YAML", 0, 0, 0, 3, 0, 0, 1, 4
"d:\IDEWORK\lvmen\src\licensedcode\data\rules\mongodb-sspl-1.0_6.yml", "YAML", 0, 0, 0, 5, 0, 0, 1, 6
"d:\IDEWORK\lvmen\src\licensedcode\data\rules\mongodb-sspl-1.0_60.yml", "YAML", 0, 0, 0, 3, 0, 0, 1, 4
"d:\IDEWORK\lvmen\src\licensedcode\data\rules\mongodb-sspl-1.0_7.yml", "YAML", 0, 0, 0, 5, 0, 0, 1, 6
"d:\IDEWORK\lvmen\src\licensedcode\data\rules\mongodb-sspl-1.0_8.yml", "YAML", 0, 0, 0, 3, 0, 0, 2, 5
"d:\IDEWORK\lvmen\src\licensedcode\data\rules\mongodb-sspl-1.0_9.yml", "YAML", 0, 0, 0, 12, 0, 0, 1, 13
"d:\IDEWORK\lvmen\src\licensedcode\data\rules\mongodb-sspl-1.0_url_1.yml", "YAML", 0, 0, 0, 5, 0, 0, 1, 6
"d:\IDEWORK\lvmen\src\licensedcode\data\rules\mongodb-sspl-1.0_url_2.yml", "YAML", 0, 0, 0, 5, 0, 0, 1, 6
"d:\IDEWORK\lvmen\src\licensedcode\data\rules\mongodb-sspl-1.0_with_mongodb-openssl-exception_1.yml", "YAML", 0, 0, 0, 4, 0, 0, 1, 5
"d:\IDEWORK\lvmen\src\licensedcode\data\rules\motorola.yml", "YAML", 0, 0, 0, 5, 0, 0, 1, 6
"d:\IDEWORK\lvmen\src\licensedcode\data\rules\motosoto-0.9.1.SPDX.yml", "YAML", 0, 0, 0, 4, 0, 0, 1, 5
"d:\IDEWORK\lvmen\src\licensedcode\data\rules\motosoto-0.9.1.yml", "YAML", 0, 0, 0, 5, 0, 0, 1, 6
"d:\IDEWORK\lvmen\src\licensedcode\data\rules\motosoto-0.9.1_1.yml", "YAML", 0, 0, 0, 3, 0, 0, 1, 4
"d:\IDEWORK\lvmen\src\licensedcode\data\rules\motosoto-0.9.1_2.yml", "YAML", 0, 0, 0, 5, 0, 0, 1, 6
"d:\IDEWORK\lvmen\src\licensedcode\data\rules\motosoto-0.9.1_3.yml", "YAML", 0, 0, 0, 2, 0, 0, 1, 3
"d:\IDEWORK\lvmen\src\licensedcode\data\rules\motosoto-0.9.1_url_1.yml", "YAML", 0, 0, 0, 5, 0, 0, 1, 6
"d:\IDEWORK\lvmen\src\licensedcode\data\rules\motosoto-0.9.1_url_2.yml", "YAML", 0, 0, 0, 5, 0, 0, 1, 6
"d:\IDEWORK\lvmen\src\licensedcode\data\rules\motosoto-0.9.1_url_glc_196.yml", "YAML", 0, 0, 0, 5, 0, 0, 1, 6
"d:\IDEWORK\lvmen\src\licensedcode\data\rules\motosoto-0.9.1_url_glc_197.yml", "YAML", 0, 0, 0, 5, 0, 0, 1, 6
"d:\IDEWORK\lvmen\src\licensedcode\data\rules\mozilla-gc_or_stlport-4.5.yml", "YAML", 0, 0, 0, 3, 0, 0, 1, 4
"d:\IDEWORK\lvmen\src\licensedcode\data\rules\mpeg-ssg.yml", "YAML", 0, 0, 0, 5, 0, 0, 1, 6
"d:\IDEWORK\lvmen\src\licensedcode\data\rules\mpeg-ssg_1.yml", "YAML", 0, 0, 0, 2, 0, 0, 1, 3
"d:\IDEWORK\lvmen\src\licensedcode\data\rules\mpich.SPDX.yml", "YAML", 0, 0, 0, 7, 0, 0, 1, 8
"d:\IDEWORK\lvmen\src\licensedcode\data\rules\mpich_1.yml", "YAML", 0, 0, 0, 4, 0, 0, 1, 5
"d:\IDEWORK\lvmen\src\licensedcode\data\rules\mpich_2.yml", "YAML", 0, 0, 0, 4, 0, 0, 1, 5
"d:\IDEWORK\lvmen\src\licensedcode\data\rules\mpich_3.yml", "YAML", 0, 0, 0, 4, 0, 0, 1, 5
"d:\IDEWORK\lvmen\src\licensedcode\data\rules\mpich_4.yml", "YAML", 0, 0, 0, 3, 0, 0, 1, 4
"d:\IDEWORK\lvmen\src\licensedcode\data\rules\mpich_url_1.yml", "YAML", 0, 0, 0, 5, 0, 0, 1, 6
"d:\IDEWORK\lvmen\src\licensedcode\data\rules\mpich_url_2.yml", "YAML", 0, 0, 0, 5, 0, 0, 1, 6
"d:\IDEWORK\lvmen\src\licensedcode\data\rules\mpl-1.0_0.yml", "YAML", 0, 0, 0, 5, 0, 0, 1, 6
"d:\IDEWORK\lvmen\src\licensedcode\data\rules\mpl-1.0_1.yml", "YAML", 0, 0, 0, 5, 0, 0, 1, 6
"d:\IDEWORK\lvmen\src\licensedcode\data\rules\mpl-1.0_10.yml", "YAML", 0, 0, 0, 5, 0, 0, 1, 6
"d:\IDEWORK\lvmen\src\licensedcode\data\rules\mpl-1.0_11.yml", "YAML", 0, 0, 0, 5, 0, 0, 1, 6
"d:\IDEWORK\lvmen\src\licensedcode\data\rules\mpl-1.0_12.yml", "YAML", 0, 0, 0, 3, 0, 0, 1, 4
"d:\IDEWORK\lvmen\src\licensedcode\data\rules\mpl-1.0_13.yml", "YAML", 0, 0, 0, 2, 0, 0, 1, 3
"d:\IDEWORK\lvmen\src\licensedcode\data\rules\mpl-1.0_14.yml", "YAML", 0, 0, 0, 5, 0, 0, 1, 6
"d:\IDEWORK\lvmen\src\licensedcode\data\rules\mpl-1.0_15.yml", "YAML", 0, 0, 0, 3, 0, 0, 1, 4
"d:\IDEWORK\lvmen\src\licensedcode\data\rules\mpl-1.0_16.yml", "YAML", 0, 0, 0, 3, 0, 0, 1, 4
"d:\IDEWORK\lvmen\src\licensedcode\data\rules\mpl-1.0_17.yml", "YAML", 0, 0, 0, 3, 0, 0, 1, 4
"d:\IDEWORK\lvmen\src\licensedcode\data\rules\mpl-1.0_18.yml", "YAML", 0, 0, 0, 5, 0, 0, 1, 6
"d:\IDEWORK\lvmen\src\licensedcode\data\rules\mpl-1.0_19.yml", "YAML", 0, 0, 0, 5, 0, 0, 1, 6
"d:\IDEWORK\lvmen\src\licensedcode\data\rules\mpl-1.0_2.yml", "YAML", 0, 0, 0, 5, 0, 0, 1, 6
"d:\IDEWORK\lvmen\src\licensedcode\data\rules\mpl-1.0_20.yml", "YAML", 0, 0, 0, 3, 0, 0, 1, 4
"d:\IDEWORK\lvmen\src\licensedcode\data\rules\mpl-1.0_21.yml", "YAML", 0, 0, 0, 6, 0, 0, 1, 7
"d:\IDEWORK\lvmen\src\licensedcode\data\rules\mpl-1.0_22.yml", "YAML", 0, 0, 0, 6, 0, 0, 1, 7
"d:\IDEWORK\lvmen\src\licensedcode\data\rules\mpl-1.0_23.yml", "YAML", 0, 0, 0, 4, 0, 0, 1, 5
"d:\IDEWORK\lvmen\src\licensedcode\data\rules\mpl-1.0_3.yml", "YAML", 0, 0, 0, 3, 0, 0, 1, 4
"d:\IDEWORK\lvmen\src\licensedcode\data\rules\mpl-1.0_4.yml", "YAML", 0, 0, 0, 2, 0, 0, 1, 3
"d:\IDEWORK\lvmen\src\licensedcode\data\rules\mpl-1.0_5.yml", "YAML", 0, 0, 0, 5, 0, 0, 1, 6
"d:\IDEWORK\lvmen\src\licensedcode\data\rules\mpl-1.0_6.yml", "YAML", 0, 0, 0, 5, 0, 0, 1, 6
"d:\IDEWORK\lvmen\src\licensedcode\data\rules\mpl-1.0_7.yml", "YAML", 0, 0, 0, 6, 0, 0, 1, 7
"d:\IDEWORK\lvmen\src\licensedcode\data\rules\mpl-1.0_8.yml", "YAML", 0, 0, 0, 5, 0, 0, 1, 6
"d:\IDEWORK\lvmen\src\licensedcode\data\rules\mpl-1.0_9.yml", "YAML", 0, 0, 0, 6, 0, 0, 1, 7
"d:\IDEWORK\lvmen\src\licensedcode\data\rules\mpl-1.0_or_apache-2.0_or_gpl-2.0-plus_1.yml", "YAML", 0, 0, 0, 3, 0, 0, 1, 4
"d:\IDEWORK\lvmen\src\licensedcode\data\rules\mpl-1.0_or_gpl-2.0-plus_1.yml", "YAML", 0, 0, 0, 5, 0, 0, 1, 6
"d:\IDEWORK\lvmen\src\licensedcode\data\rules\mpl-1.0_or_gpl-2.0-plus_2.yml", "YAML", 0, 0, 0, 5, 0, 0, 1, 6
"d:\IDEWORK\lvmen\src\licensedcode\data\rules\mpl-1.0_or_gpl-2.0-plus_or_lgpl-2.0-plus_1.yml", "YAML", 0, 0, 0, 3, 0, 0, 1, 4
"d:\IDEWORK\lvmen\src\licensedcode\data\rules\mpl-1.0_or_gpl-2.0-plus_or_lgpl-2.0-plus_2.yml", "YAML", 0, 0, 0, 3, 0, 0, 1, 4
"d:\IDEWORK\lvmen\src\licensedcode\data\rules\mpl-1.0_or_gpl-2.0-plus_or_lgpl-2.0-plus_4.yml", "YAML", 0, 0, 0, 3, 0, 0, 1, 4
"d:\IDEWORK\lvmen\src\licensedcode\data\rules\mpl-1.0_or_gpl-2.0-plus_or_lgpl-2.1-plus_1.yml", "YAML", 0, 0, 0, 5, 0, 0, 1, 6
"d:\IDEWORK\lvmen\src\licensedcode\data\rules\mpl-1.0_or_gpl-2.0-plus_or_lgpl-2.1-plus_2.yml", "YAML", 0, 0, 0, 5, 0, 0, 1, 6
"d:\IDEWORK\lvmen\src\licensedcode\data\rules\mpl-1.0_or_gpl-2.0-plus_or_lgpl-2.1-plus_3.yml", "YAML", 0, 0, 0, 5, 0, 0, 1, 6
"d:\IDEWORK\lvmen\src\licensedcode\data\rules\mpl-1.0_or_lgpl-2.0-plus_1.yml", "YAML", 0, 0, 0, 5, 0, 0, 1, 6
"d:\IDEWORK\lvmen\src\licensedcode\data\rules\mpl-1.0_or_lgpl-2.0-plus_2.yml", "YAML", 0, 0, 0, 5, 0, 0, 1, 6
"d:\IDEWORK\lvmen\src\licensedcode\data\rules\mpl-1.0_or_lgpl-2.0-plus_3.yml", "YAML", 0, 0, 0, 4, 0, 0, 1, 5
"d:\IDEWORK\lvmen\src\licensedcode\data\rules\mpl-1.0_url_1.yml", "YAML", 0, 0, 0, 5, 0, 0, 1, 6
"d:\IDEWORK\lvmen\src\licensedcode\data\rules\mpl-1.0_url_2.yml", "YAML", 0, 0, 0, 5, 0, 0, 1, 6
"d:\IDEWORK\lvmen\src\licensedcode\data\rules\mpl-1.0_url_glc_96.yml", "YAML", 0, 0, 0, 5, 0, 0, 1, 6
"d:\IDEWORK\lvmen\src\licensedcode\data\rules\mpl-1.0_url_glc_97.yml", "YAML", 0, 0, 0, 5, 0, 0, 1, 6
"d:\IDEWORK\lvmen\src\licensedcode\data\rules\mpl-1.1_1.yml", "YAML", 0, 0, 0, 4, 0, 0, 1, 5
"d:\IDEWORK\lvmen\src\licensedcode\data\rules\mpl-1.1_10.yml", "YAML", 0, 0, 0, 5, 0, 0, 1, 6
"d:\IDEWORK\lvmen\src\licensedcode\data\rules\mpl-1.1_11.yml", "YAML", 0, 0, 0, 5, 0, 0, 1, 6
"d:\IDEWORK\lvmen\src\licensedcode\data\rules\mpl-1.1_12.yml", "YAML", 0, 0, 0, 6, 0, 0, 1, 7
"d:\IDEWORK\lvmen\src\licensedcode\data\rules\mpl-1.1_13.yml", "YAML", 0, 0, 0, 5, 0, 0, 1, 6
"d:\IDEWORK\lvmen\src\licensedcode\data\rules\mpl-1.1_14.yml", "YAML", 0, 0, 0, 5, 0, 0, 1, 6
"d:\IDEWORK\lvmen\src\licensedcode\data\rules\mpl-1.1_15.yml", "YAML", 0, 0, 0, 3, 0, 0, 1, 4
"d:\IDEWORK\lvmen\src\licensedcode\data\rules\mpl-1.1_16.yml", "YAML", 0, 0, 0, 4, 0, 0, 1, 5
"d:\IDEWORK\lvmen\src\licensedcode\data\rules\mpl-1.1_17.yml", "YAML", 0, 0, 0, 3, 0, 0, 1, 4
"d:\IDEWORK\lvmen\src\licensedcode\data\rules\mpl-1.1_18.yml", "YAML", 0, 0, 0, 4, 0, 0, 1, 5
"d:\IDEWORK\lvmen\src\licensedcode\data\rules\mpl-1.1_19.yml", "YAML", 0, 0, 0, 5, 0, 0, 1, 6
"d:\IDEWORK\lvmen\src\licensedcode\data\rules\mpl-1.1_2.yml", "YAML", 0, 0, 0, 4, 0, 0, 1, 5
"d:\IDEWORK\lvmen\src\licensedcode\data\rules\mpl-1.1_20.yml", "YAML", 0, 0, 0, 4, 0, 0, 1, 5
"d:\IDEWORK\lvmen\src\licensedcode\data\rules\mpl-1.1_21.yml", "YAML", 0, 0, 0, 4, 0, 0, 1, 5
"d:\IDEWORK\lvmen\src\licensedcode\data\rules\mpl-1.1_22.yml", "YAML", 0, 0, 0, 5, 0, 0, 1, 6
"d:\IDEWORK\lvmen\src\licensedcode\data\rules\mpl-1.1_23.yml", "YAML", 0, 0, 0, 5, 0, 0, 1, 6
"d:\IDEWORK\lvmen\src\licensedcode\data\rules\mpl-1.1_24.yml", "YAML", 0, 0, 0, 3, 0, 0, 1, 4
"d:\IDEWORK\lvmen\src\licensedcode\data\rules\mpl-1.1_25.yml", "YAML", 0, 0, 0, 4, 0, 0, 1, 5
"d:\IDEWORK\lvmen\src\licensedcode\data\rules\mpl-1.1_26.yml", "YAML", 0, 0, 0, 5, 0, 0, 1, 6
"d:\IDEWORK\lvmen\src\licensedcode\data\rules\mpl-1.1_27.yml", "YAML", 0, 0, 0, 5, 0, 0, 1, 6
"d:\IDEWORK\lvmen\src\licensedcode\data\rules\mpl-1.1_28.yml", "YAML", 0, 0, 0, 4, 0, 0, 1, 5
"d:\IDEWORK\lvmen\src\licensedcode\data\rules\mpl-1.1_29.yml", "YAML", 0, 0, 0, 4, 0, 0, 1, 5
"d:\IDEWORK\lvmen\src\licensedcode\data\rules\mpl-1.1_3.yml", "YAML", 0, 0, 0, 5, 0, 0, 1, 6
"d:\IDEWORK\lvmen\src\licensedcode\data\rules\mpl-1.1_30.yml", "YAML", 0, 0, 0, 4, 0, 0, 1, 5
"d:\IDEWORK\lvmen\src\licensedcode\data\rules\mpl-1.1_31.yml", "YAML", 0, 0, 0, 5, 0, 0, 1, 6
"d:\IDEWORK\lvmen\src\licensedcode\data\rules\mpl-1.1_32.yml", "YAML", 0, 0, 0, 3, 0, 0, 1, 4
"d:\IDEWORK\lvmen\src\licensedcode\data\rules\mpl-1.1_33.yml", "YAML", 0, 0, 0, 3, 0, 0, 1, 4
"d:\IDEWORK\lvmen\src\licensedcode\data\rules\mpl-1.1_34.yml", "YAML", 0, 0, 0, 4, 0, 0, 1, 5
"d:\IDEWORK\lvmen\src\licensedcode\data\rules\mpl-1.1_35.yml", "YAML", 0, 0, 0, 4, 0, 0, 1, 5
"d:\IDEWORK\lvmen\src\licensedcode\data\rules\mpl-1.1_36.yml", "YAML", 0, 0, 0, 2, 0, 0, 1, 3
"d:\IDEWORK\lvmen\src\licensedcode\data\rules\mpl-1.1_37.yml", "YAML", 0, 0, 0, 6, 0, 0, 1, 7
"d:\IDEWORK\lvmen\src\licensedcode\data\rules\mpl-1.1_38.yml", "YAML", 0, 0, 0, 4, 0, 0, 1, 5
"d:\IDEWORK\lvmen\src\licensedcode\data\rules\mpl-1.1_39.yml", "YAML", 0, 0, 0, 5, 0, 0, 1, 6
"d:\IDEWORK\lvmen\src\licensedcode\data\rules\mpl-1.1_4.yml", "YAML", 0, 0, 0, 5, 0, 0, 1, 6
"d:\IDEWORK\lvmen\src\licensedcode\data\rules\mpl-1.1_40.yml", "YAML", 0, 0, 0, 5, 0, 0, 1, 6
"d:\IDEWORK\lvmen\src\licensedcode\data\rules\mpl-1.1_41.yml", "YAML", 0, 0, 0, 5, 0, 0, 1, 6
"d:\IDEWORK\lvmen\src\licensedcode\data\rules\mpl-1.1_42.yml", "YAML", 0, 0, 0, 3, 0, 0, 1, 4
"d:\IDEWORK\lvmen\src\licensedcode\data\rules\mpl-1.1_43.yml", "YAML", 0, 0, 0, 3, 0, 0, 1, 4
"d:\IDEWORK\lvmen\src\licensedcode\data\rules\mpl-1.1_44.yml", "YAML", 0, 0, 0, 5, 0, 0, 1, 6
"d:\IDEWORK\lvmen\src\licensedcode\data\rules\mpl-1.1_45.yml", "YAML", 0, 0, 0, 5, 0, 0, 1, 6
"d:\IDEWORK\lvmen\src\licensedcode\data\rules\mpl-1.1_46.yml", "YAML", 0, 0, 0, 12, 0, 0, 1, 13
"d:\IDEWORK\lvmen\src\licensedcode\data\rules\mpl-1.1_47.yml", "YAML", 0, 0, 0, 5, 0, 0, 1, 6
"d:\IDEWORK\lvmen\src\licensedcode\data\rules\mpl-1.1_5.yml", "YAML", 0, 0, 0, 6, 0, 0, 1, 7
"d:\IDEWORK\lvmen\src\licensedcode\data\rules\mpl-1.1_6.yml", "YAML", 0, 0, 0, 6, 0, 0, 1, 7
"d:\IDEWORK\lvmen\src\licensedcode\data\rules\mpl-1.1_7.yml", "YAML", 0, 0, 0, 5, 0, 0, 1, 6
"d:\IDEWORK\lvmen\src\licensedcode\data\rules\mpl-1.1_8.yml", "YAML", 0, 0, 0, 3, 0, 0, 1, 4
"d:\IDEWORK\lvmen\src\licensedcode\data\rules\mpl-1.1_9.yml", "YAML", 0, 0, 0, 6, 0, 0, 1, 7
"d:\IDEWORK\lvmen\src\licensedcode\data\rules\mpl-1.1_and_epl-1.0_and_proprietary-license_1.yml", "YAML", 0, 0, 0, 5, 0, 0, 1, 6
"d:\IDEWORK\lvmen\src\licensedcode\data\rules\mpl-1.1_and_free-unknown_1.yml", "YAML", 0, 0, 0, 5, 0, 0, 1, 6
"d:\IDEWORK\lvmen\src\licensedcode\data\rules\mpl-1.1_and_free-unknown_2.yml", "YAML", 0, 0, 0, 5, 0, 0, 1, 6
"d:\IDEWORK\lvmen\src\licensedcode\data\rules\mpl-1.1_and_free-unknown_3.yml", "YAML", 0, 0, 0, 5, 0, 0, 1, 6
"d:\IDEWORK\lvmen\src\licensedcode\data\rules\mpl-1.1_and_mit_and_apache-2.0_and_bsd-new_1.yml", "YAML", 0, 0, 0, 3, 0, 0, 1, 4
"d:\IDEWORK\lvmen\src\licensedcode\data\rules\mpl-1.1_or_gpl-1.0-plus_1.yml", "YAML", 0, 0, 0, 4, 0, 0, 1, 5
"d:\IDEWORK\lvmen\src\licensedcode\data\rules\mpl-1.1_or_gpl-1.0-plus_2.yml", "YAML", 0, 0, 0, 5, 0, 0, 1, 6
"d:\IDEWORK\lvmen\src\licensedcode\data\rules\mpl-1.1_or_gpl-1.0-plus_3.yml", "YAML", 0, 0, 0, 2, 0, 0, 1, 3
"d:\IDEWORK\lvmen\src\licensedcode\data\rules\mpl-1.1_or_gpl-1.0-plus_4.yml", "YAML", 0, 0, 0, 2, 0, 0, 1, 3
"d:\IDEWORK\lvmen\src\licensedcode\data\rules\mpl-1.1_or_gpl-1.0-plus_5.yml", "YAML", 0, 0, 0, 3, 0, 0, 1, 4
"d:\IDEWORK\lvmen\src\licensedcode\data\rules\mpl-1.1_or_gpl-2.0-plus_1.yml", "YAML", 0, 0, 0, 4, 0, 0, 1, 5
"d:\IDEWORK\lvmen\src\licensedcode\data\rules\mpl-1.1_or_gpl-2.0-plus_2.yml", "YAML", 0, 0, 0, 4, 0, 0, 1, 5
"d:\IDEWORK\lvmen\src\licensedcode\data\rules\mpl-1.1_or_gpl-2.0-plus_3.yml", "YAML", 0, 0, 0, 9, 0, 0, 1, 10
"d:\IDEWORK\lvmen\src\licensedcode\data\rules\mpl-1.1_or_gpl-2.0-plus_4.yml", "YAML", 0, 0, 0, 3, 0, 0, 1, 4
"d:\IDEWORK\lvmen\src\licensedcode\data\rules\mpl-1.1_or_gpl-2.0-plus_5.yml", "YAML", 0, 0, 0, 5, 0, 0, 1, 6
"d:\IDEWORK\lvmen\src\licensedcode\data\rules\mpl-1.1_or_gpl-2.0-plus_or_lgpl-2.1-plus_1.yml", "YAML", 0, 0, 0, 5, 0, 0, 1, 6
"d:\IDEWORK\lvmen\src\licensedcode\data\rules\mpl-1.1_or_gpl-2.0-plus_or_lgpl-2.1-plus_10.yml", "YAML", 0, 0, 0, 4, 0, 0, 1, 5
"d:\IDEWORK\lvmen\src\licensedcode\data\rules\mpl-1.1_or_gpl-2.0-plus_or_lgpl-2.1-plus_11.yml", "YAML", 0, 0, 0, 4, 0, 0, 1, 5
"d:\IDEWORK\lvmen\src\licensedcode\data\rules\mpl-1.1_or_gpl-2.0-plus_or_lgpl-2.1-plus_12.yml", "YAML", 0, 0, 0, 11, 0, 0, 1, 12
"d:\IDEWORK\lvmen\src\licensedcode\data\rules\mpl-1.1_or_gpl-2.0-plus_or_lgpl-2.1-plus_13.yml", "YAML", 0, 0, 0, 5, 0, 0, 1, 6
"d:\IDEWORK\lvmen\src\licensedcode\data\rules\mpl-1.1_or_gpl-2.0-plus_or_lgpl-2.1-plus_14.yml", "YAML", 0, 0, 0, 11, 0, 0, 1, 12
"d:\IDEWORK\lvmen\src\licensedcode\data\rules\mpl-1.1_or_gpl-2.0-plus_or_lgpl-2.1-plus_15.yml", "YAML", 0, 0, 0, 3, 0, 0, 1, 4
"d:\IDEWORK\lvmen\src\licensedcode\data\rules\mpl-1.1_or_gpl-2.0-plus_or_lgpl-2.1-plus_16.yml", "YAML", 0, 0, 0, 7, 0, 0, 1, 8
"d:\IDEWORK\lvmen\src\licensedcode\data\rules\mpl-1.1_or_gpl-2.0-plus_or_lgpl-2.1-plus_17.yml", "YAML", 0, 0, 0, 5, 0, 0, 1, 6
"d:\IDEWORK\lvmen\src\licensedcode\data\rules\mpl-1.1_or_gpl-2.0-plus_or_lgpl-2.1-plus_18.yml", "YAML", 0, 0, 0, 11, 0, 0, 1, 12
"d:\IDEWORK\lvmen\src\licensedcode\data\rules\mpl-1.1_or_gpl-2.0-plus_or_lgpl-2.1-plus_19.yml", "YAML", 0, 0, 0, 11, 0, 0, 1, 12
"d:\IDEWORK\lvmen\src\licensedcode\data\rules\mpl-1.1_or_gpl-2.0-plus_or_lgpl-2.1-plus_2.yml", "YAML", 0, 0, 0, 5, 0, 0, 1, 6
"d:\IDEWORK\lvmen\src\licensedcode\data\rules\mpl-1.1_or_gpl-2.0-plus_or_lgpl-2.1-plus_20.yml", "YAML", 0, 0, 0, 7, 0, 0, 1, 8
"d:\IDEWORK\lvmen\src\licensedcode\data\rules\mpl-1.1_or_gpl-2.0-plus_or_lgpl-2.1-plus_21.yml", "YAML", 0, 0, 0, 9, 0, 0, 1, 10
"d:\IDEWORK\lvmen\src\licensedcode\data\rules\mpl-1.1_or_gpl-2.0-plus_or_lgpl-2.1-plus_22.yml", "YAML", 0, 0, 0, 5, 0, 0, 1, 6
"d:\IDEWORK\lvmen\src\licensedcode\data\rules\mpl-1.1_or_gpl-2.0-plus_or_lgpl-2.1-plus_23.yml", "YAML", 0, 0, 0, 3, 0, 0, 1, 4
"d:\IDEWORK\lvmen\src\licensedcode\data\rules\mpl-1.1_or_gpl-2.0-plus_or_lgpl-2.1-plus_24.yml", "YAML", 0, 0, 0, 7, 0, 0, 1, 8
"d:\IDEWORK\lvmen\src\licensedcode\data\rules\mpl-1.1_or_gpl-2.0-plus_or_lgpl-2.1-plus_25.yml", "YAML", 0, 0, 0, 7, 0, 0, 1, 8
"d:\IDEWORK\lvmen\src\licensedcode\data\rules\mpl-1.1_or_gpl-2.0-plus_or_lgpl-2.1-plus_26.yml", "YAML", 0, 0, 0, 11, 0, 0, 1, 12
"d:\IDEWORK\lvmen\src\licensedcode\data\rules\mpl-1.1_or_gpl-2.0-plus_or_lgpl-2.1-plus_27.yml", "YAML", 0, 0, 0, 7, 0, 0, 1, 8
"d:\IDEWORK\lvmen\src\licensedcode\data\rules\mpl-1.1_or_gpl-2.0-plus_or_lgpl-2.1-plus_28.yml", "YAML", 0, 0, 0, 11, 0, 0, 1, 12
"d:\IDEWORK\lvmen\src\licensedcode\data\rules\mpl-1.1_or_gpl-2.0-plus_or_lgpl-2.1-plus_29.yml", "YAML", 0, 0, 0, 6, 0, 0, 1, 7
"d:\IDEWORK\lvmen\src\licensedcode\data\rules\mpl-1.1_or_gpl-2.0-plus_or_lgpl-2.1-plus_3.yml", "YAML", 0, 0, 0, 5, 0, 0, 1, 6
"d:\IDEWORK\lvmen\src\licensedcode\data\rules\mpl-1.1_or_gpl-2.0-plus_or_lgpl-2.1-plus_30.yml", "YAML", 0, 0, 0, 7, 0, 0, 1, 8
"d:\IDEWORK\lvmen\src\licensedcode\data\rules\mpl-1.1_or_gpl-2.0-plus_or_lgpl-2.1-plus_4.yml", "YAML", 0, 0, 0, 5, 0, 0, 1, 6
"d:\IDEWORK\lvmen\src\licensedcode\data\rules\mpl-1.1_or_gpl-2.0-plus_or_lgpl-2.1-plus_5.yml", "YAML", 0, 0, 0, 4, 0, 0, 1, 5
"d:\IDEWORK\lvmen\src\licensedcode\data\rules\mpl-1.1_or_gpl-2.0-plus_or_lgpl-2.1-plus_6.yml", "YAML", 0, 0, 0, 3, 0, 0, 1, 4
"d:\IDEWORK\lvmen\src\licensedcode\data\rules\mpl-1.1_or_gpl-2.0-plus_or_lgpl-2.1-plus_7.yml", "YAML", 0, 0, 0, 4, 0, 0, 1, 5
"d:\IDEWORK\lvmen\src\licensedcode\data\rules\mpl-1.1_or_gpl-2.0-plus_or_lgpl-2.1-plus_8.yml", "YAML", 0, 0, 0, 3, 0, 0, 1, 4
"d:\IDEWORK\lvmen\src\licensedcode\data\rules\mpl-1.1_or_gpl-2.0-plus_or_lgpl-2.1-plus_9.yml", "YAML", 0, 0, 0, 10, 0, 0, 1, 11
"d:\IDEWORK\lvmen\src\licensedcode\data\rules\mpl-1.1_or_gpl-2.0-plus_or_lgpl-2.1-plus_with_openmotif-exception-2.0-plus_1.yml", "YAML", 0, 0, 0, 4, 0, 0, 1, 5
"d:\IDEWORK\lvmen\src\licensedcode\data\rules\mpl-1.1_or_gpl-2.0_1.yml", "YAML", 0, 0, 0, 5, 0, 0, 1, 6
"d:\IDEWORK\lvmen\src\licensedcode\data\rules\mpl-1.1_or_gpl-2.0_10.yml", "YAML", 0, 0, 0, 4, 0, 0, 1, 5
"d:\IDEWORK\lvmen\src\licensedcode\data\rules\mpl-1.1_or_gpl-2.0_2.yml", "YAML", 0, 0, 0, 5, 0, 0, 1, 6
"d:\IDEWORK\lvmen\src\licensedcode\data\rules\mpl-1.1_or_gpl-2.0_3.yml", "YAML", 0, 0, 0, 4, 0, 0, 1, 5
"d:\IDEWORK\lvmen\src\licensedcode\data\rules\mpl-1.1_or_gpl-2.0_4.yml", "YAML", 0, 0, 0, 4, 0, 0, 1, 5
"d:\IDEWORK\lvmen\src\licensedcode\data\rules\mpl-1.1_or_gpl-2.0_5.yml", "YAML", 0, 0, 0, 4, 0, 0, 1, 5
"d:\IDEWORK\lvmen\src\licensedcode\data\rules\mpl-1.1_or_gpl-2.0_6.yml", "YAML", 0, 0, 0, 5, 0, 0, 1, 6
"d:\IDEWORK\lvmen\src\licensedcode\data\rules\mpl-1.1_or_gpl-2.0_7.yml", "YAML", 0, 0, 0, 7, 0, 0, 1, 8
"d:\IDEWORK\lvmen\src\licensedcode\data\rules\mpl-1.1_or_gpl-2.0_8.yml", "YAML", 0, 0, 0, 2, 0, 0, 1, 3
"d:\IDEWORK\lvmen\src\licensedcode\data\rules\mpl-1.1_or_gpl-2.0_9.yml", "YAML", 0, 0, 0, 4, 0, 0, 1, 5
"d:\IDEWORK\lvmen\src\licensedcode\data\rules\mpl-1.1_or_gpl-2.0_and_bsd-new_1.yml", "YAML", 0, 0, 0, 2, 0, 0, 1, 3
"d:\IDEWORK\lvmen\src\licensedcode\data\rules\mpl-1.1_or_gpl-2.0_and_bsd-new_2.yml", "YAML", 0, 0, 0, 2, 0, 0, 1, 3
"d:\IDEWORK\lvmen\src\licensedcode\data\rules\mpl-1.1_or_gpl-2.0_or_apache-2.0_1.yml", "YAML", 0, 0, 0, 7, 0, 0, 1, 8
"d:\IDEWORK\lvmen\src\licensedcode\data\rules\mpl-1.1_or_gpl-2.0_or_apache-2.0_2.yml", "YAML", 0, 0, 0, 8, 0, 0, 1, 9
"d:\IDEWORK\lvmen\src\licensedcode\data\rules\mpl-1.1_or_gpl-2.0_or_lgpl-2.0_1.yml", "YAML", 0, 0, 0, 3, 0, 0, 1, 4
"d:\IDEWORK\lvmen\src\licensedcode\data\rules\mpl-1.1_or_gpl-2.0_or_lgpl-2.1_1.yml", "YAML", 0, 0, 0, 3, 0, 0, 1, 4
"d:\IDEWORK\lvmen\src\licensedcode\data\rules\mpl-1.1_or_gpl-2.0_or_lgpl-2.1_2.yml", "YAML", 0, 0, 0, 3, 0, 0, 1, 4
"d:\IDEWORK\lvmen\src\licensedcode\data\rules\mpl-1.1_or_gpl-2.0_or_lgpl-2.1_3.yml", "YAML", 0, 0, 0, 3, 0, 0, 1, 4
"d:\IDEWORK\lvmen\src\licensedcode\data\rules\mpl-1.1_or_gpl-2.0_or_lgpl-2.1_4.yml", "YAML", 0, 0, 0, 3, 0, 0, 1, 4
"d:\IDEWORK\lvmen\src\licensedcode\data\rules\mpl-1.1_or_gpl-2.0_or_lgpl-2.1_5.yml", "YAML", 0, 0, 0, 3, 0, 0, 1, 4
"d:\IDEWORK\lvmen\src\licensedcode\data\rules\mpl-1.1_or_gpl-3.0-plus_or_lgpl-3.0-plus_1.yml", "YAML", 0, 0, 0, 3, 0, 0, 1, 4
"d:\IDEWORK\lvmen\src\licensedcode\data\rules\mpl-1.1_or_gpl-3.0-plus_or_lgpl-3.0-plus_2.yml", "YAML", 0, 0, 0, 5, 0, 0, 1, 6
"d:\IDEWORK\lvmen\src\licensedcode\data\rules\mpl-1.1_or_gpl-3.0-plus_or_lgpl-3.0-plus_3.yml", "YAML", 0, 0, 0, 4, 0, 0, 1, 5
"d:\IDEWORK\lvmen\src\licensedcode\data\rules\mpl-1.1_or_lgpl-2.0-plus_1.yml", "YAML", 0, 0, 0, 2, 0, 0, 1, 3
"d:\IDEWORK\lvmen\src\licensedcode\data\rules\mpl-1.1_or_lgpl-2.0-plus_2.yml", "YAML", 0, 0, 0, 5, 0, 0, 1, 6
"d:\IDEWORK\lvmen\src\licensedcode\data\rules\mpl-1.1_or_lgpl-2.0-plus_3.yml", "YAML", 0, 0, 0, 5, 0, 0, 1, 6
"d:\IDEWORK\lvmen\src\licensedcode\data\rules\mpl-1.1_or_lgpl-2.1-plus_1.yml", "YAML", 0, 0, 0, 3, 0, 0, 1, 4
"d:\IDEWORK\lvmen\src\licensedcode\data\rules\mpl-1.1_or_lgpl-2.1-plus_10.yml", "YAML", 0, 0, 0, 6, 0, 0, 1, 7
"d:\IDEWORK\lvmen\src\licensedcode\data\rules\mpl-1.1_or_lgpl-2.1-plus_11.yml", "YAML", 0, 0, 0, 7, 0, 0, 1, 8
"d:\IDEWORK\lvmen\src\licensedcode\data\rules\mpl-1.1_or_lgpl-2.1-plus_12.yml", "YAML", 0, 0, 0, 7, 0, 0, 1, 8
"d:\IDEWORK\lvmen\src\licensedcode\data\rules\mpl-1.1_or_lgpl-2.1-plus_2.yml", "YAML", 0, 0, 0, 6, 0, 0, 1, 7
"d:\IDEWORK\lvmen\src\licensedcode\data\rules\mpl-1.1_or_lgpl-2.1-plus_3.yml", "YAML", 0, 0, 0, 6, 0, 0, 1, 7
"d:\IDEWORK\lvmen\src\licensedcode\data\rules\mpl-1.1_or_lgpl-2.1-plus_4.yml", "YAML", 0, 0, 0, 6, 0, 0, 1, 7
"d:\IDEWORK\lvmen\src\licensedcode\data\rules\mpl-1.1_or_lgpl-2.1-plus_5.yml", "YAML", 0, 0, 0, 4, 0, 0, 1, 5
"d:\IDEWORK\lvmen\src\licensedcode\data\rules\mpl-1.1_or_lgpl-2.1-plus_6.yml", "YAML", 0, 0, 0, 7, 0, 0, 1, 8
"d:\IDEWORK\lvmen\src\licensedcode\data\rules\mpl-1.1_or_lgpl-2.1-plus_7.yml", "YAML", 0, 0, 0, 5, 0, 0, 1, 6
"d:\IDEWORK\lvmen\src\licensedcode\data\rules\mpl-1.1_or_lgpl-2.1-plus_8.yml", "YAML", 0, 0, 0, 5, 0, 0, 1, 6
"d:\IDEWORK\lvmen\src\licensedcode\data\rules\mpl-1.1_or_lgpl-2.1-plus_9.yml", "YAML", 0, 0, 0, 7, 0, 0, 1, 8
"d:\IDEWORK\lvmen\src\licensedcode\data\rules\mpl-1.1_or_lgpl-2.1-plus_or_apache-2.0_1.yml", "YAML", 0, 0, 0, 7, 0, 0, 1, 8
"d:\IDEWORK\lvmen\src\licensedcode\data\rules\mpl-1.1_or_lgpl-2.1-plus_or_apache-2.0_10.yml", "YAML", 0, 0, 0, 11, 0, 0, 1, 12
"d:\IDEWORK\lvmen\src\licensedcode\data\rules\mpl-1.1_or_lgpl-2.1-plus_or_apache-2.0_11.yml", "YAML", 0, 0, 0, 10, 0, 0, 1, 11
"d:\IDEWORK\lvmen\src\licensedcode\data\rules\mpl-1.1_or_lgpl-2.1-plus_or_apache-2.0_12.yml", "YAML", 0, 0, 0, 12, 0, 0, 1, 13
"d:\IDEWORK\lvmen\src\licensedcode\data\rules\mpl-1.1_or_lgpl-2.1-plus_or_apache-2.0_13.yml", "YAML", 0, 0, 0, 7, 0, 0, 1, 8
"d:\IDEWORK\lvmen\src\licensedcode\data\rules\mpl-1.1_or_lgpl-2.1-plus_or_apache-2.0_14.yml", "YAML", 0, 0, 0, 8, 0, 0, 1, 9
"d:\IDEWORK\lvmen\src\licensedcode\data\rules\mpl-1.1_or_lgpl-2.1-plus_or_apache-2.0_15.yml", "YAML", 0, 0, 0, 8, 0, 0, 1, 9
"d:\IDEWORK\lvmen\src\licensedcode\data\rules\mpl-1.1_or_lgpl-2.1-plus_or_apache-2.0_2.yml", "YAML", 0, 0, 0, 3, 0, 0, 1, 4
"d:\IDEWORK\lvmen\src\licensedcode\data\rules\mpl-1.1_or_lgpl-2.1-plus_or_apache-2.0_3.yml", "YAML", 0, 0, 0, 2, 0, 0, 1, 3
"d:\IDEWORK\lvmen\src\licensedcode\data\rules\mpl-1.1_or_lgpl-2.1-plus_or_apache-2.0_4.yml", "YAML", 0, 0, 0, 6, 0, 0, 1, 7
"d:\IDEWORK\lvmen\src\licensedcode\data\rules\mpl-1.1_or_lgpl-2.1-plus_or_apache-2.0_5.yml", "YAML", 0, 0, 0, 2, 0, 0, 1, 3
"d:\IDEWORK\lvmen\src\licensedcode\data\rules\mpl-1.1_or_lgpl-2.1-plus_or_apache-2.0_6.yml", "YAML", 0, 0, 0, 3, 0, 0, 1, 4
"d:\IDEWORK\lvmen\src\licensedcode\data\rules\mpl-1.1_or_lgpl-2.1-plus_or_apache-2.0_7.yml", "YAML", 0, 0, 0, 6, 0, 0, 1, 7
"d:\IDEWORK\lvmen\src\licensedcode\data\rules\mpl-1.1_or_lgpl-2.1-plus_or_apache-2.0_8.yml", "YAML", 0, 0, 0, 10, 0, 0, 1, 11
"d:\IDEWORK\lvmen\src\licensedcode\data\rules\mpl-1.1_or_lgpl-2.1-plus_or_apache-2.0_9.yml", "YAML", 0, 0, 0, 10, 0, 0, 1, 11
"d:\IDEWORK\lvmen\src\licensedcode\data\rules\mpl-1.1_or_lgpl-2.1-plus_or_gpl-2.0-plus_1.yml", "YAML", 0, 0, 0, 5, 0, 0, 1, 6
"d:\IDEWORK\lvmen\src\licensedcode\data\rules\mpl-1.1_or_lgpl-2.1-plus_or_gpl-2.0-plus_2.yml", "YAML", 0, 0, 0, 5, 0, 0, 1, 6
"d:\IDEWORK\lvmen\src\licensedcode\data\rules\mpl-1.1_or_lgpl-2.1_2.yml", "YAML", 0, 0, 0, 4, 0, 0, 1, 5
"d:\IDEWORK\lvmen\src\licensedcode\data\rules\mpl-1.1_url_1.yml", "YAML", 0, 0, 0, 5, 0, 0, 1, 6
"d:\IDEWORK\lvmen\src\licensedcode\data\rules\mpl-1.1_url_2.yml", "YAML", 0, 0, 0, 5, 0, 0, 1, 6
"d:\IDEWORK\lvmen\src\licensedcode\data\rules\mpl-1.1_url_glc_188.yml", "YAML", 0, 0, 0, 5, 0, 0, 1, 6
"d:\IDEWORK\lvmen\src\licensedcode\data\rules\mpl-1.1_url_glc_189.yml", "YAML", 0, 0, 0, 5, 0, 0, 1, 6
"d:\IDEWORK\lvmen\src\licensedcode\data\rules\mpl-2.0-no-copyleft-exception2.yml", "YAML", 0, 0, 0, 4, 0, 0, 1, 5
"d:\IDEWORK\lvmen\src\licensedcode\data\rules\mpl-2.0-no-copyleft-exception3.yml", "YAML", 0, 0, 0, 6, 0, 0, 1, 7
"d:\IDEWORK\lvmen\src\licensedcode\data\rules\mpl-2.0-no-copyleft-exception_url_1.yml", "YAML", 0, 0, 0, 5, 0, 0, 1, 6
"d:\IDEWORK\lvmen\src\licensedcode\data\rules\mpl-2.0-no-copyleft-exception_url_2.yml", "YAML", 0, 0, 0, 5, 0, 0, 1, 6
"d:\IDEWORK\lvmen\src\licensedcode\data\rules\mpl-2.0_1.yml", "YAML", 0, 0, 0, 5, 0, 0, 1, 6
"d:\IDEWORK\lvmen\src\licensedcode\data\rules\mpl-2.0_10.yml", "YAML", 0, 0, 0, 4, 0, 0, 1, 5
"d:\IDEWORK\lvmen\src\licensedcode\data\rules\mpl-2.0_100.yml", "YAML", 0, 0, 0, 3, 0, 0, 1, 4
"d:\IDEWORK\lvmen\src\licensedcode\data\rules\mpl-2.0_101.yml", "YAML", 0, 0, 0, 3, 0, 0, 1, 4
"d:\IDEWORK\lvmen\src\licensedcode\data\rules\mpl-2.0_102.yml", "YAML", 0, 0, 0, 3, 0, 0, 1, 4
"d:\IDEWORK\lvmen\src\licensedcode\data\rules\mpl-2.0_103.yml", "YAML", 0, 0, 0, 5, 0, 0, 1, 6
"d:\IDEWORK\lvmen\src\licensedcode\data\rules\mpl-2.0_104.yml", "YAML", 0, 0, 0, 4, 0, 0, 1, 5
"d:\IDEWORK\lvmen\src\licensedcode\data\rules\mpl-2.0_11.yml", "YAML", 0, 0, 0, 4, 0, 0, 1, 5
"d:\IDEWORK\lvmen\src\licensedcode\data\rules\mpl-2.0_12.yml", "YAML", 0, 0, 0, 5, 0, 0, 1, 6
"d:\IDEWORK\lvmen\src\licensedcode\data\rules\mpl-2.0_13.yml", "YAML", 0, 0, 0, 5, 0, 0, 1, 6
"d:\IDEWORK\lvmen\src\licensedcode\data\rules\mpl-2.0_14.yml", "YAML", 0, 0, 0, 3, 0, 0, 1, 4
"d:\IDEWORK\lvmen\src\licensedcode\data\rules\mpl-2.0_15.yml", "YAML", 0, 0, 0, 5, 0, 0, 1, 6
"d:\IDEWORK\lvmen\src\licensedcode\data\rules\mpl-2.0_16.yml", "YAML", 0, 0, 0, 5, 0, 0, 1, 6
"d:\IDEWORK\lvmen\src\licensedcode\data\rules\mpl-2.0_17.yml", "YAML", 0, 0, 0, 5, 0, 0, 1, 6
"d:\IDEWORK\lvmen\src\licensedcode\data\rules\mpl-2.0_18.yml", "YAML", 0, 0, 0, 4, 0, 0, 1, 5
"d:\IDEWORK\lvmen\src\licensedcode\data\rules\mpl-2.0_19.yml", "YAML", 0, 0, 0, 5, 0, 0, 1, 6
"d:\IDEWORK\lvmen\src\licensedcode\data\rules\mpl-2.0_2.yml", "YAML", 0, 0, 0, 5, 0, 0, 1, 6
"d:\IDEWORK\lvmen\src\licensedcode\data\rules\mpl-2.0_20.yml", "YAML", 0, 0, 0, 2, 0, 0, 1, 3
"d:\IDEWORK\lvmen\src\licensedcode\data\rules\mpl-2.0_21.yml", "YAML", 0, 0, 0, 3, 0, 0, 1, 4
"d:\IDEWORK\lvmen\src\licensedcode\data\rules\mpl-2.0_22.yml", "YAML", 0, 0, 0, 3, 0, 0, 1, 4
"d:\IDEWORK\lvmen\src\licensedcode\data\rules\mpl-2.0_23.yml", "YAML", 0, 0, 0, 2, 0, 0, 1, 3
"d:\IDEWORK\lvmen\src\licensedcode\data\rules\mpl-2.0_24.yml", "YAML", 0, 0, 0, 3, 0, 0, 1, 4
"d:\IDEWORK\lvmen\src\licensedcode\data\rules\mpl-2.0_25.yml", "YAML", 0, 0, 0, 4, 0, 0, 1, 5
"d:\IDEWORK\lvmen\src\licensedcode\data\rules\mpl-2.0_26.yml", "YAML", 0, 0, 0, 4, 0, 0, 1, 5
"d:\IDEWORK\lvmen\src\licensedcode\data\rules\mpl-2.0_27.yml", "YAML", 0, 0, 0, 2, 0, 0, 1, 3
"d:\IDEWORK\lvmen\src\licensedcode\data\rules\mpl-2.0_28.yml", "YAML", 0, 0, 0, 7, 0, 0, 1, 8
"d:\IDEWORK\lvmen\src\licensedcode\data\rules\mpl-2.0_29.yml", "YAML", 0, 0, 0, 3, 0, 0, 1, 4
"d:\IDEWORK\lvmen\src\licensedcode\data\rules\mpl-2.0_3.yml", "YAML", 0, 0, 0, 4, 0, 0, 1, 5
"d:\IDEWORK\lvmen\src\licensedcode\data\rules\mpl-2.0_30.yml", "YAML", 0, 0, 0, 5, 0, 0, 1, 6
"d:\IDEWORK\lvmen\src\licensedcode\data\rules\mpl-2.0_31.yml", "YAML", 0, 0, 0, 5, 0, 0, 1, 6
"d:\IDEWORK\lvmen\src\licensedcode\data\rules\mpl-2.0_32.yml", "YAML", 0, 0, 0, 3, 0, 0, 1, 4
"d:\IDEWORK\lvmen\src\licensedcode\data\rules\mpl-2.0_33.yml", "YAML", 0, 0, 0, 3, 0, 0, 1, 4
"d:\IDEWORK\lvmen\src\licensedcode\data\rules\mpl-2.0_34.yml", "YAML", 0, 0, 0, 5, 0, 0, 1, 6
"d:\IDEWORK\lvmen\src\licensedcode\data\rules\mpl-2.0_35.yml", "YAML", 0, 0, 0, 3, 0, 0, 1, 4
"d:\IDEWORK\lvmen\src\licensedcode\data\rules\mpl-2.0_36.yml", "YAML", 0, 0, 0, 5, 0, 0, 1, 6
"d:\IDEWORK\lvmen\src\licensedcode\data\rules\mpl-2.0_37.yml", "YAML", 0, 0, 0, 5, 0, 0, 1, 6
"d:\IDEWORK\lvmen\src\licensedcode\data\rules\mpl-2.0_38.yml", "YAML", 0, 0, 0, 5, 0, 0, 1, 6
"d:\IDEWORK\lvmen\src\licensedcode\data\rules\mpl-2.0_39.yml", "YAML", 0, 0, 0, 3, 0, 0, 1, 4
"d:\IDEWORK\lvmen\src\licensedcode\data\rules\mpl-2.0_4.yml", "YAML", 0, 0, 0, 5, 0, 0, 1, 6
"d:\IDEWORK\lvmen\src\licensedcode\data\rules\mpl-2.0_40.yml", "YAML", 0, 0, 0, 5, 0, 0, 1, 6
"d:\IDEWORK\lvmen\src\licensedcode\data\rules\mpl-2.0_41.yml", "YAML", 0, 0, 0, 3, 0, 0, 1, 4
"d:\IDEWORK\lvmen\src\licensedcode\data\rules\mpl-2.0_42.yml", "YAML", 0, 0, 0, 4, 0, 0, 1, 5
"d:\IDEWORK\lvmen\src\licensedcode\data\rules\mpl-2.0_43.yml", "YAML", 0, 0, 0, 5, 0, 0, 1, 6
"d:\IDEWORK\lvmen\src\licensedcode\data\rules\mpl-2.0_44.yml", "YAML", 0, 0, 0, 3, 0, 0, 1, 4
"d:\IDEWORK\lvmen\src\licensedcode\data\rules\mpl-2.0_45.yml", "YAML", 0, 0, 0, 5, 0, 0, 1, 6
"d:\IDEWORK\lvmen\src\licensedcode\data\rules\mpl-2.0_46.yml", "YAML", 0, 0, 0, 5, 0, 0, 1, 6
"d:\IDEWORK\lvmen\src\licensedcode\data\rules\mpl-2.0_47.yml", "YAML", 0, 0, 0, 5, 0, 0, 1, 6
"d:\IDEWORK\lvmen\src\licensedcode\data\rules\mpl-2.0_48.yml", "YAML", 0, 0, 0, 5, 0, 0, 1, 6
"d:\IDEWORK\lvmen\src\licensedcode\data\rules\mpl-2.0_49.yml", "YAML", 0, 0, 0, 5, 0, 0, 1, 6
"d:\IDEWORK\lvmen\src\licensedcode\data\rules\mpl-2.0_5.yml", "YAML", 0, 0, 0, 5, 0, 0, 1, 6
"d:\IDEWORK\lvmen\src\licensedcode\data\rules\mpl-2.0_50.yml", "YAML", 0, 0, 0, 3, 0, 0, 1, 4
"d:\IDEWORK\lvmen\src\licensedcode\data\rules\mpl-2.0_51.yml", "YAML", 0, 0, 0, 3, 0, 0, 1, 4
"d:\IDEWORK\lvmen\src\licensedcode\data\rules\mpl-2.0_52.yml", "YAML", 0, 0, 0, 5, 0, 0, 1, 6
"d:\IDEWORK\lvmen\src\licensedcode\data\rules\mpl-2.0_53.yml", "YAML", 0, 0, 0, 3, 0, 0, 1, 4
"d:\IDEWORK\lvmen\src\licensedcode\data\rules\mpl-2.0_54.yml", "YAML", 0, 0, 0, 3, 0, 0, 1, 4
"d:\IDEWORK\lvmen\src\licensedcode\data\rules\mpl-2.0_55.yml", "YAML", 0, 0, 0, 3, 0, 0, 1, 4
"d:\IDEWORK\lvmen\src\licensedcode\data\rules\mpl-2.0_56.yml", "YAML", 0, 0, 0, 5, 0, 0, 1, 6
"d:\IDEWORK\lvmen\src\licensedcode\data\rules\mpl-2.0_57.yml", "YAML", 0, 0, 0, 6, 0, 0, 1, 7
"d:\IDEWORK\lvmen\src\licensedcode\data\rules\mpl-2.0_58.yml", "YAML", 0, 0, 0, 5, 0, 0, 1, 6
"d:\IDEWORK\lvmen\src\licensedcode\data\rules\mpl-2.0_59.yml", "YAML", 0, 0, 0, 5, 0, 0, 1, 6
"d:\IDEWORK\lvmen\src\licensedcode\data\rules\mpl-2.0_6.yml", "YAML", 0, 0, 0, 4, 0, 0, 1, 5
"d:\IDEWORK\lvmen\src\licensedcode\data\rules\mpl-2.0_60.yml", "YAML", 0, 0, 0, 3, 0, 0, 1, 4
"d:\IDEWORK\lvmen\src\licensedcode\data\rules\mpl-2.0_61.yml", "YAML", 0, 0, 0, 6, 0, 0, 1, 7
"d:\IDEWORK\lvmen\src\licensedcode\data\rules\mpl-2.0_62.yml", "YAML", 0, 0, 0, 3, 0, 0, 1, 4
"d:\IDEWORK\lvmen\src\licensedcode\data\rules\mpl-2.0_63.yml", "YAML", 0, 0, 0, 3, 0, 0, 1, 4
"d:\IDEWORK\lvmen\src\licensedcode\data\rules\mpl-2.0_64.yml", "YAML", 0, 0, 0, 3, 0, 0, 1, 4
"d:\IDEWORK\lvmen\src\licensedcode\data\rules\mpl-2.0_65.yml", "YAML", 0, 0, 0, 5, 0, 0, 1, 6
"d:\IDEWORK\lvmen\src\licensedcode\data\rules\mpl-2.0_66.yml", "YAML", 0, 0, 0, 5, 0, 0, 1, 6
"d:\IDEWORK\lvmen\src\licensedcode\data\rules\mpl-2.0_67.yml", "YAML", 0, 0, 0, 5, 0, 0, 1, 6
"d:\IDEWORK\lvmen\src\licensedcode\data\rules\mpl-2.0_68.yml", "YAML", 0, 0, 0, 3, 0, 0, 1, 4
"d:\IDEWORK\lvmen\src\licensedcode\data\rules\mpl-2.0_69.yml", "YAML", 0, 0, 0, 5, 0, 0, 1, 6
"d:\IDEWORK\lvmen\src\licensedcode\data\rules\mpl-2.0_7.yml", "YAML", 0, 0, 0, 4, 0, 0, 1, 5
"d:\IDEWORK\lvmen\src\licensedcode\data\rules\mpl-2.0_70.yml", "YAML", 0, 0, 0, 3, 0, 0, 1, 4
"d:\IDEWORK\lvmen\src\licensedcode\data\rules\mpl-2.0_71.yml", "YAML", 0, 0, 0, 3, 0, 0, 1, 4
"d:\IDEWORK\lvmen\src\licensedcode\data\rules\mpl-2.0_72.yml", "YAML", 0, 0, 0, 10, 0, 0, 1, 11
"d:\IDEWORK\lvmen\src\licensedcode\data\rules\mpl-2.0_73.yml", "YAML", 0, 0, 0, 3, 0, 0, 1, 4
"d:\IDEWORK\lvmen\src\licensedcode\data\rules\mpl-2.0_74.yml", "YAML", 0, 0, 0, 3, 0, 0, 1, 4
"d:\IDEWORK\lvmen\src\licensedcode\data\rules\mpl-2.0_75.yml", "YAML", 0, 0, 0, 3, 0, 0, 1, 4
"d:\IDEWORK\lvmen\src\licensedcode\data\rules\mpl-2.0_76.yml", "YAML", 0, 0, 0, 7, 0, 0, 1, 8
"d:\IDEWORK\lvmen\src\licensedcode\data\rules\mpl-2.0_77.yml", "YAML", 0, 0, 0, 6, 0, 0, 1, 7
"d:\IDEWORK\lvmen\src\licensedcode\data\rules\mpl-2.0_78.yml", "YAML", 0, 0, 0, 3, 0, 0, 1, 4
"d:\IDEWORK\lvmen\src\licensedcode\data\rules\mpl-2.0_79.yml", "YAML", 0, 0, 0, 5, 0, 0, 1, 6
"d:\IDEWORK\lvmen\src\licensedcode\data\rules\mpl-2.0_8.yml", "YAML", 0, 0, 0, 4, 0, 0, 1, 5
"d:\IDEWORK\lvmen\src\licensedcode\data\rules\mpl-2.0_80.yml", "YAML", 0, 0, 0, 3, 0, 0, 1, 4
"d:\IDEWORK\lvmen\src\licensedcode\data\rules\mpl-2.0_81.yml", "YAML", 0, 0, 0, 3, 0, 0, 1, 4
"d:\IDEWORK\lvmen\src\licensedcode\data\rules\mpl-2.0_82.yml", "YAML", 0, 0, 0, 3, 0, 0, 1, 4
"d:\IDEWORK\lvmen\src\licensedcode\data\rules\mpl-2.0_83.yml", "YAML", 0, 0, 0, 3, 0, 0, 1, 4
"d:\IDEWORK\lvmen\src\licensedcode\data\rules\mpl-2.0_84.yml", "YAML", 0, 0, 0, 3, 0, 0, 1, 4
"d:\IDEWORK\lvmen\src\licensedcode\data\rules\mpl-2.0_85.yml", "YAML", 0, 0, 0, 3, 0, 0, 1, 4
"d:\IDEWORK\lvmen\src\licensedcode\data\rules\mpl-2.0_86.yml", "YAML", 0, 0, 0, 3, 0, 0, 1, 4
"d:\IDEWORK\lvmen\src\licensedcode\data\rules\mpl-2.0_87.yml", "YAML", 0, 0, 0, 5, 0, 0, 1, 6
"d:\IDEWORK\lvmen\src\licensedcode\data\rules\mpl-2.0_88.yml", "YAML", 0, 0, 0, 3, 0, 0, 1, 4
"d:\IDEWORK\lvmen\src\licensedcode\data\rules\mpl-2.0_89.yml", "YAML", 0, 0, 0, 5, 0, 0, 1, 6
"d:\IDEWORK\lvmen\src\licensedcode\data\rules\mpl-2.0_9.yml", "YAML", 0, 0, 0, 5, 0, 0, 1, 6
"d:\IDEWORK\lvmen\src\licensedcode\data\rules\mpl-2.0_90.yml", "YAML", 0, 0, 0, 3, 0, 0, 1, 4
"d:\IDEWORK\lvmen\src\licensedcode\data\rules\mpl-2.0_91.yml", "YAML", 0, 0, 0, 3, 0, 0, 1, 4
"d:\IDEWORK\lvmen\src\licensedcode\data\rules\mpl-2.0_92.yml", "YAML", 0, 0, 0, 3, 0, 0, 1, 4
"d:\IDEWORK\lvmen\src\licensedcode\data\rules\mpl-2.0_93.yml", "YAML", 0, 0, 0, 3, 0, 0, 1, 4
"d:\IDEWORK\lvmen\src\licensedcode\data\rules\mpl-2.0_94.yml", "YAML", 0, 0, 0, 3, 0, 0, 1, 4
"d:\IDEWORK\lvmen\src\licensedcode\data\rules\mpl-2.0_95.yml", "YAML", 0, 0, 0, 3, 0, 0, 1, 4
"d:\IDEWORK\lvmen\src\licensedcode\data\rules\mpl-2.0_96.yml", "YAML", 0, 0, 0, 3, 0, 0, 1, 4
"d:\IDEWORK\lvmen\src\licensedcode\data\rules\mpl-2.0_97.yml", "YAML", 0, 0, 0, 3, 0, 0, 1, 4
"d:\IDEWORK\lvmen\src\licensedcode\data\rules\mpl-2.0_98.yml", "YAML", 0, 0, 0, 5, 0, 0, 1, 6
"d:\IDEWORK\lvmen\src\licensedcode\data\rules\mpl-2.0_99.yml", "YAML", 0, 0, 0, 3, 0, 0, 1, 4
"d:\IDEWORK\lvmen\src\licensedcode\data\rules\mpl-2.0_and_cc-by-sa-3.0.yml", "YAML", 0, 0, 0, 6, 0, 0, 1, 7
"d:\IDEWORK\lvmen\src\licensedcode\data\rules\mpl-2.0_and_free-unknown_1.yml", "YAML", 0, 0, 0, 7, 0, 0, 1, 8
"d:\IDEWORK\lvmen\src\licensedcode\data\rules\mpl-2.0_and_lgpl-2.1_and_lgpl-2.1-plus_and_bsd-new_and_other-permissive.yml", "YAML", 0, 0, 0, 9, 0, 0, 1, 10
"d:\IDEWORK\lvmen\src\licensedcode\data\rules\mpl-2.0_and_mit_and_bsd-new_and_apache-2.0_and_json_1.yml", "YAML", 0, 0, 0, 3, 0, 0, 1, 4
"d:\IDEWORK\lvmen\src\licensedcode\data\rules\mpl-2.0_or_epl-1.0_and_proprietary-license_1.yml", "YAML", 0, 0, 0, 6, 0, 0, 1, 7
"d:\IDEWORK\lvmen\src\licensedcode\data\rules\mpl-2.0_or_epl-1.0_and_proprietary-license_2.yml", "YAML", 0, 0, 0, 5, 0, 0, 1, 6
"d:\IDEWORK\lvmen\src\licensedcode\data\rules\mpl-2.0_or_gpl-2.0_1.yml", "YAML", 0, 0, 0, 2, 0, 0, 1, 3
"d:\IDEWORK\lvmen\src\licensedcode\data\rules\mpl-2.0_or_gpl-2.0_2.yml", "YAML", 0, 0, 0, 4, 0, 0, 1, 5
"d:\IDEWORK\lvmen\src\licensedcode\data\rules\mpl-2.0_or_gpl-2.0_3.yml", "YAML", 0, 0, 0, 4, 0, 0, 1, 5
"d:\IDEWORK\lvmen\src\licensedcode\data\rules\mpl-2.0_or_gpl-2.0_4.yml", "YAML", 0, 0, 0, 4, 0, 0, 1, 5
"d:\IDEWORK\lvmen\src\licensedcode\data\rules\mpl-2.0_or_gpl-3.0-plus_1.yml", "YAML", 0, 0, 0, 3, 0, 0, 1, 4
"d:\IDEWORK\lvmen\src\licensedcode\data\rules\mpl-2.0_or_gpl-3.0-plus_2.yml", "YAML", 0, 0, 0, 3, 0, 0, 1, 4
"d:\IDEWORK\lvmen\src\licensedcode\data\rules\mpl-2.0_or_mit_1.yml", "YAML", 0, 0, 0, 3, 0, 0, 1, 4
"d:\IDEWORK\lvmen\src\licensedcode\data\rules\mpl-2.0_url_1.yml", "YAML", 0, 0, 0, 5, 0, 0, 1, 6
"d:\IDEWORK\lvmen\src\licensedcode\data\rules\mpl-2.0_url_2.yml", "YAML", 0, 0, 0, 5, 0, 0, 1, 6
"d:\IDEWORK\lvmen\src\licensedcode\data\rules\mpl-2.0_url_badge.yml", "YAML", 0, 0, 0, 5, 0, 0, 1, 6
"d:\IDEWORK\lvmen\src\licensedcode\data\rules\mpl-2.0_url_glc_98.yml", "YAML", 0, 0, 0, 5, 0, 0, 1, 6
"d:\IDEWORK\lvmen\src\licensedcode\data\rules\mpl-2.0_url_glc_99.yml", "YAML", 0, 0, 0, 5, 0, 0, 1, 6
"d:\IDEWORK\lvmen\src\licensedcode\data\rules\ms-asp-net-software_1.yml", "YAML", 0, 0, 0, 5, 0, 0, 1, 6
"d:\IDEWORK\lvmen\src\licensedcode\data\rules\ms-asp-net-software_2.yml", "YAML", 0, 0, 0, 5, 0, 0, 1, 6
"d:\IDEWORK\lvmen\src\licensedcode\data\rules\ms-asp-net-software_3.yml", "YAML", 0, 0, 0, 5, 0, 0, 1, 6
"d:\IDEWORK\lvmen\src\licensedcode\data\rules\ms-asp-net-software_4.yml", "YAML", 0, 0, 0, 5, 0, 0, 1, 6
"d:\IDEWORK\lvmen\src\licensedcode\data\rules\ms-asp-net-software_5.yml", "YAML", 0, 0, 0, 5, 0, 0, 1, 6
"d:\IDEWORK\lvmen\src\licensedcode\data\rules\ms-developer-services-agreement-2018-06_1.yml", "YAML", 0, 0, 0, 5, 0, 0, 1, 6
"d:\IDEWORK\lvmen\src\licensedcode\data\rules\ms-developer-services-agreement.yml", "YAML", 0, 0, 0, 6, 0, 0, 1, 7
"d:\IDEWORK\lvmen\src\licensedcode\data\rules\ms-developer-services-agreement2.yml", "YAML", 0, 0, 0, 6, 0, 0, 1, 7
"d:\IDEWORK\lvmen\src\licensedcode\data\rules\ms-eula-notice.yml", "YAML", 0, 0, 0, 2, 0, 0, 1, 3
"d:\IDEWORK\lvmen\src\licensedcode\data\rules\ms-invisible-eula-1.0.yml", "YAML", 0, 0, 0, 2, 0, 0, 1, 3
"d:\IDEWORK\lvmen\src\licensedcode\data\rules\ms-limited-public.yml", "YAML", 0, 0, 0, 5, 0, 0, 1, 6
"d:\IDEWORK\lvmen\src\licensedcode\data\rules\ms-lpl.yml", "YAML", 0, 0, 0, 5, 0, 0, 1, 6
"d:\IDEWORK\lvmen\src\licensedcode\data\rules\ms-lpl2.yml", "YAML", 0, 0, 0, 2, 0, 0, 1, 3
"d:\IDEWORK\lvmen\src\licensedcode\data\rules\ms-lpl_1.yml", "YAML", 0, 0, 0, 3, 0, 0, 1, 4
"d:\IDEWORK\lvmen\src\licensedcode\data\rules\ms-lpl_2.yml", "YAML", 0, 0, 0, 3, 0, 0, 1, 4
"d:\IDEWORK\lvmen\src\licensedcode\data\rules\ms-net-framework-4-supplemental-terms.yml", "YAML", 0, 0, 0, 5, 0, 0, 1, 6
"d:\IDEWORK\lvmen\src\licensedcode\data\rules\ms-net-library-2018-11_1.yml", "YAML", 0, 0, 0, 6, 0, 0, 1, 7
"d:\IDEWORK\lvmen\src\licensedcode\data\rules\ms-net-library-2018-11_2.yml", "YAML", 0, 0, 0, 5, 0, 0, 1, 6
"d:\IDEWORK\lvmen\src\licensedcode\data\rules\ms-net-library-2018-11_3.yml", "YAML", 0, 0, 0, 5, 0, 0, 1, 6
"d:\IDEWORK\lvmen\src\licensedcode\data\rules\ms-net-library-2019-06_1.yml", "YAML", 0, 0, 0, 5, 0, 0, 1, 6
"d:\IDEWORK\lvmen\src\licensedcode\data\rules\ms-net-library_1.yml", "YAML", 0, 0, 0, 5, 0, 0, 1, 6
"d:\IDEWORK\lvmen\src\licensedcode\data\rules\ms-net-library_2.yml", "YAML", 0, 0, 0, 5, 0, 0, 1, 6
"d:\IDEWORK\lvmen\src\licensedcode\data\rules\ms-net-library_3.yml", "YAML", 0, 0, 0, 4, 0, 0, 1, 5
"d:\IDEWORK\lvmen\src\licensedcode\data\rules\ms-net-library_4_old.yml", "YAML", 0, 0, 0, 4, 0, 0, 1, 5
"d:\IDEWORK\lvmen\src\licensedcode\data\rules\ms-net-library_5.yml", "YAML", 0, 0, 0, 5, 0, 0, 1, 6
"d:\IDEWORK\lvmen\src\licensedcode\data\rules\ms-net-library_6.yml", "YAML", 0, 0, 0, 5, 0, 0, 1, 6
"d:\IDEWORK\lvmen\src\licensedcode\data\rules\ms-nuget_1.yml", "YAML", 0, 0, 0, 2, 0, 0, 1, 3
"d:\IDEWORK\lvmen\src\licensedcode\data\rules\ms-nuget_2.yml", "YAML", 0, 0, 0, 2, 0, 0, 1, 3
"d:\IDEWORK\lvmen\src\licensedcode\data\rules\ms-nuget_3.yml", "YAML", 0, 0, 0, 5, 0, 0, 1, 6
"d:\IDEWORK\lvmen\src\licensedcode\data\rules\ms-nuget_4.yml", "YAML", 0, 0, 0, 5, 0, 0, 1, 6
"d:\IDEWORK\lvmen\src\licensedcode\data\rules\ms-nuget_and_mit_1.yml", "YAML", 0, 0, 0, 6, 0, 0, 1, 7
"d:\IDEWORK\lvmen\src\licensedcode\data\rules\ms-pl.SPDX.yml", "YAML", 0, 0, 0, 4, 0, 0, 1, 5
"d:\IDEWORK\lvmen\src\licensedcode\data\rules\ms-pl.yml", "YAML", 0, 0, 0, 5, 0, 0, 1, 6
"d:\IDEWORK\lvmen\src\licensedcode\data\rules\ms-pl_1.yml", "YAML", 0, 0, 0, 6, 0, 0, 1, 7
"d:\IDEWORK\lvmen\src\licensedcode\data\rules\ms-pl_10.yml", "YAML", 0, 0, 0, 5, 0, 0, 1, 6
"d:\IDEWORK\lvmen\src\licensedcode\data\rules\ms-pl_11.yml", "YAML", 0, 0, 0, 4, 0, 0, 1, 5
"d:\IDEWORK\lvmen\src\licensedcode\data\rules\ms-pl_12.yml", "YAML", 0, 0, 0, 4, 0, 0, 1, 5
"d:\IDEWORK\lvmen\src\licensedcode\data\rules\ms-pl_13.yml", "YAML", 0, 0, 0, 2, 0, 0, 1, 3
"d:\IDEWORK\lvmen\src\licensedcode\data\rules\ms-pl_14.yml", "YAML", 0, 0, 0, 2, 0, 0, 1, 3
"d:\IDEWORK\lvmen\src\licensedcode\data\rules\ms-pl_15.yml", "YAML", 0, 0, 0, 5, 0, 0, 1, 6
"d:\IDEWORK\lvmen\src\licensedcode\data\rules\ms-pl_16.yml", "YAML", 0, 0, 0, 5, 0, 0, 1, 6
"d:\IDEWORK\lvmen\src\licensedcode\data\rules\ms-pl_17.yml", "YAML", 0, 0, 0, 5, 0, 0, 1, 6
"d:\IDEWORK\lvmen\src\licensedcode\data\rules\ms-pl_18.yml", "YAML", 0, 0, 0, 5, 0, 0, 1, 6
"d:\IDEWORK\lvmen\src\licensedcode\data\rules\ms-pl_19.yml", "YAML", 0, 0, 0, 5, 0, 0, 1, 6
"d:\IDEWORK\lvmen\src\licensedcode\data\rules\ms-pl_2.yml", "YAML", 0, 0, 0, 5, 0, 0, 1, 6
"d:\IDEWORK\lvmen\src\licensedcode\data\rules\ms-pl_20.yml", "YAML", 0, 0, 0, 5, 0, 0, 1, 6
"d:\IDEWORK\lvmen\src\licensedcode\data\rules\ms-pl_21.yml", "YAML", 0, 0, 0, 5, 0, 0, 1, 6
"d:\IDEWORK\lvmen\src\licensedcode\data\rules\ms-pl_22.yml", "YAML", 0, 0, 0, 5, 0, 0, 1, 6
"d:\IDEWORK\lvmen\src\licensedcode\data\rules\ms-pl_23.yml", "YAML", 0, 0, 0, 5, 0, 0, 1, 6
"d:\IDEWORK\lvmen\src\licensedcode\data\rules\ms-pl_24.yml", "YAML", 0, 0, 0, 5, 0, 0, 1, 6
"d:\IDEWORK\lvmen\src\licensedcode\data\rules\ms-pl_25.yml", "YAML", 0, 0, 0, 5, 0, 0, 1, 6
"d:\IDEWORK\lvmen\src\licensedcode\data\rules\ms-pl_26.yml", "YAML", 0, 0, 0, 5, 0, 0, 1, 6
"d:\IDEWORK\lvmen\src\licensedcode\data\rules\ms-pl_27.yml", "YAML", 0, 0, 0, 5, 0, 0, 1, 6
"d:\IDEWORK\lvmen\src\licensedcode\data\rules\ms-pl_28.yml", "YAML", 0, 0, 0, 5, 0, 0, 1, 6
"d:\IDEWORK\lvmen\src\licensedcode\data\rules\ms-pl_29.yml", "YAML", 0, 0, 0, 5, 0, 0, 1, 6
"d:\IDEWORK\lvmen\src\licensedcode\data\rules\ms-pl_3.yml", "YAML", 0, 0, 0, 2, 0, 0, 1, 3
"d:\IDEWORK\lvmen\src\licensedcode\data\rules\ms-pl_30.yml", "YAML", 0, 0, 0, 3, 0, 0, 1, 4
"d:\IDEWORK\lvmen\src\licensedcode\data\rules\ms-pl_4.yml", "YAML", 0, 0, 0, 2, 0, 0, 1, 3
"d:\IDEWORK\lvmen\src\licensedcode\data\rules\ms-pl_5.yml", "YAML", 0, 0, 0, 5, 0, 0, 1, 6
"d:\IDEWORK\lvmen\src\licensedcode\data\rules\ms-pl_6.yml", "YAML", 0, 0, 0, 3, 0, 0, 1, 4
"d:\IDEWORK\lvmen\src\licensedcode\data\rules\ms-pl_7.yml", "YAML", 0, 0, 0, 3, 0, 0, 1, 4
"d:\IDEWORK\lvmen\src\licensedcode\data\rules\ms-pl_8.yml", "YAML", 0, 0, 0, 3, 0, 0, 1, 4
"d:\IDEWORK\lvmen\src\licensedcode\data\rules\ms-pl_9.yml", "YAML", 0, 0, 0, 4, 0, 0, 1, 5
"d:\IDEWORK\lvmen\src\licensedcode\data\rules\ms-pl_and_lgpl-2.0-plus_and_bsd-new_nuget_url_1.yml", "YAML", 0, 0, 0, 5, 0, 0, 1, 6
"d:\IDEWORK\lvmen\src\licensedcode\data\rules\ms-pl_nuget_url_1.yml", "YAML", 0, 0, 0, 5, 0, 0, 1, 6
"d:\IDEWORK\lvmen\src\licensedcode\data\rules\ms-pl_nuget_url_2.yml", "YAML", 0, 0, 0, 5, 0, 0, 1, 6
"d:\IDEWORK\lvmen\src\licensedcode\data\rules\ms-pl_nuget_url_3.yml", "YAML", 0, 0, 0, 5, 0, 0, 1, 6
"d:\IDEWORK\lvmen\src\licensedcode\data\rules\ms-pl_or_apache-2.0_1.yml", "YAML", 0, 0, 0, 3, 0, 0, 1, 4
"d:\IDEWORK\lvmen\src\licensedcode\data\rules\ms-pl_or_apache-2.0_2.yml", "YAML", 0, 0, 0, 4, 0, 0, 1, 5
"d:\IDEWORK\lvmen\src\licensedcode\data\rules\ms-pl_or_apache-2.0_3.yml", "YAML", 0, 0, 0, 3, 0, 0, 1, 4
"d:\IDEWORK\lvmen\src\licensedcode\data\rules\ms-pl_or_apache-2.0_4.yml", "YAML", 0, 0, 0, 3, 0, 0, 1, 4
"d:\IDEWORK\lvmen\src\licensedcode\data\rules\ms-pl_url_1.yml", "YAML", 0, 0, 0, 5, 0, 0, 1, 6
"d:\IDEWORK\lvmen\src\licensedcode\data\rules\ms-pl_url_2.yml", "YAML", 0, 0, 0, 5, 0, 0, 1, 6
"d:\IDEWORK\lvmen\src\licensedcode\data\rules\ms-research-shared-source.yml", "YAML", 0, 0, 0, 5, 0, 0, 1, 6
"d:\IDEWORK\lvmen\src\licensedcode\data\rules\ms-rl.SPDX.yml", "YAML", 0, 0, 0, 4, 0, 0, 1, 5
"d:\IDEWORK\lvmen\src\licensedcode\data\rules\ms-rl.yml", "YAML", 0, 0, 0, 5, 0, 0, 1, 6
"d:\IDEWORK\lvmen\src\licensedcode\data\rules\ms-rl_1.yml", "YAML", 0, 0, 0, 3, 0, 0, 1, 4
"d:\IDEWORK\lvmen\src\licensedcode\data\rules\ms-rl_10.yml", "YAML", 0, 0, 0, 3, 0, 0, 1, 4
"d:\IDEWORK\lvmen\src\licensedcode\data\rules\ms-rl_11.yml", "YAML", 0, 0, 0, 5, 0, 0, 1, 6
"d:\IDEWORK\lvmen\src\licensedcode\data\rules\ms-rl_12.yml", "YAML", 0, 0, 0, 5, 0, 0, 1, 6
"d:\IDEWORK\lvmen\src\licensedcode\data\rules\ms-rl_13.yml", "YAML", 0, 0, 0, 5, 0, 0, 1, 6
"d:\IDEWORK\lvmen\src\licensedcode\data\rules\ms-rl_14.yml", "YAML", 0, 0, 0, 5, 0, 0, 1, 6
"d:\IDEWORK\lvmen\src\licensedcode\data\rules\ms-rl_15.yml", "YAML", 0, 0, 0, 4, 0, 0, 1, 5
"d:\IDEWORK\lvmen\src\licensedcode\data\rules\ms-rl_16.yml", "YAML", 0, 0, 0, 6, 0, 0, 1, 7
"d:\IDEWORK\lvmen\src\licensedcode\data\rules\ms-rl_17.yml", "YAML", 0, 0, 0, 3, 0, 0, 1, 4
"d:\IDEWORK\lvmen\src\licensedcode\data\rules\ms-rl_2.yml", "YAML", 0, 0, 0, 5, 0, 0, 1, 6
"d:\IDEWORK\lvmen\src\licensedcode\data\rules\ms-rl_3.yml", "YAML", 0, 0, 0, 5, 0, 0, 1, 6
"d:\IDEWORK\lvmen\src\licensedcode\data\rules\ms-rl_4.yml", "YAML", 0, 0, 0, 5, 0, 0, 1, 6
"d:\IDEWORK\lvmen\src\licensedcode\data\rules\ms-rl_5.yml", "YAML", 0, 0, 0, 2, 0, 0, 1, 3
"d:\IDEWORK\lvmen\src\licensedcode\data\rules\ms-rl_6.yml", "YAML", 0, 0, 0, 5, 0, 0, 1, 6
"d:\IDEWORK\lvmen\src\licensedcode\data\rules\ms-rl_7.yml", "YAML", 0, 0, 0, 5, 0, 0, 1, 6
"d:\IDEWORK\lvmen\src\licensedcode\data\rules\ms-rl_8.yml", "YAML", 0, 0, 0, 3, 0, 0, 1, 4
"d:\IDEWORK\lvmen\src\licensedcode\data\rules\ms-rl_9.yml", "YAML", 0, 0, 0, 4, 0, 0, 1, 5
"d:\IDEWORK\lvmen\src\licensedcode\data\rules\ms-rl_url_1.yml", "YAML", 0, 0, 0, 5, 0, 0, 1, 6
"d:\IDEWORK\lvmen\src\licensedcode\data\rules\ms-rl_url_2.yml", "YAML", 0, 0, 0, 5, 0, 0, 1, 6
"d:\IDEWORK\lvmen\src\licensedcode\data\rules\ms-rl_url_glc_192.yml", "YAML", 0, 0, 0, 5, 0, 0, 1, 6
"d:\IDEWORK\lvmen\src\licensedcode\data\rules\ms-rl_url_glc_193.yml", "YAML", 0, 0, 0, 5, 0, 0, 1, 6
"d:\IDEWORK\lvmen\src\licensedcode\data\rules\ms-rsl_1.yml", "YAML", 0, 0, 0, 5, 0, 0, 1, 6
"d:\IDEWORK\lvmen\src\licensedcode\data\rules\ms-rsl_2.yml", "YAML", 0, 0, 0, 2, 0, 0, 1, 3
"d:\IDEWORK\lvmen\src\licensedcode\data\rules\ms-rsl_3.yml", "YAML", 0, 0, 0, 3, 0, 0, 1, 4
"d:\IDEWORK\lvmen\src\licensedcode\data\rules\ms-rsl_4.yml", "YAML", 0, 0, 0, 2, 0, 0, 1, 3
"d:\IDEWORK\lvmen\src\licensedcode\data\rules\ms-rsl_5.yml", "YAML", 0, 0, 0, 2, 0, 0, 1, 3
"d:\IDEWORK\lvmen\src\licensedcode\data\rules\ms-ttf-eula.yml", "YAML", 0, 0, 0, 2, 0, 0, 1, 3
"d:\IDEWORK\lvmen\src\licensedcode\data\rules\ms-visual-2010-runtime.yml", "YAML", 0, 0, 0, 4, 0, 0, 1, 5
"d:\IDEWORK\lvmen\src\licensedcode\data\rules\ms-visual-2015-sdk_1.yml", "YAML", 0, 0, 0, 5, 0, 0, 1, 6
"d:\IDEWORK\lvmen\src\licensedcode\data\rules\ms-visual-studio-2017-tools_1.yml", "YAML", 0, 0, 0, 5, 0, 0, 1, 6
"d:\IDEWORK\lvmen\src\licensedcode\data\rules\msntp_1.yml", "YAML", 0, 0, 0, 5, 0, 0, 1, 6
"d:\IDEWORK\lvmen\src\licensedcode\data\rules\msntp_2.yml", "YAML", 0, 0, 0, 4, 0, 0, 1, 5
"d:\IDEWORK\lvmen\src\licensedcode\data\rules\msntp_3.yml", "YAML", 0, 0, 0, 8, 0, 0, 1, 9
"d:\IDEWORK\lvmen\src\licensedcode\data\rules\mtll2.yml", "YAML", 0, 0, 0, 3, 0, 0, 1, 4
"d:\IDEWORK\lvmen\src\licensedcode\data\rules\mtll_url_1.yml", "YAML", 0, 0, 0, 5, 0, 0, 1, 6
"d:\IDEWORK\lvmen\src\licensedcode\data\rules\mtll_url_2.yml", "YAML", 0, 0, 0, 5, 0, 0, 1, 6
"d:\IDEWORK\lvmen\src\licensedcode\data\rules\mulanpsl-1.0-en_1.yml", "YAML", 0, 0, 0, 5, 0, 0, 1, 6
"d:\IDEWORK\lvmen\src\licensedcode\data\rules\mulanpsl-1.0-en_2.yml", "YAML", 0, 0, 0, 5, 0, 0, 1, 6
"d:\IDEWORK\lvmen\src\licensedcode\data\rules\mulanpsl-1.0-en_3.yml", "YAML", 0, 0, 0, 3, 0, 0, 1, 4
"d:\IDEWORK\lvmen\src\licensedcode\data\rules\mulanpsl-1.0-en_4.yml", "YAML", 0, 0, 0, 5, 0, 0, 1, 6
"d:\IDEWORK\lvmen\src\licensedcode\data\rules\mulanpsl-1.0-en_5.yml", "YAML", 0, 0, 0, 5, 0, 0, 1, 6
"d:\IDEWORK\lvmen\src\licensedcode\data\rules\mulanpsl-2.0-en_1.yml", "YAML", 0, 0, 0, 3, 0, 0, 1, 4
"d:\IDEWORK\lvmen\src\licensedcode\data\rules\mulanpsl-2.0-en_10.yml", "YAML", 0, 0, 0, 3, 0, 0, 1, 4
"d:\IDEWORK\lvmen\src\licensedcode\data\rules\mulanpsl-2.0-en_11.yml", "YAML", 0, 0, 0, 3, 0, 0, 1, 4
"d:\IDEWORK\lvmen\src\licensedcode\data\rules\mulanpsl-2.0-en_12.yml", "YAML", 0, 0, 0, 3, 0, 0, 1, 4
"d:\IDEWORK\lvmen\src\licensedcode\data\rules\mulanpsl-2.0-en_2.yml", "YAML", 0, 0, 0, 3, 0, 0, 1, 4
"d:\IDEWORK\lvmen\src\licensedcode\data\rules\mulanpsl-2.0-en_3.yml", "YAML", 0, 0, 0, 3, 0, 0, 1, 4
"d:\IDEWORK\lvmen\src\licensedcode\data\rules\mulanpsl-2.0-en_4.yml", "YAML", 0, 0, 0, 5, 0, 0, 1, 6
"d:\IDEWORK\lvmen\src\licensedcode\data\rules\mulanpsl-2.0-en_5.yml", "YAML", 0, 0, 0, 5, 0, 0, 1, 6
"d:\IDEWORK\lvmen\src\licensedcode\data\rules\mulanpsl-2.0-en_6.yml", "YAML", 0, 0, 0, 5, 0, 0, 1, 6
"d:\IDEWORK\lvmen\src\licensedcode\data\rules\mulanpsl-2.0-en_7.yml", "YAML", 0, 0, 0, 5, 0, 0, 1, 6
"d:\IDEWORK\lvmen\src\licensedcode\data\rules\mulanpsl-2.0-en_8.yml", "YAML", 0, 0, 0, 4, 0, 0, 1, 5
"d:\IDEWORK\lvmen\src\licensedcode\data\rules\mulanpsl-2.0-en_9.yml", "YAML", 0, 0, 0, 4, 0, 0, 1, 5
"d:\IDEWORK\lvmen\src\licensedcode\data\rules\mule-source-1.1.4_1.yml", "YAML", 0, 0, 0, 5, 0, 0, 1, 6
"d:\IDEWORK\lvmen\src\licensedcode\data\rules\mulle-kybernetik.yml", "YAML", 0, 0, 0, 5, 0, 0, 1, 6
"d:\IDEWORK\lvmen\src\licensedcode\data\rules\mulle-kybernetik2.yml", "YAML", 0, 0, 0, 3, 0, 0, 1, 4
"d:\IDEWORK\lvmen\src\licensedcode\data\rules\mulle-kybernetik3.yml", "YAML", 0, 0, 0, 2, 0, 0, 1, 3
"d:\IDEWORK\lvmen\src\licensedcode\data\rules\mulle-kybernetik_1.yml", "YAML", 0, 0, 0, 2, 0, 0, 1, 3
"d:\IDEWORK\lvmen\src\licensedcode\data\rules\multics.SPDX.yml", "YAML", 0, 0, 0, 13, 0, 0, 1, 14
"d:\IDEWORK\lvmen\src\licensedcode\data\rules\multics.yml", "YAML", 0, 0, 0, 5, 0, 0, 1, 6
"d:\IDEWORK\lvmen\src\licensedcode\data\rules\multics_1.yml", "YAML", 0, 0, 0, 5, 0, 0, 1, 6
"d:\IDEWORK\lvmen\src\licensedcode\data\rules\multics_2.yml", "YAML", 0, 0, 0, 5, 0, 0, 1, 6
"d:\IDEWORK\lvmen\src\licensedcode\data\rules\multics_url_1.yml", "YAML", 0, 0, 0, 5, 0, 0, 1, 6
"d:\IDEWORK\lvmen\src\licensedcode\data\rules\multics_url_2.yml", "YAML", 0, 0, 0, 5, 0, 0, 1, 6
"d:\IDEWORK\lvmen\src\licensedcode\data\rules\multics_url_glc_198.yml", "YAML", 0, 0, 0, 5, 0, 0, 1, 6
"d:\IDEWORK\lvmen\src\licensedcode\data\rules\multics_url_glc_199.yml", "YAML", 0, 0, 0, 5, 0, 0, 1, 6
"d:\IDEWORK\lvmen\src\licensedcode\data\rules\mup_url_1.yml", "YAML", 0, 0, 0, 5, 0, 0, 1, 6
"d:\IDEWORK\lvmen\src\licensedcode\data\rules\mup_url_2.yml", "YAML", 0, 0, 0, 5, 0, 0, 1, 6
"d:\IDEWORK\lvmen\src\licensedcode\data\rules\mx4j_1.yml", "YAML", 0, 0, 0, 13, 0, 0, 1, 14
"d:\IDEWORK\lvmen\src\licensedcode\data\rules\mx4j_2.yml", "YAML", 0, 0, 0, 3, 0, 0, 1, 4
"d:\IDEWORK\lvmen\src\licensedcode\data\rules\mx4j_3.yml", "YAML", 0, 0, 0, 12, 0, 0, 1, 13
"d:\IDEWORK\lvmen\src\licensedcode\data\rules\mx4j_4.yml", "YAML", 0, 0, 0, 10, 0, 0, 1, 11
"d:\IDEWORK\lvmen\src\licensedcode\data\rules\mx4j_5.yml", "YAML", 0, 0, 0, 2, 0, 0, 1, 3
"d:\IDEWORK\lvmen\src\licensedcode\data\rules\mx4j_6.yml", "YAML", 0, 0, 0, 3, 0, 0, 1, 4
"d:\IDEWORK\lvmen\src\licensedcode\data\rules\mx4j_7.yml", "YAML", 0, 0, 0, 3, 0, 0, 1, 4
"d:\IDEWORK\lvmen\src\licensedcode\data\rules\naist-2003_1.yml", "YAML", 0, 0, 0, 6, 0, 0, 1, 7
"d:\IDEWORK\lvmen\src\licensedcode\data\rules\naist-mecab.yml", "YAML", 0, 0, 0, 2, 0, 0, 1, 3
"d:\IDEWORK\lvmen\src\licensedcode\data\rules\nasa-1.3.SPDX.yml", "YAML", 0, 0, 0, 4, 0, 0, 1, 5
"d:\IDEWORK\lvmen\src\licensedcode\data\rules\nasa-1.3.yml", "YAML", 0, 0, 0, 5, 0, 0, 1, 6
"d:\IDEWORK\lvmen\src\licensedcode\data\rules\nasa-1.3_1.yml", "YAML", 0, 0, 0, 5, 0, 0, 1, 6
"d:\IDEWORK\lvmen\src\licensedcode\data\rules\nasa-1.3_2.yml", "YAML", 0, 0, 0, 3, 0, 0, 1, 4
"d:\IDEWORK\lvmen\src\licensedcode\data\rules\nasa-1.3_url_1.yml", "YAML", 0, 0, 0, 5, 0, 0, 1, 6
"d:\IDEWORK\lvmen\src\licensedcode\data\rules\nasa-1.3_url_2.yml", "YAML", 0, 0, 0, 5, 0, 0, 1, 6
"d:\IDEWORK\lvmen\src\licensedcode\data\rules\nasa-1.3_url_glc_200.yml", "YAML", 0, 0, 0, 5, 0, 0, 1, 6
"d:\IDEWORK\lvmen\src\licensedcode\data\rules\nasa-1.3_url_glc_201.yml", "YAML", 0, 0, 0, 5, 0, 0, 1, 6
"d:\IDEWORK\lvmen\src\licensedcode\data\rules\naughter2.yml", "YAML", 0, 0, 0, 3, 0, 0, 1, 4
"d:\IDEWORK\lvmen\src\licensedcode\data\rules\naumen.yml", "YAML", 0, 0, 0, 3, 0, 0, 1, 4
"d:\IDEWORK\lvmen\src\licensedcode\data\rules\naumen_1.yml", "YAML", 0, 0, 0, 5, 0, 0, 1, 6
"d:\IDEWORK\lvmen\src\licensedcode\data\rules\naumen_url_1.yml", "YAML", 0, 0, 0, 5, 0, 0, 1, 6
"d:\IDEWORK\lvmen\src\licensedcode\data\rules\naumen_url_2.yml", "YAML", 0, 0, 0, 5, 0, 0, 1, 6
"d:\IDEWORK\lvmen\src\licensedcode\data\rules\naumen_url_glc_210.yml", "YAML", 0, 0, 0, 5, 0, 0, 1, 6
"d:\IDEWORK\lvmen\src\licensedcode\data\rules\naumen_url_glc_211.yml", "YAML", 0, 0, 0, 5, 0, 0, 1, 6
"d:\IDEWORK\lvmen\src\licensedcode\data\rules\nbpl-1.0.yml", "YAML", 0, 0, 0, 2, 0, 0, 1, 3
"d:\IDEWORK\lvmen\src\licensedcode\data\rules\nbpl-1.0_1.yml", "YAML", 0, 0, 0, 2, 0, 0, 1, 3
"d:\IDEWORK\lvmen\src\licensedcode\data\rules\nbpl-1.0_url_1.yml", "YAML", 0, 0, 0, 5, 0, 0, 1, 6
"d:\IDEWORK\lvmen\src\licensedcode\data\rules\nbpl-1.0_url_2.yml", "YAML", 0, 0, 0, 5, 0, 0, 1, 6
"d:\IDEWORK\lvmen\src\licensedcode\data\rules\ncsa_1.yml", "YAML", 0, 0, 0, 5, 0, 0, 1, 6
"d:\IDEWORK\lvmen\src\licensedcode\data\rules\ncsa_2.yml", "YAML", 0, 0, 0, 5, 0, 0, 1, 6
"d:\IDEWORK\lvmen\src\licensedcode\data\rules\net-snmp.yml", "YAML", 0, 0, 0, 5, 0, 0, 1, 6
"d:\IDEWORK\lvmen\src\licensedcode\data\rules\net-snmp_url_1.yml", "YAML", 0, 0, 0, 5, 0, 0, 1, 6
"d:\IDEWORK\lvmen\src\licensedcode\data\rules\net-snmp_url_2.yml", "YAML", 0, 0, 0, 5, 0, 0, 1, 6
"d:\IDEWORK\lvmen\src\licensedcode\data\rules\netcdf_1.yml", "YAML", 0, 0, 0, 2, 0, 0, 1, 3
"d:\IDEWORK\lvmen\src\licensedcode\data\rules\netcdf_2.yml", "YAML", 0, 0, 0, 5, 0, 0, 1, 6
"d:\IDEWORK\lvmen\src\licensedcode\data\rules\netcdf_3.yml", "YAML", 0, 0, 0, 5, 0, 0, 1, 6
"d:\IDEWORK\lvmen\src\licensedcode\data\rules\netcdf_url_1.yml", "YAML", 0, 0, 0, 5, 0, 0, 1, 6
"d:\IDEWORK\lvmen\src\licensedcode\data\rules\netcdf_url_2.yml", "YAML", 0, 0, 0, 5, 0, 0, 1, 6
"d:\IDEWORK\lvmen\src\licensedcode\data\rules\netcomponents.yml", "YAML", 0, 0, 0, 5, 0, 0, 1, 6
"d:\IDEWORK\lvmen\src\licensedcode\data\rules\network-time-protocol.yml", "YAML", 0, 0, 0, 5, 0, 0, 1, 6
"d:\IDEWORK\lvmen\src\licensedcode\data\rules\network-time-protocol2.yml", "YAML", 0, 0, 0, 3, 0, 0, 1, 4
"d:\IDEWORK\lvmen\src\licensedcode\data\rules\network-time-protocol3.yml", "YAML", 0, 0, 0, 5, 0, 0, 1, 6
"d:\IDEWORK\lvmen\src\licensedcode\data\rules\network-time-protocol5.yml", "YAML", 0, 0, 0, 2, 0, 0, 1, 3
"d:\IDEWORK\lvmen\src\licensedcode\data\rules\new-relic.yml", "YAML", 0, 0, 0, 2, 0, 0, 1, 3
"d:\IDEWORK\lvmen\src\licensedcode\data\rules\newlib-historical_and_warranty-disclaimer_1.yml", "YAML", 0, 0, 0, 4, 0, 0, 1, 5
"d:\IDEWORK\lvmen\src\licensedcode\data\rules\newsletr.SPDX.yml", "YAML", 0, 0, 0, 8, 0, 0, 1, 9
"d:\IDEWORK\lvmen\src\licensedcode\data\rules\newsletr_url_1.yml", "YAML", 0, 0, 0, 5, 0, 0, 1, 6
"d:\IDEWORK\lvmen\src\licensedcode\data\rules\newsletr_url_2.yml", "YAML", 0, 0, 0, 5, 0, 0, 1, 6
"d:\IDEWORK\lvmen\src\licensedcode\data\rules\ngpl.SPDX.yml", "YAML", 0, 0, 0, 14, 0, 0, 1, 15
"d:\IDEWORK\lvmen\src\licensedcode\data\rules\ngpl.yml", "YAML", 0, 0, 0, 5, 0, 0, 1, 6
"d:\IDEWORK\lvmen\src\licensedcode\data\rules\ngpl_1.yml", "YAML", 0, 0, 0, 9, 0, 0, 1, 10
"d:\IDEWORK\lvmen\src\licensedcode\data\rules\ngpl_2.yml", "YAML", 0, 0, 0, 3, 0, 0, 1, 4
"d:\IDEWORK\lvmen\src\licensedcode\data\rules\ngpl_url_1.yml", "YAML", 0, 0, 0, 5, 0, 0, 1, 6
"d:\IDEWORK\lvmen\src\licensedcode\data\rules\ngpl_url_2.yml", "YAML", 0, 0, 0, 5, 0, 0, 1, 6
"d:\IDEWORK\lvmen\src\licensedcode\data\rules\ngpl_url_glc_204.yml", "YAML", 0, 0, 0, 5, 0, 0, 1, 6
"d:\IDEWORK\lvmen\src\licensedcode\data\rules\ngpl_url_glc_205.yml", "YAML", 0, 0, 0, 5, 0, 0, 1, 6
"d:\IDEWORK\lvmen\src\licensedcode\data\rules\nicta-exception_1.yml", "YAML", 0, 0, 0, 3, 0, 0, 1, 4
"d:\IDEWORK\lvmen\src\licensedcode\data\rules\nicta-psl_1.yml", "YAML", 0, 0, 0, 2, 0, 0, 1, 3
"d:\IDEWORK\lvmen\src\licensedcode\data\rules\nist-pd_1.yml", "YAML", 0, 0, 0, 2, 0, 0, 1, 3
"d:\IDEWORK\lvmen\src\licensedcode\data\rules\nist-pd_10.yml", "YAML", 0, 0, 0, 7, 0, 0, 1, 8
"d:\IDEWORK\lvmen\src\licensedcode\data\rules\nist-pd_11.yml", "YAML", 0, 0, 0, 3, 0, 0, 1, 4
"d:\IDEWORK\lvmen\src\licensedcode\data\rules\nist-pd_12.yml", "YAML", 0, 0, 0, 3, 0, 0, 1, 4
"d:\IDEWORK\lvmen\src\licensedcode\data\rules\nist-pd_13.yml", "YAML", 0, 0, 0, 5, 0, 0, 1, 6
"d:\IDEWORK\lvmen\src\licensedcode\data\rules\nist-pd_2.yml", "YAML", 0, 0, 0, 2, 0, 0, 1, 3
"d:\IDEWORK\lvmen\src\licensedcode\data\rules\nist-pd_3.yml", "YAML", 0, 0, 0, 2, 0, 0, 1, 3
"d:\IDEWORK\lvmen\src\licensedcode\data\rules\nist-pd_4.yml", "YAML", 0, 0, 0, 2, 0, 0, 1, 3
"d:\IDEWORK\lvmen\src\licensedcode\data\rules\nist-pd_5.yml", "YAML", 0, 0, 0, 4, 0, 0, 1, 5
"d:\IDEWORK\lvmen\src\licensedcode\data\rules\nist-pd_6.yml", "YAML", 0, 0, 0, 3, 0, 0, 1, 4
"d:\IDEWORK\lvmen\src\licensedcode\data\rules\nist-pd_7.yml", "YAML", 0, 0, 0, 3, 0, 0, 1, 4
"d:\IDEWORK\lvmen\src\licensedcode\data\rules\nist-pd_8.yml", "YAML", 0, 0, 0, 3, 0, 0, 1, 4
"d:\IDEWORK\lvmen\src\licensedcode\data\rules\nist-pd_9.yml", "YAML", 0, 0, 0, 3, 0, 0, 1, 4
"d:\IDEWORK\lvmen\src\licensedcode\data\rules\nist-pd_or_cc0-1.0_1.yml", "YAML", 0, 0, 0, 6, 0, 0, 1, 7
"d:\IDEWORK\lvmen\src\licensedcode\data\rules\nlod-1.0_url_1.yml", "YAML", 0, 0, 0, 5, 0, 0, 1, 6
"d:\IDEWORK\lvmen\src\licensedcode\data\rules\nlod-1.0_url_2.yml", "YAML", 0, 0, 0, 5, 0, 0, 1, 6
"d:\IDEWORK\lvmen\src\licensedcode\data\rules\nlpl_1.yml", "YAML", 0, 0, 0, 2, 0, 0, 1, 3
"d:\IDEWORK\lvmen\src\licensedcode\data\rules\nlpl_url_1.yml", "YAML", 0, 0, 0, 5, 0, 0, 1, 6
"d:\IDEWORK\lvmen\src\licensedcode\data\rules\nlpl_url_2.yml", "YAML", 0, 0, 0, 5, 0, 0, 1, 6
"d:\IDEWORK\lvmen\src\licensedcode\data\rules\nokia.yml", "YAML", 0, 0, 0, 6, 0, 0, 1, 7
"d:\IDEWORK\lvmen\src\licensedcode\data\rules\nokos-1.0a_1.yml", "YAML", 0, 0, 0, 2, 0, 0, 1, 3
"d:\IDEWORK\lvmen\src\licensedcode\data\rules\nokos-1.0a_2.yml", "YAML", 0, 0, 0, 5, 0, 0, 1, 6
"d:\IDEWORK\lvmen\src\licensedcode\data\rules\nokos-1.0a_3.yml", "YAML", 0, 0, 0, 5, 0, 0, 1, 6
"d:\IDEWORK\lvmen\src\licensedcode\data\rules\nokos-1.0a_4.yml", "YAML", 0, 0, 0, 3, 0, 0, 1, 4
"d:\IDEWORK\lvmen\src\licensedcode\data\rules\nokos-1.0a_5.yml", "YAML", 0, 0, 0, 2, 0, 0, 1, 3
"d:\IDEWORK\lvmen\src\licensedcode\data\rules\nokos-1.0a_url_1.yml", "YAML", 0, 0, 0, 5, 0, 0, 1, 6
"d:\IDEWORK\lvmen\src\licensedcode\data\rules\nokos-1.0a_url_2.yml", "YAML", 0, 0, 0, 5, 0, 0, 1, 6
"d:\IDEWORK\lvmen\src\licensedcode\data\rules\nokos-1.0a_url_glc_256.yml", "YAML", 0, 0, 0, 5, 0, 0, 1, 6
"d:\IDEWORK\lvmen\src\licensedcode\data\rules\nokos-1.0a_url_glc_257.yml", "YAML", 0, 0, 0, 5, 0, 0, 1, 6
"d:\IDEWORK\lvmen\src\licensedcode\data\rules\nonexclusive_1.yml", "YAML", 0, 0, 0, 2, 0, 0, 1, 3
"d:\IDEWORK\lvmen\src\licensedcode\data\rules\nortel-dasa_1.yml", "YAML", 0, 0, 0, 5, 0, 0, 1, 6
"d:\IDEWORK\lvmen\src\licensedcode\data\rules\nosl-1.0.SPDX.yml", "YAML", 0, 0, 0, 6, 0, 0, 1, 7
"d:\IDEWORK\lvmen\src\licensedcode\data\rules\nosl-1.0.yml", "YAML", 0, 0, 0, 5, 0, 0, 1, 6
"d:\IDEWORK\lvmen\src\licensedcode\data\rules\nosl-1.0_url_1.yml", "YAML", 0, 0, 0, 5, 0, 0, 1, 6
"d:\IDEWORK\lvmen\src\licensedcode\data\rules\nosl-1.0_url_2.yml", "YAML", 0, 0, 0, 5, 0, 0, 1, 6
"d:\IDEWORK\lvmen\src\licensedcode\data\rules\nosl-3.0.SPDX.yml", "YAML", 0, 0, 0, 8, 0, 0, 1, 9
"d:\IDEWORK\lvmen\src\licensedcode\data\rules\nosl-3.0.yml", "YAML", 0, 0, 0, 5, 0, 0, 1, 6
"d:\IDEWORK\lvmen\src\licensedcode\data\rules\nosl-3.0_1.yml", "YAML", 0, 0, 0, 3, 0, 0, 1, 4
"d:\IDEWORK\lvmen\src\licensedcode\data\rules\nosl-3.0_2.yml", "YAML", 0, 0, 0, 3, 0, 0, 1, 4
"d:\IDEWORK\lvmen\src\licensedcode\data\rules\nosl-3.0_url_1.yml", "YAML", 0, 0, 0, 5, 0, 0, 1, 6
"d:\IDEWORK\lvmen\src\licensedcode\data\rules\nosl-3.0_url_2.yml", "YAML", 0, 0, 0, 5, 0, 0, 1, 6
"d:\IDEWORK\lvmen\src\licensedcode\data\rules\nosl-3.0_url_glc_206.yml", "YAML", 0, 0, 0, 5, 0, 0, 1, 6
"d:\IDEWORK\lvmen\src\licensedcode\data\rules\nosl-3.0_url_glc_207.yml", "YAML", 0, 0, 0, 5, 0, 0, 1, 6
"d:\IDEWORK\lvmen\src\licensedcode\data\rules\noweb_url_1.yml", "YAML", 0, 0, 0, 5, 0, 0, 1, 6
"d:\IDEWORK\lvmen\src\licensedcode\data\rules\noweb_url_2.yml", "YAML", 0, 0, 0, 5, 0, 0, 1, 6
"d:\IDEWORK\lvmen\src\licensedcode\data\rules\npl-1.0_1.yml", "YAML", 0, 0, 0, 2, 0, 0, 1, 3
"d:\IDEWORK\lvmen\src\licensedcode\data\rules\npl-1.0_2.yml", "YAML", 0, 0, 0, 4, 0, 0, 1, 5
"d:\IDEWORK\lvmen\src\licensedcode\data\rules\npl-1.0_3.yml", "YAML", 0, 0, 0, 5, 0, 0, 1, 6
"d:\IDEWORK\lvmen\src\licensedcode\data\rules\npl-1.0_4.yml", "YAML", 0, 0, 0, 10, 0, 0, 1, 11
"d:\IDEWORK\lvmen\src\licensedcode\data\rules\npl-1.0_url_1.yml", "YAML", 0, 0, 0, 5, 0, 0, 1, 6
"d:\IDEWORK\lvmen\src\licensedcode\data\rules\npl-1.0_url_2.yml", "YAML", 0, 0, 0, 5, 0, 0, 1, 6
"d:\IDEWORK\lvmen\src\licensedcode\data\rules\npl-1.1_1.yml", "YAML", 0, 0, 0, 4, 0, 0, 1, 5
"d:\IDEWORK\lvmen\src\licensedcode\data\rules\npl-1.1_10.yml", "YAML", 0, 0, 0, 4, 0, 0, 1, 5
"d:\IDEWORK\lvmen\src\licensedcode\data\rules\npl-1.1_2.yml", "YAML", 0, 0, 0, 5, 0, 0, 1, 6
"d:\IDEWORK\lvmen\src\licensedcode\data\rules\npl-1.1_3.yml", "YAML", 0, 0, 0, 2, 0, 0, 1, 3
"d:\IDEWORK\lvmen\src\licensedcode\data\rules\npl-1.1_4.yml", "YAML", 0, 0, 0, 5, 0, 0, 1, 6
"d:\IDEWORK\lvmen\src\licensedcode\data\rules\npl-1.1_5.yml", "YAML", 0, 0, 0, 11, 0, 0, 1, 12
"d:\IDEWORK\lvmen\src\licensedcode\data\rules\npl-1.1_6.yml", "YAML", 0, 0, 0, 5, 0, 0, 1, 6
"d:\IDEWORK\lvmen\src\licensedcode\data\rules\npl-1.1_7.yml", "YAML", 0, 0, 0, 8, 0, 0, 1, 9
"d:\IDEWORK\lvmen\src\licensedcode\data\rules\npl-1.1_8.yml", "YAML", 0, 0, 0, 6, 0, 0, 1, 7
"d:\IDEWORK\lvmen\src\licensedcode\data\rules\npl-1.1_9.yml", "YAML", 0, 0, 0, 6, 0, 0, 1, 7
"d:\IDEWORK\lvmen\src\licensedcode\data\rules\npl-1.1_or_gpl-1.0-plus_1.yml", "YAML", 0, 0, 0, 4, 0, 0, 1, 5
"d:\IDEWORK\lvmen\src\licensedcode\data\rules\npl-1.1_or_gpl-1.0-plus_2.yml", "YAML", 0, 0, 0, 4, 0, 0, 1, 5
"d:\IDEWORK\lvmen\src\licensedcode\data\rules\npl-1.1_or_gpl-1.0-plus_and_mpl-1.1_or_gpl-1.0-plus_1.yml", "YAML", 0, 0, 0, 3, 0, 0, 1, 4
"d:\IDEWORK\lvmen\src\licensedcode\data\rules\npl-1.1_or_gpl-1.0-plus_and_mpl-1.1_or_gpl-1.0-plus_2.yml", "YAML", 0, 0, 0, 3, 0, 0, 1, 4
"d:\IDEWORK\lvmen\src\licensedcode\data\rules\npl-1.1_or_gpl-2.0-plus_or_lgpl-2.1-plus.yml", "YAML", 0, 0, 0, 4, 0, 0, 1, 5
"d:\IDEWORK\lvmen\src\licensedcode\data\rules\npl-1.1_or_gpl-2.0_1.yml", "YAML", 0, 0, 0, 5, 0, 0, 1, 6
"d:\IDEWORK\lvmen\src\licensedcode\data\rules\npl-1.1_or_gpl-2.0_2.yml", "YAML", 0, 0, 0, 5, 0, 0, 1, 6
"d:\IDEWORK\lvmen\src\licensedcode\data\rules\npl-1.1_or_gpl-2.0_3.yml", "YAML", 0, 0, 0, 5, 0, 0, 1, 6
"d:\IDEWORK\lvmen\src\licensedcode\data\rules\npl-1.1_or_gpl-2.0_4.yml", "YAML", 0, 0, 0, 5, 0, 0, 1, 6
"d:\IDEWORK\lvmen\src\licensedcode\data\rules\npl-1.1_or_gpl-2.0_5.yml", "YAML", 0, 0, 0, 3, 0, 0, 1, 4
"d:\IDEWORK\lvmen\src\licensedcode\data\rules\npl-1.1_url_1.yml", "YAML", 0, 0, 0, 5, 0, 0, 1, 6
"d:\IDEWORK\lvmen\src\licensedcode\data\rules\npl-1.1_url_2.yml", "YAML", 0, 0, 0, 5, 0, 0, 1, 6
"d:\IDEWORK\lvmen\src\licensedcode\data\rules\nrl-permission_1.yml", "YAML", 0, 0, 0, 5, 0, 0, 1, 6
"d:\IDEWORK\lvmen\src\licensedcode\data\rules\nrl_1.yml", "YAML", 0, 0, 0, 9, 0, 0, 1, 10
"d:\IDEWORK\lvmen\src\licensedcode\data\rules\nrl_url_1.yml", "YAML", 0, 0, 0, 5, 0, 0, 1, 6
"d:\IDEWORK\lvmen\src\licensedcode\data\rules\nrl_url_2.yml", "YAML", 0, 0, 0, 5, 0, 0, 1, 6
"d:\IDEWORK\lvmen\src\licensedcode\data\rules\nsis_1.yml", "YAML", 0, 0, 0, 3, 0, 0, 1, 4
"d:\IDEWORK\lvmen\src\licensedcode\data\rules\nsis_2.yml", "YAML", 0, 0, 0, 5, 0, 0, 1, 6
"d:\IDEWORK\lvmen\src\licensedcode\data\rules\nsis_3.yml", "YAML", 0, 0, 0, 3, 0, 0, 1, 4
"d:\IDEWORK\lvmen\src\licensedcode\data\rules\nsis_4.yml", "YAML", 0, 0, 0, 3, 0, 0, 1, 4
"d:\IDEWORK\lvmen\src\licensedcode\data\rules\nsis_5.yml", "YAML", 0, 0, 0, 3, 0, 0, 1, 4
"d:\IDEWORK\lvmen\src\licensedcode\data\rules\ntp-0_1.yml", "YAML", 0, 0, 0, 3, 0, 0, 1, 4
"d:\IDEWORK\lvmen\src\licensedcode\data\rules\nuget_ms-pl_9.yml", "YAML", 0, 0, 0, 5, 0, 0, 1, 6
"d:\IDEWORK\lvmen\src\licensedcode\data\rules\nunit-v2.SPDX.yml", "YAML", 0, 0, 0, 11, 0, 0, 1, 12
"d:\IDEWORK\lvmen\src\licensedcode\data\rules\nvidia-gov.yml", "YAML", 0, 0, 0, 7, 0, 0, 1, 8
"d:\IDEWORK\lvmen\src\licensedcode\data\rules\nvidia-gov2.yml", "YAML", 0, 0, 0, 7, 0, 0, 1, 8
"d:\IDEWORK\lvmen\src\licensedcode\data\rules\nvidia-gov3.yml", "YAML", 0, 0, 0, 7, 0, 0, 1, 8
"d:\IDEWORK\lvmen\src\licensedcode\data\rules\nvidia-gov4.yml", "YAML", 0, 0, 0, 7, 0, 0, 1, 8
"d:\IDEWORK\lvmen\src\licensedcode\data\rules\nvidia-gov5.yml", "YAML", 0, 0, 0, 9, 0, 0, 1, 10
"d:\IDEWORK\lvmen\src\licensedcode\data\rules\nvidia.yml", "YAML", 0, 0, 0, 5, 0, 0, 1, 6
"d:\IDEWORK\lvmen\src\licensedcode\data\rules\nvidia_not_not-a-license_gpl_linux.yml", "YAML", 0, 0, 0, 4, 0, 0, 1, 5
"d:\IDEWORK\lvmen\src\licensedcode\data\rules\nysl-0.9982.yml", "YAML", 0, 0, 0, 5, 0, 0, 1, 6
"d:\IDEWORK\lvmen\src\licensedcode\data\rules\nysl-0.9982_2.yml", "YAML", 0, 0, 0, 3, 0, 0, 1, 4
"d:\IDEWORK\lvmen\src\licensedcode\data\rules\oasis-ipr-policy-2014_1.yml", "YAML", 0, 0, 0, 4, 0, 0, 1, 5
"d:\IDEWORK\lvmen\src\licensedcode\data\rules\oasis-ws-security-spec.yml", "YAML", 0, 0, 0, 5, 0, 0, 1, 6
"d:\IDEWORK\lvmen\src\licensedcode\data\rules\ocaml-lgpl-linking-exception_1.yml", "YAML", 0, 0, 0, 2, 0, 0, 1, 3
"d:\IDEWORK\lvmen\src\licensedcode\data\rules\ocaml-lgpl-linking-exception_url_1.yml", "YAML", 0, 0, 0, 5, 0, 0, 1, 6
"d:\IDEWORK\lvmen\src\licensedcode\data\rules\ocaml-lgpl-linking-exception_url_2.yml", "YAML", 0, 0, 0, 5, 0, 0, 1, 6
"d:\IDEWORK\lvmen\src\licensedcode\data\rules\ocb-open-source-2013_1.yml", "YAML", 0, 0, 0, 5, 0, 0, 1, 6
"d:\IDEWORK\lvmen\src\licensedcode\data\rules\ocb-open-source-2013_10.yml", "YAML", 0, 0, 0, 2, 0, 0, 1, 3
"d:\IDEWORK\lvmen\src\licensedcode\data\rules\ocb-open-source-2013_11.yml", "YAML", 0, 0, 0, 5, 0, 0, 1, 6
"d:\IDEWORK\lvmen\src\licensedcode\data\rules\ocb-open-source-2013_12.yml", "YAML", 0, 0, 0, 3, 0, 0, 1, 4
"d:\IDEWORK\lvmen\src\licensedcode\data\rules\ocb-open-source-2013_2.yml", "YAML", 0, 0, 0, 4, 0, 0, 1, 5
"d:\IDEWORK\lvmen\src\licensedcode\data\rules\ocb-open-source-2013_3.yml", "YAML", 0, 0, 0, 5, 0, 0, 2, 7
"d:\IDEWORK\lvmen\src\licensedcode\data\rules\ocb-open-source-2013_4.yml", "YAML", 0, 0, 0, 3, 0, 0, 1, 4
"d:\IDEWORK\lvmen\src\licensedcode\data\rules\ocb-open-source-2013_5.yml", "YAML", 0, 0, 0, 3, 0, 0, 1, 4
"d:\IDEWORK\lvmen\src\licensedcode\data\rules\ocb-open-source-2013_6.yml", "YAML", 0, 0, 0, 3, 0, 0, 1, 4
"d:\IDEWORK\lvmen\src\licensedcode\data\rules\ocb-open-source-2013_7.yml", "YAML", 0, 0, 0, 3, 0, 0, 1, 4
"d:\IDEWORK\lvmen\src\licensedcode\data\rules\ocb-open-source-2013_8.yml", "YAML", 0, 0, 0, 3, 0, 0, 1, 4
"d:\IDEWORK\lvmen\src\licensedcode\data\rules\ocb-open-source-2013_9.yml", "YAML", 0, 0, 0, 5, 0, 0, 2, 7
"d:\IDEWORK\lvmen\src\licensedcode\data\rules\occt-exception-1.0_url_1.yml", "YAML", 0, 0, 0, 5, 0, 0, 1, 6
"d:\IDEWORK\lvmen\src\licensedcode\data\rules\occt-exception-1.0_url_2.yml", "YAML", 0, 0, 0, 5, 0, 0, 1, 6
"d:\IDEWORK\lvmen\src\licensedcode\data\rules\occt-pl_1.yml", "YAML", 0, 0, 0, 2, 0, 0, 1, 3
"d:\IDEWORK\lvmen\src\licensedcode\data\rules\occt-pl_url_1.yml", "YAML", 0, 0, 0, 5, 0, 0, 1, 6
"d:\IDEWORK\lvmen\src\licensedcode\data\rules\occt-pl_url_2.yml", "YAML", 0, 0, 0, 5, 0, 0, 1, 6
"d:\IDEWORK\lvmen\src\licensedcode\data\rules\oclc-1.0.yml", "YAML", 0, 0, 0, 5, 0, 0, 1, 6
"d:\IDEWORK\lvmen\src\licensedcode\data\rules\oclc-2.0.SPDX.yml", "YAML", 0, 0, 0, 14, 0, 0, 1, 15
"d:\IDEWORK\lvmen\src\licensedcode\data\rules\oclc-2.0.yml", "YAML", 0, 0, 0, 5, 0, 0, 1, 6
"d:\IDEWORK\lvmen\src\licensedcode\data\rules\oclc-2.0_1.yml", "YAML", 0, 0, 0, 5, 0, 0, 1, 6
"d:\IDEWORK\lvmen\src\licensedcode\data\rules\oclc-2.0_2.yml", "YAML", 0, 0, 0, 6, 0, 0, 1, 7
"d:\IDEWORK\lvmen\src\licensedcode\data\rules\oclc-2.0_3.yml", "YAML", 0, 0, 0, 3, 0, 0, 1, 4
"d:\IDEWORK\lvmen\src\licensedcode\data\rules\oclc-2.0_url_1.yml", "YAML", 0, 0, 0, 5, 0, 0, 1, 6
"d:\IDEWORK\lvmen\src\licensedcode\data\rules\oclc-2.0_url_2.yml", "YAML", 0, 0, 0, 5, 0, 0, 1, 6
"d:\IDEWORK\lvmen\src\licensedcode\data\rules\oclc-2.0_url_glc_212.yml", "YAML", 0, 0, 0, 5, 0, 0, 1, 6
"d:\IDEWORK\lvmen\src\licensedcode\data\rules\oclc-2.0_url_glc_213.yml", "YAML", 0, 0, 0, 5, 0, 0, 1, 6
"d:\IDEWORK\lvmen\src\licensedcode\data\rules\odbl-1.0.yml", "YAML", 0, 0, 0, 5, 0, 0, 1, 6
"d:\IDEWORK\lvmen\src\licensedcode\data\rules\odbl-1.0_1.yml", "YAML", 0, 0, 0, 5, 0, 0, 1, 6
"d:\IDEWORK\lvmen\src\licensedcode\data\rules\odbl-1.0_10.yml", "YAML", 0, 0, 0, 3, 0, 0, 1, 4
"d:\IDEWORK\lvmen\src\licensedcode\data\rules\odbl-1.0_11.yml", "YAML", 0, 0, 0, 3, 0, 0, 1, 4
"d:\IDEWORK\lvmen\src\licensedcode\data\rules\odbl-1.0_12.yml", "YAML", 0, 0, 0, 3, 0, 0, 1, 4
"d:\IDEWORK\lvmen\src\licensedcode\data\rules\odbl-1.0_13.yml", "YAML", 0, 0, 0, 3, 0, 0, 1, 4
"d:\IDEWORK\lvmen\src\licensedcode\data\rules\odbl-1.0_14.yml", "YAML", 0, 0, 0, 3, 0, 0, 1, 4
"d:\IDEWORK\lvmen\src\licensedcode\data\rules\odbl-1.0_15.yml", "YAML", 0, 0, 0, 3, 0, 0, 1, 4
"d:\IDEWORK\lvmen\src\licensedcode\data\rules\odbl-1.0_16.yml", "YAML", 0, 0, 0, 3, 0, 0, 1, 4
"d:\IDEWORK\lvmen\src\licensedcode\data\rules\odbl-1.0_17.yml", "YAML", 0, 0, 0, 5, 0, 0, 1, 6
"d:\IDEWORK\lvmen\src\licensedcode\data\rules\odbl-1.0_18.yml", "YAML", 0, 0, 0, 3, 0, 0, 1, 4
"d:\IDEWORK\lvmen\src\licensedcode\data\rules\odbl-1.0_19.yml", "YAML", 0, 0, 0, 5, 0, 0, 1, 6
"d:\IDEWORK\lvmen\src\licensedcode\data\rules\odbl-1.0_2.yml", "YAML", 0, 0, 0, 3, 0, 0, 1, 4
"d:\IDEWORK\lvmen\src\licensedcode\data\rules\odbl-1.0_20.yml", "YAML", 0, 0, 0, 5, 0, 0, 1, 6
"d:\IDEWORK\lvmen\src\licensedcode\data\rules\odbl-1.0_21.yml", "YAML", 0, 0, 0, 5, 0, 0, 1, 6
"d:\IDEWORK\lvmen\src\licensedcode\data\rules\odbl-1.0_22.yml", "YAML", 0, 0, 0, 5, 0, 0, 1, 6
"d:\IDEWORK\lvmen\src\licensedcode\data\rules\odbl-1.0_23.yml", "YAML", 0, 0, 0, 5, 0, 0, 1, 6
"d:\IDEWORK\lvmen\src\licensedcode\data\rules\odbl-1.0_24.yml", "YAML", 0, 0, 0, 5, 0, 0, 1, 6
"d:\IDEWORK\lvmen\src\licensedcode\data\rules\odbl-1.0_25.yml", "YAML", 0, 0, 0, 5, 0, 0, 1, 6
"d:\IDEWORK\lvmen\src\licensedcode\data\rules\odbl-1.0_26.yml", "YAML", 0, 0, 0, 9, 0, 0, 1, 10
"d:\IDEWORK\lvmen\src\licensedcode\data\rules\odbl-1.0_27.yml", "YAML", 0, 0, 0, 3, 0, 0, 1, 4
"d:\IDEWORK\lvmen\src\licensedcode\data\rules\odbl-1.0_28.yml", "YAML", 0, 0, 0, 5, 0, 0, 1, 6
"d:\IDEWORK\lvmen\src\licensedcode\data\rules\odbl-1.0_29.yml", "YAML", 0, 0, 0, 5, 0, 0, 1, 6
"d:\IDEWORK\lvmen\src\licensedcode\data\rules\odbl-1.0_3.yml", "YAML", 0, 0, 0, 5, 0, 0, 1, 6
"d:\IDEWORK\lvmen\src\licensedcode\data\rules\odbl-1.0_30.yml", "YAML", 0, 0, 0, 3, 0, 0, 1, 4
"d:\IDEWORK\lvmen\src\licensedcode\data\rules\odbl-1.0_31.yml", "YAML", 0, 0, 0, 3, 0, 0, 1, 4
"d:\IDEWORK\lvmen\src\licensedcode\data\rules\odbl-1.0_32.yml", "YAML", 0, 0, 0, 3, 0, 0, 1, 4
"d:\IDEWORK\lvmen\src\licensedcode\data\rules\odbl-1.0_33.yml", "YAML", 0, 0, 0, 3, 0, 0, 1, 4
"d:\IDEWORK\lvmen\src\licensedcode\data\rules\odbl-1.0_34.yml", "YAML", 0, 0, 0, 5, 0, 0, 1, 6
"d:\IDEWORK\lvmen\src\licensedcode\data\rules\odbl-1.0_35.yml", "YAML", 0, 0, 0, 5, 0, 0, 1, 6
"d:\IDEWORK\lvmen\src\licensedcode\data\rules\odbl-1.0_36.yml", "YAML", 0, 0, 0, 5, 0, 0, 1, 6
"d:\IDEWORK\lvmen\src\licensedcode\data\rules\odbl-1.0_37.yml", "YAML", 0, 0, 0, 5, 0, 0, 1, 6
"d:\IDEWORK\lvmen\src\licensedcode\data\rules\odbl-1.0_38.yml", "YAML", 0, 0, 0, 5, 0, 0, 1, 6
"d:\IDEWORK\lvmen\src\licensedcode\data\rules\odbl-1.0_39.yml", "YAML", 0, 0, 0, 5, 0, 0, 1, 6
"d:\IDEWORK\lvmen\src\licensedcode\data\rules\odbl-1.0_4.yml", "YAML", 0, 0, 0, 5, 0, 0, 1, 6
"d:\IDEWORK\lvmen\src\licensedcode\data\rules\odbl-1.0_40.yml", "YAML", 0, 0, 0, 5, 0, 0, 1, 6
"d:\IDEWORK\lvmen\src\licensedcode\data\rules\odbl-1.0_41.yml", "YAML", 0, 0, 0, 5, 0, 0, 1, 6
"d:\IDEWORK\lvmen\src\licensedcode\data\rules\odbl-1.0_42.yml", "YAML", 0, 0, 0, 3, 0, 0, 1, 4
"d:\IDEWORK\lvmen\src\licensedcode\data\rules\odbl-1.0_43.yml", "YAML", 0, 0, 0, 3, 0, 0, 1, 4
"d:\IDEWORK\lvmen\src\licensedcode\data\rules\odbl-1.0_44.yml", "YAML", 0, 0, 0, 5, 0, 0, 1, 6
"d:\IDEWORK\lvmen\src\licensedcode\data\rules\odbl-1.0_45.yml", "YAML", 0, 0, 0, 5, 0, 0, 1, 6
"d:\IDEWORK\lvmen\src\licensedcode\data\rules\odbl-1.0_46.yml", "YAML", 0, 0, 0, 7, 0, 0, 1, 8
"d:\IDEWORK\lvmen\src\licensedcode\data\rules\odbl-1.0_47.yml", "YAML", 0, 0, 0, 5, 0, 0, 1, 6
"d:\IDEWORK\lvmen\src\licensedcode\data\rules\odbl-1.0_48.yml", "YAML", 0, 0, 0, 3, 0, 0, 1, 4
"d:\IDEWORK\lvmen\src\licensedcode\data\rules\odbl-1.0_49.yml", "YAML", 0, 0, 0, 5, 0, 0, 1, 6
"d:\IDEWORK\lvmen\src\licensedcode\data\rules\odbl-1.0_5.yml", "YAML", 0, 0, 0, 5, 0, 0, 1, 6
"d:\IDEWORK\lvmen\src\licensedcode\data\rules\odbl-1.0_50.yml", "YAML", 0, 0, 0, 5, 0, 0, 1, 6
"d:\IDEWORK\lvmen\src\licensedcode\data\rules\odbl-1.0_6.yml", "YAML", 0, 0, 0, 5, 0, 0, 1, 6
"d:\IDEWORK\lvmen\src\licensedcode\data\rules\odbl-1.0_7.yml", "YAML", 0, 0, 0, 3, 0, 0, 1, 4
"d:\IDEWORK\lvmen\src\licensedcode\data\rules\odbl-1.0_8.yml", "YAML", 0, 0, 0, 3, 0, 0, 1, 4
"d:\IDEWORK\lvmen\src\licensedcode\data\rules\odbl-1.0_9.yml", "YAML", 0, 0, 0, 3, 0, 0, 1, 4
"d:\IDEWORK\lvmen\src\licensedcode\data\rules\odbl-1.0_and_dbcl-1.0_1.yml", "YAML", 0, 0, 0, 6, 0, 0, 1, 7
"d:\IDEWORK\lvmen\src\licensedcode\data\rules\odbl-1.0_and_dbcl-1.0_2.yml", "YAML", 0, 0, 0, 6, 0, 0, 1, 7
"d:\IDEWORK\lvmen\src\licensedcode\data\rules\odbl-1.0_and_dbcl-1.0_3.yml", "YAML", 0, 0, 0, 6, 0, 0, 1, 7
"d:\IDEWORK\lvmen\src\licensedcode\data\rules\odbl-1.0_url_1.yml", "YAML", 0, 0, 0, 5, 0, 0, 1, 6
"d:\IDEWORK\lvmen\src\licensedcode\data\rules\odbl-1.0_url_2.yml", "YAML", 0, 0, 0, 5, 0, 0, 1, 6
"d:\IDEWORK\lvmen\src\licensedcode\data\rules\odbl-1.0_url_badge.yml", "YAML", 0, 0, 0, 7, 0, 0, 1, 8
"d:\IDEWORK\lvmen\src\licensedcode\data\rules\odc-by-1.0_1.yml", "YAML", 0, 0, 0, 3, 0, 0, 1, 4
"d:\IDEWORK\lvmen\src\licensedcode\data\rules\odc-by-1.0_2.yml", "YAML", 0, 0, 0, 3, 0, 0, 1, 4
"d:\IDEWORK\lvmen\src\licensedcode\data\rules\odc-by-1.0_3.yml", "YAML", 0, 0, 0, 3, 0, 0, 1, 4
"d:\IDEWORK\lvmen\src\licensedcode\data\rules\odc-by-1.0_url_1.yml", "YAML", 0, 0, 0, 5, 0, 0, 1, 6
"d:\IDEWORK\lvmen\src\licensedcode\data\rules\odc-by-1.0_url_2.yml", "YAML", 0, 0, 0, 5, 0, 0, 1, 6
"d:\IDEWORK\lvmen\src\licensedcode\data\rules\odc-by-1.0_url_badge.yml", "YAML", 0, 0, 0, 5, 0, 0, 1, 6
"d:\IDEWORK\lvmen\src\licensedcode\data\rules\odl.yml", "YAML", 0, 0, 0, 5, 0, 0, 1, 6
"d:\IDEWORK\lvmen\src\licensedcode\data\rules\odl_1.yml", "YAML", 0, 0, 0, 5, 0, 0, 1, 6
"d:\IDEWORK\lvmen\src\licensedcode\data\rules\ofl-1.0.yml", "YAML", 0, 0, 0, 5, 0, 0, 1, 6
"d:\IDEWORK\lvmen\src\licensedcode\data\rules\ofl-1.0_1.yml", "YAML", 0, 0, 0, 5, 0, 0, 1, 6
"d:\IDEWORK\lvmen\src\licensedcode\data\rules\ofl-1.0_10.yml", "YAML", 0, 0, 0, 3, 0, 0, 1, 4
"d:\IDEWORK\lvmen\src\licensedcode\data\rules\ofl-1.0_11.yml", "YAML", 0, 0, 0, 5, 0, 0, 1, 6
"d:\IDEWORK\lvmen\src\licensedcode\data\rules\ofl-1.0_12.yml", "YAML", 0, 0, 0, 3, 0, 0, 1, 4
"d:\IDEWORK\lvmen\src\licensedcode\data\rules\ofl-1.0_2.yml", "YAML", 0, 0, 0, 5, 0, 0, 1, 6
"d:\IDEWORK\lvmen\src\licensedcode\data\rules\ofl-1.0_3.yml", "YAML", 0, 0, 0, 5, 0, 0, 1, 6
"d:\IDEWORK\lvmen\src\licensedcode\data\rules\ofl-1.0_5.yml", "YAML", 0, 0, 0, 3, 0, 0, 1, 4
"d:\IDEWORK\lvmen\src\licensedcode\data\rules\ofl-1.0_6.yml", "YAML", 0, 0, 0, 5, 0, 0, 1, 6
"d:\IDEWORK\lvmen\src\licensedcode\data\rules\ofl-1.0_7.yml", "YAML", 0, 0, 0, 3, 0, 0, 1, 4
"d:\IDEWORK\lvmen\src\licensedcode\data\rules\ofl-1.0_8.yml", "YAML", 0, 0, 0, 3, 0, 0, 1, 4
"d:\IDEWORK\lvmen\src\licensedcode\data\rules\ofl-1.0_9.yml", "YAML", 0, 0, 0, 3, 0, 0, 1, 4
"d:\IDEWORK\lvmen\src\licensedcode\data\rules\ofl-1.0_and_bitstream_1.yml", "YAML", 0, 0, 0, 3, 0, 0, 1, 4
"d:\IDEWORK\lvmen\src\licensedcode\data\rules\ofl-1.0_url_1.yml", "YAML", 0, 0, 0, 5, 0, 0, 1, 6
"d:\IDEWORK\lvmen\src\licensedcode\data\rules\ofl-1.0_url_2.yml", "YAML", 0, 0, 0, 5, 0, 0, 1, 6
"d:\IDEWORK\lvmen\src\licensedcode\data\rules\ofl-1.1.yml", "YAML", 0, 0, 0, 5, 0, 0, 1, 6
"d:\IDEWORK\lvmen\src\licensedcode\data\rules\ofl-1.1_1.yml", "YAML", 0, 0, 0, 3, 0, 0, 1, 4
"d:\IDEWORK\lvmen\src\licensedcode\data\rules\ofl-1.1_10.yml", "YAML", 0, 0, 0, 4, 0, 0, 1, 5
"d:\IDEWORK\lvmen\src\licensedcode\data\rules\ofl-1.1_11.yml", "YAML", 0, 0, 0, 5, 0, 0, 1, 6
"d:\IDEWORK\lvmen\src\licensedcode\data\rules\ofl-1.1_12.yml", "YAML", 0, 0, 0, 5, 0, 0, 1, 6
"d:\IDEWORK\lvmen\src\licensedcode\data\rules\ofl-1.1_13.yml", "YAML", 0, 0, 0, 3, 0, 0, 1, 4
"d:\IDEWORK\lvmen\src\licensedcode\data\rules\ofl-1.1_14.yml", "YAML", 0, 0, 0, 6, 0, 0, 1, 7
"d:\IDEWORK\lvmen\src\licensedcode\data\rules\ofl-1.1_15.yml", "YAML", 0, 0, 0, 6, 0, 0, 1, 7
"d:\IDEWORK\lvmen\src\licensedcode\data\rules\ofl-1.1_16.yml", "YAML", 0, 0, 0, 5, 0, 0, 1, 6
"d:\IDEWORK\lvmen\src\licensedcode\data\rules\ofl-1.1_17.yml", "YAML", 0, 0, 0, 5, 0, 0, 1, 6
"d:\IDEWORK\lvmen\src\licensedcode\data\rules\ofl-1.1_18.yml", "YAML", 0, 0, 0, 5, 0, 0, 1, 6
"d:\IDEWORK\lvmen\src\licensedcode\data\rules\ofl-1.1_19.yml", "YAML", 0, 0, 0, 5, 0, 0, 1, 6
"d:\IDEWORK\lvmen\src\licensedcode\data\rules\ofl-1.1_2.yml", "YAML", 0, 0, 0, 5, 0, 0, 1, 6
"d:\IDEWORK\lvmen\src\licensedcode\data\rules\ofl-1.1_20.yml", "YAML", 0, 0, 0, 3, 0, 0, 1, 4
"d:\IDEWORK\lvmen\src\licensedcode\data\rules\ofl-1.1_21.yml", "YAML", 0, 0, 0, 5, 0, 0, 1, 6
"d:\IDEWORK\lvmen\src\licensedcode\data\rules\ofl-1.1_22.yml", "YAML", 0, 0, 0, 6, 0, 0, 1, 7
"d:\IDEWORK\lvmen\src\licensedcode\data\rules\ofl-1.1_23.yml", "YAML", 0, 0, 0, 3, 0, 0, 1, 4
"d:\IDEWORK\lvmen\src\licensedcode\data\rules\ofl-1.1_24.yml", "YAML", 0, 0, 0, 5, 0, 0, 1, 6
"d:\IDEWORK\lvmen\src\licensedcode\data\rules\ofl-1.1_25.yml", "YAML", 0, 0, 0, 5, 0, 0, 1, 6
"d:\IDEWORK\lvmen\src\licensedcode\data\rules\ofl-1.1_26.yml", "YAML", 0, 0, 0, 3, 0, 0, 1, 4
"d:\IDEWORK\lvmen\src\licensedcode\data\rules\ofl-1.1_27.yml", "YAML", 0, 0, 0, 5, 0, 0, 1, 6
"d:\IDEWORK\lvmen\src\licensedcode\data\rules\ofl-1.1_28.yml", "YAML", 0, 0, 0, 3, 0, 0, 1, 4
"d:\IDEWORK\lvmen\src\licensedcode\data\rules\ofl-1.1_29.yml", "YAML", 0, 0, 0, 3, 0, 0, 1, 4
"d:\IDEWORK\lvmen\src\licensedcode\data\rules\ofl-1.1_3.yml", "YAML", 0, 0, 0, 5, 0, 0, 1, 6
"d:\IDEWORK\lvmen\src\licensedcode\data\rules\ofl-1.1_30.yml", "YAML", 0, 0, 0, 5, 0, 0, 1, 6
"d:\IDEWORK\lvmen\src\licensedcode\data\rules\ofl-1.1_31.yml", "YAML", 0, 0, 0, 5, 0, 0, 1, 6
"d:\IDEWORK\lvmen\src\licensedcode\data\rules\ofl-1.1_32.yml", "YAML", 0, 0, 0, 5, 0, 0, 1, 6
"d:\IDEWORK\lvmen\src\licensedcode\data\rules\ofl-1.1_33.yml", "YAML", 0, 0, 0, 5, 0, 0, 1, 6
"d:\IDEWORK\lvmen\src\licensedcode\data\rules\ofl-1.1_34.yml", "YAML", 0, 0, 0, 5, 0, 0, 1, 6
"d:\IDEWORK\lvmen\src\licensedcode\data\rules\ofl-1.1_35.yml", "YAML", 0, 0, 0, 5, 0, 0, 1, 6
"d:\IDEWORK\lvmen\src\licensedcode\data\rules\ofl-1.1_36.yml", "YAML", 0, 0, 0, 5, 0, 0, 1, 6
"d:\IDEWORK\lvmen\src\licensedcode\data\rules\ofl-1.1_37.yml", "YAML", 0, 0, 0, 5, 0, 0, 1, 6
"d:\IDEWORK\lvmen\src\licensedcode\data\rules\ofl-1.1_38.yml", "YAML", 0, 0, 0, 3, 0, 0, 1, 4
"d:\IDEWORK\lvmen\src\licensedcode\data\rules\ofl-1.1_39.yml", "YAML", 0, 0, 0, 3, 0, 0, 1, 4
"d:\IDEWORK\lvmen\src\licensedcode\data\rules\ofl-1.1_4.yml", "YAML", 0, 0, 0, 5, 0, 0, 1, 6
"d:\IDEWORK\lvmen\src\licensedcode\data\rules\ofl-1.1_40.yml", "YAML", 0, 0, 0, 5, 0, 0, 1, 6
"d:\IDEWORK\lvmen\src\licensedcode\data\rules\ofl-1.1_41.yml", "YAML", 0, 0, 0, 3, 0, 0, 1, 4
"d:\IDEWORK\lvmen\src\licensedcode\data\rules\ofl-1.1_42.yml", "YAML", 0, 0, 0, 3, 0, 0, 1, 4
"d:\IDEWORK\lvmen\src\licensedcode\data\rules\ofl-1.1_43.yml", "YAML", 0, 0, 0, 3, 0, 0, 1, 4
"d:\IDEWORK\lvmen\src\licensedcode\data\rules\ofl-1.1_44.yml", "YAML", 0, 0, 0, 5, 0, 0, 1, 6
"d:\IDEWORK\lvmen\src\licensedcode\data\rules\ofl-1.1_45.yml", "YAML", 0, 0, 0, 5, 0, 0, 1, 6
"d:\IDEWORK\lvmen\src\licensedcode\data\rules\ofl-1.1_46.yml", "YAML", 0, 0, 0, 5, 0, 0, 1, 6
"d:\IDEWORK\lvmen\src\licensedcode\data\rules\ofl-1.1_47.yml", "YAML", 0, 0, 0, 5, 0, 0, 1, 6
"d:\IDEWORK\lvmen\src\licensedcode\data\rules\ofl-1.1_48.yml", "YAML", 0, 0, 0, 6, 0, 0, 1, 7
"d:\IDEWORK\lvmen\src\licensedcode\data\rules\ofl-1.1_49.yml", "YAML", 0, 0, 0, 5, 0, 0, 1, 6
"d:\IDEWORK\lvmen\src\licensedcode\data\rules\ofl-1.1_5.yml", "YAML", 0, 0, 0, 4, 0, 0, 1, 5
"d:\IDEWORK\lvmen\src\licensedcode\data\rules\ofl-1.1_50.yml", "YAML", 0, 0, 0, 5, 0, 0, 1, 6
"d:\IDEWORK\lvmen\src\licensedcode\data\rules\ofl-1.1_51.yml", "YAML", 0, 0, 0, 5, 0, 0, 1, 6
"d:\IDEWORK\lvmen\src\licensedcode\data\rules\ofl-1.1_52.yml", "YAML", 0, 0, 0, 3, 0, 0, 1, 4
"d:\IDEWORK\lvmen\src\licensedcode\data\rules\ofl-1.1_53.yml", "YAML", 0, 0, 0, 3, 0, 0, 1, 4
"d:\IDEWORK\lvmen\src\licensedcode\data\rules\ofl-1.1_54.yml", "YAML", 0, 0, 0, 3, 0, 0, 1, 4
"d:\IDEWORK\lvmen\src\licensedcode\data\rules\ofl-1.1_55.yml", "YAML", 0, 0, 0, 3, 0, 0, 1, 4
"d:\IDEWORK\lvmen\src\licensedcode\data\rules\ofl-1.1_56.yml", "YAML", 0, 0, 0, 3, 0, 0, 1, 4
"d:\IDEWORK\lvmen\src\licensedcode\data\rules\ofl-1.1_57.yml", "YAML", 0, 0, 0, 3, 0, 0, 1, 4
"d:\IDEWORK\lvmen\src\licensedcode\data\rules\ofl-1.1_58.yml", "YAML", 0, 0, 0, 6, 0, 0, 1, 7
"d:\IDEWORK\lvmen\src\licensedcode\data\rules\ofl-1.1_59.yml", "YAML", 0, 0, 0, 4, 0, 0, 1, 5
"d:\IDEWORK\lvmen\src\licensedcode\data\rules\ofl-1.1_6.yml", "YAML", 0, 0, 0, 3, 0, 0, 1, 4
"d:\IDEWORK\lvmen\src\licensedcode\data\rules\ofl-1.1_60.yml", "YAML", 0, 0, 0, 5, 0, 0, 1, 6
"d:\IDEWORK\lvmen\src\licensedcode\data\rules\ofl-1.1_61.yml", "YAML", 0, 0, 0, 3, 0, 0, 1, 4
"d:\IDEWORK\lvmen\src\licensedcode\data\rules\ofl-1.1_62.yml", "YAML", 0, 0, 0, 5, 0, 0, 1, 6
"d:\IDEWORK\lvmen\src\licensedcode\data\rules\ofl-1.1_63.yml", "YAML", 0, 0, 0, 3, 0, 0, 1, 4
"d:\IDEWORK\lvmen\src\licensedcode\data\rules\ofl-1.1_64.yml", "YAML", 0, 0, 0, 5, 0, 0, 1, 6
"d:\IDEWORK\lvmen\src\licensedcode\data\rules\ofl-1.1_65.yml", "YAML", 0, 0, 0, 3, 0, 0, 1, 4
"d:\IDEWORK\lvmen\src\licensedcode\data\rules\ofl-1.1_66.yml", "YAML", 0, 0, 0, 6, 0, 0, 1, 7
"d:\IDEWORK\lvmen\src\licensedcode\data\rules\ofl-1.1_67.yml", "YAML", 0, 0, 0, 3, 0, 0, 1, 4
"d:\IDEWORK\lvmen\src\licensedcode\data\rules\ofl-1.1_68.yml", "YAML", 0, 0, 0, 5, 0, 0, 1, 6
"d:\IDEWORK\lvmen\src\licensedcode\data\rules\ofl-1.1_69.yml", "YAML", 0, 0, 0, 3, 0, 0, 1, 4
"d:\IDEWORK\lvmen\src\licensedcode\data\rules\ofl-1.1_7.yml", "YAML", 0, 0, 0, 4, 0, 0, 1, 5
"d:\IDEWORK\lvmen\src\licensedcode\data\rules\ofl-1.1_70.yml", "YAML", 0, 0, 0, 14, 0, 0, 1, 15
"d:\IDEWORK\lvmen\src\licensedcode\data\rules\ofl-1.1_8.yml", "YAML", 0, 0, 0, 4, 0, 0, 1, 5
"d:\IDEWORK\lvmen\src\licensedcode\data\rules\ofl-1.1_9.yml", "YAML", 0, 0, 0, 3, 0, 0, 1, 4
"d:\IDEWORK\lvmen\src\licensedcode\data\rules\ofl-1.1_and_mit_1.yml", "YAML", 0, 0, 0, 5, 0, 0, 1, 6
"d:\IDEWORK\lvmen\src\licensedcode\data\rules\ofl-1.1_and_mit_2.yml", "YAML", 0, 0, 0, 5, 0, 0, 1, 6
"d:\IDEWORK\lvmen\src\licensedcode\data\rules\ofl-1.1_and_mit_3.yml", "YAML", 0, 0, 0, 3, 0, 0, 1, 4
"d:\IDEWORK\lvmen\src\licensedcode\data\rules\ofl-1.1_and_mit_4.yml", "YAML", 0, 0, 0, 5, 0, 0, 1, 6
"d:\IDEWORK\lvmen\src\licensedcode\data\rules\ofl-1.1_and_mit_5.yml", "YAML", 0, 0, 0, 7, 0, 0, 1, 8
"d:\IDEWORK\lvmen\src\licensedcode\data\rules\ofl-1.1_and_mit_6.yml", "YAML", 0, 0, 0, 6, 0, 0, 1, 7
"d:\IDEWORK\lvmen\src\licensedcode\data\rules\ofl-1.1_and_mit_7.yml", "YAML", 0, 0, 0, 7, 0, 0, 1, 8
"d:\IDEWORK\lvmen\src\licensedcode\data\rules\ofl-1.1_and_mit_and_cc-by-3.0_1.yml", "YAML", 0, 0, 0, 8, 0, 0, 1, 9
"d:\IDEWORK\lvmen\src\licensedcode\data\rules\ofl-1.1_not_gpl.yml", "YAML", 0, 0, 0, 13, 0, 0, 1, 14
"d:\IDEWORK\lvmen\src\licensedcode\data\rules\ofl-1.1_url_1.yml", "YAML", 0, 0, 0, 5, 0, 0, 1, 6
"d:\IDEWORK\lvmen\src\licensedcode\data\rules\ofl-1.1_url_2.yml", "YAML", 0, 0, 0, 5, 0, 0, 1, 6
"d:\IDEWORK\lvmen\src\licensedcode\data\rules\ofl-1.1_url_glc_214.yml", "YAML", 0, 0, 0, 5, 0, 0, 1, 6
"d:\IDEWORK\lvmen\src\licensedcode\data\rules\ofl-1.1_url_glc_215.yml", "YAML", 0, 0, 0, 5, 0, 0, 1, 6
"d:\IDEWORK\lvmen\src\licensedcode\data\rules\ogc-1.0_not_2006.yml", "YAML", 0, 0, 0, 8, 0, 0, 1, 9
"d:\IDEWORK\lvmen\src\licensedcode\data\rules\ogc-2006_1.yml", "YAML", 0, 0, 0, 9, 0, 0, 1, 10
"d:\IDEWORK\lvmen\src\licensedcode\data\rules\ogc-2006_2.yml", "YAML", 0, 0, 0, 10, 0, 0, 1, 11
"d:\IDEWORK\lvmen\src\licensedcode\data\rules\ogl-uk-1.0.yml", "YAML", 0, 0, 0, 2, 0, 0, 1, 3
"d:\IDEWORK\lvmen\src\licensedcode\data\rules\ogl-uk-1.0_url_1.yml", "YAML", 0, 0, 0, 5, 0, 0, 1, 6
"d:\IDEWORK\lvmen\src\licensedcode\data\rules\ogl-uk-1.0_url_2.yml", "YAML", 0, 0, 0, 5, 0, 0, 1, 6
"d:\IDEWORK\lvmen\src\licensedcode\data\rules\ogl-uk-2.0_1.yml", "YAML", 0, 0, 0, 3, 0, 0, 1, 4
"d:\IDEWORK\lvmen\src\licensedcode\data\rules\ogl-uk-2.0_url_1.yml", "YAML", 0, 0, 0, 5, 0, 0, 1, 6
"d:\IDEWORK\lvmen\src\licensedcode\data\rules\ogl-uk-2.0_url_2.yml", "YAML", 0, 0, 0, 5, 0, 0, 1, 6
"d:\IDEWORK\lvmen\src\licensedcode\data\rules\ogl-uk-3.0_1.yml", "YAML", 0, 0, 0, 4, 0, 0, 1, 5
"d:\IDEWORK\lvmen\src\licensedcode\data\rules\ogl-uk-3.0_2.yml", "YAML", 0, 0, 0, 4, 0, 0, 1, 5
"d:\IDEWORK\lvmen\src\licensedcode\data\rules\ogl-uk-3.0_url_1.yml", "YAML", 0, 0, 0, 5, 0, 0, 1, 6
"d:\IDEWORK\lvmen\src\licensedcode\data\rules\ogl-uk-3.0_url_2.yml", "YAML", 0, 0, 0, 5, 0, 0, 1, 6
"d:\IDEWORK\lvmen\src\licensedcode\data\rules\open-group.yml", "YAML", 0, 0, 0, 5, 0, 0, 1, 6
"d:\IDEWORK\lvmen\src\licensedcode\data\rules\open-group_1.yml", "YAML", 0, 0, 0, 3, 0, 0, 1, 4
"d:\IDEWORK\lvmen\src\licensedcode\data\rules\open-public.SPDX.yml", "YAML", 0, 0, 0, 4, 0, 0, 1, 5
"d:\IDEWORK\lvmen\src\licensedcode\data\rules\open-public.yml", "YAML", 0, 0, 0, 5, 0, 0, 1, 6
"d:\IDEWORK\lvmen\src\licensedcode\data\rules\open-public_1.yml", "YAML", 0, 0, 0, 5, 0, 0, 1, 6
"d:\IDEWORK\lvmen\src\licensedcode\data\rules\open-public_url_1.yml", "YAML", 0, 0, 0, 5, 0, 0, 1, 6
"d:\IDEWORK\lvmen\src\licensedcode\data\rules\open-public_url_2.yml", "YAML", 0, 0, 0, 5, 0, 0, 1, 6
"d:\IDEWORK\lvmen\src\licensedcode\data\rules\opengroup.yml", "YAML", 0, 0, 0, 3, 0, 0, 1, 4
"d:\IDEWORK\lvmen\src\licensedcode\data\rules\opengroup_1.yml", "YAML", 0, 0, 0, 5, 0, 0, 1, 6
"d:\IDEWORK\lvmen\src\licensedcode\data\rules\opengroup_2.yml", "YAML", 0, 0, 0, 5, 0, 0, 1, 6
"d:\IDEWORK\lvmen\src\licensedcode\data\rules\opengroup_url_1.yml", "YAML", 0, 0, 0, 5, 0, 0, 1, 6
"d:\IDEWORK\lvmen\src\licensedcode\data\rules\opengroup_url_2.yml", "YAML", 0, 0, 0, 5, 0, 0, 1, 6
"d:\IDEWORK\lvmen\src\licensedcode\data\rules\opengroup_url_glc_216.yml", "YAML", 0, 0, 0, 5, 0, 0, 1, 6
"d:\IDEWORK\lvmen\src\licensedcode\data\rules\opengroup_url_glc_217.yml", "YAML", 0, 0, 0, 5, 0, 0, 1, 6
"d:\IDEWORK\lvmen\src\licensedcode\data\rules\openjdk-assembly-exception-1.0_1.yml", "YAML", 0, 0, 0, 2, 0, 0, 1, 3
"d:\IDEWORK\lvmen\src\licensedcode\data\rules\openjdk-assembly-exception-1.0_url_1.yml", "YAML", 0, 0, 0, 5, 0, 0, 1, 6
"d:\IDEWORK\lvmen\src\licensedcode\data\rules\openjdk-assembly-exception-1.0_url_2.yml", "YAML", 0, 0, 0, 5, 0, 0, 1, 6
"d:\IDEWORK\lvmen\src\licensedcode\data\rules\openjdk-exception_1.yml", "YAML", 0, 0, 0, 6, 0, 0, 1, 7
"d:\IDEWORK\lvmen\src\licensedcode\data\rules\openjdk-exception_2.yml", "YAML", 0, 0, 0, 4, 0, 0, 1, 5
"d:\IDEWORK\lvmen\src\licensedcode\data\rules\openjdk-exception_3.yml", "YAML", 0, 0, 0, 5, 0, 0, 1, 6
"d:\IDEWORK\lvmen\src\licensedcode\data\rules\openjdk-exception_4.yml", "YAML", 0, 0, 0, 5, 0, 0, 1, 6
"d:\IDEWORK\lvmen\src\licensedcode\data\rules\openjdk-exception_5.yml", "YAML", 0, 0, 0, 5, 0, 0, 1, 6
"d:\IDEWORK\lvmen\src\licensedcode\data\rules\openjdk-exception_6.yml", "YAML", 0, 0, 0, 5, 0, 0, 1, 6
"d:\IDEWORK\lvmen\src\licensedcode\data\rules\openjdk-exception_7.yml", "YAML", 0, 0, 0, 4, 0, 0, 1, 5
"d:\IDEWORK\lvmen\src\licensedcode\data\rules\openjdk-exception_8.yml", "YAML", 0, 0, 0, 6, 0, 0, 1, 7
"d:\IDEWORK\lvmen\src\licensedcode\data\rules\openjdk-exception_9.yml", "YAML", 0, 0, 0, 6, 0, 0, 1, 7
"d:\IDEWORK\lvmen\src\licensedcode\data\rules\openjdk-exception_designated-modules.yml", "YAML", 0, 0, 0, 2, 0, 0, 1, 3
"d:\IDEWORK\lvmen\src\licensedcode\data\rules\openjdk-exception_designated-modules2.yml", "YAML", 0, 0, 0, 2, 0, 0, 1, 3
"d:\IDEWORK\lvmen\src\licensedcode\data\rules\openldap-1.1.yml", "YAML", 0, 0, 0, 8, 0, 0, 1, 9
"d:\IDEWORK\lvmen\src\licensedcode\data\rules\openldap-1.1_url_1.yml", "YAML", 0, 0, 0, 5, 0, 0, 1, 6
"d:\IDEWORK\lvmen\src\licensedcode\data\rules\openldap-1.1_url_2.yml", "YAML", 0, 0, 0, 5, 0, 0, 1, 6
"d:\IDEWORK\lvmen\src\licensedcode\data\rules\openldap-1.2.yml", "YAML", 0, 0, 0, 7, 0, 0, 1, 8
"d:\IDEWORK\lvmen\src\licensedcode\data\rules\openldap-1.2_url_1.yml", "YAML", 0, 0, 0, 5, 0, 0, 1, 6
"d:\IDEWORK\lvmen\src\licensedcode\data\rules\openldap-1.2_url_2.yml", "YAML", 0, 0, 0, 5, 0, 0, 1, 6
"d:\IDEWORK\lvmen\src\licensedcode\data\rules\openldap-1.3.yml", "YAML", 0, 0, 0, 8, 0, 0, 1, 9
"d:\IDEWORK\lvmen\src\licensedcode\data\rules\openldap-1.3_url_1.yml", "YAML", 0, 0, 0, 5, 0, 0, 1, 6
"d:\IDEWORK\lvmen\src\licensedcode\data\rules\openldap-1.3_url_2.yml", "YAML", 0, 0, 0, 5, 0, 0, 1, 6
"d:\IDEWORK\lvmen\src\licensedcode\data\rules\openldap-1.4.yml", "YAML", 0, 0, 0, 8, 0, 0, 1, 9
"d:\IDEWORK\lvmen\src\licensedcode\data\rules\openldap-1.4_url_1.yml", "YAML", 0, 0, 0, 5, 0, 0, 1, 6
"d:\IDEWORK\lvmen\src\licensedcode\data\rules\openldap-1.4_url_2.yml", "YAML", 0, 0, 0, 5, 0, 0, 1, 6
"d:\IDEWORK\lvmen\src\licensedcode\data\rules\openldap-2.0.1_url_1.yml", "YAML", 0, 0, 0, 5, 0, 0, 1, 6
"d:\IDEWORK\lvmen\src\licensedcode\data\rules\openldap-2.0.1_url_2.yml", "YAML", 0, 0, 0, 5, 0, 0, 1, 6
"d:\IDEWORK\lvmen\src\licensedcode\data\rules\openldap-2.0_url_1.yml", "YAML", 0, 0, 0, 5, 0, 0, 1, 6
"d:\IDEWORK\lvmen\src\licensedcode\data\rules\openldap-2.0_url_2.yml", "YAML", 0, 0, 0, 5, 0, 0, 1, 6
"d:\IDEWORK\lvmen\src\licensedcode\data\rules\openldap-2.1_url_1.yml", "YAML", 0, 0, 0, 5, 0, 0, 1, 6
"d:\IDEWORK\lvmen\src\licensedcode\data\rules\openldap-2.1_url_2.yml", "YAML", 0, 0, 0, 5, 0, 0, 1, 6
"d:\IDEWORK\lvmen\src\licensedcode\data\rules\openldap-2.2.1_url_1.yml", "YAML", 0, 0, 0, 5, 0, 0, 1, 6
"d:\IDEWORK\lvmen\src\licensedcode\data\rules\openldap-2.2.1_url_2.yml", "YAML", 0, 0, 0, 5, 0, 0, 1, 6
"d:\IDEWORK\lvmen\src\licensedcode\data\rules\openldap-2.2.2_url_1.yml", "YAML", 0, 0, 0, 5, 0, 0, 1, 6
"d:\IDEWORK\lvmen\src\licensedcode\data\rules\openldap-2.2.2_url_2.yml", "YAML", 0, 0, 0, 5, 0, 0, 1, 6
"d:\IDEWORK\lvmen\src\licensedcode\data\rules\openldap-2.2_url_1.yml", "YAML", 0, 0, 0, 5, 0, 0, 1, 6
"d:\IDEWORK\lvmen\src\licensedcode\data\rules\openldap-2.2_url_2.yml", "YAML", 0, 0, 0, 5, 0, 0, 1, 6
"d:\IDEWORK\lvmen\src\licensedcode\data\rules\openldap-2.3_url_1.yml", "YAML", 0, 0, 0, 5, 0, 0, 1, 6
"d:\IDEWORK\lvmen\src\licensedcode\data\rules\openldap-2.3_url_2.yml", "YAML", 0, 0, 0, 5, 0, 0, 1, 6
"d:\IDEWORK\lvmen\src\licensedcode\data\rules\openldap-2.4_url_1.yml", "YAML", 0, 0, 0, 5, 0, 0, 1, 6
"d:\IDEWORK\lvmen\src\licensedcode\data\rules\openldap-2.4_url_2.yml", "YAML", 0, 0, 0, 5, 0, 0, 1, 6
"d:\IDEWORK\lvmen\src\licensedcode\data\rules\openldap-2.5_url_1.yml", "YAML", 0, 0, 0, 5, 0, 0, 1, 6
"d:\IDEWORK\lvmen\src\licensedcode\data\rules\openldap-2.5_url_2.yml", "YAML", 0, 0, 0, 5, 0, 0, 1, 6
"d:\IDEWORK\lvmen\src\licensedcode\data\rules\openldap-2.6.yml", "YAML", 0, 0, 0, 7, 0, 0, 1, 8
"d:\IDEWORK\lvmen\src\licensedcode\data\rules\openldap-2.6_url_1.yml", "YAML", 0, 0, 0, 5, 0, 0, 1, 6
"d:\IDEWORK\lvmen\src\licensedcode\data\rules\openldap-2.6_url_2.yml", "YAML", 0, 0, 0, 5, 0, 0, 1, 6
"d:\IDEWORK\lvmen\src\licensedcode\data\rules\openldap-2.7.yml", "YAML", 0, 0, 0, 7, 0, 0, 1, 8
"d:\IDEWORK\lvmen\src\licensedcode\data\rules\openldap-2.7_url_1.yml", "YAML", 0, 0, 0, 5, 0, 0, 1, 6
"d:\IDEWORK\lvmen\src\licensedcode\data\rules\openldap-2.7_url_2.yml", "YAML", 0, 0, 0, 5, 0, 0, 1, 6
"d:\IDEWORK\lvmen\src\licensedcode\data\rules\openldap-2.8.yml", "YAML", 0, 0, 0, 5, 0, 0, 1, 6
"d:\IDEWORK\lvmen\src\licensedcode\data\rules\openldap-2.8_1.yml", "YAML", 0, 0, 0, 3, 0, 0, 1, 4
"d:\IDEWORK\lvmen\src\licensedcode\data\rules\openldap-2.8_10.yml", "YAML", 0, 0, 0, 3, 0, 0, 1, 4
"d:\IDEWORK\lvmen\src\licensedcode\data\rules\openldap-2.8_11.yml", "YAML", 0, 0, 0, 3, 0, 0, 1, 4
"d:\IDEWORK\lvmen\src\licensedcode\data\rules\openldap-2.8_12.yml", "YAML", 0, 0, 0, 3, 0, 0, 1, 4
"d:\IDEWORK\lvmen\src\licensedcode\data\rules\openldap-2.8_13.yml", "YAML", 0, 0, 0, 3, 0, 0, 1, 4
"d:\IDEWORK\lvmen\src\licensedcode\data\rules\openldap-2.8_14.yml", "YAML", 0, 0, 0, 8, 0, 0, 1, 9
"d:\IDEWORK\lvmen\src\licensedcode\data\rules\openldap-2.8_15.yml", "YAML", 0, 0, 0, 7, 0, 0, 1, 8
"d:\IDEWORK\lvmen\src\licensedcode\data\rules\openldap-2.8_16.yml", "YAML", 0, 0, 0, 3, 0, 0, 1, 4
"d:\IDEWORK\lvmen\src\licensedcode\data\rules\openldap-2.8_17.yml", "YAML", 0, 0, 0, 3, 0, 0, 1, 4
"d:\IDEWORK\lvmen\src\licensedcode\data\rules\openldap-2.8_18.yml", "YAML", 0, 0, 0, 7, 0, 0, 1, 8
"d:\IDEWORK\lvmen\src\licensedcode\data\rules\openldap-2.8_19.yml", "YAML", 0, 0, 0, 9, 0, 0, 1, 10
"d:\IDEWORK\lvmen\src\licensedcode\data\rules\openldap-2.8_2.yml", "YAML", 0, 0, 0, 9, 0, 0, 1, 10
"d:\IDEWORK\lvmen\src\licensedcode\data\rules\openldap-2.8_20.yml", "YAML", 0, 0, 0, 5, 0, 0, 1, 6
"d:\IDEWORK\lvmen\src\licensedcode\data\rules\openldap-2.8_21.yml", "YAML", 0, 0, 0, 6, 0, 0, 1, 7
"d:\IDEWORK\lvmen\src\licensedcode\data\rules\openldap-2.8_3.yml", "YAML", 0, 0, 0, 9, 0, 0, 1, 10
"d:\IDEWORK\lvmen\src\licensedcode\data\rules\openldap-2.8_4.yml", "YAML", 0, 0, 0, 5, 0, 0, 1, 6
"d:\IDEWORK\lvmen\src\licensedcode\data\rules\openldap-2.8_5.yml", "YAML", 0, 0, 0, 4, 0, 0, 1, 5
"d:\IDEWORK\lvmen\src\licensedcode\data\rules\openldap-2.8_6.yml", "YAML", 0, 0, 0, 5, 0, 0, 1, 6
"d:\IDEWORK\lvmen\src\licensedcode\data\rules\openldap-2.8_7.yml", "YAML", 0, 0, 0, 4, 0, 0, 1, 5
"d:\IDEWORK\lvmen\src\licensedcode\data\rules\openldap-2.8_8.yml", "YAML", 0, 0, 0, 4, 0, 0, 1, 5
"d:\IDEWORK\lvmen\src\licensedcode\data\rules\openldap-2.8_9.yml", "YAML", 0, 0, 0, 7, 0, 0, 1, 8
"d:\IDEWORK\lvmen\src\licensedcode\data\rules\openldap-2.8_url_1.yml", "YAML", 0, 0, 0, 5, 0, 0, 1, 6
"d:\IDEWORK\lvmen\src\licensedcode\data\rules\openldap-2.8_url_2.yml", "YAML", 0, 0, 0, 5, 0, 0, 1, 6
"d:\IDEWORK\lvmen\src\licensedcode\data\rules\openmarket-fastcgi.yml", "YAML", 0, 0, 0, 5, 0, 0, 1, 6
"d:\IDEWORK\lvmen\src\licensedcode\data\rules\openmotif-exception-2.0-plus_1.yml", "YAML", 0, 0, 0, 4, 0, 0, 1, 5
"d:\IDEWORK\lvmen\src\licensedcode\data\rules\openpbs-2.3.yml", "YAML", 0, 0, 0, 5, 0, 0, 1, 6
"d:\IDEWORK\lvmen\src\licensedcode\data\rules\openpbs-2.3_1.yml", "YAML", 0, 0, 0, 5, 0, 0, 1, 6
"d:\IDEWORK\lvmen\src\licensedcode\data\rules\openpub_1.yml", "YAML", 0, 0, 0, 4, 0, 0, 1, 5
"d:\IDEWORK\lvmen\src\licensedcode\data\rules\openpub_2.yml", "YAML", 0, 0, 0, 5, 0, 0, 1, 6
"d:\IDEWORK\lvmen\src\licensedcode\data\rules\openpub_3.yml", "YAML", 0, 0, 0, 4, 0, 0, 1, 5
"d:\IDEWORK\lvmen\src\licensedcode\data\rules\openpub_4.yml", "YAML", 0, 0, 0, 3, 0, 0, 1, 4
"d:\IDEWORK\lvmen\src\licensedcode\data\rules\openpub_5.yml", "YAML", 0, 0, 0, 4, 0, 0, 1, 5
"d:\IDEWORK\lvmen\src\licensedcode\data\rules\openpub_6.yml", "YAML", 0, 0, 0, 5, 0, 0, 1, 6
"d:\IDEWORK\lvmen\src\licensedcode\data\rules\openpub_7.yml", "YAML", 0, 0, 0, 3, 0, 0, 1, 4
"d:\IDEWORK\lvmen\src\licensedcode\data\rules\openpub_8.yml", "YAML", 0, 0, 0, 11, 0, 0, 1, 12
"d:\IDEWORK\lvmen\src\licensedcode\data\rules\opensaml-1.0.yml", "YAML", 0, 0, 0, 8, 0, 0, 1, 9
"d:\IDEWORK\lvmen\src\licensedcode\data\rules\openssl-exception-agpl-3.0_1.yml", "YAML", 0, 0, 0, 4, 0, 0, 1, 5
"d:\IDEWORK\lvmen\src\licensedcode\data\rules\openssl-exception-gpl-2.0-plus_1.yml", "YAML", 0, 0, 0, 3, 0, 0, 1, 4
"d:\IDEWORK\lvmen\src\licensedcode\data\rules\openssl-exception-gpl-2.0_1.yml", "YAML", 0, 0, 0, 3, 0, 0, 1, 4
"d:\IDEWORK\lvmen\src\licensedcode\data\rules\openssl-exception-gpl-2.0_2.yml", "YAML", 0, 0, 0, 3, 0, 0, 1, 4
"d:\IDEWORK\lvmen\src\licensedcode\data\rules\openssl-exception-gpl-2.0_3.yml", "YAML", 0, 0, 0, 3, 0, 0, 1, 4
"d:\IDEWORK\lvmen\src\licensedcode\data\rules\openssl-exception-gpl-3.0-plus_1.yml", "YAML", 0, 0, 0, 4, 0, 0, 1, 5
"d:\IDEWORK\lvmen\src\licensedcode\data\rules\openssl-exception-gpl-3.0-plus_2.yml", "YAML", 0, 0, 0, 3, 0, 0, 1, 4
"d:\IDEWORK\lvmen\src\licensedcode\data\rules\openssl-exception-gpl-3.0-plus_3.yml", "YAML", 0, 0, 0, 4, 0, 0, 1, 5
"d:\IDEWORK\lvmen\src\licensedcode\data\rules\openssl-exception-lgpl-2.0-plus_1.yml", "YAML", 0, 0, 0, 6, 0, 0, 1, 7
"d:\IDEWORK\lvmen\src\licensedcode\data\rules\openssl-ssleay.SPDX.yml", "YAML", 0, 0, 0, 20, 0, 0, 1, 21
"d:\IDEWORK\lvmen\src\licensedcode\data\rules\openssl-ssleay_1.yml", "YAML", 0, 0, 0, 5, 0, 0, 1, 6
"d:\IDEWORK\lvmen\src\licensedcode\data\rules\openssl-ssleay_10.yml", "YAML", 0, 0, 0, 2, 0, 0, 1, 3
"d:\IDEWORK\lvmen\src\licensedcode\data\rules\openssl-ssleay_11.yml", "YAML", 0, 0, 0, 3, 0, 0, 1, 4
"d:\IDEWORK\lvmen\src\licensedcode\data\rules\openssl-ssleay_12.yml", "YAML", 0, 0, 0, 5, 0, 0, 1, 6
"d:\IDEWORK\lvmen\src\licensedcode\data\rules\openssl-ssleay_13.yml", "YAML", 0, 0, 0, 2, 0, 0, 1, 3
"d:\IDEWORK\lvmen\src\licensedcode\data\rules\openssl-ssleay_14.yml", "YAML", 0, 0, 0, 21, 0, 0, 1, 22
"d:\IDEWORK\lvmen\src\licensedcode\data\rules\openssl-ssleay_15.yml", "YAML", 0, 0, 0, 3, 0, 0, 1, 4
"d:\IDEWORK\lvmen\src\licensedcode\data\rules\openssl-ssleay_16.yml", "YAML", 0, 0, 0, 3, 0, 0, 1, 4
"d:\IDEWORK\lvmen\src\licensedcode\data\rules\openssl-ssleay_17.yml", "YAML", 0, 0, 0, 3, 0, 0, 1, 4
"d:\IDEWORK\lvmen\src\licensedcode\data\rules\openssl-ssleay_18.yml", "YAML", 0, 0, 0, 21, 0, 0, 1, 22
"d:\IDEWORK\lvmen\src\licensedcode\data\rules\openssl-ssleay_19.yml", "YAML", 0, 0, 0, 18, 0, 0, 1, 19
"d:\IDEWORK\lvmen\src\licensedcode\data\rules\openssl-ssleay_2.yml", "YAML", 0, 0, 0, 3, 0, 0, 1, 4
"d:\IDEWORK\lvmen\src\licensedcode\data\rules\openssl-ssleay_20.yml", "YAML", 0, 0, 0, 2, 0, 0, 1, 3
"d:\IDEWORK\lvmen\src\licensedcode\data\rules\openssl-ssleay_21.yml", "YAML", 0, 0, 0, 5, 0, 0, 1, 6
"d:\IDEWORK\lvmen\src\licensedcode\data\rules\openssl-ssleay_22.yml", "YAML", 0, 0, 0, 8, 0, 0, 1, 9
"d:\IDEWORK\lvmen\src\licensedcode\data\rules\openssl-ssleay_23.yml", "YAML", 0, 0, 0, 3, 0, 0, 1, 4
"d:\IDEWORK\lvmen\src\licensedcode\data\rules\openssl-ssleay_24.yml", "YAML", 0, 0, 0, 3, 0, 0, 1, 4
"d:\IDEWORK\lvmen\src\licensedcode\data\rules\openssl-ssleay_25.yml", "YAML", 0, 0, 0, 3, 0, 0, 1, 4
"d:\IDEWORK\lvmen\src\licensedcode\data\rules\openssl-ssleay_26.yml", "YAML", 0, 0, 0, 5, 0, 0, 1, 6
"d:\IDEWORK\lvmen\src\licensedcode\data\rules\openssl-ssleay_27.yml", "YAML", 0, 0, 0, 5, 0, 0, 1, 6
"d:\IDEWORK\lvmen\src\licensedcode\data\rules\openssl-ssleay_28.yml", "YAML", 0, 0, 0, 3, 0, 0, 1, 4
"d:\IDEWORK\lvmen\src\licensedcode\data\rules\openssl-ssleay_29.yml", "YAML", 0, 0, 0, 3, 0, 0, 1, 4
"d:\IDEWORK\lvmen\src\licensedcode\data\rules\openssl-ssleay_3.yml", "YAML", 0, 0, 0, 20, 0, 0, 1, 21
"d:\IDEWORK\lvmen\src\licensedcode\data\rules\openssl-ssleay_30.yml", "YAML", 0, 0, 0, 3, 0, 0, 1, 4
"d:\IDEWORK\lvmen\src\licensedcode\data\rules\openssl-ssleay_31.yml", "YAML", 0, 0, 0, 21, 0, 0, 1, 22
"d:\IDEWORK\lvmen\src\licensedcode\data\rules\openssl-ssleay_32.yml", "YAML", 0, 0, 0, 3, 0, 0, 1, 4
"d:\IDEWORK\lvmen\src\licensedcode\data\rules\openssl-ssleay_33.yml", "YAML", 0, 0, 0, 5, 0, 0, 1, 6
"d:\IDEWORK\lvmen\src\licensedcode\data\rules\openssl-ssleay_34.yml", "YAML", 0, 0, 0, 19, 0, 0, 1, 20
"d:\IDEWORK\lvmen\src\licensedcode\data\rules\openssl-ssleay_35.yml", "YAML", 0, 0, 0, 21, 0, 0, 1, 22
"d:\IDEWORK\lvmen\src\licensedcode\data\rules\openssl-ssleay_36.yml", "YAML", 0, 0, 0, 22, 0, 0, 1, 23
"d:\IDEWORK\lvmen\src\licensedcode\data\rules\openssl-ssleay_37.yml", "YAML", 0, 0, 0, 21, 0, 0, 1, 22
"d:\IDEWORK\lvmen\src\licensedcode\data\rules\openssl-ssleay_38.yml", "YAML", 0, 0, 0, 3, 0, 0, 1, 4
"d:\IDEWORK\lvmen\src\licensedcode\data\rules\openssl-ssleay_39.yml", "YAML", 0, 0, 0, 3, 0, 0, 1, 4
"d:\IDEWORK\lvmen\src\licensedcode\data\rules\openssl-ssleay_4.yml", "YAML", 0, 0, 0, 22, 0, 0, 1, 23
"d:\IDEWORK\lvmen\src\licensedcode\data\rules\openssl-ssleay_40.yml", "YAML", 0, 0, 0, 21, 0, 0, 1, 22
"d:\IDEWORK\lvmen\src\licensedcode\data\rules\openssl-ssleay_41.yml", "YAML", 0, 0, 0, 5, 0, 0, 1, 6
"d:\IDEWORK\lvmen\src\licensedcode\data\rules\openssl-ssleay_42.yml", "YAML", 0, 0, 0, 5, 0, 0, 1, 6
"d:\IDEWORK\lvmen\src\licensedcode\data\rules\openssl-ssleay_43.yml", "YAML", 0, 0, 0, 5, 0, 0, 1, 6
"d:\IDEWORK\lvmen\src\licensedcode\data\rules\openssl-ssleay_44.yml", "YAML", 0, 0, 0, 4, 0, 0, 1, 5
"d:\IDEWORK\lvmen\src\licensedcode\data\rules\openssl-ssleay_45.yml", "YAML", 0, 0, 0, 3, 0, 0, 1, 4
"d:\IDEWORK\lvmen\src\licensedcode\data\rules\openssl-ssleay_46.yml", "YAML", 0, 0, 0, 5, 0, 0, 1, 6
"d:\IDEWORK\lvmen\src\licensedcode\data\rules\openssl-ssleay_47.yml", "YAML", 0, 0, 0, 3, 0, 0, 1, 4
"d:\IDEWORK\lvmen\src\licensedcode\data\rules\openssl-ssleay_48.yml", "YAML", 0, 0, 0, 3, 0, 0, 1, 4
"d:\IDEWORK\lvmen\src\licensedcode\data\rules\openssl-ssleay_49.yml", "YAML", 0, 0, 0, 3, 0, 0, 1, 4
"d:\IDEWORK\lvmen\src\licensedcode\data\rules\openssl-ssleay_5.yml", "YAML", 0, 0, 0, 5, 0, 0, 1, 6
"d:\IDEWORK\lvmen\src\licensedcode\data\rules\openssl-ssleay_50.yml", "YAML", 0, 0, 0, 3, 0, 0, 1, 4
"d:\IDEWORK\lvmen\src\licensedcode\data\rules\openssl-ssleay_51.yml", "YAML", 0, 0, 0, 12, 0, 0, 1, 13
"d:\IDEWORK\lvmen\src\licensedcode\data\rules\openssl-ssleay_52.yml", "YAML", 0, 0, 0, 7, 0, 0, 1, 8
"d:\IDEWORK\lvmen\src\licensedcode\data\rules\openssl-ssleay_53.yml", "YAML", 0, 0, 0, 3, 0, 0, 1, 4
"d:\IDEWORK\lvmen\src\licensedcode\data\rules\openssl-ssleay_54.yml", "YAML", 0, 0, 0, 5, 0, 0, 1, 6
"d:\IDEWORK\lvmen\src\licensedcode\data\rules\openssl-ssleay_55.yml", "YAML", 0, 0, 0, 21, 0, 0, 1, 22
"d:\IDEWORK\lvmen\src\licensedcode\data\rules\openssl-ssleay_56.yml", "YAML", 0, 0, 0, 21, 0, 0, 1, 22
"d:\IDEWORK\lvmen\src\licensedcode\data\rules\openssl-ssleay_57.yml", "YAML", 0, 0, 0, 3, 0, 0, 1, 4
"d:\IDEWORK\lvmen\src\licensedcode\data\rules\openssl-ssleay_6.yml", "YAML", 0, 0, 0, 9, 0, 0, 1, 10
"d:\IDEWORK\lvmen\src\licensedcode\data\rules\openssl-ssleay_7.yml", "YAML", 0, 0, 0, 5, 0, 0, 1, 6
"d:\IDEWORK\lvmen\src\licensedcode\data\rules\openssl-ssleay_8.yml", "YAML", 0, 0, 0, 3, 0, 0, 1, 4
"d:\IDEWORK\lvmen\src\licensedcode\data\rules\openssl-ssleay_9.yml", "YAML", 0, 0, 0, 21, 0, 0, 1, 22
"d:\IDEWORK\lvmen\src\licensedcode\data\rules\openssl-ssleay_and_isc_1.yml", "YAML", 0, 0, 0, 3, 0, 0, 1, 4
"d:\IDEWORK\lvmen\src\licensedcode\data\rules\openssl-ssleay_and_mit.yml", "YAML", 0, 0, 0, 5, 0, 0, 1, 6
"d:\IDEWORK\lvmen\src\licensedcode\data\rules\openssl-ssleay_and_other-permissive.yml", "YAML", 0, 0, 0, 5, 0, 0, 1, 6
"d:\IDEWORK\lvmen\src\licensedcode\data\rules\openssl-ssleay_and_other-permissive_1.yml", "YAML", 0, 0, 0, 14, 0, 0, 1, 15
"d:\IDEWORK\lvmen\src\licensedcode\data\rules\openssl-ssleay_and_other-permissive_2.yml", "YAML", 0, 0, 0, 13, 0, 0, 1, 14
"d:\IDEWORK\lvmen\src\licensedcode\data\rules\openssl-ssleay_and_other-permissive_3.yml", "YAML", 0, 0, 0, 14, 0, 0, 1, 15
"d:\IDEWORK\lvmen\src\licensedcode\data\rules\openssl-ssleay_gpl_mention_openssl.yml", "YAML", 0, 0, 0, 3, 0, 0, 1, 4
"d:\IDEWORK\lvmen\src\licensedcode\data\rules\openssl-ssleay_or_bsd-new_1.yml", "YAML", 0, 0, 0, 5, 0, 0, 1, 6
"d:\IDEWORK\lvmen\src\licensedcode\data\rules\openssl-ssleay_or_bsd-new_2.yml", "YAML", 0, 0, 0, 5, 0, 0, 1, 6
"d:\IDEWORK\lvmen\src\licensedcode\data\rules\openssl-ssleay_or_bsd-new_3.yml", "YAML", 0, 0, 0, 9, 0, 0, 1, 10
"d:\IDEWORK\lvmen\src\licensedcode\data\rules\openssl-ssleay_or_bsd-new_or_gpl-1.0-plus_1.yml", "YAML", 0, 0, 0, 5, 0, 0, 1, 6
"d:\IDEWORK\lvmen\src\licensedcode\data\rules\openssl-ssleay_or_bsd-new_or_gpl-1.0-plus_or_gpl-2.0_1.yml", "YAML", 0, 0, 0, 5, 0, 0, 1, 6
"d:\IDEWORK\lvmen\src\licensedcode\data\rules\openssl-ssleay_or_bsd-simplified_1.yml", "YAML", 0, 0, 0, 5, 0, 0, 1, 6
"d:\IDEWORK\lvmen\src\licensedcode\data\rules\openssl-ssleay_url_1.yml", "YAML", 0, 0, 0, 5, 0, 0, 1, 6
"d:\IDEWORK\lvmen\src\licensedcode\data\rules\openssl-ssleay_url_2.yml", "YAML", 0, 0, 0, 5, 0, 0, 1, 6
"d:\IDEWORK\lvmen\src\licensedcode\data\rules\openssl_1.yml", "YAML", 0, 0, 0, 12, 0, 0, 1, 13
"d:\IDEWORK\lvmen\src\licensedcode\data\rules\openssl_2.yml", "YAML", 0, 0, 0, 9, 0, 0, 1, 10
"d:\IDEWORK\lvmen\src\licensedcode\data\rules\openssl_3.yml", "YAML", 0, 0, 0, 14, 0, 0, 1, 15
"d:\IDEWORK\lvmen\src\licensedcode\data\rules\openssl_4.yml", "YAML", 0, 0, 0, 9, 0, 0, 1, 10
"d:\IDEWORK\lvmen\src\licensedcode\data\rules\openvpn-openssl-exception_1.yml", "YAML", 0, 0, 0, 3, 0, 0, 1, 4
"d:\IDEWORK\lvmen\src\licensedcode\data\rules\openvpn-openssl-exception_2.yml", "YAML", 0, 0, 0, 3, 0, 0, 1, 4
"d:\IDEWORK\lvmen\src\licensedcode\data\rules\openvpn-openssl-exception_3.yml", "YAML", 0, 0, 0, 3, 0, 0, 1, 4
"d:\IDEWORK\lvmen\src\licensedcode\data\rules\openvpn-openssl-exception_4.yml", "YAML", 0, 0, 0, 3, 0, 0, 1, 4
"d:\IDEWORK\lvmen\src\licensedcode\data\rules\openvpn-openssl-exception_5.yml", "YAML", 0, 0, 0, 4, 0, 0, 1, 5
"d:\IDEWORK\lvmen\src\licensedcode\data\rules\openvpn-openssl-exception_url_1.yml", "YAML", 0, 0, 0, 5, 0, 0, 1, 6
"d:\IDEWORK\lvmen\src\licensedcode\data\rules\openvpn-openssl-exception_url_2.yml", "YAML", 0, 0, 0, 5, 0, 0, 1, 6
"d:\IDEWORK\lvmen\src\licensedcode\data\rules\opera-widget-1.0.yml", "YAML", 0, 0, 0, 5, 0, 0, 1, 6
"d:\IDEWORK\lvmen\src\licensedcode\data\rules\opl-1.0.yml", "YAML", 0, 0, 0, 5, 0, 0, 1, 6
"d:\IDEWORK\lvmen\src\licensedcode\data\rules\opl-1.0_1.yml", "YAML", 0, 0, 0, 4, 0, 0, 1, 5
"d:\IDEWORK\lvmen\src\licensedcode\data\rules\oracle-bcl-javaee.yml", "YAML", 0, 0, 0, 6, 0, 0, 1, 7
"d:\IDEWORK\lvmen\src\licensedcode\data\rules\oracle-bcl-javase-javafx-2012_1.yml", "YAML", 0, 0, 0, 6, 0, 0, 1, 7
"d:\IDEWORK\lvmen\src\licensedcode\data\rules\oracle-bcl-javase-javafx-2012_2.yml", "YAML", 0, 0, 0, 4, 0, 0, 1, 5
"d:\IDEWORK\lvmen\src\licensedcode\data\rules\oracle-bsd-no-nuclear_url_1.yml", "YAML", 0, 0, 0, 5, 0, 0, 1, 6
"d:\IDEWORK\lvmen\src\licensedcode\data\rules\oracle-bsd-no-nuclear_url_2.yml", "YAML", 0, 0, 0, 5, 0, 0, 1, 6
"d:\IDEWORK\lvmen\src\licensedcode\data\rules\oracle-mysql-foss-exception-2.0_1.yml", "YAML", 0, 0, 0, 5, 0, 0, 1, 6
"d:\IDEWORK\lvmen\src\licensedcode\data\rules\oracle-mysql-foss-exception-2.0_2.yml", "YAML", 0, 0, 0, 6, 0, 0, 1, 7
"d:\IDEWORK\lvmen\src\licensedcode\data\rules\oracle-mysql-foss-exception-2.0_3.yml", "YAML", 0, 0, 0, 4, 0, 0, 1, 5
"d:\IDEWORK\lvmen\src\licensedcode\data\rules\oracle-mysql-foss-exception-2.0_4.yml", "YAML", 0, 0, 0, 6, 0, 0, 1, 7
"d:\IDEWORK\lvmen\src\licensedcode\data\rules\oracle-mysql-foss-exception-2.0_5.yml", "YAML", 0, 0, 0, 4, 0, 0, 1, 5
"d:\IDEWORK\lvmen\src\licensedcode\data\rules\oracle-mysql-foss-exception-2.0_6.yml", "YAML", 0, 0, 0, 5, 0, 0, 1, 6
"d:\IDEWORK\lvmen\src\licensedcode\data\rules\oracle-openjdk-classpath-exception-2.0_1.yml", "YAML", 0, 0, 0, 4, 0, 0, 1, 5
"d:\IDEWORK\lvmen\src\licensedcode\data\rules\oracle-openjdk-classpath-exception-2.0_2.yml", "YAML", 0, 0, 0, 4, 0, 0, 1, 5
"d:\IDEWORK\lvmen\src\licensedcode\data\rules\oracle-web-sites-tou.yml", "YAML", 0, 0, 0, 6, 0, 0, 1, 7
"d:\IDEWORK\lvmen\src\licensedcode\data\rules\oreilly-notice.yml", "YAML", 0, 0, 0, 5, 0, 0, 1, 6
"d:\IDEWORK\lvmen\src\licensedcode\data\rules\oreilly-notice_1.yml", "YAML", 0, 0, 0, 4, 0, 0, 1, 5
"d:\IDEWORK\lvmen\src\licensedcode\data\rules\oset-pl-2.1_1.yml", "YAML", 0, 0, 0, 6, 0, 0, 1, 7
"d:\IDEWORK\lvmen\src\licensedcode\data\rules\oset-pl-2.1_url_1.yml", "YAML", 0, 0, 0, 5, 0, 0, 1, 6
"d:\IDEWORK\lvmen\src\licensedcode\data\rules\oset-pl-2.1_url_2.yml", "YAML", 0, 0, 0, 5, 0, 0, 1, 6
"d:\IDEWORK\lvmen\src\licensedcode\data\rules\oset-pl-2.1_url_glc_100.yml", "YAML", 0, 0, 0, 5, 0, 0, 1, 6
"d:\IDEWORK\lvmen\src\licensedcode\data\rules\oset-pl-2.1_url_glc_101.yml", "YAML", 0, 0, 0, 5, 0, 0, 1, 6
"d:\IDEWORK\lvmen\src\licensedcode\data\rules\osf-1990.yml", "YAML", 0, 0, 0, 4, 0, 0, 1, 5
"d:\IDEWORK\lvmen\src\licensedcode\data\rules\osf-1990_1.yml", "YAML", 0, 0, 0, 4, 0, 0, 1, 5
"d:\IDEWORK\lvmen\src\licensedcode\data\rules\osf-1990_2.yml", "YAML", 0, 0, 0, 2, 0, 0, 1, 3
"d:\IDEWORK\lvmen\src\licensedcode\data\rules\osf-1990_3.yml", "YAML", 0, 0, 0, 2, 0, 0, 1, 3
"d:\IDEWORK\lvmen\src\licensedcode\data\rules\osf-1990_4.yml", "YAML", 0, 0, 0, 3, 0, 0, 1, 4
"d:\IDEWORK\lvmen\src\licensedcode\data\rules\osf-1990_5.yml", "YAML", 0, 0, 0, 2, 0, 0, 1, 3
"d:\IDEWORK\lvmen\src\licensedcode\data\rules\osf-1990_6.yml", "YAML", 0, 0, 0, 4, 0, 0, 1, 5
"d:\IDEWORK\lvmen\src\licensedcode\data\rules\osf-1990_7.yml", "YAML", 0, 0, 0, 3, 0, 0, 1, 4
"d:\IDEWORK\lvmen\src\licensedcode\data\rules\osl-1.0.yml", "YAML", 0, 0, 0, 5, 0, 0, 1, 6
"d:\IDEWORK\lvmen\src\licensedcode\data\rules\osl-1.0_1.yml", "YAML", 0, 0, 0, 3, 0, 0, 1, 4
"d:\IDEWORK\lvmen\src\licensedcode\data\rules\osl-1.0_2.yml", "YAML", 0, 0, 0, 3, 0, 0, 1, 4
"d:\IDEWORK\lvmen\src\licensedcode\data\rules\osl-1.0_3.yml", "YAML", 0, 0, 0, 7, 0, 0, 1, 8
"d:\IDEWORK\lvmen\src\licensedcode\data\rules\osl-1.0_url_1.yml", "YAML", 0, 0, 0, 5, 0, 0, 1, 6
"d:\IDEWORK\lvmen\src\licensedcode\data\rules\osl-1.0_url_2.yml", "YAML", 0, 0, 0, 5, 0, 0, 1, 6
"d:\IDEWORK\lvmen\src\licensedcode\data\rules\osl-1.0_url_glc_102.yml", "YAML", 0, 0, 0, 5, 0, 0, 1, 6
"d:\IDEWORK\lvmen\src\licensedcode\data\rules\osl-1.0_url_glc_103.yml", "YAML", 0, 0, 0, 5, 0, 0, 1, 6
"d:\IDEWORK\lvmen\src\licensedcode\data\rules\osl-1.1_or_gpl-2.0_1.yml", "YAML", 0, 0, 0, 6, 0, 0, 1, 7
"d:\IDEWORK\lvmen\src\licensedcode\data\rules\osl-1.1_or_gpl-2.0_2.yml", "YAML", 0, 0, 0, 6, 0, 0, 1, 7
"d:\IDEWORK\lvmen\src\licensedcode\data\rules\osl-1.1_or_gpl-2.0_3.yml", "YAML", 0, 0, 0, 6, 0, 0, 1, 7
"d:\IDEWORK\lvmen\src\licensedcode\data\rules\osl-1.1_or_gpl-2.0_4.yml", "YAML", 0, 0, 0, 6, 0, 0, 1, 7
"d:\IDEWORK\lvmen\src\licensedcode\data\rules\osl-1.1_or_gpl-2.0_5.yml", "YAML", 0, 0, 0, 6, 0, 0, 1, 7
"d:\IDEWORK\lvmen\src\licensedcode\data\rules\osl-1.1_or_gpl-2.0_6.yml", "YAML", 0, 0, 0, 4, 0, 0, 1, 5
"d:\IDEWORK\lvmen\src\licensedcode\data\rules\osl-1.1_url_1.yml", "YAML", 0, 0, 0, 5, 0, 0, 1, 6
"d:\IDEWORK\lvmen\src\licensedcode\data\rules\osl-1.1_url_2.yml", "YAML", 0, 0, 0, 5, 0, 0, 1, 6
"d:\IDEWORK\lvmen\src\licensedcode\data\rules\osl-2.0.yml", "YAML", 0, 0, 0, 5, 0, 0, 1, 6
"d:\IDEWORK\lvmen\src\licensedcode\data\rules\osl-2.0_1.yml", "YAML", 0, 0, 0, 3, 0, 0, 1, 4
"d:\IDEWORK\lvmen\src\licensedcode\data\rules\osl-2.0_2.yml", "YAML", 0, 0, 0, 5, 0, 0, 1, 6
"d:\IDEWORK\lvmen\src\licensedcode\data\rules\osl-2.0_3.yml", "YAML", 0, 0, 0, 5, 0, 0, 1, 6
"d:\IDEWORK\lvmen\src\licensedcode\data\rules\osl-2.0_url_1.yml", "YAML", 0, 0, 0, 5, 0, 0, 1, 6
"d:\IDEWORK\lvmen\src\licensedcode\data\rules\osl-2.0_url_2.yml", "YAML", 0, 0, 0, 5, 0, 0, 1, 6
"d:\IDEWORK\lvmen\src\licensedcode\data\rules\osl-2.1.SPDX.yml", "YAML", 0, 0, 0, 8, 0, 0, 1, 9
"d:\IDEWORK\lvmen\src\licensedcode\data\rules\osl-2.1.yml", "YAML", 0, 0, 0, 5, 0, 0, 1, 6
"d:\IDEWORK\lvmen\src\licensedcode\data\rules\osl-2.1_1.yml", "YAML", 0, 0, 0, 3, 0, 0, 1, 4
"d:\IDEWORK\lvmen\src\licensedcode\data\rules\osl-2.1_2.yml", "YAML", 0, 0, 0, 5, 0, 0, 1, 6
"d:\IDEWORK\lvmen\src\licensedcode\data\rules\osl-2.1_3.yml", "YAML", 0, 0, 0, 5, 0, 0, 1, 6
"d:\IDEWORK\lvmen\src\licensedcode\data\rules\osl-2.1_url_1.yml", "YAML", 0, 0, 0, 5, 0, 0, 1, 6
"d:\IDEWORK\lvmen\src\licensedcode\data\rules\osl-2.1_url_2.yml", "YAML", 0, 0, 0, 5, 0, 0, 1, 6
"d:\IDEWORK\lvmen\src\licensedcode\data\rules\osl-2.1_url_glc_104.yml", "YAML", 0, 0, 0, 5, 0, 0, 1, 6
"d:\IDEWORK\lvmen\src\licensedcode\data\rules\osl-2.1_url_glc_105.yml", "YAML", 0, 0, 0, 5, 0, 0, 1, 6
"d:\IDEWORK\lvmen\src\licensedcode\data\rules\osl-3.0.SPDX.yml", "YAML", 0, 0, 0, 8, 0, 0, 1, 9
"d:\IDEWORK\lvmen\src\licensedcode\data\rules\osl-3.0.yml", "YAML", 0, 0, 0, 5, 0, 0, 1, 6
"d:\IDEWORK\lvmen\src\licensedcode\data\rules\osl-3.0_1.yml", "YAML", 0, 0, 0, 6, 0, 0, 1, 7
"d:\IDEWORK\lvmen\src\licensedcode\data\rules\osl-3.0_10.yml", "YAML", 0, 0, 0, 5, 0, 0, 1, 6
"d:\IDEWORK\lvmen\src\licensedcode\data\rules\osl-3.0_11.yml", "YAML", 0, 0, 0, 5, 0, 0, 1, 6
"d:\IDEWORK\lvmen\src\licensedcode\data\rules\osl-3.0_12.yml", "YAML", 0, 0, 0, 5, 0, 0, 1, 6
"d:\IDEWORK\lvmen\src\licensedcode\data\rules\osl-3.0_13.yml", "YAML", 0, 0, 0, 3, 0, 0, 1, 4
"d:\IDEWORK\lvmen\src\licensedcode\data\rules\osl-3.0_14.yml", "YAML", 0, 0, 0, 5, 0, 0, 1, 6
"d:\IDEWORK\lvmen\src\licensedcode\data\rules\osl-3.0_15.yml", "YAML", 0, 0, 0, 5, 0, 0, 1, 6
"d:\IDEWORK\lvmen\src\licensedcode\data\rules\osl-3.0_16.yml", "YAML", 0, 0, 0, 3, 0, 0, 1, 4
"d:\IDEWORK\lvmen\src\licensedcode\data\rules\osl-3.0_17.yml", "YAML", 0, 0, 0, 5, 0, 0, 1, 6
"d:\IDEWORK\lvmen\src\licensedcode\data\rules\osl-3.0_18.yml", "YAML", 0, 0, 0, 3, 0, 0, 1, 4
"d:\IDEWORK\lvmen\src\licensedcode\data\rules\osl-3.0_19.yml", "YAML", 0, 0, 0, 5, 0, 0, 1, 6
"d:\IDEWORK\lvmen\src\licensedcode\data\rules\osl-3.0_2.yml", "YAML", 0, 0, 0, 5, 0, 0, 1, 6
"d:\IDEWORK\lvmen\src\licensedcode\data\rules\osl-3.0_20.yml", "YAML", 0, 0, 0, 5, 0, 0, 1, 6
"d:\IDEWORK\lvmen\src\licensedcode\data\rules\osl-3.0_21.yml", "YAML", 0, 0, 0, 5, 0, 0, 1, 6
"d:\IDEWORK\lvmen\src\licensedcode\data\rules\osl-3.0_22.yml", "YAML", 0, 0, 0, 5, 0, 0, 1, 6
"d:\IDEWORK\lvmen\src\licensedcode\data\rules\osl-3.0_23.yml", "YAML", 0, 0, 0, 5, 0, 0, 1, 6
"d:\IDEWORK\lvmen\src\licensedcode\data\rules\osl-3.0_24.yml", "YAML", 0, 0, 0, 5, 0, 0, 1, 6
"d:\IDEWORK\lvmen\src\licensedcode\data\rules\osl-3.0_25.yml", "YAML", 0, 0, 0, 9, 0, 0, 1, 10
"d:\IDEWORK\lvmen\src\licensedcode\data\rules\osl-3.0_26.yml", "YAML", 0, 0, 0, 7, 0, 0, 1, 8
"d:\IDEWORK\lvmen\src\licensedcode\data\rules\osl-3.0_27.yml", "YAML", 0, 0, 0, 5, 0, 0, 1, 6
"d:\IDEWORK\lvmen\src\licensedcode\data\rules\osl-3.0_28.yml", "YAML", 0, 0, 0, 3, 0, 0, 1, 4
"d:\IDEWORK\lvmen\src\licensedcode\data\rules\osl-3.0_29.yml", "YAML", 0, 0, 0, 3, 0, 0, 1, 4
"d:\IDEWORK\lvmen\src\licensedcode\data\rules\osl-3.0_3.yml", "YAML", 0, 0, 0, 5, 0, 0, 1, 6
"d:\IDEWORK\lvmen\src\licensedcode\data\rules\osl-3.0_4.yml", "YAML", 0, 0, 0, 3, 0, 0, 1, 4
"d:\IDEWORK\lvmen\src\licensedcode\data\rules\osl-3.0_5.yml", "YAML", 0, 0, 0, 4, 0, 0, 1, 5
"d:\IDEWORK\lvmen\src\licensedcode\data\rules\osl-3.0_6.yml", "YAML", 0, 0, 0, 5, 0, 0, 1, 6
"d:\IDEWORK\lvmen\src\licensedcode\data\rules\osl-3.0_7.yml", "YAML", 0, 0, 0, 6, 0, 0, 1, 7
"d:\IDEWORK\lvmen\src\licensedcode\data\rules\osl-3.0_8.yml", "YAML", 0, 0, 0, 4, 0, 0, 1, 5
"d:\IDEWORK\lvmen\src\licensedcode\data\rules\osl-3.0_9.yml", "YAML", 0, 0, 0, 3, 0, 0, 1, 4
"d:\IDEWORK\lvmen\src\licensedcode\data\rules\osl-3.0_url_1.yml", "YAML", 0, 0, 0, 5, 0, 0, 1, 6
"d:\IDEWORK\lvmen\src\licensedcode\data\rules\osl-3.0_url_2.yml", "YAML", 0, 0, 0, 5, 0, 0, 1, 6
"d:\IDEWORK\lvmen\src\licensedcode\data\rules\ossn-3.0.yml", "YAML", 0, 0, 0, 5, 0, 0, 1, 6
"d:\IDEWORK\lvmen\src\licensedcode\data\rules\oswego-concurrent.yml", "YAML", 0, 0, 0, 6, 0, 0, 1, 7
"d:\IDEWORK\lvmen\src\licensedcode\data\rules\oswego-concurrent_1.yml", "YAML", 0, 0, 0, 5, 0, 0, 1, 6
"d:\IDEWORK\lvmen\src\licensedcode\data\rules\oswego-concurrent_2.yml", "YAML", 0, 0, 0, 6, 0, 0, 1, 7
"d:\IDEWORK\lvmen\src\licensedcode\data\rules\other-copyleft_1.yml", "YAML", 0, 0, 0, 2, 0, 0, 1, 3
"d:\IDEWORK\lvmen\src\licensedcode\data\rules\other-copyleft_10.yml", "YAML", 0, 0, 0, 4, 0, 0, 1, 5
"d:\IDEWORK\lvmen\src\licensedcode\data\rules\other-copyleft_11.yml", "YAML", 0, 0, 0, 3, 0, 0, 1, 4
"d:\IDEWORK\lvmen\src\licensedcode\data\rules\other-copyleft_12.yml", "YAML", 0, 0, 0, 3, 0, 0, 1, 4
"d:\IDEWORK\lvmen\src\licensedcode\data\rules\other-copyleft_13.yml", "YAML", 0, 0, 0, 3, 0, 0, 1, 4
"d:\IDEWORK\lvmen\src\licensedcode\data\rules\other-copyleft_14.yml", "YAML", 0, 0, 0, 3, 0, 0, 1, 4
"d:\IDEWORK\lvmen\src\licensedcode\data\rules\other-copyleft_15.yml", "YAML", 0, 0, 0, 3, 0, 0, 1, 4
"d:\IDEWORK\lvmen\src\licensedcode\data\rules\other-copyleft_16.yml", "YAML", 0, 0, 0, 3, 0, 0, 1, 4
"d:\IDEWORK\lvmen\src\licensedcode\data\rules\other-copyleft_17.yml", "YAML", 0, 0, 0, 5, 0, 0, 1, 6
"d:\IDEWORK\lvmen\src\licensedcode\data\rules\other-copyleft_18.yml", "YAML", 0, 0, 0, 4, 0, 0, 1, 5
"d:\IDEWORK\lvmen\src\licensedcode\data\rules\other-copyleft_19.yml", "YAML", 0, 0, 0, 4, 0, 0, 1, 5
"d:\IDEWORK\lvmen\src\licensedcode\data\rules\other-copyleft_2.yml", "YAML", 0, 0, 0, 6, 0, 0, 1, 7
"d:\IDEWORK\lvmen\src\licensedcode\data\rules\other-copyleft_20.yml", "YAML", 0, 0, 0, 5, 0, 0, 1, 6
"d:\IDEWORK\lvmen\src\licensedcode\data\rules\other-copyleft_21.yml", "YAML", 0, 0, 0, 3, 0, 0, 1, 4
"d:\IDEWORK\lvmen\src\licensedcode\data\rules\other-copyleft_22.yml", "YAML", 0, 0, 0, 3, 0, 0, 1, 4
"d:\IDEWORK\lvmen\src\licensedcode\data\rules\other-copyleft_23.yml", "YAML", 0, 0, 0, 3, 0, 0, 1, 4
"d:\IDEWORK\lvmen\src\licensedcode\data\rules\other-copyleft_24.yml", "YAML", 0, 0, 0, 3, 0, 0, 1, 4
"d:\IDEWORK\lvmen\src\licensedcode\data\rules\other-copyleft_25.yml", "YAML", 0, 0, 0, 9, 0, 0, 1, 10
"d:\IDEWORK\lvmen\src\licensedcode\data\rules\other-copyleft_26.yml", "YAML", 0, 0, 0, 3, 0, 0, 1, 4
"d:\IDEWORK\lvmen\src\licensedcode\data\rules\other-copyleft_27.yml", "YAML", 0, 0, 0, 3, 0, 0, 1, 4
"d:\IDEWORK\lvmen\src\licensedcode\data\rules\other-copyleft_28.yml", "YAML", 0, 0, 0, 3, 0, 0, 1, 4
"d:\IDEWORK\lvmen\src\licensedcode\data\rules\other-copyleft_3.yml", "YAML", 0, 0, 0, 2, 0, 0, 1, 3
"d:\IDEWORK\lvmen\src\licensedcode\data\rules\other-copyleft_4.yml", "YAML", 0, 0, 0, 3, 0, 0, 1, 4
"d:\IDEWORK\lvmen\src\licensedcode\data\rules\other-copyleft_5.yml", "YAML", 0, 0, 0, 7, 0, 0, 1, 8
"d:\IDEWORK\lvmen\src\licensedcode\data\rules\other-copyleft_6.yml", "YAML", 0, 0, 0, 7, 0, 0, 1, 8
"d:\IDEWORK\lvmen\src\licensedcode\data\rules\other-copyleft_7.yml", "YAML", 0, 0, 0, 4, 0, 0, 1, 5
"d:\IDEWORK\lvmen\src\licensedcode\data\rules\other-copyleft_8.yml", "YAML", 0, 0, 0, 9, 0, 0, 1, 10
"d:\IDEWORK\lvmen\src\licensedcode\data\rules\other-copyleft_81.yml", "YAML", 0, 0, 0, 4, 0, 0, 1, 5
"d:\IDEWORK\lvmen\src\licensedcode\data\rules\other-copyleft_9.yml", "YAML", 0, 0, 0, 5, 0, 0, 1, 6
"d:\IDEWORK\lvmen\src\licensedcode\data\rules\other-copyleft_and_other-permissive_1.yml", "YAML", 0, 0, 0, 3, 0, 0, 1, 4
"d:\IDEWORK\lvmen\src\licensedcode\data\rules\other-copyleft_and_public-domain_1.yml", "YAML", 0, 0, 0, 3, 0, 0, 1, 4
"d:\IDEWORK\lvmen\src\licensedcode\data\rules\other-copyleft_fsf_address_1.yml", "YAML", 0, 0, 0, 3, 0, 0, 1, 4
"d:\IDEWORK\lvmen\src\licensedcode\data\rules\other-copyleft_fsf_address_2.yml", "YAML", 0, 0, 0, 3, 0, 0, 1, 4
"d:\IDEWORK\lvmen\src\licensedcode\data\rules\other-copyleft_fsf_address_3.yml", "YAML", 0, 0, 0, 3, 0, 0, 1, 4
"d:\IDEWORK\lvmen\src\licensedcode\data\rules\other-copyleft_fsf_address_4.yml", "YAML", 0, 0, 0, 3, 0, 0, 1, 4
"d:\IDEWORK\lvmen\src\licensedcode\data\rules\other-copyleft_fsf_address_5.yml", "YAML", 0, 0, 0, 3, 0, 0, 1, 4
"d:\IDEWORK\lvmen\src\licensedcode\data\rules\other-copyleft_fsf_address_6.yml", "YAML", 0, 0, 0, 3, 0, 0, 1, 4
"d:\IDEWORK\lvmen\src\licensedcode\data\rules\other-permissive_0.yml", "YAML", 0, 0, 0, 3, 0, 0, 1, 4
"d:\IDEWORK\lvmen\src\licensedcode\data\rules\other-permissive_1.yml", "YAML", 0, 0, 0, 2, 0, 0, 1, 3
"d:\IDEWORK\lvmen\src\licensedcode\data\rules\other-permissive_10.yml", "YAML", 0, 0, 0, 4, 0, 0, 1, 5
"d:\IDEWORK\lvmen\src\licensedcode\data\rules\other-permissive_100.yml", "YAML", 0, 0, 0, 3, 0, 0, 1, 4
"d:\IDEWORK\lvmen\src\licensedcode\data\rules\other-permissive_101.yml", "YAML", 0, 0, 0, 3, 0, 0, 1, 4
"d:\IDEWORK\lvmen\src\licensedcode\data\rules\other-permissive_102.yml", "YAML", 0, 0, 0, 3, 0, 0, 1, 4
"d:\IDEWORK\lvmen\src\licensedcode\data\rules\other-permissive_103.yml", "YAML", 0, 0, 0, 3, 0, 0, 1, 4
"d:\IDEWORK\lvmen\src\licensedcode\data\rules\other-permissive_104.yml", "YAML", 0, 0, 0, 3, 0, 0, 1, 4
"d:\IDEWORK\lvmen\src\licensedcode\data\rules\other-permissive_105.yml", "YAML", 0, 0, 0, 3, 0, 0, 1, 4
"d:\IDEWORK\lvmen\src\licensedcode\data\rules\other-permissive_106.yml", "YAML", 0, 0, 0, 3, 0, 0, 1, 4
"d:\IDEWORK\lvmen\src\licensedcode\data\rules\other-permissive_107.yml", "YAML", 0, 0, 0, 3, 0, 0, 1, 4
"d:\IDEWORK\lvmen\src\licensedcode\data\rules\other-permissive_108.yml", "YAML", 0, 0, 0, 3, 0, 0, 1, 4
"d:\IDEWORK\lvmen\src\licensedcode\data\rules\other-permissive_109.yml", "YAML", 0, 0, 0, 3, 0, 0, 1, 4
"d:\IDEWORK\lvmen\src\licensedcode\data\rules\other-permissive_11.yml", "YAML", 0, 0, 0, 3, 0, 0, 1, 4
"d:\IDEWORK\lvmen\src\licensedcode\data\rules\other-permissive_110.yml", "YAML", 0, 0, 0, 5, 0, 0, 1, 6
"d:\IDEWORK\lvmen\src\licensedcode\data\rules\other-permissive_111.yml", "YAML", 0, 0, 0, 3, 0, 0, 1, 4
"d:\IDEWORK\lvmen\src\licensedcode\data\rules\other-permissive_112.yml", "YAML", 0, 0, 0, 5, 0, 0, 1, 6
"d:\IDEWORK\lvmen\src\licensedcode\data\rules\other-permissive_113.yml", "YAML", 0, 0, 0, 7, 0, 0, 1, 8
"d:\IDEWORK\lvmen\src\licensedcode\data\rules\other-permissive_114.yml", "YAML", 0, 0, 0, 4, 0, 0, 1, 5
"d:\IDEWORK\lvmen\src\licensedcode\data\rules\other-permissive_115.yml", "YAML", 0, 0, 0, 3, 0, 0, 1, 4
"d:\IDEWORK\lvmen\src\licensedcode\data\rules\other-permissive_116.yml", "YAML", 0, 0, 0, 3, 0, 0, 1, 4
"d:\IDEWORK\lvmen\src\licensedcode\data\rules\other-permissive_117.yml", "YAML", 0, 0, 0, 3, 0, 0, 1, 4
"d:\IDEWORK\lvmen\src\licensedcode\data\rules\other-permissive_118.yml", "YAML", 0, 0, 0, 3, 0, 0, 1, 4
"d:\IDEWORK\lvmen\src\licensedcode\data\rules\other-permissive_119.yml", "YAML", 0, 0, 0, 4, 0, 0, 1, 5
"d:\IDEWORK\lvmen\src\licensedcode\data\rules\other-permissive_12.yml", "YAML", 0, 0, 0, 3, 0, 0, 1, 4
"d:\IDEWORK\lvmen\src\licensedcode\data\rules\other-permissive_120.yml", "YAML", 0, 0, 0, 4, 0, 0, 1, 5
"d:\IDEWORK\lvmen\src\licensedcode\data\rules\other-permissive_121.yml", "YAML", 0, 0, 0, 3, 0, 0, 1, 4
"d:\IDEWORK\lvmen\src\licensedcode\data\rules\other-permissive_122.yml", "YAML", 0, 0, 0, 3, 0, 0, 1, 4
"d:\IDEWORK\lvmen\src\licensedcode\data\rules\other-permissive_123.yml", "YAML", 0, 0, 0, 3, 0, 0, 1, 4
"d:\IDEWORK\lvmen\src\licensedcode\data\rules\other-permissive_124.yml", "YAML", 0, 0, 0, 3, 0, 0, 1, 4
"d:\IDEWORK\lvmen\src\licensedcode\data\rules\other-permissive_125.yml", "YAML", 0, 0, 0, 3, 0, 0, 1, 4
"d:\IDEWORK\lvmen\src\licensedcode\data\rules\other-permissive_126.yml", "YAML", 0, 0, 0, 3, 0, 0, 1, 4
"d:\IDEWORK\lvmen\src\licensedcode\data\rules\other-permissive_127.yml", "YAML", 0, 0, 0, 3, 0, 0, 1, 4
"d:\IDEWORK\lvmen\src\licensedcode\data\rules\other-permissive_128.yml", "YAML", 0, 0, 0, 3, 0, 0, 1, 4
"d:\IDEWORK\lvmen\src\licensedcode\data\rules\other-permissive_129.yml", "YAML", 0, 0, 0, 3, 0, 0, 1, 4
"d:\IDEWORK\lvmen\src\licensedcode\data\rules\other-permissive_13.yml", "YAML", 0, 0, 0, 4, 0, 0, 1, 5
"d:\IDEWORK\lvmen\src\licensedcode\data\rules\other-permissive_130.yml", "YAML", 0, 0, 0, 3, 0, 0, 1, 4
"d:\IDEWORK\lvmen\src\licensedcode\data\rules\other-permissive_131.yml", "YAML", 0, 0, 0, 4, 0, 0, 1, 5
"d:\IDEWORK\lvmen\src\licensedcode\data\rules\other-permissive_132.yml", "YAML", 0, 0, 0, 3, 0, 0, 1, 4
"d:\IDEWORK\lvmen\src\licensedcode\data\rules\other-permissive_133.yml", "YAML", 0, 0, 0, 3, 0, 0, 1, 4
"d:\IDEWORK\lvmen\src\licensedcode\data\rules\other-permissive_134.yml", "YAML", 0, 0, 0, 3, 0, 0, 1, 4
"d:\IDEWORK\lvmen\src\licensedcode\data\rules\other-permissive_135.yml", "YAML", 0, 0, 0, 3, 0, 0, 1, 4
"d:\IDEWORK\lvmen\src\licensedcode\data\rules\other-permissive_136.yml", "YAML", 0, 0, 0, 4, 0, 0, 1, 5
"d:\IDEWORK\lvmen\src\licensedcode\data\rules\other-permissive_137.yml", "YAML", 0, 0, 0, 4, 0, 0, 1, 5
"d:\IDEWORK\lvmen\src\licensedcode\data\rules\other-permissive_138.yml", "YAML", 0, 0, 0, 3, 0, 0, 1, 4
"d:\IDEWORK\lvmen\src\licensedcode\data\rules\other-permissive_139.yml", "YAML", 0, 0, 0, 4, 0, 0, 1, 5
"d:\IDEWORK\lvmen\src\licensedcode\data\rules\other-permissive_14.yml", "YAML", 0, 0, 0, 4, 0, 0, 1, 5
"d:\IDEWORK\lvmen\src\licensedcode\data\rules\other-permissive_140.yml", "YAML", 0, 0, 0, 3, 0, 0, 1, 4
"d:\IDEWORK\lvmen\src\licensedcode\data\rules\other-permissive_141.yml", "YAML", 0, 0, 0, 3, 0, 0, 1, 4
"d:\IDEWORK\lvmen\src\licensedcode\data\rules\other-permissive_142.yml", "YAML", 0, 0, 0, 3, 0, 0, 1, 4
"d:\IDEWORK\lvmen\src\licensedcode\data\rules\other-permissive_143.yml", "YAML", 0, 0, 0, 4, 0, 0, 1, 5
"d:\IDEWORK\lvmen\src\licensedcode\data\rules\other-permissive_144.yml", "YAML", 0, 0, 0, 3, 0, 0, 1, 4
"d:\IDEWORK\lvmen\src\licensedcode\data\rules\other-permissive_145.yml", "YAML", 0, 0, 0, 3, 0, 0, 1, 4
"d:\IDEWORK\lvmen\src\licensedcode\data\rules\other-permissive_146.yml", "YAML", 0, 0, 0, 3, 0, 0, 1, 4
"d:\IDEWORK\lvmen\src\licensedcode\data\rules\other-permissive_147.yml", "YAML", 0, 0, 0, 3, 0, 0, 1, 4
"d:\IDEWORK\lvmen\src\licensedcode\data\rules\other-permissive_148.yml", "YAML", 0, 0, 0, 3, 0, 0, 1, 4
"d:\IDEWORK\lvmen\src\licensedcode\data\rules\other-permissive_149.yml", "YAML", 0, 0, 0, 5, 0, 0, 1, 6
"d:\IDEWORK\lvmen\src\licensedcode\data\rules\other-permissive_15.yml", "YAML", 0, 0, 0, 3, 0, 0, 1, 4
"d:\IDEWORK\lvmen\src\licensedcode\data\rules\other-permissive_150.yml", "YAML", 0, 0, 0, 3, 0, 0, 1, 4
"d:\IDEWORK\lvmen\src\licensedcode\data\rules\other-permissive_151.yml", "YAML", 0, 0, 0, 3, 0, 0, 1, 4
"d:\IDEWORK\lvmen\src\licensedcode\data\rules\other-permissive_152.yml", "YAML", 0, 0, 0, 3, 0, 0, 1, 4
"d:\IDEWORK\lvmen\src\licensedcode\data\rules\other-permissive_153.yml", "YAML", 0, 0, 0, 3, 0, 0, 1, 4
"d:\IDEWORK\lvmen\src\licensedcode\data\rules\other-permissive_154.yml", "YAML", 0, 0, 0, 4, 0, 0, 1, 5
"d:\IDEWORK\lvmen\src\licensedcode\data\rules\other-permissive_155.yml", "YAML", 0, 0, 0, 3, 0, 0, 1, 4
"d:\IDEWORK\lvmen\src\licensedcode\data\rules\other-permissive_156.yml", "YAML", 0, 0, 0, 3, 0, 0, 1, 4
"d:\IDEWORK\lvmen\src\licensedcode\data\rules\other-permissive_157.yml", "YAML", 0, 0, 0, 3, 0, 0, 1, 4
"d:\IDEWORK\lvmen\src\licensedcode\data\rules\other-permissive_158.yml", "YAML", 0, 0, 0, 3, 0, 0, 1, 4
"d:\IDEWORK\lvmen\src\licensedcode\data\rules\other-permissive_159.yml", "YAML", 0, 0, 0, 3, 0, 0, 1, 4
"d:\IDEWORK\lvmen\src\licensedcode\data\rules\other-permissive_16.yml", "YAML", 0, 0, 0, 3, 0, 0, 1, 4
"d:\IDEWORK\lvmen\src\licensedcode\data\rules\other-permissive_160.yml", "YAML", 0, 0, 0, 3, 0, 0, 1, 4
"d:\IDEWORK\lvmen\src\licensedcode\data\rules\other-permissive_161.yml", "YAML", 0, 0, 0, 3, 0, 0, 1, 4
"d:\IDEWORK\lvmen\src\licensedcode\data\rules\other-permissive_162.yml", "YAML", 0, 0, 0, 3, 0, 0, 1, 4
"d:\IDEWORK\lvmen\src\licensedcode\data\rules\other-permissive_163.yml", "YAML", 0, 0, 0, 3, 0, 0, 1, 4
"d:\IDEWORK\lvmen\src\licensedcode\data\rules\other-permissive_164.yml", "YAML", 0, 0, 0, 3, 0, 0, 1, 4
"d:\IDEWORK\lvmen\src\licensedcode\data\rules\other-permissive_165.yml", "YAML", 0, 0, 0, 4, 0, 0, 1, 5
"d:\IDEWORK\lvmen\src\licensedcode\data\rules\other-permissive_166.yml", "YAML", 0, 0, 0, 3, 0, 0, 1, 4
"d:\IDEWORK\lvmen\src\licensedcode\data\rules\other-permissive_167.yml", "YAML", 0, 0, 0, 3, 0, 0, 1, 4
"d:\IDEWORK\lvmen\src\licensedcode\data\rules\other-permissive_168.yml", "YAML", 0, 0, 0, 5, 0, 0, 1, 6
"d:\IDEWORK\lvmen\src\licensedcode\data\rules\other-permissive_169.yml", "YAML", 0, 0, 0, 6, 0, 0, 1, 7
"d:\IDEWORK\lvmen\src\licensedcode\data\rules\other-permissive_17.yml", "YAML", 0, 0, 0, 3, 0, 0, 1, 4
"d:\IDEWORK\lvmen\src\licensedcode\data\rules\other-permissive_170.yml", "YAML", 0, 0, 0, 7, 0, 0, 1, 8
"d:\IDEWORK\lvmen\src\licensedcode\data\rules\other-permissive_171.yml", "YAML", 0, 0, 0, 4, 0, 0, 1, 5
"d:\IDEWORK\lvmen\src\licensedcode\data\rules\other-permissive_172.yml", "YAML", 0, 0, 0, 4, 0, 0, 1, 5
"d:\IDEWORK\lvmen\src\licensedcode\data\rules\other-permissive_173.yml", "YAML", 0, 0, 0, 4, 0, 0, 1, 5
"d:\IDEWORK\lvmen\src\licensedcode\data\rules\other-permissive_174.yml", "YAML", 0, 0, 0, 4, 0, 0, 1, 5
"d:\IDEWORK\lvmen\src\licensedcode\data\rules\other-permissive_175.yml", "YAML", 0, 0, 0, 9, 0, 0, 1, 10
"d:\IDEWORK\lvmen\src\licensedcode\data\rules\other-permissive_176.yml", "YAML", 0, 0, 0, 3, 0, 0, 1, 4
"d:\IDEWORK\lvmen\src\licensedcode\data\rules\other-permissive_177.yml", "YAML", 0, 0, 0, 3, 0, 0, 1, 4
"d:\IDEWORK\lvmen\src\licensedcode\data\rules\other-permissive_178.yml", "YAML", 0, 0, 0, 5, 0, 0, 1, 6
"d:\IDEWORK\lvmen\src\licensedcode\data\rules\other-permissive_179.yml", "YAML", 0, 0, 0, 7, 0, 0, 1, 8
"d:\IDEWORK\lvmen\src\licensedcode\data\rules\other-permissive_18.yml", "YAML", 0, 0, 0, 3, 0, 0, 1, 4
"d:\IDEWORK\lvmen\src\licensedcode\data\rules\other-permissive_180.yml", "YAML", 0, 0, 0, 9, 0, 0, 1, 10
"d:\IDEWORK\lvmen\src\licensedcode\data\rules\other-permissive_181.yml", "YAML", 0, 0, 0, 9, 0, 0, 1, 10
"d:\IDEWORK\lvmen\src\licensedcode\data\rules\other-permissive_182.yml", "YAML", 0, 0, 0, 5, 0, 0, 1, 6
"d:\IDEWORK\lvmen\src\licensedcode\data\rules\other-permissive_183.yml", "YAML", 0, 0, 0, 6, 0, 0, 1, 7
"d:\IDEWORK\lvmen\src\licensedcode\data\rules\other-permissive_184.yml", "YAML", 0, 0, 0, 4, 0, 0, 1, 5
"d:\IDEWORK\lvmen\src\licensedcode\data\rules\other-permissive_185.yml", "YAML", 0, 0, 0, 4, 0, 0, 1, 5
"d:\IDEWORK\lvmen\src\licensedcode\data\rules\other-permissive_186.yml", "YAML", 0, 0, 0, 3, 0, 0, 1, 4
"d:\IDEWORK\lvmen\src\licensedcode\data\rules\other-permissive_187.yml", "YAML", 0, 0, 0, 4, 0, 0, 1, 5
"d:\IDEWORK\lvmen\src\licensedcode\data\rules\other-permissive_188.yml", "YAML", 0, 0, 0, 4, 0, 0, 1, 5
"d:\IDEWORK\lvmen\src\licensedcode\data\rules\other-permissive_189.yml", "YAML", 0, 0, 0, 4, 0, 0, 1, 5
"d:\IDEWORK\lvmen\src\licensedcode\data\rules\other-permissive_19.yml", "YAML", 0, 0, 0, 2, 0, 0, 1, 3
"d:\IDEWORK\lvmen\src\licensedcode\data\rules\other-permissive_190.yml", "YAML", 0, 0, 0, 4, 0, 0, 1, 5
"d:\IDEWORK\lvmen\src\licensedcode\data\rules\other-permissive_191.yml", "YAML", 0, 0, 0, 4, 0, 0, 1, 5
"d:\IDEWORK\lvmen\src\licensedcode\data\rules\other-permissive_192.yml", "YAML", 0, 0, 0, 4, 0, 0, 1, 5
"d:\IDEWORK\lvmen\src\licensedcode\data\rules\other-permissive_193.yml", "YAML", 0, 0, 0, 6, 0, 0, 1, 7
"d:\IDEWORK\lvmen\src\licensedcode\data\rules\other-permissive_194.yml", "YAML", 0, 0, 0, 4, 0, 0, 1, 5
"d:\IDEWORK\lvmen\src\licensedcode\data\rules\other-permissive_195.yml", "YAML", 0, 0, 0, 4, 0, 0, 1, 5
"d:\IDEWORK\lvmen\src\licensedcode\data\rules\other-permissive_196.yml", "YAML", 0, 0, 0, 4, 0, 0, 1, 5
"d:\IDEWORK\lvmen\src\licensedcode\data\rules\other-permissive_197.yml", "YAML", 0, 0, 0, 6, 0, 0, 1, 7
"d:\IDEWORK\lvmen\src\licensedcode\data\rules\other-permissive_198.yml", "YAML", 0, 0, 0, 6, 0, 0, 1, 7
"d:\IDEWORK\lvmen\src\licensedcode\data\rules\other-permissive_199.yml", "YAML", 0, 0, 0, 3, 0, 0, 1, 4
"d:\IDEWORK\lvmen\src\licensedcode\data\rules\other-permissive_2.yml", "YAML", 0, 0, 0, 4, 0, 0, 2, 6
"d:\IDEWORK\lvmen\src\licensedcode\data\rules\other-permissive_20.yml", "YAML", 0, 0, 0, 2, 0, 0, 1, 3
"d:\IDEWORK\lvmen\src\licensedcode\data\rules\other-permissive_200.yml", "YAML", 0, 0, 0, 4, 0, 0, 1, 5
"d:\IDEWORK\lvmen\src\licensedcode\data\rules\other-permissive_201.yml", "YAML", 0, 0, 0, 4, 0, 0, 1, 5
"d:\IDEWORK\lvmen\src\licensedcode\data\rules\other-permissive_202.yml", "YAML", 0, 0, 0, 4, 0, 0, 1, 5
"d:\IDEWORK\lvmen\src\licensedcode\data\rules\other-permissive_203.yml", "YAML", 0, 0, 0, 4, 0, 0, 1, 5
"d:\IDEWORK\lvmen\src\licensedcode\data\rules\other-permissive_204.yml", "YAML", 0, 0, 0, 4, 0, 0, 1, 5
"d:\IDEWORK\lvmen\src\licensedcode\data\rules\other-permissive_205.yml", "YAML", 0, 0, 0, 4, 0, 0, 1, 5
"d:\IDEWORK\lvmen\src\licensedcode\data\rules\other-permissive_206.yml", "YAML", 0, 0, 0, 4, 0, 0, 1, 5
"d:\IDEWORK\lvmen\src\licensedcode\data\rules\other-permissive_207.yml", "YAML", 0, 0, 0, 4, 0, 0, 1, 5
"d:\IDEWORK\lvmen\src\licensedcode\data\rules\other-permissive_208.yml", "YAML", 0, 0, 0, 4, 0, 0, 1, 5
"d:\IDEWORK\lvmen\src\licensedcode\data\rules\other-permissive_209.yml", "YAML", 0, 0, 0, 3, 0, 0, 0, 3
"d:\IDEWORK\lvmen\src\licensedcode\data\rules\other-permissive_21.yml", "YAML", 0, 0, 0, 4, 0, 0, 1, 5
"d:\IDEWORK\lvmen\src\licensedcode\data\rules\other-permissive_210.yml", "YAML", 0, 0, 0, 4, 0, 0, 1, 5
"d:\IDEWORK\lvmen\src\licensedcode\data\rules\other-permissive_211.yml", "YAML", 0, 0, 0, 4, 0, 0, 1, 5
"d:\IDEWORK\lvmen\src\licensedcode\data\rules\other-permissive_212.yml", "YAML", 0, 0, 0, 4, 0, 0, 1, 5
"d:\IDEWORK\lvmen\src\licensedcode\data\rules\other-permissive_213.yml", "YAML", 0, 0, 0, 6, 0, 0, 1, 7
"d:\IDEWORK\lvmen\src\licensedcode\data\rules\other-permissive_214.yml", "YAML", 0, 0, 0, 4, 0, 0, 1, 5
"d:\IDEWORK\lvmen\src\licensedcode\data\rules\other-permissive_215.yml", "YAML", 0, 0, 0, 5, 0, 0, 1, 6
"d:\IDEWORK\lvmen\src\licensedcode\data\rules\other-permissive_216.yml", "YAML", 0, 0, 0, 3, 0, 0, 1, 4
"d:\IDEWORK\lvmen\src\licensedcode\data\rules\other-permissive_217.yml", "YAML", 0, 0, 0, 4, 0, 0, 1, 5
"d:\IDEWORK\lvmen\src\licensedcode\data\rules\other-permissive_218.yml", "YAML", 0, 0, 0, 5, 0, 0, 1, 6
"d:\IDEWORK\lvmen\src\licensedcode\data\rules\other-permissive_219.yml", "YAML", 0, 0, 0, 3, 0, 0, 1, 4
"d:\IDEWORK\lvmen\src\licensedcode\data\rules\other-permissive_22.yml", "YAML", 0, 0, 0, 3, 0, 0, 1, 4
"d:\IDEWORK\lvmen\src\licensedcode\data\rules\other-permissive_220.yml", "YAML", 0, 0, 0, 3, 0, 0, 1, 4
"d:\IDEWORK\lvmen\src\licensedcode\data\rules\other-permissive_221.yml", "YAML", 0, 0, 0, 4, 0, 0, 1, 5
"d:\IDEWORK\lvmen\src\licensedcode\data\rules\other-permissive_222.yml", "YAML", 0, 0, 0, 3, 0, 0, 1, 4
"d:\IDEWORK\lvmen\src\licensedcode\data\rules\other-permissive_223.yml", "YAML", 0, 0, 0, 3, 0, 0, 1, 4
"d:\IDEWORK\lvmen\src\licensedcode\data\rules\other-permissive_224.yml", "YAML", 0, 0, 0, 3, 0, 0, 1, 4
"d:\IDEWORK\lvmen\src\licensedcode\data\rules\other-permissive_225.yml", "YAML", 0, 0, 0, 3, 0, 0, 1, 4
"d:\IDEWORK\lvmen\src\licensedcode\data\rules\other-permissive_226.yml", "YAML", 0, 0, 0, 3, 0, 0, 1, 4
"d:\IDEWORK\lvmen\src\licensedcode\data\rules\other-permissive_227.yml", "YAML", 0, 0, 0, 3, 0, 0, 1, 4
"d:\IDEWORK\lvmen\src\licensedcode\data\rules\other-permissive_228.yml", "YAML", 0, 0, 0, 3, 0, 0, 1, 4
"d:\IDEWORK\lvmen\src\licensedcode\data\rules\other-permissive_229.yml", "YAML", 0, 0, 0, 3, 0, 0, 1, 4
"d:\IDEWORK\lvmen\src\licensedcode\data\rules\other-permissive_23.yml", "YAML", 0, 0, 0, 4, 0, 0, 1, 5
"d:\IDEWORK\lvmen\src\licensedcode\data\rules\other-permissive_230.yml", "YAML", 0, 0, 0, 9, 0, 0, 1, 10
"d:\IDEWORK\lvmen\src\licensedcode\data\rules\other-permissive_231.yml", "YAML", 0, 0, 0, 4, 0, 0, 1, 5
"d:\IDEWORK\lvmen\src\licensedcode\data\rules\other-permissive_232.yml", "YAML", 0, 0, 0, 4, 0, 0, 1, 5
"d:\IDEWORK\lvmen\src\licensedcode\data\rules\other-permissive_233.yml", "YAML", 0, 0, 0, 4, 0, 0, 1, 5
"d:\IDEWORK\lvmen\src\licensedcode\data\rules\other-permissive_234.yml", "YAML", 0, 0, 0, 4, 0, 0, 1, 5
"d:\IDEWORK\lvmen\src\licensedcode\data\rules\other-permissive_235.yml", "YAML", 0, 0, 0, 4, 0, 0, 1, 5
"d:\IDEWORK\lvmen\src\licensedcode\data\rules\other-permissive_236.yml", "YAML", 0, 0, 0, 6, 0, 0, 1, 7
"d:\IDEWORK\lvmen\src\licensedcode\data\rules\other-permissive_237.yml", "YAML", 0, 0, 0, 6, 0, 0, 1, 7
"d:\IDEWORK\lvmen\src\licensedcode\data\rules\other-permissive_238.yml", "YAML", 0, 0, 0, 6, 0, 0, 1, 7
"d:\IDEWORK\lvmen\src\licensedcode\data\rules\other-permissive_239.yml", "YAML", 0, 0, 0, 6, 0, 0, 1, 7
"d:\IDEWORK\lvmen\src\licensedcode\data\rules\other-permissive_24.yml", "YAML", 0, 0, 0, 3, 0, 0, 1, 4
"d:\IDEWORK\lvmen\src\licensedcode\data\rules\other-permissive_240.yml", "YAML", 0, 0, 0, 4, 0, 0, 1, 5
"d:\IDEWORK\lvmen\src\licensedcode\data\rules\other-permissive_241.yml", "YAML", 0, 0, 0, 4, 0, 0, 1, 5
"d:\IDEWORK\lvmen\src\licensedcode\data\rules\other-permissive_242.yml", "YAML", 0, 0, 0, 4, 0, 0, 1, 5
"d:\IDEWORK\lvmen\src\licensedcode\data\rules\other-permissive_243.yml", "YAML", 0, 0, 0, 4, 0, 0, 1, 5
"d:\IDEWORK\lvmen\src\licensedcode\data\rules\other-permissive_244.yml", "YAML", 0, 0, 0, 4, 0, 0, 1, 5
"d:\IDEWORK\lvmen\src\licensedcode\data\rules\other-permissive_245.yml", "YAML", 0, 0, 0, 4, 0, 0, 1, 5
"d:\IDEWORK\lvmen\src\licensedcode\data\rules\other-permissive_246.yml", "YAML", 0, 0, 0, 5, 0, 0, 1, 6
"d:\IDEWORK\lvmen\src\licensedcode\data\rules\other-permissive_247.yml", "YAML", 0, 0, 0, 7, 0, 0, 1, 8
"d:\IDEWORK\lvmen\src\licensedcode\data\rules\other-permissive_248.yml", "YAML", 0, 0, 0, 4, 0, 0, 1, 5
"d:\IDEWORK\lvmen\src\licensedcode\data\rules\other-permissive_249.yml", "YAML", 0, 0, 0, 4, 0, 0, 1, 5
"d:\IDEWORK\lvmen\src\licensedcode\data\rules\other-permissive_25.yml", "YAML", 0, 0, 0, 2, 0, 0, 1, 3
"d:\IDEWORK\lvmen\src\licensedcode\data\rules\other-permissive_250.yml", "YAML", 0, 0, 0, 4, 0, 0, 1, 5
"d:\IDEWORK\lvmen\src\licensedcode\data\rules\other-permissive_251.yml", "YAML", 0, 0, 0, 4, 0, 0, 1, 5
"d:\IDEWORK\lvmen\src\licensedcode\data\rules\other-permissive_252.yml", "YAML", 0, 0, 0, 3, 0, 0, 1, 4
"d:\IDEWORK\lvmen\src\licensedcode\data\rules\other-permissive_253.yml", "YAML", 0, 0, 0, 3, 0, 0, 1, 4
"d:\IDEWORK\lvmen\src\licensedcode\data\rules\other-permissive_254.yml", "YAML", 0, 0, 0, 3, 0, 0, 1, 4
"d:\IDEWORK\lvmen\src\licensedcode\data\rules\other-permissive_255.yml", "YAML", 0, 0, 0, 4, 0, 0, 1, 5
"d:\IDEWORK\lvmen\src\licensedcode\data\rules\other-permissive_256.yml", "YAML", 0, 0, 0, 4, 0, 0, 1, 5
"d:\IDEWORK\lvmen\src\licensedcode\data\rules\other-permissive_257.yml", "YAML", 0, 0, 0, 4, 0, 0, 1, 5
"d:\IDEWORK\lvmen\src\licensedcode\data\rules\other-permissive_258.yml", "YAML", 0, 0, 0, 4, 0, 0, 1, 5
"d:\IDEWORK\lvmen\src\licensedcode\data\rules\other-permissive_259.yml", "YAML", 0, 0, 0, 4, 0, 0, 1, 5
"d:\IDEWORK\lvmen\src\licensedcode\data\rules\other-permissive_26.yml", "YAML", 0, 0, 0, 3, 0, 0, 1, 4
"d:\IDEWORK\lvmen\src\licensedcode\data\rules\other-permissive_260.yml", "YAML", 0, 0, 0, 4, 0, 0, 1, 5
"d:\IDEWORK\lvmen\src\licensedcode\data\rules\other-permissive_261.yml", "YAML", 0, 0, 0, 4, 0, 0, 1, 5
"d:\IDEWORK\lvmen\src\licensedcode\data\rules\other-permissive_262.yml", "YAML", 0, 0, 0, 4, 0, 0, 1, 5
"d:\IDEWORK\lvmen\src\licensedcode\data\rules\other-permissive_263.yml", "YAML", 0, 0, 0, 4, 0, 0, 1, 5
"d:\IDEWORK\lvmen\src\licensedcode\data\rules\other-permissive_264.yml", "YAML", 0, 0, 0, 5, 0, 0, 1, 6
"d:\IDEWORK\lvmen\src\licensedcode\data\rules\other-permissive_265.yml", "YAML", 0, 0, 0, 3, 0, 0, 1, 4
"d:\IDEWORK\lvmen\src\licensedcode\data\rules\other-permissive_266.yml", "YAML", 0, 0, 0, 4, 0, 0, 1, 5
"d:\IDEWORK\lvmen\src\licensedcode\data\rules\other-permissive_267.yml", "YAML", 0, 0, 0, 4, 0, 0, 1, 5
"d:\IDEWORK\lvmen\src\licensedcode\data\rules\other-permissive_268.yml", "YAML", 0, 0, 0, 4, 0, 0, 1, 5
"d:\IDEWORK\lvmen\src\licensedcode\data\rules\other-permissive_269.yml", "YAML", 0, 0, 0, 4, 0, 0, 1, 5
"d:\IDEWORK\lvmen\src\licensedcode\data\rules\other-permissive_27.yml", "YAML", 0, 0, 0, 3, 0, 0, 1, 4
"d:\IDEWORK\lvmen\src\licensedcode\data\rules\other-permissive_270.yml", "YAML", 0, 0, 0, 4, 0, 0, 1, 5
"d:\IDEWORK\lvmen\src\licensedcode\data\rules\other-permissive_271.yml", "YAML", 0, 0, 0, 3, 0, 0, 1, 4
"d:\IDEWORK\lvmen\src\licensedcode\data\rules\other-permissive_272.yml", "YAML", 0, 0, 0, 3, 0, 0, 1, 4
"d:\IDEWORK\lvmen\src\licensedcode\data\rules\other-permissive_273.yml", "YAML", 0, 0, 0, 3, 0, 0, 1, 4
"d:\IDEWORK\lvmen\src\licensedcode\data\rules\other-permissive_274.yml", "YAML", 0, 0, 0, 3, 0, 0, 1, 4
"d:\IDEWORK\lvmen\src\licensedcode\data\rules\other-permissive_275.yml", "YAML", 0, 0, 0, 5, 0, 0, 1, 6
"d:\IDEWORK\lvmen\src\licensedcode\data\rules\other-permissive_276.yml", "YAML", 0, 0, 0, 7, 0, 0, 1, 8
"d:\IDEWORK\lvmen\src\licensedcode\data\rules\other-permissive_277.yml", "YAML", 0, 0, 0, 4, 0, 0, 1, 5
"d:\IDEWORK\lvmen\src\licensedcode\data\rules\other-permissive_278.yml", "YAML", 0, 0, 0, 3, 0, 0, 1, 4
"d:\IDEWORK\lvmen\src\licensedcode\data\rules\other-permissive_279.yml", "YAML", 0, 0, 0, 4, 0, 0, 1, 5
"d:\IDEWORK\lvmen\src\licensedcode\data\rules\other-permissive_28.yml", "YAML", 0, 0, 0, 3, 0, 0, 1, 4
"d:\IDEWORK\lvmen\src\licensedcode\data\rules\other-permissive_280.yml", "YAML", 0, 0, 0, 6, 0, 0, 1, 7
"d:\IDEWORK\lvmen\src\licensedcode\data\rules\other-permissive_281.yml", "YAML", 0, 0, 0, 2, 0, 0, 1, 3
"d:\IDEWORK\lvmen\src\licensedcode\data\rules\other-permissive_282.yml", "YAML", 0, 0, 0, 7, 0, 0, 2, 9
"d:\IDEWORK\lvmen\src\licensedcode\data\rules\other-permissive_283.yml", "YAML", 0, 0, 0, 4, 0, 0, 1, 5
"d:\IDEWORK\lvmen\src\licensedcode\data\rules\other-permissive_284.yml", "YAML", 0, 0, 0, 4, 0, 0, 1, 5
"d:\IDEWORK\lvmen\src\licensedcode\data\rules\other-permissive_285.yml", "YAML", 0, 0, 0, 4, 0, 0, 1, 5
"d:\IDEWORK\lvmen\src\licensedcode\data\rules\other-permissive_286.yml", "YAML", 0, 0, 0, 7, 0, 0, 1, 8
"d:\IDEWORK\lvmen\src\licensedcode\data\rules\other-permissive_287.yml", "YAML", 0, 0, 0, 4, 0, 0, 1, 5
"d:\IDEWORK\lvmen\src\licensedcode\data\rules\other-permissive_288.yml", "YAML", 0, 0, 0, 4, 0, 0, 1, 5
"d:\IDEWORK\lvmen\src\licensedcode\data\rules\other-permissive_289.yml", "YAML", 0, 0, 0, 6, 0, 0, 1, 7
"d:\IDEWORK\lvmen\src\licensedcode\data\rules\other-permissive_29.yml", "YAML", 0, 0, 0, 3, 0, 0, 1, 4
"d:\IDEWORK\lvmen\src\licensedcode\data\rules\other-permissive_290.yml", "YAML", 0, 0, 0, 3, 0, 0, 1, 4
"d:\IDEWORK\lvmen\src\licensedcode\data\rules\other-permissive_291.yml", "YAML", 0, 0, 0, 2, 0, 0, 1, 3
"d:\IDEWORK\lvmen\src\licensedcode\data\rules\other-permissive_292.yml", "YAML", 0, 0, 0, 3, 0, 0, 1, 4
"d:\IDEWORK\lvmen\src\licensedcode\data\rules\other-permissive_293.yml", "YAML", 0, 0, 0, 3, 0, 0, 1, 4
"d:\IDEWORK\lvmen\src\licensedcode\data\rules\other-permissive_294.yml", "YAML", 0, 0, 0, 5, 0, 0, 1, 6
"d:\IDEWORK\lvmen\src\licensedcode\data\rules\other-permissive_295.yml", "YAML", 0, 0, 0, 3, 0, 0, 1, 4
"d:\IDEWORK\lvmen\src\licensedcode\data\rules\other-permissive_296.yml", "YAML", 0, 0, 0, 5, 0, 0, 1, 6
"d:\IDEWORK\lvmen\src\licensedcode\data\rules\other-permissive_297.yml", "YAML", 0, 0, 0, 4, 0, 0, 1, 5
"d:\IDEWORK\lvmen\src\licensedcode\data\rules\other-permissive_298.yml", "YAML", 0, 0, 0, 3, 0, 0, 1, 4
"d:\IDEWORK\lvmen\src\licensedcode\data\rules\other-permissive_299.yml", "YAML", 0, 0, 0, 3, 0, 0, 1, 4
"d:\IDEWORK\lvmen\src\licensedcode\data\rules\other-permissive_3.yml", "YAML", 0, 0, 0, 2, 0, 0, 1, 3
"d:\IDEWORK\lvmen\src\licensedcode\data\rules\other-permissive_30.yml", "YAML", 0, 0, 0, 3, 0, 0, 1, 4
"d:\IDEWORK\lvmen\src\licensedcode\data\rules\other-permissive_300.yml", "YAML", 0, 0, 0, 3, 0, 0, 1, 4
"d:\IDEWORK\lvmen\src\licensedcode\data\rules\other-permissive_301.yml", "YAML", 0, 0, 0, 3, 0, 0, 1, 4
"d:\IDEWORK\lvmen\src\licensedcode\data\rules\other-permissive_302.yml", "YAML", 0, 0, 0, 3, 0, 0, 1, 4
"d:\IDEWORK\lvmen\src\licensedcode\data\rules\other-permissive_303.yml", "YAML", 0, 0, 0, 3, 0, 0, 1, 4
"d:\IDEWORK\lvmen\src\licensedcode\data\rules\other-permissive_304.yml", "YAML", 0, 0, 0, 3, 0, 0, 1, 4
"d:\IDEWORK\lvmen\src\licensedcode\data\rules\other-permissive_305.yml", "YAML", 0, 0, 0, 3, 0, 0, 1, 4
"d:\IDEWORK\lvmen\src\licensedcode\data\rules\other-permissive_306.yml", "YAML", 0, 0, 0, 3, 0, 0, 1, 4
"d:\IDEWORK\lvmen\src\licensedcode\data\rules\other-permissive_307.yml", "YAML", 0, 0, 0, 3, 0, 0, 1, 4
"d:\IDEWORK\lvmen\src\licensedcode\data\rules\other-permissive_308.yml", "YAML", 0, 0, 0, 3, 0, 0, 1, 4
"d:\IDEWORK\lvmen\src\licensedcode\data\rules\other-permissive_309.yml", "YAML", 0, 0, 0, 9, 0, 0, 1, 10
"d:\IDEWORK\lvmen\src\licensedcode\data\rules\other-permissive_31.yml", "YAML", 0, 0, 0, 2, 0, 0, 1, 3
"d:\IDEWORK\lvmen\src\licensedcode\data\rules\other-permissive_310.yml", "YAML", 0, 0, 0, 3, 0, 0, 1, 4
"d:\IDEWORK\lvmen\src\licensedcode\data\rules\other-permissive_311.yml", "YAML", 0, 0, 0, 2, 0, 0, 1, 3
"d:\IDEWORK\lvmen\src\licensedcode\data\rules\other-permissive_312.yml", "YAML", 0, 0, 0, 3, 0, 0, 1, 4
"d:\IDEWORK\lvmen\src\licensedcode\data\rules\other-permissive_313.yml", "YAML", 0, 0, 0, 2, 0, 0, 1, 3
"d:\IDEWORK\lvmen\src\licensedcode\data\rules\other-permissive_314.yml", "YAML", 0, 0, 0, 3, 0, 0, 1, 4
"d:\IDEWORK\lvmen\src\licensedcode\data\rules\other-permissive_315.yml", "YAML", 0, 0, 0, 3, 0, 0, 1, 4
"d:\IDEWORK\lvmen\src\licensedcode\data\rules\other-permissive_316.yml", "YAML", 0, 0, 0, 3, 0, 0, 1, 4
"d:\IDEWORK\lvmen\src\licensedcode\data\rules\other-permissive_317.yml", "YAML", 0, 0, 0, 3, 0, 0, 1, 4
"d:\IDEWORK\lvmen\src\licensedcode\data\rules\other-permissive_318.yml", "YAML", 0, 0, 0, 3, 0, 0, 1, 4
"d:\IDEWORK\lvmen\src\licensedcode\data\rules\other-permissive_319.yml", "YAML", 0, 0, 0, 3, 0, 0, 1, 4
"d:\IDEWORK\lvmen\src\licensedcode\data\rules\other-permissive_32.yml", "YAML", 0, 0, 0, 2, 0, 0, 1, 3
"d:\IDEWORK\lvmen\src\licensedcode\data\rules\other-permissive_320.yml", "YAML", 0, 0, 0, 2, 0, 0, 1, 3
"d:\IDEWORK\lvmen\src\licensedcode\data\rules\other-permissive_321.yml", "YAML", 0, 0, 0, 3, 0, 0, 1, 4
"d:\IDEWORK\lvmen\src\licensedcode\data\rules\other-permissive_322.yml", "YAML", 0, 0, 0, 3, 0, 0, 1, 4
"d:\IDEWORK\lvmen\src\licensedcode\data\rules\other-permissive_323.yml", "YAML", 0, 0, 0, 2, 0, 0, 1, 3
"d:\IDEWORK\lvmen\src\licensedcode\data\rules\other-permissive_324.yml", "YAML", 0, 0, 0, 3, 0, 0, 1, 4
"d:\IDEWORK\lvmen\src\licensedcode\data\rules\other-permissive_325.yml", "YAML", 0, 0, 0, 3, 0, 0, 1, 4
"d:\IDEWORK\lvmen\src\licensedcode\data\rules\other-permissive_326.yml", "YAML", 0, 0, 0, 3, 0, 0, 1, 4
"d:\IDEWORK\lvmen\src\licensedcode\data\rules\other-permissive_327.yml", "YAML", 0, 0, 0, 3, 0, 0, 1, 4
"d:\IDEWORK\lvmen\src\licensedcode\data\rules\other-permissive_328.yml", "YAML", 0, 0, 0, 3, 0, 0, 1, 4
"d:\IDEWORK\lvmen\src\licensedcode\data\rules\other-permissive_33.yml", "YAML", 0, 0, 0, 2, 0, 0, 1, 3
"d:\IDEWORK\lvmen\src\licensedcode\data\rules\other-permissive_34.yml", "YAML", 0, 0, 0, 3, 0, 0, 1, 4
"d:\IDEWORK\lvmen\src\licensedcode\data\rules\other-permissive_35.yml", "YAML", 0, 0, 0, 3, 0, 0, 1, 4
"d:\IDEWORK\lvmen\src\licensedcode\data\rules\other-permissive_357.yml", "YAML", 0, 0, 0, 3, 0, 0, 1, 4
"d:\IDEWORK\lvmen\src\licensedcode\data\rules\other-permissive_358.yml", "YAML", 0, 0, 0, 2, 0, 0, 1, 3
"d:\IDEWORK\lvmen\src\licensedcode\data\rules\other-permissive_36.yml", "YAML", 0, 0, 0, 2, 0, 0, 1, 3
"d:\IDEWORK\lvmen\src\licensedcode\data\rules\other-permissive_37.yml", "YAML", 0, 0, 0, 4, 0, 0, 1, 5
"d:\IDEWORK\lvmen\src\licensedcode\data\rules\other-permissive_38.yml", "YAML", 0, 0, 0, 3, 0, 0, 1, 4
"d:\IDEWORK\lvmen\src\licensedcode\data\rules\other-permissive_39.yml", "YAML", 0, 0, 0, 2, 0, 0, 1, 3
"d:\IDEWORK\lvmen\src\licensedcode\data\rules\other-permissive_4.yml", "YAML", 0, 0, 0, 5, 0, 0, 1, 6
"d:\IDEWORK\lvmen\src\licensedcode\data\rules\other-permissive_40.yml", "YAML", 0, 0, 0, 3, 0, 0, 1, 4
"d:\IDEWORK\lvmen\src\licensedcode\data\rules\other-permissive_41.yml", "YAML", 0, 0, 0, 3, 0, 0, 1, 4
"d:\IDEWORK\lvmen\src\licensedcode\data\rules\other-permissive_42.yml", "YAML", 0, 0, 0, 2, 0, 0, 1, 3
"d:\IDEWORK\lvmen\src\licensedcode\data\rules\other-permissive_43.yml", "YAML", 0, 0, 0, 3, 0, 0, 1, 4
"d:\IDEWORK\lvmen\src\licensedcode\data\rules\other-permissive_44.yml", "YAML", 0, 0, 0, 2, 0, 0, 1, 3
"d:\IDEWORK\lvmen\src\licensedcode\data\rules\other-permissive_45.yml", "YAML", 0, 0, 0, 2, 0, 0, 1, 3
"d:\IDEWORK\lvmen\src\licensedcode\data\rules\other-permissive_46.yml", "YAML", 0, 0, 0, 2, 0, 0, 1, 3
"d:\IDEWORK\lvmen\src\licensedcode\data\rules\other-permissive_47.yml", "YAML", 0, 0, 0, 3, 0, 0, 1, 4
"d:\IDEWORK\lvmen\src\licensedcode\data\rules\other-permissive_48.yml", "YAML", 0, 0, 0, 3, 0, 0, 1, 4
"d:\IDEWORK\lvmen\src\licensedcode\data\rules\other-permissive_49.yml", "YAML", 0, 0, 0, 4, 0, 0, 1, 5
"d:\IDEWORK\lvmen\src\licensedcode\data\rules\other-permissive_5.yml", "YAML", 0, 0, 0, 2, 0, 0, 1, 3
"d:\IDEWORK\lvmen\src\licensedcode\data\rules\other-permissive_50.yml", "YAML", 0, 0, 0, 3, 0, 0, 1, 4
"d:\IDEWORK\lvmen\src\licensedcode\data\rules\other-permissive_51.yml", "YAML", 0, 0, 0, 3, 0, 0, 1, 4
"d:\IDEWORK\lvmen\src\licensedcode\data\rules\other-permissive_52.yml", "YAML", 0, 0, 0, 3, 0, 0, 1, 4
"d:\IDEWORK\lvmen\src\licensedcode\data\rules\other-permissive_53.yml", "YAML", 0, 0, 0, 3, 0, 0, 1, 4
"d:\IDEWORK\lvmen\src\licensedcode\data\rules\other-permissive_54.yml", "YAML", 0, 0, 0, 3, 0, 0, 1, 4
"d:\IDEWORK\lvmen\src\licensedcode\data\rules\other-permissive_55.yml", "YAML", 0, 0, 0, 3, 0, 0, 1, 4
"d:\IDEWORK\lvmen\src\licensedcode\data\rules\other-permissive_56.yml", "YAML", 0, 0, 0, 3, 0, 0, 1, 4
"d:\IDEWORK\lvmen\src\licensedcode\data\rules\other-permissive_57.yml", "YAML", 0, 0, 0, 4, 0, 0, 1, 5
"d:\IDEWORK\lvmen\src\licensedcode\data\rules\other-permissive_58.yml", "YAML", 0, 0, 0, 4, 0, 0, 1, 5
"d:\IDEWORK\lvmen\src\licensedcode\data\rules\other-permissive_59.yml", "YAML", 0, 0, 0, 3, 0, 0, 1, 4
"d:\IDEWORK\lvmen\src\licensedcode\data\rules\other-permissive_6.yml", "YAML", 0, 0, 0, 3, 0, 0, 1, 4
"d:\IDEWORK\lvmen\src\licensedcode\data\rules\other-permissive_60.yml", "YAML", 0, 0, 0, 3, 0, 0, 1, 4
"d:\IDEWORK\lvmen\src\licensedcode\data\rules\other-permissive_61.yml", "YAML", 0, 0, 0, 3, 0, 0, 1, 4
"d:\IDEWORK\lvmen\src\licensedcode\data\rules\other-permissive_62.yml", "YAML", 0, 0, 0, 3, 0, 0, 1, 4
"d:\IDEWORK\lvmen\src\licensedcode\data\rules\other-permissive_63.yml", "YAML", 0, 0, 0, 2, 0, 0, 1, 3
"d:\IDEWORK\lvmen\src\licensedcode\data\rules\other-permissive_64.yml", "YAML", 0, 0, 0, 2, 0, 0, 1, 3
"d:\IDEWORK\lvmen\src\licensedcode\data\rules\other-permissive_65.yml", "YAML", 0, 0, 0, 7, 0, 0, 1, 8
"d:\IDEWORK\lvmen\src\licensedcode\data\rules\other-permissive_66.yml", "YAML", 0, 0, 0, 3, 0, 0, 1, 4
"d:\IDEWORK\lvmen\src\licensedcode\data\rules\other-permissive_67.yml", "YAML", 0, 0, 0, 3, 0, 0, 1, 4
"d:\IDEWORK\lvmen\src\licensedcode\data\rules\other-permissive_68.yml", "YAML", 0, 0, 0, 3, 0, 0, 1, 4
"d:\IDEWORK\lvmen\src\licensedcode\data\rules\other-permissive_69.yml", "YAML", 0, 0, 0, 3, 0, 0, 1, 4
"d:\IDEWORK\lvmen\src\licensedcode\data\rules\other-permissive_7.yml", "YAML", 0, 0, 0, 4, 0, 0, 1, 5
"d:\IDEWORK\lvmen\src\licensedcode\data\rules\other-permissive_70.yml", "YAML", 0, 0, 0, 2, 0, 0, 1, 3
"d:\IDEWORK\lvmen\src\licensedcode\data\rules\other-permissive_71.yml", "YAML", 0, 0, 0, 3, 0, 0, 1, 4
"d:\IDEWORK\lvmen\src\licensedcode\data\rules\other-permissive_72.yml", "YAML", 0, 0, 0, 4, 0, 0, 1, 5
"d:\IDEWORK\lvmen\src\licensedcode\data\rules\other-permissive_73.yml", "YAML", 0, 0, 0, 3, 0, 0, 1, 4
"d:\IDEWORK\lvmen\src\licensedcode\data\rules\other-permissive_74.yml", "YAML", 0, 0, 0, 4, 0, 0, 1, 5
"d:\IDEWORK\lvmen\src\licensedcode\data\rules\other-permissive_75.yml", "YAML", 0, 0, 0, 2, 0, 0, 1, 3
"d:\IDEWORK\lvmen\src\licensedcode\data\rules\other-permissive_76.yml", "YAML", 0, 0, 0, 3, 0, 0, 1, 4
"d:\IDEWORK\lvmen\src\licensedcode\data\rules\other-permissive_77.yml", "YAML", 0, 0, 0, 4, 0, 0, 1, 5
"d:\IDEWORK\lvmen\src\licensedcode\data\rules\other-permissive_78.yml", "YAML", 0, 0, 0, 4, 0, 0, 1, 5
"d:\IDEWORK\lvmen\src\licensedcode\data\rules\other-permissive_79.yml", "YAML", 0, 0, 0, 3, 0, 0, 1, 4
"d:\IDEWORK\lvmen\src\licensedcode\data\rules\other-permissive_8.yml", "YAML", 0, 0, 0, 6, 0, 0, 1, 7
"d:\IDEWORK\lvmen\src\licensedcode\data\rules\other-permissive_80.yml", "YAML", 0, 0, 0, 9, 0, 0, 1, 10
"d:\IDEWORK\lvmen\src\licensedcode\data\rules\other-permissive_81.yml", "YAML", 0, 0, 0, 3, 0, 0, 1, 4
"d:\IDEWORK\lvmen\src\licensedcode\data\rules\other-permissive_82.yml", "YAML", 0, 0, 0, 3, 0, 0, 1, 4
"d:\IDEWORK\lvmen\src\licensedcode\data\rules\other-permissive_83.yml", "YAML", 0, 0, 0, 9, 0, 0, 1, 10
"d:\IDEWORK\lvmen\src\licensedcode\data\rules\other-permissive_84.yml", "YAML", 0, 0, 0, 3, 0, 0, 1, 4
"d:\IDEWORK\lvmen\src\licensedcode\data\rules\other-permissive_85.yml", "YAML", 0, 0, 0, 5, 0, 0, 1, 6
"d:\IDEWORK\lvmen\src\licensedcode\data\rules\other-permissive_86.yml", "YAML", 0, 0, 0, 6, 0, 0, 1, 7
"d:\IDEWORK\lvmen\src\licensedcode\data\rules\other-permissive_87.yml", "YAML", 0, 0, 0, 8, 0, 0, 1, 9
"d:\IDEWORK\lvmen\src\licensedcode\data\rules\other-permissive_88.yml", "YAML", 0, 0, 0, 3, 0, 0, 1, 4
"d:\IDEWORK\lvmen\src\licensedcode\data\rules\other-permissive_89.yml", "YAML", 0, 0, 0, 4, 0, 0, 1, 5
"d:\IDEWORK\lvmen\src\licensedcode\data\rules\other-permissive_9.yml", "YAML", 0, 0, 0, 6, 0, 0, 1, 7
"d:\IDEWORK\lvmen\src\licensedcode\data\rules\other-permissive_90.yml", "YAML", 0, 0, 0, 3, 0, 0, 1, 4
"d:\IDEWORK\lvmen\src\licensedcode\data\rules\other-permissive_91.yml", "YAML", 0, 0, 0, 3, 0, 0, 1, 4
"d:\IDEWORK\lvmen\src\licensedcode\data\rules\other-permissive_92.yml", "YAML", 0, 0, 0, 3, 0, 0, 1, 4
"d:\IDEWORK\lvmen\src\licensedcode\data\rules\other-permissive_93.yml", "YAML", 0, 0, 0, 2, 0, 0, 1, 3
"d:\IDEWORK\lvmen\src\licensedcode\data\rules\other-permissive_94.yml", "YAML", 0, 0, 0, 2, 0, 0, 1, 3
"d:\IDEWORK\lvmen\src\licensedcode\data\rules\other-permissive_95.yml", "YAML", 0, 0, 0, 3, 0, 0, 1, 4
"d:\IDEWORK\lvmen\src\licensedcode\data\rules\other-permissive_96.yml", "YAML", 0, 0, 0, 6, 0, 0, 1, 7
"d:\IDEWORK\lvmen\src\licensedcode\data\rules\other-permissive_97.yml", "YAML", 0, 0, 0, 3, 0, 0, 1, 4
"d:\IDEWORK\lvmen\src\licensedcode\data\rules\other-permissive_98.yml", "YAML", 0, 0, 0, 3, 0, 0, 1, 4
"d:\IDEWORK\lvmen\src\licensedcode\data\rules\other-permissive_99.yml", "YAML", 0, 0, 0, 3, 0, 0, 1, 4
"d:\IDEWORK\lvmen\src\licensedcode\data\rules\other-permissive_adobe.yml", "YAML", 0, 0, 0, 2, 0, 0, 1, 3
"d:\IDEWORK\lvmen\src\licensedcode\data\rules\other-permissive_and_free-unknown_1.yml", "YAML", 0, 0, 0, 4, 0, 0, 1, 5
"d:\IDEWORK\lvmen\src\licensedcode\data\rules\other-permissive_and_free-unknown_2.yml", "YAML", 0, 0, 0, 4, 0, 0, 1, 5
"d:\IDEWORK\lvmen\src\licensedcode\data\rules\other-permissive_and_free-unknown_87.yml", "YAML", 0, 0, 0, 2, 0, 0, 1, 3
"d:\IDEWORK\lvmen\src\licensedcode\data\rules\other-permissive_and_ietf_1.yml", "YAML", 0, 0, 0, 2, 0, 0, 1, 3
"d:\IDEWORK\lvmen\src\licensedcode\data\rules\other-permissive_and_info-zip-2009-01_1.yml", "YAML", 0, 0, 0, 4, 0, 0, 1, 5
"d:\IDEWORK\lvmen\src\licensedcode\data\rules\other-permissive_and_lgpl-2.0-plus_and_gpl-1.0-plus_1.yml", "YAML", 0, 0, 0, 3, 0, 0, 1, 4
"d:\IDEWORK\lvmen\src\licensedcode\data\rules\other-permissive_and_other-copyleft_1.yml", "YAML", 0, 0, 0, 3, 0, 0, 1, 4
"d:\IDEWORK\lvmen\src\licensedcode\data\rules\other-permissive_and_other-copyleft_2.yml", "YAML", 0, 0, 0, 3, 0, 0, 1, 4
"d:\IDEWORK\lvmen\src\licensedcode\data\rules\other-permissive_and_other-copyleft_3.yml", "YAML", 0, 0, 0, 2, 0, 0, 1, 3
"d:\IDEWORK\lvmen\src\licensedcode\data\rules\other-permissive_and_other-copyleft_4.yml", "YAML", 0, 0, 0, 3, 0, 0, 1, 4
"d:\IDEWORK\lvmen\src\licensedcode\data\rules\other-permissive_and_public-domain_1.yml", "YAML", 0, 0, 0, 4, 0, 0, 1, 5
"d:\IDEWORK\lvmen\src\licensedcode\data\rules\other-permissive_bitstream_2.yml", "YAML", 0, 0, 0, 2, 0, 0, 1, 3
"d:\IDEWORK\lvmen\src\licensedcode\data\rules\other-permissive_bsdish_1.yml", "YAML", 0, 0, 0, 2, 0, 0, 1, 3
"d:\IDEWORK\lvmen\src\licensedcode\data\rules\other-permissive_bsdish_2.yml", "YAML", 0, 0, 0, 2, 0, 0, 1, 3
"d:\IDEWORK\lvmen\src\licensedcode\data\rules\other-permissive_cern.yml", "YAML", 0, 0, 0, 3, 0, 0, 1, 4
"d:\IDEWORK\lvmen\src\licensedcode\data\rules\other-permissive_colamd.yml", "YAML", 0, 0, 0, 3, 0, 0, 1, 4
"d:\IDEWORK\lvmen\src\licensedcode\data\rules\other-permissive_deb1.yml", "YAML", 0, 0, 0, 2, 0, 0, 1, 3
"d:\IDEWORK\lvmen\src\licensedcode\data\rules\other-permissive_deb2.yml", "YAML", 0, 0, 0, 2, 0, 0, 1, 3
"d:\IDEWORK\lvmen\src\licensedcode\data\rules\other-permissive_docutils.yml", "YAML", 0, 0, 0, 3, 0, 0, 1, 4
"d:\IDEWORK\lvmen\src\licensedcode\data\rules\other-permissive_epsg-data-2007.yml", "YAML", 0, 0, 0, 2, 0, 0, 1, 3
"d:\IDEWORK\lvmen\src\licensedcode\data\rules\other-permissive_epsg-data-2007_2.yml", "YAML", 0, 0, 0, 2, 0, 0, 1, 3
"d:\IDEWORK\lvmen\src\licensedcode\data\rules\other-permissive_epsg-data-2014.yml", "YAML", 0, 0, 0, 2, 0, 0, 1, 3
"d:\IDEWORK\lvmen\src\licensedcode\data\rules\other-permissive_free-unknown_46.yml", "YAML", 0, 0, 0, 3, 0, 0, 1, 4
"d:\IDEWORK\lvmen\src\licensedcode\data\rules\other-permissive_friesenhahn.yml", "YAML", 0, 0, 0, 3, 0, 0, 1, 4
"d:\IDEWORK\lvmen\src\licensedcode\data\rules\other-permissive_ghostgum.yml", "YAML", 0, 0, 0, 3, 0, 0, 1, 4
"d:\IDEWORK\lvmen\src\licensedcode\data\rules\other-permissive_kalle-kaukonen_1.yml", "YAML", 0, 0, 0, 2, 0, 0, 1, 3
"d:\IDEWORK\lvmen\src\licensedcode\data\rules\other-permissive_kalle-kaukonen_2.yml", "YAML", 0, 0, 0, 2, 0, 0, 1, 3
"d:\IDEWORK\lvmen\src\licensedcode\data\rules\other-permissive_kalle-kaukonen_3.yml", "YAML", 0, 0, 0, 2, 0, 0, 1, 3
"d:\IDEWORK\lvmen\src\licensedcode\data\rules\other-permissive_kalle-kaukonen_4.yml", "YAML", 0, 0, 0, 2, 0, 0, 1, 3
"d:\IDEWORK\lvmen\src\licensedcode\data\rules\other-permissive_mazieres.yml", "YAML", 0, 0, 0, 2, 0, 0, 1, 3
"d:\IDEWORK\lvmen\src\licensedcode\data\rules\other-permissive_mazieres2.yml", "YAML", 0, 0, 0, 2, 0, 0, 1, 3
"d:\IDEWORK\lvmen\src\licensedcode\data\rules\other-permissive_morissey.yml", "YAML", 0, 0, 0, 3, 0, 0, 1, 4
"d:\IDEWORK\lvmen\src\licensedcode\data\rules\other-permissive_newlib.yml", "YAML", 0, 0, 0, 3, 0, 0, 1, 4
"d:\IDEWORK\lvmen\src\licensedcode\data\rules\other-permissive_non-nuclear_1.yml", "YAML", 0, 0, 0, 2, 0, 0, 1, 3
"d:\IDEWORK\lvmen\src\licensedcode\data\rules\other-permissive_not_commercial-license_2.yml", "YAML", 0, 0, 0, 5, 0, 0, 1, 6
"d:\IDEWORK\lvmen\src\licensedcode\data\rules\other-permissive_not_unknown_69.yml", "YAML", 0, 0, 0, 6, 0, 0, 1, 7
"d:\IDEWORK\lvmen\src\licensedcode\data\rules\other-permissive_old_elastic.yml", "YAML", 0, 0, 0, 10, 0, 0, 1, 11
"d:\IDEWORK\lvmen\src\licensedcode\data\rules\other-permissive_or_artistic-perl-1.0_1.yml", "YAML", 0, 0, 0, 4, 0, 0, 1, 5
"d:\IDEWORK\lvmen\src\licensedcode\data\rules\other-permissive_or_commercial-license_1.yml", "YAML", 0, 0, 0, 8, 0, 0, 1, 9
"d:\IDEWORK\lvmen\src\licensedcode\data\rules\other-permissive_or_gpl-1.0-plus_1.yml", "YAML", 0, 0, 0, 2, 0, 0, 1, 3
"d:\IDEWORK\lvmen\src\licensedcode\data\rules\other-permissive_or_lgpl-2.0-plus_or_gpl-1.0-plus_1.yml", "YAML", 0, 0, 0, 4, 0, 0, 1, 5
"d:\IDEWORK\lvmen\src\licensedcode\data\rules\other-permissive_or_lgpl-2.0-plus_or_gpl-1.0-plus_2.yml", "YAML", 0, 0, 0, 5, 0, 0, 1, 6
"d:\IDEWORK\lvmen\src\licensedcode\data\rules\other-permissive_owl_1.yml", "YAML", 0, 0, 0, 2, 0, 0, 1, 3
"d:\IDEWORK\lvmen\src\licensedcode\data\rules\other-permissive_owl_10.yml", "YAML", 0, 0, 0, 2, 0, 0, 1, 3
"d:\IDEWORK\lvmen\src\licensedcode\data\rules\other-permissive_owl_11.yml", "YAML", 0, 0, 0, 2, 0, 0, 1, 3
"d:\IDEWORK\lvmen\src\licensedcode\data\rules\other-permissive_owl_2.yml", "YAML", 0, 0, 0, 2, 0, 0, 1, 3
"d:\IDEWORK\lvmen\src\licensedcode\data\rules\other-permissive_owl_3.yml", "YAML", 0, 0, 0, 2, 0, 0, 1, 3
"d:\IDEWORK\lvmen\src\licensedcode\data\rules\other-permissive_owl_4.yml", "YAML", 0, 0, 0, 2, 0, 0, 1, 3
"d:\IDEWORK\lvmen\src\licensedcode\data\rules\other-permissive_owl_5.yml", "YAML", 0, 0, 0, 2, 0, 0, 1, 3
"d:\IDEWORK\lvmen\src\licensedcode\data\rules\other-permissive_owl_6.yml", "YAML", 0, 0, 0, 2, 0, 0, 1, 3
"d:\IDEWORK\lvmen\src\licensedcode\data\rules\other-permissive_owl_7.yml", "YAML", 0, 0, 0, 2, 0, 0, 1, 3
"d:\IDEWORK\lvmen\src\licensedcode\data\rules\other-permissive_owl_8.yml", "YAML", 0, 0, 0, 2, 0, 0, 1, 3
"d:\IDEWORK\lvmen\src\licensedcode\data\rules\other-permissive_owl_9.yml", "YAML", 0, 0, 0, 2, 0, 0, 1, 3
"d:\IDEWORK\lvmen\src\licensedcode\data\rules\other-permissive_public-domain_like.yml", "YAML", 0, 0, 0, 3, 0, 0, 1, 4
"d:\IDEWORK\lvmen\src\licensedcode\data\rules\other-permissive_punycode_1.yml", "YAML", 0, 0, 0, 2, 0, 0, 1, 3
"d:\IDEWORK\lvmen\src\licensedcode\data\rules\other-permissive_punycode_2.yml", "YAML", 0, 0, 0, 2, 0, 0, 1, 3
"d:\IDEWORK\lvmen\src\licensedcode\data\rules\other-permissive_sei-cmu3.yml", "YAML", 0, 0, 0, 8, 0, 0, 1, 9
"d:\IDEWORK\lvmen\src\licensedcode\data\rules\other-permissive_sei-cmu4.yml", "YAML", 0, 0, 0, 4, 0, 0, 1, 5
"d:\IDEWORK\lvmen\src\licensedcode\data\rules\other-permissive_tesla_1.yml", "YAML", 0, 0, 0, 6, 0, 0, 2, 8
"d:\IDEWORK\lvmen\src\licensedcode\data\rules\other-permissive_tesla_2.yml", "YAML", 0, 0, 0, 6, 0, 0, 2, 8
"d:\IDEWORK\lvmen\src\licensedcode\data\rules\other-permissive_tesla_3.yml", "YAML", 0, 0, 0, 2, 0, 0, 1, 3
"d:\IDEWORK\lvmen\src\licensedcode\data\rules\other-permissive_tesla_4.yml", "YAML", 0, 0, 0, 2, 0, 0, 1, 3
"d:\IDEWORK\lvmen\src\licensedcode\data\rules\other-permissive_twain.yml", "YAML", 0, 0, 0, 2, 0, 0, 1, 3
"d:\IDEWORK\lvmen\src\licensedcode\data\rules\other-permissive_uli.yml", "YAML", 0, 0, 0, 3, 0, 0, 1, 4
"d:\IDEWORK\lvmen\src\licensedcode\data\rules\other-permissive_uli2.yml", "YAML", 0, 0, 0, 3, 0, 0, 1, 4
"d:\IDEWORK\lvmen\src\licensedcode\data\rules\other-permissive_wcwidth_1.yml", "YAML", 0, 0, 0, 2, 0, 0, 1, 3
"d:\IDEWORK\lvmen\src\licensedcode\data\rules\other-permissive_xin-yang.yml", "YAML", 0, 0, 0, 3, 0, 0, 1, 4
"d:\IDEWORK\lvmen\src\licensedcode\data\rules\otn-dev-dist.yml", "YAML", 0, 0, 0, 5, 0, 0, 1, 6
"d:\IDEWORK\lvmen\src\licensedcode\data\rules\otn-dev-dist_1.yml", "YAML", 0, 0, 0, 5, 0, 0, 1, 6
"d:\IDEWORK\lvmen\src\licensedcode\data\rules\ozplb-1.0.yml", "YAML", 0, 0, 0, 5, 0, 0, 1, 6
"d:\IDEWORK\lvmen\src\licensedcode\data\rules\ozplb-1.0_1.yml", "YAML", 0, 0, 0, 5, 0, 0, 1, 6
"d:\IDEWORK\lvmen\src\licensedcode\data\rules\ozplb-1.1.yml", "YAML", 0, 0, 0, 5, 0, 0, 1, 6
"d:\IDEWORK\lvmen\src\licensedcode\data\rules\parity-6.0.0_url_1.yml", "YAML", 0, 0, 0, 5, 0, 0, 1, 6
"d:\IDEWORK\lvmen\src\licensedcode\data\rules\parity-6.0.0_url_2.yml", "YAML", 0, 0, 0, 5, 0, 0, 1, 6
"d:\IDEWORK\lvmen\src\licensedcode\data\rules\parity-7.0.0_1.yml", "YAML", 0, 0, 0, 8, 0, 0, 1, 9
"d:\IDEWORK\lvmen\src\licensedcode\data\rules\parity-7.0.0_2.yml", "YAML", 0, 0, 0, 3, 0, 0, 1, 4
"d:\IDEWORK\lvmen\src\licensedcode\data\rules\patent-disclaimer.yml", "YAML", 0, 0, 0, 2, 0, 0, 1, 3
"d:\IDEWORK\lvmen\src\licensedcode\data\rules\patent-disclaimer2.yml", "YAML", 0, 0, 0, 2, 0, 0, 1, 3
"d:\IDEWORK\lvmen\src\licensedcode\data\rules\patent-disclaimer3.yml", "YAML", 0, 0, 0, 2, 0, 0, 1, 3
"d:\IDEWORK\lvmen\src\licensedcode\data\rules\patent-disclaimer4.yml", "YAML", 0, 0, 0, 2, 0, 0, 1, 3
"d:\IDEWORK\lvmen\src\licensedcode\data\rules\patent-disclaimer_1.yml", "YAML", 0, 0, 0, 4, 0, 0, 1, 5
"d:\IDEWORK\lvmen\src\licensedcode\data\rules\paul-hsieh-derivative_1.yml", "YAML", 0, 0, 0, 3, 0, 0, 1, 4
"d:\IDEWORK\lvmen\src\licensedcode\data\rules\paul-hsieh-exposition.yml", "YAML", 0, 0, 0, 6, 0, 0, 1, 7
"d:\IDEWORK\lvmen\src\licensedcode\data\rules\paul-hsieh-exposition_1.yml", "YAML", 0, 0, 0, 2, 0, 0, 1, 3
"d:\IDEWORK\lvmen\src\licensedcode\data\rules\paul-mackerras-binary_1.yml", "YAML", 0, 0, 0, 2, 0, 0, 1, 3
"d:\IDEWORK\lvmen\src\licensedcode\data\rules\paul-mackerras-binary_2.yml", "YAML", 0, 0, 0, 2, 0, 0, 1, 3
"d:\IDEWORK\lvmen\src\licensedcode\data\rules\paul-mackerras-binary_3.yml", "YAML", 0, 0, 0, 7, 0, 0, 1, 8
"d:\IDEWORK\lvmen\src\licensedcode\data\rules\paul-mackerras-new_1.yml", "YAML", 0, 0, 0, 2, 0, 0, 1, 3
"d:\IDEWORK\lvmen\src\licensedcode\data\rules\pcre.yml", "YAML", 0, 0, 0, 5, 0, 0, 1, 6
"d:\IDEWORK\lvmen\src\licensedcode\data\rules\pcre_1.yml", "YAML", 0, 0, 0, 11, 0, 0, 1, 12
"d:\IDEWORK\lvmen\src\licensedcode\data\rules\pcre_2.yml", "YAML", 0, 0, 0, 11, 0, 0, 1, 12
"d:\IDEWORK\lvmen\src\licensedcode\data\rules\pcre_3.yml", "YAML", 0, 0, 0, 3, 0, 0, 1, 4
"d:\IDEWORK\lvmen\src\licensedcode\data\rules\pcre_4.yml", "YAML", 0, 0, 0, 3, 0, 0, 2, 5
"d:\IDEWORK\lvmen\src\licensedcode\data\rules\pcre_5.yml", "YAML", 0, 0, 0, 4, 0, 0, 1, 5
"d:\IDEWORK\lvmen\src\licensedcode\data\rules\pcre_6.yml", "YAML", 0, 0, 0, 5, 0, 0, 1, 6
"d:\IDEWORK\lvmen\src\licensedcode\data\rules\pcre_7.yml", "YAML", 0, 0, 0, 5, 0, 0, 1, 6
"d:\IDEWORK\lvmen\src\licensedcode\data\rules\pcre_8.yml", "YAML", 0, 0, 0, 5, 0, 0, 1, 6
"d:\IDEWORK\lvmen\src\licensedcode\data\rules\pd-programming.yml", "YAML", 0, 0, 0, 5, 0, 0, 1, 6
"d:\IDEWORK\lvmen\src\licensedcode\data\rules\pddl-1.0.SPDX.yml", "YAML", 0, 0, 0, 4, 0, 0, 1, 5
"d:\IDEWORK\lvmen\src\licensedcode\data\rules\pddl-1.0.yml", "YAML", 0, 0, 0, 5, 0, 0, 1, 6
"d:\IDEWORK\lvmen\src\licensedcode\data\rules\pddl-1.0_1.yml", "YAML", 0, 0, 0, 6, 0, 0, 1, 7
"d:\IDEWORK\lvmen\src\licensedcode\data\rules\pddl-1.0_and_mit_1.yml", "YAML", 0, 0, 0, 3, 0, 0, 1, 4
"d:\IDEWORK\lvmen\src\licensedcode\data\rules\pddl-1.0_url_1.yml", "YAML", 0, 0, 0, 5, 0, 0, 1, 6
"d:\IDEWORK\lvmen\src\licensedcode\data\rules\pddl-1.0_url_2.yml", "YAML", 0, 0, 0, 5, 0, 0, 1, 6
"d:\IDEWORK\lvmen\src\licensedcode\data\rules\pddl-1.0_url_badge.yml", "YAML", 0, 0, 0, 7, 0, 0, 1, 8
"d:\IDEWORK\lvmen\src\licensedcode\data\rules\perserve.yml", "YAML", 0, 0, 0, 3, 0, 0, 1, 4
"d:\IDEWORK\lvmen\src\licensedcode\data\rules\perserve2.yml", "YAML", 0, 0, 0, 2, 0, 0, 1, 3
"d:\IDEWORK\lvmen\src\licensedcode\data\rules\perserve3.yml", "YAML", 0, 0, 0, 3, 0, 0, 1, 4
"d:\IDEWORK\lvmen\src\licensedcode\data\rules\peter-deutsch-document_1.yml", "YAML", 0, 0, 0, 3, 0, 0, 1, 4
"d:\IDEWORK\lvmen\src\licensedcode\data\rules\pftijah-1.1.yml", "YAML", 0, 0, 0, 5, 0, 0, 1, 6
"d:\IDEWORK\lvmen\src\licensedcode\data\rules\pftijah-1.1_1.yml", "YAML", 0, 0, 0, 4, 0, 0, 1, 5
"d:\IDEWORK\lvmen\src\licensedcode\data\rules\philippe-de-muyter_linum_1.yml", "YAML", 0, 0, 0, 3, 0, 0, 1, 4
"d:\IDEWORK\lvmen\src\licensedcode\data\rules\phorum-2.0_1.yml", "YAML", 0, 0, 0, 13, 0, 0, 1, 14
"d:\IDEWORK\lvmen\src\licensedcode\data\rules\phorum-2.0_2.yml", "YAML", 0, 0, 0, 5, 0, 0, 1, 6
"d:\IDEWORK\lvmen\src\licensedcode\data\rules\php-2.0.2_1.yml", "YAML", 0, 0, 0, 6, 0, 0, 1, 7
"d:\IDEWORK\lvmen\src\licensedcode\data\rules\php-2.0.2_and_other-permissive_1.yml", "YAML", 0, 0, 0, 14, 0, 0, 1, 15
"d:\IDEWORK\lvmen\src\licensedcode\data\rules\php-3.0.yml", "YAML", 0, 0, 0, 3, 0, 0, 1, 4
"d:\IDEWORK\lvmen\src\licensedcode\data\rules\php-3.01.yml", "YAML", 0, 0, 0, 5, 0, 0, 1, 6
"d:\IDEWORK\lvmen\src\licensedcode\data\rules\php-3.01_1.yml", "YAML", 0, 0, 0, 13, 0, 0, 1, 14
"d:\IDEWORK\lvmen\src\licensedcode\data\rules\php-3.01_10.yml", "YAML", 0, 0, 0, 12, 0, 0, 1, 13
"d:\IDEWORK\lvmen\src\licensedcode\data\rules\php-3.01_11.yml", "YAML", 0, 0, 0, 3, 0, 0, 1, 4
"d:\IDEWORK\lvmen\src\licensedcode\data\rules\php-3.01_2.yml", "YAML", 0, 0, 0, 5, 0, 0, 1, 6
"d:\IDEWORK\lvmen\src\licensedcode\data\rules\php-3.01_3.yml", "YAML", 0, 0, 0, 13, 0, 0, 1, 14
"d:\IDEWORK\lvmen\src\licensedcode\data\rules\php-3.01_4.yml", "YAML", 0, 0, 0, 3, 0, 0, 1, 4
"d:\IDEWORK\lvmen\src\licensedcode\data\rules\php-3.01_5.yml", "YAML", 0, 0, 0, 6, 0, 0, 1, 7
"d:\IDEWORK\lvmen\src\licensedcode\data\rules\php-3.01_6.yml", "YAML", 0, 0, 0, 5, 0, 0, 1, 6
"d:\IDEWORK\lvmen\src\licensedcode\data\rules\php-3.01_7.yml", "YAML", 0, 0, 0, 6, 0, 0, 1, 7
"d:\IDEWORK\lvmen\src\licensedcode\data\rules\php-3.01_8.yml", "YAML", 0, 0, 0, 6, 0, 0, 1, 7
"d:\IDEWORK\lvmen\src\licensedcode\data\rules\php-3.01_9.yml", "YAML", 0, 0, 0, 12, 0, 0, 1, 13
"d:\IDEWORK\lvmen\src\licensedcode\data\rules\php-3.01_or_lgpl-3.0_1.yml", "YAML", 0, 0, 0, 3, 0, 0, 1, 4
"d:\IDEWORK\lvmen\src\licensedcode\data\rules\php-3.01_url_1.yml", "YAML", 0, 0, 0, 5, 0, 0, 1, 6
"d:\IDEWORK\lvmen\src\licensedcode\data\rules\php-3.01_url_2.yml", "YAML", 0, 0, 0, 5, 0, 0, 1, 6
"d:\IDEWORK\lvmen\src\licensedcode\data\rules\php-3.0_1.yml", "YAML", 0, 0, 0, 5, 0, 0, 1, 6
"d:\IDEWORK\lvmen\src\licensedcode\data\rules\php-3.0_10.yml", "YAML", 0, 0, 0, 3, 0, 0, 1, 4
"d:\IDEWORK\lvmen\src\licensedcode\data\rules\php-3.0_2.yml", "YAML", 0, 0, 0, 5, 0, 0, 1, 6
"d:\IDEWORK\lvmen\src\licensedcode\data\rules\php-3.0_3.yml", "YAML", 0, 0, 0, 5, 0, 0, 1, 6
"d:\IDEWORK\lvmen\src\licensedcode\data\rules\php-3.0_4.yml", "YAML", 0, 0, 0, 8, 0, 0, 1, 9
"d:\IDEWORK\lvmen\src\licensedcode\data\rules\php-3.0_5.yml", "YAML", 0, 0, 0, 6, 0, 0, 1, 7
"d:\IDEWORK\lvmen\src\licensedcode\data\rules\php-3.0_6.yml", "YAML", 0, 0, 0, 6, 0, 0, 1, 7
"d:\IDEWORK\lvmen\src\licensedcode\data\rules\php-3.0_7.yml", "YAML", 0, 0, 0, 6, 0, 0, 1, 7
"d:\IDEWORK\lvmen\src\licensedcode\data\rules\php-3.0_8.yml", "YAML", 0, 0, 0, 6, 0, 0, 1, 7
"d:\IDEWORK\lvmen\src\licensedcode\data\rules\php-3.0_9.yml", "YAML", 0, 0, 0, 5, 0, 0, 1, 6
"d:\IDEWORK\lvmen\src\licensedcode\data\rules\php-3.0_or_lgpl-3.0_1.yml", "YAML", 0, 0, 0, 3, 0, 0, 1, 4
"d:\IDEWORK\lvmen\src\licensedcode\data\rules\php-3.0_url_1.yml", "YAML", 0, 0, 0, 5, 0, 0, 1, 6
"d:\IDEWORK\lvmen\src\licensedcode\data\rules\php-3.0_url_2.yml", "YAML", 0, 0, 0, 5, 0, 0, 1, 6
"d:\IDEWORK\lvmen\src\licensedcode\data\rules\php-3.0_url_glc_220.yml", "YAML", 0, 0, 0, 5, 0, 0, 1, 6
"d:\IDEWORK\lvmen\src\licensedcode\data\rules\php-3.0_url_glc_221.yml", "YAML", 0, 0, 0, 5, 0, 0, 1, 6
"d:\IDEWORK\lvmen\src\licensedcode\data\rules\pine.yml", "YAML", 0, 0, 0, 5, 0, 0, 1, 6
"d:\IDEWORK\lvmen\src\licensedcode\data\rules\polyform-free-trial-1.0.0_1.yml", "YAML", 0, 0, 0, 5, 0, 0, 1, 6
"d:\IDEWORK\lvmen\src\licensedcode\data\rules\polyform-free-trial-1.0.0_2.yml", "YAML", 0, 0, 0, 5, 0, 0, 1, 6
"d:\IDEWORK\lvmen\src\licensedcode\data\rules\polyform-free-trial-1.0.0_3.yml", "YAML", 0, 0, 0, 3, 0, 0, 1, 4
"d:\IDEWORK\lvmen\src\licensedcode\data\rules\polyform-noncommercial-1.0.0_1.yml", "YAML", 0, 0, 0, 3, 0, 0, 1, 4
"d:\IDEWORK\lvmen\src\licensedcode\data\rules\polyform-noncommercial-1.0.0_2.yml", "YAML", 0, 0, 0, 3, 0, 0, 1, 4
"d:\IDEWORK\lvmen\src\licensedcode\data\rules\polyform-noncommercial-1.0.0_3.yml", "YAML", 0, 0, 0, 3, 0, 0, 1, 4
"d:\IDEWORK\lvmen\src\licensedcode\data\rules\polyform-noncommercial-1.0.0_4.yml", "YAML", 0, 0, 0, 5, 0, 0, 2, 7
"d:\IDEWORK\lvmen\src\licensedcode\data\rules\polyform-noncommercial-1.0.0_5.yml", "YAML", 0, 0, 0, 3, 0, 0, 1, 4
"d:\IDEWORK\lvmen\src\licensedcode\data\rules\polyform-noncommercial-1.0.0_6.yml", "YAML", 0, 0, 0, 3, 0, 0, 1, 4
"d:\IDEWORK\lvmen\src\licensedcode\data\rules\polyform-noncommercial-1.0.0_7.yml", "YAML", 0, 0, 0, 5, 0, 0, 2, 7
"d:\IDEWORK\lvmen\src\licensedcode\data\rules\polyform-noncommercial-1.0.0_or_commercial-license_1.yml", "YAML", 0, 0, 0, 3, 0, 0, 1, 4
"d:\IDEWORK\lvmen\src\licensedcode\data\rules\polyform-shield-1.0.0_1.yml", "YAML", 0, 0, 0, 5, 0, 0, 1, 6
"d:\IDEWORK\lvmen\src\licensedcode\data\rules\polyform-shield-1.0.0_2.yml", "YAML", 0, 0, 0, 3, 0, 0, 1, 4
"d:\IDEWORK\lvmen\src\licensedcode\data\rules\polyform-shield-1.0.0_3.yml", "YAML", 0, 0, 0, 5, 0, 0, 1, 6
"d:\IDEWORK\lvmen\src\licensedcode\data\rules\polyform-shield-1.0.0_4.yml", "YAML", 0, 0, 0, 5, 0, 0, 1, 6
"d:\IDEWORK\lvmen\src\licensedcode\data\rules\polyform-small-business-1.0.0_1.yml", "YAML", 0, 0, 0, 5, 0, 0, 1, 6
"d:\IDEWORK\lvmen\src\licensedcode\data\rules\polyform-small-business-1.0.0_2.yml", "YAML", 0, 0, 0, 3, 0, 0, 1, 4
"d:\IDEWORK\lvmen\src\licensedcode\data\rules\polyform-small-business-1.0.0_or_polyform-free-trial-1.0.0_1.yml", "YAML", 0, 0, 0, 6, 0, 0, 1, 7
"d:\IDEWORK\lvmen\src\licensedcode\data\rules\postgresql_1.yml", "YAML", 0, 0, 0, 6, 0, 0, 1, 7
"d:\IDEWORK\lvmen\src\licensedcode\data\rules\postgresql_10.yml", "YAML", 0, 0, 0, 3, 0, 0, 1, 4
"d:\IDEWORK\lvmen\src\licensedcode\data\rules\postgresql_11.yml", "YAML", 0, 0, 0, 2, 0, 0, 1, 3
"d:\IDEWORK\lvmen\src\licensedcode\data\rules\postgresql_12.yml", "YAML", 0, 0, 0, 3, 0, 0, 1, 4
"d:\IDEWORK\lvmen\src\licensedcode\data\rules\postgresql_13.yml", "YAML", 0, 0, 0, 5, 0, 0, 1, 6
"d:\IDEWORK\lvmen\src\licensedcode\data\rules\postgresql_14.yml", "YAML", 0, 0, 0, 5, 0, 0, 1, 6
"d:\IDEWORK\lvmen\src\licensedcode\data\rules\postgresql_15.yml", "YAML", 0, 0, 0, 3, 0, 0, 1, 4
"d:\IDEWORK\lvmen\src\licensedcode\data\rules\postgresql_16.yml", "YAML", 0, 0, 0, 5, 0, 0, 1, 6
"d:\IDEWORK\lvmen\src\licensedcode\data\rules\postgresql_17.yml", "YAML", 0, 0, 0, 3, 0, 0, 1, 4
"d:\IDEWORK\lvmen\src\licensedcode\data\rules\postgresql_18.yml", "YAML", 0, 0, 0, 3, 0, 0, 1, 4
"d:\IDEWORK\lvmen\src\licensedcode\data\rules\postgresql_19.yml", "YAML", 0, 0, 0, 3, 0, 0, 1, 4
"d:\IDEWORK\lvmen\src\licensedcode\data\rules\postgresql_2.yml", "YAML", 0, 0, 0, 3, 0, 0, 1, 4
"d:\IDEWORK\lvmen\src\licensedcode\data\rules\postgresql_20.yml", "YAML", 0, 0, 0, 3, 0, 0, 1, 4
"d:\IDEWORK\lvmen\src\licensedcode\data\rules\postgresql_21.yml", "YAML", 0, 0, 0, 5, 0, 0, 1, 6
"d:\IDEWORK\lvmen\src\licensedcode\data\rules\postgresql_22.yml", "YAML", 0, 0, 0, 9, 0, 0, 1, 10
"d:\IDEWORK\lvmen\src\licensedcode\data\rules\postgresql_23.yml", "YAML", 0, 0, 0, 4, 0, 0, 1, 5
"d:\IDEWORK\lvmen\src\licensedcode\data\rules\postgresql_24.yml", "YAML", 0, 0, 0, 4, 0, 0, 1, 5
"d:\IDEWORK\lvmen\src\licensedcode\data\rules\postgresql_25.yml", "YAML", 0, 0, 0, 3, 0, 0, 1, 4
"d:\IDEWORK\lvmen\src\licensedcode\data\rules\postgresql_3.yml", "YAML", 0, 0, 0, 5, 0, 0, 1, 6
"d:\IDEWORK\lvmen\src\licensedcode\data\rules\postgresql_4.yml", "YAML", 0, 0, 0, 3, 0, 0, 1, 4
"d:\IDEWORK\lvmen\src\licensedcode\data\rules\postgresql_5.yml", "YAML", 0, 0, 0, 3, 0, 0, 1, 4
"d:\IDEWORK\lvmen\src\licensedcode\data\rules\postgresql_6.yml", "YAML", 0, 0, 0, 5, 0, 0, 1, 6
"d:\IDEWORK\lvmen\src\licensedcode\data\rules\postgresql_7.yml", "YAML", 0, 0, 0, 5, 0, 0, 1, 6
"d:\IDEWORK\lvmen\src\licensedcode\data\rules\postgresql_8.yml", "YAML", 0, 0, 0, 2, 0, 0, 1, 3
"d:\IDEWORK\lvmen\src\licensedcode\data\rules\postgresql_9.yml", "YAML", 0, 0, 0, 3, 0, 0, 1, 4
"d:\IDEWORK\lvmen\src\licensedcode\data\rules\postgresql_url_1.yml", "YAML", 0, 0, 0, 5, 0, 0, 1, 6
"d:\IDEWORK\lvmen\src\licensedcode\data\rules\postgresql_url_2.yml", "YAML", 0, 0, 0, 5, 0, 0, 1, 6
"d:\IDEWORK\lvmen\src\licensedcode\data\rules\postgresql_url_glc_223.yml", "YAML", 0, 0, 0, 5, 0, 0, 1, 6
"d:\IDEWORK\lvmen\src\licensedcode\data\rules\proprietary-01_10.yml", "YAML", 0, 0, 0, 2, 0, 0, 1, 3
"d:\IDEWORK\lvmen\src\licensedcode\data\rules\proprietary-01_11.yml", "YAML", 0, 0, 0, 3, 0, 0, 1, 4
"d:\IDEWORK\lvmen\src\licensedcode\data\rules\proprietary-01_12.yml", "YAML", 0, 0, 0, 3, 0, 0, 1, 4
"d:\IDEWORK\lvmen\src\licensedcode\data\rules\proprietary-02_10.yml", "YAML", 0, 0, 0, 2, 0, 0, 1, 3
"d:\IDEWORK\lvmen\src\licensedcode\data\rules\proprietary-03.yml", "YAML", 0, 0, 0, 2, 0, 0, 1, 3
"d:\IDEWORK\lvmen\src\licensedcode\data\rules\proprietary-04_10.yml", "YAML", 0, 0, 0, 2, 0, 0, 1, 3
"d:\IDEWORK\lvmen\src\licensedcode\data\rules\proprietary-05_10.yml", "YAML", 0, 0, 0, 2, 0, 0, 1, 3
"d:\IDEWORK\lvmen\src\licensedcode\data\rules\proprietary-06.yml", "YAML", 0, 0, 0, 3, 0, 0, 1, 4
"d:\IDEWORK\lvmen\src\licensedcode\data\rules\proprietary-06_10.yml", "YAML", 0, 0, 0, 3, 0, 0, 1, 4
"d:\IDEWORK\lvmen\src\licensedcode\data\rules\proprietary-07.yml", "YAML", 0, 0, 0, 2, 0, 0, 1, 3
"d:\IDEWORK\lvmen\src\licensedcode\data\rules\proprietary-07_10.yml", "YAML", 0, 0, 0, 2, 0, 0, 1, 3
"d:\IDEWORK\lvmen\src\licensedcode\data\rules\proprietary-08.yml", "YAML", 0, 0, 0, 2, 0, 0, 1, 3
"d:\IDEWORK\lvmen\src\licensedcode\data\rules\proprietary-08_1.yml", "YAML", 0, 0, 0, 2, 0, 0, 1, 3
"d:\IDEWORK\lvmen\src\licensedcode\data\rules\proprietary-08_3.yml", "YAML", 0, 0, 0, 4, 0, 0, 1, 5
"d:\IDEWORK\lvmen\src\licensedcode\data\rules\proprietary-10.yml", "YAML", 0, 0, 0, 2, 0, 0, 1, 3
"d:\IDEWORK\lvmen\src\licensedcode\data\rules\proprietary-10_10.yml", "YAML", 0, 0, 0, 2, 0, 0, 1, 3
"d:\IDEWORK\lvmen\src\licensedcode\data\rules\proprietary-license_1.yml", "YAML", 0, 0, 0, 2, 0, 0, 1, 3
"d:\IDEWORK\lvmen\src\licensedcode\data\rules\proprietary-license_10.yml", "YAML", 0, 0, 0, 3, 0, 0, 1, 4
"d:\IDEWORK\lvmen\src\licensedcode\data\rules\proprietary-license_100.yml", "YAML", 0, 0, 0, 5, 0, 0, 1, 6
"d:\IDEWORK\lvmen\src\licensedcode\data\rules\proprietary-license_101.yml", "YAML", 0, 0, 0, 3, 0, 0, 1, 4
"d:\IDEWORK\lvmen\src\licensedcode\data\rules\proprietary-license_102.yml", "YAML", 0, 0, 0, 3, 0, 0, 1, 4
"d:\IDEWORK\lvmen\src\licensedcode\data\rules\proprietary-license_103.yml", "YAML", 0, 0, 0, 4, 0, 0, 1, 5
"d:\IDEWORK\lvmen\src\licensedcode\data\rules\proprietary-license_104.yml", "YAML", 0, 0, 0, 3, 0, 0, 1, 4
"d:\IDEWORK\lvmen\src\licensedcode\data\rules\proprietary-license_105.yml", "YAML", 0, 0, 0, 3, 0, 0, 1, 4
"d:\IDEWORK\lvmen\src\licensedcode\data\rules\proprietary-license_106.yml", "YAML", 0, 0, 0, 3, 0, 0, 1, 4
"d:\IDEWORK\lvmen\src\licensedcode\data\rules\proprietary-license_107.yml", "YAML", 0, 0, 0, 3, 0, 0, 1, 4
"d:\IDEWORK\lvmen\src\licensedcode\data\rules\proprietary-license_108.yml", "YAML", 0, 0, 0, 4, 0, 0, 1, 5
"d:\IDEWORK\lvmen\src\licensedcode\data\rules\proprietary-license_109.yml", "YAML", 0, 0, 0, 5, 0, 0, 1, 6
"d:\IDEWORK\lvmen\src\licensedcode\data\rules\proprietary-license_11.yml", "YAML", 0, 0, 0, 5, 0, 0, 1, 6
"d:\IDEWORK\lvmen\src\licensedcode\data\rules\proprietary-license_110.yml", "YAML", 0, 0, 0, 5, 0, 0, 1, 6
"d:\IDEWORK\lvmen\src\licensedcode\data\rules\proprietary-license_111.yml", "YAML", 0, 0, 0, 7, 0, 0, 1, 8
"d:\IDEWORK\lvmen\src\licensedcode\data\rules\proprietary-license_112.yml", "YAML", 0, 0, 0, 5, 0, 0, 1, 6
"d:\IDEWORK\lvmen\src\licensedcode\data\rules\proprietary-license_113.yml", "YAML", 0, 0, 0, 3, 0, 0, 1, 4
"d:\IDEWORK\lvmen\src\licensedcode\data\rules\proprietary-license_114.yml", "YAML", 0, 0, 0, 3, 0, 0, 1, 4
"d:\IDEWORK\lvmen\src\licensedcode\data\rules\proprietary-license_115.yml", "YAML", 0, 0, 0, 5, 0, 0, 1, 6
"d:\IDEWORK\lvmen\src\licensedcode\data\rules\proprietary-license_116.yml", "YAML", 0, 0, 0, 5, 0, 0, 1, 6
"d:\IDEWORK\lvmen\src\licensedcode\data\rules\proprietary-license_117.yml", "YAML", 0, 0, 0, 5, 0, 0, 1, 6
"d:\IDEWORK\lvmen\src\licensedcode\data\rules\proprietary-license_118.yml", "YAML", 0, 0, 0, 3, 0, 0, 1, 4
"d:\IDEWORK\lvmen\src\licensedcode\data\rules\proprietary-license_119.yml", "YAML", 0, 0, 0, 3, 0, 0, 1, 4
"d:\IDEWORK\lvmen\src\licensedcode\data\rules\proprietary-license_12.yml", "YAML", 0, 0, 0, 3, 0, 0, 1, 4
"d:\IDEWORK\lvmen\src\licensedcode\data\rules\proprietary-license_120.yml", "YAML", 0, 0, 0, 3, 0, 0, 1, 4
"d:\IDEWORK\lvmen\src\licensedcode\data\rules\proprietary-license_121.yml", "YAML", 0, 0, 0, 6, 0, 0, 1, 7
"d:\IDEWORK\lvmen\src\licensedcode\data\rules\proprietary-license_122.yml", "YAML", 0, 0, 0, 4, 0, 0, 1, 5
"d:\IDEWORK\lvmen\src\licensedcode\data\rules\proprietary-license_123.yml", "YAML", 0, 0, 0, 6, 0, 0, 1, 7
"d:\IDEWORK\lvmen\src\licensedcode\data\rules\proprietary-license_124.yml", "YAML", 0, 0, 0, 3, 0, 0, 1, 4
"d:\IDEWORK\lvmen\src\licensedcode\data\rules\proprietary-license_125.yml", "YAML", 0, 0, 0, 3, 0, 0, 1, 4
"d:\IDEWORK\lvmen\src\licensedcode\data\rules\proprietary-license_126.yml", "YAML", 0, 0, 0, 3, 0, 0, 1, 4
"d:\IDEWORK\lvmen\src\licensedcode\data\rules\proprietary-license_127.yml", "YAML", 0, 0, 0, 3, 0, 0, 1, 4
"d:\IDEWORK\lvmen\src\licensedcode\data\rules\proprietary-license_128.yml", "YAML", 0, 0, 0, 5, 0, 0, 1, 6
"d:\IDEWORK\lvmen\src\licensedcode\data\rules\proprietary-license_129.yml", "YAML", 0, 0, 0, 5, 0, 0, 1, 6
"d:\IDEWORK\lvmen\src\licensedcode\data\rules\proprietary-license_13.yml", "YAML", 0, 0, 0, 5, 0, 0, 1, 6
"d:\IDEWORK\lvmen\src\licensedcode\data\rules\proprietary-license_130.yml", "YAML", 0, 0, 0, 5, 0, 0, 1, 6
"d:\IDEWORK\lvmen\src\licensedcode\data\rules\proprietary-license_131.yml", "YAML", 0, 0, 0, 5, 0, 0, 1, 6
"d:\IDEWORK\lvmen\src\licensedcode\data\rules\proprietary-license_132.yml", "YAML", 0, 0, 0, 4, 0, 0, 1, 5
"d:\IDEWORK\lvmen\src\licensedcode\data\rules\proprietary-license_133.yml", "YAML", 0, 0, 0, 4, 0, 0, 1, 5
"d:\IDEWORK\lvmen\src\licensedcode\data\rules\proprietary-license_134.yml", "YAML", 0, 0, 0, 6, 0, 0, 1, 7
"d:\IDEWORK\lvmen\src\licensedcode\data\rules\proprietary-license_135.yml", "YAML", 0, 0, 0, 3, 0, 0, 1, 4
"d:\IDEWORK\lvmen\src\licensedcode\data\rules\proprietary-license_136.yml", "YAML", 0, 0, 0, 3, 0, 0, 1, 4
"d:\IDEWORK\lvmen\src\licensedcode\data\rules\proprietary-license_137.yml", "YAML", 0, 0, 0, 3, 0, 0, 1, 4
"d:\IDEWORK\lvmen\src\licensedcode\data\rules\proprietary-license_138.yml", "YAML", 0, 0, 0, 4, 0, 0, 1, 5
"d:\IDEWORK\lvmen\src\licensedcode\data\rules\proprietary-license_139.yml", "YAML", 0, 0, 0, 3, 0, 0, 1, 4
"d:\IDEWORK\lvmen\src\licensedcode\data\rules\proprietary-license_14.yml", "YAML", 0, 0, 0, 5, 0, 0, 1, 6
"d:\IDEWORK\lvmen\src\licensedcode\data\rules\proprietary-license_140.yml", "YAML", 0, 0, 0, 3, 0, 0, 1, 4
"d:\IDEWORK\lvmen\src\licensedcode\data\rules\proprietary-license_141.yml", "YAML", 0, 0, 0, 3, 0, 0, 1, 4
"d:\IDEWORK\lvmen\src\licensedcode\data\rules\proprietary-license_142.yml", "YAML", 0, 0, 0, 4, 0, 0, 1, 5
"d:\IDEWORK\lvmen\src\licensedcode\data\rules\proprietary-license_143.yml", "YAML", 0, 0, 0, 4, 0, 0, 1, 5
"d:\IDEWORK\lvmen\src\licensedcode\data\rules\proprietary-license_144.yml", "YAML", 0, 0, 0, 4, 0, 0, 1, 5
"d:\IDEWORK\lvmen\src\licensedcode\data\rules\proprietary-license_145.yml", "YAML", 0, 0, 0, 4, 0, 0, 1, 5
"d:\IDEWORK\lvmen\src\licensedcode\data\rules\proprietary-license_146.yml", "YAML", 0, 0, 0, 3, 0, 0, 1, 4
"d:\IDEWORK\lvmen\src\licensedcode\data\rules\proprietary-license_147.yml", "YAML", 0, 0, 0, 8, 0, 0, 1, 9
"d:\IDEWORK\lvmen\src\licensedcode\data\rules\proprietary-license_148.yml", "YAML", 0, 0, 0, 3, 0, 0, 1, 4
"d:\IDEWORK\lvmen\src\licensedcode\data\rules\proprietary-license_149.yml", "YAML", 0, 0, 0, 3, 0, 0, 1, 4
"d:\IDEWORK\lvmen\src\licensedcode\data\rules\proprietary-license_15.yml", "YAML", 0, 0, 0, 5, 0, 0, 1, 6
"d:\IDEWORK\lvmen\src\licensedcode\data\rules\proprietary-license_150.yml", "YAML", 0, 0, 0, 5, 0, 0, 1, 6
"d:\IDEWORK\lvmen\src\licensedcode\data\rules\proprietary-license_151.yml", "YAML", 0, 0, 0, 3, 0, 0, 1, 4
"d:\IDEWORK\lvmen\src\licensedcode\data\rules\proprietary-license_152.yml", "YAML", 0, 0, 0, 3, 0, 0, 1, 4
"d:\IDEWORK\lvmen\src\licensedcode\data\rules\proprietary-license_153.yml", "YAML", 0, 0, 0, 3, 0, 0, 1, 4
"d:\IDEWORK\lvmen\src\licensedcode\data\rules\proprietary-license_154.yml", "YAML", 0, 0, 0, 3, 0, 0, 1, 4
"d:\IDEWORK\lvmen\src\licensedcode\data\rules\proprietary-license_155.yml", "YAML", 0, 0, 0, 3, 0, 0, 1, 4
"d:\IDEWORK\lvmen\src\licensedcode\data\rules\proprietary-license_156.yml", "YAML", 0, 0, 0, 3, 0, 0, 1, 4
"d:\IDEWORK\lvmen\src\licensedcode\data\rules\proprietary-license_157.yml", "YAML", 0, 0, 0, 3, 0, 0, 1, 4
"d:\IDEWORK\lvmen\src\licensedcode\data\rules\proprietary-license_158.yml", "YAML", 0, 0, 0, 3, 0, 0, 1, 4
"d:\IDEWORK\lvmen\src\licensedcode\data\rules\proprietary-license_159.yml", "YAML", 0, 0, 0, 3, 0, 0, 1, 4
"d:\IDEWORK\lvmen\src\licensedcode\data\rules\proprietary-license_16.yml", "YAML", 0, 0, 0, 5, 0, 0, 1, 6
"d:\IDEWORK\lvmen\src\licensedcode\data\rules\proprietary-license_160.yml", "YAML", 0, 0, 0, 13, 0, 0, 1, 14
"d:\IDEWORK\lvmen\src\licensedcode\data\rules\proprietary-license_161.yml", "YAML", 0, 0, 0, 6, 0, 0, 1, 7
"d:\IDEWORK\lvmen\src\licensedcode\data\rules\proprietary-license_162.yml", "YAML", 0, 0, 0, 6, 0, 0, 1, 7
"d:\IDEWORK\lvmen\src\licensedcode\data\rules\proprietary-license_163.yml", "YAML", 0, 0, 0, 3, 0, 0, 1, 4
"d:\IDEWORK\lvmen\src\licensedcode\data\rules\proprietary-license_164.yml", "YAML", 0, 0, 0, 3, 0, 0, 1, 4
"d:\IDEWORK\lvmen\src\licensedcode\data\rules\proprietary-license_165.yml", "YAML", 0, 0, 0, 3, 0, 0, 1, 4
"d:\IDEWORK\lvmen\src\licensedcode\data\rules\proprietary-license_166.yml", "YAML", 0, 0, 0, 3, 0, 0, 1, 4
"d:\IDEWORK\lvmen\src\licensedcode\data\rules\proprietary-license_167.yml", "YAML", 0, 0, 0, 3, 0, 0, 1, 4
"d:\IDEWORK\lvmen\src\licensedcode\data\rules\proprietary-license_168.yml", "YAML", 0, 0, 0, 3, 0, 0, 1, 4
"d:\IDEWORK\lvmen\src\licensedcode\data\rules\proprietary-license_169.yml", "YAML", 0, 0, 0, 3, 0, 0, 1, 4
"d:\IDEWORK\lvmen\src\licensedcode\data\rules\proprietary-license_17.yml", "YAML", 0, 0, 0, 5, 0, 0, 1, 6
"d:\IDEWORK\lvmen\src\licensedcode\data\rules\proprietary-license_170.yml", "YAML", 0, 0, 0, 3, 0, 0, 1, 4
"d:\IDEWORK\lvmen\src\licensedcode\data\rules\proprietary-license_171.yml", "YAML", 0, 0, 0, 3, 0, 0, 1, 4
"d:\IDEWORK\lvmen\src\licensedcode\data\rules\proprietary-license_172.yml", "YAML", 0, 0, 0, 3, 0, 0, 1, 4
"d:\IDEWORK\lvmen\src\licensedcode\data\rules\proprietary-license_173.yml", "YAML", 0, 0, 0, 3, 0, 0, 1, 4
"d:\IDEWORK\lvmen\src\licensedcode\data\rules\proprietary-license_174.yml", "YAML", 0, 0, 0, 3, 0, 0, 1, 4
"d:\IDEWORK\lvmen\src\licensedcode\data\rules\proprietary-license_175.yml", "YAML", 0, 0, 0, 3, 0, 0, 1, 4
"d:\IDEWORK\lvmen\src\licensedcode\data\rules\proprietary-license_176.yml", "YAML", 0, 0, 0, 3, 0, 0, 1, 4
"d:\IDEWORK\lvmen\src\licensedcode\data\rules\proprietary-license_177.yml", "YAML", 0, 0, 0, 3, 0, 0, 1, 4
"d:\IDEWORK\lvmen\src\licensedcode\data\rules\proprietary-license_178.yml", "YAML", 0, 0, 0, 3, 0, 0, 1, 4
"d:\IDEWORK\lvmen\src\licensedcode\data\rules\proprietary-license_179.yml", "YAML", 0, 0, 0, 3, 0, 0, 1, 4
"d:\IDEWORK\lvmen\src\licensedcode\data\rules\proprietary-license_18.yml", "YAML", 0, 0, 0, 5, 0, 0, 1, 6
"d:\IDEWORK\lvmen\src\licensedcode\data\rules\proprietary-license_180.yml", "YAML", 0, 0, 0, 3, 0, 0, 1, 4
"d:\IDEWORK\lvmen\src\licensedcode\data\rules\proprietary-license_181.yml", "YAML", 0, 0, 0, 3, 0, 0, 1, 4
"d:\IDEWORK\lvmen\src\licensedcode\data\rules\proprietary-license_182.yml", "YAML", 0, 0, 0, 3, 0, 0, 1, 4
"d:\IDEWORK\lvmen\src\licensedcode\data\rules\proprietary-license_183.yml", "YAML", 0, 0, 0, 3, 0, 0, 1, 4
"d:\IDEWORK\lvmen\src\licensedcode\data\rules\proprietary-license_184.yml", "YAML", 0, 0, 0, 3, 0, 0, 1, 4
"d:\IDEWORK\lvmen\src\licensedcode\data\rules\proprietary-license_185.yml", "YAML", 0, 0, 0, 3, 0, 0, 1, 4
"d:\IDEWORK\lvmen\src\licensedcode\data\rules\proprietary-license_186.yml", "YAML", 0, 0, 0, 3, 0, 0, 1, 4
"d:\IDEWORK\lvmen\src\licensedcode\data\rules\proprietary-license_187.yml", "YAML", 0, 0, 0, 3, 0, 0, 1, 4
"d:\IDEWORK\lvmen\src\licensedcode\data\rules\proprietary-license_188.yml", "YAML", 0, 0, 0, 3, 0, 0, 1, 4
"d:\IDEWORK\lvmen\src\licensedcode\data\rules\proprietary-license_189.yml", "YAML", 0, 0, 0, 3, 0, 0, 1, 4
"d:\IDEWORK\lvmen\src\licensedcode\data\rules\proprietary-license_19.yml", "YAML", 0, 0, 0, 5, 0, 0, 1, 6
"d:\IDEWORK\lvmen\src\licensedcode\data\rules\proprietary-license_190.yml", "YAML", 0, 0, 0, 3, 0, 0, 1, 4
"d:\IDEWORK\lvmen\src\licensedcode\data\rules\proprietary-license_191.yml", "YAML", 0, 0, 0, 3, 0, 0, 1, 4
"d:\IDEWORK\lvmen\src\licensedcode\data\rules\proprietary-license_192.yml", "YAML", 0, 0, 0, 3, 0, 0, 1, 4
"d:\IDEWORK\lvmen\src\licensedcode\data\rules\proprietary-license_193.yml", "YAML", 0, 0, 0, 3, 0, 0, 1, 4
"d:\IDEWORK\lvmen\src\licensedcode\data\rules\proprietary-license_194.yml", "YAML", 0, 0, 0, 3, 0, 0, 1, 4
"d:\IDEWORK\lvmen\src\licensedcode\data\rules\proprietary-license_195.yml", "YAML", 0, 0, 0, 3, 0, 0, 1, 4
"d:\IDEWORK\lvmen\src\licensedcode\data\rules\proprietary-license_196.yml", "YAML", 0, 0, 0, 3, 0, 0, 1, 4
"d:\IDEWORK\lvmen\src\licensedcode\data\rules\proprietary-license_197.yml", "YAML", 0, 0, 0, 3, 0, 0, 1, 4
"d:\IDEWORK\lvmen\src\licensedcode\data\rules\proprietary-license_198.yml", "YAML", 0, 0, 0, 3, 0, 0, 1, 4
"d:\IDEWORK\lvmen\src\licensedcode\data\rules\proprietary-license_199.yml", "YAML", 0, 0, 0, 3, 0, 0, 1, 4
"d:\IDEWORK\lvmen\src\licensedcode\data\rules\proprietary-license_2.yml", "YAML", 0, 0, 0, 3, 0, 0, 1, 4
"d:\IDEWORK\lvmen\src\licensedcode\data\rules\proprietary-license_20.yml", "YAML", 0, 0, 0, 5, 0, 0, 1, 6
"d:\IDEWORK\lvmen\src\licensedcode\data\rules\proprietary-license_200.yml", "YAML", 0, 0, 0, 3, 0, 0, 1, 4
"d:\IDEWORK\lvmen\src\licensedcode\data\rules\proprietary-license_201.yml", "YAML", 0, 0, 0, 3, 0, 0, 1, 4
"d:\IDEWORK\lvmen\src\licensedcode\data\rules\proprietary-license_202.yml", "YAML", 0, 0, 0, 3, 0, 0, 1, 4
"d:\IDEWORK\lvmen\src\licensedcode\data\rules\proprietary-license_203.yml", "YAML", 0, 0, 0, 3, 0, 0, 1, 4
"d:\IDEWORK\lvmen\src\licensedcode\data\rules\proprietary-license_204.yml", "YAML", 0, 0, 0, 3, 0, 0, 1, 4
"d:\IDEWORK\lvmen\src\licensedcode\data\rules\proprietary-license_205.yml", "YAML", 0, 0, 0, 3, 0, 0, 1, 4
"d:\IDEWORK\lvmen\src\licensedcode\data\rules\proprietary-license_206.yml", "YAML", 0, 0, 0, 3, 0, 0, 1, 4
"d:\IDEWORK\lvmen\src\licensedcode\data\rules\proprietary-license_207.yml", "YAML", 0, 0, 0, 3, 0, 0, 1, 4
"d:\IDEWORK\lvmen\src\licensedcode\data\rules\proprietary-license_208.yml", "YAML", 0, 0, 0, 3, 0, 0, 1, 4
"d:\IDEWORK\lvmen\src\licensedcode\data\rules\proprietary-license_209.yml", "YAML", 0, 0, 0, 3, 0, 0, 1, 4
"d:\IDEWORK\lvmen\src\licensedcode\data\rules\proprietary-license_21.yml", "YAML", 0, 0, 0, 5, 0, 0, 1, 6
"d:\IDEWORK\lvmen\src\licensedcode\data\rules\proprietary-license_210.yml", "YAML", 0, 0, 0, 3, 0, 0, 1, 4
"d:\IDEWORK\lvmen\src\licensedcode\data\rules\proprietary-license_211.yml", "YAML", 0, 0, 0, 3, 0, 0, 1, 4
"d:\IDEWORK\lvmen\src\licensedcode\data\rules\proprietary-license_212.yml", "YAML", 0, 0, 0, 3, 0, 0, 1, 4
"d:\IDEWORK\lvmen\src\licensedcode\data\rules\proprietary-license_213.yml", "YAML", 0, 0, 0, 3, 0, 0, 1, 4
"d:\IDEWORK\lvmen\src\licensedcode\data\rules\proprietary-license_214.yml", "YAML", 0, 0, 0, 3, 0, 0, 1, 4
"d:\IDEWORK\lvmen\src\licensedcode\data\rules\proprietary-license_215.yml", "YAML", 0, 0, 0, 3, 0, 0, 1, 4
"d:\IDEWORK\lvmen\src\licensedcode\data\rules\proprietary-license_216.yml", "YAML", 0, 0, 0, 3, 0, 0, 1, 4
"d:\IDEWORK\lvmen\src\licensedcode\data\rules\proprietary-license_217.yml", "YAML", 0, 0, 0, 3, 0, 0, 1, 4
"d:\IDEWORK\lvmen\src\licensedcode\data\rules\proprietary-license_218.yml", "YAML", 0, 0, 0, 3, 0, 0, 1, 4
"d:\IDEWORK\lvmen\src\licensedcode\data\rules\proprietary-license_219.yml", "YAML", 0, 0, 0, 3, 0, 0, 1, 4
"d:\IDEWORK\lvmen\src\licensedcode\data\rules\proprietary-license_22.yml", "YAML", 0, 0, 0, 5, 0, 0, 1, 6
"d:\IDEWORK\lvmen\src\licensedcode\data\rules\proprietary-license_220.yml", "YAML", 0, 0, 0, 3, 0, 0, 1, 4
"d:\IDEWORK\lvmen\src\licensedcode\data\rules\proprietary-license_221.yml", "YAML", 0, 0, 0, 3, 0, 0, 1, 4
"d:\IDEWORK\lvmen\src\licensedcode\data\rules\proprietary-license_222.yml", "YAML", 0, 0, 0, 3, 0, 0, 1, 4
"d:\IDEWORK\lvmen\src\licensedcode\data\rules\proprietary-license_223.yml", "YAML", 0, 0, 0, 3, 0, 0, 1, 4
"d:\IDEWORK\lvmen\src\licensedcode\data\rules\proprietary-license_224.yml", "YAML", 0, 0, 0, 3, 0, 0, 1, 4
"d:\IDEWORK\lvmen\src\licensedcode\data\rules\proprietary-license_225.yml", "YAML", 0, 0, 0, 3, 0, 0, 1, 4
"d:\IDEWORK\lvmen\src\licensedcode\data\rules\proprietary-license_226.yml", "YAML", 0, 0, 0, 3, 0, 0, 1, 4
"d:\IDEWORK\lvmen\src\licensedcode\data\rules\proprietary-license_227.yml", "YAML", 0, 0, 0, 3, 0, 0, 1, 4
"d:\IDEWORK\lvmen\src\licensedcode\data\rules\proprietary-license_228.yml", "YAML", 0, 0, 0, 3, 0, 0, 1, 4
"d:\IDEWORK\lvmen\src\licensedcode\data\rules\proprietary-license_229.yml", "YAML", 0, 0, 0, 3, 0, 0, 1, 4
"d:\IDEWORK\lvmen\src\licensedcode\data\rules\proprietary-license_23.yml", "YAML", 0, 0, 0, 5, 0, 0, 1, 6
"d:\IDEWORK\lvmen\src\licensedcode\data\rules\proprietary-license_230.yml", "YAML", 0, 0, 0, 3, 0, 0, 1, 4
"d:\IDEWORK\lvmen\src\licensedcode\data\rules\proprietary-license_231.yml", "YAML", 0, 0, 0, 3, 0, 0, 1, 4
"d:\IDEWORK\lvmen\src\licensedcode\data\rules\proprietary-license_232.yml", "YAML", 0, 0, 0, 3, 0, 0, 1, 4
"d:\IDEWORK\lvmen\src\licensedcode\data\rules\proprietary-license_233.yml", "YAML", 0, 0, 0, 3, 0, 0, 1, 4
"d:\IDEWORK\lvmen\src\licensedcode\data\rules\proprietary-license_234.yml", "YAML", 0, 0, 0, 3, 0, 0, 1, 4
"d:\IDEWORK\lvmen\src\licensedcode\data\rules\proprietary-license_235.yml", "YAML", 0, 0, 0, 3, 0, 0, 1, 4
"d:\IDEWORK\lvmen\src\licensedcode\data\rules\proprietary-license_236.yml", "YAML", 0, 0, 0, 3, 0, 0, 1, 4
"d:\IDEWORK\lvmen\src\licensedcode\data\rules\proprietary-license_237.yml", "YAML", 0, 0, 0, 3, 0, 0, 1, 4
"d:\IDEWORK\lvmen\src\licensedcode\data\rules\proprietary-license_238.yml", "YAML", 0, 0, 0, 3, 0, 0, 1, 4
"d:\IDEWORK\lvmen\src\licensedcode\data\rules\proprietary-license_239.yml", "YAML", 0, 0, 0, 3, 0, 0, 1, 4
"d:\IDEWORK\lvmen\src\licensedcode\data\rules\proprietary-license_24.yml", "YAML", 0, 0, 0, 5, 0, 0, 1, 6
"d:\IDEWORK\lvmen\src\licensedcode\data\rules\proprietary-license_240.yml", "YAML", 0, 0, 0, 3, 0, 0, 1, 4
"d:\IDEWORK\lvmen\src\licensedcode\data\rules\proprietary-license_241.yml", "YAML", 0, 0, 0, 3, 0, 0, 1, 4
"d:\IDEWORK\lvmen\src\licensedcode\data\rules\proprietary-license_242.yml", "YAML", 0, 0, 0, 3, 0, 0, 1, 4
"d:\IDEWORK\lvmen\src\licensedcode\data\rules\proprietary-license_243.yml", "YAML", 0, 0, 0, 3, 0, 0, 1, 4
"d:\IDEWORK\lvmen\src\licensedcode\data\rules\proprietary-license_244.yml", "YAML", 0, 0, 0, 3, 0, 0, 1, 4
"d:\IDEWORK\lvmen\src\licensedcode\data\rules\proprietary-license_245.yml", "YAML", 0, 0, 0, 3, 0, 0, 1, 4
"d:\IDEWORK\lvmen\src\licensedcode\data\rules\proprietary-license_246.yml", "YAML", 0, 0, 0, 9, 0, 0, 1, 10
"d:\IDEWORK\lvmen\src\licensedcode\data\rules\proprietary-license_247.yml", "YAML", 0, 0, 0, 5, 0, 0, 1, 6
"d:\IDEWORK\lvmen\src\licensedcode\data\rules\proprietary-license_248.yml", "YAML", 0, 0, 0, 3, 0, 0, 1, 4
"d:\IDEWORK\lvmen\src\licensedcode\data\rules\proprietary-license_249.yml", "YAML", 0, 0, 0, 3, 0, 0, 1, 4
"d:\IDEWORK\lvmen\src\licensedcode\data\rules\proprietary-license_25.yml", "YAML", 0, 0, 0, 5, 0, 0, 1, 6
"d:\IDEWORK\lvmen\src\licensedcode\data\rules\proprietary-license_250.yml", "YAML", 0, 0, 0, 3, 0, 0, 1, 4
"d:\IDEWORK\lvmen\src\licensedcode\data\rules\proprietary-license_251.yml", "YAML", 0, 0, 0, 3, 0, 0, 1, 4
"d:\IDEWORK\lvmen\src\licensedcode\data\rules\proprietary-license_252.yml", "YAML", 0, 0, 0, 3, 0, 0, 1, 4
"d:\IDEWORK\lvmen\src\licensedcode\data\rules\proprietary-license_253.yml", "YAML", 0, 0, 0, 3, 0, 0, 1, 4
"d:\IDEWORK\lvmen\src\licensedcode\data\rules\proprietary-license_254.yml", "YAML", 0, 0, 0, 3, 0, 0, 1, 4
"d:\IDEWORK\lvmen\src\licensedcode\data\rules\proprietary-license_255.yml", "YAML", 0, 0, 0, 3, 0, 0, 1, 4
"d:\IDEWORK\lvmen\src\licensedcode\data\rules\proprietary-license_256.yml", "YAML", 0, 0, 0, 3, 0, 0, 1, 4
"d:\IDEWORK\lvmen\src\licensedcode\data\rules\proprietary-license_257.yml", "YAML", 0, 0, 0, 3, 0, 0, 1, 4
"d:\IDEWORK\lvmen\src\licensedcode\data\rules\proprietary-license_258.yml", "YAML", 0, 0, 0, 3, 0, 0, 1, 4
"d:\IDEWORK\lvmen\src\licensedcode\data\rules\proprietary-license_259.yml", "YAML", 0, 0, 0, 3, 0, 0, 1, 4
"d:\IDEWORK\lvmen\src\licensedcode\data\rules\proprietary-license_26.yml", "YAML", 0, 0, 0, 5, 0, 0, 1, 6
"d:\IDEWORK\lvmen\src\licensedcode\data\rules\proprietary-license_260.yml", "YAML", 0, 0, 0, 3, 0, 0, 1, 4
"d:\IDEWORK\lvmen\src\licensedcode\data\rules\proprietary-license_261.yml", "YAML", 0, 0, 0, 3, 0, 0, 1, 4
"d:\IDEWORK\lvmen\src\licensedcode\data\rules\proprietary-license_262.yml", "YAML", 0, 0, 0, 3, 0, 0, 1, 4
"d:\IDEWORK\lvmen\src\licensedcode\data\rules\proprietary-license_263.yml", "YAML", 0, 0, 0, 3, 0, 0, 1, 4
"d:\IDEWORK\lvmen\src\licensedcode\data\rules\proprietary-license_264.yml", "YAML", 0, 0, 0, 3, 0, 0, 1, 4
"d:\IDEWORK\lvmen\src\licensedcode\data\rules\proprietary-license_265.yml", "YAML", 0, 0, 0, 3, 0, 0, 1, 4
"d:\IDEWORK\lvmen\src\licensedcode\data\rules\proprietary-license_266.yml", "YAML", 0, 0, 0, 3, 0, 0, 1, 4
"d:\IDEWORK\lvmen\src\licensedcode\data\rules\proprietary-license_267.yml", "YAML", 0, 0, 0, 3, 0, 0, 1, 4
"d:\IDEWORK\lvmen\src\licensedcode\data\rules\proprietary-license_268.yml", "YAML", 0, 0, 0, 3, 0, 0, 1, 4
"d:\IDEWORK\lvmen\src\licensedcode\data\rules\proprietary-license_269.yml", "YAML", 0, 0, 0, 3, 0, 0, 1, 4
"d:\IDEWORK\lvmen\src\licensedcode\data\rules\proprietary-license_27.yml", "YAML", 0, 0, 0, 5, 0, 0, 1, 6
"d:\IDEWORK\lvmen\src\licensedcode\data\rules\proprietary-license_270.yml", "YAML", 0, 0, 0, 3, 0, 0, 1, 4
"d:\IDEWORK\lvmen\src\licensedcode\data\rules\proprietary-license_271.yml", "YAML", 0, 0, 0, 3, 0, 0, 1, 4
"d:\IDEWORK\lvmen\src\licensedcode\data\rules\proprietary-license_272.yml", "YAML", 0, 0, 0, 3, 0, 0, 1, 4
"d:\IDEWORK\lvmen\src\licensedcode\data\rules\proprietary-license_273.yml", "YAML", 0, 0, 0, 3, 0, 0, 1, 4
"d:\IDEWORK\lvmen\src\licensedcode\data\rules\proprietary-license_274.yml", "YAML", 0, 0, 0, 3, 0, 0, 1, 4
"d:\IDEWORK\lvmen\src\licensedcode\data\rules\proprietary-license_275.yml", "YAML", 0, 0, 0, 3, 0, 0, 1, 4
"d:\IDEWORK\lvmen\src\licensedcode\data\rules\proprietary-license_276.yml", "YAML", 0, 0, 0, 3, 0, 0, 1, 4
"d:\IDEWORK\lvmen\src\licensedcode\data\rules\proprietary-license_277.yml", "YAML", 0, 0, 0, 3, 0, 0, 1, 4
"d:\IDEWORK\lvmen\src\licensedcode\data\rules\proprietary-license_278.yml", "YAML", 0, 0, 0, 3, 0, 0, 1, 4
"d:\IDEWORK\lvmen\src\licensedcode\data\rules\proprietary-license_279.yml", "YAML", 0, 0, 0, 10, 0, 0, 1, 11
"d:\IDEWORK\lvmen\src\licensedcode\data\rules\proprietary-license_28.yml", "YAML", 0, 0, 0, 5, 0, 0, 1, 6
"d:\IDEWORK\lvmen\src\licensedcode\data\rules\proprietary-license_280.yml", "YAML", 0, 0, 0, 6, 0, 0, 1, 7
"d:\IDEWORK\lvmen\src\licensedcode\data\rules\proprietary-license_281.yml", "YAML", 0, 0, 0, 3, 0, 0, 1, 4
"d:\IDEWORK\lvmen\src\licensedcode\data\rules\proprietary-license_282.yml", "YAML", 0, 0, 0, 3, 0, 0, 1, 4
"d:\IDEWORK\lvmen\src\licensedcode\data\rules\proprietary-license_283.yml", "YAML", 0, 0, 0, 4, 0, 0, 1, 5
"d:\IDEWORK\lvmen\src\licensedcode\data\rules\proprietary-license_284.yml", "YAML", 0, 0, 0, 4, 0, 0, 1, 5
"d:\IDEWORK\lvmen\src\licensedcode\data\rules\proprietary-license_285.yml", "YAML", 0, 0, 0, 7, 0, 0, 1, 8
"d:\IDEWORK\lvmen\src\licensedcode\data\rules\proprietary-license_286.yml", "YAML", 0, 0, 0, 3, 0, 0, 1, 4
"d:\IDEWORK\lvmen\src\licensedcode\data\rules\proprietary-license_287.yml", "YAML", 0, 0, 0, 3, 0, 0, 1, 4
"d:\IDEWORK\lvmen\src\licensedcode\data\rules\proprietary-license_288.yml", "YAML", 0, 0, 0, 6, 0, 0, 1, 7
"d:\IDEWORK\lvmen\src\licensedcode\data\rules\proprietary-license_289.yml", "YAML", 0, 0, 0, 5, 0, 0, 1, 6
"d:\IDEWORK\lvmen\src\licensedcode\data\rules\proprietary-license_29.yml", "YAML", 0, 0, 0, 5, 0, 0, 1, 6
"d:\IDEWORK\lvmen\src\licensedcode\data\rules\proprietary-license_290.yml", "YAML", 0, 0, 0, 5, 0, 0, 1, 6
"d:\IDEWORK\lvmen\src\licensedcode\data\rules\proprietary-license_291.yml", "YAML", 0, 0, 0, 4, 0, 0, 1, 5
"d:\IDEWORK\lvmen\src\licensedcode\data\rules\proprietary-license_292.yml", "YAML", 0, 0, 0, 3, 0, 0, 1, 4
"d:\IDEWORK\lvmen\src\licensedcode\data\rules\proprietary-license_293.yml", "YAML", 0, 0, 0, 5, 0, 0, 1, 6
"d:\IDEWORK\lvmen\src\licensedcode\data\rules\proprietary-license_294.yml", "YAML", 0, 0, 0, 3, 0, 0, 1, 4
"d:\IDEWORK\lvmen\src\licensedcode\data\rules\proprietary-license_295.yml", "YAML", 0, 0, 0, 4, 0, 0, 1, 5
"d:\IDEWORK\lvmen\src\licensedcode\data\rules\proprietary-license_296.yml", "YAML", 0, 0, 0, 6, 0, 0, 1, 7
"d:\IDEWORK\lvmen\src\licensedcode\data\rules\proprietary-license_297.yml", "YAML", 0, 0, 0, 3, 0, 0, 1, 4
"d:\IDEWORK\lvmen\src\licensedcode\data\rules\proprietary-license_298.yml", "YAML", 0, 0, 0, 3, 0, 0, 1, 4
"d:\IDEWORK\lvmen\src\licensedcode\data\rules\proprietary-license_299.yml", "YAML", 0, 0, 0, 3, 0, 0, 1, 4
"d:\IDEWORK\lvmen\src\licensedcode\data\rules\proprietary-license_3.yml", "YAML", 0, 0, 0, 3, 0, 0, 1, 4
"d:\IDEWORK\lvmen\src\licensedcode\data\rules\proprietary-license_30.yml", "YAML", 0, 0, 0, 5, 0, 0, 1, 6
"d:\IDEWORK\lvmen\src\licensedcode\data\rules\proprietary-license_300.yml", "YAML", 0, 0, 0, 3, 0, 0, 1, 4
"d:\IDEWORK\lvmen\src\licensedcode\data\rules\proprietary-license_301.yml", "YAML", 0, 0, 0, 7, 0, 0, 1, 8
"d:\IDEWORK\lvmen\src\licensedcode\data\rules\proprietary-license_302.yml", "YAML", 0, 0, 0, 10, 0, 0, 1, 11
"d:\IDEWORK\lvmen\src\licensedcode\data\rules\proprietary-license_303.yml", "YAML", 0, 0, 0, 11, 0, 0, 1, 12
"d:\IDEWORK\lvmen\src\licensedcode\data\rules\proprietary-license_304.yml", "YAML", 0, 0, 0, 6, 0, 0, 1, 7
"d:\IDEWORK\lvmen\src\licensedcode\data\rules\proprietary-license_305.yml", "YAML", 0, 0, 0, 5, 0, 0, 1, 6
"d:\IDEWORK\lvmen\src\licensedcode\data\rules\proprietary-license_306.yml", "YAML", 0, 0, 0, 3, 0, 0, 1, 4
"d:\IDEWORK\lvmen\src\licensedcode\data\rules\proprietary-license_307.yml", "YAML", 0, 0, 0, 3, 0, 0, 1, 4
"d:\IDEWORK\lvmen\src\licensedcode\data\rules\proprietary-license_308.yml", "YAML", 0, 0, 0, 3, 0, 0, 1, 4
"d:\IDEWORK\lvmen\src\licensedcode\data\rules\proprietary-license_309.yml", "YAML", 0, 0, 0, 3, 0, 0, 1, 4
"d:\IDEWORK\lvmen\src\licensedcode\data\rules\proprietary-license_31.yml", "YAML", 0, 0, 0, 5, 0, 0, 1, 6
"d:\IDEWORK\lvmen\src\licensedcode\data\rules\proprietary-license_310.yml", "YAML", 0, 0, 0, 3, 0, 0, 1, 4
"d:\IDEWORK\lvmen\src\licensedcode\data\rules\proprietary-license_311.yml", "YAML", 0, 0, 0, 3, 0, 0, 1, 4
"d:\IDEWORK\lvmen\src\licensedcode\data\rules\proprietary-license_312.yml", "YAML", 0, 0, 0, 3, 0, 0, 1, 4
"d:\IDEWORK\lvmen\src\licensedcode\data\rules\proprietary-license_313.yml", "YAML", 0, 0, 0, 3, 0, 0, 1, 4
"d:\IDEWORK\lvmen\src\licensedcode\data\rules\proprietary-license_314.yml", "YAML", 0, 0, 0, 3, 0, 0, 1, 4
"d:\IDEWORK\lvmen\src\licensedcode\data\rules\proprietary-license_315.yml", "YAML", 0, 0, 0, 3, 0, 0, 1, 4
"d:\IDEWORK\lvmen\src\licensedcode\data\rules\proprietary-license_316.yml", "YAML", 0, 0, 0, 3, 0, 0, 1, 4
"d:\IDEWORK\lvmen\src\licensedcode\data\rules\proprietary-license_317.yml", "YAML", 0, 0, 0, 3, 0, 0, 1, 4
"d:\IDEWORK\lvmen\src\licensedcode\data\rules\proprietary-license_318.yml", "YAML", 0, 0, 0, 3, 0, 0, 1, 4
"d:\IDEWORK\lvmen\src\licensedcode\data\rules\proprietary-license_319.yml", "YAML", 0, 0, 0, 6, 0, 0, 1, 7
"d:\IDEWORK\lvmen\src\licensedcode\data\rules\proprietary-license_32.yml", "YAML", 0, 0, 0, 5, 0, 0, 1, 6
"d:\IDEWORK\lvmen\src\licensedcode\data\rules\proprietary-license_320.yml", "YAML", 0, 0, 0, 3, 0, 0, 1, 4
"d:\IDEWORK\lvmen\src\licensedcode\data\rules\proprietary-license_321.yml", "YAML", 0, 0, 0, 3, 0, 0, 1, 4
"d:\IDEWORK\lvmen\src\licensedcode\data\rules\proprietary-license_322.yml", "YAML", 0, 0, 0, 3, 0, 0, 1, 4
"d:\IDEWORK\lvmen\src\licensedcode\data\rules\proprietary-license_323.yml", "YAML", 0, 0, 0, 3, 0, 0, 1, 4
"d:\IDEWORK\lvmen\src\licensedcode\data\rules\proprietary-license_324.yml", "YAML", 0, 0, 0, 3, 0, 0, 1, 4
"d:\IDEWORK\lvmen\src\licensedcode\data\rules\proprietary-license_325.yml", "YAML", 0, 0, 0, 5, 0, 0, 1, 6
"d:\IDEWORK\lvmen\src\licensedcode\data\rules\proprietary-license_326.yml", "YAML", 0, 0, 0, 3, 0, 0, 1, 4
"d:\IDEWORK\lvmen\src\licensedcode\data\rules\proprietary-license_327.yml", "YAML", 0, 0, 0, 3, 0, 0, 1, 4
"d:\IDEWORK\lvmen\src\licensedcode\data\rules\proprietary-license_328.yml", "YAML", 0, 0, 0, 5, 0, 0, 1, 6
"d:\IDEWORK\lvmen\src\licensedcode\data\rules\proprietary-license_329.yml", "YAML", 0, 0, 0, 3, 0, 0, 1, 4
"d:\IDEWORK\lvmen\src\licensedcode\data\rules\proprietary-license_33.yml", "YAML", 0, 0, 0, 5, 0, 0, 1, 6
"d:\IDEWORK\lvmen\src\licensedcode\data\rules\proprietary-license_330.yml", "YAML", 0, 0, 0, 3, 0, 0, 1, 4
"d:\IDEWORK\lvmen\src\licensedcode\data\rules\proprietary-license_331.yml", "YAML", 0, 0, 0, 3, 0, 0, 1, 4
"d:\IDEWORK\lvmen\src\licensedcode\data\rules\proprietary-license_332.yml", "YAML", 0, 0, 0, 3, 0, 0, 1, 4
"d:\IDEWORK\lvmen\src\licensedcode\data\rules\proprietary-license_333.yml", "YAML", 0, 0, 0, 3, 0, 0, 1, 4
"d:\IDEWORK\lvmen\src\licensedcode\data\rules\proprietary-license_334.yml", "YAML", 0, 0, 0, 3, 0, 0, 1, 4
"d:\IDEWORK\lvmen\src\licensedcode\data\rules\proprietary-license_335.yml", "YAML", 0, 0, 0, 3, 0, 0, 1, 4
"d:\IDEWORK\lvmen\src\licensedcode\data\rules\proprietary-license_336.yml", "YAML", 0, 0, 0, 2, 0, 0, 1, 3
"d:\IDEWORK\lvmen\src\licensedcode\data\rules\proprietary-license_337.yml", "YAML", 0, 0, 0, 3, 0, 0, 1, 4
"d:\IDEWORK\lvmen\src\licensedcode\data\rules\proprietary-license_338.yml", "YAML", 0, 0, 0, 3, 0, 0, 1, 4
"d:\IDEWORK\lvmen\src\licensedcode\data\rules\proprietary-license_339.yml", "YAML", 0, 0, 0, 3, 0, 0, 1, 4
"d:\IDEWORK\lvmen\src\licensedcode\data\rules\proprietary-license_34.yml", "YAML", 0, 0, 0, 5, 0, 0, 1, 6
"d:\IDEWORK\lvmen\src\licensedcode\data\rules\proprietary-license_340.yml", "YAML", 0, 0, 0, 3, 0, 0, 1, 4
"d:\IDEWORK\lvmen\src\licensedcode\data\rules\proprietary-license_341.yml", "YAML", 0, 0, 0, 3, 0, 0, 1, 4
"d:\IDEWORK\lvmen\src\licensedcode\data\rules\proprietary-license_342.yml", "YAML", 0, 0, 0, 5, 0, 0, 1, 6
"d:\IDEWORK\lvmen\src\licensedcode\data\rules\proprietary-license_343.yml", "YAML", 0, 0, 0, 5, 0, 0, 1, 6
"d:\IDEWORK\lvmen\src\licensedcode\data\rules\proprietary-license_344.yml", "YAML", 0, 0, 0, 5, 0, 0, 1, 6
"d:\IDEWORK\lvmen\src\licensedcode\data\rules\proprietary-license_345.yml", "YAML", 0, 0, 0, 3, 0, 0, 1, 4
"d:\IDEWORK\lvmen\src\licensedcode\data\rules\proprietary-license_346.yml", "YAML", 0, 0, 0, 3, 0, 0, 1, 4
"d:\IDEWORK\lvmen\src\licensedcode\data\rules\proprietary-license_347.yml", "YAML", 0, 0, 0, 4, 0, 0, 1, 5
"d:\IDEWORK\lvmen\src\licensedcode\data\rules\proprietary-license_348.yml", "YAML", 0, 0, 0, 4, 0, 0, 1, 5
"d:\IDEWORK\lvmen\src\licensedcode\data\rules\proprietary-license_349.yml", "YAML", 0, 0, 0, 4, 0, 0, 1, 5
"d:\IDEWORK\lvmen\src\licensedcode\data\rules\proprietary-license_35.yml", "YAML", 0, 0, 0, 5, 0, 0, 1, 6
"d:\IDEWORK\lvmen\src\licensedcode\data\rules\proprietary-license_350.yml", "YAML", 0, 0, 0, 4, 0, 0, 1, 5
"d:\IDEWORK\lvmen\src\licensedcode\data\rules\proprietary-license_351.yml", "YAML", 0, 0, 0, 4, 0, 0, 1, 5
"d:\IDEWORK\lvmen\src\licensedcode\data\rules\proprietary-license_352.yml", "YAML", 0, 0, 0, 4, 0, 0, 1, 5
"d:\IDEWORK\lvmen\src\licensedcode\data\rules\proprietary-license_353.yml", "YAML", 0, 0, 0, 4, 0, 0, 1, 5
"d:\IDEWORK\lvmen\src\licensedcode\data\rules\proprietary-license_354.yml", "YAML", 0, 0, 0, 4, 0, 0, 1, 5
"d:\IDEWORK\lvmen\src\licensedcode\data\rules\proprietary-license_355.yml", "YAML", 0, 0, 0, 4, 0, 0, 1, 5
"d:\IDEWORK\lvmen\src\licensedcode\data\rules\proprietary-license_356.yml", "YAML", 0, 0, 0, 4, 0, 0, 1, 5
"d:\IDEWORK\lvmen\src\licensedcode\data\rules\proprietary-license_357.yml", "YAML", 0, 0, 0, 4, 0, 0, 1, 5
"d:\IDEWORK\lvmen\src\licensedcode\data\rules\proprietary-license_358.yml", "YAML", 0, 0, 0, 5, 0, 0, 1, 6
"d:\IDEWORK\lvmen\src\licensedcode\data\rules\proprietary-license_359.yml", "YAML", 0, 0, 0, 5, 0, 0, 1, 6
"d:\IDEWORK\lvmen\src\licensedcode\data\rules\proprietary-license_36.yml", "YAML", 0, 0, 0, 5, 0, 0, 1, 6
"d:\IDEWORK\lvmen\src\licensedcode\data\rules\proprietary-license_360.yml", "YAML", 0, 0, 0, 5, 0, 0, 1, 6
"d:\IDEWORK\lvmen\src\licensedcode\data\rules\proprietary-license_361.yml", "YAML", 0, 0, 0, 3, 0, 0, 1, 4
"d:\IDEWORK\lvmen\src\licensedcode\data\rules\proprietary-license_362.yml", "YAML", 0, 0, 0, 3, 0, 0, 1, 4
"d:\IDEWORK\lvmen\src\licensedcode\data\rules\proprietary-license_363.yml", "YAML", 0, 0, 0, 3, 0, 0, 1, 4
"d:\IDEWORK\lvmen\src\licensedcode\data\rules\proprietary-license_364.yml", "YAML", 0, 0, 0, 5, 0, 0, 1, 6
"d:\IDEWORK\lvmen\src\licensedcode\data\rules\proprietary-license_365.yml", "YAML", 0, 0, 0, 5, 0, 0, 1, 6
"d:\IDEWORK\lvmen\src\licensedcode\data\rules\proprietary-license_366.yml", "YAML", 0, 0, 0, 5, 0, 0, 1, 6
"d:\IDEWORK\lvmen\src\licensedcode\data\rules\proprietary-license_367.yml", "YAML", 0, 0, 0, 4, 0, 0, 1, 5
"d:\IDEWORK\lvmen\src\licensedcode\data\rules\proprietary-license_368.yml", "YAML", 0, 0, 0, 4, 0, 0, 1, 5
"d:\IDEWORK\lvmen\src\licensedcode\data\rules\proprietary-license_369.yml", "YAML", 0, 0, 0, 4, 0, 0, 1, 5
"d:\IDEWORK\lvmen\src\licensedcode\data\rules\proprietary-license_37.yml", "YAML", 0, 0, 0, 5, 0, 0, 1, 6
"d:\IDEWORK\lvmen\src\licensedcode\data\rules\proprietary-license_370.yml", "YAML", 0, 0, 0, 3, 0, 0, 1, 4
"d:\IDEWORK\lvmen\src\licensedcode\data\rules\proprietary-license_371.yml", "YAML", 0, 0, 0, 3, 0, 0, 1, 4
"d:\IDEWORK\lvmen\src\licensedcode\data\rules\proprietary-license_372.yml", "YAML", 0, 0, 0, 4, 0, 0, 1, 5
"d:\IDEWORK\lvmen\src\licensedcode\data\rules\proprietary-license_373.yml", "YAML", 0, 0, 0, 4, 0, 0, 1, 5
"d:\IDEWORK\lvmen\src\licensedcode\data\rules\proprietary-license_374.yml", "YAML", 0, 0, 0, 3, 0, 0, 1, 4
"d:\IDEWORK\lvmen\src\licensedcode\data\rules\proprietary-license_375.yml", "YAML", 0, 0, 0, 8, 0, 0, 1, 9
"d:\IDEWORK\lvmen\src\licensedcode\data\rules\proprietary-license_376.yml", "YAML", 0, 0, 0, 6, 0, 0, 1, 7
"d:\IDEWORK\lvmen\src\licensedcode\data\rules\proprietary-license_377.yml", "YAML", 0, 0, 0, 6, 0, 0, 1, 7
"d:\IDEWORK\lvmen\src\licensedcode\data\rules\proprietary-license_378.yml", "YAML", 0, 0, 0, 6, 0, 0, 1, 7
"d:\IDEWORK\lvmen\src\licensedcode\data\rules\proprietary-license_379.yml", "YAML", 0, 0, 0, 4, 0, 0, 1, 5
"d:\IDEWORK\lvmen\src\licensedcode\data\rules\proprietary-license_38.yml", "YAML", 0, 0, 0, 5, 0, 0, 1, 6
"d:\IDEWORK\lvmen\src\licensedcode\data\rules\proprietary-license_380.yml", "YAML", 0, 0, 0, 4, 0, 0, 1, 5
"d:\IDEWORK\lvmen\src\licensedcode\data\rules\proprietary-license_381.yml", "YAML", 0, 0, 0, 4, 0, 0, 1, 5
"d:\IDEWORK\lvmen\src\licensedcode\data\rules\proprietary-license_382.yml", "YAML", 0, 0, 0, 3, 0, 0, 1, 4
"d:\IDEWORK\lvmen\src\licensedcode\data\rules\proprietary-license_383.yml", "YAML", 0, 0, 0, 3, 0, 0, 1, 4
"d:\IDEWORK\lvmen\src\licensedcode\data\rules\proprietary-license_384.yml", "YAML", 0, 0, 0, 6, 0, 0, 1, 7
"d:\IDEWORK\lvmen\src\licensedcode\data\rules\proprietary-license_385.yml", "YAML", 0, 0, 0, 3, 0, 0, 1, 4
"d:\IDEWORK\lvmen\src\licensedcode\data\rules\proprietary-license_386.yml", "YAML", 0, 0, 0, 4, 0, 0, 1, 5
"d:\IDEWORK\lvmen\src\licensedcode\data\rules\proprietary-license_387.yml", "YAML", 0, 0, 0, 4, 0, 0, 1, 5
"d:\IDEWORK\lvmen\src\licensedcode\data\rules\proprietary-license_388.yml", "YAML", 0, 0, 0, 4, 0, 0, 1, 5
"d:\IDEWORK\lvmen\src\licensedcode\data\rules\proprietary-license_389.yml", "YAML", 0, 0, 0, 6, 0, 0, 1, 7
"d:\IDEWORK\lvmen\src\licensedcode\data\rules\proprietary-license_39.yml", "YAML", 0, 0, 0, 5, 0, 0, 1, 6
"d:\IDEWORK\lvmen\src\licensedcode\data\rules\proprietary-license_390.yml", "YAML", 0, 0, 0, 5, 0, 0, 1, 6
"d:\IDEWORK\lvmen\src\licensedcode\data\rules\proprietary-license_391.yml", "YAML", 0, 0, 0, 5, 0, 0, 1, 6
"d:\IDEWORK\lvmen\src\licensedcode\data\rules\proprietary-license_392.yml", "YAML", 0, 0, 0, 5, 0, 0, 1, 6
"d:\IDEWORK\lvmen\src\licensedcode\data\rules\proprietary-license_393.yml", "YAML", 0, 0, 0, 5, 0, 0, 1, 6
"d:\IDEWORK\lvmen\src\licensedcode\data\rules\proprietary-license_394.yml", "YAML", 0, 0, 0, 5, 0, 0, 1, 6
"d:\IDEWORK\lvmen\src\licensedcode\data\rules\proprietary-license_395.yml", "YAML", 0, 0, 0, 5, 0, 0, 1, 6
"d:\IDEWORK\lvmen\src\licensedcode\data\rules\proprietary-license_396.yml", "YAML", 0, 0, 0, 5, 0, 0, 1, 6
"d:\IDEWORK\lvmen\src\licensedcode\data\rules\proprietary-license_397.yml", "YAML", 0, 0, 0, 5, 0, 0, 1, 6
"d:\IDEWORK\lvmen\src\licensedcode\data\rules\proprietary-license_398.yml", "YAML", 0, 0, 0, 5, 0, 0, 1, 6
"d:\IDEWORK\lvmen\src\licensedcode\data\rules\proprietary-license_399.yml", "YAML", 0, 0, 0, 5, 0, 0, 1, 6
"d:\IDEWORK\lvmen\src\licensedcode\data\rules\proprietary-license_4.yml", "YAML", 0, 0, 0, 3, 0, 0, 1, 4
"d:\IDEWORK\lvmen\src\licensedcode\data\rules\proprietary-license_40.yml", "YAML", 0, 0, 0, 5, 0, 0, 1, 6
"d:\IDEWORK\lvmen\src\licensedcode\data\rules\proprietary-license_400.yml", "YAML", 0, 0, 0, 5, 0, 0, 1, 6
"d:\IDEWORK\lvmen\src\licensedcode\data\rules\proprietary-license_401.yml", "YAML", 0, 0, 0, 4, 0, 0, 1, 5
"d:\IDEWORK\lvmen\src\licensedcode\data\rules\proprietary-license_402.yml", "YAML", 0, 0, 0, 4, 0, 0, 1, 5
"d:\IDEWORK\lvmen\src\licensedcode\data\rules\proprietary-license_403.yml", "YAML", 0, 0, 0, 4, 0, 0, 1, 5
"d:\IDEWORK\lvmen\src\licensedcode\data\rules\proprietary-license_404.yml", "YAML", 0, 0, 0, 4, 0, 0, 1, 5
"d:\IDEWORK\lvmen\src\licensedcode\data\rules\proprietary-license_405.yml", "YAML", 0, 0, 0, 4, 0, 0, 1, 5
"d:\IDEWORK\lvmen\src\licensedcode\data\rules\proprietary-license_406.yml", "YAML", 0, 0, 0, 4, 0, 0, 1, 5
"d:\IDEWORK\lvmen\src\licensedcode\data\rules\proprietary-license_407.yml", "YAML", 0, 0, 0, 4, 0, 0, 1, 5
"d:\IDEWORK\lvmen\src\licensedcode\data\rules\proprietary-license_408.yml", "YAML", 0, 0, 0, 4, 0, 0, 1, 5
"d:\IDEWORK\lvmen\src\licensedcode\data\rules\proprietary-license_409.yml", "YAML", 0, 0, 0, 4, 0, 0, 1, 5
"d:\IDEWORK\lvmen\src\licensedcode\data\rules\proprietary-license_41.yml", "YAML", 0, 0, 0, 5, 0, 0, 1, 6
"d:\IDEWORK\lvmen\src\licensedcode\data\rules\proprietary-license_410.yml", "YAML", 0, 0, 0, 4, 0, 0, 1, 5
"d:\IDEWORK\lvmen\src\licensedcode\data\rules\proprietary-license_411.yml", "YAML", 0, 0, 0, 4, 0, 0, 1, 5
"d:\IDEWORK\lvmen\src\licensedcode\data\rules\proprietary-license_412.yml", "YAML", 0, 0, 0, 6, 0, 0, 1, 7
"d:\IDEWORK\lvmen\src\licensedcode\data\rules\proprietary-license_413.yml", "YAML", 0, 0, 0, 6, 0, 0, 1, 7
"d:\IDEWORK\lvmen\src\licensedcode\data\rules\proprietary-license_414.yml", "YAML", 0, 0, 0, 4, 0, 0, 1, 5
"d:\IDEWORK\lvmen\src\licensedcode\data\rules\proprietary-license_415.yml", "YAML", 0, 0, 0, 4, 0, 0, 1, 5
"d:\IDEWORK\lvmen\src\licensedcode\data\rules\proprietary-license_416.yml", "YAML", 0, 0, 0, 4, 0, 0, 1, 5
"d:\IDEWORK\lvmen\src\licensedcode\data\rules\proprietary-license_417.yml", "YAML", 0, 0, 0, 3, 0, 0, 1, 4
"d:\IDEWORK\lvmen\src\licensedcode\data\rules\proprietary-license_418.yml", "YAML", 0, 0, 0, 3, 0, 0, 1, 4
"d:\IDEWORK\lvmen\src\licensedcode\data\rules\proprietary-license_419.yml", "YAML", 0, 0, 0, 3, 0, 0, 1, 4
"d:\IDEWORK\lvmen\src\licensedcode\data\rules\proprietary-license_42.yml", "YAML", 0, 0, 0, 5, 0, 0, 1, 6
"d:\IDEWORK\lvmen\src\licensedcode\data\rules\proprietary-license_420.yml", "YAML", 0, 0, 0, 3, 0, 0, 1, 4
"d:\IDEWORK\lvmen\src\licensedcode\data\rules\proprietary-license_421.yml", "YAML", 0, 0, 0, 10, 0, 0, 1, 11
"d:\IDEWORK\lvmen\src\licensedcode\data\rules\proprietary-license_422.yml", "YAML", 0, 0, 0, 3, 0, 0, 1, 4
"d:\IDEWORK\lvmen\src\licensedcode\data\rules\proprietary-license_423.yml", "YAML", 0, 0, 0, 3, 0, 0, 1, 4
"d:\IDEWORK\lvmen\src\licensedcode\data\rules\proprietary-license_424.yml", "YAML", 0, 0, 0, 3, 0, 0, 1, 4
"d:\IDEWORK\lvmen\src\licensedcode\data\rules\proprietary-license_425.yml", "YAML", 0, 0, 0, 3, 0, 0, 1, 4
"d:\IDEWORK\lvmen\src\licensedcode\data\rules\proprietary-license_426.yml", "YAML", 0, 0, 0, 3, 0, 0, 1, 4
"d:\IDEWORK\lvmen\src\licensedcode\data\rules\proprietary-license_427.yml", "YAML", 0, 0, 0, 4, 0, 0, 1, 5
"d:\IDEWORK\lvmen\src\licensedcode\data\rules\proprietary-license_428.yml", "YAML", 0, 0, 0, 3, 0, 0, 1, 4
"d:\IDEWORK\lvmen\src\licensedcode\data\rules\proprietary-license_429.yml", "YAML", 0, 0, 0, 3, 0, 0, 1, 4
"d:\IDEWORK\lvmen\src\licensedcode\data\rules\proprietary-license_43.yml", "YAML", 0, 0, 0, 5, 0, 0, 1, 6
"d:\IDEWORK\lvmen\src\licensedcode\data\rules\proprietary-license_430.yml", "YAML", 0, 0, 0, 3, 0, 0, 1, 4
"d:\IDEWORK\lvmen\src\licensedcode\data\rules\proprietary-license_431.yml", "YAML", 0, 0, 0, 3, 0, 0, 1, 4
"d:\IDEWORK\lvmen\src\licensedcode\data\rules\proprietary-license_432.yml", "YAML", 0, 0, 0, 5, 0, 0, 1, 6
"d:\IDEWORK\lvmen\src\licensedcode\data\rules\proprietary-license_433.yml", "YAML", 0, 0, 0, 3, 0, 0, 1, 4
"d:\IDEWORK\lvmen\src\licensedcode\data\rules\proprietary-license_434.yml", "YAML", 0, 0, 0, 3, 0, 0, 1, 4
"d:\IDEWORK\lvmen\src\licensedcode\data\rules\proprietary-license_435.yml", "YAML", 0, 0, 0, 3, 0, 0, 1, 4
"d:\IDEWORK\lvmen\src\licensedcode\data\rules\proprietary-license_436.yml", "YAML", 0, 0, 0, 5, 0, 0, 1, 6
"d:\IDEWORK\lvmen\src\licensedcode\data\rules\proprietary-license_437.yml", "YAML", 0, 0, 0, 3, 0, 0, 1, 4
"d:\IDEWORK\lvmen\src\licensedcode\data\rules\proprietary-license_438.yml", "YAML", 0, 0, 0, 3, 0, 0, 1, 4
"d:\IDEWORK\lvmen\src\licensedcode\data\rules\proprietary-license_439.yml", "YAML", 0, 0, 0, 3, 0, 0, 1, 4
"d:\IDEWORK\lvmen\src\licensedcode\data\rules\proprietary-license_44.yml", "YAML", 0, 0, 0, 5, 0, 0, 1, 6
"d:\IDEWORK\lvmen\src\licensedcode\data\rules\proprietary-license_440.yml", "YAML", 0, 0, 0, 3, 0, 0, 1, 4
"d:\IDEWORK\lvmen\src\licensedcode\data\rules\proprietary-license_441.yml", "YAML", 0, 0, 0, 3, 0, 0, 1, 4
"d:\IDEWORK\lvmen\src\licensedcode\data\rules\proprietary-license_442.yml", "YAML", 0, 0, 0, 3, 0, 0, 1, 4
"d:\IDEWORK\lvmen\src\licensedcode\data\rules\proprietary-license_443.yml", "YAML", 0, 0, 0, 3, 0, 0, 1, 4
"d:\IDEWORK\lvmen\src\licensedcode\data\rules\proprietary-license_444.yml", "YAML", 0, 0, 0, 9, 0, 0, 1, 10
"d:\IDEWORK\lvmen\src\licensedcode\data\rules\proprietary-license_445.yml", "YAML", 0, 0, 0, 3, 0, 0, 1, 4
"d:\IDEWORK\lvmen\src\licensedcode\data\rules\proprietary-license_446.yml", "YAML", 0, 0, 0, 3, 0, 0, 1, 4
"d:\IDEWORK\lvmen\src\licensedcode\data\rules\proprietary-license_447.yml", "YAML", 0, 0, 0, 3, 0, 0, 1, 4
"d:\IDEWORK\lvmen\src\licensedcode\data\rules\proprietary-license_448.yml", "YAML", 0, 0, 0, 3, 0, 0, 1, 4
"d:\IDEWORK\lvmen\src\licensedcode\data\rules\proprietary-license_449.yml", "YAML", 0, 0, 0, 4, 0, 0, 1, 5
"d:\IDEWORK\lvmen\src\licensedcode\data\rules\proprietary-license_45.yml", "YAML", 0, 0, 0, 5, 0, 0, 1, 6
"d:\IDEWORK\lvmen\src\licensedcode\data\rules\proprietary-license_450.yml", "YAML", 0, 0, 0, 3, 0, 0, 1, 4
"d:\IDEWORK\lvmen\src\licensedcode\data\rules\proprietary-license_451.yml", "YAML", 0, 0, 0, 6, 0, 0, 1, 7
"d:\IDEWORK\lvmen\src\licensedcode\data\rules\proprietary-license_452.yml", "YAML", 0, 0, 0, 4, 0, 0, 1, 5
"d:\IDEWORK\lvmen\src\licensedcode\data\rules\proprietary-license_453.yml", "YAML", 0, 0, 0, 13, 0, 0, 1, 14
"d:\IDEWORK\lvmen\src\licensedcode\data\rules\proprietary-license_454.yml", "YAML", 0, 0, 0, 4, 0, 0, 1, 5
"d:\IDEWORK\lvmen\src\licensedcode\data\rules\proprietary-license_455.yml", "YAML", 0, 0, 0, 3, 0, 0, 1, 4
"d:\IDEWORK\lvmen\src\licensedcode\data\rules\proprietary-license_456.yml", "YAML", 0, 0, 0, 4, 0, 0, 1, 5
"d:\IDEWORK\lvmen\src\licensedcode\data\rules\proprietary-license_457.yml", "YAML", 0, 0, 0, 6, 0, 0, 1, 7
"d:\IDEWORK\lvmen\src\licensedcode\data\rules\proprietary-license_458.yml", "YAML", 0, 0, 0, 6, 0, 0, 1, 7
"d:\IDEWORK\lvmen\src\licensedcode\data\rules\proprietary-license_459.yml", "YAML", 0, 0, 0, 8, 0, 0, 1, 9
"d:\IDEWORK\lvmen\src\licensedcode\data\rules\proprietary-license_46.yml", "YAML", 0, 0, 0, 5, 0, 0, 1, 6
"d:\IDEWORK\lvmen\src\licensedcode\data\rules\proprietary-license_460.yml", "YAML", 0, 0, 0, 3, 0, 0, 1, 4
"d:\IDEWORK\lvmen\src\licensedcode\data\rules\proprietary-license_461.yml", "YAML", 0, 0, 0, 3, 0, 0, 1, 4
"d:\IDEWORK\lvmen\src\licensedcode\data\rules\proprietary-license_462.yml", "YAML", 0, 0, 0, 3, 0, 0, 1, 4
"d:\IDEWORK\lvmen\src\licensedcode\data\rules\proprietary-license_463.yml", "YAML", 0, 0, 0, 3, 0, 0, 1, 4
"d:\IDEWORK\lvmen\src\licensedcode\data\rules\proprietary-license_464.yml", "YAML", 0, 0, 0, 3, 0, 0, 1, 4
"d:\IDEWORK\lvmen\src\licensedcode\data\rules\proprietary-license_465.yml", "YAML", 0, 0, 0, 3, 0, 0, 1, 4
"d:\IDEWORK\lvmen\src\licensedcode\data\rules\proprietary-license_466.yml", "YAML", 0, 0, 0, 3, 0, 0, 1, 4
"d:\IDEWORK\lvmen\src\licensedcode\data\rules\proprietary-license_467.yml", "YAML", 0, 0, 0, 3, 0, 0, 1, 4
"d:\IDEWORK\lvmen\src\licensedcode\data\rules\proprietary-license_468.yml", "YAML", 0, 0, 0, 3, 0, 0, 1, 4
"d:\IDEWORK\lvmen\src\licensedcode\data\rules\proprietary-license_469.yml", "YAML", 0, 0, 0, 3, 0, 0, 1, 4
"d:\IDEWORK\lvmen\src\licensedcode\data\rules\proprietary-license_47.yml", "YAML", 0, 0, 0, 5, 0, 0, 1, 6
"d:\IDEWORK\lvmen\src\licensedcode\data\rules\proprietary-license_470.yml", "YAML", 0, 0, 0, 3, 0, 0, 1, 4
"d:\IDEWORK\lvmen\src\licensedcode\data\rules\proprietary-license_471.yml", "YAML", 0, 0, 0, 3, 0, 0, 1, 4
"d:\IDEWORK\lvmen\src\licensedcode\data\rules\proprietary-license_472.yml", "YAML", 0, 0, 0, 3, 0, 0, 1, 4
"d:\IDEWORK\lvmen\src\licensedcode\data\rules\proprietary-license_473.yml", "YAML", 0, 0, 0, 3, 0, 0, 1, 4
"d:\IDEWORK\lvmen\src\licensedcode\data\rules\proprietary-license_474.yml", "YAML", 0, 0, 0, 3, 0, 0, 1, 4
"d:\IDEWORK\lvmen\src\licensedcode\data\rules\proprietary-license_475.yml", "YAML", 0, 0, 0, 3, 0, 0, 1, 4
"d:\IDEWORK\lvmen\src\licensedcode\data\rules\proprietary-license_476.yml", "YAML", 0, 0, 0, 3, 0, 0, 1, 4
"d:\IDEWORK\lvmen\src\licensedcode\data\rules\proprietary-license_477.yml", "YAML", 0, 0, 0, 5, 0, 0, 1, 6
"d:\IDEWORK\lvmen\src\licensedcode\data\rules\proprietary-license_478.yml", "YAML", 0, 0, 0, 3, 0, 0, 1, 4
"d:\IDEWORK\lvmen\src\licensedcode\data\rules\proprietary-license_479.yml", "YAML", 0, 0, 0, 4, 0, 0, 1, 5
"d:\IDEWORK\lvmen\src\licensedcode\data\rules\proprietary-license_48.yml", "YAML", 0, 0, 0, 5, 0, 0, 1, 6
"d:\IDEWORK\lvmen\src\licensedcode\data\rules\proprietary-license_480.yml", "YAML", 0, 0, 0, 4, 0, 0, 1, 5
"d:\IDEWORK\lvmen\src\licensedcode\data\rules\proprietary-license_481.yml", "YAML", 0, 0, 0, 9, 0, 0, 1, 10
"d:\IDEWORK\lvmen\src\licensedcode\data\rules\proprietary-license_482.yml", "YAML", 0, 0, 0, 4, 0, 0, 1, 5
"d:\IDEWORK\lvmen\src\licensedcode\data\rules\proprietary-license_483.yml", "YAML", 0, 0, 0, 3, 0, 0, 1, 4
"d:\IDEWORK\lvmen\src\licensedcode\data\rules\proprietary-license_484.yml", "YAML", 0, 0, 0, 3, 0, 0, 1, 4
"d:\IDEWORK\lvmen\src\licensedcode\data\rules\proprietary-license_485.yml", "YAML", 0, 0, 0, 3, 0, 0, 1, 4
"d:\IDEWORK\lvmen\src\licensedcode\data\rules\proprietary-license_486.yml", "YAML", 0, 0, 0, 6, 0, 0, 1, 7
"d:\IDEWORK\lvmen\src\licensedcode\data\rules\proprietary-license_487.yml", "YAML", 0, 0, 0, 5, 0, 0, 1, 6
"d:\IDEWORK\lvmen\src\licensedcode\data\rules\proprietary-license_488.yml", "YAML", 0, 0, 0, 5, 0, 0, 1, 6
"d:\IDEWORK\lvmen\src\licensedcode\data\rules\proprietary-license_489.yml", "YAML", 0, 0, 0, 4, 0, 0, 1, 5
"d:\IDEWORK\lvmen\src\licensedcode\data\rules\proprietary-license_49.yml", "YAML", 0, 0, 0, 5, 0, 0, 1, 6
"d:\IDEWORK\lvmen\src\licensedcode\data\rules\proprietary-license_490.yml", "YAML", 0, 0, 0, 4, 0, 0, 1, 5
"d:\IDEWORK\lvmen\src\licensedcode\data\rules\proprietary-license_491.yml", "YAML", 0, 0, 0, 4, 0, 0, 1, 5
"d:\IDEWORK\lvmen\src\licensedcode\data\rules\proprietary-license_492.yml", "YAML", 0, 0, 0, 7, 0, 0, 1, 8
"d:\IDEWORK\lvmen\src\licensedcode\data\rules\proprietary-license_493.yml", "YAML", 0, 0, 0, 5, 0, 0, 1, 6
"d:\IDEWORK\lvmen\src\licensedcode\data\rules\proprietary-license_494.yml", "YAML", 0, 0, 0, 4, 0, 0, 1, 5
"d:\IDEWORK\lvmen\src\licensedcode\data\rules\proprietary-license_495.yml", "YAML", 0, 0, 0, 3, 0, 0, 1, 4
"d:\IDEWORK\lvmen\src\licensedcode\data\rules\proprietary-license_496.yml", "YAML", 0, 0, 0, 3, 0, 0, 1, 4
"d:\IDEWORK\lvmen\src\licensedcode\data\rules\proprietary-license_497.yml", "YAML", 0, 0, 0, 3, 0, 0, 1, 4
"d:\IDEWORK\lvmen\src\licensedcode\data\rules\proprietary-license_498.yml", "YAML", 0, 0, 0, 4, 0, 0, 1, 5
"d:\IDEWORK\lvmen\src\licensedcode\data\rules\proprietary-license_499.yml", "YAML", 0, 0, 0, 5, 0, 0, 1, 6
"d:\IDEWORK\lvmen\src\licensedcode\data\rules\proprietary-license_5.yml", "YAML", 0, 0, 0, 3, 0, 0, 1, 4
"d:\IDEWORK\lvmen\src\licensedcode\data\rules\proprietary-license_50.yml", "YAML", 0, 0, 0, 5, 0, 0, 1, 6
"d:\IDEWORK\lvmen\src\licensedcode\data\rules\proprietary-license_500.yml", "YAML", 0, 0, 0, 5, 0, 0, 1, 6
"d:\IDEWORK\lvmen\src\licensedcode\data\rules\proprietary-license_501.yml", "YAML", 0, 0, 0, 5, 0, 0, 1, 6
"d:\IDEWORK\lvmen\src\licensedcode\data\rules\proprietary-license_502.yml", "YAML", 0, 0, 0, 6, 0, 0, 1, 7
"d:\IDEWORK\lvmen\src\licensedcode\data\rules\proprietary-license_503.yml", "YAML", 0, 0, 0, 5, 0, 0, 1, 6
"d:\IDEWORK\lvmen\src\licensedcode\data\rules\proprietary-license_504.yml", "YAML", 0, 0, 0, 4, 0, 0, 2, 6
"d:\IDEWORK\lvmen\src\licensedcode\data\rules\proprietary-license_505.yml", "YAML", 0, 0, 0, 6, 0, 0, 1, 7
"d:\IDEWORK\lvmen\src\licensedcode\data\rules\proprietary-license_506.yml", "YAML", 0, 0, 0, 3, 0, 0, 1, 4
"d:\IDEWORK\lvmen\src\licensedcode\data\rules\proprietary-license_507.yml", "YAML", 0, 0, 0, 3, 0, 0, 1, 4
"d:\IDEWORK\lvmen\src\licensedcode\data\rules\proprietary-license_508.yml", "YAML", 0, 0, 0, 7, 0, 0, 1, 8
"d:\IDEWORK\lvmen\src\licensedcode\data\rules\proprietary-license_509.yml", "YAML", 0, 0, 0, 3, 0, 0, 1, 4
"d:\IDEWORK\lvmen\src\licensedcode\data\rules\proprietary-license_51.yml", "YAML", 0, 0, 0, 5, 0, 0, 1, 6
"d:\IDEWORK\lvmen\src\licensedcode\data\rules\proprietary-license_510.yml", "YAML", 0, 0, 0, 13, 0, 0, 1, 14
"d:\IDEWORK\lvmen\src\licensedcode\data\rules\proprietary-license_511.yml", "YAML", 0, 0, 0, 6, 0, 0, 1, 7
"d:\IDEWORK\lvmen\src\licensedcode\data\rules\proprietary-license_512.yml", "YAML", 0, 0, 0, 10, 0, 0, 1, 11
"d:\IDEWORK\lvmen\src\licensedcode\data\rules\proprietary-license_513.yml", "YAML", 0, 0, 0, 4, 0, 0, 1, 5
"d:\IDEWORK\lvmen\src\licensedcode\data\rules\proprietary-license_514.yml", "YAML", 0, 0, 0, 4, 0, 0, 1, 5
"d:\IDEWORK\lvmen\src\licensedcode\data\rules\proprietary-license_515.yml", "YAML", 0, 0, 0, 4, 0, 0, 1, 5
"d:\IDEWORK\lvmen\src\licensedcode\data\rules\proprietary-license_516.yml", "YAML", 0, 0, 0, 4, 0, 0, 1, 5
"d:\IDEWORK\lvmen\src\licensedcode\data\rules\proprietary-license_517.yml", "YAML", 0, 0, 0, 8, 0, 0, 1, 9
"d:\IDEWORK\lvmen\src\licensedcode\data\rules\proprietary-license_518.yml", "YAML", 0, 0, 0, 5, 0, 0, 1, 6
"d:\IDEWORK\lvmen\src\licensedcode\data\rules\proprietary-license_519.yml", "YAML", 0, 0, 0, 4, 0, 0, 1, 5
"d:\IDEWORK\lvmen\src\licensedcode\data\rules\proprietary-license_52.yml", "YAML", 0, 0, 0, 5, 0, 0, 1, 6
"d:\IDEWORK\lvmen\src\licensedcode\data\rules\proprietary-license_520.yml", "YAML", 0, 0, 0, 8, 0, 0, 1, 9
"d:\IDEWORK\lvmen\src\licensedcode\data\rules\proprietary-license_521.yml", "YAML", 0, 0, 0, 3, 0, 0, 1, 4
"d:\IDEWORK\lvmen\src\licensedcode\data\rules\proprietary-license_522.yml", "YAML", 0, 0, 0, 3, 0, 0, 1, 4
"d:\IDEWORK\lvmen\src\licensedcode\data\rules\proprietary-license_523.yml", "YAML", 0, 0, 0, 3, 0, 0, 1, 4
"d:\IDEWORK\lvmen\src\licensedcode\data\rules\proprietary-license_524.yml", "YAML", 0, 0, 0, 3, 0, 0, 1, 4
"d:\IDEWORK\lvmen\src\licensedcode\data\rules\proprietary-license_525.yml", "YAML", 0, 0, 0, 3, 0, 0, 1, 4
"d:\IDEWORK\lvmen\src\licensedcode\data\rules\proprietary-license_526.yml", "YAML", 0, 0, 0, 8, 0, 0, 1, 9
"d:\IDEWORK\lvmen\src\licensedcode\data\rules\proprietary-license_527.yml", "YAML", 0, 0, 0, 3, 0, 0, 1, 4
"d:\IDEWORK\lvmen\src\licensedcode\data\rules\proprietary-license_528.yml", "YAML", 0, 0, 0, 3, 0, 0, 1, 4
"d:\IDEWORK\lvmen\src\licensedcode\data\rules\proprietary-license_529.yml", "YAML", 0, 0, 0, 4, 0, 0, 1, 5
"d:\IDEWORK\lvmen\src\licensedcode\data\rules\proprietary-license_53.yml", "YAML", 0, 0, 0, 5, 0, 0, 1, 6
"d:\IDEWORK\lvmen\src\licensedcode\data\rules\proprietary-license_530.yml", "YAML", 0, 0, 0, 4, 0, 0, 1, 5
"d:\IDEWORK\lvmen\src\licensedcode\data\rules\proprietary-license_531.yml", "YAML", 0, 0, 0, 4, 0, 0, 1, 5
"d:\IDEWORK\lvmen\src\licensedcode\data\rules\proprietary-license_532.yml", "YAML", 0, 0, 0, 4, 0, 0, 1, 5
"d:\IDEWORK\lvmen\src\licensedcode\data\rules\proprietary-license_533.yml", "YAML", 0, 0, 0, 12, 0, 0, 1, 13
"d:\IDEWORK\lvmen\src\licensedcode\data\rules\proprietary-license_534.yml", "YAML", 0, 0, 0, 10, 0, 0, 1, 11
"d:\IDEWORK\lvmen\src\licensedcode\data\rules\proprietary-license_535.yml", "YAML", 0, 0, 0, 3, 0, 0, 1, 4
"d:\IDEWORK\lvmen\src\licensedcode\data\rules\proprietary-license_536.yml", "YAML", 0, 0, 0, 6, 0, 0, 1, 7
"d:\IDEWORK\lvmen\src\licensedcode\data\rules\proprietary-license_537.yml", "YAML", 0, 0, 0, 5, 0, 0, 1, 6
"d:\IDEWORK\lvmen\src\licensedcode\data\rules\proprietary-license_538.yml", "YAML", 0, 0, 0, 3, 0, 0, 1, 4
"d:\IDEWORK\lvmen\src\licensedcode\data\rules\proprietary-license_539.yml", "YAML", 0, 0, 0, 3, 0, 0, 1, 4
"d:\IDEWORK\lvmen\src\licensedcode\data\rules\proprietary-license_54.yml", "YAML", 0, 0, 0, 5, 0, 0, 1, 6
"d:\IDEWORK\lvmen\src\licensedcode\data\rules\proprietary-license_540.yml", "YAML", 0, 0, 0, 3, 0, 0, 1, 4
"d:\IDEWORK\lvmen\src\licensedcode\data\rules\proprietary-license_541.yml", "YAML", 0, 0, 0, 3, 0, 0, 1, 4
"d:\IDEWORK\lvmen\src\licensedcode\data\rules\proprietary-license_542.yml", "YAML", 0, 0, 0, 3, 0, 0, 1, 4
"d:\IDEWORK\lvmen\src\licensedcode\data\rules\proprietary-license_543.yml", "YAML", 0, 0, 0, 3, 0, 0, 1, 4
"d:\IDEWORK\lvmen\src\licensedcode\data\rules\proprietary-license_544.yml", "YAML", 0, 0, 0, 3, 0, 0, 1, 4
"d:\IDEWORK\lvmen\src\licensedcode\data\rules\proprietary-license_545.yml", "YAML", 0, 0, 0, 3, 0, 0, 1, 4
"d:\IDEWORK\lvmen\src\licensedcode\data\rules\proprietary-license_546.yml", "YAML", 0, 0, 0, 3, 0, 0, 1, 4
"d:\IDEWORK\lvmen\src\licensedcode\data\rules\proprietary-license_547.yml", "YAML", 0, 0, 0, 4, 0, 0, 1, 5
"d:\IDEWORK\lvmen\src\licensedcode\data\rules\proprietary-license_548.yml", "YAML", 0, 0, 0, 4, 0, 0, 1, 5
"d:\IDEWORK\lvmen\src\licensedcode\data\rules\proprietary-license_549.yml", "YAML", 0, 0, 0, 5, 0, 0, 1, 6
"d:\IDEWORK\lvmen\src\licensedcode\data\rules\proprietary-license_55.yml", "YAML", 0, 0, 0, 5, 0, 0, 1, 6
"d:\IDEWORK\lvmen\src\licensedcode\data\rules\proprietary-license_550.yml", "YAML", 0, 0, 0, 5, 0, 0, 1, 6
"d:\IDEWORK\lvmen\src\licensedcode\data\rules\proprietary-license_551.yml", "YAML", 0, 0, 0, 3, 0, 0, 1, 4
"d:\IDEWORK\lvmen\src\licensedcode\data\rules\proprietary-license_552.yml", "YAML", 0, 0, 0, 3, 0, 0, 1, 4
"d:\IDEWORK\lvmen\src\licensedcode\data\rules\proprietary-license_553.yml", "YAML", 0, 0, 0, 3, 0, 0, 1, 4
"d:\IDEWORK\lvmen\src\licensedcode\data\rules\proprietary-license_554.yml", "YAML", 0, 0, 0, 13, 0, 0, 1, 14
"d:\IDEWORK\lvmen\src\licensedcode\data\rules\proprietary-license_555.yml", "YAML", 0, 0, 0, 15, 0, 0, 1, 16
"d:\IDEWORK\lvmen\src\licensedcode\data\rules\proprietary-license_556.yml", "YAML", 0, 0, 0, 3, 0, 0, 2, 5
"d:\IDEWORK\lvmen\src\licensedcode\data\rules\proprietary-license_557.yml", "YAML", 0, 0, 0, 4, 0, 0, 1, 5
"d:\IDEWORK\lvmen\src\licensedcode\data\rules\proprietary-license_558.yml", "YAML", 0, 0, 0, 3, 0, 0, 1, 4
"d:\IDEWORK\lvmen\src\licensedcode\data\rules\proprietary-license_559.yml", "YAML", 0, 0, 0, 6, 0, 0, 2, 8
"d:\IDEWORK\lvmen\src\licensedcode\data\rules\proprietary-license_56.yml", "YAML", 0, 0, 0, 5, 0, 0, 1, 6
"d:\IDEWORK\lvmen\src\licensedcode\data\rules\proprietary-license_560.yml", "YAML", 0, 0, 0, 4, 0, 0, 1, 5
"d:\IDEWORK\lvmen\src\licensedcode\data\rules\proprietary-license_561.yml", "YAML", 0, 0, 0, 4, 0, 0, 1, 5
"d:\IDEWORK\lvmen\src\licensedcode\data\rules\proprietary-license_562.yml", "YAML", 0, 0, 0, 6, 0, 0, 2, 8
"d:\IDEWORK\lvmen\src\licensedcode\data\rules\proprietary-license_563.yml", "YAML", 0, 0, 0, 4, 0, 0, 1, 5
"d:\IDEWORK\lvmen\src\licensedcode\data\rules\proprietary-license_564.yml", "YAML", 0, 0, 0, 4, 0, 0, 1, 5
"d:\IDEWORK\lvmen\src\licensedcode\data\rules\proprietary-license_565.yml", "YAML", 0, 0, 0, 4, 0, 0, 1, 5
"d:\IDEWORK\lvmen\src\licensedcode\data\rules\proprietary-license_566.yml", "YAML", 0, 0, 0, 3, 0, 0, 1, 4
"d:\IDEWORK\lvmen\src\licensedcode\data\rules\proprietary-license_567.yml", "YAML", 0, 0, 0, 4, 0, 0, 1, 5
"d:\IDEWORK\lvmen\src\licensedcode\data\rules\proprietary-license_568.yml", "YAML", 0, 0, 0, 5, 0, 0, 1, 6
"d:\IDEWORK\lvmen\src\licensedcode\data\rules\proprietary-license_569.yml", "YAML", 0, 0, 0, 3, 0, 0, 1, 4
"d:\IDEWORK\lvmen\src\licensedcode\data\rules\proprietary-license_57.yml", "YAML", 0, 0, 0, 5, 0, 0, 1, 6
"d:\IDEWORK\lvmen\src\licensedcode\data\rules\proprietary-license_570.yml", "YAML", 0, 0, 0, 3, 0, 0, 1, 4
"d:\IDEWORK\lvmen\src\licensedcode\data\rules\proprietary-license_571.yml", "YAML", 0, 0, 0, 4, 0, 0, 1, 5
"d:\IDEWORK\lvmen\src\licensedcode\data\rules\proprietary-license_572.yml", "YAML", 0, 0, 0, 4, 0, 0, 1, 5
"d:\IDEWORK\lvmen\src\licensedcode\data\rules\proprietary-license_573.yml", "YAML", 0, 0, 0, 4, 0, 0, 1, 5
"d:\IDEWORK\lvmen\src\licensedcode\data\rules\proprietary-license_574.yml", "YAML", 0, 0, 0, 15, 0, 0, 3, 18
"d:\IDEWORK\lvmen\src\licensedcode\data\rules\proprietary-license_575.yml", "YAML", 0, 0, 0, 17, 0, 0, 3, 20
"d:\IDEWORK\lvmen\src\licensedcode\data\rules\proprietary-license_576.yml", "YAML", 0, 0, 0, 6, 0, 0, 1, 7
"d:\IDEWORK\lvmen\src\licensedcode\data\rules\proprietary-license_577.yml", "YAML", 0, 0, 0, 4, 0, 0, 1, 5
"d:\IDEWORK\lvmen\src\licensedcode\data\rules\proprietary-license_578.yml", "YAML", 0, 0, 0, 3, 0, 0, 1, 4
"d:\IDEWORK\lvmen\src\licensedcode\data\rules\proprietary-license_579.yml", "YAML", 0, 0, 0, 3, 0, 0, 1, 4
"d:\IDEWORK\lvmen\src\licensedcode\data\rules\proprietary-license_58.yml", "YAML", 0, 0, 0, 5, 0, 0, 1, 6
"d:\IDEWORK\lvmen\src\licensedcode\data\rules\proprietary-license_580.yml", "YAML", 0, 0, 0, 4, 0, 0, 1, 5
"d:\IDEWORK\lvmen\src\licensedcode\data\rules\proprietary-license_581.yml", "YAML", 0, 0, 0, 4, 0, 0, 1, 5
"d:\IDEWORK\lvmen\src\licensedcode\data\rules\proprietary-license_582.yml", "YAML", 0, 0, 0, 2, 0, 0, 1, 3
"d:\IDEWORK\lvmen\src\licensedcode\data\rules\proprietary-license_583.yml", "YAML", 0, 0, 0, 3, 0, 0, 1, 4
"d:\IDEWORK\lvmen\src\licensedcode\data\rules\proprietary-license_584.yml", "YAML", 0, 0, 0, 3, 0, 0, 1, 4
"d:\IDEWORK\lvmen\src\licensedcode\data\rules\proprietary-license_585.yml", "YAML", 0, 0, 0, 3, 0, 0, 1, 4
"d:\IDEWORK\lvmen\src\licensedcode\data\rules\proprietary-license_586.yml", "YAML", 0, 0, 0, 4, 0, 0, 1, 5
"d:\IDEWORK\lvmen\src\licensedcode\data\rules\proprietary-license_587.yml", "YAML", 0, 0, 0, 4, 0, 0, 1, 5
"d:\IDEWORK\lvmen\src\licensedcode\data\rules\proprietary-license_588.yml", "YAML", 0, 0, 0, 3, 0, 0, 1, 4
"d:\IDEWORK\lvmen\src\licensedcode\data\rules\proprietary-license_589.yml", "YAML", 0, 0, 0, 2, 0, 0, 1, 3
"d:\IDEWORK\lvmen\src\licensedcode\data\rules\proprietary-license_59.yml", "YAML", 0, 0, 0, 5, 0, 0, 1, 6
"d:\IDEWORK\lvmen\src\licensedcode\data\rules\proprietary-license_590.yml", "YAML", 0, 0, 0, 2, 0, 0, 1, 3
"d:\IDEWORK\lvmen\src\licensedcode\data\rules\proprietary-license_591.yml", "YAML", 0, 0, 0, 3, 0, 0, 1, 4
"d:\IDEWORK\lvmen\src\licensedcode\data\rules\proprietary-license_592.yml", "YAML", 0, 0, 0, 4, 0, 0, 1, 5
"d:\IDEWORK\lvmen\src\licensedcode\data\rules\proprietary-license_593.yml", "YAML", 0, 0, 0, 3, 0, 0, 1, 4
"d:\IDEWORK\lvmen\src\licensedcode\data\rules\proprietary-license_594.yml", "YAML", 0, 0, 0, 3, 0, 0, 1, 4
"d:\IDEWORK\lvmen\src\licensedcode\data\rules\proprietary-license_595.yml", "YAML", 0, 0, 0, 3, 0, 0, 1, 4
"d:\IDEWORK\lvmen\src\licensedcode\data\rules\proprietary-license_596.yml", "YAML", 0, 0, 0, 3, 0, 0, 1, 4
"d:\IDEWORK\lvmen\src\licensedcode\data\rules\proprietary-license_597.yml", "YAML", 0, 0, 0, 13, 0, 0, 1, 14
"d:\IDEWORK\lvmen\src\licensedcode\data\rules\proprietary-license_598.yml", "YAML", 0, 0, 0, 7, 0, 0, 1, 8
"d:\IDEWORK\lvmen\src\licensedcode\data\rules\proprietary-license_599.yml", "YAML", 0, 0, 0, 2, 0, 0, 1, 3
"d:\IDEWORK\lvmen\src\licensedcode\data\rules\proprietary-license_6.yml", "YAML", 0, 0, 0, 3, 0, 0, 1, 4
"d:\IDEWORK\lvmen\src\licensedcode\data\rules\proprietary-license_60.yml", "YAML", 0, 0, 0, 5, 0, 0, 1, 6
"d:\IDEWORK\lvmen\src\licensedcode\data\rules\proprietary-license_600.yml", "YAML", 0, 0, 0, 3, 0, 0, 1, 4
"d:\IDEWORK\lvmen\src\licensedcode\data\rules\proprietary-license_601.yml", "YAML", 0, 0, 0, 3, 0, 0, 1, 4
"d:\IDEWORK\lvmen\src\licensedcode\data\rules\proprietary-license_602.yml", "YAML", 0, 0, 0, 3, 0, 0, 1, 4
"d:\IDEWORK\lvmen\src\licensedcode\data\rules\proprietary-license_603.yml", "YAML", 0, 0, 0, 3, 0, 0, 1, 4
"d:\IDEWORK\lvmen\src\licensedcode\data\rules\proprietary-license_604.yml", "YAML", 0, 0, 0, 3, 0, 0, 1, 4
"d:\IDEWORK\lvmen\src\licensedcode\data\rules\proprietary-license_605.yml", "YAML", 0, 0, 0, 3, 0, 0, 1, 4
"d:\IDEWORK\lvmen\src\licensedcode\data\rules\proprietary-license_606.yml", "YAML", 0, 0, 0, 3, 0, 0, 1, 4
"d:\IDEWORK\lvmen\src\licensedcode\data\rules\proprietary-license_607.yml", "YAML", 0, 0, 0, 3, 0, 0, 1, 4
"d:\IDEWORK\lvmen\src\licensedcode\data\rules\proprietary-license_608.yml", "YAML", 0, 0, 0, 4, 0, 0, 1, 5
"d:\IDEWORK\lvmen\src\licensedcode\data\rules\proprietary-license_609.yml", "YAML", 0, 0, 0, 3, 0, 0, 1, 4
"d:\IDEWORK\lvmen\src\licensedcode\data\rules\proprietary-license_61.yml", "YAML", 0, 0, 0, 5, 0, 0, 1, 6
"d:\IDEWORK\lvmen\src\licensedcode\data\rules\proprietary-license_610.yml", "YAML", 0, 0, 0, 3, 0, 0, 1, 4
"d:\IDEWORK\lvmen\src\licensedcode\data\rules\proprietary-license_611.yml", "YAML", 0, 0, 0, 3, 0, 0, 1, 4
"d:\IDEWORK\lvmen\src\licensedcode\data\rules\proprietary-license_612.yml", "YAML", 0, 0, 0, 3, 0, 0, 1, 4
"d:\IDEWORK\lvmen\src\licensedcode\data\rules\proprietary-license_613.yml", "YAML", 0, 0, 0, 3, 0, 0, 1, 4
"d:\IDEWORK\lvmen\src\licensedcode\data\rules\proprietary-license_614.yml", "YAML", 0, 0, 0, 5, 0, 0, 1, 6
"d:\IDEWORK\lvmen\src\licensedcode\data\rules\proprietary-license_615.yml", "YAML", 0, 0, 0, 4, 0, 0, 1, 5
"d:\IDEWORK\lvmen\src\licensedcode\data\rules\proprietary-license_616.yml", "YAML", 0, 0, 0, 3, 0, 0, 1, 4
"d:\IDEWORK\lvmen\src\licensedcode\data\rules\proprietary-license_617.yml", "YAML", 0, 0, 0, 3, 0, 0, 1, 4
"d:\IDEWORK\lvmen\src\licensedcode\data\rules\proprietary-license_618.yml", "YAML", 0, 0, 0, 5, 0, 0, 1, 6
"d:\IDEWORK\lvmen\src\licensedcode\data\rules\proprietary-license_619.yml", "YAML", 0, 0, 0, 3, 0, 0, 1, 4
"d:\IDEWORK\lvmen\src\licensedcode\data\rules\proprietary-license_62.yml", "YAML", 0, 0, 0, 5, 0, 0, 1, 6
"d:\IDEWORK\lvmen\src\licensedcode\data\rules\proprietary-license_620.yml", "YAML", 0, 0, 0, 5, 0, 0, 1, 6
"d:\IDEWORK\lvmen\src\licensedcode\data\rules\proprietary-license_621.yml", "YAML", 0, 0, 0, 3, 0, 0, 1, 4
"d:\IDEWORK\lvmen\src\licensedcode\data\rules\proprietary-license_622.yml", "YAML", 0, 0, 0, 3, 0, 0, 1, 4
"d:\IDEWORK\lvmen\src\licensedcode\data\rules\proprietary-license_623.yml", "YAML", 0, 0, 0, 3, 0, 0, 1, 4
"d:\IDEWORK\lvmen\src\licensedcode\data\rules\proprietary-license_624.yml", "YAML", 0, 0, 0, 3, 0, 0, 1, 4
"d:\IDEWORK\lvmen\src\licensedcode\data\rules\proprietary-license_625.yml", "YAML", 0, 0, 0, 3, 0, 0, 1, 4
"d:\IDEWORK\lvmen\src\licensedcode\data\rules\proprietary-license_626.yml", "YAML", 0, 0, 0, 3, 0, 0, 1, 4
"d:\IDEWORK\lvmen\src\licensedcode\data\rules\proprietary-license_627.yml", "YAML", 0, 0, 0, 3, 0, 0, 1, 4
"d:\IDEWORK\lvmen\src\licensedcode\data\rules\proprietary-license_628.yml", "YAML", 0, 0, 0, 3, 0, 0, 1, 4
"d:\IDEWORK\lvmen\src\licensedcode\data\rules\proprietary-license_629.yml", "YAML", 0, 0, 0, 3, 0, 0, 1, 4
"d:\IDEWORK\lvmen\src\licensedcode\data\rules\proprietary-license_63.yml", "YAML", 0, 0, 0, 3, 0, 0, 1, 4
"d:\IDEWORK\lvmen\src\licensedcode\data\rules\proprietary-license_630.yml", "YAML", 0, 0, 0, 3, 0, 0, 1, 4
"d:\IDEWORK\lvmen\src\licensedcode\data\rules\proprietary-license_631.yml", "YAML", 0, 0, 0, 3, 0, 0, 1, 4
"d:\IDEWORK\lvmen\src\licensedcode\data\rules\proprietary-license_632.yml", "YAML", 0, 0, 0, 3, 0, 0, 1, 4
"d:\IDEWORK\lvmen\src\licensedcode\data\rules\proprietary-license_633.yml", "YAML", 0, 0, 0, 3, 0, 0, 1, 4
"d:\IDEWORK\lvmen\src\licensedcode\data\rules\proprietary-license_634.yml", "YAML", 0, 0, 0, 4, 0, 0, 1, 5
"d:\IDEWORK\lvmen\src\licensedcode\data\rules\proprietary-license_635.yml", "YAML", 0, 0, 0, 3, 0, 0, 1, 4
"d:\IDEWORK\lvmen\src\licensedcode\data\rules\proprietary-license_636.yml", "YAML", 0, 0, 0, 3, 0, 0, 1, 4
"d:\IDEWORK\lvmen\src\licensedcode\data\rules\proprietary-license_637.yml", "YAML", 0, 0, 0, 5, 0, 0, 1, 6
"d:\IDEWORK\lvmen\src\licensedcode\data\rules\proprietary-license_638.yml", "YAML", 0, 0, 0, 3, 0, 0, 1, 4
"d:\IDEWORK\lvmen\src\licensedcode\data\rules\proprietary-license_639.yml", "YAML", 0, 0, 0, 3, 0, 0, 1, 4
"d:\IDEWORK\lvmen\src\licensedcode\data\rules\proprietary-license_64.yml", "YAML", 0, 0, 0, 3, 0, 0, 1, 4
"d:\IDEWORK\lvmen\src\licensedcode\data\rules\proprietary-license_640.yml", "YAML", 0, 0, 0, 3, 0, 0, 1, 4
"d:\IDEWORK\lvmen\src\licensedcode\data\rules\proprietary-license_641.yml", "YAML", 0, 0, 0, 8, 0, 0, 1, 9
"d:\IDEWORK\lvmen\src\licensedcode\data\rules\proprietary-license_642.yml", "YAML", 0, 0, 0, 7, 0, 0, 1, 8
"d:\IDEWORK\lvmen\src\licensedcode\data\rules\proprietary-license_643.yml", "YAML", 0, 0, 0, 6, 0, 0, 1, 7
"d:\IDEWORK\lvmen\src\licensedcode\data\rules\proprietary-license_644.yml", "YAML", 0, 0, 0, 8, 0, 0, 1, 9
"d:\IDEWORK\lvmen\src\licensedcode\data\rules\proprietary-license_645.yml", "YAML", 0, 0, 0, 3, 0, 0, 1, 4
"d:\IDEWORK\lvmen\src\licensedcode\data\rules\proprietary-license_646.yml", "YAML", 0, 0, 0, 4, 0, 0, 1, 5
"d:\IDEWORK\lvmen\src\licensedcode\data\rules\proprietary-license_647.yml", "YAML", 0, 0, 0, 3, 0, 0, 1, 4
"d:\IDEWORK\lvmen\src\licensedcode\data\rules\proprietary-license_648.yml", "YAML", 0, 0, 0, 3, 0, 0, 1, 4
"d:\IDEWORK\lvmen\src\licensedcode\data\rules\proprietary-license_649.yml", "YAML", 0, 0, 0, 5, 0, 0, 1, 6
"d:\IDEWORK\lvmen\src\licensedcode\data\rules\proprietary-license_65.yml", "YAML", 0, 0, 0, 5, 0, 0, 1, 6
"d:\IDEWORK\lvmen\src\licensedcode\data\rules\proprietary-license_650.yml", "YAML", 0, 0, 0, 5, 0, 0, 1, 6
"d:\IDEWORK\lvmen\src\licensedcode\data\rules\proprietary-license_651.yml", "YAML", 0, 0, 0, 3, 0, 0, 1, 4
"d:\IDEWORK\lvmen\src\licensedcode\data\rules\proprietary-license_652.yml", "YAML", 0, 0, 0, 3, 0, 0, 1, 4
"d:\IDEWORK\lvmen\src\licensedcode\data\rules\proprietary-license_653.yml", "YAML", 0, 0, 0, 3, 0, 0, 1, 4
"d:\IDEWORK\lvmen\src\licensedcode\data\rules\proprietary-license_654.yml", "YAML", 0, 0, 0, 3, 0, 0, 1, 4
"d:\IDEWORK\lvmen\src\licensedcode\data\rules\proprietary-license_655.yml", "YAML", 0, 0, 0, 2, 0, 0, 1, 3
"d:\IDEWORK\lvmen\src\licensedcode\data\rules\proprietary-license_656.yml", "YAML", 0, 0, 0, 3, 0, 0, 1, 4
"d:\IDEWORK\lvmen\src\licensedcode\data\rules\proprietary-license_657.yml", "YAML", 0, 0, 0, 3, 0, 0, 1, 4
"d:\IDEWORK\lvmen\src\licensedcode\data\rules\proprietary-license_658.yml", "YAML", 0, 0, 0, 6, 0, 0, 1, 7
"d:\IDEWORK\lvmen\src\licensedcode\data\rules\proprietary-license_659.yml", "YAML", 0, 0, 0, 3, 0, 0, 1, 4
"d:\IDEWORK\lvmen\src\licensedcode\data\rules\proprietary-license_66.yml", "YAML", 0, 0, 0, 3, 0, 0, 1, 4
"d:\IDEWORK\lvmen\src\licensedcode\data\rules\proprietary-license_660.yml", "YAML", 0, 0, 0, 2, 0, 0, 1, 3
"d:\IDEWORK\lvmen\src\licensedcode\data\rules\proprietary-license_661.yml", "YAML", 0, 0, 0, 5, 0, 0, 1, 6
"d:\IDEWORK\lvmen\src\licensedcode\data\rules\proprietary-license_662.yml", "YAML", 0, 0, 0, 7, 0, 0, 1, 8
"d:\IDEWORK\lvmen\src\licensedcode\data\rules\proprietary-license_67.yml", "YAML", 0, 0, 0, 3, 0, 0, 1, 4
"d:\IDEWORK\lvmen\src\licensedcode\data\rules\proprietary-license_68.yml", "YAML", 0, 0, 0, 3, 0, 0, 1, 4
"d:\IDEWORK\lvmen\src\licensedcode\data\rules\proprietary-license_69.yml", "YAML", 0, 0, 0, 3, 0, 0, 1, 4
"d:\IDEWORK\lvmen\src\licensedcode\data\rules\proprietary-license_7.yml", "YAML", 0, 0, 0, 3, 0, 0, 1, 4
"d:\IDEWORK\lvmen\src\licensedcode\data\rules\proprietary-license_70.yml", "YAML", 0, 0, 0, 4, 0, 0, 1, 5
"d:\IDEWORK\lvmen\src\licensedcode\data\rules\proprietary-license_71.yml", "YAML", 0, 0, 0, 3, 0, 0, 1, 4
"d:\IDEWORK\lvmen\src\licensedcode\data\rules\proprietary-license_72.yml", "YAML", 0, 0, 0, 3, 0, 0, 1, 4
"d:\IDEWORK\lvmen\src\licensedcode\data\rules\proprietary-license_73.yml", "YAML", 0, 0, 0, 3, 0, 0, 1, 4
"d:\IDEWORK\lvmen\src\licensedcode\data\rules\proprietary-license_74.yml", "YAML", 0, 0, 0, 5, 0, 0, 1, 6
"d:\IDEWORK\lvmen\src\licensedcode\data\rules\proprietary-license_75.yml", "YAML", 0, 0, 0, 3, 0, 0, 1, 4
"d:\IDEWORK\lvmen\src\licensedcode\data\rules\proprietary-license_76.yml", "YAML", 0, 0, 0, 3, 0, 0, 1, 4
"d:\IDEWORK\lvmen\src\licensedcode\data\rules\proprietary-license_77.yml", "YAML", 0, 0, 0, 4, 0, 0, 1, 5
"d:\IDEWORK\lvmen\src\licensedcode\data\rules\proprietary-license_78.yml", "YAML", 0, 0, 0, 9, 0, 0, 1, 10
"d:\IDEWORK\lvmen\src\licensedcode\data\rules\proprietary-license_79.yml", "YAML", 0, 0, 0, 5, 0, 0, 1, 6
"d:\IDEWORK\lvmen\src\licensedcode\data\rules\proprietary-license_8.yml", "YAML", 0, 0, 0, 2, 0, 0, 1, 3
"d:\IDEWORK\lvmen\src\licensedcode\data\rules\proprietary-license_80.yml", "YAML", 0, 0, 0, 3, 0, 0, 1, 4
"d:\IDEWORK\lvmen\src\licensedcode\data\rules\proprietary-license_81.yml", "YAML", 0, 0, 0, 3, 0, 0, 1, 4
"d:\IDEWORK\lvmen\src\licensedcode\data\rules\proprietary-license_82.yml", "YAML", 0, 0, 0, 8, 0, 0, 1, 9
"d:\IDEWORK\lvmen\src\licensedcode\data\rules\proprietary-license_83.yml", "YAML", 0, 0, 0, 7, 0, 0, 1, 8
"d:\IDEWORK\lvmen\src\licensedcode\data\rules\proprietary-license_84.yml", "YAML", 0, 0, 0, 8, 0, 0, 1, 9
"d:\IDEWORK\lvmen\src\licensedcode\data\rules\proprietary-license_85.yml", "YAML", 0, 0, 0, 5, 0, 0, 1, 6
"d:\IDEWORK\lvmen\src\licensedcode\data\rules\proprietary-license_86.yml", "YAML", 0, 0, 0, 7, 0, 0, 1, 8
"d:\IDEWORK\lvmen\src\licensedcode\data\rules\proprietary-license_87.yml", "YAML", 0, 0, 0, 13, 0, 0, 1, 14
"d:\IDEWORK\lvmen\src\licensedcode\data\rules\proprietary-license_88.yml", "YAML", 0, 0, 0, 4, 0, 0, 1, 5
"d:\IDEWORK\lvmen\src\licensedcode\data\rules\proprietary-license_89.yml", "YAML", 0, 0, 0, 6, 0, 0, 1, 7
"d:\IDEWORK\lvmen\src\licensedcode\data\rules\proprietary-license_9.yml", "YAML", 0, 0, 0, 12, 0, 0, 1, 13
"d:\IDEWORK\lvmen\src\licensedcode\data\rules\proprietary-license_90.yml", "YAML", 0, 0, 0, 4, 0, 0, 1, 5
"d:\IDEWORK\lvmen\src\licensedcode\data\rules\proprietary-license_91.yml", "YAML", 0, 0, 0, 5, 0, 0, 1, 6
"d:\IDEWORK\lvmen\src\licensedcode\data\rules\proprietary-license_92.yml", "YAML", 0, 0, 0, 6, 0, 0, 1, 7
"d:\IDEWORK\lvmen\src\licensedcode\data\rules\proprietary-license_93.yml", "YAML", 0, 0, 0, 3, 0, 0, 1, 4
"d:\IDEWORK\lvmen\src\licensedcode\data\rules\proprietary-license_94.yml", "YAML", 0, 0, 0, 7, 0, 0, 1, 8
"d:\IDEWORK\lvmen\src\licensedcode\data\rules\proprietary-license_95.yml", "YAML", 0, 0, 0, 3, 0, 0, 1, 4
"d:\IDEWORK\lvmen\src\licensedcode\data\rules\proprietary-license_96.yml", "YAML", 0, 0, 0, 9, 0, 0, 1, 10
"d:\IDEWORK\lvmen\src\licensedcode\data\rules\proprietary-license_97.yml", "YAML", 0, 0, 0, 3, 0, 0, 1, 4
"d:\IDEWORK\lvmen\src\licensedcode\data\rules\proprietary-license_98.yml", "YAML", 0, 0, 0, 3, 0, 0, 1, 4
"d:\IDEWORK\lvmen\src\licensedcode\data\rules\proprietary-license_99.yml", "YAML", 0, 0, 0, 3, 0, 0, 1, 4
"d:\IDEWORK\lvmen\src\licensedcode\data\rules\proprietary-license_against-drm.yml", "YAML", 0, 0, 0, 2, 0, 0, 1, 3
"d:\IDEWORK\lvmen\src\licensedcode\data\rules\proprietary-license_and_apache-2.0_1.yml", "YAML", 0, 0, 0, 9, 0, 0, 1, 10
"d:\IDEWORK\lvmen\src\licensedcode\data\rules\proprietary-license_and_apache-2.0_2.yml", "YAML", 0, 0, 0, 9, 0, 0, 1, 10
"d:\IDEWORK\lvmen\src\licensedcode\data\rules\proprietary-license_and_bsd-new_1.yml", "YAML", 0, 0, 0, 3, 0, 0, 1, 4
"d:\IDEWORK\lvmen\src\licensedcode\data\rules\proprietary-license_and_bsd-new_sage.yml", "YAML", 0, 0, 0, 2, 0, 0, 1, 3
"d:\IDEWORK\lvmen\src\licensedcode\data\rules\proprietary-license_and_cc-by-3.0_1.yml", "YAML", 0, 0, 0, 12, 0, 0, 1, 13
"d:\IDEWORK\lvmen\src\licensedcode\data\rules\proprietary-license_and_cc-by-3.0_2.yml", "YAML", 0, 0, 0, 6, 0, 0, 1, 7
"d:\IDEWORK\lvmen\src\licensedcode\data\rules\proprietary-license_and_cc-by-nc-nd-3.0_1.yml", "YAML", 0, 0, 0, 6, 0, 0, 1, 7
"d:\IDEWORK\lvmen\src\licensedcode\data\rules\proprietary-license_and_generic-cla_1.yml", "YAML", 0, 0, 0, 3, 0, 0, 1, 4
"d:\IDEWORK\lvmen\src\licensedcode\data\rules\proprietary-license_and_gpl-1.0-plus_and_lgpl-2.0-plus_1.yml", "YAML", 0, 0, 0, 7, 0, 0, 1, 8
"d:\IDEWORK\lvmen\src\licensedcode\data\rules\proprietary-license_and_gpl-2.0_1.yml", "YAML", 0, 0, 0, 6, 0, 0, 1, 7
"d:\IDEWORK\lvmen\src\licensedcode\data\rules\proprietary-license_and_other-permissive_1.yml", "YAML", 0, 0, 0, 10, 0, 0, 1, 11
"d:\IDEWORK\lvmen\src\licensedcode\data\rules\proprietary-license_and_public-domain_1.yml", "YAML", 0, 0, 0, 5, 0, 0, 1, 6
"d:\IDEWORK\lvmen\src\licensedcode\data\rules\proprietary-license_and_public-domain_2.yml", "YAML", 0, 0, 0, 5, 0, 0, 1, 6
"d:\IDEWORK\lvmen\src\licensedcode\data\rules\proprietary-license_confidential.yml", "YAML", 0, 0, 0, 2, 0, 0, 1, 3
"d:\IDEWORK\lvmen\src\licensedcode\data\rules\proprietary-license_ibm.yml", "YAML", 0, 0, 0, 3, 0, 0, 1, 4
"d:\IDEWORK\lvmen\src\licensedcode\data\rules\proprietary-license_ibm2.yml", "YAML", 0, 0, 0, 3, 0, 0, 1, 4
"d:\IDEWORK\lvmen\src\licensedcode\data\rules\proprietary-license_not_bcm.yml", "YAML", 0, 0, 0, 2, 0, 0, 1, 3
"d:\IDEWORK\lvmen\src\licensedcode\data\rules\proprietary-license_not_unknown_73.yml", "YAML", 0, 0, 0, 3, 0, 0, 1, 4
"d:\IDEWORK\lvmen\src\licensedcode\data\rules\proprietary-license_nuget_url_1.yml", "YAML", 0, 0, 0, 5, 0, 0, 1, 6
"d:\IDEWORK\lvmen\src\licensedcode\data\rules\proprietary-license_or_commercial-license_1.yml", "YAML", 0, 0, 0, 6, 0, 0, 1, 7
"d:\IDEWORK\lvmen\src\licensedcode\data\rules\proprietary-license_or_commercial-license_2.yml", "YAML", 0, 0, 0, 5, 0, 0, 1, 6
"d:\IDEWORK\lvmen\src\licensedcode\data\rules\proprietary-license_or_commercial-license_3.yml", "YAML", 0, 0, 0, 3, 0, 0, 1, 4
"d:\IDEWORK\lvmen\src\licensedcode\data\rules\proprietary-license_or_gpl-3.0_1.yml", "YAML", 0, 0, 0, 2, 0, 0, 1, 3
"d:\IDEWORK\lvmen\src\licensedcode\data\rules\proprietary-license_srl1.yml", "YAML", 0, 0, 0, 6, 0, 0, 1, 7
"d:\IDEWORK\lvmen\src\licensedcode\data\rules\proprietary-license_srl2.yml", "YAML", 0, 0, 0, 6, 0, 0, 1, 7
"d:\IDEWORK\lvmen\src\licensedcode\data\rules\proprietary-license_unknown_13.yml", "YAML", 0, 0, 0, 2, 0, 0, 1, 3
"d:\IDEWORK\lvmen\src\licensedcode\data\rules\proprietary.yml", "YAML", 0, 0, 0, 5, 0, 0, 1, 6
"d:\IDEWORK\lvmen\src\licensedcode\data\rules\proprietary_1.yml", "YAML", 0, 0, 0, 2, 0, 0, 1, 3
"d:\IDEWORK\lvmen\src\licensedcode\data\rules\proprietary_10.yml", "YAML", 0, 0, 0, 3, 0, 0, 1, 4
"d:\IDEWORK\lvmen\src\licensedcode\data\rules\proprietary_100.yml", "YAML", 0, 0, 0, 4, 0, 0, 1, 5
"d:\IDEWORK\lvmen\src\licensedcode\data\rules\proprietary_101.yml", "YAML", 0, 0, 0, 2, 0, 0, 1, 3
"d:\IDEWORK\lvmen\src\licensedcode\data\rules\proprietary_101_1.yml", "YAML", 0, 0, 0, 2, 0, 0, 1, 3
"d:\IDEWORK\lvmen\src\licensedcode\data\rules\proprietary_102.yml", "YAML", 0, 0, 0, 2, 0, 0, 1, 3
"d:\IDEWORK\lvmen\src\licensedcode\data\rules\proprietary_103.yml", "YAML", 0, 0, 0, 3, 0, 0, 1, 4
"d:\IDEWORK\lvmen\src\licensedcode\data\rules\proprietary_104.yml", "YAML", 0, 0, 0, 3, 0, 0, 1, 4
"d:\IDEWORK\lvmen\src\licensedcode\data\rules\proprietary_105.yml", "YAML", 0, 0, 0, 2, 0, 0, 1, 3
"d:\IDEWORK\lvmen\src\licensedcode\data\rules\proprietary_106.yml", "YAML", 0, 0, 0, 2, 0, 0, 1, 3
"d:\IDEWORK\lvmen\src\licensedcode\data\rules\proprietary_107.yml", "YAML", 0, 0, 0, 3, 0, 0, 1, 4
"d:\IDEWORK\lvmen\src\licensedcode\data\rules\proprietary_108.yml", "YAML", 0, 0, 0, 2, 0, 0, 1, 3
"d:\IDEWORK\lvmen\src\licensedcode\data\rules\proprietary_109.yml", "YAML", 0, 0, 0, 2, 0, 0, 1, 3
"d:\IDEWORK\lvmen\src\licensedcode\data\rules\proprietary_11.yml", "YAML", 0, 0, 0, 4, 0, 0, 1, 5
"d:\IDEWORK\lvmen\src\licensedcode\data\rules\proprietary_110.yml", "YAML", 0, 0, 0, 3, 0, 0, 1, 4
"d:\IDEWORK\lvmen\src\licensedcode\data\rules\proprietary_111.yml", "YAML", 0, 0, 0, 5, 0, 0, 1, 6
"d:\IDEWORK\lvmen\src\licensedcode\data\rules\proprietary_112.yml", "YAML", 0, 0, 0, 4, 0, 0, 1, 5
"d:\IDEWORK\lvmen\src\licensedcode\data\rules\proprietary_113.yml", "YAML", 0, 0, 0, 2, 0, 0, 1, 3
"d:\IDEWORK\lvmen\src\licensedcode\data\rules\proprietary_114.yml", "YAML", 0, 0, 0, 3, 0, 0, 1, 4
"d:\IDEWORK\lvmen\src\licensedcode\data\rules\proprietary_115.yml", "YAML", 0, 0, 0, 8, 0, 0, 1, 9
"d:\IDEWORK\lvmen\src\licensedcode\data\rules\proprietary_116.yml", "YAML", 0, 0, 0, 2, 0, 0, 1, 3
"d:\IDEWORK\lvmen\src\licensedcode\data\rules\proprietary_117.yml", "YAML", 0, 0, 0, 6, 0, 0, 1, 7
"d:\IDEWORK\lvmen\src\licensedcode\data\rules\proprietary_118.yml", "YAML", 0, 0, 0, 2, 0, 0, 1, 3
"d:\IDEWORK\lvmen\src\licensedcode\data\rules\proprietary_119.yml", "YAML", 0, 0, 0, 2, 0, 0, 1, 3
"d:\IDEWORK\lvmen\src\licensedcode\data\rules\proprietary_12.yml", "YAML", 0, 0, 0, 3, 0, 0, 1, 4
"d:\IDEWORK\lvmen\src\licensedcode\data\rules\proprietary_120.yml", "YAML", 0, 0, 0, 6, 0, 0, 1, 7
"d:\IDEWORK\lvmen\src\licensedcode\data\rules\proprietary_121.yml", "YAML", 0, 0, 0, 2, 0, 0, 1, 3
"d:\IDEWORK\lvmen\src\licensedcode\data\rules\proprietary_122.yml", "YAML", 0, 0, 0, 4, 0, 0, 1, 5
"d:\IDEWORK\lvmen\src\licensedcode\data\rules\proprietary_123.yml", "YAML", 0, 0, 0, 3, 0, 0, 1, 4
"d:\IDEWORK\lvmen\src\licensedcode\data\rules\proprietary_123_1.yml", "YAML", 0, 0, 0, 5, 0, 0, 1, 6
"d:\IDEWORK\lvmen\src\licensedcode\data\rules\proprietary_123_2.yml", "YAML", 0, 0, 0, 6, 0, 0, 1, 7
"d:\IDEWORK\lvmen\src\licensedcode\data\rules\proprietary_124.yml", "YAML", 0, 0, 0, 3, 0, 0, 1, 4
"d:\IDEWORK\lvmen\src\licensedcode\data\rules\proprietary_125.yml", "YAML", 0, 0, 0, 2, 0, 0, 1, 3
"d:\IDEWORK\lvmen\src\licensedcode\data\rules\proprietary_126.yml", "YAML", 0, 0, 0, 2, 0, 0, 1, 3
"d:\IDEWORK\lvmen\src\licensedcode\data\rules\proprietary_127.yml", "YAML", 0, 0, 0, 4, 0, 0, 1, 5
"d:\IDEWORK\lvmen\src\licensedcode\data\rules\proprietary_128.yml", "YAML", 0, 0, 0, 3, 0, 0, 1, 4
"d:\IDEWORK\lvmen\src\licensedcode\data\rules\proprietary_129.yml", "YAML", 0, 0, 0, 5, 0, 0, 1, 6
"d:\IDEWORK\lvmen\src\licensedcode\data\rules\proprietary_13.yml", "YAML", 0, 0, 0, 4, 0, 0, 1, 5
"d:\IDEWORK\lvmen\src\licensedcode\data\rules\proprietary_130.yml", "YAML", 0, 0, 0, 5, 0, 0, 1, 6
"d:\IDEWORK\lvmen\src\licensedcode\data\rules\proprietary_131.yml", "YAML", 0, 0, 0, 2, 0, 0, 1, 3
"d:\IDEWORK\lvmen\src\licensedcode\data\rules\proprietary_132.yml", "YAML", 0, 0, 0, 2, 0, 0, 1, 3
"d:\IDEWORK\lvmen\src\licensedcode\data\rules\proprietary_133.yml", "YAML", 0, 0, 0, 5, 0, 0, 1, 6
"d:\IDEWORK\lvmen\src\licensedcode\data\rules\proprietary_134.yml", "YAML", 0, 0, 0, 2, 0, 0, 1, 3
"d:\IDEWORK\lvmen\src\licensedcode\data\rules\proprietary_135.yml", "YAML", 0, 0, 0, 3, 0, 0, 1, 4
"d:\IDEWORK\lvmen\src\licensedcode\data\rules\proprietary_136.yml", "YAML", 0, 0, 0, 3, 0, 0, 1, 4
"d:\IDEWORK\lvmen\src\licensedcode\data\rules\proprietary_137.yml", "YAML", 0, 0, 0, 3, 0, 0, 1, 4
"d:\IDEWORK\lvmen\src\licensedcode\data\rules\proprietary_138.yml", "YAML", 0, 0, 0, 3, 0, 0, 1, 4
"d:\IDEWORK\lvmen\src\licensedcode\data\rules\proprietary_139.yml", "YAML", 0, 0, 0, 2, 0, 0, 1, 3
"d:\IDEWORK\lvmen\src\licensedcode\data\rules\proprietary_14.yml", "YAML", 0, 0, 0, 2, 0, 0, 1, 3
"d:\IDEWORK\lvmen\src\licensedcode\data\rules\proprietary_140.yml", "YAML", 0, 0, 0, 2, 0, 0, 1, 3
"d:\IDEWORK\lvmen\src\licensedcode\data\rules\proprietary_141.yml", "YAML", 0, 0, 0, 7, 0, 0, 1, 8
"d:\IDEWORK\lvmen\src\licensedcode\data\rules\proprietary_142.yml", "YAML", 0, 0, 0, 2, 0, 0, 1, 3
"d:\IDEWORK\lvmen\src\licensedcode\data\rules\proprietary_143.yml", "YAML", 0, 0, 0, 3, 0, 0, 1, 4
"d:\IDEWORK\lvmen\src\licensedcode\data\rules\proprietary_144.yml", "YAML", 0, 0, 0, 3, 0, 0, 1, 4
"d:\IDEWORK\lvmen\src\licensedcode\data\rules\proprietary_145.yml", "YAML", 0, 0, 0, 3, 0, 0, 1, 4
"d:\IDEWORK\lvmen\src\licensedcode\data\rules\proprietary_146.yml", "YAML", 0, 0, 0, 3, 0, 0, 1, 4
"d:\IDEWORK\lvmen\src\licensedcode\data\rules\proprietary_147.yml", "YAML", 0, 0, 0, 2, 0, 0, 1, 3
"d:\IDEWORK\lvmen\src\licensedcode\data\rules\proprietary_148.yml", "YAML", 0, 0, 0, 2, 0, 0, 1, 3
"d:\IDEWORK\lvmen\src\licensedcode\data\rules\proprietary_149.yml", "YAML", 0, 0, 0, 2, 0, 0, 1, 3
"d:\IDEWORK\lvmen\src\licensedcode\data\rules\proprietary_15.yml", "YAML", 0, 0, 0, 6, 0, 0, 1, 7
"d:\IDEWORK\lvmen\src\licensedcode\data\rules\proprietary_150.yml", "YAML", 0, 0, 0, 3, 0, 0, 1, 4
"d:\IDEWORK\lvmen\src\licensedcode\data\rules\proprietary_151.yml", "YAML", 0, 0, 0, 4, 0, 0, 1, 5
"d:\IDEWORK\lvmen\src\licensedcode\data\rules\proprietary_152.yml", "YAML", 0, 0, 0, 2, 0, 0, 1, 3
"d:\IDEWORK\lvmen\src\licensedcode\data\rules\proprietary_153.yml", "YAML", 0, 0, 0, 6, 0, 0, 1, 7
"d:\IDEWORK\lvmen\src\licensedcode\data\rules\proprietary_154.yml", "YAML", 0, 0, 0, 10, 0, 0, 1, 11
"d:\IDEWORK\lvmen\src\licensedcode\data\rules\proprietary_16.yml", "YAML", 0, 0, 0, 3, 0, 0, 1, 4
"d:\IDEWORK\lvmen\src\licensedcode\data\rules\proprietary_17.yml", "YAML", 0, 0, 0, 2, 0, 0, 1, 3
"d:\IDEWORK\lvmen\src\licensedcode\data\rules\proprietary_18.yml", "YAML", 0, 0, 0, 3, 0, 0, 1, 4
"d:\IDEWORK\lvmen\src\licensedcode\data\rules\proprietary_19.yml", "YAML", 0, 0, 0, 3, 0, 0, 1, 4
"d:\IDEWORK\lvmen\src\licensedcode\data\rules\proprietary_2.yml", "YAML", 0, 0, 0, 4, 0, 0, 1, 5
"d:\IDEWORK\lvmen\src\licensedcode\data\rules\proprietary_20.yml", "YAML", 0, 0, 0, 2, 0, 0, 1, 3
"d:\IDEWORK\lvmen\src\licensedcode\data\rules\proprietary_21.yml", "YAML", 0, 0, 0, 3, 0, 0, 1, 4
"d:\IDEWORK\lvmen\src\licensedcode\data\rules\proprietary_22.yml", "YAML", 0, 0, 0, 2, 0, 0, 1, 3
"d:\IDEWORK\lvmen\src\licensedcode\data\rules\proprietary_23.yml", "YAML", 0, 0, 0, 3, 0, 0, 1, 4
"d:\IDEWORK\lvmen\src\licensedcode\data\rules\proprietary_24.yml", "YAML", 0, 0, 0, 3, 0, 0, 1, 4
"d:\IDEWORK\lvmen\src\licensedcode\data\rules\proprietary_25.yml", "YAML", 0, 0, 0, 3, 0, 0, 1, 4
"d:\IDEWORK\lvmen\src\licensedcode\data\rules\proprietary_26.yml", "YAML", 0, 0, 0, 2, 0, 0, 1, 3
"d:\IDEWORK\lvmen\src\licensedcode\data\rules\proprietary_27.yml", "YAML", 0, 0, 0, 2, 0, 0, 1, 3
"d:\IDEWORK\lvmen\src\licensedcode\data\rules\proprietary_28.yml", "YAML", 0, 0, 0, 2, 0, 0, 1, 3
"d:\IDEWORK\lvmen\src\licensedcode\data\rules\proprietary_29.yml", "YAML", 0, 0, 0, 2, 0, 0, 1, 3
"d:\IDEWORK\lvmen\src\licensedcode\data\rules\proprietary_3.yml", "YAML", 0, 0, 0, 3, 0, 0, 1, 4
"d:\IDEWORK\lvmen\src\licensedcode\data\rules\proprietary_30.yml", "YAML", 0, 0, 0, 3, 0, 0, 1, 4
"d:\IDEWORK\lvmen\src\licensedcode\data\rules\proprietary_31.yml", "YAML", 0, 0, 0, 3, 0, 0, 1, 4
"d:\IDEWORK\lvmen\src\licensedcode\data\rules\proprietary_32.yml", "YAML", 0, 0, 0, 3, 0, 0, 1, 4
"d:\IDEWORK\lvmen\src\licensedcode\data\rules\proprietary_33.yml", "YAML", 0, 0, 0, 2, 0, 0, 1, 3
"d:\IDEWORK\lvmen\src\licensedcode\data\rules\proprietary_34.yml", "YAML", 0, 0, 0, 3, 0, 0, 1, 4
"d:\IDEWORK\lvmen\src\licensedcode\data\rules\proprietary_35.yml", "YAML", 0, 0, 0, 3, 0, 0, 1, 4
"d:\IDEWORK\lvmen\src\licensedcode\data\rules\proprietary_36.yml", "YAML", 0, 0, 0, 3, 0, 0, 1, 4
"d:\IDEWORK\lvmen\src\licensedcode\data\rules\proprietary_37.yml", "YAML", 0, 0, 0, 3, 0, 0, 1, 4
"d:\IDEWORK\lvmen\src\licensedcode\data\rules\proprietary_38.yml", "YAML", 0, 0, 0, 2, 0, 0, 1, 3
"d:\IDEWORK\lvmen\src\licensedcode\data\rules\proprietary_39.yml", "YAML", 0, 0, 0, 3, 0, 0, 1, 4
"d:\IDEWORK\lvmen\src\licensedcode\data\rules\proprietary_4.yml", "YAML", 0, 0, 0, 4, 0, 0, 1, 5
"d:\IDEWORK\lvmen\src\licensedcode\data\rules\proprietary_40.yml", "YAML", 0, 0, 0, 2, 0, 0, 1, 3
"d:\IDEWORK\lvmen\src\licensedcode\data\rules\proprietary_41.yml", "YAML", 0, 0, 0, 3, 0, 0, 1, 4
"d:\IDEWORK\lvmen\src\licensedcode\data\rules\proprietary_42.yml", "YAML", 0, 0, 0, 4, 0, 0, 1, 5
"d:\IDEWORK\lvmen\src\licensedcode\data\rules\proprietary_43.yml", "YAML", 0, 0, 0, 4, 0, 0, 1, 5
"d:\IDEWORK\lvmen\src\licensedcode\data\rules\proprietary_44.yml", "YAML", 0, 0, 0, 2, 0, 0, 1, 3
"d:\IDEWORK\lvmen\src\licensedcode\data\rules\proprietary_45.yml", "YAML", 0, 0, 0, 2, 0, 0, 1, 3
"d:\IDEWORK\lvmen\src\licensedcode\data\rules\proprietary_46.yml", "YAML", 0, 0, 0, 2, 0, 0, 1, 3
"d:\IDEWORK\lvmen\src\licensedcode\data\rules\proprietary_47.yml", "YAML", 0, 0, 0, 3, 0, 0, 1, 4
"d:\IDEWORK\lvmen\src\licensedcode\data\rules\proprietary_48.yml", "YAML", 0, 0, 0, 3, 0, 0, 1, 4
"d:\IDEWORK\lvmen\src\licensedcode\data\rules\proprietary_49.yml", "YAML", 0, 0, 0, 3, 0, 0, 1, 4
"d:\IDEWORK\lvmen\src\licensedcode\data\rules\proprietary_5.yml", "YAML", 0, 0, 0, 9, 0, 0, 1, 10
"d:\IDEWORK\lvmen\src\licensedcode\data\rules\proprietary_50.yml", "YAML", 0, 0, 0, 2, 0, 0, 1, 3
"d:\IDEWORK\lvmen\src\licensedcode\data\rules\proprietary_51.yml", "YAML", 0, 0, 0, 2, 0, 0, 1, 3
"d:\IDEWORK\lvmen\src\licensedcode\data\rules\proprietary_52.yml", "YAML", 0, 0, 0, 4, 0, 0, 1, 5
"d:\IDEWORK\lvmen\src\licensedcode\data\rules\proprietary_53.yml", "YAML", 0, 0, 0, 2, 0, 0, 1, 3
"d:\IDEWORK\lvmen\src\licensedcode\data\rules\proprietary_54.yml", "YAML", 0, 0, 0, 2, 0, 0, 1, 3
"d:\IDEWORK\lvmen\src\licensedcode\data\rules\proprietary_55.yml", "YAML", 0, 0, 0, 7, 0, 0, 1, 8
"d:\IDEWORK\lvmen\src\licensedcode\data\rules\proprietary_56.yml", "YAML", 0, 0, 0, 6, 0, 0, 1, 7
"d:\IDEWORK\lvmen\src\licensedcode\data\rules\proprietary_56_1.yml", "YAML", 0, 0, 0, 10, 0, 0, 1, 11
"d:\IDEWORK\lvmen\src\licensedcode\data\rules\proprietary_57.yml", "YAML", 0, 0, 0, 6, 0, 0, 1, 7
"d:\IDEWORK\lvmen\src\licensedcode\data\rules\proprietary_58.yml", "YAML", 0, 0, 0, 7, 0, 0, 1, 8
"d:\IDEWORK\lvmen\src\licensedcode\data\rules\proprietary_59.yml", "YAML", 0, 0, 0, 8, 0, 0, 1, 9
"d:\IDEWORK\lvmen\src\licensedcode\data\rules\proprietary_6.yml", "YAML", 0, 0, 0, 3, 0, 0, 1, 4
"d:\IDEWORK\lvmen\src\licensedcode\data\rules\proprietary_60.yml", "YAML", 0, 0, 0, 4, 0, 0, 1, 5
"d:\IDEWORK\lvmen\src\licensedcode\data\rules\proprietary_61.yml", "YAML", 0, 0, 0, 3, 0, 0, 1, 4
"d:\IDEWORK\lvmen\src\licensedcode\data\rules\proprietary_62.yml", "YAML", 0, 0, 0, 3, 0, 0, 1, 4
"d:\IDEWORK\lvmen\src\licensedcode\data\rules\proprietary_63.yml", "YAML", 0, 0, 0, 3, 0, 0, 1, 4
"d:\IDEWORK\lvmen\src\licensedcode\data\rules\proprietary_64.yml", "YAML", 0, 0, 0, 4, 0, 0, 1, 5
"d:\IDEWORK\lvmen\src\licensedcode\data\rules\proprietary_65.yml", "YAML", 0, 0, 0, 2, 0, 0, 1, 3
"d:\IDEWORK\lvmen\src\licensedcode\data\rules\proprietary_66.yml", "YAML", 0, 0, 0, 2, 0, 0, 1, 3
"d:\IDEWORK\lvmen\src\licensedcode\data\rules\proprietary_67.yml", "YAML", 0, 0, 0, 3, 0, 0, 1, 4
"d:\IDEWORK\lvmen\src\licensedcode\data\rules\proprietary_68.yml", "YAML", 0, 0, 0, 2, 0, 0, 1, 3
"d:\IDEWORK\lvmen\src\licensedcode\data\rules\proprietary_69.yml", "YAML", 0, 0, 0, 2, 0, 0, 1, 3
"d:\IDEWORK\lvmen\src\licensedcode\data\rules\proprietary_7.yml", "YAML", 0, 0, 0, 3, 0, 0, 1, 4
"d:\IDEWORK\lvmen\src\licensedcode\data\rules\proprietary_70.yml", "YAML", 0, 0, 0, 3, 0, 0, 1, 4
"d:\IDEWORK\lvmen\src\licensedcode\data\rules\proprietary_71.yml", "YAML", 0, 0, 0, 2, 0, 0, 1, 3
"d:\IDEWORK\lvmen\src\licensedcode\data\rules\proprietary_72.yml", "YAML", 0, 0, 0, 2, 0, 0, 1, 3
"d:\IDEWORK\lvmen\src\licensedcode\data\rules\proprietary_73.yml", "YAML", 0, 0, 0, 2, 0, 0, 1, 3
"d:\IDEWORK\lvmen\src\licensedcode\data\rules\proprietary_74.yml", "YAML", 0, 0, 0, 2, 0, 0, 1, 3
"d:\IDEWORK\lvmen\src\licensedcode\data\rules\proprietary_75.yml", "YAML", 0, 0, 0, 3, 0, 0, 1, 4
"d:\IDEWORK\lvmen\src\licensedcode\data\rules\proprietary_76.yml", "YAML", 0, 0, 0, 2, 0, 0, 1, 3
"d:\IDEWORK\lvmen\src\licensedcode\data\rules\proprietary_77.yml", "YAML", 0, 0, 0, 3, 0, 0, 1, 4
"d:\IDEWORK\lvmen\src\licensedcode\data\rules\proprietary_78.yml", "YAML", 0, 0, 0, 2, 0, 0, 1, 3
"d:\IDEWORK\lvmen\src\licensedcode\data\rules\proprietary_79.yml", "YAML", 0, 0, 0, 2, 0, 0, 1, 3
"d:\IDEWORK\lvmen\src\licensedcode\data\rules\proprietary_8.yml", "YAML", 0, 0, 0, 4, 0, 0, 1, 5
"d:\IDEWORK\lvmen\src\licensedcode\data\rules\proprietary_80.yml", "YAML", 0, 0, 0, 2, 0, 0, 1, 3
"d:\IDEWORK\lvmen\src\licensedcode\data\rules\proprietary_82.yml", "YAML", 0, 0, 0, 2, 0, 0, 1, 3
"d:\IDEWORK\lvmen\src\licensedcode\data\rules\proprietary_83.yml", "YAML", 0, 0, 0, 4, 0, 0, 1, 5
"d:\IDEWORK\lvmen\src\licensedcode\data\rules\proprietary_84.yml", "YAML", 0, 0, 0, 2, 0, 0, 1, 3
"d:\IDEWORK\lvmen\src\licensedcode\data\rules\proprietary_85.yml", "YAML", 0, 0, 0, 2, 0, 0, 1, 3
"d:\IDEWORK\lvmen\src\licensedcode\data\rules\proprietary_86.yml", "YAML", 0, 0, 0, 8, 0, 0, 1, 9
"d:\IDEWORK\lvmen\src\licensedcode\data\rules\proprietary_87.yml", "YAML", 0, 0, 0, 3, 0, 0, 1, 4
"d:\IDEWORK\lvmen\src\licensedcode\data\rules\proprietary_88.yml", "YAML", 0, 0, 0, 6, 0, 0, 1, 7
"d:\IDEWORK\lvmen\src\licensedcode\data\rules\proprietary_89.yml", "YAML", 0, 0, 0, 2, 0, 0, 1, 3
"d:\IDEWORK\lvmen\src\licensedcode\data\rules\proprietary_9.yml", "YAML", 0, 0, 0, 3, 0, 0, 1, 4
"d:\IDEWORK\lvmen\src\licensedcode\data\rules\proprietary_90.yml", "YAML", 0, 0, 0, 2, 0, 0, 1, 3
"d:\IDEWORK\lvmen\src\licensedcode\data\rules\proprietary_91.yml", "YAML", 0, 0, 0, 6, 0, 0, 1, 7
"d:\IDEWORK\lvmen\src\licensedcode\data\rules\proprietary_92.yml", "YAML", 0, 0, 0, 3, 0, 0, 1, 4
"d:\IDEWORK\lvmen\src\licensedcode\data\rules\proprietary_93.yml", "YAML", 0, 0, 0, 5, 0, 0, 1, 6
"d:\IDEWORK\lvmen\src\licensedcode\data\rules\proprietary_94.yml", "YAML", 0, 0, 0, 2, 0, 0, 1, 3
"d:\IDEWORK\lvmen\src\licensedcode\data\rules\proprietary_95.yml", "YAML", 0, 0, 0, 2, 0, 0, 1, 3
"d:\IDEWORK\lvmen\src\licensedcode\data\rules\proprietary_96.yml", "YAML", 0, 0, 0, 2, 0, 0, 1, 3
"d:\IDEWORK\lvmen\src\licensedcode\data\rules\proprietary_97.yml", "YAML", 0, 0, 0, 3, 0, 0, 1, 4
"d:\IDEWORK\lvmen\src\licensedcode\data\rules\proprietary_98.yml", "YAML", 0, 0, 0, 2, 0, 0, 1, 3
"d:\IDEWORK\lvmen\src\licensedcode\data\rules\proprietary_99.yml", "YAML", 0, 0, 0, 4, 0, 0, 1, 5
"d:\IDEWORK\lvmen\src\licensedcode\data\rules\proprietary_academic_1.yml", "YAML", 0, 0, 0, 3, 0, 0, 1, 4
"d:\IDEWORK\lvmen\src\licensedcode\data\rules\proprietary_altera.yml", "YAML", 0, 0, 0, 2, 0, 0, 1, 3
"d:\IDEWORK\lvmen\src\licensedcode\data\rules\proprietary_arachni.yml", "YAML", 0, 0, 0, 5, 0, 0, 1, 6
"d:\IDEWORK\lvmen\src\licensedcode\data\rules\proprietary_arachni2.yml", "YAML", 0, 0, 0, 4, 0, 0, 1, 5
"d:\IDEWORK\lvmen\src\licensedcode\data\rules\proprietary_arachni3.yml", "YAML", 0, 0, 0, 3, 0, 0, 1, 4
"d:\IDEWORK\lvmen\src\licensedcode\data\rules\proprietary_closed.yml", "YAML", 0, 0, 0, 3, 0, 0, 1, 4
"d:\IDEWORK\lvmen\src\licensedcode\data\rules\proprietary_closed2.yml", "YAML", 0, 0, 0, 3, 0, 0, 1, 4
"d:\IDEWORK\lvmen\src\licensedcode\data\rules\proprietary_closed3.yml", "YAML", 0, 0, 0, 3, 0, 0, 1, 4
"d:\IDEWORK\lvmen\src\licensedcode\data\rules\proprietary_confidential.yml", "YAML", 0, 0, 0, 3, 0, 0, 1, 4
"d:\IDEWORK\lvmen\src\licensedcode\data\rules\proprietary_confidential_1.yml", "YAML", 0, 0, 0, 2, 0, 0, 1, 3
"d:\IDEWORK\lvmen\src\licensedcode\data\rules\proprietary_confidential_2.yml", "YAML", 0, 0, 0, 2, 0, 0, 1, 3
"d:\IDEWORK\lvmen\src\licensedcode\data\rules\proprietary_confidential_3.yml", "YAML", 0, 0, 0, 2, 0, 0, 1, 3
"d:\IDEWORK\lvmen\src\licensedcode\data\rules\proprietary_dinkumware.yml", "YAML", 0, 0, 0, 3, 0, 0, 1, 4
"d:\IDEWORK\lvmen\src\licensedcode\data\rules\proprietary_dinkumware_1.yml", "YAML", 0, 0, 0, 2, 0, 0, 1, 3
"d:\IDEWORK\lvmen\src\licensedcode\data\rules\proprietary_dinkumware_2.yml", "YAML", 0, 0, 0, 2, 0, 0, 1, 3
"d:\IDEWORK\lvmen\src\licensedcode\data\rules\proprietary_dinkumware_3.yml", "YAML", 0, 0, 0, 2, 0, 0, 1, 3
"d:\IDEWORK\lvmen\src\licensedcode\data\rules\proprietary_elastic_and_apache-2.0_and_other-permissive_1.yml", "YAML", 0, 0, 0, 2, 0, 0, 1, 3
"d:\IDEWORK\lvmen\src\licensedcode\data\rules\proprietary_eula.yml", "YAML", 0, 0, 0, 2, 0, 0, 1, 3
"d:\IDEWORK\lvmen\src\licensedcode\data\rules\proprietary_fcgi.yml", "YAML", 0, 0, 0, 2, 0, 0, 1, 3
"d:\IDEWORK\lvmen\src\licensedcode\data\rules\proprietary_gpl_and_lgpl.yml", "YAML", 0, 0, 0, 6, 0, 0, 1, 7
"d:\IDEWORK\lvmen\src\licensedcode\data\rules\proprietary_greensock_1.yml", "YAML", 0, 0, 0, 6, 0, 0, 1, 7
"d:\IDEWORK\lvmen\src\licensedcode\data\rules\proprietary_greensock_10.yml", "YAML", 0, 0, 0, 6, 0, 0, 1, 7
"d:\IDEWORK\lvmen\src\licensedcode\data\rules\proprietary_greensock_11.yml", "YAML", 0, 0, 0, 6, 0, 0, 1, 7
"d:\IDEWORK\lvmen\src\licensedcode\data\rules\proprietary_greensock_12.yml", "YAML", 0, 0, 0, 6, 0, 0, 1, 7
"d:\IDEWORK\lvmen\src\licensedcode\data\rules\proprietary_greensock_13.yml", "YAML", 0, 0, 0, 10, 0, 0, 1, 11
"d:\IDEWORK\lvmen\src\licensedcode\data\rules\proprietary_greensock_14.yml", "YAML", 0, 0, 0, 5, 0, 0, 1, 6
"d:\IDEWORK\lvmen\src\licensedcode\data\rules\proprietary_greensock_15.yml", "YAML", 0, 0, 0, 5, 0, 0, 1, 6
"d:\IDEWORK\lvmen\src\licensedcode\data\rules\proprietary_greensock_16.yml", "YAML", 0, 0, 0, 3, 0, 0, 1, 4
"d:\IDEWORK\lvmen\src\licensedcode\data\rules\proprietary_greensock_17.yml", "YAML", 0, 0, 0, 4, 0, 0, 1, 5
"d:\IDEWORK\lvmen\src\licensedcode\data\rules\proprietary_greensock_18.yml", "YAML", 0, 0, 0, 3, 0, 0, 1, 4
"d:\IDEWORK\lvmen\src\licensedcode\data\rules\proprietary_greensock_2.yml", "YAML", 0, 0, 0, 4, 0, 0, 1, 5
"d:\IDEWORK\lvmen\src\licensedcode\data\rules\proprietary_greensock_3.yml", "YAML", 0, 0, 0, 5, 0, 0, 1, 6
"d:\IDEWORK\lvmen\src\licensedcode\data\rules\proprietary_greensock_4.yml", "YAML", 0, 0, 0, 5, 0, 0, 1, 6
"d:\IDEWORK\lvmen\src\licensedcode\data\rules\proprietary_greensock_5.yml", "YAML", 0, 0, 0, 4, 0, 0, 1, 5
"d:\IDEWORK\lvmen\src\licensedcode\data\rules\proprietary_greensock_6.yml", "YAML", 0, 0, 0, 7, 0, 0, 1, 8
"d:\IDEWORK\lvmen\src\licensedcode\data\rules\proprietary_greensock_7.yml", "YAML", 0, 0, 0, 4, 0, 0, 1, 5
"d:\IDEWORK\lvmen\src\licensedcode\data\rules\proprietary_greensock_8.yml", "YAML", 0, 0, 0, 5, 0, 0, 1, 6
"d:\IDEWORK\lvmen\src\licensedcode\data\rules\proprietary_greensock_9.yml", "YAML", 0, 0, 0, 4, 0, 0, 1, 5
"d:\IDEWORK\lvmen\src\licensedcode\data\rules\proprietary_ibm.yml", "YAML", 0, 0, 0, 3, 0, 0, 1, 4
"d:\IDEWORK\lvmen\src\licensedcode\data\rules\proprietary_intel-license.yml", "YAML", 0, 0, 0, 2, 0, 0, 1, 3
"d:\IDEWORK\lvmen\src\licensedcode\data\rules\proprietary_intel-security-disclaimer.yml", "YAML", 0, 0, 0, 2, 0, 0, 1, 3
"d:\IDEWORK\lvmen\src\licensedcode\data\rules\proprietary_international2.yml", "YAML", 0, 0, 0, 2, 0, 0, 1, 3
"d:\IDEWORK\lvmen\src\licensedcode\data\rules\proprietary_international3.yml", "YAML", 0, 0, 0, 2, 0, 0, 1, 3
"d:\IDEWORK\lvmen\src\licensedcode\data\rules\proprietary_international4.yml", "YAML", 0, 0, 0, 2, 0, 0, 1, 3
"d:\IDEWORK\lvmen\src\licensedcode\data\rules\proprietary_international5.yml", "YAML", 0, 0, 0, 2, 0, 0, 1, 3
"d:\IDEWORK\lvmen\src\licensedcode\data\rules\proprietary_non-commercial1.yml", "YAML", 0, 0, 0, 4, 0, 0, 1, 5
"d:\IDEWORK\lvmen\src\licensedcode\data\rules\proprietary_non-commercial2.yml", "YAML", 0, 0, 0, 3, 0, 0, 1, 4
"d:\IDEWORK\lvmen\src\licensedcode\data\rules\proprietary_non-commercial3.yml", "YAML", 0, 0, 0, 4, 0, 0, 1, 5
"d:\IDEWORK\lvmen\src\licensedcode\data\rules\proprietary_non-commercial4.yml", "YAML", 0, 0, 0, 4, 0, 0, 1, 5
"d:\IDEWORK\lvmen\src\licensedcode\data\rules\proprietary_non-commercial5.yml", "YAML", 0, 0, 0, 4, 0, 0, 1, 5
"d:\IDEWORK\lvmen\src\licensedcode\data\rules\proprietary_non-commercial6.yml", "YAML", 0, 0, 0, 3, 0, 0, 1, 4
"d:\IDEWORK\lvmen\src\licensedcode\data\rules\proprietary_non-proprietary.yml", "YAML", 0, 0, 0, 4, 0, 0, 1, 5
"d:\IDEWORK\lvmen\src\licensedcode\data\rules\proprietary_nvidia.yml", "YAML", 0, 0, 0, 2, 0, 0, 1, 3
"d:\IDEWORK\lvmen\src\licensedcode\data\rules\proprietary_nvidia2.yml", "YAML", 0, 0, 0, 2, 0, 0, 1, 3
"d:\IDEWORK\lvmen\src\licensedcode\data\rules\proprietary_or_gpl-2.0_1.yml", "YAML", 0, 0, 0, 5, 0, 0, 1, 6
"d:\IDEWORK\lvmen\src\licensedcode\data\rules\proprietary_or_gpl-2.0_2.yml", "YAML", 0, 0, 0, 5, 0, 0, 1, 6
"d:\IDEWORK\lvmen\src\licensedcode\data\rules\proprietary_or_gpl-2.0_3.yml", "YAML", 0, 0, 0, 5, 0, 0, 1, 6
"d:\IDEWORK\lvmen\src\licensedcode\data\rules\proprietary_or_gpl-2.0_4.yml", "YAML", 0, 0, 0, 5, 0, 0, 1, 6
"d:\IDEWORK\lvmen\src\licensedcode\data\rules\proprietary_or_gpl-2.0_5.yml", "YAML", 0, 0, 0, 5, 0, 0, 1, 6
"d:\IDEWORK\lvmen\src\licensedcode\data\rules\proprietary_or_lgpl_and_gpl.yml", "YAML", 0, 0, 0, 3, 0, 0, 1, 4
"d:\IDEWORK\lvmen\src\licensedcode\data\rules\proprietary_phoenix.yml", "YAML", 0, 0, 0, 6, 0, 0, 1, 7
"d:\IDEWORK\lvmen\src\licensedcode\data\rules\proprietary_pizza.yml", "YAML", 0, 0, 0, 4, 0, 0, 1, 5
"d:\IDEWORK\lvmen\src\licensedcode\data\rules\proprietary_reproduce.yml", "YAML", 0, 0, 0, 2, 0, 0, 1, 3
"d:\IDEWORK\lvmen\src\licensedcode\data\rules\proprietary_reproduce2.yml", "YAML", 0, 0, 0, 2, 0, 0, 1, 3
"d:\IDEWORK\lvmen\src\licensedcode\data\rules\proprietary_sei-cmu.yml", "YAML", 0, 0, 0, 2, 0, 0, 1, 3
"d:\IDEWORK\lvmen\src\licensedcode\data\rules\proprietary_sei-cmu2.yml", "YAML", 0, 0, 0, 4, 0, 0, 1, 5
"d:\IDEWORK\lvmen\src\licensedcode\data\rules\proprietary_sncl_1.1.0.yml", "YAML", 0, 0, 0, 2, 0, 0, 1, 3
"d:\IDEWORK\lvmen\src\licensedcode\data\rules\proprietary_sncl_2.0.0.yml", "YAML", 0, 0, 0, 2, 0, 0, 1, 3
"d:\IDEWORK\lvmen\src\licensedcode\data\rules\proprietary_sncl_ft_2.0.0.yml", "YAML", 0, 0, 0, 2, 0, 0, 1, 3
"d:\IDEWORK\lvmen\src\licensedcode\data\rules\proprietary_sncl_ft_2.0.2.yml", "YAML", 0, 0, 0, 2, 0, 0, 1, 3
"d:\IDEWORK\lvmen\src\licensedcode\data\rules\proprietary_sncl_ft_2.3.0.yml", "YAML", 0, 0, 0, 2, 0, 0, 1, 3
"d:\IDEWORK\lvmen\src\licensedcode\data\rules\proprietary_ualarm_1.yml", "YAML", 0, 0, 0, 2, 0, 0, 1, 3
"d:\IDEWORK\lvmen\src\licensedcode\data\rules\proprietary_unbound.yml", "YAML", 0, 0, 0, 2, 0, 0, 1, 3
"d:\IDEWORK\lvmen\src\licensedcode\data\rules\proprietary_use.yml", "YAML", 0, 0, 0, 3, 0, 0, 1, 4
"d:\IDEWORK\lvmen\src\licensedcode\data\rules\proprietary_vfeed.yml", "YAML", 0, 0, 0, 4, 0, 0, 1, 5
"d:\IDEWORK\lvmen\src\licensedcode\data\rules\proprietary_vfeed2.yml", "YAML", 0, 0, 0, 14, 0, 0, 1, 15
"d:\IDEWORK\lvmen\src\licensedcode\data\rules\proprietary_vfeed3.yml", "YAML", 0, 0, 0, 4, 0, 0, 1, 5
"d:\IDEWORK\lvmen\src\licensedcode\data\rules\proprietary_xvgif.yml", "YAML", 0, 0, 0, 2, 0, 0, 1, 3
"d:\IDEWORK\lvmen\src\licensedcode\data\rules\prosperity-2.0_1.yml", "YAML", 0, 0, 0, 3, 0, 0, 1, 4
"d:\IDEWORK\lvmen\src\licensedcode\data\rules\prosperity-2.0_2.yml", "YAML", 0, 0, 0, 3, 0, 0, 1, 4
"d:\IDEWORK\lvmen\src\licensedcode\data\rules\prosperity-3.0_1.yml", "YAML", 0, 0, 0, 3, 0, 0, 1, 4
"d:\IDEWORK\lvmen\src\licensedcode\data\rules\prosperity-3.0_2.yml", "YAML", 0, 0, 0, 3, 0, 0, 1, 4
"d:\IDEWORK\lvmen\src\licensedcode\data\rules\prosperity-3.0_3.yml", "YAML", 0, 0, 0, 3, 0, 0, 1, 4
"d:\IDEWORK\lvmen\src\licensedcode\data\rules\protobuf_nuget_url_1.yml", "YAML", 0, 0, 0, 5, 0, 0, 1, 6
"d:\IDEWORK\lvmen\src\licensedcode\data\rules\ps-or-pdf-font-exception-20170817_url_1.yml", "YAML", 0, 0, 0, 5, 0, 0, 1, 6
"d:\IDEWORK\lvmen\src\licensedcode\data\rules\ps-or-pdf-font-exception-20170817_url_2.yml", "YAML", 0, 0, 0, 5, 0, 0, 1, 6
"d:\IDEWORK\lvmen\src\licensedcode\data\rules\psf-2.0_1.yml", "YAML", 0, 0, 0, 8, 0, 0, 1, 9
"d:\IDEWORK\lvmen\src\licensedcode\data\rules\psfrag_url_1.yml", "YAML", 0, 0, 0, 5, 0, 0, 1, 6
"d:\IDEWORK\lvmen\src\licensedcode\data\rules\psfrag_url_2.yml", "YAML", 0, 0, 0, 5, 0, 0, 1, 6
"d:\IDEWORK\lvmen\src\licensedcode\data\rules\psutils_url_1.yml", "YAML", 0, 0, 0, 5, 0, 0, 1, 6
"d:\IDEWORK\lvmen\src\licensedcode\data\rules\psutils_url_2.yml", "YAML", 0, 0, 0, 5, 0, 0, 1, 6
"d:\IDEWORK\lvmen\src\licensedcode\data\rules\psytec-freesoft.yml", "YAML", 0, 0, 0, 3, 0, 0, 1, 4
"d:\IDEWORK\lvmen\src\licensedcode\data\rules\psytec-freesoft_1.yml", "YAML", 0, 0, 0, 3, 0, 0, 1, 4
"d:\IDEWORK\lvmen\src\licensedcode\data\rules\public-domain-disclaimer_1.yml", "YAML", 0, 0, 0, 2, 0, 0, 1, 3
"d:\IDEWORK\lvmen\src\licensedcode\data\rules\public-domain-disclaimer_10.yml", "YAML", 0, 0, 0, 2, 0, 0, 1, 3
"d:\IDEWORK\lvmen\src\licensedcode\data\rules\public-domain-disclaimer_11.yml", "YAML", 0, 0, 0, 2, 0, 0, 1, 3
"d:\IDEWORK\lvmen\src\licensedcode\data\rules\public-domain-disclaimer_12.yml", "YAML", 0, 0, 0, 2, 0, 0, 1, 3
"d:\IDEWORK\lvmen\src\licensedcode\data\rules\public-domain-disclaimer_13.yml", "YAML", 0, 0, 0, 2, 0, 0, 1, 3
"d:\IDEWORK\lvmen\src\licensedcode\data\rules\public-domain-disclaimer_134.yml", "YAML", 0, 0, 0, 3, 0, 0, 1, 4
"d:\IDEWORK\lvmen\src\licensedcode\data\rules\public-domain-disclaimer_135.yml", "YAML", 0, 0, 0, 3, 0, 0, 1, 4
"d:\IDEWORK\lvmen\src\licensedcode\data\rules\public-domain-disclaimer_136.yml", "YAML", 0, 0, 0, 3, 0, 0, 1, 4
"d:\IDEWORK\lvmen\src\licensedcode\data\rules\public-domain-disclaimer_137.yml", "YAML", 0, 0, 0, 3, 0, 0, 1, 4
"d:\IDEWORK\lvmen\src\licensedcode\data\rules\public-domain-disclaimer_14.yml", "YAML", 0, 0, 0, 5, 0, 0, 1, 6
"d:\IDEWORK\lvmen\src\licensedcode\data\rules\public-domain-disclaimer_15.yml", "YAML", 0, 0, 0, 2, 0, 0, 1, 3
"d:\IDEWORK\lvmen\src\licensedcode\data\rules\public-domain-disclaimer_16.yml", "YAML", 0, 0, 0, 2, 0, 0, 1, 3
"d:\IDEWORK\lvmen\src\licensedcode\data\rules\public-domain-disclaimer_17.yml", "YAML", 0, 0, 0, 4, 0, 0, 1, 5
"d:\IDEWORK\lvmen\src\licensedcode\data\rules\public-domain-disclaimer_18.yml", "YAML", 0, 0, 0, 2, 0, 0, 1, 3
"d:\IDEWORK\lvmen\src\licensedcode\data\rules\public-domain-disclaimer_19.yml", "YAML", 0, 0, 0, 3, 0, 0, 1, 4
"d:\IDEWORK\lvmen\src\licensedcode\data\rules\public-domain-disclaimer_2.yml", "YAML", 0, 0, 0, 4, 0, 0, 1, 5
"d:\IDEWORK\lvmen\src\licensedcode\data\rules\public-domain-disclaimer_20.yml", "YAML", 0, 0, 0, 5, 0, 0, 1, 6
"d:\IDEWORK\lvmen\src\licensedcode\data\rules\public-domain-disclaimer_21.yml", "YAML", 0, 0, 0, 5, 0, 0, 1, 6
"d:\IDEWORK\lvmen\src\licensedcode\data\rules\public-domain-disclaimer_22.yml", "YAML", 0, 0, 0, 3, 0, 0, 1, 4
"d:\IDEWORK\lvmen\src\licensedcode\data\rules\public-domain-disclaimer_23.yml", "YAML", 0, 0, 0, 5, 0, 0, 1, 6
"d:\IDEWORK\lvmen\src\licensedcode\data\rules\public-domain-disclaimer_24.yml", "YAML", 0, 0, 0, 2, 0, 0, 1, 3
"d:\IDEWORK\lvmen\src\licensedcode\data\rules\public-domain-disclaimer_25.yml", "YAML", 0, 0, 0, 2, 0, 0, 1, 3
"d:\IDEWORK\lvmen\src\licensedcode\data\rules\public-domain-disclaimer_26.yml", "YAML", 0, 0, 0, 5, 0, 0, 1, 6
"d:\IDEWORK\lvmen\src\licensedcode\data\rules\public-domain-disclaimer_27.yml", "YAML", 0, 0, 0, 3, 0, 0, 1, 4
"d:\IDEWORK\lvmen\src\licensedcode\data\rules\public-domain-disclaimer_28.yml", "YAML", 0, 0, 0, 3, 0, 0, 1, 4
"d:\IDEWORK\lvmen\src\licensedcode\data\rules\public-domain-disclaimer_29.yml", "YAML", 0, 0, 0, 3, 0, 0, 1, 4
"d:\IDEWORK\lvmen\src\licensedcode\data\rules\public-domain-disclaimer_3.yml", "YAML", 0, 0, 0, 4, 0, 0, 1, 5
"d:\IDEWORK\lvmen\src\licensedcode\data\rules\public-domain-disclaimer_30.yml", "YAML", 0, 0, 0, 2, 0, 0, 1, 3
"d:\IDEWORK\lvmen\src\licensedcode\data\rules\public-domain-disclaimer_31.yml", "YAML", 0, 0, 0, 3, 0, 0, 1, 4
"d:\IDEWORK\lvmen\src\licensedcode\data\rules\public-domain-disclaimer_32.yml", "YAML", 0, 0, 0, 9, 0, 0, 1, 10
"d:\IDEWORK\lvmen\src\licensedcode\data\rules\public-domain-disclaimer_33.yml", "YAML", 0, 0, 0, 2, 0, 0, 1, 3
"d:\IDEWORK\lvmen\src\licensedcode\data\rules\public-domain-disclaimer_34.yml", "YAML", 0, 0, 0, 2, 0, 0, 1, 3
"d:\IDEWORK\lvmen\src\licensedcode\data\rules\public-domain-disclaimer_35.yml", "YAML", 0, 0, 0, 3, 0, 0, 1, 4
"d:\IDEWORK\lvmen\src\licensedcode\data\rules\public-domain-disclaimer_36.yml", "YAML", 0, 0, 0, 3, 0, 0, 1, 4
"d:\IDEWORK\lvmen\src\licensedcode\data\rules\public-domain-disclaimer_37.yml", "YAML", 0, 0, 0, 3, 0, 0, 1, 4
"d:\IDEWORK\lvmen\src\licensedcode\data\rules\public-domain-disclaimer_38.yml", "YAML", 0, 0, 0, 3, 0, 0, 1, 4
"d:\IDEWORK\lvmen\src\licensedcode\data\rules\public-domain-disclaimer_39.yml", "YAML", 0, 0, 0, 3, 0, 0, 1, 4
"d:\IDEWORK\lvmen\src\licensedcode\data\rules\public-domain-disclaimer_4.yml", "YAML", 0, 0, 0, 3, 0, 0, 1, 4
"d:\IDEWORK\lvmen\src\licensedcode\data\rules\public-domain-disclaimer_40.yml", "YAML", 0, 0, 0, 3, 0, 0, 1, 4
"d:\IDEWORK\lvmen\src\licensedcode\data\rules\public-domain-disclaimer_41.yml", "YAML", 0, 0, 0, 3, 0, 0, 1, 4
"d:\IDEWORK\lvmen\src\licensedcode\data\rules\public-domain-disclaimer_42.yml", "YAML", 0, 0, 0, 3, 0, 0, 1, 4
"d:\IDEWORK\lvmen\src\licensedcode\data\rules\public-domain-disclaimer_43.yml", "YAML", 0, 0, 0, 3, 0, 0, 1, 4
"d:\IDEWORK\lvmen\src\licensedcode\data\rules\public-domain-disclaimer_44.yml", "YAML", 0, 0, 0, 3, 0, 0, 1, 4
"d:\IDEWORK\lvmen\src\licensedcode\data\rules\public-domain-disclaimer_45.yml", "YAML", 0, 0, 0, 3, 0, 0, 1, 4
"d:\IDEWORK\lvmen\src\licensedcode\data\rules\public-domain-disclaimer_46.yml", "YAML", 0, 0, 0, 3, 0, 0, 1, 4
"d:\IDEWORK\lvmen\src\licensedcode\data\rules\public-domain-disclaimer_47.yml", "YAML", 0, 0, 0, 3, 0, 0, 1, 4
"d:\IDEWORK\lvmen\src\licensedcode\data\rules\public-domain-disclaimer_48.yml", "YAML", 0, 0, 0, 3, 0, 0, 1, 4
"d:\IDEWORK\lvmen\src\licensedcode\data\rules\public-domain-disclaimer_49.yml", "YAML", 0, 0, 0, 3, 0, 0, 1, 4
"d:\IDEWORK\lvmen\src\licensedcode\data\rules\public-domain-disclaimer_5.yml", "YAML", 0, 0, 0, 3, 0, 0, 1, 4
"d:\IDEWORK\lvmen\src\licensedcode\data\rules\public-domain-disclaimer_50.yml", "YAML", 0, 0, 0, 4, 0, 0, 1, 5
"d:\IDEWORK\lvmen\src\licensedcode\data\rules\public-domain-disclaimer_51.yml", "YAML", 0, 0, 0, 3, 0, 0, 1, 4
"d:\IDEWORK\lvmen\src\licensedcode\data\rules\public-domain-disclaimer_52.yml", "YAML", 0, 0, 0, 3, 0, 0, 1, 4
"d:\IDEWORK\lvmen\src\licensedcode\data\rules\public-domain-disclaimer_53.yml", "YAML", 0, 0, 0, 4, 0, 0, 1, 5
"d:\IDEWORK\lvmen\src\licensedcode\data\rules\public-domain-disclaimer_54.yml", "YAML", 0, 0, 0, 5, 0, 0, 1, 6
"d:\IDEWORK\lvmen\src\licensedcode\data\rules\public-domain-disclaimer_55.yml", "YAML", 0, 0, 0, 3, 0, 0, 1, 4
"d:\IDEWORK\lvmen\src\licensedcode\data\rules\public-domain-disclaimer_56.yml", "YAML", 0, 0, 0, 3, 0, 0, 1, 4
"d:\IDEWORK\lvmen\src\licensedcode\data\rules\public-domain-disclaimer_57.yml", "YAML", 0, 0, 0, 3, 0, 0, 1, 4
"d:\IDEWORK\lvmen\src\licensedcode\data\rules\public-domain-disclaimer_58.yml", "YAML", 0, 0, 0, 3, 0, 0, 1, 4
"d:\IDEWORK\lvmen\src\licensedcode\data\rules\public-domain-disclaimer_59.yml", "YAML", 0, 0, 0, 3, 0, 0, 1, 4
"d:\IDEWORK\lvmen\src\licensedcode\data\rules\public-domain-disclaimer_6.yml", "YAML", 0, 0, 0, 2, 0, 0, 1, 3
"d:\IDEWORK\lvmen\src\licensedcode\data\rules\public-domain-disclaimer_60.yml", "YAML", 0, 0, 0, 3, 0, 0, 1, 4
"d:\IDEWORK\lvmen\src\licensedcode\data\rules\public-domain-disclaimer_61.yml", "YAML", 0, 0, 0, 3, 0, 0, 1, 4
"d:\IDEWORK\lvmen\src\licensedcode\data\rules\public-domain-disclaimer_62.yml", "YAML", 0, 0, 0, 3, 0, 0, 1, 4
"d:\IDEWORK\lvmen\src\licensedcode\data\rules\public-domain-disclaimer_63.yml", "YAML", 0, 0, 0, 3, 0, 0, 1, 4
"d:\IDEWORK\lvmen\src\licensedcode\data\rules\public-domain-disclaimer_64.yml", "YAML", 0, 0, 0, 3, 0, 0, 1, 4
"d:\IDEWORK\lvmen\src\licensedcode\data\rules\public-domain-disclaimer_65.yml", "YAML", 0, 0, 0, 3, 0, 0, 1, 4
"d:\IDEWORK\lvmen\src\licensedcode\data\rules\public-domain-disclaimer_66.yml", "YAML", 0, 0, 0, 3, 0, 0, 1, 4
"d:\IDEWORK\lvmen\src\licensedcode\data\rules\public-domain-disclaimer_67.yml", "YAML", 0, 0, 0, 4, 0, 0, 1, 5
"d:\IDEWORK\lvmen\src\licensedcode\data\rules\public-domain-disclaimer_68.yml", "YAML", 0, 0, 0, 4, 0, 0, 1, 5
"d:\IDEWORK\lvmen\src\licensedcode\data\rules\public-domain-disclaimer_69.yml", "YAML", 0, 0, 0, 5, 0, 0, 2, 7
"d:\IDEWORK\lvmen\src\licensedcode\data\rules\public-domain-disclaimer_7.yml", "YAML", 0, 0, 0, 3, 0, 0, 1, 4
"d:\IDEWORK\lvmen\src\licensedcode\data\rules\public-domain-disclaimer_70.yml", "YAML", 0, 0, 0, 2, 0, 0, 1, 3
"d:\IDEWORK\lvmen\src\licensedcode\data\rules\public-domain-disclaimer_71.yml", "YAML", 0, 0, 0, 2, 0, 0, 1, 3
"d:\IDEWORK\lvmen\src\licensedcode\data\rules\public-domain-disclaimer_72.yml", "YAML", 0, 0, 0, 4, 0, 0, 1, 5
"d:\IDEWORK\lvmen\src\licensedcode\data\rules\public-domain-disclaimer_73.yml", "YAML", 0, 0, 0, 3, 0, 0, 1, 4
"d:\IDEWORK\lvmen\src\licensedcode\data\rules\public-domain-disclaimer_8.yml", "YAML", 0, 0, 0, 2, 0, 0, 1, 3
"d:\IDEWORK\lvmen\src\licensedcode\data\rules\public-domain-disclaimer_9.yml", "YAML", 0, 0, 0, 2, 0, 0, 1, 3
"d:\IDEWORK\lvmen\src\licensedcode\data\rules\public-domain-disclaimer_not_sax-pd2.yml", "YAML", 0, 0, 0, 3, 0, 0, 1, 4
"d:\IDEWORK\lvmen\src\licensedcode\data\rules\public-domain-disclaimer_or_other-permissive_1.yml", "YAML", 0, 0, 0, 2, 0, 0, 1, 3
"d:\IDEWORK\lvmen\src\licensedcode\data\rules\public-domain_0.yml", "YAML", 0, 0, 0, 3, 0, 0, 1, 4
"d:\IDEWORK\lvmen\src\licensedcode\data\rules\public-domain_1.yml", "YAML", 0, 0, 0, 3, 0, 0, 1, 4
"d:\IDEWORK\lvmen\src\licensedcode\data\rules\public-domain_10.yml", "YAML", 0, 0, 0, 2, 0, 0, 1, 3
"d:\IDEWORK\lvmen\src\licensedcode\data\rules\public-domain_100.yml", "YAML", 0, 0, 0, 3, 0, 0, 1, 4
"d:\IDEWORK\lvmen\src\licensedcode\data\rules\public-domain_101.yml", "YAML", 0, 0, 0, 3, 0, 0, 1, 4
"d:\IDEWORK\lvmen\src\licensedcode\data\rules\public-domain_102.yml", "YAML", 0, 0, 0, 3, 0, 0, 1, 4
"d:\IDEWORK\lvmen\src\licensedcode\data\rules\public-domain_103.yml", "YAML", 0, 0, 0, 3, 0, 0, 1, 4
"d:\IDEWORK\lvmen\src\licensedcode\data\rules\public-domain_104.yml", "YAML", 0, 0, 0, 3, 0, 0, 1, 4
"d:\IDEWORK\lvmen\src\licensedcode\data\rules\public-domain_105.yml", "YAML", 0, 0, 0, 3, 0, 0, 1, 4
"d:\IDEWORK\lvmen\src\licensedcode\data\rules\public-domain_106.yml", "YAML", 0, 0, 0, 3, 0, 0, 1, 4
"d:\IDEWORK\lvmen\src\licensedcode\data\rules\public-domain_107.yml", "YAML", 0, 0, 0, 2, 0, 0, 1, 3
"d:\IDEWORK\lvmen\src\licensedcode\data\rules\public-domain_108.yml", "YAML", 0, 0, 0, 3, 0, 0, 1, 4
"d:\IDEWORK\lvmen\src\licensedcode\data\rules\public-domain_109.yml", "YAML", 0, 0, 0, 3, 0, 0, 1, 4
"d:\IDEWORK\lvmen\src\licensedcode\data\rules\public-domain_11.yml", "YAML", 0, 0, 0, 3, 0, 0, 1, 4
"d:\IDEWORK\lvmen\src\licensedcode\data\rules\public-domain_110.yml", "YAML", 0, 0, 0, 3, 0, 0, 1, 4
"d:\IDEWORK\lvmen\src\licensedcode\data\rules\public-domain_111.yml", "YAML", 0, 0, 0, 2, 0, 0, 1, 3
"d:\IDEWORK\lvmen\src\licensedcode\data\rules\public-domain_112.yml", "YAML", 0, 0, 0, 3, 0, 0, 1, 4
"d:\IDEWORK\lvmen\src\licensedcode\data\rules\public-domain_113.yml", "YAML", 0, 0, 0, 3, 0, 0, 1, 4
"d:\IDEWORK\lvmen\src\licensedcode\data\rules\public-domain_114.yml", "YAML", 0, 0, 0, 3, 0, 0, 1, 4
"d:\IDEWORK\lvmen\src\licensedcode\data\rules\public-domain_115.yml", "YAML", 0, 0, 0, 3, 0, 0, 1, 4
"d:\IDEWORK\lvmen\src\licensedcode\data\rules\public-domain_116.yml", "YAML", 0, 0, 0, 3, 0, 0, 1, 4
"d:\IDEWORK\lvmen\src\licensedcode\data\rules\public-domain_117.yml", "YAML", 0, 0, 0, 3, 0, 0, 1, 4
"d:\IDEWORK\lvmen\src\licensedcode\data\rules\public-domain_118.yml", "YAML", 0, 0, 0, 3, 0, 0, 1, 4
"d:\IDEWORK\lvmen\src\licensedcode\data\rules\public-domain_119.yml", "YAML", 0, 0, 0, 3, 0, 0, 1, 4
"d:\IDEWORK\lvmen\src\licensedcode\data\rules\public-domain_12.yml", "YAML", 0, 0, 0, 3, 0, 0, 1, 4
"d:\IDEWORK\lvmen\src\licensedcode\data\rules\public-domain_120.yml", "YAML", 0, 0, 0, 5, 0, 0, 1, 6
"d:\IDEWORK\lvmen\src\licensedcode\data\rules\public-domain_121.yml", "YAML", 0, 0, 0, 3, 0, 0, 1, 4
"d:\IDEWORK\lvmen\src\licensedcode\data\rules\public-domain_122.yml", "YAML", 0, 0, 0, 3, 0, 0, 1, 4
"d:\IDEWORK\lvmen\src\licensedcode\data\rules\public-domain_123.yml", "YAML", 0, 0, 0, 6, 0, 0, 1, 7
"d:\IDEWORK\lvmen\src\licensedcode\data\rules\public-domain_124.yml", "YAML", 0, 0, 0, 4, 0, 0, 1, 5
"d:\IDEWORK\lvmen\src\licensedcode\data\rules\public-domain_125.yml", "YAML", 0, 0, 0, 3, 0, 0, 1, 4
"d:\IDEWORK\lvmen\src\licensedcode\data\rules\public-domain_126.yml", "YAML", 0, 0, 0, 3, 0, 0, 1, 4
"d:\IDEWORK\lvmen\src\licensedcode\data\rules\public-domain_127.yml", "YAML", 0, 0, 0, 3, 0, 0, 1, 4
"d:\IDEWORK\lvmen\src\licensedcode\data\rules\public-domain_128.yml", "YAML", 0, 0, 0, 3, 0, 0, 1, 4
"d:\IDEWORK\lvmen\src\licensedcode\data\rules\public-domain_129.yml", "YAML", 0, 0, 0, 4, 0, 0, 1, 5
"d:\IDEWORK\lvmen\src\licensedcode\data\rules\public-domain_13.yml", "YAML", 0, 0, 0, 3, 0, 0, 1, 4
"d:\IDEWORK\lvmen\src\licensedcode\data\rules\public-domain_130.yml", "YAML", 0, 0, 0, 3, 0, 0, 1, 4
"d:\IDEWORK\lvmen\src\licensedcode\data\rules\public-domain_131.yml", "YAML", 0, 0, 0, 3, 0, 0, 1, 4
"d:\IDEWORK\lvmen\src\licensedcode\data\rules\public-domain_132.yml", "YAML", 0, 0, 0, 3, 0, 0, 1, 4
"d:\IDEWORK\lvmen\src\licensedcode\data\rules\public-domain_133.yml", "YAML", 0, 0, 0, 3, 0, 0, 1, 4
"d:\IDEWORK\lvmen\src\licensedcode\data\rules\public-domain_134.yml", "YAML", 0, 0, 0, 2, 0, 0, 1, 3
"d:\IDEWORK\lvmen\src\licensedcode\data\rules\public-domain_135.yml", "YAML", 0, 0, 0, 3, 0, 0, 1, 4
"d:\IDEWORK\lvmen\src\licensedcode\data\rules\public-domain_136.yml", "YAML", 0, 0, 0, 4, 0, 0, 1, 5
"d:\IDEWORK\lvmen\src\licensedcode\data\rules\public-domain_137.yml", "YAML", 0, 0, 0, 3, 0, 0, 1, 4
"d:\IDEWORK\lvmen\src\licensedcode\data\rules\public-domain_138.yml", "YAML", 0, 0, 0, 6, 0, 0, 1, 7
"d:\IDEWORK\lvmen\src\licensedcode\data\rules\public-domain_139.yml", "YAML", 0, 0, 0, 6, 0, 0, 1, 7
"d:\IDEWORK\lvmen\src\licensedcode\data\rules\public-domain_14.yml", "YAML", 0, 0, 0, 4, 0, 0, 1, 5
"d:\IDEWORK\lvmen\src\licensedcode\data\rules\public-domain_140.yml", "YAML", 0, 0, 0, 2, 0, 0, 1, 3
"d:\IDEWORK\lvmen\src\licensedcode\data\rules\public-domain_141.yml", "YAML", 0, 0, 0, 3, 0, 0, 1, 4
"d:\IDEWORK\lvmen\src\licensedcode\data\rules\public-domain_142.yml", "YAML", 0, 0, 0, 3, 0, 0, 1, 4
"d:\IDEWORK\lvmen\src\licensedcode\data\rules\public-domain_143.yml", "YAML", 0, 0, 0, 3, 0, 0, 1, 4
"d:\IDEWORK\lvmen\src\licensedcode\data\rules\public-domain_144.yml", "YAML", 0, 0, 0, 3, 0, 0, 1, 4
"d:\IDEWORK\lvmen\src\licensedcode\data\rules\public-domain_145.yml", "YAML", 0, 0, 0, 3, 0, 0, 1, 4
"d:\IDEWORK\lvmen\src\licensedcode\data\rules\public-domain_146.yml", "YAML", 0, 0, 0, 3, 0, 0, 1, 4
"d:\IDEWORK\lvmen\src\licensedcode\data\rules\public-domain_147.yml", "YAML", 0, 0, 0, 3, 0, 0, 1, 4
"d:\IDEWORK\lvmen\src\licensedcode\data\rules\public-domain_148.yml", "YAML", 0, 0, 0, 3, 0, 0, 1, 4
"d:\IDEWORK\lvmen\src\licensedcode\data\rules\public-domain_149.yml", "YAML", 0, 0, 0, 3, 0, 0, 1, 4
"d:\IDEWORK\lvmen\src\licensedcode\data\rules\public-domain_15.yml", "YAML", 0, 0, 0, 4, 0, 0, 1, 5
"d:\IDEWORK\lvmen\src\licensedcode\data\rules\public-domain_150.yml", "YAML", 0, 0, 0, 3, 0, 0, 1, 4
"d:\IDEWORK\lvmen\src\licensedcode\data\rules\public-domain_151.yml", "YAML", 0, 0, 0, 3, 0, 0, 1, 4
"d:\IDEWORK\lvmen\src\licensedcode\data\rules\public-domain_152.yml", "YAML", 0, 0, 0, 3, 0, 0, 1, 4
"d:\IDEWORK\lvmen\src\licensedcode\data\rules\public-domain_153.yml", "YAML", 0, 0, 0, 3, 0, 0, 1, 4
"d:\IDEWORK\lvmen\src\licensedcode\data\rules\public-domain_154.yml", "YAML", 0, 0, 0, 4, 0, 0, 1, 5
"d:\IDEWORK\lvmen\src\licensedcode\data\rules\public-domain_155.yml", "YAML", 0, 0, 0, 4, 0, 0, 1, 5
"d:\IDEWORK\lvmen\src\licensedcode\data\rules\public-domain_156.yml", "YAML", 0, 0, 0, 4, 0, 0, 1, 5
"d:\IDEWORK\lvmen\src\licensedcode\data\rules\public-domain_157.yml", "YAML", 0, 0, 0, 5, 0, 0, 1, 6
"d:\IDEWORK\lvmen\src\licensedcode\data\rules\public-domain_158.yml", "YAML", 0, 0, 0, 3, 0, 0, 1, 4
"d:\IDEWORK\lvmen\src\licensedcode\data\rules\public-domain_159.yml", "YAML", 0, 0, 0, 3, 0, 0, 1, 4
"d:\IDEWORK\lvmen\src\licensedcode\data\rules\public-domain_16.yml", "YAML", 0, 0, 0, 4, 0, 0, 1, 5
"d:\IDEWORK\lvmen\src\licensedcode\data\rules\public-domain_160.yml", "YAML", 0, 0, 0, 3, 0, 0, 1, 4
"d:\IDEWORK\lvmen\src\licensedcode\data\rules\public-domain_161.yml", "YAML", 0, 0, 0, 3, 0, 0, 1, 4
"d:\IDEWORK\lvmen\src\licensedcode\data\rules\public-domain_162.yml", "YAML", 0, 0, 0, 3, 0, 0, 1, 4
"d:\IDEWORK\lvmen\src\licensedcode\data\rules\public-domain_163.yml", "YAML", 0, 0, 0, 3, 0, 0, 1, 4
"d:\IDEWORK\lvmen\src\licensedcode\data\rules\public-domain_164.yml", "YAML", 0, 0, 0, 3, 0, 0, 1, 4
"d:\IDEWORK\lvmen\src\licensedcode\data\rules\public-domain_165.yml", "YAML", 0, 0, 0, 4, 0, 0, 1, 5
"d:\IDEWORK\lvmen\src\licensedcode\data\rules\public-domain_166.yml", "YAML", 0, 0, 0, 4, 0, 0, 1, 5
"d:\IDEWORK\lvmen\src\licensedcode\data\rules\public-domain_167.yml", "YAML", 0, 0, 0, 4, 0, 0, 1, 5
"d:\IDEWORK\lvmen\src\licensedcode\data\rules\public-domain_168.yml", "YAML", 0, 0, 0, 4, 0, 0, 1, 5
"d:\IDEWORK\lvmen\src\licensedcode\data\rules\public-domain_169.yml", "YAML", 0, 0, 0, 3, 0, 0, 1, 4
"d:\IDEWORK\lvmen\src\licensedcode\data\rules\public-domain_17.yml", "YAML", 0, 0, 0, 3, 0, 0, 1, 4
"d:\IDEWORK\lvmen\src\licensedcode\data\rules\public-domain_170.yml", "YAML", 0, 0, 0, 3, 0, 0, 1, 4
"d:\IDEWORK\lvmen\src\licensedcode\data\rules\public-domain_171.yml", "YAML", 0, 0, 0, 3, 0, 0, 1, 4
"d:\IDEWORK\lvmen\src\licensedcode\data\rules\public-domain_172.yml", "YAML", 0, 0, 0, 3, 0, 0, 1, 4
"d:\IDEWORK\lvmen\src\licensedcode\data\rules\public-domain_173.yml", "YAML", 0, 0, 0, 3, 0, 0, 1, 4
"d:\IDEWORK\lvmen\src\licensedcode\data\rules\public-domain_174.yml", "YAML", 0, 0, 0, 3, 0, 0, 1, 4
"d:\IDEWORK\lvmen\src\licensedcode\data\rules\public-domain_175.yml", "YAML", 0, 0, 0, 3, 0, 0, 1, 4
"d:\IDEWORK\lvmen\src\licensedcode\data\rules\public-domain_176.yml", "YAML", 0, 0, 0, 3, 0, 0, 1, 4
"d:\IDEWORK\lvmen\src\licensedcode\data\rules\public-domain_177.yml", "YAML", 0, 0, 0, 3, 0, 0, 1, 4
"d:\IDEWORK\lvmen\src\licensedcode\data\rules\public-domain_178.yml", "YAML", 0, 0, 0, 3, 0, 0, 1, 4
"d:\IDEWORK\lvmen\src\licensedcode\data\rules\public-domain_179.yml", "YAML", 0, 0, 0, 3, 0, 0, 1, 4
"d:\IDEWORK\lvmen\src\licensedcode\data\rules\public-domain_17_1.yml", "YAML", 0, 0, 0, 3, 0, 0, 1, 4
"d:\IDEWORK\lvmen\src\licensedcode\data\rules\public-domain_18.yml", "YAML", 0, 0, 0, 3, 0, 0, 1, 4
"d:\IDEWORK\lvmen\src\licensedcode\data\rules\public-domain_180.yml", "YAML", 0, 0, 0, 3, 0, 0, 1, 4
"d:\IDEWORK\lvmen\src\licensedcode\data\rules\public-domain_181.yml", "YAML", 0, 0, 0, 3, 0, 0, 1, 4
"d:\IDEWORK\lvmen\src\licensedcode\data\rules\public-domain_182.yml", "YAML", 0, 0, 0, 5, 0, 0, 1, 6
"d:\IDEWORK\lvmen\src\licensedcode\data\rules\public-domain_183.yml", "YAML", 0, 0, 0, 3, 0, 0, 1, 4
"d:\IDEWORK\lvmen\src\licensedcode\data\rules\public-domain_184.yml", "YAML", 0, 0, 0, 5, 0, 0, 1, 6
"d:\IDEWORK\lvmen\src\licensedcode\data\rules\public-domain_185.yml", "YAML", 0, 0, 0, 5, 0, 0, 1, 6
"d:\IDEWORK\lvmen\src\licensedcode\data\rules\public-domain_186.yml", "YAML", 0, 0, 0, 3, 0, 0, 1, 4
"d:\IDEWORK\lvmen\src\licensedcode\data\rules\public-domain_187.yml", "YAML", 0, 0, 0, 3, 0, 0, 1, 4
"d:\IDEWORK\lvmen\src\licensedcode\data\rules\public-domain_188.yml", "YAML", 0, 0, 0, 3, 0, 0, 1, 4
"d:\IDEWORK\lvmen\src\licensedcode\data\rules\public-domain_189.yml", "YAML", 0, 0, 0, 3, 0, 0, 1, 4
"d:\IDEWORK\lvmen\src\licensedcode\data\rules\public-domain_19.yml", "YAML", 0, 0, 0, 7, 0, 0, 1, 8
"d:\IDEWORK\lvmen\src\licensedcode\data\rules\public-domain_190.yml", "YAML", 0, 0, 0, 3, 0, 0, 1, 4
"d:\IDEWORK\lvmen\src\licensedcode\data\rules\public-domain_191.yml", "YAML", 0, 0, 0, 3, 0, 0, 1, 4
"d:\IDEWORK\lvmen\src\licensedcode\data\rules\public-domain_192.yml", "YAML", 0, 0, 0, 3, 0, 0, 1, 4
"d:\IDEWORK\lvmen\src\licensedcode\data\rules\public-domain_193.yml", "YAML", 0, 0, 0, 3, 0, 0, 1, 4
"d:\IDEWORK\lvmen\src\licensedcode\data\rules\public-domain_194.yml", "YAML", 0, 0, 0, 3, 0, 0, 1, 4
"d:\IDEWORK\lvmen\src\licensedcode\data\rules\public-domain_195.yml", "YAML", 0, 0, 0, 3, 0, 0, 1, 4
"d:\IDEWORK\lvmen\src\licensedcode\data\rules\public-domain_196.yml", "YAML", 0, 0, 0, 3, 0, 0, 1, 4
"d:\IDEWORK\lvmen\src\licensedcode\data\rules\public-domain_197.yml", "YAML", 0, 0, 0, 3, 0, 0, 1, 4
"d:\IDEWORK\lvmen\src\licensedcode\data\rules\public-domain_198.yml", "YAML", 0, 0, 0, 3, 0, 0, 1, 4
"d:\IDEWORK\lvmen\src\licensedcode\data\rules\public-domain_199.yml", "YAML", 0, 0, 0, 5, 0, 0, 1, 6
"d:\IDEWORK\lvmen\src\licensedcode\data\rules\public-domain_2.yml", "YAML", 0, 0, 0, 5, 0, 0, 1, 6
"d:\IDEWORK\lvmen\src\licensedcode\data\rules\public-domain_20.yml", "YAML", 0, 0, 0, 3, 0, 0, 1, 4
"d:\IDEWORK\lvmen\src\licensedcode\data\rules\public-domain_200.yml", "YAML", 0, 0, 0, 5, 0, 0, 1, 6
"d:\IDEWORK\lvmen\src\licensedcode\data\rules\public-domain_201.yml", "YAML", 0, 0, 0, 5, 0, 0, 1, 6
"d:\IDEWORK\lvmen\src\licensedcode\data\rules\public-domain_202.yml", "YAML", 0, 0, 0, 3, 0, 0, 1, 4
"d:\IDEWORK\lvmen\src\licensedcode\data\rules\public-domain_203.yml", "YAML", 0, 0, 0, 3, 0, 0, 1, 4
"d:\IDEWORK\lvmen\src\licensedcode\data\rules\public-domain_204.yml", "YAML", 0, 0, 0, 3, 0, 0, 1, 4
"d:\IDEWORK\lvmen\src\licensedcode\data\rules\public-domain_205.yml", "YAML", 0, 0, 0, 3, 0, 0, 1, 4
"d:\IDEWORK\lvmen\src\licensedcode\data\rules\public-domain_206.yml", "YAML", 0, 0, 0, 3, 0, 0, 1, 4
"d:\IDEWORK\lvmen\src\licensedcode\data\rules\public-domain_207.yml", "YAML", 0, 0, 0, 3, 0, 0, 1, 4
"d:\IDEWORK\lvmen\src\licensedcode\data\rules\public-domain_208.yml", "YAML", 0, 0, 0, 3, 0, 0, 1, 4
"d:\IDEWORK\lvmen\src\licensedcode\data\rules\public-domain_209.yml", "YAML", 0, 0, 0, 4, 0, 0, 1, 5
"d:\IDEWORK\lvmen\src\licensedcode\data\rules\public-domain_21.yml", "YAML", 0, 0, 0, 4, 0, 0, 1, 5
"d:\IDEWORK\lvmen\src\licensedcode\data\rules\public-domain_210.yml", "YAML", 0, 0, 0, 4, 0, 0, 1, 5
"d:\IDEWORK\lvmen\src\licensedcode\data\rules\public-domain_211.yml", "YAML", 0, 0, 0, 4, 0, 0, 1, 5
"d:\IDEWORK\lvmen\src\licensedcode\data\rules\public-domain_212.yml", "YAML", 0, 0, 0, 3, 0, 0, 1, 4
"d:\IDEWORK\lvmen\src\licensedcode\data\rules\public-domain_213.yml", "YAML", 0, 0, 0, 3, 0, 0, 1, 4
"d:\IDEWORK\lvmen\src\licensedcode\data\rules\public-domain_214.yml", "YAML", 0, 0, 0, 3, 0, 0, 1, 4
"d:\IDEWORK\lvmen\src\licensedcode\data\rules\public-domain_215.yml", "YAML", 0, 0, 0, 3, 0, 0, 1, 4
"d:\IDEWORK\lvmen\src\licensedcode\data\rules\public-domain_216.yml", "YAML", 0, 0, 0, 3, 0, 0, 1, 4
"d:\IDEWORK\lvmen\src\licensedcode\data\rules\public-domain_217.yml", "YAML", 0, 0, 0, 5, 0, 0, 1, 6
"d:\IDEWORK\lvmen\src\licensedcode\data\rules\public-domain_218.yml", "YAML", 0, 0, 0, 5, 0, 0, 1, 6
"d:\IDEWORK\lvmen\src\licensedcode\data\rules\public-domain_219.yml", "YAML", 0, 0, 0, 3, 0, 0, 1, 4
"d:\IDEWORK\lvmen\src\licensedcode\data\rules\public-domain_22.yml", "YAML", 0, 0, 0, 4, 0, 0, 1, 5
"d:\IDEWORK\lvmen\src\licensedcode\data\rules\public-domain_220.yml", "YAML", 0, 0, 0, 3, 0, 0, 1, 4
"d:\IDEWORK\lvmen\src\licensedcode\data\rules\public-domain_221.yml", "YAML", 0, 0, 0, 5, 0, 0, 1, 6
"d:\IDEWORK\lvmen\src\licensedcode\data\rules\public-domain_222.yml", "YAML", 0, 0, 0, 3, 0, 0, 1, 4
"d:\IDEWORK\lvmen\src\licensedcode\data\rules\public-domain_223.yml", "YAML", 0, 0, 0, 3, 0, 0, 1, 4
"d:\IDEWORK\lvmen\src\licensedcode\data\rules\public-domain_224.yml", "YAML", 0, 0, 0, 5, 0, 0, 1, 6
"d:\IDEWORK\lvmen\src\licensedcode\data\rules\public-domain_225.yml", "YAML", 0, 0, 0, 3, 0, 0, 1, 4
"d:\IDEWORK\lvmen\src\licensedcode\data\rules\public-domain_226.yml", "YAML", 0, 0, 0, 3, 0, 0, 1, 4
"d:\IDEWORK\lvmen\src\licensedcode\data\rules\public-domain_227.yml", "YAML", 0, 0, 0, 3, 0, 0, 1, 4
"d:\IDEWORK\lvmen\src\licensedcode\data\rules\public-domain_228.yml", "YAML", 0, 0, 0, 3, 0, 0, 1, 4
"d:\IDEWORK\lvmen\src\licensedcode\data\rules\public-domain_229.yml", "YAML", 0, 0, 0, 3, 0, 0, 1, 4
"d:\IDEWORK\lvmen\src\licensedcode\data\rules\public-domain_23.yml", "YAML", 0, 0, 0, 2, 0, 0, 1, 3
"d:\IDEWORK\lvmen\src\licensedcode\data\rules\public-domain_230.yml", "YAML", 0, 0, 0, 3, 0, 0, 1, 4
"d:\IDEWORK\lvmen\src\licensedcode\data\rules\public-domain_231.yml", "YAML", 0, 0, 0, 3, 0, 0, 1, 4
"d:\IDEWORK\lvmen\src\licensedcode\data\rules\public-domain_232.yml", "YAML", 0, 0, 0, 3, 0, 0, 1, 4
"d:\IDEWORK\lvmen\src\licensedcode\data\rules\public-domain_233.yml", "YAML", 0, 0, 0, 3, 0, 0, 1, 4
"d:\IDEWORK\lvmen\src\licensedcode\data\rules\public-domain_234.yml", "YAML", 0, 0, 0, 3, 0, 0, 1, 4
"d:\IDEWORK\lvmen\src\licensedcode\data\rules\public-domain_235.yml", "YAML", 0, 0, 0, 3, 0, 0, 1, 4
"d:\IDEWORK\lvmen\src\licensedcode\data\rules\public-domain_236.yml", "YAML", 0, 0, 0, 3, 0, 0, 1, 4
"d:\IDEWORK\lvmen\src\licensedcode\data\rules\public-domain_237.yml", "YAML", 0, 0, 0, 3, 0, 0, 1, 4
"d:\IDEWORK\lvmen\src\licensedcode\data\rules\public-domain_238.yml", "YAML", 0, 0, 0, 3, 0, 0, 1, 4
"d:\IDEWORK\lvmen\src\licensedcode\data\rules\public-domain_239.yml", "YAML", 0, 0, 0, 3, 0, 0, 1, 4
"d:\IDEWORK\lvmen\src\licensedcode\data\rules\public-domain_24.yml", "YAML", 0, 0, 0, 3, 0, 0, 1, 4
"d:\IDEWORK\lvmen\src\licensedcode\data\rules\public-domain_240.yml", "YAML", 0, 0, 0, 3, 0, 0, 1, 4
"d:\IDEWORK\lvmen\src\licensedcode\data\rules\public-domain_241.yml", "YAML", 0, 0, 0, 3, 0, 0, 1, 4
"d:\IDEWORK\lvmen\src\licensedcode\data\rules\public-domain_242.yml", "YAML", 0, 0, 0, 3, 0, 0, 1, 4
"d:\IDEWORK\lvmen\src\licensedcode\data\rules\public-domain_243.yml", "YAML", 0, 0, 0, 3, 0, 0, 1, 4
"d:\IDEWORK\lvmen\src\licensedcode\data\rules\public-domain_244.yml", "YAML", 0, 0, 0, 3, 0, 0, 1, 4
"d:\IDEWORK\lvmen\src\licensedcode\data\rules\public-domain_245.yml", "YAML", 0, 0, 0, 3, 0, 0, 1, 4
"d:\IDEWORK\lvmen\src\licensedcode\data\rules\public-domain_246.yml", "YAML", 0, 0, 0, 3, 0, 0, 1, 4
"d:\IDEWORK\lvmen\src\licensedcode\data\rules\public-domain_247.yml", "YAML", 0, 0, 0, 3, 0, 0, 1, 4
"d:\IDEWORK\lvmen\src\licensedcode\data\rules\public-domain_248.yml", "YAML", 0, 0, 0, 3, 0, 0, 1, 4
"d:\IDEWORK\lvmen\src\licensedcode\data\rules\public-domain_249.yml", "YAML", 0, 0, 0, 3, 0, 0, 1, 4
"d:\IDEWORK\lvmen\src\licensedcode\data\rules\public-domain_25.yml", "YAML", 0, 0, 0, 4, 0, 0, 1, 5
"d:\IDEWORK\lvmen\src\licensedcode\data\rules\public-domain_250.yml", "YAML", 0, 0, 0, 3, 0, 0, 1, 4
"d:\IDEWORK\lvmen\src\licensedcode\data\rules\public-domain_251.yml", "YAML", 0, 0, 0, 3, 0, 0, 1, 4
"d:\IDEWORK\lvmen\src\licensedcode\data\rules\public-domain_252.yml", "YAML", 0, 0, 0, 3, 0, 0, 1, 4
"d:\IDEWORK\lvmen\src\licensedcode\data\rules\public-domain_253.yml", "YAML", 0, 0, 0, 3, 0, 0, 1, 4
"d:\IDEWORK\lvmen\src\licensedcode\data\rules\public-domain_254.yml", "YAML", 0, 0, 0, 3, 0, 0, 1, 4
"d:\IDEWORK\lvmen\src\licensedcode\data\rules\public-domain_255.yml", "YAML", 0, 0, 0, 3, 0, 0, 1, 4
"d:\IDEWORK\lvmen\src\licensedcode\data\rules\public-domain_256.yml", "YAML", 0, 0, 0, 3, 0, 0, 1, 4
"d:\IDEWORK\lvmen\src\licensedcode\data\rules\public-domain_257.yml", "YAML", 0, 0, 0, 3, 0, 0, 1, 4
"d:\IDEWORK\lvmen\src\licensedcode\data\rules\public-domain_258.yml", "YAML", 0, 0, 0, 3, 0, 0, 1, 4
"d:\IDEWORK\lvmen\src\licensedcode\data\rules\public-domain_259.yml", "YAML", 0, 0, 0, 3, 0, 0, 1, 4
"d:\IDEWORK\lvmen\src\licensedcode\data\rules\public-domain_26.yml", "YAML", 0, 0, 0, 4, 0, 0, 1, 5
"d:\IDEWORK\lvmen\src\licensedcode\data\rules\public-domain_260.yml", "YAML", 0, 0, 0, 3, 0, 0, 1, 4
"d:\IDEWORK\lvmen\src\licensedcode\data\rules\public-domain_261.yml", "YAML", 0, 0, 0, 5, 0, 0, 1, 6
"d:\IDEWORK\lvmen\src\licensedcode\data\rules\public-domain_262.yml", "YAML", 0, 0, 0, 3, 0, 0, 1, 4
"d:\IDEWORK\lvmen\src\licensedcode\data\rules\public-domain_263.yml", "YAML", 0, 0, 0, 3, 0, 0, 1, 4
"d:\IDEWORK\lvmen\src\licensedcode\data\rules\public-domain_264.yml", "YAML", 0, 0, 0, 3, 0, 0, 1, 4
"d:\IDEWORK\lvmen\src\licensedcode\data\rules\public-domain_265.yml", "YAML", 0, 0, 0, 3, 0, 0, 1, 4
"d:\IDEWORK\lvmen\src\licensedcode\data\rules\public-domain_266.yml", "YAML", 0, 0, 0, 3, 0, 0, 1, 4
"d:\IDEWORK\lvmen\src\licensedcode\data\rules\public-domain_267.yml", "YAML", 0, 0, 0, 3, 0, 0, 1, 4
"d:\IDEWORK\lvmen\src\licensedcode\data\rules\public-domain_268.yml", "YAML", 0, 0, 0, 3, 0, 0, 1, 4
"d:\IDEWORK\lvmen\src\licensedcode\data\rules\public-domain_269.yml", "YAML", 0, 0, 0, 3, 0, 0, 1, 4
"d:\IDEWORK\lvmen\src\licensedcode\data\rules\public-domain_27.yml", "YAML", 0, 0, 0, 4, 0, 0, 1, 5
"d:\IDEWORK\lvmen\src\licensedcode\data\rules\public-domain_270.yml", "YAML", 0, 0, 0, 3, 0, 0, 1, 4
"d:\IDEWORK\lvmen\src\licensedcode\data\rules\public-domain_271.yml", "YAML", 0, 0, 0, 3, 0, 0, 1, 4
"d:\IDEWORK\lvmen\src\licensedcode\data\rules\public-domain_272.yml", "YAML", 0, 0, 0, 3, 0, 0, 1, 4
"d:\IDEWORK\lvmen\src\licensedcode\data\rules\public-domain_273.yml", "YAML", 0, 0, 0, 3, 0, 0, 1, 4
"d:\IDEWORK\lvmen\src\licensedcode\data\rules\public-domain_274.yml", "YAML", 0, 0, 0, 4, 0, 0, 1, 5
"d:\IDEWORK\lvmen\src\licensedcode\data\rules\public-domain_275.yml", "YAML", 0, 0, 0, 3, 0, 0, 1, 4
"d:\IDEWORK\lvmen\src\licensedcode\data\rules\public-domain_276.yml", "YAML", 0, 0, 0, 3, 0, 0, 1, 4
"d:\IDEWORK\lvmen\src\licensedcode\data\rules\public-domain_277.yml", "YAML", 0, 0, 0, 3, 0, 0, 1, 4
"d:\IDEWORK\lvmen\src\licensedcode\data\rules\public-domain_278.yml", "YAML", 0, 0, 0, 6, 0, 0, 1, 7
"d:\IDEWORK\lvmen\src\licensedcode\data\rules\public-domain_279.yml", "YAML", 0, 0, 0, 3, 0, 0, 1, 4
"d:\IDEWORK\lvmen\src\licensedcode\data\rules\public-domain_28.yml", "YAML", 0, 0, 0, 3, 0, 0, 1, 4
"d:\IDEWORK\lvmen\src\licensedcode\data\rules\public-domain_280.yml", "YAML", 0, 0, 0, 4, 0, 0, 1, 5
"d:\IDEWORK\lvmen\src\licensedcode\data\rules\public-domain_281.yml", "YAML", 0, 0, 0, 3, 0, 0, 1, 4
"d:\IDEWORK\lvmen\src\licensedcode\data\rules\public-domain_282.yml", "YAML", 0, 0, 0, 3, 0, 0, 1, 4
"d:\IDEWORK\lvmen\src\licensedcode\data\rules\public-domain_283.yml", "YAML", 0, 0, 0, 4, 0, 0, 1, 5
"d:\IDEWORK\lvmen\src\licensedcode\data\rules\public-domain_284.yml", "YAML", 0, 0, 0, 4, 0, 0, 1, 5
"d:\IDEWORK\lvmen\src\licensedcode\data\rules\public-domain_285.yml", "YAML", 0, 0, 0, 4, 0, 0, 1, 5
"d:\IDEWORK\lvmen\src\licensedcode\data\rules\public-domain_286.yml", "YAML", 0, 0, 0, 3, 0, 0, 1, 4
"d:\IDEWORK\lvmen\src\licensedcode\data\rules\public-domain_287.yml", "YAML", 0, 0, 0, 3, 0, 0, 1, 4
"d:\IDEWORK\lvmen\src\licensedcode\data\rules\public-domain_288.yml", "YAML", 0, 0, 0, 3, 0, 0, 1, 4
"d:\IDEWORK\lvmen\src\licensedcode\data\rules\public-domain_289.yml", "YAML", 0, 0, 0, 3, 0, 0, 1, 4
"d:\IDEWORK\lvmen\src\licensedcode\data\rules\public-domain_29.yml", "YAML", 0, 0, 0, 4, 0, 0, 1, 5
"d:\IDEWORK\lvmen\src\licensedcode\data\rules\public-domain_290.yml", "YAML", 0, 0, 0, 3, 0, 0, 1, 4
"d:\IDEWORK\lvmen\src\licensedcode\data\rules\public-domain_291.yml", "YAML", 0, 0, 0, 3, 0, 0, 1, 4
"d:\IDEWORK\lvmen\src\licensedcode\data\rules\public-domain_292.yml", "YAML", 0, 0, 0, 3, 0, 0, 1, 4
"d:\IDEWORK\lvmen\src\licensedcode\data\rules\public-domain_293.yml", "YAML", 0, 0, 0, 3, 0, 0, 1, 4
"d:\IDEWORK\lvmen\src\licensedcode\data\rules\public-domain_294.yml", "YAML", 0, 0, 0, 3, 0, 0, 1, 4
"d:\IDEWORK\lvmen\src\licensedcode\data\rules\public-domain_295.yml", "YAML", 0, 0, 0, 4, 0, 0, 1, 5
"d:\IDEWORK\lvmen\src\licensedcode\data\rules\public-domain_296.yml", "YAML", 0, 0, 0, 3, 0, 0, 1, 4
"d:\IDEWORK\lvmen\src\licensedcode\data\rules\public-domain_297.yml", "YAML", 0, 0, 0, 3, 0, 0, 1, 4
"d:\IDEWORK\lvmen\src\licensedcode\data\rules\public-domain_298.yml", "YAML", 0, 0, 0, 3, 0, 0, 1, 4
"d:\IDEWORK\lvmen\src\licensedcode\data\rules\public-domain_299.yml", "YAML", 0, 0, 0, 3, 0, 0, 1, 4
"d:\IDEWORK\lvmen\src\licensedcode\data\rules\public-domain_3.yml", "YAML", 0, 0, 0, 4, 0, 0, 1, 5
"d:\IDEWORK\lvmen\src\licensedcode\data\rules\public-domain_30.yml", "YAML", 0, 0, 0, 2, 0, 0, 1, 3
"d:\IDEWORK\lvmen\src\licensedcode\data\rules\public-domain_300.yml", "YAML", 0, 0, 0, 3, 0, 0, 1, 4
"d:\IDEWORK\lvmen\src\licensedcode\data\rules\public-domain_301.yml", "YAML", 0, 0, 0, 4, 0, 0, 1, 5
"d:\IDEWORK\lvmen\src\licensedcode\data\rules\public-domain_302.yml", "YAML", 0, 0, 0, 4, 0, 0, 1, 5
"d:\IDEWORK\lvmen\src\licensedcode\data\rules\public-domain_303.yml", "YAML", 0, 0, 0, 5, 0, 0, 1, 6
"d:\IDEWORK\lvmen\src\licensedcode\data\rules\public-domain_304.yml", "YAML", 0, 0, 0, 3, 0, 0, 1, 4
"d:\IDEWORK\lvmen\src\licensedcode\data\rules\public-domain_305.yml", "YAML", 0, 0, 0, 3, 0, 0, 1, 4
"d:\IDEWORK\lvmen\src\licensedcode\data\rules\public-domain_306.yml", "YAML", 0, 0, 0, 3, 0, 0, 1, 4
"d:\IDEWORK\lvmen\src\licensedcode\data\rules\public-domain_307.yml", "YAML", 0, 0, 0, 5, 0, 0, 1, 6
"d:\IDEWORK\lvmen\src\licensedcode\data\rules\public-domain_308.yml", "YAML", 0, 0, 0, 4, 0, 0, 1, 5
"d:\IDEWORK\lvmen\src\licensedcode\data\rules\public-domain_309.yml", "YAML", 0, 0, 0, 3, 0, 0, 1, 4
"d:\IDEWORK\lvmen\src\licensedcode\data\rules\public-domain_31.yml", "YAML", 0, 0, 0, 3, 0, 0, 1, 4
"d:\IDEWORK\lvmen\src\licensedcode\data\rules\public-domain_310.yml", "YAML", 0, 0, 0, 3, 0, 0, 1, 4
"d:\IDEWORK\lvmen\src\licensedcode\data\rules\public-domain_311.yml", "YAML", 0, 0, 0, 3, 0, 0, 1, 4
"d:\IDEWORK\lvmen\src\licensedcode\data\rules\public-domain_312.yml", "YAML", 0, 0, 0, 3, 0, 0, 1, 4
"d:\IDEWORK\lvmen\src\licensedcode\data\rules\public-domain_313.yml", "YAML", 0, 0, 0, 3, 0, 0, 1, 4
"d:\IDEWORK\lvmen\src\licensedcode\data\rules\public-domain_314.yml", "YAML", 0, 0, 0, 3, 0, 0, 1, 4
"d:\IDEWORK\lvmen\src\licensedcode\data\rules\public-domain_315.yml", "YAML", 0, 0, 0, 3, 0, 0, 1, 4
"d:\IDEWORK\lvmen\src\licensedcode\data\rules\public-domain_316.yml", "YAML", 0, 0, 0, 3, 0, 0, 1, 4
"d:\IDEWORK\lvmen\src\licensedcode\data\rules\public-domain_317.yml", "YAML", 0, 0, 0, 3, 0, 0, 1, 4
"d:\IDEWORK\lvmen\src\licensedcode\data\rules\public-domain_318.yml", "YAML", 0, 0, 0, 3, 0, 0, 1, 4
"d:\IDEWORK\lvmen\src\licensedcode\data\rules\public-domain_319.yml", "YAML", 0, 0, 0, 3, 0, 0, 1, 4
"d:\IDEWORK\lvmen\src\licensedcode\data\rules\public-domain_32.yml", "YAML", 0, 0, 0, 4, 0, 0, 1, 5
"d:\IDEWORK\lvmen\src\licensedcode\data\rules\public-domain_320.yml", "YAML", 0, 0, 0, 3, 0, 0, 1, 4
"d:\IDEWORK\lvmen\src\licensedcode\data\rules\public-domain_321.yml", "YAML", 0, 0, 0, 3, 0, 0, 1, 4
"d:\IDEWORK\lvmen\src\licensedcode\data\rules\public-domain_322.yml", "YAML", 0, 0, 0, 3, 0, 0, 1, 4
"d:\IDEWORK\lvmen\src\licensedcode\data\rules\public-domain_323.yml", "YAML", 0, 0, 0, 3, 0, 0, 1, 4
"d:\IDEWORK\lvmen\src\licensedcode\data\rules\public-domain_324.yml", "YAML", 0, 0, 0, 3, 0, 0, 1, 4
"d:\IDEWORK\lvmen\src\licensedcode\data\rules\public-domain_325.yml", "YAML", 0, 0, 0, 3, 0, 0, 1, 4
"d:\IDEWORK\lvmen\src\licensedcode\data\rules\public-domain_326.yml", "YAML", 0, 0, 0, 3, 0, 0, 1, 4
"d:\IDEWORK\lvmen\src\licensedcode\data\rules\public-domain_327.yml", "YAML", 0, 0, 0, 3, 0, 0, 1, 4
"d:\IDEWORK\lvmen\src\licensedcode\data\rules\public-domain_328.yml", "YAML", 0, 0, 0, 3, 0, 0, 1, 4
"d:\IDEWORK\lvmen\src\licensedcode\data\rules\public-domain_329.yml", "YAML", 0, 0, 0, 3, 0, 0, 1, 4
"d:\IDEWORK\lvmen\src\licensedcode\data\rules\public-domain_33.yml", "YAML", 0, 0, 0, 4, 0, 0, 1, 5
"d:\IDEWORK\lvmen\src\licensedcode\data\rules\public-domain_330.yml", "YAML", 0, 0, 0, 3, 0, 0, 1, 4
"d:\IDEWORK\lvmen\src\licensedcode\data\rules\public-domain_331.yml", "YAML", 0, 0, 0, 3, 0, 0, 1, 4
"d:\IDEWORK\lvmen\src\licensedcode\data\rules\public-domain_332.yml", "YAML", 0, 0, 0, 3, 0, 0, 1, 4
"d:\IDEWORK\lvmen\src\licensedcode\data\rules\public-domain_333.yml", "YAML", 0, 0, 0, 3, 0, 0, 1, 4
"d:\IDEWORK\lvmen\src\licensedcode\data\rules\public-domain_334.yml", "YAML", 0, 0, 0, 3, 0, 0, 1, 4
"d:\IDEWORK\lvmen\src\licensedcode\data\rules\public-domain_335.yml", "YAML", 0, 0, 0, 3, 0, 0, 1, 4
"d:\IDEWORK\lvmen\src\licensedcode\data\rules\public-domain_336.yml", "YAML", 0, 0, 0, 3, 0, 0, 1, 4
"d:\IDEWORK\lvmen\src\licensedcode\data\rules\public-domain_337.yml", "YAML", 0, 0, 0, 4, 0, 0, 1, 5
"d:\IDEWORK\lvmen\src\licensedcode\data\rules\public-domain_338.yml", "YAML", 0, 0, 0, 3, 0, 0, 1, 4
"d:\IDEWORK\lvmen\src\licensedcode\data\rules\public-domain_339.yml", "YAML", 0, 0, 0, 3, 0, 0, 1, 4
"d:\IDEWORK\lvmen\src\licensedcode\data\rules\public-domain_34.yml", "YAML", 0, 0, 0, 2, 0, 0, 1, 3
"d:\IDEWORK\lvmen\src\licensedcode\data\rules\public-domain_340.yml", "YAML", 0, 0, 0, 3, 0, 0, 1, 4
"d:\IDEWORK\lvmen\src\licensedcode\data\rules\public-domain_341.yml", "YAML", 0, 0, 0, 3, 0, 0, 1, 4
"d:\IDEWORK\lvmen\src\licensedcode\data\rules\public-domain_342.yml", "YAML", 0, 0, 0, 3, 0, 0, 1, 4
"d:\IDEWORK\lvmen\src\licensedcode\data\rules\public-domain_343.yml", "YAML", 0, 0, 0, 3, 0, 0, 1, 4
"d:\IDEWORK\lvmen\src\licensedcode\data\rules\public-domain_344.yml", "YAML", 0, 0, 0, 3, 0, 0, 1, 4
"d:\IDEWORK\lvmen\src\licensedcode\data\rules\public-domain_345.yml", "YAML", 0, 0, 0, 3, 0, 0, 1, 4
"d:\IDEWORK\lvmen\src\licensedcode\data\rules\public-domain_346.yml", "YAML", 0, 0, 0, 3, 0, 0, 1, 4
"d:\IDEWORK\lvmen\src\licensedcode\data\rules\public-domain_347.yml", "YAML", 0, 0, 0, 3, 0, 0, 1, 4
"d:\IDEWORK\lvmen\src\licensedcode\data\rules\public-domain_348.yml", "YAML", 0, 0, 0, 3, 0, 0, 1, 4
"d:\IDEWORK\lvmen\src\licensedcode\data\rules\public-domain_349.yml", "YAML", 0, 0, 0, 3, 0, 0, 1, 4
"d:\IDEWORK\lvmen\src\licensedcode\data\rules\public-domain_35.yml", "YAML", 0, 0, 0, 2, 0, 0, 1, 3
"d:\IDEWORK\lvmen\src\licensedcode\data\rules\public-domain_350.yml", "YAML", 0, 0, 0, 3, 0, 0, 1, 4
"d:\IDEWORK\lvmen\src\licensedcode\data\rules\public-domain_351.yml", "YAML", 0, 0, 0, 3, 0, 0, 1, 4
"d:\IDEWORK\lvmen\src\licensedcode\data\rules\public-domain_352.yml", "YAML", 0, 0, 0, 3, 0, 0, 1, 4
"d:\IDEWORK\lvmen\src\licensedcode\data\rules\public-domain_353.yml", "YAML", 0, 0, 0, 3, 0, 0, 1, 4
"d:\IDEWORK\lvmen\src\licensedcode\data\rules\public-domain_354.yml", "YAML", 0, 0, 0, 5, 0, 0, 1, 6
"d:\IDEWORK\lvmen\src\licensedcode\data\rules\public-domain_355.yml", "YAML", 0, 0, 0, 5, 0, 0, 1, 6
"d:\IDEWORK\lvmen\src\licensedcode\data\rules\public-domain_356.yml", "YAML", 0, 0, 0, 5, 0, 0, 1, 6
"d:\IDEWORK\lvmen\src\licensedcode\data\rules\public-domain_357.yml", "YAML", 0, 0, 0, 3, 0, 0, 1, 4
"d:\IDEWORK\lvmen\src\licensedcode\data\rules\public-domain_358.yml", "YAML", 0, 0, 0, 3, 0, 0, 1, 4
"d:\IDEWORK\lvmen\src\licensedcode\data\rules\public-domain_359.yml", "YAML", 0, 0, 0, 3, 0, 0, 1, 4
"d:\IDEWORK\lvmen\src\licensedcode\data\rules\public-domain_36.yml", "YAML", 0, 0, 0, 3, 0, 0, 1, 4
"d:\IDEWORK\lvmen\src\licensedcode\data\rules\public-domain_360.yml", "YAML", 0, 0, 0, 3, 0, 0, 0, 3
"d:\IDEWORK\lvmen\src\licensedcode\data\rules\public-domain_361.yml", "YAML", 0, 0, 0, 19, 0, 0, 1, 20
"d:\IDEWORK\lvmen\src\licensedcode\data\rules\public-domain_362.yml", "YAML", 0, 0, 0, 13, 0, 0, 2, 15
"d:\IDEWORK\lvmen\src\licensedcode\data\rules\public-domain_363.yml", "YAML", 0, 0, 0, 5, 0, 0, 1, 6
"d:\IDEWORK\lvmen\src\licensedcode\data\rules\public-domain_364.yml", "YAML", 0, 0, 0, 4, 0, 0, 1, 5
"d:\IDEWORK\lvmen\src\licensedcode\data\rules\public-domain_365.yml", "YAML", 0, 0, 0, 4, 0, 0, 1, 5
"d:\IDEWORK\lvmen\src\licensedcode\data\rules\public-domain_366.yml", "YAML", 0, 0, 0, 4, 0, 0, 1, 5
"d:\IDEWORK\lvmen\src\licensedcode\data\rules\public-domain_367.yml", "YAML", 0, 0, 0, 4, 0, 0, 1, 5
"d:\IDEWORK\lvmen\src\licensedcode\data\rules\public-domain_368.yml", "YAML", 0, 0, 0, 4, 0, 0, 1, 5
"d:\IDEWORK\lvmen\src\licensedcode\data\rules\public-domain_369.yml", "YAML", 0, 0, 0, 4, 0, 0, 1, 5
"d:\IDEWORK\lvmen\src\licensedcode\data\rules\public-domain_37.yml", "YAML", 0, 0, 0, 4, 0, 0, 1, 5
"d:\IDEWORK\lvmen\src\licensedcode\data\rules\public-domain_370.yml", "YAML", 0, 0, 0, 4, 0, 0, 1, 5
"d:\IDEWORK\lvmen\src\licensedcode\data\rules\public-domain_371.yml", "YAML", 0, 0, 0, 4, 0, 0, 1, 5
"d:\IDEWORK\lvmen\src\licensedcode\data\rules\public-domain_372.yml", "YAML", 0, 0, 0, 4, 0, 0, 1, 5
"d:\IDEWORK\lvmen\src\licensedcode\data\rules\public-domain_373.yml", "YAML", 0, 0, 0, 4, 0, 0, 1, 5
"d:\IDEWORK\lvmen\src\licensedcode\data\rules\public-domain_374.yml", "YAML", 0, 0, 0, 3, 0, 0, 1, 4
"d:\IDEWORK\lvmen\src\licensedcode\data\rules\public-domain_375.yml", "YAML", 0, 0, 0, 6, 0, 0, 2, 8
"d:\IDEWORK\lvmen\src\licensedcode\data\rules\public-domain_376.yml", "YAML", 0, 0, 0, 3, 0, 0, 1, 4
"d:\IDEWORK\lvmen\src\licensedcode\data\rules\public-domain_377.yml", "YAML", 0, 0, 0, 3, 0, 0, 1, 4
"d:\IDEWORK\lvmen\src\licensedcode\data\rules\public-domain_378.yml", "YAML", 0, 0, 0, 3, 0, 0, 1, 4
"d:\IDEWORK\lvmen\src\licensedcode\data\rules\public-domain_379.yml", "YAML", 0, 0, 0, 2, 0, 0, 1, 3
"d:\IDEWORK\lvmen\src\licensedcode\data\rules\public-domain_38.yml", "YAML", 0, 0, 0, 3, 0, 0, 1, 4
"d:\IDEWORK\lvmen\src\licensedcode\data\rules\public-domain_380.yml", "YAML", 0, 0, 0, 3, 0, 0, 1, 4
"d:\IDEWORK\lvmen\src\licensedcode\data\rules\public-domain_381.yml", "YAML", 0, 0, 0, 3, 0, 0, 1, 4
"d:\IDEWORK\lvmen\src\licensedcode\data\rules\public-domain_382.yml", "YAML", 0, 0, 0, 2, 0, 0, 1, 3
"d:\IDEWORK\lvmen\src\licensedcode\data\rules\public-domain_383.yml", "YAML", 0, 0, 0, 2, 0, 0, 1, 3
"d:\IDEWORK\lvmen\src\licensedcode\data\rules\public-domain_384.yml", "YAML", 0, 0, 0, 3, 0, 0, 1, 4
"d:\IDEWORK\lvmen\src\licensedcode\data\rules\public-domain_385.yml", "YAML", 0, 0, 0, 3, 0, 0, 1, 4
"d:\IDEWORK\lvmen\src\licensedcode\data\rules\public-domain_386.yml", "YAML", 0, 0, 0, 3, 0, 0, 1, 4
"d:\IDEWORK\lvmen\src\licensedcode\data\rules\public-domain_387.yml", "YAML", 0, 0, 0, 3, 0, 0, 1, 4
"d:\IDEWORK\lvmen\src\licensedcode\data\rules\public-domain_388.yml", "YAML", 0, 0, 0, 3, 0, 0, 1, 4
"d:\IDEWORK\lvmen\src\licensedcode\data\rules\public-domain_389.yml", "YAML", 0, 0, 0, 3, 0, 0, 1, 4
"d:\IDEWORK\lvmen\src\licensedcode\data\rules\public-domain_39.yml", "YAML", 0, 0, 0, 3, 0, 0, 1, 4
"d:\IDEWORK\lvmen\src\licensedcode\data\rules\public-domain_390.yml", "YAML", 0, 0, 0, 3, 0, 0, 1, 4
"d:\IDEWORK\lvmen\src\licensedcode\data\rules\public-domain_391.yml", "YAML", 0, 0, 0, 3, 0, 0, 1, 4
"d:\IDEWORK\lvmen\src\licensedcode\data\rules\public-domain_392.yml", "YAML", 0, 0, 0, 3, 0, 0, 1, 4
"d:\IDEWORK\lvmen\src\licensedcode\data\rules\public-domain_393.yml", "YAML", 0, 0, 0, 3, 0, 0, 1, 4
"d:\IDEWORK\lvmen\src\licensedcode\data\rules\public-domain_394.yml", "YAML", 0, 0, 0, 2, 0, 0, 1, 3
"d:\IDEWORK\lvmen\src\licensedcode\data\rules\public-domain_395.yml", "YAML", 0, 0, 0, 3, 0, 0, 1, 4
"d:\IDEWORK\lvmen\src\licensedcode\data\rules\public-domain_396.yml", "YAML", 0, 0, 0, 3, 0, 0, 1, 4
"d:\IDEWORK\lvmen\src\licensedcode\data\rules\public-domain_397.yml", "YAML", 0, 0, 0, 3, 0, 0, 1, 4
"d:\IDEWORK\lvmen\src\licensedcode\data\rules\public-domain_398.yml", "YAML", 0, 0, 0, 3, 0, 0, 1, 4
"d:\IDEWORK\lvmen\src\licensedcode\data\rules\public-domain_399.yml", "YAML", 0, 0, 0, 3, 0, 0, 1, 4
"d:\IDEWORK\lvmen\src\licensedcode\data\rules\public-domain_4.yml", "YAML", 0, 0, 0, 3, 0, 0, 1, 4
"d:\IDEWORK\lvmen\src\licensedcode\data\rules\public-domain_40.yml", "YAML", 0, 0, 0, 3, 0, 0, 1, 4
"d:\IDEWORK\lvmen\src\licensedcode\data\rules\public-domain_400.yml", "YAML", 0, 0, 0, 3, 0, 0, 1, 4
"d:\IDEWORK\lvmen\src\licensedcode\data\rules\public-domain_401.yml", "YAML", 0, 0, 0, 3, 0, 0, 1, 4
"d:\IDEWORK\lvmen\src\licensedcode\data\rules\public-domain_402.yml", "YAML", 0, 0, 0, 3, 0, 0, 1, 4
"d:\IDEWORK\lvmen\src\licensedcode\data\rules\public-domain_403.yml", "YAML", 0, 0, 0, 3, 0, 0, 1, 4
"d:\IDEWORK\lvmen\src\licensedcode\data\rules\public-domain_404.yml", "YAML", 0, 0, 0, 3, 0, 0, 1, 4
"d:\IDEWORK\lvmen\src\licensedcode\data\rules\public-domain_405.yml", "YAML", 0, 0, 0, 2, 0, 0, 1, 3
"d:\IDEWORK\lvmen\src\licensedcode\data\rules\public-domain_406.yml", "YAML", 0, 0, 0, 4, 0, 0, 1, 5
"d:\IDEWORK\lvmen\src\licensedcode\data\rules\public-domain_407.yml", "YAML", 0, 0, 0, 4, 0, 0, 1, 5
"d:\IDEWORK\lvmen\src\licensedcode\data\rules\public-domain_408.yml", "YAML", 0, 0, 0, 4, 0, 0, 1, 5
"d:\IDEWORK\lvmen\src\licensedcode\data\rules\public-domain_409.yml", "YAML", 0, 0, 0, 4, 0, 0, 1, 5
"d:\IDEWORK\lvmen\src\licensedcode\data\rules\public-domain_41.yml", "YAML", 0, 0, 0, 3, 0, 0, 1, 4
"d:\IDEWORK\lvmen\src\licensedcode\data\rules\public-domain_410.yml", "YAML", 0, 0, 0, 4, 0, 0, 1, 5
"d:\IDEWORK\lvmen\src\licensedcode\data\rules\public-domain_411.yml", "YAML", 0, 0, 0, 3, 0, 0, 1, 4
"d:\IDEWORK\lvmen\src\licensedcode\data\rules\public-domain_412.yml", "YAML", 0, 0, 0, 3, 0, 0, 1, 4
"d:\IDEWORK\lvmen\src\licensedcode\data\rules\public-domain_413.yml", "YAML", 0, 0, 0, 3, 0, 0, 1, 4
"d:\IDEWORK\lvmen\src\licensedcode\data\rules\public-domain_414.yml", "YAML", 0, 0, 0, 3, 0, 0, 1, 4
"d:\IDEWORK\lvmen\src\licensedcode\data\rules\public-domain_415.yml", "YAML", 0, 0, 0, 3, 0, 0, 1, 4
"d:\IDEWORK\lvmen\src\licensedcode\data\rules\public-domain_416.yml", "YAML", 0, 0, 0, 3, 0, 0, 1, 4
"d:\IDEWORK\lvmen\src\licensedcode\data\rules\public-domain_417.yml", "YAML", 0, 0, 0, 5, 0, 0, 1, 6
"d:\IDEWORK\lvmen\src\licensedcode\data\rules\public-domain_418.yml", "YAML", 0, 0, 0, 5, 0, 0, 1, 6
"d:\IDEWORK\lvmen\src\licensedcode\data\rules\public-domain_419.yml", "YAML", 0, 0, 0, 3, 0, 0, 1, 4
"d:\IDEWORK\lvmen\src\licensedcode\data\rules\public-domain_42.yml", "YAML", 0, 0, 0, 3, 0, 0, 1, 4
"d:\IDEWORK\lvmen\src\licensedcode\data\rules\public-domain_420.yml", "YAML", 0, 0, 0, 3, 0, 0, 1, 4
"d:\IDEWORK\lvmen\src\licensedcode\data\rules\public-domain_421.yml", "YAML", 0, 0, 0, 4, 0, 0, 1, 5
"d:\IDEWORK\lvmen\src\licensedcode\data\rules\public-domain_422.yml", "YAML", 0, 0, 0, 3, 0, 0, 1, 4
"d:\IDEWORK\lvmen\src\licensedcode\data\rules\public-domain_423.yml", "YAML", 0, 0, 0, 3, 0, 0, 1, 4
"d:\IDEWORK\lvmen\src\licensedcode\data\rules\public-domain_424.yml", "YAML", 0, 0, 0, 2, 0, 0, 1, 3
"d:\IDEWORK\lvmen\src\licensedcode\data\rules\public-domain_425.yml", "YAML", 0, 0, 0, 3, 0, 0, 1, 4
"d:\IDEWORK\lvmen\src\licensedcode\data\rules\public-domain_426.yml", "YAML", 0, 0, 0, 5, 0, 0, 1, 6
"d:\IDEWORK\lvmen\src\licensedcode\data\rules\public-domain_427.yml", "YAML", 0, 0, 0, 3, 0, 0, 1, 4
"d:\IDEWORK\lvmen\src\licensedcode\data\rules\public-domain_428.yml", "YAML", 0, 0, 0, 3, 0, 0, 1, 4
"d:\IDEWORK\lvmen\src\licensedcode\data\rules\public-domain_429.yml", "YAML", 0, 0, 0, 3, 0, 0, 1, 4
"d:\IDEWORK\lvmen\src\licensedcode\data\rules\public-domain_43.yml", "YAML", 0, 0, 0, 3, 0, 0, 1, 4
"d:\IDEWORK\lvmen\src\licensedcode\data\rules\public-domain_430.yml", "YAML", 0, 0, 0, 3, 0, 0, 1, 4
"d:\IDEWORK\lvmen\src\licensedcode\data\rules\public-domain_431.yml", "YAML", 0, 0, 0, 3, 0, 0, 1, 4
"d:\IDEWORK\lvmen\src\licensedcode\data\rules\public-domain_44.yml", "YAML", 0, 0, 0, 3, 0, 0, 1, 4
"d:\IDEWORK\lvmen\src\licensedcode\data\rules\public-domain_45.yml", "YAML", 0, 0, 0, 3, 0, 0, 1, 4
"d:\IDEWORK\lvmen\src\licensedcode\data\rules\public-domain_46.yml", "YAML", 0, 0, 0, 3, 0, 0, 1, 4
"d:\IDEWORK\lvmen\src\licensedcode\data\rules\public-domain_47.yml", "YAML", 0, 0, 0, 2, 0, 0, 1, 3
"d:\IDEWORK\lvmen\src\licensedcode\data\rules\public-domain_48.yml", "YAML", 0, 0, 0, 3, 0, 0, 1, 4
"d:\IDEWORK\lvmen\src\licensedcode\data\rules\public-domain_49.yml", "YAML", 0, 0, 0, 3, 0, 0, 1, 4
"d:\IDEWORK\lvmen\src\licensedcode\data\rules\public-domain_5.yml", "YAML", 0, 0, 0, 4, 0, 0, 1, 5
"d:\IDEWORK\lvmen\src\licensedcode\data\rules\public-domain_50.yml", "YAML", 0, 0, 0, 3, 0, 0, 1, 4
"d:\IDEWORK\lvmen\src\licensedcode\data\rules\public-domain_51.yml", "YAML", 0, 0, 0, 3, 0, 0, 1, 4
"d:\IDEWORK\lvmen\src\licensedcode\data\rules\public-domain_52.yml", "YAML", 0, 0, 0, 3, 0, 0, 1, 4
"d:\IDEWORK\lvmen\src\licensedcode\data\rules\public-domain_53.yml", "YAML", 0, 0, 0, 3, 0, 0, 1, 4
"d:\IDEWORK\lvmen\src\licensedcode\data\rules\public-domain_54.yml", "YAML", 0, 0, 0, 2, 0, 0, 1, 3
"d:\IDEWORK\lvmen\src\licensedcode\data\rules\public-domain_55.yml", "YAML", 0, 0, 0, 3, 0, 0, 1, 4
"d:\IDEWORK\lvmen\src\licensedcode\data\rules\public-domain_56.yml", "YAML", 0, 0, 0, 2, 0, 0, 1, 3
"d:\IDEWORK\lvmen\src\licensedcode\data\rules\public-domain_57.yml", "YAML", 0, 0, 0, 3, 0, 0, 1, 4
"d:\IDEWORK\lvmen\src\licensedcode\data\rules\public-domain_58.yml", "YAML", 0, 0, 0, 3, 0, 0, 1, 4
"d:\IDEWORK\lvmen\src\licensedcode\data\rules\public-domain_59.yml", "YAML", 0, 0, 0, 3, 0, 0, 1, 4
"d:\IDEWORK\lvmen\src\licensedcode\data\rules\public-domain_6.yml", "YAML", 0, 0, 0, 3, 0, 0, 1, 4
"d:\IDEWORK\lvmen\src\licensedcode\data\rules\public-domain_60.yml", "YAML", 0, 0, 0, 3, 0, 0, 1, 4
"d:\IDEWORK\lvmen\src\licensedcode\data\rules\public-domain_61.yml", "YAML", 0, 0, 0, 3, 0, 0, 1, 4
"d:\IDEWORK\lvmen\src\licensedcode\data\rules\public-domain_62.yml", "YAML", 0, 0, 0, 3, 0, 0, 1, 4
"d:\IDEWORK\lvmen\src\licensedcode\data\rules\public-domain_63.yml", "YAML", 0, 0, 0, 3, 0, 0, 1, 4
"d:\IDEWORK\lvmen\src\licensedcode\data\rules\public-domain_64.yml", "YAML", 0, 0, 0, 3, 0, 0, 1, 4
"d:\IDEWORK\lvmen\src\licensedcode\data\rules\public-domain_65.yml", "YAML", 0, 0, 0, 3, 0, 0, 1, 4
"d:\IDEWORK\lvmen\src\licensedcode\data\rules\public-domain_66.yml", "YAML", 0, 0, 0, 3, 0, 0, 1, 4
"d:\IDEWORK\lvmen\src\licensedcode\data\rules\public-domain_67.yml", "YAML", 0, 0, 0, 3, 0, 0, 1, 4
"d:\IDEWORK\lvmen\src\licensedcode\data\rules\public-domain_68.yml", "YAML", 0, 0, 0, 3, 0, 0, 1, 4
"d:\IDEWORK\lvmen\src\licensedcode\data\rules\public-domain_69.yml", "YAML", 0, 0, 0, 3, 0, 0, 1, 4
"d:\IDEWORK\lvmen\src\licensedcode\data\rules\public-domain_7.yml", "YAML", 0, 0, 0, 4, 0, 0, 1, 5
"d:\IDEWORK\lvmen\src\licensedcode\data\rules\public-domain_70.yml", "YAML", 0, 0, 0, 3, 0, 0, 1, 4
"d:\IDEWORK\lvmen\src\licensedcode\data\rules\public-domain_71.yml", "YAML", 0, 0, 0, 3, 0, 0, 1, 4
"d:\IDEWORK\lvmen\src\licensedcode\data\rules\public-domain_72.yml", "YAML", 0, 0, 0, 2, 0, 0, 1, 3
"d:\IDEWORK\lvmen\src\licensedcode\data\rules\public-domain_73.yml", "YAML", 0, 0, 0, 3, 0, 0, 1, 4
"d:\IDEWORK\lvmen\src\licensedcode\data\rules\public-domain_74.yml", "YAML", 0, 0, 0, 3, 0, 0, 1, 4
"d:\IDEWORK\lvmen\src\licensedcode\data\rules\public-domain_75.yml", "YAML", 0, 0, 0, 3, 0, 0, 1, 4
"d:\IDEWORK\lvmen\src\licensedcode\data\rules\public-domain_76.yml", "YAML", 0, 0, 0, 3, 0, 0, 1, 4
"d:\IDEWORK\lvmen\src\licensedcode\data\rules\public-domain_77.yml", "YAML", 0, 0, 0, 3, 0, 0, 1, 4
"d:\IDEWORK\lvmen\src\licensedcode\data\rules\public-domain_78.yml", "YAML", 0, 0, 0, 3, 0, 0, 1, 4
"d:\IDEWORK\lvmen\src\licensedcode\data\rules\public-domain_79.yml", "YAML", 0, 0, 0, 3, 0, 0, 1, 4
"d:\IDEWORK\lvmen\src\licensedcode\data\rules\public-domain_8.yml", "YAML", 0, 0, 0, 6, 0, 0, 1, 7
"d:\IDEWORK\lvmen\src\licensedcode\data\rules\public-domain_80.yml", "YAML", 0, 0, 0, 3, 0, 0, 1, 4
"d:\IDEWORK\lvmen\src\licensedcode\data\rules\public-domain_81.yml", "YAML", 0, 0, 0, 3, 0, 0, 1, 4
"d:\IDEWORK\lvmen\src\licensedcode\data\rules\public-domain_82.yml", "YAML", 0, 0, 0, 3, 0, 0, 1, 4
"d:\IDEWORK\lvmen\src\licensedcode\data\rules\public-domain_83.yml", "YAML", 0, 0, 0, 3, 0, 0, 1, 4
"d:\IDEWORK\lvmen\src\licensedcode\data\rules\public-domain_84.yml", "YAML", 0, 0, 0, 3, 0, 0, 1, 4
"d:\IDEWORK\lvmen\src\licensedcode\data\rules\public-domain_85.yml", "YAML", 0, 0, 0, 3, 0, 0, 1, 4
"d:\IDEWORK\lvmen\src\licensedcode\data\rules\public-domain_86.yml", "YAML", 0, 0, 0, 2, 0, 0, 1, 3
"d:\IDEWORK\lvmen\src\licensedcode\data\rules\public-domain_87.yml", "YAML", 0, 0, 0, 2, 0, 0, 1, 3
"d:\IDEWORK\lvmen\src\licensedcode\data\rules\public-domain_88.yml", "YAML", 0, 0, 0, 3, 0, 0, 1, 4
"d:\IDEWORK\lvmen\src\licensedcode\data\rules\public-domain_89.yml", "YAML", 0, 0, 0, 3, 0, 0, 1, 4
"d:\IDEWORK\lvmen\src\licensedcode\data\rules\public-domain_9.yml", "YAML", 0, 0, 0, 4, 0, 0, 1, 5
"d:\IDEWORK\lvmen\src\licensedcode\data\rules\public-domain_90.yml", "YAML", 0, 0, 0, 3, 0, 0, 1, 4
"d:\IDEWORK\lvmen\src\licensedcode\data\rules\public-domain_91.yml", "YAML", 0, 0, 0, 3, 0, 0, 1, 4
"d:\IDEWORK\lvmen\src\licensedcode\data\rules\public-domain_92.yml", "YAML", 0, 0, 0, 3, 0, 0, 1, 4
"d:\IDEWORK\lvmen\src\licensedcode\data\rules\public-domain_93.yml", "YAML", 0, 0, 0, 2, 0, 0, 1, 3
"d:\IDEWORK\lvmen\src\licensedcode\data\rules\public-domain_94.yml", "YAML", 0, 0, 0, 3, 0, 0, 1, 4
"d:\IDEWORK\lvmen\src\licensedcode\data\rules\public-domain_95.yml", "YAML", 0, 0, 0, 3, 0, 0, 1, 4
"d:\IDEWORK\lvmen\src\licensedcode\data\rules\public-domain_96.yml", "YAML", 0, 0, 0, 3, 0, 0, 1, 4
"d:\IDEWORK\lvmen\src\licensedcode\data\rules\public-domain_97.yml", "YAML", 0, 0, 0, 3, 0, 0, 1, 4
"d:\IDEWORK\lvmen\src\licensedcode\data\rules\public-domain_98.yml", "YAML", 0, 0, 0, 3, 0, 0, 1, 4
"d:\IDEWORK\lvmen\src\licensedcode\data\rules\public-domain_99.yml", "YAML", 0, 0, 0, 3, 0, 0, 1, 4
"d:\IDEWORK\lvmen\src\licensedcode\data\rules\public-domain_and_apache-2.0_1.yml", "YAML", 0, 0, 0, 6, 0, 0, 1, 7
"d:\IDEWORK\lvmen\src\licensedcode\data\rules\public-domain_and_apache-2.0_2.yml", "YAML", 0, 0, 0, 3, 0, 0, 1, 4
"d:\IDEWORK\lvmen\src\licensedcode\data\rules\public-domain_and_apache.yml", "YAML", 0, 0, 0, 6, 0, 0, 1, 7
"d:\IDEWORK\lvmen\src\licensedcode\data\rules\public-domain_and_apache2.yml", "YAML", 0, 0, 0, 6, 0, 0, 1, 7
"d:\IDEWORK\lvmen\src\licensedcode\data\rules\public-domain_and_free-unknown_1.yml", "YAML", 0, 0, 0, 4, 0, 0, 1, 5
"d:\IDEWORK\lvmen\src\licensedcode\data\rules\public-domain_and_gpl-1.0-plus_1.yml", "YAML", 0, 0, 0, 2, 0, 0, 1, 3
"d:\IDEWORK\lvmen\src\licensedcode\data\rules\public-domain_and_gpl-1.0-plus_2.yml", "YAML", 0, 0, 0, 2, 0, 0, 1, 3
"d:\IDEWORK\lvmen\src\licensedcode\data\rules\public-domain_and_gpl-2.0-plus.yml", "YAML", 0, 0, 0, 2, 0, 0, 1, 3
"d:\IDEWORK\lvmen\src\licensedcode\data\rules\public-domain_and_gpl-2.0-plus_1.yml", "YAML", 0, 0, 0, 2, 0, 0, 1, 3
"d:\IDEWORK\lvmen\src\licensedcode\data\rules\public-domain_and_gpl-2.0-plus_and_gpl-3.0-plus_1.yml", "YAML", 0, 0, 0, 3, 0, 0, 1, 4
"d:\IDEWORK\lvmen\src\licensedcode\data\rules\public-domain_and_gpl-2.0.yml", "YAML", 0, 0, 0, 2, 0, 0, 1, 3
"d:\IDEWORK\lvmen\src\licensedcode\data\rules\public-domain_and_gpl-2.0_2.yml", "YAML", 0, 0, 0, 3, 0, 0, 1, 4
"d:\IDEWORK\lvmen\src\licensedcode\data\rules\public-domain_and_gutenberg-2020_1.yml", "YAML", 0, 0, 0, 3, 0, 0, 1, 4
"d:\IDEWORK\lvmen\src\licensedcode\data\rules\public-domain_and_lgpl-2.1_with_libwebsockets-exception_1.yml", "YAML", 0, 0, 0, 3, 0, 0, 1, 4
"d:\IDEWORK\lvmen\src\licensedcode\data\rules\public-domain_and_lgpl-2.1_with_libwebsockets-exception_2.yml", "YAML", 0, 0, 0, 3, 0, 0, 1, 4
"d:\IDEWORK\lvmen\src\licensedcode\data\rules\public-domain_and_mit2.yml", "YAML", 0, 0, 0, 3, 0, 0, 1, 4
"d:\IDEWORK\lvmen\src\licensedcode\data\rules\public-domain_and_mit_1.yml", "YAML", 0, 0, 0, 3, 0, 0, 1, 4
"d:\IDEWORK\lvmen\src\licensedcode\data\rules\public-domain_and_other-permissive_1.yml", "YAML", 0, 0, 0, 4, 0, 0, 1, 5
"d:\IDEWORK\lvmen\src\licensedcode\data\rules\public-domain_and_other-permissive_2.yml", "YAML", 0, 0, 0, 4, 0, 0, 1, 5
"d:\IDEWORK\lvmen\src\licensedcode\data\rules\public-domain_and_other-permissive_and_other-copyleft_and_proprietary-license_1.yml", "YAML", 0, 0, 0, 3, 0, 0, 1, 4
"d:\IDEWORK\lvmen\src\licensedcode\data\rules\public-domain_and_proprietary-license_1.yml", "YAML", 0, 0, 0, 7, 0, 0, 1, 8
"d:\IDEWORK\lvmen\src\licensedcode\data\rules\public-domain_and_proprietary-license_2.yml", "YAML", 0, 0, 0, 5, 0, 0, 1, 6
"d:\IDEWORK\lvmen\src\licensedcode\data\rules\public-domain_and_proprietary-license_3.yml", "YAML", 0, 0, 0, 14, 0, 0, 1, 15
"d:\IDEWORK\lvmen\src\licensedcode\data\rules\public-domain_and_unknown-license-reference_1.yml", "YAML", 0, 0, 0, 3, 0, 0, 1, 4
"d:\IDEWORK\lvmen\src\licensedcode\data\rules\public-domain_and_unknown_1.yml", "YAML", 0, 0, 0, 3, 0, 0, 1, 4
"d:\IDEWORK\lvmen\src\licensedcode\data\rules\public-domain_and_warranty-disclaimer_1.yml", "YAML", 0, 0, 0, 4, 0, 0, 1, 5
"d:\IDEWORK\lvmen\src\licensedcode\data\rules\public-domain_apache_1.yml", "YAML", 0, 0, 0, 5, 0, 0, 1, 6
"d:\IDEWORK\lvmen\src\licensedcode\data\rules\public-domain_bare_words.yml", "YAML", 0, 0, 0, 4, 0, 0, 1, 5
"d:\IDEWORK\lvmen\src\licensedcode\data\rules\public-domain_disclaimed_38.yml", "YAML", 0, 0, 0, 3, 0, 0, 1, 4
"d:\IDEWORK\lvmen\src\licensedcode\data\rules\public-domain_docutils.yml", "YAML", 0, 0, 0, 2, 0, 0, 1, 3
"d:\IDEWORK\lvmen\src\licensedcode\data\rules\public-domain_docutils2.yml", "YAML", 0, 0, 0, 2, 0, 0, 1, 3
"d:\IDEWORK\lvmen\src\licensedcode\data\rules\public-domain_docutils3.yml", "YAML", 0, 0, 0, 3, 0, 0, 1, 4
"d:\IDEWORK\lvmen\src\licensedcode\data\rules\public-domain_licensebutton.yml", "YAML", 0, 0, 0, 5, 0, 0, 1, 6
"d:\IDEWORK\lvmen\src\licensedcode\data\rules\public-domain_newlib.yml", "YAML", 0, 0, 0, 3, 0, 0, 1, 4
"d:\IDEWORK\lvmen\src\licensedcode\data\rules\public-domain_newlib2.yml", "YAML", 0, 0, 0, 2, 0, 0, 1, 3
"d:\IDEWORK\lvmen\src\licensedcode\data\rules\public-domain_newlib3.yml", "YAML", 0, 0, 0, 3, 0, 0, 1, 4
"d:\IDEWORK\lvmen\src\licensedcode\data\rules\public-domain_not_sax-pd.yml", "YAML", 0, 0, 0, 3, 0, 0, 1, 4
"d:\IDEWORK\lvmen\src\licensedcode\data\rules\public-domain_not_sax-pd3.yml", "YAML", 0, 0, 0, 3, 0, 0, 1, 4
"d:\IDEWORK\lvmen\src\licensedcode\data\rules\public-domain_not_unknown_1.yml", "YAML", 0, 0, 0, 4, 0, 0, 1, 5
"d:\IDEWORK\lvmen\src\licensedcode\data\rules\public-domain_or_apache-2.0_1.yml", "YAML", 0, 0, 0, 3, 0, 0, 1, 4
"d:\IDEWORK\lvmen\src\licensedcode\data\rules\public-domain_or_apache-2.0_2.yml", "YAML", 0, 0, 0, 3, 0, 0, 1, 4
"d:\IDEWORK\lvmen\src\licensedcode\data\rules\public-domain_or_bsd-source-code_1.yml", "YAML", 0, 0, 0, 4, 0, 0, 1, 5
"d:\IDEWORK\lvmen\src\licensedcode\data\rules\public-domain_or_bsd-zero_1.yml", "YAML", 0, 0, 0, 2, 0, 0, 1, 3
"d:\IDEWORK\lvmen\src\licensedcode\data\rules\public-domain_or_cc0-1.0_1.yml", "YAML", 0, 0, 0, 3, 0, 0, 1, 4
"d:\IDEWORK\lvmen\src\licensedcode\data\rules\public-domain_or_cc0.yml", "YAML", 0, 0, 0, 2, 0, 0, 1, 3
"d:\IDEWORK\lvmen\src\licensedcode\data\rules\public-domain_or_cc0_1.yml", "YAML", 0, 0, 0, 4, 0, 0, 1, 5
"d:\IDEWORK\lvmen\src\licensedcode\data\rules\public-domain_or_cc0_2.yml", "YAML", 0, 0, 0, 4, 0, 0, 1, 5
"d:\IDEWORK\lvmen\src\licensedcode\data\rules\public-domain_or_cc0_3.yml", "YAML", 0, 0, 0, 4, 0, 0, 1, 5
"d:\IDEWORK\lvmen\src\licensedcode\data\rules\public-domain_or_cc0_4.yml", "YAML", 0, 0, 0, 5, 0, 0, 1, 6
"d:\IDEWORK\lvmen\src\licensedcode\data\rules\public-domain_or_free-unknown_usgov.yml", "YAML", 0, 0, 0, 3, 0, 0, 1, 4
"d:\IDEWORK\lvmen\src\licensedcode\data\rules\public-domain_or_lgpl-2.0-plus_or_gpl-1.0-plus_1.yml", "YAML", 0, 0, 0, 5, 0, 0, 1, 6
"d:\IDEWORK\lvmen\src\licensedcode\data\rules\public-domain_or_lgpl-2.0-plus_or_gpl-1.0-plus_2.yml", "YAML", 0, 0, 0, 4, 0, 0, 1, 5
"d:\IDEWORK\lvmen\src\licensedcode\data\rules\public-domain_or_lgpl-2.0-plus_or_gpl-1.0-plus_3.yml", "YAML", 0, 0, 0, 3, 0, 0, 1, 4
"d:\IDEWORK\lvmen\src\licensedcode\data\rules\public-domain_or_lgpl-2.0-plus_or_gpl-1.0-plus_4.yml", "YAML", 0, 0, 0, 3, 0, 0, 1, 4
"d:\IDEWORK\lvmen\src\licensedcode\data\rules\public-domain_or_lgpl-2.0-plus_or_gpl-1.0-plus_5.yml", "YAML", 0, 0, 0, 6, 0, 0, 1, 7
"d:\IDEWORK\lvmen\src\licensedcode\data\rules\public-domain_or_mentalis_1.yml", "YAML", 0, 0, 0, 2, 0, 0, 1, 3
"d:\IDEWORK\lvmen\src\licensedcode\data\rules\public-domain_or_mit_1.yml", "YAML", 0, 0, 0, 5, 0, 0, 1, 6
"d:\IDEWORK\lvmen\src\licensedcode\data\rules\public-domain_or_mit_2.yml", "YAML", 0, 0, 0, 5, 0, 0, 1, 6
"d:\IDEWORK\lvmen\src\licensedcode\data\rules\public-domain_or_mit_3.yml", "YAML", 0, 0, 0, 6, 0, 0, 1, 7
"d:\IDEWORK\lvmen\src\licensedcode\data\rules\public-domain_or_mit_4.yml", "YAML", 0, 0, 0, 3, 0, 0, 1, 4
"d:\IDEWORK\lvmen\src\licensedcode\data\rules\public-domain_or_mit_5.yml", "YAML", 0, 0, 0, 3, 0, 0, 1, 4
"d:\IDEWORK\lvmen\src\licensedcode\data\rules\public-domain_or_mit_6.yml", "YAML", 0, 0, 0, 3, 0, 0, 1, 4
"d:\IDEWORK\lvmen\src\licensedcode\data\rules\public-domain_or_mit_7.yml", "YAML", 0, 0, 0, 5, 0, 0, 1, 6
"d:\IDEWORK\lvmen\src\licensedcode\data\rules\public-domain_or_mit_or_artistic-1.0_or_artistic-2.0_or_gpl-1.0-plus_1.yml", "YAML", 0, 0, 0, 2, 0, 0, 1, 3
"d:\IDEWORK\lvmen\src\licensedcode\data\rules\public-domain_or_nysl-0.9982_1.yml", "YAML", 0, 0, 0, 3, 0, 0, 1, 4
"d:\IDEWORK\lvmen\src\licensedcode\data\rules\public-domain_or_other-permissive_1.yml", "YAML", 0, 0, 0, 2, 0, 0, 1, 3
"d:\IDEWORK\lvmen\src\licensedcode\data\rules\public-domain_or_other-permissive_10.yml", "YAML", 0, 0, 0, 8, 0, 0, 1, 9
"d:\IDEWORK\lvmen\src\licensedcode\data\rules\public-domain_or_other-permissive_11.yml", "YAML", 0, 0, 0, 7, 0, 0, 1, 8
"d:\IDEWORK\lvmen\src\licensedcode\data\rules\public-domain_or_other-permissive_2.yml", "YAML", 0, 0, 0, 2, 0, 0, 1, 3
"d:\IDEWORK\lvmen\src\licensedcode\data\rules\public-domain_or_other-permissive_3.yml", "YAML", 0, 0, 0, 6, 0, 0, 1, 7
"d:\IDEWORK\lvmen\src\licensedcode\data\rules\public-domain_or_other-permissive_4.yml", "YAML", 0, 0, 0, 2, 0, 0, 1, 3
"d:\IDEWORK\lvmen\src\licensedcode\data\rules\public-domain_or_other-permissive_5.yml", "YAML", 0, 0, 0, 6, 0, 0, 1, 7
"d:\IDEWORK\lvmen\src\licensedcode\data\rules\public-domain_or_other-permissive_6.yml", "YAML", 0, 0, 0, 9, 0, 0, 1, 10
"d:\IDEWORK\lvmen\src\licensedcode\data\rules\public-domain_or_other-permissive_7.yml", "YAML", 0, 0, 0, 7, 0, 0, 2, 9
"d:\IDEWORK\lvmen\src\licensedcode\data\rules\public-domain_or_other-permissive_8.yml", "YAML", 0, 0, 0, 7, 0, 0, 1, 8
"d:\IDEWORK\lvmen\src\licensedcode\data\rules\public-domain_or_other-permissive_9.yml", "YAML", 0, 0, 0, 8, 0, 0, 1, 9
"d:\IDEWORK\lvmen\src\licensedcode\data\rules\public-domain_or_other-permissive_md5_1.yml", "YAML", 0, 0, 0, 2, 0, 0, 1, 3
"d:\IDEWORK\lvmen\src\licensedcode\data\rules\public-domain_or_other-permissive_md5_2.yml", "YAML", 0, 0, 0, 6, 0, 0, 1, 7
"d:\IDEWORK\lvmen\src\licensedcode\data\rules\public-domain_or_wtfpl-2.0_1.yml", "YAML", 0, 0, 0, 5, 0, 0, 1, 6
"d:\IDEWORK\lvmen\src\licensedcode\data\rules\public-domain_this2.yml", "YAML", 0, 0, 0, 3, 0, 0, 1, 4
"d:\IDEWORK\lvmen\src\licensedcode\data\rules\public-domain_zlib.yml", "YAML", 0, 0, 0, 3, 0, 0, 1, 4
"d:\IDEWORK\lvmen\src\licensedcode\data\rules\public-domain_zlib10.yml", "YAML", 0, 0, 0, 7, 0, 0, 1, 8
"d:\IDEWORK\lvmen\src\licensedcode\data\rules\public-domain_zlib11.yml", "YAML", 0, 0, 0, 7, 0, 0, 1, 8
"d:\IDEWORK\lvmen\src\licensedcode\data\rules\public-domain_zlib12.yml", "YAML", 0, 0, 0, 7, 0, 0, 1, 8
"d:\IDEWORK\lvmen\src\licensedcode\data\rules\public-domain_zlib2.yml", "YAML", 0, 0, 0, 7, 0, 0, 1, 8
"d:\IDEWORK\lvmen\src\licensedcode\data\rules\public-domain_zlib3.yml", "YAML", 0, 0, 0, 7, 0, 0, 1, 8
"d:\IDEWORK\lvmen\src\licensedcode\data\rules\public-domain_zlib4.yml", "YAML", 0, 0, 0, 2, 0, 0, 1, 3
"d:\IDEWORK\lvmen\src\licensedcode\data\rules\public-domain_zlib5.yml", "YAML", 0, 0, 0, 3, 0, 0, 1, 4
"d:\IDEWORK\lvmen\src\licensedcode\data\rules\public-domain_zlib6.yml", "YAML", 0, 0, 0, 3, 0, 0, 1, 4
"d:\IDEWORK\lvmen\src\licensedcode\data\rules\public-domain_zlib7.yml", "YAML", 0, 0, 0, 2, 0, 0, 1, 3
"d:\IDEWORK\lvmen\src\licensedcode\data\rules\public-domain_zlib8.yml", "YAML", 0, 0, 0, 3, 0, 0, 1, 4
"d:\IDEWORK\lvmen\src\licensedcode\data\rules\public-domain_zlib9.yml", "YAML", 0, 0, 0, 7, 0, 0, 1, 8
"d:\IDEWORK\lvmen\src\licensedcode\data\rules\purdue-bsd_and_other-permissive_1.yml", "YAML", 0, 0, 0, 5, 0, 0, 1, 6
"d:\IDEWORK\lvmen\src\licensedcode\data\rules\purdue-bsd_and_sendmail_1.yml", "YAML", 0, 0, 0, 6, 0, 0, 1, 7
"d:\IDEWORK\lvmen\src\licensedcode\data\rules\purdue-bsd_and_sendmail_2.yml", "YAML", 0, 0, 0, 6, 0, 0, 0, 6
"d:\IDEWORK\lvmen\src\licensedcode\data\rules\purdue-bsd_and_sendmail_3.yml", "YAML", 0, 0, 0, 6, 0, 0, 1, 7
"d:\IDEWORK\lvmen\src\licensedcode\data\rules\pycrypto.yml", "YAML", 0, 0, 0, 2, 0, 0, 1, 3
"d:\IDEWORK\lvmen\src\licensedcode\data\rules\pycrypto_1.yml", "YAML", 0, 0, 0, 4, 0, 0, 1, 5
"d:\IDEWORK\lvmen\src\licensedcode\data\rules\pycrypto_2.yml", "YAML", 0, 0, 0, 4, 0, 0, 1, 5
"d:\IDEWORK\lvmen\src\licensedcode\data\rules\pygres-2.2.yml", "YAML", 0, 0, 0, 5, 0, 0, 1, 6
"d:\IDEWORK\lvmen\src\licensedcode\data\rules\pygres-2.2_1.yml", "YAML", 0, 0, 0, 13, 0, 0, 1, 14
"d:\IDEWORK\lvmen\src\licensedcode\data\rules\pygres-2.2_2.yml", "YAML", 0, 0, 0, 3, 0, 0, 1, 4
"d:\IDEWORK\lvmen\src\licensedcode\data\rules\pypi_academic_free_license.yml", "YAML", 0, 0, 0, 5, 0, 0, 1, 6
"d:\IDEWORK\lvmen\src\licensedcode\data\rules\pypi_aladdin_free_public_license.yml", "YAML", 0, 0, 0, 5, 0, 0, 1, 6
"d:\IDEWORK\lvmen\src\licensedcode\data\rules\pypi_apache_no-version.yml", "YAML", 0, 0, 0, 5, 0, 0, 2, 7
"d:\IDEWORK\lvmen\src\licensedcode\data\rules\pypi_apple_public_source_license.yml", "YAML", 0, 0, 0, 5, 0, 0, 1, 6
"d:\IDEWORK\lvmen\src\licensedcode\data\rules\pypi_artistic_license.yml", "YAML", 0, 0, 0, 5, 0, 0, 1, 6
"d:\IDEWORK\lvmen\src\licensedcode\data\rules\pypi_attribution_assurance_license.yml", "YAML", 0, 0, 0, 3, 0, 0, 1, 4
"d:\IDEWORK\lvmen\src\licensedcode\data\rules\pypi_boost.yml", "YAML", 0, 0, 0, 3, 0, 0, 1, 4
"d:\IDEWORK\lvmen\src\licensedcode\data\rules\pypi_bsd_license.yml", "YAML", 0, 0, 0, 4, 0, 0, 1, 5
"d:\IDEWORK\lvmen\src\licensedcode\data\rules\pypi_bsd_license2.yml", "YAML", 0, 0, 0, 4, 0, 0, 1, 5
"d:\IDEWORK\lvmen\src\licensedcode\data\rules\pypi_cc0_1_0_universal.yml", "YAML", 0, 0, 0, 3, 0, 0, 1, 4
"d:\IDEWORK\lvmen\src\licensedcode\data\rules\pypi_cddl-1.0.yml", "YAML", 0, 0, 0, 3, 0, 0, 1, 4
"d:\IDEWORK\lvmen\src\licensedcode\data\rules\pypi_cea_cnrs_inria_logiciel_libre_license_version_2_1.yml", "YAML", 0, 0, 0, 3, 0, 0, 1, 4
"d:\IDEWORK\lvmen\src\licensedcode\data\rules\pypi_cecill-b.yml", "YAML", 0, 0, 0, 3, 0, 0, 1, 4
"d:\IDEWORK\lvmen\src\licensedcode\data\rules\pypi_cecill-c.yml", "YAML", 0, 0, 0, 3, 0, 0, 1, 4
"d:\IDEWORK\lvmen\src\licensedcode\data\rules\pypi_common_public_license.yml", "YAML", 0, 0, 0, 5, 0, 0, 1, 6
"d:\IDEWORK\lvmen\src\licensedcode\data\rules\pypi_dfsg_approved.yml", "YAML", 0, 0, 0, 3, 0, 0, 1, 4
"d:\IDEWORK\lvmen\src\licensedcode\data\rules\pypi_eiffel_forum_license.yml", "YAML", 0, 0, 0, 3, 0, 0, 1, 4
"d:\IDEWORK\lvmen\src\licensedcode\data\rules\pypi_eiffel_forum_license2.yml", "YAML", 0, 0, 0, 3, 0, 0, 1, 4
"d:\IDEWORK\lvmen\src\licensedcode\data\rules\pypi_epl-1.0.yml", "YAML", 0, 0, 0, 3, 0, 0, 1, 4
"d:\IDEWORK\lvmen\src\licensedcode\data\rules\pypi_epl-2.0.yml", "YAML", 0, 0, 0, 3, 0, 0, 1, 4
"d:\IDEWORK\lvmen\src\licensedcode\data\rules\pypi_european_union_public_licence_1_0.yml", "YAML", 0, 0, 0, 3, 0, 0, 1, 4
"d:\IDEWORK\lvmen\src\licensedcode\data\rules\pypi_european_union_public_licence_1_1.yml", "YAML", 0, 0, 0, 3, 0, 0, 1, 4
"d:\IDEWORK\lvmen\src\licensedcode\data\rules\pypi_european_union_public_licence_1_2.yml", "YAML", 0, 0, 0, 3, 0, 0, 1, 4
"d:\IDEWORK\lvmen\src\licensedcode\data\rules\pypi_free_for_educational_use.yml", "YAML", 0, 0, 0, 3, 0, 0, 1, 4
"d:\IDEWORK\lvmen\src\licensedcode\data\rules\pypi_free_for_home_use.yml", "YAML", 0, 0, 0, 3, 0, 0, 1, 4
"d:\IDEWORK\lvmen\src\licensedcode\data\rules\pypi_free_for_non_commercial_use.yml", "YAML", 0, 0, 0, 3, 0, 0, 1, 4
"d:\IDEWORK\lvmen\src\licensedcode\data\rules\pypi_free_to_use_but_restricted.yml", "YAML", 0, 0, 0, 3, 0, 0, 1, 4
"d:\IDEWORK\lvmen\src\licensedcode\data\rules\pypi_freely_distributable.yml", "YAML", 0, 0, 0, 3, 0, 0, 1, 4
"d:\IDEWORK\lvmen\src\licensedcode\data\rules\pypi_freeware.yml", "YAML", 0, 0, 0, 3, 0, 0, 1, 4
"d:\IDEWORK\lvmen\src\licensedcode\data\rules\pypi_gnu_affero_general_public_license_v3.yml", "YAML", 0, 0, 0, 3, 0, 0, 1, 4
"d:\IDEWORK\lvmen\src\licensedcode\data\rules\pypi_gnu_affero_general_public_license_v3_or_later.yml", "YAML", 0, 0, 0, 3, 0, 0, 1, 4
"d:\IDEWORK\lvmen\src\licensedcode\data\rules\pypi_gnu_free_documentation_license.yml", "YAML", 0, 0, 0, 4, 0, 0, 1, 5
"d:\IDEWORK\lvmen\src\licensedcode\data\rules\pypi_gnu_general_public_license.yml", "YAML", 0, 0, 0, 3, 0, 0, 1, 4
"d:\IDEWORK\lvmen\src\licensedcode\data\rules\pypi_gnu_general_public_license2.yml", "YAML", 0, 0, 0, 3, 0, 0, 1, 4
"d:\IDEWORK\lvmen\src\licensedcode\data\rules\pypi_gnu_general_public_license_v2.yml", "YAML", 0, 0, 0, 3, 0, 0, 1, 4
"d:\IDEWORK\lvmen\src\licensedcode\data\rules\pypi_gnu_general_public_license_v2_1.yml", "YAML", 0, 0, 0, 3, 0, 0, 1, 4
"d:\IDEWORK\lvmen\src\licensedcode\data\rules\pypi_gnu_general_public_license_v2_or_later.yml", "YAML", 0, 0, 0, 3, 0, 0, 1, 4
"d:\IDEWORK\lvmen\src\licensedcode\data\rules\pypi_gnu_general_public_license_v3.yml", "YAML", 0, 0, 0, 3, 0, 0, 1, 4
"d:\IDEWORK\lvmen\src\licensedcode\data\rules\pypi_gnu_general_public_license_v3_1.yml", "YAML", 0, 0, 0, 3, 0, 0, 1, 4
"d:\IDEWORK\lvmen\src\licensedcode\data\rules\pypi_gnu_general_public_license_v3_or_later.yml", "YAML", 0, 0, 0, 3, 0, 0, 1, 4
"d:\IDEWORK\lvmen\src\licensedcode\data\rules\pypi_gnu_lesser_general_public_license_v2.yml", "YAML", 0, 0, 0, 3, 0, 0, 1, 4
"d:\IDEWORK\lvmen\src\licensedcode\data\rules\pypi_gnu_lesser_general_public_license_v2_or_later.yml", "YAML", 0, 0, 0, 3, 0, 0, 1, 4
"d:\IDEWORK\lvmen\src\licensedcode\data\rules\pypi_gnu_lesser_general_public_license_v3.yml", "YAML", 0, 0, 0, 3, 0, 0, 1, 4
"d:\IDEWORK\lvmen\src\licensedcode\data\rules\pypi_gnu_lesser_general_public_license_v3_or_later.yml", "YAML", 0, 0, 0, 3, 0, 0, 1, 4
"d:\IDEWORK\lvmen\src\licensedcode\data\rules\pypi_gnu_library_or_lesser_general_public_license.yml", "YAML", 0, 0, 0, 3, 0, 0, 1, 4
"d:\IDEWORK\lvmen\src\licensedcode\data\rules\pypi_gnu_library_or_lesser_general_public_license2.yml", "YAML", 0, 0, 0, 3, 0, 0, 1, 4
"d:\IDEWORK\lvmen\src\licensedcode\data\rules\pypi_gnu_library_or_lesser_general_public_license3.yml", "YAML", 0, 0, 0, 3, 0, 0, 1, 4
"d:\IDEWORK\lvmen\src\licensedcode\data\rules\pypi_gnu_library_or_lesser_general_public_license_v3_1.yml", "YAML", 0, 0, 0, 3, 0, 0, 1, 4
"d:\IDEWORK\lvmen\src\licensedcode\data\rules\pypi_gust_font_license.yml", "YAML", 0, 0, 0, 3, 0, 0, 1, 4
"d:\IDEWORK\lvmen\src\licensedcode\data\rules\pypi_gust_font_license2.yml", "YAML", 0, 0, 0, 3, 0, 0, 1, 4
"d:\IDEWORK\lvmen\src\licensedcode\data\rules\pypi_ibm_public_license.yml", "YAML", 0, 0, 0, 3, 0, 0, 1, 4
"d:\IDEWORK\lvmen\src\licensedcode\data\rules\pypi_intel_open_source_license.yml", "YAML", 0, 0, 0, 3, 0, 0, 1, 4
"d:\IDEWORK\lvmen\src\licensedcode\data\rules\pypi_isc_license.yml", "YAML", 0, 0, 0, 3, 0, 0, 1, 4
"d:\IDEWORK\lvmen\src\licensedcode\data\rules\pypi_jabber_open_source_license.yml", "YAML", 0, 0, 0, 3, 0, 0, 1, 4
"d:\IDEWORK\lvmen\src\licensedcode\data\rules\pypi_mir-os_license.yml", "YAML", 0, 0, 0, 3, 0, 0, 1, 4
"d:\IDEWORK\lvmen\src\licensedcode\data\rules\pypi_mit_license.yml", "YAML", 0, 0, 0, 3, 0, 0, 1, 4
"d:\IDEWORK\lvmen\src\licensedcode\data\rules\pypi_mitre_collaborative_virtual_workspace_license.yml", "YAML", 0, 0, 0, 3, 0, 0, 1, 4
"d:\IDEWORK\lvmen\src\licensedcode\data\rules\pypi_motosoto_license.yml", "YAML", 0, 0, 0, 3, 0, 0, 1, 4
"d:\IDEWORK\lvmen\src\licensedcode\data\rules\pypi_mozilla_public_license_1_0.yml", "YAML", 0, 0, 0, 3, 0, 0, 1, 4
"d:\IDEWORK\lvmen\src\licensedcode\data\rules\pypi_mozilla_public_license_1_1.yml", "YAML", 0, 0, 0, 3, 0, 0, 1, 4
"d:\IDEWORK\lvmen\src\licensedcode\data\rules\pypi_mozilla_public_license_2_0.yml", "YAML", 0, 0, 0, 3, 0, 0, 1, 4
"d:\IDEWORK\lvmen\src\licensedcode\data\rules\pypi_mozilla_public_license_2_0_1.yml", "YAML", 0, 0, 0, 3, 0, 0, 1, 4
"d:\IDEWORK\lvmen\src\licensedcode\data\rules\pypi_nethack_general_public_license.yml", "YAML", 0, 0, 0, 3, 0, 0, 1, 4
"d:\IDEWORK\lvmen\src\licensedcode\data\rules\pypi_netscape_public_license.yml", "YAML", 0, 0, 0, 5, 0, 0, 1, 6
"d:\IDEWORK\lvmen\src\licensedcode\data\rules\pypi_nokia_open_source_license.yml", "YAML", 0, 0, 0, 5, 0, 0, 1, 6
"d:\IDEWORK\lvmen\src\licensedcode\data\rules\pypi_nokia_open_source_license2.yml", "YAML", 0, 0, 0, 5, 0, 0, 1, 6
"d:\IDEWORK\lvmen\src\licensedcode\data\rules\pypi_open_group_test_suite_license.yml", "YAML", 0, 0, 0, 3, 0, 0, 1, 4
"d:\IDEWORK\lvmen\src\licensedcode\data\rules\pypi_osi_approved.yml", "YAML", 0, 0, 0, 3, 0, 0, 1, 4
"d:\IDEWORK\lvmen\src\licensedcode\data\rules\pypi_osi_approved2.yml", "YAML", 0, 0, 0, 3, 0, 0, 1, 4
"d:\IDEWORK\lvmen\src\licensedcode\data\rules\pypi_other_proprietary_license.yml", "YAML", 0, 0, 0, 3, 0, 0, 1, 4
"d:\IDEWORK\lvmen\src\licensedcode\data\rules\pypi_postgresql.yml", "YAML", 0, 0, 0, 3, 0, 0, 1, 4
"d:\IDEWORK\lvmen\src\licensedcode\data\rules\pypi_public_domain.yml", "YAML", 0, 0, 0, 3, 0, 0, 1, 4
"d:\IDEWORK\lvmen\src\licensedcode\data\rules\pypi_python_license.yml", "YAML", 0, 0, 0, 3, 0, 0, 1, 4
"d:\IDEWORK\lvmen\src\licensedcode\data\rules\pypi_python_software_foundation_license.yml", "YAML", 0, 0, 0, 3, 0, 0, 1, 4
"d:\IDEWORK\lvmen\src\licensedcode\data\rules\pypi_python_software_foundation_license2.yml", "YAML", 0, 0, 0, 3, 0, 0, 1, 4
"d:\IDEWORK\lvmen\src\licensedcode\data\rules\pypi_qt_public_license.yml", "YAML", 0, 0, 0, 3, 0, 0, 1, 4
"d:\IDEWORK\lvmen\src\licensedcode\data\rules\pypi_repoze_public_license.yml", "YAML", 0, 0, 0, 3, 0, 0, 1, 4
"d:\IDEWORK\lvmen\src\licensedcode\data\rules\pypi_ricoh_source_code_public_license.yml", "YAML", 0, 0, 0, 3, 0, 0, 1, 4
"d:\IDEWORK\lvmen\src\licensedcode\data\rules\pypi_sil.yml", "YAML", 0, 0, 0, 3, 0, 0, 1, 4
"d:\IDEWORK\lvmen\src\licensedcode\data\rules\pypi_sleepycat_license.yml", "YAML", 0, 0, 0, 3, 0, 0, 1, 4
"d:\IDEWORK\lvmen\src\licensedcode\data\rules\pypi_sun_industry_standards_source_license.yml", "YAML", 0, 0, 0, 5, 0, 0, 1, 6
"d:\IDEWORK\lvmen\src\licensedcode\data\rules\pypi_sun_public_license.yml", "YAML", 0, 0, 0, 3, 0, 0, 1, 4
"d:\IDEWORK\lvmen\src\licensedcode\data\rules\pypi_university_of_illinois_ncsa_open_source_license.yml", "YAML", 0, 0, 0, 3, 0, 0, 1, 4
"d:\IDEWORK\lvmen\src\licensedcode\data\rules\pypi_upl.yml", "YAML", 0, 0, 0, 3, 0, 0, 1, 4
"d:\IDEWORK\lvmen\src\licensedcode\data\rules\pypi_vovida_software_license_1_0.yml", "YAML", 0, 0, 0, 3, 0, 0, 1, 4
"d:\IDEWORK\lvmen\src\licensedcode\data\rules\pypi_w3c_license.yml", "YAML", 0, 0, 0, 3, 0, 0, 1, 4
"d:\IDEWORK\lvmen\src\licensedcode\data\rules\pypi_x_net_license.yml", "YAML", 0, 0, 0, 3, 0, 0, 1, 4
"d:\IDEWORK\lvmen\src\licensedcode\data\rules\pypi_zlib_libpng_license.yml", "YAML", 0, 0, 0, 3, 0, 0, 1, 4
"d:\IDEWORK\lvmen\src\licensedcode\data\rules\pypi_zope_public_license.yml", "YAML", 0, 0, 0, 5, 0, 0, 1, 6
"d:\IDEWORK\lvmen\src\licensedcode\data\rules\python-cwi.yml", "YAML", 0, 0, 0, 4, 0, 0, 1, 5
"d:\IDEWORK\lvmen\src\licensedcode\data\rules\python.yml", "YAML", 0, 0, 0, 5, 0, 0, 1, 6
"d:\IDEWORK\lvmen\src\licensedcode\data\rules\python_1.yml", "YAML", 0, 0, 0, 5, 0, 0, 1, 6
"d:\IDEWORK\lvmen\src\licensedcode\data\rules\python_10.yml", "YAML", 0, 0, 0, 4, 0, 0, 1, 5
"d:\IDEWORK\lvmen\src\licensedcode\data\rules\python_11.yml", "YAML", 0, 0, 0, 5, 0, 0, 1, 6
"d:\IDEWORK\lvmen\src\licensedcode\data\rules\python_12.yml", "YAML", 0, 0, 0, 5, 0, 0, 1, 6
"d:\IDEWORK\lvmen\src\licensedcode\data\rules\python_13.yml", "YAML", 0, 0, 0, 3, 0, 0, 1, 4
"d:\IDEWORK\lvmen\src\licensedcode\data\rules\python_14.yml", "YAML", 0, 0, 0, 12, 0, 0, 1, 13
"d:\IDEWORK\lvmen\src\licensedcode\data\rules\python_15.yml", "YAML", 0, 0, 0, 3, 0, 0, 1, 4
"d:\IDEWORK\lvmen\src\licensedcode\data\rules\python_16.yml", "YAML", 0, 0, 0, 3, 0, 0, 1, 4
"d:\IDEWORK\lvmen\src\licensedcode\data\rules\python_17.yml", "YAML", 0, 0, 0, 3, 0, 0, 1, 4
"d:\IDEWORK\lvmen\src\licensedcode\data\rules\python_18.yml", "YAML", 0, 0, 0, 5, 0, 0, 1, 6
"d:\IDEWORK\lvmen\src\licensedcode\data\rules\python_19.yml", "YAML", 0, 0, 0, 3, 0, 0, 1, 4
"d:\IDEWORK\lvmen\src\licensedcode\data\rules\python_2.yml", "YAML", 0, 0, 0, 3, 0, 0, 1, 4
"d:\IDEWORK\lvmen\src\licensedcode\data\rules\python_20.yml", "YAML", 0, 0, 0, 4, 0, 0, 1, 5
"d:\IDEWORK\lvmen\src\licensedcode\data\rules\python_2001.yml", "YAML", 0, 0, 0, 14, 0, 0, 1, 15
"d:\IDEWORK\lvmen\src\licensedcode\data\rules\python_2002.yml", "YAML", 0, 0, 0, 18, 0, 0, 1, 19
"d:\IDEWORK\lvmen\src\licensedcode\data\rules\python_2003.yml", "YAML", 0, 0, 0, 18, 0, 0, 1, 19
"d:\IDEWORK\lvmen\src\licensedcode\data\rules\python_2009.yml", "YAML", 0, 0, 0, 18, 0, 0, 1, 19
"d:\IDEWORK\lvmen\src\licensedcode\data\rules\python_2014.yml", "YAML", 0, 0, 0, 18, 0, 0, 1, 19
"d:\IDEWORK\lvmen\src\licensedcode\data\rules\python_2018.yml", "YAML", 0, 0, 0, 17, 0, 0, 1, 18
"d:\IDEWORK\lvmen\src\licensedcode\data\rules\python_2019.yml", "YAML", 0, 0, 0, 13, 0, 0, 1, 14
"d:\IDEWORK\lvmen\src\licensedcode\data\rules\python_21.yml", "YAML", 0, 0, 0, 4, 0, 0, 1, 5
"d:\IDEWORK\lvmen\src\licensedcode\data\rules\python_22.yml", "YAML", 0, 0, 0, 6, 0, 0, 1, 7
"d:\IDEWORK\lvmen\src\licensedcode\data\rules\python_23.yml", "YAML", 0, 0, 0, 2, 0, 0, 1, 3
"d:\IDEWORK\lvmen\src\licensedcode\data\rules\python_24.yml", "YAML", 0, 0, 0, 4, 0, 0, 1, 5
"d:\IDEWORK\lvmen\src\licensedcode\data\rules\python_25.yml", "YAML", 0, 0, 0, 5, 0, 0, 1, 6
"d:\IDEWORK\lvmen\src\licensedcode\data\rules\python_26.yml", "YAML", 0, 0, 0, 3, 0, 0, 1, 4
"d:\IDEWORK\lvmen\src\licensedcode\data\rules\python_27.yml", "YAML", 0, 0, 0, 5, 0, 0, 1, 6
"d:\IDEWORK\lvmen\src\licensedcode\data\rules\python_28.yml", "YAML", 0, 0, 0, 3, 0, 0, 1, 4
"d:\IDEWORK\lvmen\src\licensedcode\data\rules\python_29.yml", "YAML", 0, 0, 0, 5, 0, 0, 1, 6
"d:\IDEWORK\lvmen\src\licensedcode\data\rules\python_3.yml", "YAML", 0, 0, 0, 3, 0, 0, 1, 4
"d:\IDEWORK\lvmen\src\licensedcode\data\rules\python_30.yml", "YAML", 0, 0, 0, 6, 0, 0, 1, 7
"d:\IDEWORK\lvmen\src\licensedcode\data\rules\python_31.yml", "YAML", 0, 0, 0, 3, 0, 0, 1, 4
"d:\IDEWORK\lvmen\src\licensedcode\data\rules\python_32.yml", "YAML", 0, 0, 0, 3, 0, 0, 1, 4
"d:\IDEWORK\lvmen\src\licensedcode\data\rules\python_33.yml", "YAML", 0, 0, 0, 3, 0, 0, 1, 4
"d:\IDEWORK\lvmen\src\licensedcode\data\rules\python_34.yml", "YAML", 0, 0, 0, 3, 0, 0, 1, 4
"d:\IDEWORK\lvmen\src\licensedcode\data\rules\python_35.yml", "YAML", 0, 0, 0, 3, 0, 0, 1, 4
"d:\IDEWORK\lvmen\src\licensedcode\data\rules\python_36.yml", "YAML", 0, 0, 0, 5, 0, 0, 1, 6
"d:\IDEWORK\lvmen\src\licensedcode\data\rules\python_37.yml", "YAML", 0, 0, 0, 5, 0, 0, 1, 6
"d:\IDEWORK\lvmen\src\licensedcode\data\rules\python_38.yml", "YAML", 0, 0, 0, 9, 0, 0, 1, 10
"d:\IDEWORK\lvmen\src\licensedcode\data\rules\python_39.yml", "YAML", 0, 0, 0, 7, 0, 0, 1, 8
"d:\IDEWORK\lvmen\src\licensedcode\data\rules\python_4.yml", "YAML", 0, 0, 0, 4, 0, 0, 1, 5
"d:\IDEWORK\lvmen\src\licensedcode\data\rules\python_40.yml", "YAML", 0, 0, 0, 20, 0, 0, 1, 21
"d:\IDEWORK\lvmen\src\licensedcode\data\rules\python_41.yml", "YAML", 0, 0, 0, 19, 0, 0, 1, 20
"d:\IDEWORK\lvmen\src\licensedcode\data\rules\python_42.yml", "YAML", 0, 0, 0, 5, 0, 0, 1, 6
"d:\IDEWORK\lvmen\src\licensedcode\data\rules\python_43.yml", "YAML", 0, 0, 0, 19, 0, 0, 1, 20
"d:\IDEWORK\lvmen\src\licensedcode\data\rules\python_44.yml", "YAML", 0, 0, 0, 3, 0, 0, 1, 4
"d:\IDEWORK\lvmen\src\licensedcode\data\rules\python_45.yml", "YAML", 0, 0, 0, 3, 0, 0, 1, 4
"d:\IDEWORK\lvmen\src\licensedcode\data\rules\python_46.yml", "YAML", 0, 0, 0, 3, 0, 0, 1, 4
"d:\IDEWORK\lvmen\src\licensedcode\data\rules\python_47.yml", "YAML", 0, 0, 0, 5, 0, 0, 1, 6
"d:\IDEWORK\lvmen\src\licensedcode\data\rules\python_48.yml", "YAML", 0, 0, 0, 5, 0, 0, 1, 6
"d:\IDEWORK\lvmen\src\licensedcode\data\rules\python_49.yml", "YAML", 0, 0, 0, 5, 0, 0, 1, 6
"d:\IDEWORK\lvmen\src\licensedcode\data\rules\python_5.yml", "YAML", 0, 0, 0, 5, 0, 0, 1, 6
"d:\IDEWORK\lvmen\src\licensedcode\data\rules\python_50.yml", "YAML", 0, 0, 0, 5, 0, 0, 1, 6
"d:\IDEWORK\lvmen\src\licensedcode\data\rules\python_51.yml", "YAML", 0, 0, 0, 3, 0, 0, 1, 4
"d:\IDEWORK\lvmen\src\licensedcode\data\rules\python_52.yml", "YAML", 0, 0, 0, 5, 0, 0, 1, 6
"d:\IDEWORK\lvmen\src\licensedcode\data\rules\python_53.yml", "YAML", 0, 0, 0, 5, 0, 0, 1, 6
"d:\IDEWORK\lvmen\src\licensedcode\data\rules\python_54.yml", "YAML", 0, 0, 0, 5, 0, 0, 1, 6
"d:\IDEWORK\lvmen\src\licensedcode\data\rules\python_55.yml", "YAML", 0, 0, 0, 5, 0, 0, 1, 6
"d:\IDEWORK\lvmen\src\licensedcode\data\rules\python_56.yml", "YAML", 0, 0, 0, 5, 0, 0, 1, 6
"d:\IDEWORK\lvmen\src\licensedcode\data\rules\python_57.yml", "YAML", 0, 0, 0, 5, 0, 0, 1, 6
"d:\IDEWORK\lvmen\src\licensedcode\data\rules\python_58.yml", "YAML", 0, 0, 0, 3, 0, 0, 1, 4
"d:\IDEWORK\lvmen\src\licensedcode\data\rules\python_59.yml", "YAML", 0, 0, 0, 6, 0, 0, 1, 7
"d:\IDEWORK\lvmen\src\licensedcode\data\rules\python_6.yml", "YAML", 0, 0, 0, 9, 0, 0, 1, 10
"d:\IDEWORK\lvmen\src\licensedcode\data\rules\python_60.yml", "YAML", 0, 0, 0, 6, 0, 0, 1, 7
"d:\IDEWORK\lvmen\src\licensedcode\data\rules\python_61.yml", "YAML", 0, 0, 0, 6, 0, 0, 1, 7
"d:\IDEWORK\lvmen\src\licensedcode\data\rules\python_62.yml", "YAML", 0, 0, 0, 3, 0, 0, 1, 4
"d:\IDEWORK\lvmen\src\licensedcode\data\rules\python_63.yml", "YAML", 0, 0, 0, 4, 0, 0, 1, 5
"d:\IDEWORK\lvmen\src\licensedcode\data\rules\python_64.yml", "YAML", 0, 0, 0, 3, 0, 0, 1, 4
"d:\IDEWORK\lvmen\src\licensedcode\data\rules\python_65.yml", "YAML", 0, 0, 0, 3, 0, 0, 1, 4
"d:\IDEWORK\lvmen\src\licensedcode\data\rules\python_66.yml", "YAML", 0, 0, 0, 3, 0, 0, 1, 4
"d:\IDEWORK\lvmen\src\licensedcode\data\rules\python_67.yml", "YAML", 0, 0, 0, 3, 0, 0, 1, 4
"d:\IDEWORK\lvmen\src\licensedcode\data\rules\python_68.yml", "YAML", 0, 0, 0, 20, 0, 0, 1, 21
"d:\IDEWORK\lvmen\src\licensedcode\data\rules\python_69.yml", "YAML", 0, 0, 0, 21, 0, 0, 1, 22
"d:\IDEWORK\lvmen\src\licensedcode\data\rules\python_6_docutils.yml", "YAML", 0, 0, 0, 8, 0, 0, 1, 9
"d:\IDEWORK\lvmen\src\licensedcode\data\rules\python_7.yml", "YAML", 0, 0, 0, 5, 0, 0, 1, 6
"d:\IDEWORK\lvmen\src\licensedcode\data\rules\python_70.yml", "YAML", 0, 0, 0, 20, 0, 0, 1, 21
"d:\IDEWORK\lvmen\src\licensedcode\data\rules\python_71.yml", "YAML", 0, 0, 0, 17, 0, 0, 1, 18
"d:\IDEWORK\lvmen\src\licensedcode\data\rules\python_72.yml", "YAML", 0, 0, 0, 5, 0, 0, 1, 6
"d:\IDEWORK\lvmen\src\licensedcode\data\rules\python_73.yml", "YAML", 0, 0, 0, 5, 0, 0, 1, 6
"d:\IDEWORK\lvmen\src\licensedcode\data\rules\python_74.yml", "YAML", 0, 0, 0, 3, 0, 0, 1, 4
"d:\IDEWORK\lvmen\src\licensedcode\data\rules\python_8.yml", "YAML", 0, 0, 0, 6, 0, 0, 1, 7
"d:\IDEWORK\lvmen\src\licensedcode\data\rules\python_9.yml", "YAML", 0, 0, 0, 4, 0, 0, 1, 5
"d:\IDEWORK\lvmen\src\licensedcode\data\rules\python_and_other-permissive_1.yml", "YAML", 0, 0, 0, 3, 0, 0, 1, 4
"d:\IDEWORK\lvmen\src\licensedcode\data\rules\python_docutils.yml", "YAML", 0, 0, 0, 3, 0, 0, 1, 4
"d:\IDEWORK\lvmen\src\licensedcode\data\rules\python_not_not-a-license_269.yml", "YAML", 0, 0, 0, 6, 0, 0, 1, 7
"d:\IDEWORK\lvmen\src\licensedcode\data\rules\python_not_not-a-license_270.yml", "YAML", 0, 0, 0, 6, 0, 0, 1, 7
"d:\IDEWORK\lvmen\src\licensedcode\data\rules\python_or_gpl-2.0.yml", "YAML", 0, 0, 0, 2, 0, 0, 1, 3
"d:\IDEWORK\lvmen\src\licensedcode\data\rules\python_url_1.yml", "YAML", 0, 0, 0, 5, 0, 0, 1, 6
"d:\IDEWORK\lvmen\src\licensedcode\data\rules\python_url_2.yml", "YAML", 0, 0, 0, 5, 0, 0, 1, 6
"d:\IDEWORK\lvmen\src\licensedcode\data\rules\python_url_glc_225.yml", "YAML", 0, 0, 0, 5, 0, 0, 1, 6
"d:\IDEWORK\lvmen\src\licensedcode\data\rules\qhull_url_1.yml", "YAML", 0, 0, 0, 5, 0, 0, 1, 6
"d:\IDEWORK\lvmen\src\licensedcode\data\rules\qhull_url_2.yml", "YAML", 0, 0, 0, 5, 0, 0, 1, 6
"d:\IDEWORK\lvmen\src\licensedcode\data\rules\qpl-1.0.SPDX.yml", "YAML", 0, 0, 0, 8, 0, 0, 1, 9
"d:\IDEWORK\lvmen\src\licensedcode\data\rules\qpl-1.0.yml", "YAML", 0, 0, 0, 5, 0, 0, 1, 6
"d:\IDEWORK\lvmen\src\licensedcode\data\rules\qpl-1.0_1.yml", "YAML", 0, 0, 0, 5, 0, 0, 1, 6
"d:\IDEWORK\lvmen\src\licensedcode\data\rules\qpl-1.0_2.yml", "YAML", 0, 0, 0, 3, 0, 0, 1, 4
"d:\IDEWORK\lvmen\src\licensedcode\data\rules\qpl-1.0_3.yml", "YAML", 0, 0, 0, 5, 0, 0, 1, 6
"d:\IDEWORK\lvmen\src\licensedcode\data\rules\qpl-1.0_4.yml", "YAML", 0, 0, 0, 5, 0, 0, 1, 6
"d:\IDEWORK\lvmen\src\licensedcode\data\rules\qpl-1.0_5.yml", "YAML", 0, 0, 0, 4, 0, 0, 1, 5
"d:\IDEWORK\lvmen\src\licensedcode\data\rules\qpl-1.0_6.yml", "YAML", 0, 0, 0, 2, 0, 0, 1, 3
"d:\IDEWORK\lvmen\src\licensedcode\data\rules\qpl-1.0_7.yml", "YAML", 0, 0, 0, 3, 0, 0, 1, 4
"d:\IDEWORK\lvmen\src\licensedcode\data\rules\qpl-1.0_or_commercial-license_1.yml", "YAML", 0, 0, 0, 3, 0, 0, 1, 4
"d:\IDEWORK\lvmen\src\licensedcode\data\rules\qpl-1.0_or_commercial-license_2.yml", "YAML", 0, 0, 0, 3, 0, 0, 1, 4
"d:\IDEWORK\lvmen\src\licensedcode\data\rules\qpl-1.0_or_commercial-license_4.yml", "YAML", 0, 0, 0, 3, 0, 0, 1, 4
"d:\IDEWORK\lvmen\src\licensedcode\data\rules\qpl-1.0_url_1.yml", "YAML", 0, 0, 0, 5, 0, 0, 1, 6
"d:\IDEWORK\lvmen\src\licensedcode\data\rules\qpl-1.0_url_2.yml", "YAML", 0, 0, 0, 5, 0, 0, 1, 6
"d:\IDEWORK\lvmen\src\licensedcode\data\rules\qpl-1.0_url_glc_226.yml", "YAML", 0, 0, 0, 5, 0, 0, 1, 6
"d:\IDEWORK\lvmen\src\licensedcode\data\rules\qpl-1.0_url_glc_227.yml", "YAML", 0, 0, 0, 5, 0, 0, 1, 6
"d:\IDEWORK\lvmen\src\licensedcode\data\rules\qt-commercial-1.1_or_lgpl-2.1_with_qt-company-exception-lgpl-2.1_or_lgpl-3.0_with_qt-company-exception-lgpl-2.1_1.yml", "YAML", 0, 0, 0, 10, 0, 0, 1, 11
"d:\IDEWORK\lvmen\src\licensedcode\data\rules\qt-company-exception-lgpl-2.1_1.yml", "YAML", 0, 0, 0, 2, 0, 0, 1, 3
"d:\IDEWORK\lvmen\src\licensedcode\data\rules\qt-exception-lgpl-2.1_3.yml", "YAML", 0, 0, 0, 2, 0, 0, 1, 3
"d:\IDEWORK\lvmen\src\licensedcode\data\rules\qt-gpl-exception-1.0_url_1.yml", "YAML", 0, 0, 0, 5, 0, 0, 1, 6
"d:\IDEWORK\lvmen\src\licensedcode\data\rules\qt-gpl-exception-1.0_url_2.yml", "YAML", 0, 0, 0, 5, 0, 0, 1, 6
"d:\IDEWORK\lvmen\src\licensedcode\data\rules\qt-kde-linking-exception_1.yml", "YAML", 0, 0, 0, 2, 0, 0, 1, 3
"d:\IDEWORK\lvmen\src\licensedcode\data\rules\qt-kde-linking-exception_2.yml", "YAML", 0, 0, 0, 3, 0, 0, 1, 4
"d:\IDEWORK\lvmen\src\licensedcode\data\rules\qt-kde-linking-exception_3.yml", "YAML", 0, 0, 0, 3, 0, 0, 1, 4
"d:\IDEWORK\lvmen\src\licensedcode\data\rules\qt-lgpl-exception-1.1_1.yml", "YAML", 0, 0, 0, 2, 0, 0, 1, 3
"d:\IDEWORK\lvmen\src\licensedcode\data\rules\qt-lgpl-exception-1.1_2.yml", "YAML", 0, 0, 0, 2, 0, 0, 1, 3
"d:\IDEWORK\lvmen\src\licensedcode\data\rules\qt-lgpl-exception-1.1_4.yml", "YAML", 0, 0, 0, 2, 0, 0, 1, 3
"d:\IDEWORK\lvmen\src\licensedcode\data\rules\qt-lgpl-exception-1.1_url_1.yml", "YAML", 0, 0, 0, 5, 0, 0, 1, 6
"d:\IDEWORK\lvmen\src\licensedcode\data\rules\qt-lgpl-exception-1.1_url_2.yml", "YAML", 0, 0, 0, 5, 0, 0, 1, 6
"d:\IDEWORK\lvmen\src\licensedcode\data\rules\qt_digia_quad_gpl3.yml", "YAML", 0, 0, 0, 8, 0, 0, 1, 9
"d:\IDEWORK\lvmen\src\licensedcode\data\rules\qt_digia_quad_gpl3_1.yml", "YAML", 0, 0, 0, 8, 0, 0, 1, 9
"d:\IDEWORK\lvmen\src\licensedcode\data\rules\qt_digia_quad_gpl3_2.yml", "YAML", 0, 0, 0, 10, 0, 0, 1, 11
"d:\IDEWORK\lvmen\src\licensedcode\data\rules\qt_digia_quad_lgpl.yml", "YAML", 0, 0, 0, 8, 0, 0, 1, 9
"d:\IDEWORK\lvmen\src\licensedcode\data\rules\qt_digia_quad_lgpl2.yml", "YAML", 0, 0, 0, 8, 0, 0, 1, 9
"d:\IDEWORK\lvmen\src\licensedcode\data\rules\qt_digia_quad_lgpl3.yml", "YAML", 0, 0, 0, 9, 0, 0, 1, 10
"d:\IDEWORK\lvmen\src\licensedcode\data\rules\qt_digia_tri_gpl2.yml", "YAML", 0, 0, 0, 8, 0, 0, 1, 9
"d:\IDEWORK\lvmen\src\licensedcode\data\rules\quicktime.yml", "YAML", 0, 0, 0, 5, 0, 0, 1, 6
"d:\IDEWORK\lvmen\src\licensedcode\data\rules\quirksmode.yml", "YAML", 0, 0, 0, 5, 0, 0, 1, 6
"d:\IDEWORK\lvmen\src\licensedcode\data\rules\qwt-exception-1.0_url_1.yml", "YAML", 0, 0, 0, 5, 0, 0, 1, 6
"d:\IDEWORK\lvmen\src\licensedcode\data\rules\qwt-exception-1.0_url_2.yml", "YAML", 0, 0, 0, 5, 0, 0, 1, 6
"d:\IDEWORK\lvmen\src\licensedcode\data\rules\radvd.yml", "YAML", 0, 0, 0, 5, 0, 0, 1, 6
"d:\IDEWORK\lvmen\src\licensedcode\data\rules\radvd_1.yml", "YAML", 0, 0, 0, 5, 0, 0, 1, 6
"d:\IDEWORK\lvmen\src\licensedcode\data\rules\ralink-firmware_1.yml", "YAML", 0, 0, 0, 3, 0, 0, 1, 4
"d:\IDEWORK\lvmen\src\licensedcode\data\rules\ralink-firmware_2.yml", "YAML", 0, 0, 0, 3, 0, 0, 1, 4
"d:\IDEWORK\lvmen\src\licensedcode\data\rules\rcsl-2.0.yml", "YAML", 0, 0, 0, 5, 0, 0, 1, 6
"d:\IDEWORK\lvmen\src\licensedcode\data\rules\rdisc_url_1.yml", "YAML", 0, 0, 0, 5, 0, 0, 1, 6
"d:\IDEWORK\lvmen\src\licensedcode\data\rules\rdisc_url_2.yml", "YAML", 0, 0, 0, 5, 0, 0, 1, 6
"d:\IDEWORK\lvmen\src\licensedcode\data\rules\redhat_logos.yml", "YAML", 0, 0, 0, 2, 0, 0, 1, 3
"d:\IDEWORK\lvmen\src\licensedcode\data\rules\redis-source-available-1.0_1.yml", "YAML", 0, 0, 0, 5, 0, 0, 1, 6
"d:\IDEWORK\lvmen\src\licensedcode\data\rules\redis-source-available-1.0_2.yml", "YAML", 0, 0, 0, 3, 0, 0, 1, 4
"d:\IDEWORK\lvmen\src\licensedcode\data\rules\redis-source-available-1.0_3.yml", "YAML", 0, 0, 0, 5, 0, 0, 1, 6
"d:\IDEWORK\lvmen\src\licensedcode\data\rules\redis-source-available-1.0_4.yml", "YAML", 0, 0, 0, 3, 0, 0, 1, 4
"d:\IDEWORK\lvmen\src\licensedcode\data\rules\redis-source-available-1.0_5.yml", "YAML", 0, 0, 0, 3, 0, 0, 1, 4
"d:\IDEWORK\lvmen\src\licensedcode\data\rules\redis-source-available-1.0_6.yml", "YAML", 0, 0, 0, 3, 0, 0, 1, 4
"d:\IDEWORK\lvmen\src\licensedcode\data\rules\redis-source-available-1.0_7.yml", "YAML", 0, 0, 0, 3, 0, 0, 1, 4
"d:\IDEWORK\lvmen\src\licensedcode\data\rules\redis-source-available-1.0_8.yml", "YAML", 0, 0, 0, 3, 0, 0, 1, 4
"d:\IDEWORK\lvmen\src\licensedcode\data\rules\regexp_url_1.yml", "YAML", 0, 0, 0, 5, 0, 0, 1, 6
"d:\IDEWORK\lvmen\src\licensedcode\data\rules\regexp_url_2.yml", "YAML", 0, 0, 0, 5, 0, 0, 1, 6
"d:\IDEWORK\lvmen\src\licensedcode\data\rules\reportbug_1.yml", "YAML", 0, 0, 0, 3, 0, 0, 1, 4
"d:\IDEWORK\lvmen\src\licensedcode\data\rules\repoze_1.yml", "YAML", 0, 0, 0, 2, 0, 0, 1, 3
"d:\IDEWORK\lvmen\src\licensedcode\data\rules\repoze_10.yml", "YAML", 0, 0, 0, 5, 0, 0, 1, 6
"d:\IDEWORK\lvmen\src\licensedcode\data\rules\repoze_11.yml", "YAML", 0, 0, 0, 5, 0, 0, 1, 6
"d:\IDEWORK\lvmen\src\licensedcode\data\rules\repoze_12.yml", "YAML", 0, 0, 0, 5, 0, 0, 1, 6
"d:\IDEWORK\lvmen\src\licensedcode\data\rules\repoze_13.yml", "YAML", 0, 0, 0, 5, 0, 0, 1, 6
"d:\IDEWORK\lvmen\src\licensedcode\data\rules\repoze_14.yml", "YAML", 0, 0, 0, 3, 0, 0, 1, 4
"d:\IDEWORK\lvmen\src\licensedcode\data\rules\repoze_2.yml", "YAML", 0, 0, 0, 5, 0, 0, 1, 6
"d:\IDEWORK\lvmen\src\licensedcode\data\rules\repoze_3.yml", "YAML", 0, 0, 0, 5, 0, 0, 1, 6
"d:\IDEWORK\lvmen\src\licensedcode\data\rules\repoze_4.yml", "YAML", 0, 0, 0, 2, 0, 0, 1, 3
"d:\IDEWORK\lvmen\src\licensedcode\data\rules\repoze_5.yml", "YAML", 0, 0, 0, 2, 0, 0, 1, 3
"d:\IDEWORK\lvmen\src\licensedcode\data\rules\repoze_6.yml", "YAML", 0, 0, 0, 3, 0, 0, 1, 4
"d:\IDEWORK\lvmen\src\licensedcode\data\rules\repoze_7.yml", "YAML", 0, 0, 0, 5, 0, 0, 1, 6
"d:\IDEWORK\lvmen\src\licensedcode\data\rules\repoze_8.yml", "YAML", 0, 0, 0, 3, 0, 0, 1, 4
"d:\IDEWORK\lvmen\src\licensedcode\data\rules\repoze_9.yml", "YAML", 0, 0, 0, 3, 0, 0, 1, 4
"d:\IDEWORK\lvmen\src\licensedcode\data\rules\ricoh-1.0.SPDX.yml", "YAML", 0, 0, 0, 10, 0, 0, 1, 11
"d:\IDEWORK\lvmen\src\licensedcode\data\rules\ricoh-1.0.yml", "YAML", 0, 0, 0, 5, 0, 0, 1, 6
"d:\IDEWORK\lvmen\src\licensedcode\data\rules\ricoh-1.0_1.yml", "YAML", 0, 0, 0, 3, 0, 0, 1, 4
"d:\IDEWORK\lvmen\src\licensedcode\data\rules\ricoh-1.0_2.yml", "YAML", 0, 0, 0, 4, 0, 0, 1, 5
"d:\IDEWORK\lvmen\src\licensedcode\data\rules\ricoh-1.0_3.yml", "YAML", 0, 0, 0, 5, 0, 0, 1, 6
"d:\IDEWORK\lvmen\src\licensedcode\data\rules\ricoh-1.0_url_1.yml", "YAML", 0, 0, 0, 5, 0, 0, 1, 6
"d:\IDEWORK\lvmen\src\licensedcode\data\rules\ricoh-1.0_url_2.yml", "YAML", 0, 0, 0, 5, 0, 0, 1, 6
"d:\IDEWORK\lvmen\src\licensedcode\data\rules\ricoh-1.0_url_glc_232.yml", "YAML", 0, 0, 0, 5, 0, 0, 1, 6
"d:\IDEWORK\lvmen\src\licensedcode\data\rules\ricoh-1.0_url_glc_233.yml", "YAML", 0, 0, 0, 5, 0, 0, 1, 6
"d:\IDEWORK\lvmen\src\licensedcode\data\rules\riverbank-sip_or_gpl-2.0_or_gpl-3.0_1.yml", "YAML", 0, 0, 0, 7, 0, 0, 1, 8
"d:\IDEWORK\lvmen\src\licensedcode\data\rules\riverbank-sip_or_gpl-2.0_or_gpl-3.0_2.yml", "YAML", 0, 0, 0, 7, 0, 0, 1, 8
"d:\IDEWORK\lvmen\src\licensedcode\data\rules\rogue-wave.yml", "YAML", 0, 0, 0, 5, 0, 0, 1, 6
"d:\IDEWORK\lvmen\src\licensedcode\data\rules\rpl-1.1_url_1.yml", "YAML", 0, 0, 0, 5, 0, 0, 1, 6
"d:\IDEWORK\lvmen\src\licensedcode\data\rules\rpl-1.1_url_2.yml", "YAML", 0, 0, 0, 5, 0, 0, 1, 6
"d:\IDEWORK\lvmen\src\licensedcode\data\rules\rpl-1.1_url_glc_106.yml", "YAML", 0, 0, 0, 5, 0, 0, 1, 6
"d:\IDEWORK\lvmen\src\licensedcode\data\rules\rpl-1.1_url_glc_107.yml", "YAML", 0, 0, 0, 5, 0, 0, 1, 6
"d:\IDEWORK\lvmen\src\licensedcode\data\rules\rpl-1.5.SPDX.yml", "YAML", 0, 0, 0, 8, 0, 0, 1, 9
"d:\IDEWORK\lvmen\src\licensedcode\data\rules\rpl-1.5.yml", "YAML", 0, 0, 0, 5, 0, 0, 1, 6
"d:\IDEWORK\lvmen\src\licensedcode\data\rules\rpl-1.5_1.yml", "YAML", 0, 0, 0, 2, 0, 0, 1, 3
"d:\IDEWORK\lvmen\src\licensedcode\data\rules\rpl-1.5_2.yml", "YAML", 0, 0, 0, 5, 0, 0, 1, 6
"d:\IDEWORK\lvmen\src\licensedcode\data\rules\rpl-1.5_3.yml", "YAML", 0, 0, 0, 3, 0, 0, 1, 4
"d:\IDEWORK\lvmen\src\licensedcode\data\rules\rpl-1.5_url_1.yml", "YAML", 0, 0, 0, 5, 0, 0, 1, 6
"d:\IDEWORK\lvmen\src\licensedcode\data\rules\rpl-1.5_url_2.yml", "YAML", 0, 0, 0, 5, 0, 0, 1, 6
"d:\IDEWORK\lvmen\src\licensedcode\data\rules\rpl-1.5_url_glc_228.yml", "YAML", 0, 0, 0, 5, 0, 0, 1, 6
"d:\IDEWORK\lvmen\src\licensedcode\data\rules\rpl-1.5_url_glc_229.yml", "YAML", 0, 0, 0, 5, 0, 0, 1, 6
"d:\IDEWORK\lvmen\src\licensedcode\data\rules\rpsl-1.0.SPDX.yml", "YAML", 0, 0, 0, 15, 0, 0, 1, 16
"d:\IDEWORK\lvmen\src\licensedcode\data\rules\rpsl-1.0.yml", "YAML", 0, 0, 0, 3, 0, 0, 1, 4
"d:\IDEWORK\lvmen\src\licensedcode\data\rules\rpsl-1.0_1.yml", "YAML", 0, 0, 0, 13, 0, 0, 1, 14
"d:\IDEWORK\lvmen\src\licensedcode\data\rules\rpsl-1.0_10.yml", "YAML", 0, 0, 0, 13, 0, 0, 1, 14
"d:\IDEWORK\lvmen\src\licensedcode\data\rules\rpsl-1.0_11.yml", "YAML", 0, 0, 0, 10, 0, 0, 1, 11
"d:\IDEWORK\lvmen\src\licensedcode\data\rules\rpsl-1.0_2.yml", "YAML", 0, 0, 0, 13, 0, 0, 1, 14
"d:\IDEWORK\lvmen\src\licensedcode\data\rules\rpsl-1.0_3.yml", "YAML", 0, 0, 0, 5, 0, 0, 1, 6
"d:\IDEWORK\lvmen\src\licensedcode\data\rules\rpsl-1.0_4.yml", "YAML", 0, 0, 0, 14, 0, 0, 1, 15
"d:\IDEWORK\lvmen\src\licensedcode\data\rules\rpsl-1.0_5.yml", "YAML", 0, 0, 0, 9, 0, 0, 1, 10
"d:\IDEWORK\lvmen\src\licensedcode\data\rules\rpsl-1.0_6.yml", "YAML", 0, 0, 0, 14, 0, 0, 1, 15
"d:\IDEWORK\lvmen\src\licensedcode\data\rules\rpsl-1.0_7.yml", "YAML", 0, 0, 0, 14, 0, 0, 1, 15
"d:\IDEWORK\lvmen\src\licensedcode\data\rules\rpsl-1.0_8.yml", "YAML", 0, 0, 0, 5, 0, 0, 1, 6
"d:\IDEWORK\lvmen\src\licensedcode\data\rules\rpsl-1.0_9.yml", "YAML", 0, 0, 0, 5, 0, 0, 1, 6
"d:\IDEWORK\lvmen\src\licensedcode\data\rules\rpsl-1.0_url_1.yml", "YAML", 0, 0, 0, 5, 0, 0, 1, 6
"d:\IDEWORK\lvmen\src\licensedcode\data\rules\rpsl-1.0_url_2.yml", "YAML", 0, 0, 0, 5, 0, 0, 1, 6
"d:\IDEWORK\lvmen\src\licensedcode\data\rules\rpsl-1.0_url_glc_230.yml", "YAML", 0, 0, 0, 5, 0, 0, 1, 6
"d:\IDEWORK\lvmen\src\licensedcode\data\rules\rpsl-1.0_url_glc_231.yml", "YAML", 0, 0, 0, 5, 0, 0, 1, 6
"d:\IDEWORK\lvmen\src\licensedcode\data\rules\rsa-cryptoki.yml", "YAML", 0, 0, 0, 5, 0, 0, 1, 6
"d:\IDEWORK\lvmen\src\licensedcode\data\rules\rsa-md5_1.yml", "YAML", 0, 0, 0, 3, 0, 0, 1, 4
"d:\IDEWORK\lvmen\src\licensedcode\data\rules\rsa-md5_2.yml", "YAML", 0, 0, 0, 4, 0, 0, 1, 5
"d:\IDEWORK\lvmen\src\licensedcode\data\rules\rsa-md5_and_apache-2.0.yml", "YAML", 0, 0, 0, 2, 0, 0, 1, 3
"d:\IDEWORK\lvmen\src\licensedcode\data\rules\rsa-md5_url_1.yml", "YAML", 0, 0, 0, 5, 0, 0, 1, 6
"d:\IDEWORK\lvmen\src\licensedcode\data\rules\rsa-md5_url_2.yml", "YAML", 0, 0, 0, 5, 0, 0, 1, 6
"d:\IDEWORK\lvmen\src\licensedcode\data\rules\ruby-1999.yml", "YAML", 0, 0, 0, 3, 0, 0, 1, 4
"d:\IDEWORK\lvmen\src\licensedcode\data\rules\ruby-1999_or_gpl.yml", "YAML", 0, 0, 0, 9, 0, 0, 1, 10
"d:\IDEWORK\lvmen\src\licensedcode\data\rules\ruby-2001-07-11.yml", "YAML", 0, 0, 0, 11, 0, 0, 1, 12
"d:\IDEWORK\lvmen\src\licensedcode\data\rules\ruby-2001-07-11_or_gpl.yml", "YAML", 0, 0, 0, 15, 0, 0, 1, 16
"d:\IDEWORK\lvmen\src\licensedcode\data\rules\ruby-2001-07-13.yml", "YAML", 0, 0, 0, 13, 0, 0, 1, 14
"d:\IDEWORK\lvmen\src\licensedcode\data\rules\ruby-2001-07-13_or_gpl.yml", "YAML", 0, 0, 0, 17, 0, 0, 1, 18
"d:\IDEWORK\lvmen\src\licensedcode\data\rules\ruby-2001-09-08_or_gpl.yml", "YAML", 0, 0, 0, 9, 0, 0, 1, 10
"d:\IDEWORK\lvmen\src\licensedcode\data\rules\ruby-2002-02-21.yml", "YAML", 0, 0, 0, 4, 0, 0, 1, 5
"d:\IDEWORK\lvmen\src\licensedcode\data\rules\ruby-2002-02-21_or_gpl.yml", "YAML", 0, 0, 0, 10, 0, 0, 1, 11
"d:\IDEWORK\lvmen\src\licensedcode\data\rules\ruby-2002-02-25-1.8.0_or_gpl.yml", "YAML", 0, 0, 0, 7, 0, 0, 1, 8
"d:\IDEWORK\lvmen\src\licensedcode\data\rules\ruby-2006-06-09_or_gpl2.yml", "YAML", 0, 0, 0, 9, 0, 0, 1, 10
"d:\IDEWORK\lvmen\src\licensedcode\data\rules\ruby-2010-09-15_or_bsd.yml", "YAML", 0, 0, 0, 6, 0, 0, 1, 7
"d:\IDEWORK\lvmen\src\licensedcode\data\rules\ruby.yml", "YAML", 0, 0, 0, 3, 0, 0, 1, 4
"d:\IDEWORK\lvmen\src\licensedcode\data\rules\ruby_1.yml", "YAML", 0, 0, 0, 5, 0, 0, 1, 6
"d:\IDEWORK\lvmen\src\licensedcode\data\rules\ruby_10.yml", "YAML", 0, 0, 0, 3, 0, 0, 1, 4
"d:\IDEWORK\lvmen\src\licensedcode\data\rules\ruby_11.yml", "YAML", 0, 0, 0, 3, 0, 0, 1, 4
"d:\IDEWORK\lvmen\src\licensedcode\data\rules\ruby_12.yml", "YAML", 0, 0, 0, 5, 0, 0, 1, 6
"d:\IDEWORK\lvmen\src\licensedcode\data\rules\ruby_13.yml", "YAML", 0, 0, 0, 3, 0, 0, 1, 4
"d:\IDEWORK\lvmen\src\licensedcode\data\rules\ruby_14.yml", "YAML", 0, 0, 0, 3, 0, 0, 1, 4
"d:\IDEWORK\lvmen\src\licensedcode\data\rules\ruby_15.yml", "YAML", 0, 0, 0, 3, 0, 0, 1, 4
"d:\IDEWORK\lvmen\src\licensedcode\data\rules\ruby_16.yml", "YAML", 0, 0, 0, 5, 0, 0, 1, 6
"d:\IDEWORK\lvmen\src\licensedcode\data\rules\ruby_17.yml", "YAML", 0, 0, 0, 5, 0, 0, 1, 6
"d:\IDEWORK\lvmen\src\licensedcode\data\rules\ruby_18.yml", "YAML", 0, 0, 0, 5, 0, 0, 1, 6
"d:\IDEWORK\lvmen\src\licensedcode\data\rules\ruby_19.yml", "YAML", 0, 0, 0, 3, 0, 0, 1, 4
"d:\IDEWORK\lvmen\src\licensedcode\data\rules\ruby_2.yml", "YAML", 0, 0, 0, 3, 0, 0, 1, 4
"d:\IDEWORK\lvmen\src\licensedcode\data\rules\ruby_20.yml", "YAML", 0, 0, 0, 3, 0, 0, 1, 4
"d:\IDEWORK\lvmen\src\licensedcode\data\rules\ruby_21.yml", "YAML", 0, 0, 0, 3, 0, 0, 1, 4
"d:\IDEWORK\lvmen\src\licensedcode\data\rules\ruby_22.yml", "YAML", 0, 0, 0, 3, 0, 0, 1, 4
"d:\IDEWORK\lvmen\src\licensedcode\data\rules\ruby_23.yml", "YAML", 0, 0, 0, 3, 0, 0, 1, 4
"d:\IDEWORK\lvmen\src\licensedcode\data\rules\ruby_3.yml", "YAML", 0, 0, 0, 3, 0, 0, 1, 4
"d:\IDEWORK\lvmen\src\licensedcode\data\rules\ruby_4.yml", "YAML", 0, 0, 0, 4, 0, 0, 1, 5
"d:\IDEWORK\lvmen\src\licensedcode\data\rules\ruby_5.yml", "YAML", 0, 0, 0, 3, 0, 0, 1, 4
"d:\IDEWORK\lvmen\src\licensedcode\data\rules\ruby_6.yml", "YAML", 0, 0, 0, 2, 0, 0, 1, 3
"d:\IDEWORK\lvmen\src\licensedcode\data\rules\ruby_7.yml", "YAML", 0, 0, 0, 2, 0, 0, 1, 3
"d:\IDEWORK\lvmen\src\licensedcode\data\rules\ruby_8.yml", "YAML", 0, 0, 0, 2, 0, 0, 1, 3
"d:\IDEWORK\lvmen\src\licensedcode\data\rules\ruby_9.yml", "YAML", 0, 0, 0, 2, 0, 0, 1, 3
"d:\IDEWORK\lvmen\src\licensedcode\data\rules\ruby_or_bsd-simplified_1.yml", "YAML", 0, 0, 0, 7, 0, 0, 1, 8
"d:\IDEWORK\lvmen\src\licensedcode\data\rules\ruby_or_gpl-2.0-plus.yml", "YAML", 0, 0, 0, 3, 0, 0, 1, 4
"d:\IDEWORK\lvmen\src\licensedcode\data\rules\ruby_or_gpl-2.0_1.yml", "YAML", 0, 0, 0, 4, 0, 0, 1, 5
"d:\IDEWORK\lvmen\src\licensedcode\data\rules\ruby_or_gpl-2.0_or_gpl-3.0.yml", "YAML", 0, 0, 0, 2, 0, 0, 1, 3
"d:\IDEWORK\lvmen\src\licensedcode\data\rules\ruby_or_gpl-2.0_or_gpl-3.0_1.yml", "YAML", 0, 0, 0, 6, 0, 0, 1, 7
"d:\IDEWORK\lvmen\src\licensedcode\data\rules\ruby_or_gpl-2.0_or_gpl-3.0_10.yml", "YAML", 0, 0, 0, 4, 0, 0, 1, 5
"d:\IDEWORK\lvmen\src\licensedcode\data\rules\ruby_or_gpl-2.0_or_gpl-3.0_2.yml", "YAML", 0, 0, 0, 6, 0, 0, 1, 7
"d:\IDEWORK\lvmen\src\licensedcode\data\rules\ruby_or_gpl-2.0_or_gpl-3.0_3.yml", "YAML", 0, 0, 0, 5, 0, 0, 1, 6
"d:\IDEWORK\lvmen\src\licensedcode\data\rules\ruby_or_gpl-2.0_or_gpl-3.0_4.yml", "YAML", 0, 0, 0, 5, 0, 0, 1, 6
"d:\IDEWORK\lvmen\src\licensedcode\data\rules\ruby_or_gpl-2.0_or_gpl-3.0_5.yml", "YAML", 0, 0, 0, 7, 0, 0, 1, 8
"d:\IDEWORK\lvmen\src\licensedcode\data\rules\ruby_or_gpl-2.0_or_gpl-3.0_6.yml", "YAML", 0, 0, 0, 9, 0, 0, 1, 10
"d:\IDEWORK\lvmen\src\licensedcode\data\rules\ruby_or_gpl-2.0_or_gpl-3.0_7.yml", "YAML", 0, 0, 0, 5, 0, 0, 1, 6
"d:\IDEWORK\lvmen\src\licensedcode\data\rules\ruby_or_gpl-2.0_or_gpl-3.0_8.yml", "YAML", 0, 0, 0, 6, 0, 0, 1, 7
"d:\IDEWORK\lvmen\src\licensedcode\data\rules\ruby_or_gpl-2.0_or_gpl-3.0_9.yml", "YAML", 0, 0, 0, 4, 0, 0, 1, 5
"d:\IDEWORK\lvmen\src\licensedcode\data\rules\ruby_or_gpl-3.0_1.yml", "YAML", 0, 0, 0, 3, 0, 0, 1, 4
"d:\IDEWORK\lvmen\src\licensedcode\data\rules\ruby_or_gpl.yml", "YAML", 0, 0, 0, 8, 0, 0, 1, 9
"d:\IDEWORK\lvmen\src\licensedcode\data\rules\ruby_or_gpl_1.yml", "YAML", 0, 0, 0, 4, 0, 0, 1, 5
"d:\IDEWORK\lvmen\src\licensedcode\data\rules\ruby_or_lgpl-3.0-plus_1.yml", "YAML", 0, 0, 0, 5, 0, 0, 1, 6
"d:\IDEWORK\lvmen\src\licensedcode\data\rules\ruby_or_lgpl-3.0-plus_2.yml", "YAML", 0, 0, 0, 3, 0, 0, 1, 4
"d:\IDEWORK\lvmen\src\licensedcode\data\rules\ruby_or_lgpl-3.0-plus_3.yml", "YAML", 0, 0, 0, 5, 0, 0, 1, 6
"d:\IDEWORK\lvmen\src\licensedcode\data\rules\ruby_or_lgpl-3.0-plus_4.yml", "YAML", 0, 0, 0, 6, 0, 0, 1, 7
"d:\IDEWORK\lvmen\src\licensedcode\data\rules\ruby_or_lgpl_1.yml", "YAML", 0, 0, 0, 3, 0, 0, 1, 4
"d:\IDEWORK\lvmen\src\licensedcode\data\rules\ruby_or_lgpl_2.yml", "YAML", 0, 0, 0, 3, 0, 0, 1, 4
"d:\IDEWORK\lvmen\src\licensedcode\data\rules\ruby_or_mit_1.yml", "YAML", 0, 0, 0, 6, 0, 0, 1, 7
"d:\IDEWORK\lvmen\src\licensedcode\data\rules\ruby_same_as_ruby_1.yml", "YAML", 0, 0, 0, 3, 0, 0, 1, 4
"d:\IDEWORK\lvmen\src\licensedcode\data\rules\ruby_same_as_ruby_2.yml", "YAML", 0, 0, 0, 3, 0, 0, 1, 4
"d:\IDEWORK\lvmen\src\licensedcode\data\rules\ruby_same_as_ruby_3.yml", "YAML", 0, 0, 0, 5, 0, 0, 1, 6
"d:\IDEWORK\lvmen\src\licensedcode\data\rules\ruby_same_as_ruby_4.yml", "YAML", 0, 0, 0, 5, 0, 0, 1, 6
"d:\IDEWORK\lvmen\src\licensedcode\data\rules\ruby_same_as_ruby_5.yml", "YAML", 0, 0, 0, 5, 0, 0, 1, 6
"d:\IDEWORK\lvmen\src\licensedcode\data\rules\ruby_url_1.yml", "YAML", 0, 0, 0, 5, 0, 0, 1, 6
"d:\IDEWORK\lvmen\src\licensedcode\data\rules\ruby_url_2.yml", "YAML", 0, 0, 0, 5, 0, 0, 1, 6
"d:\IDEWORK\lvmen\src\licensedcode\data\rules\rute.yml", "YAML", 0, 0, 0, 5, 0, 0, 1, 6
"d:\IDEWORK\lvmen\src\licensedcode\data\rules\rxtx-exception-lgpl-2.1_1.yml", "YAML", 0, 0, 0, 11, 0, 0, 1, 12
"d:\IDEWORK\lvmen\src\licensedcode\data\rules\same_as_qt.yml", "YAML", 0, 0, 0, 3, 0, 0, 1, 4
"d:\IDEWORK\lvmen\src\licensedcode\data\rules\sane-exception-2.0-plus_1.yml", "YAML", 0, 0, 0, 3, 0, 0, 1, 4
"d:\IDEWORK\lvmen\src\licensedcode\data\rules\sash_1.yml", "YAML", 0, 0, 0, 6, 0, 0, 1, 7
"d:\IDEWORK\lvmen\src\licensedcode\data\rules\sash_or_gpl-1.0-plus_1.yml", "YAML", 0, 0, 0, 4, 0, 0, 1, 5
"d:\IDEWORK\lvmen\src\licensedcode\data\rules\sata_1.yml", "YAML", 0, 0, 0, 2, 0, 0, 1, 3
"d:\IDEWORK\lvmen\src\licensedcode\data\rules\sax-pd_1.yml", "YAML", 0, 0, 0, 5, 0, 0, 1, 6
"d:\IDEWORK\lvmen\src\licensedcode\data\rules\sax-pd_10.yml", "YAML", 0, 0, 0, 5, 0, 0, 1, 6
"d:\IDEWORK\lvmen\src\licensedcode\data\rules\sax-pd_11.yml", "YAML", 0, 0, 0, 3, 0, 0, 1, 4
"d:\IDEWORK\lvmen\src\licensedcode\data\rules\sax-pd_12.yml", "YAML", 0, 0, 0, 3, 0, 0, 1, 4
"d:\IDEWORK\lvmen\src\licensedcode\data\rules\sax-pd_13.yml", "YAML", 0, 0, 0, 5, 0, 0, 1, 6
"d:\IDEWORK\lvmen\src\licensedcode\data\rules\sax-pd_14.yml", "YAML", 0, 0, 0, 5, 0, 0, 1, 6
"d:\IDEWORK\lvmen\src\licensedcode\data\rules\sax-pd_15.yml", "YAML", 0, 0, 0, 3, 0, 0, 1, 4
"d:\IDEWORK\lvmen\src\licensedcode\data\rules\sax-pd_16.yml", "YAML", 0, 0, 0, 5, 0, 0, 1, 6
"d:\IDEWORK\lvmen\src\licensedcode\data\rules\sax-pd_17.yml", "YAML", 0, 0, 0, 7, 0, 0, 1, 8
"d:\IDEWORK\lvmen\src\licensedcode\data\rules\sax-pd_18.yml", "YAML", 0, 0, 0, 6, 0, 0, 1, 7
"d:\IDEWORK\lvmen\src\licensedcode\data\rules\sax-pd_19.yml", "YAML", 0, 0, 0, 6, 0, 0, 1, 7
"d:\IDEWORK\lvmen\src\licensedcode\data\rules\sax-pd_2.yml", "YAML", 0, 0, 0, 6, 0, 0, 1, 7
"d:\IDEWORK\lvmen\src\licensedcode\data\rules\sax-pd_20.yml", "YAML", 0, 0, 0, 3, 0, 0, 1, 4
"d:\IDEWORK\lvmen\src\licensedcode\data\rules\sax-pd_21.yml", "YAML", 0, 0, 0, 6, 0, 0, 1, 7
"d:\IDEWORK\lvmen\src\licensedcode\data\rules\sax-pd_3.yml", "YAML", 0, 0, 0, 5, 0, 0, 1, 6
"d:\IDEWORK\lvmen\src\licensedcode\data\rules\sax-pd_4.yml", "YAML", 0, 0, 0, 5, 0, 0, 1, 6
"d:\IDEWORK\lvmen\src\licensedcode\data\rules\sax-pd_5.yml", "YAML", 0, 0, 0, 3, 0, 0, 1, 4
"d:\IDEWORK\lvmen\src\licensedcode\data\rules\sax-pd_6.yml", "YAML", 0, 0, 0, 5, 0, 0, 1, 6
"d:\IDEWORK\lvmen\src\licensedcode\data\rules\sax-pd_7.yml", "YAML", 0, 0, 0, 3, 0, 0, 1, 4
"d:\IDEWORK\lvmen\src\licensedcode\data\rules\sax-pd_8.yml", "YAML", 0, 0, 0, 3, 0, 0, 1, 4
"d:\IDEWORK\lvmen\src\licensedcode\data\rules\sax-pd_9.yml", "YAML", 0, 0, 0, 7, 0, 0, 1, 8
"d:\IDEWORK\lvmen\src\licensedcode\data\rules\sax-pd_url_1.yml", "YAML", 0, 0, 0, 5, 0, 0, 1, 6
"d:\IDEWORK\lvmen\src\licensedcode\data\rules\sax-pd_url_2.yml", "YAML", 0, 0, 0, 5, 0, 0, 1, 6
"d:\IDEWORK\lvmen\src\licensedcode\data\rules\sax-pd_url_4.yml", "YAML", 0, 0, 0, 6, 0, 0, 1, 7
"d:\IDEWORK\lvmen\src\licensedcode\data\rules\saxpath.yml", "YAML", 0, 0, 0, 13, 0, 0, 1, 14
"d:\IDEWORK\lvmen\src\licensedcode\data\rules\saxpath_1.yml", "YAML", 0, 0, 0, 13, 0, 0, 1, 14
"d:\IDEWORK\lvmen\src\licensedcode\data\rules\saxpath_url_1.yml", "YAML", 0, 0, 0, 5, 0, 0, 1, 6
"d:\IDEWORK\lvmen\src\licensedcode\data\rules\saxpath_url_2.yml", "YAML", 0, 0, 0, 5, 0, 0, 1, 6
"d:\IDEWORK\lvmen\src\licensedcode\data\rules\scansoft-1.2_1.yml", "YAML", 0, 0, 0, 5, 0, 0, 1, 6
"d:\IDEWORK\lvmen\src\licensedcode\data\rules\scansoft-1.2_2.yml", "YAML", 0, 0, 0, 3, 0, 0, 1, 4
"d:\IDEWORK\lvmen\src\licensedcode\data\rules\scansoft-1.2_3.yml", "YAML", 0, 0, 0, 3, 0, 0, 1, 4
"d:\IDEWORK\lvmen\src\licensedcode\data\rules\scansoft-1.2_4.yml", "YAML", 0, 0, 0, 4, 0, 0, 1, 5
"d:\IDEWORK\lvmen\src\licensedcode\data\rules\scea-1.0_3.yml", "YAML", 0, 0, 0, 5, 0, 0, 1, 6
"d:\IDEWORK\lvmen\src\licensedcode\data\rules\scea-1.0_4.yml", "YAML", 0, 0, 0, 3, 0, 0, 1, 4
"d:\IDEWORK\lvmen\src\licensedcode\data\rules\scea-1.0_5.yml", "YAML", 0, 0, 0, 5, 0, 0, 1, 6
"d:\IDEWORK\lvmen\src\licensedcode\data\rules\scea-1.0_url_1.yml", "YAML", 0, 0, 0, 5, 0, 0, 1, 6
"d:\IDEWORK\lvmen\src\licensedcode\data\rules\scea-1.0_url_2.yml", "YAML", 0, 0, 0, 5, 0, 0, 1, 6
"d:\IDEWORK\lvmen\src\licensedcode\data\rules\scilab.yml", "YAML", 0, 0, 0, 5, 0, 0, 1, 6
"d:\IDEWORK\lvmen\src\licensedcode\data\rules\scilab_1.yml", "YAML", 0, 0, 0, 5, 0, 0, 1, 6
"d:\IDEWORK\lvmen\src\licensedcode\data\rules\scilab_2.yml", "YAML", 0, 0, 0, 6, 0, 0, 1, 7
"d:\IDEWORK\lvmen\src\licensedcode\data\rules\script-nikhilk.yml", "YAML", 0, 0, 0, 5, 0, 0, 1, 6
"d:\IDEWORK\lvmen\src\licensedcode\data\rules\script-nikhilk_1.yml", "YAML", 0, 0, 0, 5, 0, 0, 1, 6
"d:\IDEWORK\lvmen\src\licensedcode\data\rules\scsl-3.0.yml", "YAML", 0, 0, 0, 5, 0, 0, 1, 6
"d:\IDEWORK\lvmen\src\licensedcode\data\rules\secret-labs-2011_1.yml", "YAML", 0, 0, 0, 3, 0, 0, 1, 4
"d:\IDEWORK\lvmen\src\licensedcode\data\rules\secret-labs-2011_2.yml", "YAML", 0, 0, 0, 3, 0, 0, 1, 4
"d:\IDEWORK\lvmen\src\licensedcode\data\rules\secret-labs-2011_3.yml", "YAML", 0, 0, 0, 3, 0, 0, 1, 4
"d:\IDEWORK\lvmen\src\licensedcode\data\rules\secret-labs-2011_4.yml", "YAML", 0, 0, 0, 4, 0, 0, 1, 5
"d:\IDEWORK\lvmen\src\licensedcode\data\rules\secret-labs-2011_5.yml", "YAML", 0, 0, 0, 4, 0, 0, 1, 5
"d:\IDEWORK\lvmen\src\licensedcode\data\rules\secret-labs-2011_6.yml", "YAML", 0, 0, 0, 5, 0, 0, 1, 6
"d:\IDEWORK\lvmen\src\licensedcode\data\rules\sencha-commercial.yml", "YAML", 0, 0, 0, 5, 0, 0, 1, 6
"d:\IDEWORK\lvmen\src\licensedcode\data\rules\sencha-notice.yml", "YAML", 0, 0, 0, 15, 0, 0, 1, 16
"d:\IDEWORK\lvmen\src\licensedcode\data\rules\sendmail-2010-17.yml", "YAML", 0, 0, 0, 10, 0, 0, 1, 11
"d:\IDEWORK\lvmen\src\licensedcode\data\rules\sendmail-2010.yml", "YAML", 0, 0, 0, 10, 0, 0, 1, 11
"d:\IDEWORK\lvmen\src\licensedcode\data\rules\sendmail-2012.yml", "YAML", 0, 0, 0, 10, 0, 0, 1, 11
"d:\IDEWORK\lvmen\src\licensedcode\data\rules\sendmail-2014.yml", "YAML", 0, 0, 0, 10, 0, 0, 1, 11
"d:\IDEWORK\lvmen\src\licensedcode\data\rules\sendmail-8.23_url_1.yml", "YAML", 0, 0, 0, 5, 0, 0, 1, 6
"d:\IDEWORK\lvmen\src\licensedcode\data\rules\sendmail-8.23_url_2.yml", "YAML", 0, 0, 0, 5, 0, 0, 1, 6
"d:\IDEWORK\lvmen\src\licensedcode\data\rules\sendmail_1.yml", "YAML", 0, 0, 0, 11, 0, 0, 1, 12
"d:\IDEWORK\lvmen\src\licensedcode\data\rules\sendmail_2.yml", "YAML", 0, 0, 0, 6, 0, 0, 1, 7
"d:\IDEWORK\lvmen\src\licensedcode\data\rules\sendmail_3.yml", "YAML", 0, 0, 0, 5, 0, 0, 1, 6
"d:\IDEWORK\lvmen\src\licensedcode\data\rules\sendmail_4.yml", "YAML", 0, 0, 0, 6, 0, 0, 1, 7
"d:\IDEWORK\lvmen\src\licensedcode\data\rules\sendmail_5.yml", "YAML", 0, 0, 0, 13, 0, 0, 1, 14
"d:\IDEWORK\lvmen\src\licensedcode\data\rules\sendmail_6.yml", "YAML", 0, 0, 0, 5, 0, 0, 1, 6
"d:\IDEWORK\lvmen\src\licensedcode\data\rules\sendmail_url_1.yml", "YAML", 0, 0, 0, 5, 0, 0, 1, 6
"d:\IDEWORK\lvmen\src\licensedcode\data\rules\sendmail_url_2.yml", "YAML", 0, 0, 0, 5, 0, 0, 1, 6
"d:\IDEWORK\lvmen\src\licensedcode\data\rules\service-comp-arch.yml", "YAML", 0, 0, 0, 4, 0, 0, 1, 5
"d:\IDEWORK\lvmen\src\licensedcode\data\rules\sfl-license.SPDX.yml", "YAML", 0, 0, 0, 12, 0, 0, 1, 13
"d:\IDEWORK\lvmen\src\licensedcode\data\rules\sfl-license.yml", "YAML", 0, 0, 0, 5, 0, 0, 1, 6
"d:\IDEWORK\lvmen\src\licensedcode\data\rules\sfl-license_1.yml", "YAML", 0, 0, 0, 5, 0, 0, 1, 6
"d:\IDEWORK\lvmen\src\licensedcode\data\rules\sfl-license_2.yml", "YAML", 0, 0, 0, 2, 0, 0, 1, 3
"d:\IDEWORK\lvmen\src\licensedcode\data\rules\sfl-license_url_1.yml", "YAML", 0, 0, 0, 5, 0, 0, 1, 6
"d:\IDEWORK\lvmen\src\licensedcode\data\rules\sfl-license_url_2.yml", "YAML", 0, 0, 0, 5, 0, 0, 1, 6
"d:\IDEWORK\lvmen\src\licensedcode\data\rules\sgi-cid-1.0.yml", "YAML", 0, 0, 0, 5, 0, 0, 1, 6
"d:\IDEWORK\lvmen\src\licensedcode\data\rules\sgi-freeb-1.1_1.yml", "YAML", 0, 0, 0, 5, 0, 0, 1, 6
"d:\IDEWORK\lvmen\src\licensedcode\data\rules\sgi-freeb-1.1_2.yml", "YAML", 0, 0, 0, 8, 0, 0, 1, 9
"d:\IDEWORK\lvmen\src\licensedcode\data\rules\sgi-freeb-1.1_3.yml", "YAML", 0, 0, 0, 4, 0, 0, 1, 5
"d:\IDEWORK\lvmen\src\licensedcode\data\rules\sgi-freeb-1.1_4.yml", "YAML", 0, 0, 0, 4, 0, 0, 1, 5
"d:\IDEWORK\lvmen\src\licensedcode\data\rules\sgi-freeb-1.1_url_1.yml", "YAML", 0, 0, 0, 5, 0, 0, 1, 6
"d:\IDEWORK\lvmen\src\licensedcode\data\rules\sgi-freeb-1.1_url_2.yml", "YAML", 0, 0, 0, 5, 0, 0, 1, 6
"d:\IDEWORK\lvmen\src\licensedcode\data\rules\sgi-freeb-2.0_1.yml", "YAML", 0, 0, 0, 5, 0, 0, 1, 6
"d:\IDEWORK\lvmen\src\licensedcode\data\rules\sgi-freeb-2.0_2.yml", "YAML", 0, 0, 0, 10, 0, 0, 1, 11
"d:\IDEWORK\lvmen\src\licensedcode\data\rules\sgi-freeb-2.0_3.yml", "YAML", 0, 0, 0, 8, 0, 0, 1, 9
"d:\IDEWORK\lvmen\src\licensedcode\data\rules\sgi-freeb-2.0_4.yml", "YAML", 0, 0, 0, 4, 0, 0, 1, 5
"d:\IDEWORK\lvmen\src\licensedcode\data\rules\sgi-freeb-2.0_5.yml", "YAML", 0, 0, 0, 4, 0, 0, 1, 5
"d:\IDEWORK\lvmen\src\licensedcode\data\rules\sgi-freeb-2.0_6.yml", "YAML", 0, 0, 0, 10, 0, 0, 1, 11
"d:\IDEWORK\lvmen\src\licensedcode\data\rules\sgi-freeb-2.0_7.yml", "YAML", 0, 0, 0, 3, 0, 0, 1, 4
"d:\IDEWORK\lvmen\src\licensedcode\data\rules\sgi-freeb-2.0_8.yml", "YAML", 0, 0, 0, 5, 0, 0, 1, 6
"d:\IDEWORK\lvmen\src\licensedcode\data\rules\sgi-freeb-2.0_9.yml", "YAML", 0, 0, 0, 9, 0, 0, 1, 10
"d:\IDEWORK\lvmen\src\licensedcode\data\rules\sgi-freeb-2.0_url_1.yml", "YAML", 0, 0, 0, 5, 0, 0, 1, 6
"d:\IDEWORK\lvmen\src\licensedcode\data\rules\sgi-freeb-2.0_url_2.yml", "YAML", 0, 0, 0, 5, 0, 0, 1, 6
"d:\IDEWORK\lvmen\src\licensedcode\data\rules\sgi-fslb-1.0_1.yml", "YAML", 0, 0, 0, 5, 0, 0, 1, 6
"d:\IDEWORK\lvmen\src\licensedcode\data\rules\sgi-fslb-1.0_2.yml", "YAML", 0, 0, 0, 6, 0, 0, 1, 7
"d:\IDEWORK\lvmen\src\licensedcode\data\rules\sgi-fslb-1.0_3.yml", "YAML", 0, 0, 0, 8, 0, 0, 1, 9
"d:\IDEWORK\lvmen\src\licensedcode\data\rules\sgi-fslb-1.0_url_1.yml", "YAML", 0, 0, 0, 5, 0, 0, 1, 6
"d:\IDEWORK\lvmen\src\licensedcode\data\rules\sgi-fslb-1.0_url_2.yml", "YAML", 0, 0, 0, 5, 0, 0, 1, 6
"d:\IDEWORK\lvmen\src\licensedcode\data\rules\sgi-glx-1.0.yml", "YAML", 0, 0, 0, 5, 0, 0, 1, 6
"d:\IDEWORK\lvmen\src\licensedcode\data\rules\sgi-glx-1.0_1.yml", "YAML", 0, 0, 0, 5, 0, 0, 1, 6
"d:\IDEWORK\lvmen\src\licensedcode\data\rules\sglib.yml", "YAML", 0, 0, 0, 5, 0, 0, 1, 6
"d:\IDEWORK\lvmen\src\licensedcode\data\rules\shl-0.51_1.yml", "YAML", 0, 0, 0, 5, 0, 0, 2, 7
"d:\IDEWORK\lvmen\src\licensedcode\data\rules\shl-0.51_url_1.yml", "YAML", 0, 0, 0, 5, 0, 0, 1, 6
"d:\IDEWORK\lvmen\src\licensedcode\data\rules\shl-0.51_url_2.yml", "YAML", 0, 0, 0, 5, 0, 0, 1, 6
"d:\IDEWORK\lvmen\src\licensedcode\data\rules\shl-0.5_url_1.yml", "YAML", 0, 0, 0, 5, 0, 0, 1, 6
"d:\IDEWORK\lvmen\src\licensedcode\data\rules\shl-0.5_url_2.yml", "YAML", 0, 0, 0, 5, 0, 0, 1, 6
"d:\IDEWORK\lvmen\src\licensedcode\data\rules\simpl-2.0.SPDX.yml", "YAML", 0, 0, 0, 4, 0, 0, 1, 5
"d:\IDEWORK\lvmen\src\licensedcode\data\rules\simpl-2.0.yml", "YAML", 0, 0, 0, 3, 0, 0, 1, 4
"d:\IDEWORK\lvmen\src\licensedcode\data\rules\simpl-2.0_1.yml", "YAML", 0, 0, 0, 5, 0, 0, 1, 6
"d:\IDEWORK\lvmen\src\licensedcode\data\rules\simpl-2.0_2.yml", "YAML", 0, 0, 0, 4, 0, 0, 1, 5
"d:\IDEWORK\lvmen\src\licensedcode\data\rules\simpl-2.0_url_1.yml", "YAML", 0, 0, 0, 5, 0, 0, 1, 6
"d:\IDEWORK\lvmen\src\licensedcode\data\rules\simpl-2.0_url_2.yml", "YAML", 0, 0, 0, 5, 0, 0, 1, 6
"d:\IDEWORK\lvmen\src\licensedcode\data\rules\simpl-2.0_url_glc_236.yml", "YAML", 0, 0, 0, 5, 0, 0, 1, 6
"d:\IDEWORK\lvmen\src\licensedcode\data\rules\simpl-2.0_url_glc_237.yml", "YAML", 0, 0, 0, 5, 0, 0, 1, 6
"d:\IDEWORK\lvmen\src\licensedcode\data\rules\sleepycat.SPDX.yml", "YAML", 0, 0, 0, 4, 0, 0, 1, 5
"d:\IDEWORK\lvmen\src\licensedcode\data\rules\sleepycat.yml", "YAML", 0, 0, 0, 5, 0, 0, 1, 6
"d:\IDEWORK\lvmen\src\licensedcode\data\rules\sleepycat_1.yml", "YAML", 0, 0, 0, 3, 0, 0, 1, 4
"d:\IDEWORK\lvmen\src\licensedcode\data\rules\sleepycat_10.yml", "YAML", 0, 0, 0, 6, 0, 0, 1, 7
"d:\IDEWORK\lvmen\src\licensedcode\data\rules\sleepycat_11.yml", "YAML", 0, 0, 0, 6, 0, 0, 1, 7
"d:\IDEWORK\lvmen\src\licensedcode\data\rules\sleepycat_12.yml", "YAML", 0, 0, 0, 5, 0, 0, 1, 6
"d:\IDEWORK\lvmen\src\licensedcode\data\rules\sleepycat_13.yml", "YAML", 0, 0, 0, 3, 0, 0, 1, 4
"d:\IDEWORK\lvmen\src\licensedcode\data\rules\sleepycat_14.yml", "YAML", 0, 0, 0, 7, 0, 0, 1, 8
"d:\IDEWORK\lvmen\src\licensedcode\data\rules\sleepycat_15.yml", "YAML", 0, 0, 0, 2, 0, 0, 1, 3
"d:\IDEWORK\lvmen\src\licensedcode\data\rules\sleepycat_16.yml", "YAML", 0, 0, 0, 6, 0, 0, 1, 7
"d:\IDEWORK\lvmen\src\licensedcode\data\rules\sleepycat_17.yml", "YAML", 0, 0, 0, 7, 0, 0, 1, 8
"d:\IDEWORK\lvmen\src\licensedcode\data\rules\sleepycat_2.yml", "YAML", 0, 0, 0, 2, 0, 0, 1, 3
"d:\IDEWORK\lvmen\src\licensedcode\data\rules\sleepycat_3.yml", "YAML", 0, 0, 0, 5, 0, 0, 1, 6
"d:\IDEWORK\lvmen\src\licensedcode\data\rules\sleepycat_4.yml", "YAML", 0, 0, 0, 3, 0, 0, 1, 4
"d:\IDEWORK\lvmen\src\licensedcode\data\rules\sleepycat_5.yml", "YAML", 0, 0, 0, 2, 0, 0, 1, 3
"d:\IDEWORK\lvmen\src\licensedcode\data\rules\sleepycat_6.yml", "YAML", 0, 0, 0, 5, 0, 0, 1, 6
"d:\IDEWORK\lvmen\src\licensedcode\data\rules\sleepycat_7.yml", "YAML", 0, 0, 0, 5, 0, 0, 1, 6
"d:\IDEWORK\lvmen\src\licensedcode\data\rules\sleepycat_9.yml", "YAML", 0, 0, 0, 4, 0, 0, 1, 5
"d:\IDEWORK\lvmen\src\licensedcode\data\rules\sleepycat_or_commercial-license_1.yml", "YAML", 0, 0, 0, 2, 0, 0, 1, 3
"d:\IDEWORK\lvmen\src\licensedcode\data\rules\sleepycat_or_commercial-license_2.yml", "YAML", 0, 0, 0, 2, 0, 0, 1, 3
"d:\IDEWORK\lvmen\src\licensedcode\data\rules\sleepycat_url_1.yml", "YAML", 0, 0, 0, 5, 0, 0, 1, 6
"d:\IDEWORK\lvmen\src\licensedcode\data\rules\sleepycat_url_2.yml", "YAML", 0, 0, 0, 5, 0, 0, 1, 6
"d:\IDEWORK\lvmen\src\licensedcode\data\rules\sleepycat_url_glc_238.yml", "YAML", 0, 0, 0, 5, 0, 0, 1, 6
"d:\IDEWORK\lvmen\src\licensedcode\data\rules\sleepycat_url_glc_239.yml", "YAML", 0, 0, 0, 5, 0, 0, 1, 6
"d:\IDEWORK\lvmen\src\licensedcode\data\rules\slf4j-2008.yml", "YAML", 0, 0, 0, 5, 0, 0, 1, 6
"d:\IDEWORK\lvmen\src\licensedcode\data\rules\slf4j-2008_1.yml", "YAML", 0, 0, 0, 3, 0, 0, 1, 4
"d:\IDEWORK\lvmen\src\licensedcode\data\rules\slf4j-2008_2.yml", "YAML", 0, 0, 0, 3, 0, 0, 1, 4
"d:\IDEWORK\lvmen\src\licensedcode\data\rules\smail-gpl.yml", "YAML", 0, 0, 0, 5, 0, 0, 1, 6
"d:\IDEWORK\lvmen\src\licensedcode\data\rules\smail-gpl_1.yml", "YAML", 0, 0, 0, 3, 0, 0, 1, 4
"d:\IDEWORK\lvmen\src\licensedcode\data\rules\smail-gpl_2.yml", "YAML", 0, 0, 0, 3, 0, 0, 1, 4
"d:\IDEWORK\lvmen\src\licensedcode\data\rules\smppl_url_1.yml", "YAML", 0, 0, 0, 5, 0, 0, 1, 6
"d:\IDEWORK\lvmen\src\licensedcode\data\rules\smppl_url_2.yml", "YAML", 0, 0, 0, 5, 0, 0, 1, 6
"d:\IDEWORK\lvmen\src\licensedcode\data\rules\snia_1.yml", "YAML", 0, 0, 0, 3, 0, 0, 1, 4
"d:\IDEWORK\lvmen\src\licensedcode\data\rules\snia_url_1.yml", "YAML", 0, 0, 0, 5, 0, 0, 1, 6
"d:\IDEWORK\lvmen\src\licensedcode\data\rules\snia_url_2.yml", "YAML", 0, 0, 0, 5, 0, 0, 1, 6
"d:\IDEWORK\lvmen\src\licensedcode\data\rules\snprintf_1.yml", "YAML", 0, 0, 0, 3, 0, 0, 1, 4
"d:\IDEWORK\lvmen\src\licensedcode\data\rules\softfloat-2.0_1.yml", "YAML", 0, 0, 0, 6, 0, 0, 1, 7
"d:\IDEWORK\lvmen\src\licensedcode\data\rules\softfloat-2.0_2.yml", "YAML", 0, 0, 0, 6, 0, 0, 1, 7
"d:\IDEWORK\lvmen\src\licensedcode\data\rules\softfloat_and_proprietary-license_1.yml", "YAML", 0, 0, 0, 4, 0, 0, 1, 5
"d:\IDEWORK\lvmen\src\licensedcode\data\rules\softsurfer2.yml", "YAML", 0, 0, 0, 2, 0, 0, 1, 3
"d:\IDEWORK\lvmen\src\licensedcode\data\rules\sparky.yml", "YAML", 0, 0, 0, 5, 0, 0, 1, 6
"d:\IDEWORK\lvmen\src\licensedcode\data\rules\sparky_1.yml", "YAML", 0, 0, 0, 5, 0, 0, 1, 6
"d:\IDEWORK\lvmen\src\licensedcode\data\rules\spdx_license_id_0bsd_for_bsd-zero.yml", "YAML", 0, 0, 0, 6, 0, 0, 1, 7
"d:\IDEWORK\lvmen\src\licensedcode\data\rules\spdx_license_id_389-exception_for_389-exception.yml", "YAML", 0, 0, 0, 6, 0, 0, 1, 7
"d:\IDEWORK\lvmen\src\licensedcode\data\rules\spdx_license_id_adobe-2006_for_adobe-scl.yml", "YAML", 0, 0, 0, 6, 0, 0, 1, 7
"d:\IDEWORK\lvmen\src\licensedcode\data\rules\spdx_license_id_afl-1.1_for_afl-1.1.yml", "YAML", 0, 0, 0, 6, 0, 0, 1, 7
"d:\IDEWORK\lvmen\src\licensedcode\data\rules\spdx_license_id_afl-1.2_for_afl-1.2.yml", "YAML", 0, 0, 0, 6, 0, 0, 1, 7
"d:\IDEWORK\lvmen\src\licensedcode\data\rules\spdx_license_id_afl-2.0_for_afl-2.0.yml", "YAML", 0, 0, 0, 6, 0, 0, 1, 7
"d:\IDEWORK\lvmen\src\licensedcode\data\rules\spdx_license_id_afl-2.1_for_afl-2.1.yml", "YAML", 0, 0, 0, 6, 0, 0, 1, 7
"d:\IDEWORK\lvmen\src\licensedcode\data\rules\spdx_license_id_afl-3.0_for_afl-3.0.yml", "YAML", 0, 0, 0, 6, 0, 0, 1, 7
"d:\IDEWORK\lvmen\src\licensedcode\data\rules\spdx_license_id_agpl-1.0+_for_agpl-1.0-plus.yml", "YAML", 0, 0, 0, 6, 0, 0, 1, 7
"d:\IDEWORK\lvmen\src\licensedcode\data\rules\spdx_license_id_agpl-1.0-only_for_agpl-1.0.yml", "YAML", 0, 0, 0, 6, 0, 0, 1, 7
"d:\IDEWORK\lvmen\src\licensedcode\data\rules\spdx_license_id_agpl-1.0-or-later_for_agpl-1.0-plus.yml", "YAML", 0, 0, 0, 6, 0, 0, 1, 7
"d:\IDEWORK\lvmen\src\licensedcode\data\rules\spdx_license_id_agpl-3.0+_for_agpl-3.0-plus.yml", "YAML", 0, 0, 0, 6, 0, 0, 1, 7
"d:\IDEWORK\lvmen\src\licensedcode\data\rules\spdx_license_id_agpl-3.0-only_for_agpl-3.0.yml", "YAML", 0, 0, 0, 6, 0, 0, 1, 7
"d:\IDEWORK\lvmen\src\licensedcode\data\rules\spdx_license_id_agpl-3.0-or-later_for_agpl-3.0-plus.yml", "YAML", 0, 0, 0, 6, 0, 0, 1, 7
"d:\IDEWORK\lvmen\src\licensedcode\data\rules\spdx_license_id_amdplpa_for_amdplpa.yml", "YAML", 0, 0, 0, 6, 0, 0, 1, 7
"d:\IDEWORK\lvmen\src\licensedcode\data\rules\spdx_license_id_antlr-pd_for_antlr-pd.yml", "YAML", 0, 0, 0, 6, 0, 0, 1, 7
"d:\IDEWORK\lvmen\src\licensedcode\data\rules\spdx_license_id_apache-1.1_for_apache-1.1.yml", "YAML", 0, 0, 0, 6, 0, 0, 1, 7
"d:\IDEWORK\lvmen\src\licensedcode\data\rules\spdx_license_id_apache-2.0_for_apache-2.0.yml", "YAML", 0, 0, 0, 6, 0, 0, 1, 7
"d:\IDEWORK\lvmen\src\licensedcode\data\rules\spdx_license_id_apafml_for_apafml.yml", "YAML", 0, 0, 0, 6, 0, 0, 1, 7
"d:\IDEWORK\lvmen\src\licensedcode\data\rules\spdx_license_id_apl-1.0_for_adapt-1.0.yml", "YAML", 0, 0, 0, 6, 0, 0, 1, 7
"d:\IDEWORK\lvmen\src\licensedcode\data\rules\spdx_license_id_apsl-1.0_for_apsl-1.0.yml", "YAML", 0, 0, 0, 6, 0, 0, 1, 7
"d:\IDEWORK\lvmen\src\licensedcode\data\rules\spdx_license_id_apsl-1.2_for_apsl-1.2.yml", "YAML", 0, 0, 0, 6, 0, 0, 1, 7
"d:\IDEWORK\lvmen\src\licensedcode\data\rules\spdx_license_id_apsl-2.0_for_apsl-2.0.yml", "YAML", 0, 0, 0, 6, 0, 0, 1, 7
"d:\IDEWORK\lvmen\src\licensedcode\data\rules\spdx_license_id_artistic-1.0-cl8_for_artistic-1.0-cl8.yml", "YAML", 0, 0, 0, 6, 0, 0, 1, 7
"d:\IDEWORK\lvmen\src\licensedcode\data\rules\spdx_license_id_artistic-1.0-perl_for_artistic-perl-1.0.yml", "YAML", 0, 0, 0, 6, 0, 0, 1, 7
"d:\IDEWORK\lvmen\src\licensedcode\data\rules\spdx_license_id_artistic-1.0_for_artistic-1.0.yml", "YAML", 0, 0, 0, 6, 0, 0, 1, 7
"d:\IDEWORK\lvmen\src\licensedcode\data\rules\spdx_license_id_artistic-2.0_for_artistic-2.0.yml", "YAML", 0, 0, 0, 6, 0, 0, 1, 7
"d:\IDEWORK\lvmen\src\licensedcode\data\rules\spdx_license_id_autoconf-exception-2.0_for_autoconf-exception-2.0.yml", "YAML", 0, 0, 0, 6, 0, 0, 1, 7
"d:\IDEWORK\lvmen\src\licensedcode\data\rules\spdx_license_id_autoconf-exception-3.0_for_autoconf-exception-3.0.yml", "YAML", 0, 0, 0, 6, 0, 0, 1, 7
"d:\IDEWORK\lvmen\src\licensedcode\data\rules\spdx_license_id_beerware_for_beerware.yml", "YAML", 0, 0, 0, 6, 0, 0, 1, 7
"d:\IDEWORK\lvmen\src\licensedcode\data\rules\spdx_license_id_bison-exception-2.2_for_bison-exception-2.2.yml", "YAML", 0, 0, 0, 6, 0, 0, 1, 7
"d:\IDEWORK\lvmen\src\licensedcode\data\rules\spdx_license_id_bittorrent-1.0_for_bittorrent-1.0.yml", "YAML", 0, 0, 0, 6, 0, 0, 1, 7
"d:\IDEWORK\lvmen\src\licensedcode\data\rules\spdx_license_id_bittorrent-1.1_for_bittorrent-1.1.yml", "YAML", 0, 0, 0, 6, 0, 0, 1, 7
"d:\IDEWORK\lvmen\src\licensedcode\data\rules\spdx_license_id_bootloader-exception_for_bootloader-exception.yml", "YAML", 0, 0, 0, 6, 0, 0, 1, 7
"d:\IDEWORK\lvmen\src\licensedcode\data\rules\spdx_license_id_borceux_for_borceux.yml", "YAML", 0, 0, 0, 6, 0, 0, 1, 7
"d:\IDEWORK\lvmen\src\licensedcode\data\rules\spdx_license_id_bsd-1-clause_for_bsd-1-clause.yml", "YAML", 0, 0, 0, 6, 0, 0, 1, 7
"d:\IDEWORK\lvmen\src\licensedcode\data\rules\spdx_license_id_bsd-2-clause-netbsd_for_bsd-2-clause-netbsd.yml", "YAML", 0, 0, 0, 6, 0, 0, 1, 7
"d:\IDEWORK\lvmen\src\licensedcode\data\rules\spdx_license_id_bsd-2-clause-patent_for_bsd-plus-patent.yml", "YAML", 0, 0, 0, 6, 0, 0, 1, 7
"d:\IDEWORK\lvmen\src\licensedcode\data\rules\spdx_license_id_bsd-2-clause_for_bsd-simplified.yml", "YAML", 0, 0, 0, 6, 0, 0, 1, 7
"d:\IDEWORK\lvmen\src\licensedcode\data\rules\spdx_license_id_bsd-3-clause-attribution_for_bsd-ack.yml", "YAML", 0, 0, 0, 6, 0, 0, 1, 7
"d:\IDEWORK\lvmen\src\licensedcode\data\rules\spdx_license_id_bsd-3-clause-clear_for_clear-bsd.yml", "YAML", 0, 0, 0, 6, 0, 0, 1, 7
"d:\IDEWORK\lvmen\src\licensedcode\data\rules\spdx_license_id_bsd-3-clause-lbnl_for_lbnl-bsd.yml", "YAML", 0, 0, 0, 6, 0, 0, 1, 7
"d:\IDEWORK\lvmen\src\licensedcode\data\rules\spdx_license_id_bsd-3-clause-no-nuclear-license-2014_for_oracle-bsd-no-nuclear.yml", "YAML", 0, 0, 0, 6, 0, 0, 1, 7
"d:\IDEWORK\lvmen\src\licensedcode\data\rules\spdx_license_id_bsd-3-clause-no-nuclear-license_for_sun-bsd-no-nuclear.yml", "YAML", 0, 0, 0, 6, 0, 0, 1, 7
"d:\IDEWORK\lvmen\src\licensedcode\data\rules\spdx_license_id_bsd-3-clause-no-nuclear-warranty_for_and_others_1.yml", "YAML", 0, 0, 0, 6, 0, 0, 1, 7
"d:\IDEWORK\lvmen\src\licensedcode\data\rules\spdx_license_id_bsd-4-clause_for_bsd-original.yml", "YAML", 0, 0, 0, 6, 0, 0, 1, 7
"d:\IDEWORK\lvmen\src\licensedcode\data\rules\spdx_license_id_bsd-protection_for_bsd-protection.yml", "YAML", 0, 0, 0, 6, 0, 0, 1, 7
"d:\IDEWORK\lvmen\src\licensedcode\data\rules\spdx_license_id_bsd-source-code_for_bsd-source-code.yml", "YAML", 0, 0, 0, 6, 0, 0, 1, 7
"d:\IDEWORK\lvmen\src\licensedcode\data\rules\spdx_license_id_catosl-1.1_for_ca-tosl-1.1.yml", "YAML", 0, 0, 0, 6, 0, 0, 1, 7
"d:\IDEWORK\lvmen\src\licensedcode\data\rules\spdx_license_id_cc-by-1.0_for_cc-by-1.0.yml", "YAML", 0, 0, 0, 6, 0, 0, 1, 7
"d:\IDEWORK\lvmen\src\licensedcode\data\rules\spdx_license_id_cc-by-2.0_for_cc-by-2.0.yml", "YAML", 0, 0, 0, 6, 0, 0, 1, 7
"d:\IDEWORK\lvmen\src\licensedcode\data\rules\spdx_license_id_cc-by-2.5_for_cc-by-2.5.yml", "YAML", 0, 0, 0, 6, 0, 0, 1, 7
"d:\IDEWORK\lvmen\src\licensedcode\data\rules\spdx_license_id_cc-by-3.0_for_cc-by-3.0.yml", "YAML", 0, 0, 0, 6, 0, 0, 1, 7
"d:\IDEWORK\lvmen\src\licensedcode\data\rules\spdx_license_id_cc-by-4.0_for_cc-by-4.0.yml", "YAML", 0, 0, 0, 6, 0, 0, 1, 7
"d:\IDEWORK\lvmen\src\licensedcode\data\rules\spdx_license_id_cc-by-nc-1.0_for_cc-by-nc-1.0.yml", "YAML", 0, 0, 0, 6, 0, 0, 1, 7
"d:\IDEWORK\lvmen\src\licensedcode\data\rules\spdx_license_id_cc-by-nc-2.0_for_cc-by-nc-2.0.yml", "YAML", 0, 0, 0, 6, 0, 0, 1, 7
"d:\IDEWORK\lvmen\src\licensedcode\data\rules\spdx_license_id_cc-by-nc-2.5_for_cc-by-nc-2.5.yml", "YAML", 0, 0, 0, 6, 0, 0, 1, 7
"d:\IDEWORK\lvmen\src\licensedcode\data\rules\spdx_license_id_cc-by-nc-3.0_for_cc-by-nc-3.0.yml", "YAML", 0, 0, 0, 6, 0, 0, 1, 7
"d:\IDEWORK\lvmen\src\licensedcode\data\rules\spdx_license_id_cc-by-nc-4.0_for_cc-by-nc-4.0.yml", "YAML", 0, 0, 0, 6, 0, 0, 1, 7
"d:\IDEWORK\lvmen\src\licensedcode\data\rules\spdx_license_id_cc-by-nc-nd-1.0_for_cc-by-nc-nd-1.0.yml", "YAML", 0, 0, 0, 6, 0, 0, 1, 7
"d:\IDEWORK\lvmen\src\licensedcode\data\rules\spdx_license_id_cc-by-nc-nd-2.0_for_cc-by-nc-nd-2.0.yml", "YAML", 0, 0, 0, 6, 0, 0, 1, 7
"d:\IDEWORK\lvmen\src\licensedcode\data\rules\spdx_license_id_cc-by-nc-nd-2.5_for_cc-by-nc-nd-2.5.yml", "YAML", 0, 0, 0, 6, 0, 0, 1, 7
"d:\IDEWORK\lvmen\src\licensedcode\data\rules\spdx_license_id_cc-by-nc-nd-3.0_for_cc-by-nc-nd-3.0.yml", "YAML", 0, 0, 0, 6, 0, 0, 1, 7
"d:\IDEWORK\lvmen\src\licensedcode\data\rules\spdx_license_id_cc-by-nc-nd-4.0_for_cc-by-nc-nd-4.0.yml", "YAML", 0, 0, 0, 6, 0, 0, 1, 7
"d:\IDEWORK\lvmen\src\licensedcode\data\rules\spdx_license_id_cc-by-nc-sa-1.0_for_cc-by-nc-sa-1.0.yml", "YAML", 0, 0, 0, 6, 0, 0, 1, 7
"d:\IDEWORK\lvmen\src\licensedcode\data\rules\spdx_license_id_cc-by-nc-sa-2.0_for_cc-by-nc-sa-2.0.yml", "YAML", 0, 0, 0, 6, 0, 0, 1, 7
"d:\IDEWORK\lvmen\src\licensedcode\data\rules\spdx_license_id_cc-by-nc-sa-2.5_for_cc-by-nc-sa-2.5.yml", "YAML", 0, 0, 0, 6, 0, 0, 1, 7
"d:\IDEWORK\lvmen\src\licensedcode\data\rules\spdx_license_id_cc-by-nc-sa-3.0_for_cc-by-nc-sa-3.0.yml", "YAML", 0, 0, 0, 6, 0, 0, 1, 7
"d:\IDEWORK\lvmen\src\licensedcode\data\rules\spdx_license_id_cc-by-nc-sa-4.0_for_cc-by-nc-sa-4.0.yml", "YAML", 0, 0, 0, 6, 0, 0, 1, 7
"d:\IDEWORK\lvmen\src\licensedcode\data\rules\spdx_license_id_cc-by-nd-1.0_for_cc-by-nd-1.0.yml", "YAML", 0, 0, 0, 6, 0, 0, 1, 7
"d:\IDEWORK\lvmen\src\licensedcode\data\rules\spdx_license_id_cc-by-nd-2.0_for_cc-by-nd-2.0.yml", "YAML", 0, 0, 0, 6, 0, 0, 1, 7
"d:\IDEWORK\lvmen\src\licensedcode\data\rules\spdx_license_id_cc-by-nd-2.5_for_cc-by-nd-2.5.yml", "YAML", 0, 0, 0, 6, 0, 0, 1, 7
"d:\IDEWORK\lvmen\src\licensedcode\data\rules\spdx_license_id_cc-by-nd-3.0_for_cc-by-nd-3.0.yml", "YAML", 0, 0, 0, 6, 0, 0, 1, 7
"d:\IDEWORK\lvmen\src\licensedcode\data\rules\spdx_license_id_cc-by-nd-4.0_for_cc-by-nd-4.0.yml", "YAML", 0, 0, 0, 6, 0, 0, 1, 7
"d:\IDEWORK\lvmen\src\licensedcode\data\rules\spdx_license_id_cc-by-sa-1.0_for_cc-by-sa-1.0.yml", "YAML", 0, 0, 0, 6, 0, 0, 1, 7
"d:\IDEWORK\lvmen\src\licensedcode\data\rules\spdx_license_id_cc-by-sa-2.0_for_cc-by-sa-2.0.yml", "YAML", 0, 0, 0, 6, 0, 0, 1, 7
"d:\IDEWORK\lvmen\src\licensedcode\data\rules\spdx_license_id_cc-by-sa-2.5_for_cc-by-sa-2.5.yml", "YAML", 0, 0, 0, 6, 0, 0, 1, 7
"d:\IDEWORK\lvmen\src\licensedcode\data\rules\spdx_license_id_cc-by-sa-3.0_for_cc-by-sa-3.0.yml", "YAML", 0, 0, 0, 6, 0, 0, 1, 7
"d:\IDEWORK\lvmen\src\licensedcode\data\rules\spdx_license_id_cc0-1.0_for_cc0-1.0.yml", "YAML", 0, 0, 0, 6, 0, 0, 1, 7
"d:\IDEWORK\lvmen\src\licensedcode\data\rules\spdx_license_id_cddl-1.0_for_cddl-1.0.yml", "YAML", 0, 0, 0, 6, 0, 0, 1, 7
"d:\IDEWORK\lvmen\src\licensedcode\data\rules\spdx_license_id_cddl-1.1_for_cddl-1.1.yml", "YAML", 0, 0, 0, 6, 0, 0, 1, 7
"d:\IDEWORK\lvmen\src\licensedcode\data\rules\spdx_license_id_cdla-permissive-1.0_for_cdla-permissive-1.0.yml", "YAML", 0, 0, 0, 6, 0, 0, 1, 7
"d:\IDEWORK\lvmen\src\licensedcode\data\rules\spdx_license_id_cdla-sharing-1.0_for_cdla-sharing-1.0.yml", "YAML", 0, 0, 0, 6, 0, 0, 1, 7
"d:\IDEWORK\lvmen\src\licensedcode\data\rules\spdx_license_id_cecill-1.0_for_cecill-1.0.yml", "YAML", 0, 0, 0, 6, 0, 0, 1, 7
"d:\IDEWORK\lvmen\src\licensedcode\data\rules\spdx_license_id_cecill-1.1_for_cecill-1.1.yml", "YAML", 0, 0, 0, 6, 0, 0, 1, 7
"d:\IDEWORK\lvmen\src\licensedcode\data\rules\spdx_license_id_cecill-2.0_for_cecill-2.0.yml", "YAML", 0, 0, 0, 6, 0, 0, 1, 7
"d:\IDEWORK\lvmen\src\licensedcode\data\rules\spdx_license_id_cecill-2.1_for_cecill-2.1.yml", "YAML", 0, 0, 0, 6, 0, 0, 1, 7
"d:\IDEWORK\lvmen\src\licensedcode\data\rules\spdx_license_id_cecill-b_for_cecill-b.yml", "YAML", 0, 0, 0, 6, 0, 0, 1, 7
"d:\IDEWORK\lvmen\src\licensedcode\data\rules\spdx_license_id_cecill-c_for_cecill-c.yml", "YAML", 0, 0, 0, 6, 0, 0, 1, 7
"d:\IDEWORK\lvmen\src\licensedcode\data\rules\spdx_license_id_clartistic_for_artistic-clarified.yml", "YAML", 0, 0, 0, 6, 0, 0, 1, 7
"d:\IDEWORK\lvmen\src\licensedcode\data\rules\spdx_license_id_clisp-exception-2.0_for_clisp-exception-2.0.yml", "YAML", 0, 0, 0, 6, 0, 0, 1, 7
"d:\IDEWORK\lvmen\src\licensedcode\data\rules\spdx_license_id_cnri-jython_for_cnri-jython.yml", "YAML", 0, 0, 0, 6, 0, 0, 1, 7
"d:\IDEWORK\lvmen\src\licensedcode\data\rules\spdx_license_id_cnri-python-gpl-compatible_for_cnri-python-1.6.1.yml", "YAML", 0, 0, 0, 6, 0, 0, 1, 7
"d:\IDEWORK\lvmen\src\licensedcode\data\rules\spdx_license_id_cnri-python_for_cnri-python-1.6.yml", "YAML", 0, 0, 0, 6, 0, 0, 1, 7
"d:\IDEWORK\lvmen\src\licensedcode\data\rules\spdx_license_id_condor-1.1_for_condor-1.1.yml", "YAML", 0, 0, 0, 6, 0, 0, 1, 7
"d:\IDEWORK\lvmen\src\licensedcode\data\rules\spdx_license_id_cpal-1.0_for_cpal-1.0.yml", "YAML", 0, 0, 0, 6, 0, 0, 1, 7
"d:\IDEWORK\lvmen\src\licensedcode\data\rules\spdx_license_id_cpl-1.0_for_cpl-1.0.yml", "YAML", 0, 0, 0, 6, 0, 0, 1, 7
"d:\IDEWORK\lvmen\src\licensedcode\data\rules\spdx_license_id_cua-opl-1.0_for_cua-opl-1.0.yml", "YAML", 0, 0, 0, 6, 0, 0, 1, 7
"d:\IDEWORK\lvmen\src\licensedcode\data\rules\spdx_license_id_digirule-foss-exception_for_digirule-foss-exception.yml", "YAML", 0, 0, 0, 6, 0, 0, 1, 7
"d:\IDEWORK\lvmen\src\licensedcode\data\rules\spdx_license_id_ecl-1.0_for_ecl-1.0.yml", "YAML", 0, 0, 0, 6, 0, 0, 1, 7
"d:\IDEWORK\lvmen\src\licensedcode\data\rules\spdx_license_id_ecl-2.0_for_ecl-2.0.yml", "YAML", 0, 0, 0, 6, 0, 0, 1, 7
"d:\IDEWORK\lvmen\src\licensedcode\data\rules\spdx_license_id_ecos-exception-2.0_for_ecos-exception-2.0.yml", "YAML", 0, 0, 0, 6, 0, 0, 1, 7
"d:\IDEWORK\lvmen\src\licensedcode\data\rules\spdx_license_id_efl-1.0_for_efl-1.0.yml", "YAML", 0, 0, 0, 6, 0, 0, 1, 7
"d:\IDEWORK\lvmen\src\licensedcode\data\rules\spdx_license_id_epl-2.0_for_epl-2.0.yml", "YAML", 0, 0, 0, 6, 0, 0, 1, 7
"d:\IDEWORK\lvmen\src\licensedcode\data\rules\spdx_license_id_erlpl-1.1_for_erlangpl-1.1.yml", "YAML", 0, 0, 0, 6, 0, 0, 1, 7
"d:\IDEWORK\lvmen\src\licensedcode\data\rules\spdx_license_id_eudatagrid_for_eu-datagrid.yml", "YAML", 0, 0, 0, 6, 0, 0, 1, 7
"d:\IDEWORK\lvmen\src\licensedcode\data\rules\spdx_license_id_eupl-1.0_for_eupl-1.0.yml", "YAML", 0, 0, 0, 6, 0, 0, 1, 7
"d:\IDEWORK\lvmen\src\licensedcode\data\rules\spdx_license_id_eupl-1.1_for_eupl-1.1.yml", "YAML", 0, 0, 0, 6, 0, 0, 1, 7
"d:\IDEWORK\lvmen\src\licensedcode\data\rules\spdx_license_id_eupl-1.2_for_eupl-1.2.yml", "YAML", 0, 0, 0, 6, 0, 0, 1, 7
"d:\IDEWORK\lvmen\src\licensedcode\data\rules\spdx_license_id_fawkes-runtime-exception_for_fawkes-runtime-exception.yml", "YAML", 0, 0, 0, 6, 0, 0, 1, 7
"d:\IDEWORK\lvmen\src\licensedcode\data\rules\spdx_license_id_fltk-exception_for_fltk-exception-lgpl-2.0.yml", "YAML", 0, 0, 0, 6, 0, 0, 1, 7
"d:\IDEWORK\lvmen\src\licensedcode\data\rules\spdx_license_id_font-exception-2.0_for_font-exception-gpl.yml", "YAML", 0, 0, 0, 6, 0, 0, 1, 7
"d:\IDEWORK\lvmen\src\licensedcode\data\rules\spdx_license_id_freertos-exception-2.0_for_freertos-exception-2.0.yml", "YAML", 0, 0, 0, 6, 0, 0, 1, 7
"d:\IDEWORK\lvmen\src\licensedcode\data\rules\spdx_license_id_fsfap_for_fsf-ap.yml", "YAML", 0, 0, 0, 6, 0, 0, 1, 7
"d:\IDEWORK\lvmen\src\licensedcode\data\rules\spdx_license_id_fsful_for_fsf-free.yml", "YAML", 0, 0, 0, 6, 0, 0, 1, 7
"d:\IDEWORK\lvmen\src\licensedcode\data\rules\spdx_license_id_fsfullr_for_fsf-unlimited.yml", "YAML", 0, 0, 0, 6, 0, 0, 1, 7
"d:\IDEWORK\lvmen\src\licensedcode\data\rules\spdx_license_id_gcc-exception-2.0_for_gcc-linking-exception-2.0.yml", "YAML", 0, 0, 0, 6, 0, 0, 1, 7
"d:\IDEWORK\lvmen\src\licensedcode\data\rules\spdx_license_id_gcc-exception-3.1_for_gcc-exception-3.1.yml", "YAML", 0, 0, 0, 6, 0, 0, 1, 7
"d:\IDEWORK\lvmen\src\licensedcode\data\rules\spdx_license_id_gfdl-1.1+_for_gfdl-1.1-plus.yml", "YAML", 0, 0, 0, 6, 0, 0, 1, 7
"d:\IDEWORK\lvmen\src\licensedcode\data\rules\spdx_license_id_gfdl-1.1-only_for_gfdl-1.1.yml", "YAML", 0, 0, 0, 6, 0, 0, 1, 7
"d:\IDEWORK\lvmen\src\licensedcode\data\rules\spdx_license_id_gfdl-1.1-or-later_for_gfdl-1.1-plus.yml", "YAML", 0, 0, 0, 6, 0, 0, 1, 7
"d:\IDEWORK\lvmen\src\licensedcode\data\rules\spdx_license_id_gfdl-1.2+_for_gfdl-1.2-plus.yml", "YAML", 0, 0, 0, 6, 0, 0, 1, 7
"d:\IDEWORK\lvmen\src\licensedcode\data\rules\spdx_license_id_gfdl-1.2-only_for_gfdl-1.2.yml", "YAML", 0, 0, 0, 6, 0, 0, 1, 7
"d:\IDEWORK\lvmen\src\licensedcode\data\rules\spdx_license_id_gfdl-1.2-or-later_for_gfdl-1.2-plus.yml", "YAML", 0, 0, 0, 6, 0, 0, 1, 7
"d:\IDEWORK\lvmen\src\licensedcode\data\rules\spdx_license_id_gfdl-1.2_for_gfdl-1.2.yml", "YAML", 0, 0, 0, 6, 0, 0, 1, 7
"d:\IDEWORK\lvmen\src\licensedcode\data\rules\spdx_license_id_gfdl-1.3+_for_gfdl-1.3-plus.yml", "YAML", 0, 0, 0, 6, 0, 0, 1, 7
"d:\IDEWORK\lvmen\src\licensedcode\data\rules\spdx_license_id_gfdl-1.3-only_for_gfdl-1.3.yml", "YAML", 0, 0, 0, 6, 0, 0, 1, 7
"d:\IDEWORK\lvmen\src\licensedcode\data\rules\spdx_license_id_gfdl-1.3-or-later_for_gfdl-1.3-plus.yml", "YAML", 0, 0, 0, 6, 0, 0, 1, 7
"d:\IDEWORK\lvmen\src\licensedcode\data\rules\spdx_license_id_gfdl-1.3_for_gfdl-1.3.yml", "YAML", 0, 0, 0, 6, 0, 0, 1, 7
"d:\IDEWORK\lvmen\src\licensedcode\data\rules\spdx_license_id_giftware_for_allegro-4.yml", "YAML", 0, 0, 0, 6, 0, 0, 1, 7
"d:\IDEWORK\lvmen\src\licensedcode\data\rules\spdx_license_id_glulxe_for_glulxe.yml", "YAML", 0, 0, 0, 6, 0, 0, 1, 7
"d:\IDEWORK\lvmen\src\licensedcode\data\rules\spdx_license_id_gnu-javamail-exception_for_gnu-javamail-exception.yml", "YAML", 0, 0, 0, 6, 0, 0, 1, 7
"d:\IDEWORK\lvmen\src\licensedcode\data\rules\spdx_license_id_gpl-1.0+_for_gpl-1.0-plus.yml", "YAML", 0, 0, 0, 6, 0, 0, 1, 7
"d:\IDEWORK\lvmen\src\licensedcode\data\rules\spdx_license_id_gpl-1.0-only_for_gpl-1.0.yml", "YAML", 0, 0, 0, 6, 0, 0, 1, 7
"d:\IDEWORK\lvmen\src\licensedcode\data\rules\spdx_license_id_gpl-1.0-or-later_for_gpl-1.0-plus.yml", "YAML", 0, 0, 0, 6, 0, 0, 1, 7
"d:\IDEWORK\lvmen\src\licensedcode\data\rules\spdx_license_id_gpl-2.0+_for_gpl-2.0-plus.yml", "YAML", 0, 0, 0, 6, 0, 0, 1, 7
"d:\IDEWORK\lvmen\src\licensedcode\data\rules\spdx_license_id_gpl-2.0-only_for_gpl-2.0.yml", "YAML", 0, 0, 0, 6, 0, 0, 1, 7
"d:\IDEWORK\lvmen\src\licensedcode\data\rules\spdx_license_id_gpl-2.0-or-later_for_gpl-2.0-plus.yml", "YAML", 0, 0, 0, 6, 0, 0, 1, 7
"d:\IDEWORK\lvmen\src\licensedcode\data\rules\spdx_license_id_gpl-3.0-only_for_gpl-3.0.yml", "YAML", 0, 0, 0, 6, 0, 0, 1, 7
"d:\IDEWORK\lvmen\src\licensedcode\data\rules\spdx_license_id_gpl-3.0-or-later_for_gpl-3.0-plus.yml", "YAML", 0, 0, 0, 6, 0, 0, 1, 7
"d:\IDEWORK\lvmen\src\licensedcode\data\rules\spdx_license_id_gsoap-1.3b_for_gsoap-1.3b.yml", "YAML", 0, 0, 0, 6, 0, 0, 1, 7
"d:\IDEWORK\lvmen\src\licensedcode\data\rules\spdx_license_id_i2p-gpl-java-exception_for_i2p-gpl-java-exception.yml", "YAML", 0, 0, 0, 6, 0, 0, 1, 7
"d:\IDEWORK\lvmen\src\licensedcode\data\rules\spdx_license_id_imlib2_for_imlib2.yml", "YAML", 0, 0, 0, 6, 0, 0, 1, 7
"d:\IDEWORK\lvmen\src\licensedcode\data\rules\spdx_license_id_ipl-1.0_for_ibmpl-1.0.yml", "YAML", 0, 0, 0, 6, 0, 0, 1, 7
"d:\IDEWORK\lvmen\src\licensedcode\data\rules\spdx_license_id_lgpl-2.0+_for_lgpl-2.0-plus.yml", "YAML", 0, 0, 0, 6, 0, 0, 1, 7
"d:\IDEWORK\lvmen\src\licensedcode\data\rules\spdx_license_id_lgpl-2.0-only_for_lgpl-2.0.yml", "YAML", 0, 0, 0, 6, 0, 0, 1, 7
"d:\IDEWORK\lvmen\src\licensedcode\data\rules\spdx_license_id_lgpl-2.0-or-later_for_lgpl-2.0-plus.yml", "YAML", 0, 0, 0, 6, 0, 0, 1, 7
"d:\IDEWORK\lvmen\src\licensedcode\data\rules\spdx_license_id_lgpl-2.1-only_for_lgpl-2.1.yml", "YAML", 0, 0, 0, 6, 0, 0, 1, 7
"d:\IDEWORK\lvmen\src\licensedcode\data\rules\spdx_license_id_lgpl-2.1-or-later_for_lgpl-2.1-plus.yml", "YAML", 0, 0, 0, 6, 0, 0, 1, 7
"d:\IDEWORK\lvmen\src\licensedcode\data\rules\spdx_license_id_lgpl-3.0-only_for_lgpl-3.0.yml", "YAML", 0, 0, 0, 6, 0, 0, 1, 7
"d:\IDEWORK\lvmen\src\licensedcode\data\rules\spdx_license_id_lgpl-3.0-or-later_for_lgpl-3.0-plus.yml", "YAML", 0, 0, 0, 6, 0, 0, 1, 7
"d:\IDEWORK\lvmen\src\licensedcode\data\rules\spdx_license_id_lgpllr_for_lgpllr.yml", "YAML", 0, 0, 0, 6, 0, 0, 1, 7
"d:\IDEWORK\lvmen\src\licensedcode\data\rules\spdx_license_id_libtool-exception_for_libtool-exception-2.0.yml", "YAML", 0, 0, 0, 6, 0, 0, 1, 7
"d:\IDEWORK\lvmen\src\licensedcode\data\rules\spdx_license_id_licenseref-proprietary-here_for_here-proprietary.yml", "YAML", 0, 0, 0, 6, 0, 0, 1, 7
"d:\IDEWORK\lvmen\src\licensedcode\data\rules\spdx_license_id_linux-syscall-note_for_linux-syscall-exception-gpl.yml", "YAML", 0, 0, 0, 6, 0, 0, 1, 7
"d:\IDEWORK\lvmen\src\licensedcode\data\rules\spdx_license_id_lpl-1.02_for_lucent-pl-1.02.yml", "YAML", 0, 0, 0, 6, 0, 0, 1, 7
"d:\IDEWORK\lvmen\src\licensedcode\data\rules\spdx_license_id_lpl-1.0_for_lucent-pl-1.0.yml", "YAML", 0, 0, 0, 6, 0, 0, 1, 7
"d:\IDEWORK\lvmen\src\licensedcode\data\rules\spdx_license_id_lppl-1.0_for_lppl-1.0.yml", "YAML", 0, 0, 0, 6, 0, 0, 1, 7
"d:\IDEWORK\lvmen\src\licensedcode\data\rules\spdx_license_id_lppl-1.1_for_lppl-1.1.yml", "YAML", 0, 0, 0, 6, 0, 0, 1, 7
"d:\IDEWORK\lvmen\src\licensedcode\data\rules\spdx_license_id_lppl-1.2_for_lppl-1.2.yml", "YAML", 0, 0, 0, 6, 0, 0, 1, 7
"d:\IDEWORK\lvmen\src\licensedcode\data\rules\spdx_license_id_lppl-1.3a_for_lppl-1.3a.yml", "YAML", 0, 0, 0, 6, 0, 0, 1, 7
"d:\IDEWORK\lvmen\src\licensedcode\data\rules\spdx_license_id_lppl-1.3c_for_lppl-1.3c.yml", "YAML", 0, 0, 0, 6, 0, 0, 1, 7
"d:\IDEWORK\lvmen\src\licensedcode\data\rules\spdx_license_id_mif-exception_for_mif-exception.yml", "YAML", 0, 0, 0, 6, 0, 0, 1, 7
"d:\IDEWORK\lvmen\src\licensedcode\data\rules\spdx_license_id_mit-advertising_for_enlightenment.yml", "YAML", 0, 0, 0, 6, 0, 0, 1, 7
"d:\IDEWORK\lvmen\src\licensedcode\data\rules\spdx_license_id_mit-cmu_for_cmu-uc.yml", "YAML", 0, 0, 0, 6, 0, 0, 1, 7
"d:\IDEWORK\lvmen\src\licensedcode\data\rules\spdx_license_id_mit-enna_for_enna.yml", "YAML", 0, 0, 0, 6, 0, 0, 1, 7
"d:\IDEWORK\lvmen\src\licensedcode\data\rules\spdx_license_id_mit-feh_for_mit-ack.yml", "YAML", 0, 0, 0, 6, 0, 0, 1, 7
"d:\IDEWORK\lvmen\src\licensedcode\data\rules\spdx_license_id_mitnfa_for_mit-no-false-attribs.yml", "YAML", 0, 0, 0, 6, 0, 0, 1, 7
"d:\IDEWORK\lvmen\src\licensedcode\data\rules\spdx_license_id_mpl-1.0_for_mpl-1.0.yml", "YAML", 0, 0, 0, 6, 0, 0, 1, 7
"d:\IDEWORK\lvmen\src\licensedcode\data\rules\spdx_license_id_mpl-1.1_for_mpl-1.1.yml", "YAML", 0, 0, 0, 6, 0, 0, 1, 7
"d:\IDEWORK\lvmen\src\licensedcode\data\rules\spdx_license_id_mpl-2.0-no-copyleft-exception_for_mpl-2.0-no-copyleft-exception.yml", "YAML", 0, 0, 0, 6, 0, 0, 1, 7
"d:\IDEWORK\lvmen\src\licensedcode\data\rules\spdx_license_id_mpl-2.0_for_mpl-2.0.yml", "YAML", 0, 0, 0, 6, 0, 0, 1, 7
"d:\IDEWORK\lvmen\src\licensedcode\data\rules\spdx_license_id_nasa-1.3_for_nasa-1.3.yml", "YAML", 0, 0, 0, 6, 0, 0, 1, 7
"d:\IDEWORK\lvmen\src\licensedcode\data\rules\spdx_license_id_nbpl-1.0_for_nbpl-1.0.yml", "YAML", 0, 0, 0, 6, 0, 0, 1, 7
"d:\IDEWORK\lvmen\src\licensedcode\data\rules\spdx_license_id_newsletr_for_newsletr.yml", "YAML", 0, 0, 0, 6, 0, 0, 1, 7
"d:\IDEWORK\lvmen\src\licensedcode\data\rules\spdx_license_id_nlod-1.0_for_nlod-1.0.yml", "YAML", 0, 0, 0, 6, 0, 0, 1, 7
"d:\IDEWORK\lvmen\src\licensedcode\data\rules\spdx_license_id_nosl_for_nosl-1.0.yml", "YAML", 0, 0, 0, 6, 0, 0, 1, 7
"d:\IDEWORK\lvmen\src\licensedcode\data\rules\spdx_license_id_noweb_for_noweb.yml", "YAML", 0, 0, 0, 6, 0, 0, 1, 7
"d:\IDEWORK\lvmen\src\licensedcode\data\rules\spdx_license_id_npl-1.0_for_npl-1.0.yml", "YAML", 0, 0, 0, 6, 0, 0, 1, 7
"d:\IDEWORK\lvmen\src\licensedcode\data\rules\spdx_license_id_npl-1.1_for_npl-1.1.yml", "YAML", 0, 0, 0, 6, 0, 0, 1, 7
"d:\IDEWORK\lvmen\src\licensedcode\data\rules\spdx_license_id_nposl-3.0_for_nosl-3.0.yml", "YAML", 0, 0, 0, 6, 0, 0, 1, 7
"d:\IDEWORK\lvmen\src\licensedcode\data\rules\spdx_license_id_occt-exception-1.0_for_occt-exception-1.0.yml", "YAML", 0, 0, 0, 6, 0, 0, 1, 7
"d:\IDEWORK\lvmen\src\licensedcode\data\rules\spdx_license_id_occt-pl_for_occt-pl.yml", "YAML", 0, 0, 0, 6, 0, 0, 1, 7
"d:\IDEWORK\lvmen\src\licensedcode\data\rules\spdx_license_id_oclc-2.0_for_oclc-2.0.yml", "YAML", 0, 0, 0, 6, 0, 0, 1, 7
"d:\IDEWORK\lvmen\src\licensedcode\data\rules\spdx_license_id_odbl-1.0_for_odbl-1.0.yml", "YAML", 0, 0, 0, 6, 0, 0, 1, 7
"d:\IDEWORK\lvmen\src\licensedcode\data\rules\spdx_license_id_ofl-1.0_for_ofl-1.0.yml", "YAML", 0, 0, 0, 6, 0, 0, 1, 7
"d:\IDEWORK\lvmen\src\licensedcode\data\rules\spdx_license_id_ofl-1.1_for_ofl-1.1.yml", "YAML", 0, 0, 0, 6, 0, 0, 1, 7
"d:\IDEWORK\lvmen\src\licensedcode\data\rules\spdx_license_id_ogtsl_for_opengroup.yml", "YAML", 0, 0, 0, 6, 0, 0, 1, 7
"d:\IDEWORK\lvmen\src\licensedcode\data\rules\spdx_license_id_oldap-1.1_for_openldap-1.1.yml", "YAML", 0, 0, 0, 6, 0, 0, 1, 7
"d:\IDEWORK\lvmen\src\licensedcode\data\rules\spdx_license_id_oldap-1.2_for_openldap-1.2.yml", "YAML", 0, 0, 0, 6, 0, 0, 1, 7
"d:\IDEWORK\lvmen\src\licensedcode\data\rules\spdx_license_id_oldap-1.3_for_openldap-1.3.yml", "YAML", 0, 0, 0, 6, 0, 0, 1, 7
"d:\IDEWORK\lvmen\src\licensedcode\data\rules\spdx_license_id_oldap-1.4_for_openldap-1.4.yml", "YAML", 0, 0, 0, 6, 0, 0, 1, 7
"d:\IDEWORK\lvmen\src\licensedcode\data\rules\spdx_license_id_oldap-2.0.1_for_openldap-2.0.1.yml", "YAML", 0, 0, 0, 6, 0, 0, 1, 7
"d:\IDEWORK\lvmen\src\licensedcode\data\rules\spdx_license_id_oldap-2.0_for_openldap-2.0.yml", "YAML", 0, 0, 0, 6, 0, 0, 1, 7
"d:\IDEWORK\lvmen\src\licensedcode\data\rules\spdx_license_id_oldap-2.1_for_openldap-2.1.yml", "YAML", 0, 0, 0, 6, 0, 0, 1, 7
"d:\IDEWORK\lvmen\src\licensedcode\data\rules\spdx_license_id_oldap-2.2.1_for_openldap-2.2.1.yml", "YAML", 0, 0, 0, 6, 0, 0, 1, 7
"d:\IDEWORK\lvmen\src\licensedcode\data\rules\spdx_license_id_oldap-2.2.2_for_openldap-2.2.2.yml", "YAML", 0, 0, 0, 6, 0, 0, 1, 7
"d:\IDEWORK\lvmen\src\licensedcode\data\rules\spdx_license_id_oldap-2.2_for_openldap-2.2.yml", "YAML", 0, 0, 0, 6, 0, 0, 1, 7
"d:\IDEWORK\lvmen\src\licensedcode\data\rules\spdx_license_id_oldap-2.3_for_openldap-2.3.yml", "YAML", 0, 0, 0, 6, 0, 0, 1, 7
"d:\IDEWORK\lvmen\src\licensedcode\data\rules\spdx_license_id_oldap-2.4_for_openldap-2.4.yml", "YAML", 0, 0, 0, 6, 0, 0, 1, 7
"d:\IDEWORK\lvmen\src\licensedcode\data\rules\spdx_license_id_oldap-2.5_for_openldap-2.5.yml", "YAML", 0, 0, 0, 6, 0, 0, 1, 7
"d:\IDEWORK\lvmen\src\licensedcode\data\rules\spdx_license_id_oldap-2.6_for_openldap-2.6.yml", "YAML", 0, 0, 0, 6, 0, 0, 1, 7
"d:\IDEWORK\lvmen\src\licensedcode\data\rules\spdx_license_id_oldap-2.7_for_openldap-2.7.yml", "YAML", 0, 0, 0, 6, 0, 0, 1, 7
"d:\IDEWORK\lvmen\src\licensedcode\data\rules\spdx_license_id_oldap-2.8_for_openldap-2.8.yml", "YAML", 0, 0, 0, 6, 0, 0, 1, 7
"d:\IDEWORK\lvmen\src\licensedcode\data\rules\spdx_license_id_openjdk-assembly-exception-1.0_for_openjdk-assembly-exception-1.0.yml", "YAML", 0, 0, 0, 6, 0, 0, 1, 7
"d:\IDEWORK\lvmen\src\licensedcode\data\rules\spdx_license_id_openvpn-openssl-exception_for_openvpn-openssl-exception.yml", "YAML", 0, 0, 0, 6, 0, 0, 1, 7
"d:\IDEWORK\lvmen\src\licensedcode\data\rules\spdx_license_id_opl-1.0_for_open-public.yml", "YAML", 0, 0, 0, 6, 0, 0, 1, 7
"d:\IDEWORK\lvmen\src\licensedcode\data\rules\spdx_license_id_oset-pl-2.1_for_oset-pl-2.1.yml", "YAML", 0, 0, 0, 6, 0, 0, 1, 7
"d:\IDEWORK\lvmen\src\licensedcode\data\rules\spdx_license_id_osl-1.0_for_osl-1.0.yml", "YAML", 0, 0, 0, 6, 0, 0, 1, 7
"d:\IDEWORK\lvmen\src\licensedcode\data\rules\spdx_license_id_osl-1.1_for_osl-1.1.yml", "YAML", 0, 0, 0, 6, 0, 0, 1, 7
"d:\IDEWORK\lvmen\src\licensedcode\data\rules\spdx_license_id_osl-2.0_for_osl-2.0.yml", "YAML", 0, 0, 0, 6, 0, 0, 1, 7
"d:\IDEWORK\lvmen\src\licensedcode\data\rules\spdx_license_id_osl-2.1_for_osl-2.1.yml", "YAML", 0, 0, 0, 6, 0, 0, 1, 7
"d:\IDEWORK\lvmen\src\licensedcode\data\rules\spdx_license_id_osl-3.0_for_osl-3.0.yml", "YAML", 0, 0, 0, 6, 0, 0, 1, 7
"d:\IDEWORK\lvmen\src\licensedcode\data\rules\spdx_license_id_pddl-1.0_for_pddl-1.0.yml", "YAML", 0, 0, 0, 6, 0, 0, 1, 7
"d:\IDEWORK\lvmen\src\licensedcode\data\rules\spdx_license_id_qpl-1.0_for_qpl-1.0.yml", "YAML", 0, 0, 0, 6, 0, 0, 1, 7
"d:\IDEWORK\lvmen\src\licensedcode\data\rules\spdx_license_id_qwt-exception-1.0_for_qwt-exception-1.0.yml", "YAML", 0, 0, 0, 6, 0, 0, 1, 7
"d:\IDEWORK\lvmen\src\licensedcode\data\rules\spdx_license_id_rhecos-1.1_for_ecosrh-1.1.yml", "YAML", 0, 0, 0, 6, 0, 0, 1, 7
"d:\IDEWORK\lvmen\src\licensedcode\data\rules\spdx_license_id_rpl-1.1_for_rpl-1.1.yml", "YAML", 0, 0, 0, 6, 0, 0, 1, 7
"d:\IDEWORK\lvmen\src\licensedcode\data\rules\spdx_license_id_rpl-1.5_for_rpl-1.5.yml", "YAML", 0, 0, 0, 6, 0, 0, 1, 7
"d:\IDEWORK\lvmen\src\licensedcode\data\rules\spdx_license_id_rpsl-1.0_for_rpsl-1.0.yml", "YAML", 0, 0, 0, 6, 0, 0, 1, 7
"d:\IDEWORK\lvmen\src\licensedcode\data\rules\spdx_license_id_sax-pd_for_sax-pd.yml", "YAML", 0, 0, 0, 6, 0, 0, 1, 7
"d:\IDEWORK\lvmen\src\licensedcode\data\rules\spdx_license_id_sgi-b-1.0_for_sgi-fslb-1.0.yml", "YAML", 0, 0, 0, 6, 0, 0, 1, 7
"d:\IDEWORK\lvmen\src\licensedcode\data\rules\spdx_license_id_sgi-b-1.1_for_sgi-freeb-1.1.yml", "YAML", 0, 0, 0, 6, 0, 0, 1, 7
"d:\IDEWORK\lvmen\src\licensedcode\data\rules\spdx_license_id_sgi-b-2.0_for_sgi-freeb-2.0.yml", "YAML", 0, 0, 0, 6, 0, 0, 1, 7
"d:\IDEWORK\lvmen\src\licensedcode\data\rules\spdx_license_id_simpl-2.0_for_simpl-2.0.yml", "YAML", 0, 0, 0, 6, 0, 0, 1, 7
"d:\IDEWORK\lvmen\src\licensedcode\data\rules\spdx_license_id_sissl-1.2_for_sun-sissl-1.2.yml", "YAML", 0, 0, 0, 6, 0, 0, 1, 7
"d:\IDEWORK\lvmen\src\licensedcode\data\rules\spdx_license_id_sissl_for_sun-sissl-1.1.yml", "YAML", 0, 0, 0, 6, 0, 0, 1, 7
"d:\IDEWORK\lvmen\src\licensedcode\data\rules\spdx_license_id_spencer-86_for_regexp.yml", "YAML", 0, 0, 0, 6, 0, 0, 1, 7
"d:\IDEWORK\lvmen\src\licensedcode\data\rules\spdx_license_id_spencer-94_for_hs-regexp.yml", "YAML", 0, 0, 0, 6, 0, 0, 1, 7
"d:\IDEWORK\lvmen\src\licensedcode\data\rules\spdx_license_id_spencer-99_for_henry-spencer-1999.yml", "YAML", 0, 0, 0, 6, 0, 0, 1, 7
"d:\IDEWORK\lvmen\src\licensedcode\data\rules\spdx_license_id_spl-1.0_for_spl-1.0.yml", "YAML", 0, 0, 0, 6, 0, 0, 1, 7
"d:\IDEWORK\lvmen\src\licensedcode\data\rules\spdx_license_id_sugarcrm-1.1.3_for_sugarcrm-1.1.3.yml", "YAML", 0, 0, 0, 6, 0, 0, 1, 7
"d:\IDEWORK\lvmen\src\licensedcode\data\rules\spdx_license_id_torque-1.1_for_torque-1.1.yml", "YAML", 0, 0, 0, 6, 0, 0, 1, 7
"d:\IDEWORK\lvmen\src\licensedcode\data\rules\spdx_license_id_u-boot-exception-2.0_for_u-boot-exception-2.0.yml", "YAML", 0, 0, 0, 6, 0, 0, 1, 7
"d:\IDEWORK\lvmen\src\licensedcode\data\rules\spdx_license_id_unicode-dfs-2015_for_unicode-dfs-2015.yml", "YAML", 0, 0, 0, 6, 0, 0, 1, 7
"d:\IDEWORK\lvmen\src\licensedcode\data\rules\spdx_license_id_unicode-dfs-2016_for_unicode-dfs-2016.yml", "YAML", 0, 0, 0, 6, 0, 0, 1, 7
"d:\IDEWORK\lvmen\src\licensedcode\data\rules\spdx_license_id_unicode-tou_for_unicode-tou.yml", "YAML", 0, 0, 0, 6, 0, 0, 1, 7
"d:\IDEWORK\lvmen\src\licensedcode\data\rules\spdx_license_id_unlicense_for_unlicense.yml", "YAML", 0, 0, 0, 6, 0, 0, 1, 7
"d:\IDEWORK\lvmen\src\licensedcode\data\rules\spdx_license_id_upl-1.0_for_upl-1.0.yml", "YAML", 0, 0, 0, 6, 0, 0, 1, 7
"d:\IDEWORK\lvmen\src\licensedcode\data\rules\spdx_license_id_vsl-1.0_for_vsl-1.0.yml", "YAML", 0, 0, 0, 6, 0, 0, 1, 7
"d:\IDEWORK\lvmen\src\licensedcode\data\rules\spdx_license_id_w3c-19980720_for_w3c-software-19980720.yml", "YAML", 0, 0, 0, 6, 0, 0, 1, 7
"d:\IDEWORK\lvmen\src\licensedcode\data\rules\spdx_license_id_w3c-20150513_for_w3c-software-doc-20150513.yml", "YAML", 0, 0, 0, 6, 0, 0, 1, 7
"d:\IDEWORK\lvmen\src\licensedcode\data\rules\spdx_license_id_watcom-1.0_for_sybase.yml", "YAML", 0, 0, 0, 6, 0, 0, 1, 7
"d:\IDEWORK\lvmen\src\licensedcode\data\rules\spdx_license_id_wtfpl_for_wtfpl-2.0.yml", "YAML", 0, 0, 0, 6, 0, 0, 1, 7
"d:\IDEWORK\lvmen\src\licensedcode\data\rules\spdx_license_id_wxwindows-exception-3.1_for_wxwindows-exception-3.1.yml", "YAML", 0, 0, 0, 6, 0, 0, 1, 7
"d:\IDEWORK\lvmen\src\licensedcode\data\rules\spdx_license_id_xfree86-1.1_for_xfree86-1.1.yml", "YAML", 0, 0, 0, 6, 0, 0, 1, 7
"d:\IDEWORK\lvmen\src\licensedcode\data\rules\spdx_license_id_ypl-1.0_for_ypl-1.0.yml", "YAML", 0, 0, 0, 6, 0, 0, 1, 7
"d:\IDEWORK\lvmen\src\licensedcode\data\rules\spdx_license_id_ypl-1.1_for_ypl-1.1.yml", "YAML", 0, 0, 0, 6, 0, 0, 1, 7
"d:\IDEWORK\lvmen\src\licensedcode\data\rules\spdx_license_id_zimbra-1.3_for_zimbra-1.3.yml", "YAML", 0, 0, 0, 6, 0, 0, 1, 7
"d:\IDEWORK\lvmen\src\licensedcode\data\rules\spdx_license_id_zimbra-1.4_for_zimbra-1.4.yml", "YAML", 0, 0, 0, 6, 0, 0, 1, 7
"d:\IDEWORK\lvmen\src\licensedcode\data\rules\spdx_license_id_zlib-acknowledgement_for_zlib-acknowledgement.yml", "YAML", 0, 0, 0, 6, 0, 0, 1, 7
"d:\IDEWORK\lvmen\src\licensedcode\data\rules\spdx_license_id_zpl-1.1_for_zpl-1.1.yml", "YAML", 0, 0, 0, 6, 0, 0, 1, 7
"d:\IDEWORK\lvmen\src\licensedcode\data\rules\spdx_license_id_zpl-2.0_for_zpl-2.0.yml", "YAML", 0, 0, 0, 6, 0, 0, 1, 7
"d:\IDEWORK\lvmen\src\licensedcode\data\rules\spdx_license_id_zpl-2.1_for_zpl-2.1.yml", "YAML", 0, 0, 0, 6, 0, 0, 1, 7
"d:\IDEWORK\lvmen\src\licensedcode\data\rules\speechworks-1.1.yml", "YAML", 0, 0, 0, 5, 0, 0, 1, 6
"d:\IDEWORK\lvmen\src\licensedcode\data\rules\spell-checker-exception-lgpl-2.1-plus_1.yml", "YAML", 0, 0, 0, 2, 0, 0, 1, 3
"d:\IDEWORK\lvmen\src\licensedcode\data\rules\spl-1.0.SPDX.yml", "YAML", 0, 0, 0, 6, 0, 0, 1, 7
"d:\IDEWORK\lvmen\src\licensedcode\data\rules\spl-1.0.yml", "YAML", 0, 0, 0, 5, 0, 0, 1, 6
"d:\IDEWORK\lvmen\src\licensedcode\data\rules\spl-1.0_1.yml", "YAML", 0, 0, 0, 5, 0, 0, 1, 6
"d:\IDEWORK\lvmen\src\licensedcode\data\rules\spl-1.0_10.yml", "YAML", 0, 0, 0, 5, 0, 0, 1, 6
"d:\IDEWORK\lvmen\src\licensedcode\data\rules\spl-1.0_2.yml", "YAML", 0, 0, 0, 5, 0, 0, 1, 6
"d:\IDEWORK\lvmen\src\licensedcode\data\rules\spl-1.0_3.yml", "YAML", 0, 0, 0, 5, 0, 0, 1, 6
"d:\IDEWORK\lvmen\src\licensedcode\data\rules\spl-1.0_4.yml", "YAML", 0, 0, 0, 5, 0, 0, 1, 6
"d:\IDEWORK\lvmen\src\licensedcode\data\rules\spl-1.0_5.yml", "YAML", 0, 0, 0, 5, 0, 0, 1, 6
"d:\IDEWORK\lvmen\src\licensedcode\data\rules\spl-1.0_6.yml", "YAML", 0, 0, 0, 3, 0, 0, 1, 4
"d:\IDEWORK\lvmen\src\licensedcode\data\rules\spl-1.0_7.yml", "YAML", 0, 0, 0, 5, 0, 0, 1, 6
"d:\IDEWORK\lvmen\src\licensedcode\data\rules\spl-1.0_8.yml", "YAML", 0, 0, 0, 4, 0, 0, 1, 5
"d:\IDEWORK\lvmen\src\licensedcode\data\rules\spl-1.0_9.yml", "YAML", 0, 0, 0, 3, 0, 0, 1, 4
"d:\IDEWORK\lvmen\src\licensedcode\data\rules\spl-1.0_or_lgpl-2.1-plus_1.yml", "YAML", 0, 0, 0, 6, 0, 0, 1, 7
"d:\IDEWORK\lvmen\src\licensedcode\data\rules\spl-1.0_or_lgpl-2.1-plus_2.yml", "YAML", 0, 0, 0, 5, 0, 0, 1, 6
"d:\IDEWORK\lvmen\src\licensedcode\data\rules\spl-1.0_url_1.yml", "YAML", 0, 0, 0, 5, 0, 0, 1, 6
"d:\IDEWORK\lvmen\src\licensedcode\data\rules\spl-1.0_url_2.yml", "YAML", 0, 0, 0, 5, 0, 0, 1, 6
"d:\IDEWORK\lvmen\src\licensedcode\data\rules\spl-1.0_url_glc_234.yml", "YAML", 0, 0, 0, 5, 0, 0, 1, 6
"d:\IDEWORK\lvmen\src\licensedcode\data\rules\spl-1.0_url_glc_235.yml", "YAML", 0, 0, 0, 5, 0, 0, 1, 6
"d:\IDEWORK\lvmen\src\licensedcode\data\rules\squeak.yml", "YAML", 0, 0, 0, 5, 0, 0, 1, 6
"d:\IDEWORK\lvmen\src\licensedcode\data\rules\srgb_1.yml", "YAML", 0, 0, 0, 2, 0, 0, 1, 3
"d:\IDEWORK\lvmen\src\licensedcode\data\rules\srgb_2.yml", "YAML", 0, 0, 0, 3, 0, 0, 1, 4
"d:\IDEWORK\lvmen\src\licensedcode\data\rules\srgb_3.yml", "YAML", 0, 0, 0, 3, 0, 0, 1, 4
"d:\IDEWORK\lvmen\src\licensedcode\data\rules\srgb_4.yml", "YAML", 0, 0, 0, 3, 0, 0, 1, 4
"d:\IDEWORK\lvmen\src\licensedcode\data\rules\ssleay-windows.yml", "YAML", 0, 0, 0, 5, 0, 0, 1, 6
"d:\IDEWORK\lvmen\src\licensedcode\data\rules\ssleay-windows_1.yml", "YAML", 0, 0, 0, 12, 0, 0, 1, 13
"d:\IDEWORK\lvmen\src\licensedcode\data\rules\ssleay-windows_2.yml", "YAML", 0, 0, 0, 13, 0, 0, 1, 14
"d:\IDEWORK\lvmen\src\licensedcode\data\rules\ssleay-windows_3.yml", "YAML", 0, 0, 0, 12, 0, 0, 1, 13
"d:\IDEWORK\lvmen\src\licensedcode\data\rules\ssleay-windows_4.yml", "YAML", 0, 0, 0, 12, 0, 0, 1, 13
"d:\IDEWORK\lvmen\src\licensedcode\data\rules\ssleay-windows_5.yml", "YAML", 0, 0, 0, 7, 0, 0, 1, 8
"d:\IDEWORK\lvmen\src\licensedcode\data\rules\ssleay-windows_6.yml", "YAML", 0, 0, 0, 9, 0, 0, 1, 10
"d:\IDEWORK\lvmen\src\licensedcode\data\rules\ssleay-windows_7.yml", "YAML", 0, 0, 0, 7, 0, 0, 1, 8
"d:\IDEWORK\lvmen\src\licensedcode\data\rules\ssleay-windows_8.yml", "YAML", 0, 0, 0, 12, 0, 0, 1, 13
"d:\IDEWORK\lvmen\src\licensedcode\data\rules\ssleay_1.yml", "YAML", 0, 0, 0, 4, 0, 0, 1, 5
"d:\IDEWORK\lvmen\src\licensedcode\data\rules\ssleay_3.yml", "YAML", 0, 0, 0, 9, 0, 0, 1, 10
"d:\IDEWORK\lvmen\src\licensedcode\data\rules\ssleay_4.yml", "YAML", 0, 0, 0, 10, 0, 0, 1, 11
"d:\IDEWORK\lvmen\src\licensedcode\data\rules\ssleay_5.yml", "YAML", 0, 0, 0, 13, 0, 0, 1, 14
"d:\IDEWORK\lvmen\src\licensedcode\data\rules\st-mcd-2.0_1.yml", "YAML", 0, 0, 0, 4, 0, 0, 1, 5
"d:\IDEWORK\lvmen\src\licensedcode\data\rules\st-mcd-2.0_2.yml", "YAML", 0, 0, 0, 5, 0, 0, 1, 6
"d:\IDEWORK\lvmen\src\licensedcode\data\rules\st-mcd-2.0_3.yml", "YAML", 0, 0, 0, 5, 0, 0, 1, 6
"d:\IDEWORK\lvmen\src\licensedcode\data\rules\st-mcd-2.0_4.yml", "YAML", 0, 0, 0, 3, 0, 0, 1, 4
"d:\IDEWORK\lvmen\src\licensedcode\data\rules\st-mcd-2.0_5.yml", "YAML", 0, 0, 0, 3, 0, 0, 1, 4
"d:\IDEWORK\lvmen\src\licensedcode\data\rules\st-mcd-2.0_6.yml", "YAML", 0, 0, 0, 5, 0, 0, 1, 6
"d:\IDEWORK\lvmen\src\licensedcode\data\rules\st-mcd-2.0_7.yml", "YAML", 0, 0, 0, 3, 0, 0, 1, 4
"d:\IDEWORK\lvmen\src\licensedcode\data\rules\st-mcd-2.0_8.yml", "YAML", 0, 0, 0, 3, 0, 0, 1, 4
"d:\IDEWORK\lvmen\src\licensedcode\data\rules\st-mcd-2.0_9.yml", "YAML", 0, 0, 0, 5, 0, 0, 1, 6
"d:\IDEWORK\lvmen\src\licensedcode\data\rules\st-mcd-2.0_and_cc-by-sa-3.0_1.yml", "YAML", 0, 0, 0, 6, 0, 0, 1, 7
"d:\IDEWORK\lvmen\src\licensedcode\data\rules\standard-ml-nj.yml", "YAML", 0, 0, 0, 2, 0, 0, 1, 3
"d:\IDEWORK\lvmen\src\licensedcode\data\rules\standard-ml-nj_1.yml", "YAML", 0, 0, 0, 3, 0, 0, 1, 4
"d:\IDEWORK\lvmen\src\licensedcode\data\rules\standard-ml-nj_10.yml", "YAML", 0, 0, 0, 4, 0, 0, 1, 5
"d:\IDEWORK\lvmen\src\licensedcode\data\rules\standard-ml-nj_11.yml", "YAML", 0, 0, 0, 3, 0, 0, 1, 4
"d:\IDEWORK\lvmen\src\licensedcode\data\rules\standard-ml-nj_12.yml", "YAML", 0, 0, 0, 4, 0, 0, 1, 5
"d:\IDEWORK\lvmen\src\licensedcode\data\rules\standard-ml-nj_13.yml", "YAML", 0, 0, 0, 6, 0, 0, 1, 7
"d:\IDEWORK\lvmen\src\licensedcode\data\rules\standard-ml-nj_2.yml", "YAML", 0, 0, 0, 3, 0, 0, 1, 4
"d:\IDEWORK\lvmen\src\licensedcode\data\rules\standard-ml-nj_3.yml", "YAML", 0, 0, 0, 3, 0, 0, 1, 4
"d:\IDEWORK\lvmen\src\licensedcode\data\rules\standard-ml-nj_4.yml", "YAML", 0, 0, 0, 3, 0, 0, 1, 4
"d:\IDEWORK\lvmen\src\licensedcode\data\rules\standard-ml-nj_5.yml", "YAML", 0, 0, 0, 6, 0, 0, 1, 7
"d:\IDEWORK\lvmen\src\licensedcode\data\rules\standard-ml-nj_6.yml", "YAML", 0, 0, 0, 3, 0, 0, 1, 4
"d:\IDEWORK\lvmen\src\licensedcode\data\rules\standard-ml-nj_7.yml", "YAML", 0, 0, 0, 3, 0, 0, 1, 4
"d:\IDEWORK\lvmen\src\licensedcode\data\rules\standard-ml-nj_8.yml", "YAML", 0, 0, 0, 3, 0, 0, 1, 4
"d:\IDEWORK\lvmen\src\licensedcode\data\rules\standard-ml-nj_9.yml", "YAML", 0, 0, 0, 4, 0, 0, 1, 5
"d:\IDEWORK\lvmen\src\licensedcode\data\rules\standard-ml-nj_url_1.yml", "YAML", 0, 0, 0, 5, 0, 0, 1, 6
"d:\IDEWORK\lvmen\src\licensedcode\data\rules\standard-ml-nj_url_2.yml", "YAML", 0, 0, 0, 5, 0, 0, 1, 6
"d:\IDEWORK\lvmen\src\licensedcode\data\rules\stanford-pvrg.yml", "YAML", 0, 0, 0, 5, 0, 0, 1, 6
"d:\IDEWORK\lvmen\src\licensedcode\data\rules\stanford-pvrg_1.yml", "YAML", 0, 0, 0, 4, 0, 0, 1, 5
"d:\IDEWORK\lvmen\src\licensedcode\data\rules\stanford-pvrg_2.yml", "YAML", 0, 0, 0, 4, 0, 0, 1, 5
"d:\IDEWORK\lvmen\src\licensedcode\data\rules\statewizard2.yml", "YAML", 0, 0, 0, 3, 0, 0, 1, 4
"d:\IDEWORK\lvmen\src\licensedcode\data\rules\stlport-4.5.yml", "YAML", 0, 0, 0, 3, 0, 0, 1, 4
"d:\IDEWORK\lvmen\src\licensedcode\data\rules\stlport-4.5_2.yml", "YAML", 0, 0, 0, 3, 0, 0, 1, 4
"d:\IDEWORK\lvmen\src\licensedcode\data\rules\strongswan-exception_1.yml", "YAML", 0, 0, 0, 2, 0, 0, 1, 3
"d:\IDEWORK\lvmen\src\licensedcode\data\rules\sugarcrm-1.1.3.yml", "YAML", 0, 0, 0, 5, 0, 0, 1, 6
"d:\IDEWORK\lvmen\src\licensedcode\data\rules\sugarcrm-1.1.3_1.yml", "YAML", 0, 0, 0, 3, 0, 0, 1, 4
"d:\IDEWORK\lvmen\src\licensedcode\data\rules\sugarcrm-1.1.3_2.yml", "YAML", 0, 0, 0, 3, 0, 0, 1, 4
"d:\IDEWORK\lvmen\src\licensedcode\data\rules\sugarcrm-1.1.3_3.yml", "YAML", 0, 0, 0, 11, 0, 0, 1, 12
"d:\IDEWORK\lvmen\src\licensedcode\data\rules\sugarcrm-1.1.3_url_1.yml", "YAML", 0, 0, 0, 5, 0, 0, 1, 6
"d:\IDEWORK\lvmen\src\licensedcode\data\rules\sugarcrm-1.1.3_url_2.yml", "YAML", 0, 0, 0, 5, 0, 0, 1, 6
"d:\IDEWORK\lvmen\src\licensedcode\data\rules\sun-bcl-11-06_2.yml", "YAML", 0, 0, 0, 3, 0, 0, 1, 4
"d:\IDEWORK\lvmen\src\licensedcode\data\rules\sun-bcl-j2re-5.0.yml", "YAML", 0, 0, 0, 5, 0, 0, 1, 6
"d:\IDEWORK\lvmen\src\licensedcode\data\rules\sun-bcl-sdk-1.4.2_1.yml", "YAML", 0, 0, 0, 8, 0, 0, 1, 9
"d:\IDEWORK\lvmen\src\licensedcode\data\rules\sun-bcl-sdk-1.4.2_2.yml", "YAML", 0, 0, 0, 3, 0, 0, 1, 4
"d:\IDEWORK\lvmen\src\licensedcode\data\rules\sun-bcl-sdk-1.4.2_3.yml", "YAML", 0, 0, 0, 3, 0, 0, 1, 4
"d:\IDEWORK\lvmen\src\licensedcode\data\rules\sun-bcl-sdk-5.0.yml", "YAML", 0, 0, 0, 5, 0, 0, 1, 6
"d:\IDEWORK\lvmen\src\licensedcode\data\rules\sun-bcl-sdk-5.0_1.yml", "YAML", 0, 0, 0, 3, 0, 0, 1, 4
"d:\IDEWORK\lvmen\src\licensedcode\data\rules\sun-bsd-extra_1.yml", "YAML", 0, 0, 0, 4, 0, 0, 1, 5
"d:\IDEWORK\lvmen\src\licensedcode\data\rules\sun-bsd-no-nuclear_1.yml", "YAML", 0, 0, 0, 2, 0, 0, 1, 3
"d:\IDEWORK\lvmen\src\licensedcode\data\rules\sun-bsd-no-nuclear_2.yml", "YAML", 0, 0, 0, 2, 0, 0, 1, 3
"d:\IDEWORK\lvmen\src\licensedcode\data\rules\sun-bsd-no-nuclear_3.yml", "YAML", 0, 0, 0, 4, 0, 0, 1, 5
"d:\IDEWORK\lvmen\src\licensedcode\data\rules\sun-bsd-no-nuclear_itext_1.yml", "YAML", 0, 0, 0, 8, 0, 0, 1, 9
"d:\IDEWORK\lvmen\src\licensedcode\data\rules\sun-bsd-no-nuclear_itext_2.yml", "YAML", 0, 0, 0, 8, 0, 0, 1, 9
"d:\IDEWORK\lvmen\src\licensedcode\data\rules\sun-bsd-no-nuclear_itext_3.yml", "YAML", 0, 0, 0, 4, 0, 0, 1, 5
"d:\IDEWORK\lvmen\src\licensedcode\data\rules\sun-bsd-no-nuclear_itext_unicode_1.yml", "YAML", 0, 0, 0, 13, 0, 0, 1, 14
"d:\IDEWORK\lvmen\src\licensedcode\data\rules\sun-bsd-no-nuclear_url_1.yml", "YAML", 0, 0, 0, 5, 0, 0, 1, 6
"d:\IDEWORK\lvmen\src\licensedcode\data\rules\sun-bsd-no-nuclear_url_2.yml", "YAML", 0, 0, 0, 5, 0, 0, 1, 6
"d:\IDEWORK\lvmen\src\licensedcode\data\rules\sun-ejb-spec-2.1.yml", "YAML", 0, 0, 0, 3, 0, 0, 1, 4
"d:\IDEWORK\lvmen\src\licensedcode\data\rules\sun-ejb-spec-2.1_1.yml", "YAML", 0, 0, 0, 3, 0, 0, 1, 4
"d:\IDEWORK\lvmen\src\licensedcode\data\rules\sun-ejb-spec-2.1_2.yml", "YAML", 0, 0, 0, 3, 0, 0, 1, 4
"d:\IDEWORK\lvmen\src\licensedcode\data\rules\sun-entitlement-jaf.yml", "YAML", 0, 0, 0, 6, 0, 0, 1, 7
"d:\IDEWORK\lvmen\src\licensedcode\data\rules\sun-entitlement-jaf2.yml", "YAML", 0, 0, 0, 6, 0, 0, 1, 7
"d:\IDEWORK\lvmen\src\licensedcode\data\rules\sun-glassfish.yml", "YAML", 0, 0, 0, 5, 0, 0, 1, 6
"d:\IDEWORK\lvmen\src\licensedcode\data\rules\sun-java-web-services-dev-pack-1.6.yml", "YAML", 0, 0, 0, 6, 0, 0, 1, 7
"d:\IDEWORK\lvmen\src\licensedcode\data\rules\sun-jsr-spec-01-2006_1.yml", "YAML", 0, 0, 0, 4, 0, 0, 1, 5
"d:\IDEWORK\lvmen\src\licensedcode\data\rules\sun-jta-spec-1.0.1.yml", "YAML", 0, 0, 0, 5, 0, 0, 1, 6
"d:\IDEWORK\lvmen\src\licensedcode\data\rules\sun-jta-spec-1.0.2.yml", "YAML", 0, 0, 0, 7, 0, 0, 1, 8
"d:\IDEWORK\lvmen\src\licensedcode\data\rules\sun-proprietary-jdk.yml", "YAML", 0, 0, 0, 3, 0, 0, 1, 4
"d:\IDEWORK\lvmen\src\licensedcode\data\rules\sun-rpc.yml", "YAML", 0, 0, 0, 5, 0, 0, 1, 6
"d:\IDEWORK\lvmen\src\licensedcode\data\rules\sun-sissl-1.1.SPDX.yml", "YAML", 0, 0, 0, 7, 0, 0, 1, 8
"d:\IDEWORK\lvmen\src\licensedcode\data\rules\sun-sissl-1.1.yml", "YAML", 0, 0, 0, 5, 0, 0, 1, 6
"d:\IDEWORK\lvmen\src\licensedcode\data\rules\sun-sissl-1.1_1.yml", "YAML", 0, 0, 0, 3, 0, 0, 1, 4
"d:\IDEWORK\lvmen\src\licensedcode\data\rules\sun-sissl-1.1_2.yml", "YAML", 0, 0, 0, 5, 0, 0, 1, 6
"d:\IDEWORK\lvmen\src\licensedcode\data\rules\sun-sissl-1.1_3.yml", "YAML", 0, 0, 0, 6, 0, 0, 1, 7
"d:\IDEWORK\lvmen\src\licensedcode\data\rules\sun-sissl-1.1_4.yml", "YAML", 0, 0, 0, 3, 0, 0, 1, 4
"d:\IDEWORK\lvmen\src\licensedcode\data\rules\sun-sissl-1.1_5.yml", "YAML", 0, 0, 0, 3, 0, 0, 1, 4
"d:\IDEWORK\lvmen\src\licensedcode\data\rules\sun-sissl-1.1_url_1.yml", "YAML", 0, 0, 0, 5, 0, 0, 1, 6
"d:\IDEWORK\lvmen\src\licensedcode\data\rules\sun-sissl-1.1_url_2.yml", "YAML", 0, 0, 0, 5, 0, 0, 1, 6
"d:\IDEWORK\lvmen\src\licensedcode\data\rules\sun-sissl-1.1_url_glc_108.yml", "YAML", 0, 0, 0, 5, 0, 0, 1, 6
"d:\IDEWORK\lvmen\src\licensedcode\data\rules\sun-sissl-1.1_url_glc_109.yml", "YAML", 0, 0, 0, 5, 0, 0, 1, 6
"d:\IDEWORK\lvmen\src\licensedcode\data\rules\sun-sissl-1.2_url_1.yml", "YAML", 0, 0, 0, 5, 0, 0, 1, 6
"d:\IDEWORK\lvmen\src\licensedcode\data\rules\sun-sissl-1.2_url_2.yml", "YAML", 0, 0, 0, 5, 0, 0, 1, 6
"d:\IDEWORK\lvmen\src\licensedcode\data\rules\sun-source_1.yml", "YAML", 0, 0, 0, 2, 0, 0, 1, 3
"d:\IDEWORK\lvmen\src\licensedcode\data\rules\sun-ssscfr-1.1.yml", "YAML", 0, 0, 0, 5, 0, 0, 1, 6
"d:\IDEWORK\lvmen\src\licensedcode\data\rules\sunpro_1.yml", "YAML", 0, 0, 0, 3, 0, 0, 1, 4
"d:\IDEWORK\lvmen\src\licensedcode\data\rules\sunsoft_1.yml", "YAML", 0, 0, 0, 3, 0, 0, 1, 4
"d:\IDEWORK\lvmen\src\licensedcode\data\rules\sunsoft_2.yml", "YAML", 0, 0, 0, 3, 0, 0, 1, 4
"d:\IDEWORK\lvmen\src\licensedcode\data\rules\sunsoft_3.yml", "YAML", 0, 0, 0, 3, 0, 0, 1, 4
"d:\IDEWORK\lvmen\src\licensedcode\data\rules\supervisor.yml", "YAML", 0, 0, 0, 5, 0, 0, 1, 6
"d:\IDEWORK\lvmen\src\licensedcode\data\rules\supervisor_1.yml", "YAML", 0, 0, 0, 11, 0, 0, 1, 12
"d:\IDEWORK\lvmen\src\licensedcode\data\rules\swl_url_1.yml", "YAML", 0, 0, 0, 5, 0, 0, 1, 6
"d:\IDEWORK\lvmen\src\licensedcode\data\rules\swl_url_2.yml", "YAML", 0, 0, 0, 5, 0, 0, 1, 6
"d:\IDEWORK\lvmen\src\licensedcode\data\rules\sybase.SPDX.yml", "YAML", 0, 0, 0, 10, 0, 0, 1, 11
"d:\IDEWORK\lvmen\src\licensedcode\data\rules\sybase.yml", "YAML", 0, 0, 0, 3, 0, 0, 1, 4
"d:\IDEWORK\lvmen\src\licensedcode\data\rules\sybase_1.yml", "YAML", 0, 0, 0, 8, 0, 0, 1, 9
"d:\IDEWORK\lvmen\src\licensedcode\data\rules\sybase_2.yml", "YAML", 0, 0, 0, 5, 0, 0, 1, 6
"d:\IDEWORK\lvmen\src\licensedcode\data\rules\sybase_3.yml", "YAML", 0, 0, 0, 5, 0, 0, 1, 6
"d:\IDEWORK\lvmen\src\licensedcode\data\rules\sybase_4.yml", "YAML", 0, 0, 0, 5, 0, 0, 1, 6
"d:\IDEWORK\lvmen\src\licensedcode\data\rules\sybase_5.yml", "YAML", 0, 0, 0, 5, 0, 0, 1, 6
"d:\IDEWORK\lvmen\src\licensedcode\data\rules\sybase_6.yml", "YAML", 0, 0, 0, 5, 0, 0, 1, 6
"d:\IDEWORK\lvmen\src\licensedcode\data\rules\sybase_7.yml", "YAML", 0, 0, 0, 5, 0, 0, 1, 6
"d:\IDEWORK\lvmen\src\licensedcode\data\rules\sybase_url_1.yml", "YAML", 0, 0, 0, 5, 0, 0, 1, 6
"d:\IDEWORK\lvmen\src\licensedcode\data\rules\sybase_url_2.yml", "YAML", 0, 0, 0, 5, 0, 0, 1, 6
"d:\IDEWORK\lvmen\src\licensedcode\data\rules\syntext-serna-exception-1.0_1.yml", "YAML", 0, 0, 0, 6, 0, 0, 1, 7
"d:\IDEWORK\lvmen\src\licensedcode\data\rules\takuya-ooura.yml", "YAML", 0, 0, 0, 5, 0, 0, 1, 6
"d:\IDEWORK\lvmen\src\licensedcode\data\rules\takuya-ooura2.yml", "YAML", 0, 0, 0, 8, 0, 0, 1, 9
"d:\IDEWORK\lvmen\src\licensedcode\data\rules\taligent-jdk_1.yml", "YAML", 0, 0, 0, 3, 0, 0, 1, 4
"d:\IDEWORK\lvmen\src\licensedcode\data\rules\taligent-jdk_2.yml", "YAML", 0, 0, 0, 3, 0, 0, 1, 4
"d:\IDEWORK\lvmen\src\licensedcode\data\rules\tapr-ohl-1.0_url_1.yml", "YAML", 0, 0, 0, 5, 0, 0, 1, 6
"d:\IDEWORK\lvmen\src\licensedcode\data\rules\tapr-ohl-1.0_url_2.yml", "YAML", 0, 0, 0, 5, 0, 0, 1, 6
"d:\IDEWORK\lvmen\src\licensedcode\data\rules\tatu-ylonen2.yml", "YAML", 0, 0, 0, 4, 0, 0, 1, 5
"d:\IDEWORK\lvmen\src\licensedcode\data\rules\tatu-ylonen3.yml", "YAML", 0, 0, 0, 4, 0, 0, 1, 5
"d:\IDEWORK\lvmen\src\licensedcode\data\rules\tcl.yml", "YAML", 0, 0, 0, 5, 0, 0, 1, 6
"d:\IDEWORK\lvmen\src\licensedcode\data\rules\tcl_1.yml", "YAML", 0, 0, 0, 7, 0, 0, 1, 8
"d:\IDEWORK\lvmen\src\licensedcode\data\rules\tcl_10.yml", "YAML", 0, 0, 0, 3, 0, 0, 1, 4
"d:\IDEWORK\lvmen\src\licensedcode\data\rules\tcl_11.yml", "YAML", 0, 0, 0, 3, 0, 0, 1, 4
"d:\IDEWORK\lvmen\src\licensedcode\data\rules\tcl_12.yml", "YAML", 0, 0, 0, 3, 0, 0, 1, 4
"d:\IDEWORK\lvmen\src\licensedcode\data\rules\tcl_13.yml", "YAML", 0, 0, 0, 3, 0, 0, 1, 4
"d:\IDEWORK\lvmen\src\licensedcode\data\rules\tcl_14.yml", "YAML", 0, 0, 0, 6, 0, 0, 1, 7
"d:\IDEWORK\lvmen\src\licensedcode\data\rules\tcl_2.yml", "YAML", 0, 0, 0, 5, 0, 0, 1, 6
"d:\IDEWORK\lvmen\src\licensedcode\data\rules\tcl_3.yml", "YAML", 0, 0, 0, 2, 0, 0, 1, 3
"d:\IDEWORK\lvmen\src\licensedcode\data\rules\tcl_4.yml", "YAML", 0, 0, 0, 2, 0, 0, 1, 3
"d:\IDEWORK\lvmen\src\licensedcode\data\rules\tcl_5.yml", "YAML", 0, 0, 0, 3, 0, 0, 1, 4
"d:\IDEWORK\lvmen\src\licensedcode\data\rules\tcl_6.yml", "YAML", 0, 0, 0, 8, 0, 0, 1, 9
"d:\IDEWORK\lvmen\src\licensedcode\data\rules\tcl_7.yml", "YAML", 0, 0, 0, 5, 0, 0, 1, 6
"d:\IDEWORK\lvmen\src\licensedcode\data\rules\tcl_8.yml", "YAML", 0, 0, 0, 5, 0, 0, 1, 6
"d:\IDEWORK\lvmen\src\licensedcode\data\rules\tcl_9.yml", "YAML", 0, 0, 0, 3, 0, 0, 1, 4
"d:\IDEWORK\lvmen\src\licensedcode\data\rules\tcl_url_1.yml", "YAML", 0, 0, 0, 5, 0, 0, 1, 6
"d:\IDEWORK\lvmen\src\licensedcode\data\rules\tcl_url_2.yml", "YAML", 0, 0, 0, 5, 0, 0, 1, 6
"d:\IDEWORK\lvmen\src\licensedcode\data\rules\tcp-wrappers.yml", "YAML", 0, 0, 0, 6, 0, 0, 1, 7
"d:\IDEWORK\lvmen\src\licensedcode\data\rules\tcp-wrappers_1.yml", "YAML", 0, 0, 0, 3, 0, 0, 1, 4
"d:\IDEWORK\lvmen\src\licensedcode\data\rules\tcp-wrappers_2.yml", "YAML", 0, 0, 0, 3, 0, 0, 1, 4
"d:\IDEWORK\lvmen\src\licensedcode\data\rules\tcp-wrappers_3.yml", "YAML", 0, 0, 0, 2, 0, 0, 2, 4
"d:\IDEWORK\lvmen\src\licensedcode\data\rules\tcp-wrappers_url_1.yml", "YAML", 0, 0, 0, 5, 0, 0, 1, 6
"d:\IDEWORK\lvmen\src\licensedcode\data\rules\tcp-wrappers_url_2.yml", "YAML", 0, 0, 0, 5, 0, 0, 1, 6
"d:\IDEWORK\lvmen\src\licensedcode\data\rules\tex-exception_1.yml", "YAML", 0, 0, 0, 2, 0, 0, 1, 3
"d:\IDEWORK\lvmen\src\licensedcode\data\rules\tex-exception_2.yml", "YAML", 0, 0, 0, 2, 0, 0, 1, 3
"d:\IDEWORK\lvmen\src\licensedcode\data\rules\tex-exception_3.yml", "YAML", 0, 0, 0, 3, 0, 0, 1, 4
"d:\IDEWORK\lvmen\src\licensedcode\data\rules\tex-live_1.yml", "YAML", 0, 0, 0, 16, 0, 0, 1, 17
"d:\IDEWORK\lvmen\src\licensedcode\data\rules\tex-live_2.yml", "YAML", 0, 0, 0, 16, 0, 0, 1, 17
"d:\IDEWORK\lvmen\src\licensedcode\data\rules\tex-live_3.yml", "YAML", 0, 0, 0, 16, 0, 0, 1, 17
"d:\IDEWORK\lvmen\src\licensedcode\data\rules\tex-live_4.yml", "YAML", 0, 0, 0, 16, 0, 0, 1, 17
"d:\IDEWORK\lvmen\src\licensedcode\data\rules\tgppl-1.0.yml", "YAML", 0, 0, 0, 5, 0, 0, 1, 6
"d:\IDEWORK\lvmen\src\licensedcode\data\rules\tgppl-1.0_1.yml", "YAML", 0, 0, 0, 2, 0, 0, 1, 3
"d:\IDEWORK\lvmen\src\licensedcode\data\rules\tidy_1.yml", "YAML", 0, 0, 0, 2, 0, 0, 1, 3
"d:\IDEWORK\lvmen\src\licensedcode\data\rules\tidy_23.yml", "YAML", 0, 0, 0, 2, 0, 0, 1, 3
"d:\IDEWORK\lvmen\src\licensedcode\data\rules\tigra-calendar-3.2.yml", "YAML", 0, 0, 0, 5, 0, 0, 1, 6
"d:\IDEWORK\lvmen\src\licensedcode\data\rules\tigra-calendar-4.0.yml", "YAML", 0, 0, 0, 5, 0, 0, 1, 6
"d:\IDEWORK\lvmen\src\licensedcode\data\rules\tmate.SPDX.yml", "YAML", 0, 0, 0, 10, 0, 0, 1, 11
"d:\IDEWORK\lvmen\src\licensedcode\data\rules\tmate.yml", "YAML", 0, 0, 0, 5, 0, 0, 1, 6
"d:\IDEWORK\lvmen\src\licensedcode\data\rules\tmate_1.yml", "YAML", 0, 0, 0, 5, 0, 0, 1, 6
"d:\IDEWORK\lvmen\src\licensedcode\data\rules\tmate_2.yml", "YAML", 0, 0, 0, 3, 0, 0, 1, 4
"d:\IDEWORK\lvmen\src\licensedcode\data\rules\tmate_3.yml", "YAML", 0, 0, 0, 3, 0, 0, 1, 4
"d:\IDEWORK\lvmen\src\licensedcode\data\rules\tmate_and_apache-2.0_1.yml", "YAML", 0, 0, 0, 9, 0, 0, 1, 10
"d:\IDEWORK\lvmen\src\licensedcode\data\rules\tmate_url_1.yml", "YAML", 0, 0, 0, 5, 0, 0, 1, 6
"d:\IDEWORK\lvmen\src\licensedcode\data\rules\tmate_url_2.yml", "YAML", 0, 0, 0, 5, 0, 0, 1, 6
"d:\IDEWORK\lvmen\src\licensedcode\data\rules\torque-1.1_url_1.yml", "YAML", 0, 0, 0, 5, 0, 0, 1, 6
"d:\IDEWORK\lvmen\src\licensedcode\data\rules\torque-1.1_url_2.yml", "YAML", 0, 0, 0, 5, 0, 0, 1, 6
"d:\IDEWORK\lvmen\src\licensedcode\data\rules\tosl_url_1.yml", "YAML", 0, 0, 0, 5, 0, 0, 1, 6
"d:\IDEWORK\lvmen\src\licensedcode\data\rules\tosl_url_2.yml", "YAML", 0, 0, 0, 5, 0, 0, 1, 6
"d:\IDEWORK\lvmen\src\licensedcode\data\rules\tpl-1.0.yml", "YAML", 0, 0, 0, 5, 0, 0, 1, 6
"d:\IDEWORK\lvmen\src\licensedcode\data\rules\trademark-notice_1.yml", "YAML", 0, 0, 0, 4, 0, 0, 1, 5
"d:\IDEWORK\lvmen\src\licensedcode\data\rules\trademark-notice_2.yml", "YAML", 0, 0, 0, 4, 0, 0, 1, 5
"d:\IDEWORK\lvmen\src\licensedcode\data\rules\trademark-notice_openjdk_1.1.yml", "YAML", 0, 0, 0, 12, 0, 0, 1, 13
"d:\IDEWORK\lvmen\src\licensedcode\data\rules\trademark-notice_openjdk_1.20.yml", "YAML", 0, 0, 0, 11, 0, 0, 1, 12
"d:\IDEWORK\lvmen\src\licensedcode\data\rules\trademark-notice_openjdk_1.21.yml", "YAML", 0, 0, 0, 17, 0, 0, 1, 18
"d:\IDEWORK\lvmen\src\licensedcode\data\rules\truecrypt-3.1_1.yml", "YAML", 0, 0, 0, 4, 0, 0, 1, 5
"d:\IDEWORK\lvmen\src\licensedcode\data\rules\tsl_1.yml", "YAML", 0, 0, 0, 4, 0, 0, 1, 5
"d:\IDEWORK\lvmen\src\licensedcode\data\rules\tsl_2.yml", "YAML", 0, 0, 0, 6, 0, 0, 1, 7
"d:\IDEWORK\lvmen\src\licensedcode\data\rules\ttyp0_1.yml", "YAML", 0, 0, 0, 3, 0, 0, 1, 4
"d:\IDEWORK\lvmen\src\licensedcode\data\rules\tu-berlin-2.0_1.yml", "YAML", 0, 0, 0, 4, 0, 0, 1, 5
"d:\IDEWORK\lvmen\src\licensedcode\data\rules\tu-berlin-2.0_url_1.yml", "YAML", 0, 0, 0, 5, 0, 0, 1, 6
"d:\IDEWORK\lvmen\src\licensedcode\data\rules\tu-berlin-2.0_url_2.yml", "YAML", 0, 0, 0, 5, 0, 0, 1, 6
"d:\IDEWORK\lvmen\src\licensedcode\data\rules\tu-berlin_url_1.yml", "YAML", 0, 0, 0, 5, 0, 0, 1, 6
"d:\IDEWORK\lvmen\src\licensedcode\data\rules\tu-berlin_url_2.yml", "YAML", 0, 0, 0, 5, 0, 0, 1, 6
"d:\IDEWORK\lvmen\src\licensedcode\data\rules\txl-10.5.yml", "YAML", 0, 0, 0, 5, 0, 0, 1, 6
"d:\IDEWORK\lvmen\src\licensedcode\data\rules\txl-10.5_1.yml", "YAML", 0, 0, 0, 3, 0, 0, 1, 4
"d:\IDEWORK\lvmen\src\licensedcode\data\rules\txl-10.5_2.yml", "YAML", 0, 0, 0, 3, 0, 0, 1, 4
"d:\IDEWORK\lvmen\src\licensedcode\data\rules\txl-10.5_3.yml", "YAML", 0, 0, 0, 4, 0, 0, 1, 5
"d:\IDEWORK\lvmen\src\licensedcode\data\rules\txl-10.5_4.yml", "YAML", 0, 0, 0, 4, 0, 0, 1, 5
"d:\IDEWORK\lvmen\src\licensedcode\data\rules\u-boot-exception-2.0_url_1.yml", "YAML", 0, 0, 0, 5, 0, 0, 1, 6
"d:\IDEWORK\lvmen\src\licensedcode\data\rules\u-boot-exception-2.0_url_2.yml", "YAML", 0, 0, 0, 5, 0, 0, 1, 6
"d:\IDEWORK\lvmen\src\licensedcode\data\rules\ubdl_1.yml", "YAML", 0, 0, 0, 3, 0, 0, 1, 4
"d:\IDEWORK\lvmen\src\licensedcode\data\rules\ubdl_2.yml", "YAML", 0, 0, 0, 2, 0, 0, 1, 3
"d:\IDEWORK\lvmen\src\licensedcode\data\rules\ubuntu-font-1.0_1.yml", "YAML", 0, 0, 0, 4, 0, 0, 1, 5
"d:\IDEWORK\lvmen\src\licensedcode\data\rules\ubuntu-font-1.0_2.yml", "YAML", 0, 0, 0, 3, 0, 0, 1, 4
"d:\IDEWORK\lvmen\src\licensedcode\data\rules\ubuntu-font-1.0_3.yml", "YAML", 0, 0, 0, 3, 0, 0, 1, 4
"d:\IDEWORK\lvmen\src\licensedcode\data\rules\unicode-data-software.yml", "YAML", 0, 0, 0, 3, 0, 0, 1, 4
"d:\IDEWORK\lvmen\src\licensedcode\data\rules\unicode-data-software2.yml", "YAML", 0, 0, 0, 14, 0, 0, 1, 15
"d:\IDEWORK\lvmen\src\licensedcode\data\rules\unicode-data-software3.yml", "YAML", 0, 0, 0, 5, 0, 0, 1, 6
"d:\IDEWORK\lvmen\src\licensedcode\data\rules\unicode-data-software6.yml", "YAML", 0, 0, 0, 6, 0, 0, 1, 7
"d:\IDEWORK\lvmen\src\licensedcode\data\rules\unicode-data-software7.yml", "YAML", 0, 0, 0, 5, 0, 0, 1, 6
"d:\IDEWORK\lvmen\src\licensedcode\data\rules\unicode-data-software_fpc.yml", "YAML", 0, 0, 0, 5, 0, 0, 1, 6
"d:\IDEWORK\lvmen\src\licensedcode\data\rules\unicode-dfs-2015_1.yml", "YAML", 0, 0, 0, 12, 0, 0, 1, 13
"d:\IDEWORK\lvmen\src\licensedcode\data\rules\unicode-dfs-2015_url_1.yml", "YAML", 0, 0, 0, 5, 0, 0, 1, 6
"d:\IDEWORK\lvmen\src\licensedcode\data\rules\unicode-dfs-2015_url_2.yml", "YAML", 0, 0, 0, 5, 0, 0, 1, 6
"d:\IDEWORK\lvmen\src\licensedcode\data\rules\unicode-dfs-2016_1.yml", "YAML", 0, 0, 0, 14, 0, 0, 1, 15
"d:\IDEWORK\lvmen\src\licensedcode\data\rules\unicode-dfs-2016_url_1.yml", "YAML", 0, 0, 0, 5, 0, 0, 1, 6
"d:\IDEWORK\lvmen\src\licensedcode\data\rules\unicode-dfs-2016_url_2.yml", "YAML", 0, 0, 0, 5, 0, 0, 1, 6
"d:\IDEWORK\lvmen\src\licensedcode\data\rules\unicode-icu-58_1.yml", "YAML", 0, 0, 0, 5, 0, 0, 1, 6
"d:\IDEWORK\lvmen\src\licensedcode\data\rules\unicode-mappings_1.yml", "YAML", 0, 0, 0, 2, 0, 0, 1, 3
"d:\IDEWORK\lvmen\src\licensedcode\data\rules\unicode-mappings_2.yml", "YAML", 0, 0, 0, 2, 0, 0, 1, 3
"d:\IDEWORK\lvmen\src\licensedcode\data\rules\unicode-tou_1.yml", "YAML", 0, 0, 0, 5, 0, 0, 1, 6
"d:\IDEWORK\lvmen\src\licensedcode\data\rules\unicode-tou_2.yml", "YAML", 0, 0, 0, 7, 0, 0, 1, 8
"d:\IDEWORK\lvmen\src\licensedcode\data\rules\unicode-tou_3.yml", "YAML", 0, 0, 0, 7, 0, 0, 1, 8
"d:\IDEWORK\lvmen\src\licensedcode\data\rules\unicode-tou_4.yml", "YAML", 0, 0, 0, 7, 0, 0, 1, 8
"d:\IDEWORK\lvmen\src\licensedcode\data\rules\unicode-tou_5.yml", "YAML", 0, 0, 0, 3, 0, 0, 1, 4
"d:\IDEWORK\lvmen\src\licensedcode\data\rules\unicode-tou_6.yml", "YAML", 0, 0, 0, 7, 0, 0, 1, 8
"d:\IDEWORK\lvmen\src\licensedcode\data\rules\unicode-tou_7.yml", "YAML", 0, 0, 0, 8, 0, 0, 1, 9
"d:\IDEWORK\lvmen\src\licensedcode\data\rules\unicode-tou_8.yml", "YAML", 0, 0, 0, 3, 0, 0, 1, 4
"d:\IDEWORK\lvmen\src\licensedcode\data\rules\unicode-tou_and_unicode_1.yml", "YAML", 0, 0, 0, 14, 0, 0, 1, 15
"d:\IDEWORK\lvmen\src\licensedcode\data\rules\unicode-tou_and_unicode_2.yml", "YAML", 0, 0, 0, 2, 0, 0, 1, 3
"d:\IDEWORK\lvmen\src\licensedcode\data\rules\unicode-tou_url_1.yml", "YAML", 0, 0, 0, 5, 0, 0, 1, 6
"d:\IDEWORK\lvmen\src\licensedcode\data\rules\unicode-tou_url_2.yml", "YAML", 0, 0, 0, 5, 0, 0, 1, 6
"d:\IDEWORK\lvmen\src\licensedcode\data\rules\unicode_1.yml", "YAML", 0, 0, 0, 5, 0, 0, 1, 6
"d:\IDEWORK\lvmen\src\licensedcode\data\rules\unicode_10.yml", "YAML", 0, 0, 0, 14, 0, 0, 1, 15
"d:\IDEWORK\lvmen\src\licensedcode\data\rules\unicode_11.yml", "YAML", 0, 0, 0, 8, 0, 0, 1, 9
"d:\IDEWORK\lvmen\src\licensedcode\data\rules\unicode_12.yml", "YAML", 0, 0, 0, 5, 0, 0, 1, 6
"d:\IDEWORK\lvmen\src\licensedcode\data\rules\unicode_13.yml", "YAML", 0, 0, 0, 5, 0, 0, 1, 6
"d:\IDEWORK\lvmen\src\licensedcode\data\rules\unicode_14.yml", "YAML", 0, 0, 0, 5, 0, 0, 1, 6
"d:\IDEWORK\lvmen\src\licensedcode\data\rules\unicode_15.yml", "YAML", 0, 0, 0, 4, 0, 0, 1, 5
"d:\IDEWORK\lvmen\src\licensedcode\data\rules\unicode_16.yml", "YAML", 0, 0, 0, 3, 0, 0, 1, 4
"d:\IDEWORK\lvmen\src\licensedcode\data\rules\unicode_17.yml", "YAML", 0, 0, 0, 5, 0, 0, 1, 6
"d:\IDEWORK\lvmen\src\licensedcode\data\rules\unicode_18.yml", "YAML", 0, 0, 0, 6, 0, 0, 1, 7
"d:\IDEWORK\lvmen\src\licensedcode\data\rules\unicode_19.yml", "YAML", 0, 0, 0, 7, 0, 0, 1, 8
"d:\IDEWORK\lvmen\src\licensedcode\data\rules\unicode_2.yml", "YAML", 0, 0, 0, 4, 0, 0, 1, 5
"d:\IDEWORK\lvmen\src\licensedcode\data\rules\unicode_20.yml", "YAML", 0, 0, 0, 7, 0, 0, 1, 8
"d:\IDEWORK\lvmen\src\licensedcode\data\rules\unicode_21.yml", "YAML", 0, 0, 0, 6, 0, 0, 1, 7
"d:\IDEWORK\lvmen\src\licensedcode\data\rules\unicode_22.yml", "YAML", 0, 0, 0, 6, 0, 0, 1, 7
"d:\IDEWORK\lvmen\src\licensedcode\data\rules\unicode_23.yml", "YAML", 0, 0, 0, 9, 0, 0, 1, 10
"d:\IDEWORK\lvmen\src\licensedcode\data\rules\unicode_24.yml", "YAML", 0, 0, 0, 9, 0, 0, 1, 10
"d:\IDEWORK\lvmen\src\licensedcode\data\rules\unicode_25.yml", "YAML", 0, 0, 0, 9, 0, 0, 1, 10
"d:\IDEWORK\lvmen\src\licensedcode\data\rules\unicode_26.yml", "YAML", 0, 0, 0, 9, 0, 0, 1, 10
"d:\IDEWORK\lvmen\src\licensedcode\data\rules\unicode_27.yml", "YAML", 0, 0, 0, 9, 0, 0, 1, 10
"d:\IDEWORK\lvmen\src\licensedcode\data\rules\unicode_28.yml", "YAML", 0, 0, 0, 9, 0, 0, 1, 10
"d:\IDEWORK\lvmen\src\licensedcode\data\rules\unicode_29.yml", "YAML", 0, 0, 0, 9, 0, 0, 1, 10
"d:\IDEWORK\lvmen\src\licensedcode\data\rules\unicode_3.yml", "YAML", 0, 0, 0, 12, 0, 0, 1, 13
"d:\IDEWORK\lvmen\src\licensedcode\data\rules\unicode_30.yml", "YAML", 0, 0, 0, 9, 0, 0, 1, 10
"d:\IDEWORK\lvmen\src\licensedcode\data\rules\unicode_31.yml", "YAML", 0, 0, 0, 9, 0, 0, 1, 10
"d:\IDEWORK\lvmen\src\licensedcode\data\rules\unicode_32.yml", "YAML", 0, 0, 0, 9, 0, 0, 1, 10
"d:\IDEWORK\lvmen\src\licensedcode\data\rules\unicode_33.yml", "YAML", 0, 0, 0, 9, 0, 0, 1, 10
"d:\IDEWORK\lvmen\src\licensedcode\data\rules\unicode_34.yml", "YAML", 0, 0, 0, 5, 0, 0, 1, 6
"d:\IDEWORK\lvmen\src\licensedcode\data\rules\unicode_35.yml", "YAML", 0, 0, 0, 6, 0, 0, 1, 7
"d:\IDEWORK\lvmen\src\licensedcode\data\rules\unicode_36.yml", "YAML", 0, 0, 0, 5, 0, 0, 1, 6
"d:\IDEWORK\lvmen\src\licensedcode\data\rules\unicode_37.yml", "YAML", 0, 0, 0, 5, 0, 0, 1, 6
"d:\IDEWORK\lvmen\src\licensedcode\data\rules\unicode_38.yml", "YAML", 0, 0, 0, 5, 0, 0, 1, 6
"d:\IDEWORK\lvmen\src\licensedcode\data\rules\unicode_39.yml", "YAML", 0, 0, 0, 5, 0, 0, 1, 6
"d:\IDEWORK\lvmen\src\licensedcode\data\rules\unicode_4.yml", "YAML", 0, 0, 0, 13, 0, 0, 1, 14
"d:\IDEWORK\lvmen\src\licensedcode\data\rules\unicode_40.yml", "YAML", 0, 0, 0, 8, 0, 0, 1, 9
"d:\IDEWORK\lvmen\src\licensedcode\data\rules\unicode_41.yml", "YAML", 0, 0, 0, 8, 0, 0, 1, 9
"d:\IDEWORK\lvmen\src\licensedcode\data\rules\unicode_42.yml", "YAML", 0, 0, 0, 5, 0, 0, 1, 6
"d:\IDEWORK\lvmen\src\licensedcode\data\rules\unicode_43.yml", "YAML", 0, 0, 0, 5, 0, 0, 1, 6
"d:\IDEWORK\lvmen\src\licensedcode\data\rules\unicode_44.yml", "YAML", 0, 0, 0, 5, 0, 0, 1, 6
"d:\IDEWORK\lvmen\src\licensedcode\data\rules\unicode_45.yml", "YAML", 0, 0, 0, 3, 0, 0, 1, 4
"d:\IDEWORK\lvmen\src\licensedcode\data\rules\unicode_46.yml", "YAML", 0, 0, 0, 5, 0, 0, 1, 6
"d:\IDEWORK\lvmen\src\licensedcode\data\rules\unicode_47.yml", "YAML", 0, 0, 0, 5, 0, 0, 1, 6
"d:\IDEWORK\lvmen\src\licensedcode\data\rules\unicode_48.yml", "YAML", 0, 0, 0, 5, 0, 0, 1, 6
"d:\IDEWORK\lvmen\src\licensedcode\data\rules\unicode_49.yml", "YAML", 0, 0, 0, 5, 0, 0, 1, 6
"d:\IDEWORK\lvmen\src\licensedcode\data\rules\unicode_5.yml", "YAML", 0, 0, 0, 8, 0, 0, 1, 9
"d:\IDEWORK\lvmen\src\licensedcode\data\rules\unicode_50.yml", "YAML", 0, 0, 0, 5, 0, 0, 1, 6
"d:\IDEWORK\lvmen\src\licensedcode\data\rules\unicode_51.yml", "YAML", 0, 0, 0, 5, 0, 0, 2, 7
"d:\IDEWORK\lvmen\src\licensedcode\data\rules\unicode_52.yml", "YAML", 0, 0, 0, 3, 0, 0, 1, 4
"d:\IDEWORK\lvmen\src\licensedcode\data\rules\unicode_53.yml", "YAML", 0, 0, 0, 3, 0, 0, 1, 4
"d:\IDEWORK\lvmen\src\licensedcode\data\rules\unicode_54.yml", "YAML", 0, 0, 0, 3, 0, 0, 1, 4
"d:\IDEWORK\lvmen\src\licensedcode\data\rules\unicode_55.yml", "YAML", 0, 0, 0, 10, 0, 0, 2, 12
"d:\IDEWORK\lvmen\src\licensedcode\data\rules\unicode_56.yml", "YAML", 0, 0, 0, 2, 0, 0, 1, 3
"d:\IDEWORK\lvmen\src\licensedcode\data\rules\unicode_57.yml", "YAML", 0, 0, 0, 8, 0, 0, 1, 9
"d:\IDEWORK\lvmen\src\licensedcode\data\rules\unicode_6.yml", "YAML", 0, 0, 0, 7, 0, 0, 1, 8
"d:\IDEWORK\lvmen\src\licensedcode\data\rules\unicode_7.yml", "YAML", 0, 0, 0, 7, 0, 0, 1, 8
"d:\IDEWORK\lvmen\src\licensedcode\data\rules\unicode_8.yml", "YAML", 0, 0, 0, 5, 0, 0, 1, 6
"d:\IDEWORK\lvmen\src\licensedcode\data\rules\unicode_9.yml", "YAML", 0, 0, 0, 12, 0, 0, 1, 13
"d:\IDEWORK\lvmen\src\licensedcode\data\rules\universal-foss-exception-1.0_url_1.yml", "YAML", 0, 0, 0, 5, 0, 0, 1, 6
"d:\IDEWORK\lvmen\src\licensedcode\data\rules\universal-foss-exception-1.0_url_2.yml", "YAML", 0, 0, 0, 5, 0, 0, 1, 6
"d:\IDEWORK\lvmen\src\licensedcode\data\rules\unknown-license-reference.yml", "YAML", 0, 0, 0, 4, 0, 0, 1, 5
"d:\IDEWORK\lvmen\src\licensedcode\data\rules\unknown-license-reference_1.yml", "YAML", 0, 0, 0, 5, 0, 0, 1, 6
"d:\IDEWORK\lvmen\src\licensedcode\data\rules\unknown-license-reference_10.yml", "YAML", 0, 0, 0, 5, 0, 0, 1, 6
"d:\IDEWORK\lvmen\src\licensedcode\data\rules\unknown-license-reference_100.yml", "YAML", 0, 0, 0, 5, 0, 0, 1, 6
"d:\IDEWORK\lvmen\src\licensedcode\data\rules\unknown-license-reference_101.yml", "YAML", 0, 0, 0, 3, 0, 0, 1, 4
"d:\IDEWORK\lvmen\src\licensedcode\data\rules\unknown-license-reference_102.yml", "YAML", 0, 0, 0, 5, 0, 0, 1, 6
"d:\IDEWORK\lvmen\src\licensedcode\data\rules\unknown-license-reference_103.yml", "YAML", 0, 0, 0, 5, 0, 0, 1, 6
"d:\IDEWORK\lvmen\src\licensedcode\data\rules\unknown-license-reference_104.yml", "YAML", 0, 0, 0, 7, 0, 0, 1, 8
"d:\IDEWORK\lvmen\src\licensedcode\data\rules\unknown-license-reference_105.yml", "YAML", 0, 0, 0, 5, 0, 0, 1, 6
"d:\IDEWORK\lvmen\src\licensedcode\data\rules\unknown-license-reference_106.yml", "YAML", 0, 0, 0, 5, 0, 0, 1, 6
"d:\IDEWORK\lvmen\src\licensedcode\data\rules\unknown-license-reference_107.yml", "YAML", 0, 0, 0, 5, 0, 0, 1, 6
"d:\IDEWORK\lvmen\src\licensedcode\data\rules\unknown-license-reference_108.yml", "YAML", 0, 0, 0, 5, 0, 0, 1, 6
"d:\IDEWORK\lvmen\src\licensedcode\data\rules\unknown-license-reference_109.yml", "YAML", 0, 0, 0, 5, 0, 0, 1, 6
"d:\IDEWORK\lvmen\src\licensedcode\data\rules\unknown-license-reference_11.yml", "YAML", 0, 0, 0, 3, 0, 0, 1, 4
"d:\IDEWORK\lvmen\src\licensedcode\data\rules\unknown-license-reference_110.yml", "YAML", 0, 0, 0, 3, 0, 0, 1, 4
"d:\IDEWORK\lvmen\src\licensedcode\data\rules\unknown-license-reference_111.yml", "YAML", 0, 0, 0, 3, 0, 0, 1, 4
"d:\IDEWORK\lvmen\src\licensedcode\data\rules\unknown-license-reference_112.yml", "YAML", 0, 0, 0, 5, 0, 0, 1, 6
"d:\IDEWORK\lvmen\src\licensedcode\data\rules\unknown-license-reference_113.yml", "YAML", 0, 0, 0, 3, 0, 0, 1, 4
"d:\IDEWORK\lvmen\src\licensedcode\data\rules\unknown-license-reference_114.yml", "YAML", 0, 0, 0, 3, 0, 0, 1, 4
"d:\IDEWORK\lvmen\src\licensedcode\data\rules\unknown-license-reference_115.yml", "YAML", 0, 0, 0, 3, 0, 0, 1, 4
"d:\IDEWORK\lvmen\src\licensedcode\data\rules\unknown-license-reference_116.yml", "YAML", 0, 0, 0, 5, 0, 0, 1, 6
"d:\IDEWORK\lvmen\src\licensedcode\data\rules\unknown-license-reference_117.yml", "YAML", 0, 0, 0, 3, 0, 0, 1, 4
"d:\IDEWORK\lvmen\src\licensedcode\data\rules\unknown-license-reference_118.yml", "YAML", 0, 0, 0, 4, 0, 0, 1, 5
"d:\IDEWORK\lvmen\src\licensedcode\data\rules\unknown-license-reference_119.yml", "YAML", 0, 0, 0, 6, 0, 0, 1, 7
"d:\IDEWORK\lvmen\src\licensedcode\data\rules\unknown-license-reference_12.yml", "YAML", 0, 0, 0, 5, 0, 0, 1, 6
"d:\IDEWORK\lvmen\src\licensedcode\data\rules\unknown-license-reference_120.yml", "YAML", 0, 0, 0, 5, 0, 0, 1, 6
"d:\IDEWORK\lvmen\src\licensedcode\data\rules\unknown-license-reference_121.yml", "YAML", 0, 0, 0, 5, 0, 0, 1, 6
"d:\IDEWORK\lvmen\src\licensedcode\data\rules\unknown-license-reference_122.yml", "YAML", 0, 0, 0, 5, 0, 0, 1, 6
"d:\IDEWORK\lvmen\src\licensedcode\data\rules\unknown-license-reference_123.yml", "YAML", 0, 0, 0, 3, 0, 0, 1, 4
"d:\IDEWORK\lvmen\src\licensedcode\data\rules\unknown-license-reference_124.yml", "YAML", 0, 0, 0, 3, 0, 0, 1, 4
"d:\IDEWORK\lvmen\src\licensedcode\data\rules\unknown-license-reference_125.yml", "YAML", 0, 0, 0, 3, 0, 0, 1, 4
"d:\IDEWORK\lvmen\src\licensedcode\data\rules\unknown-license-reference_126.yml", "YAML", 0, 0, 0, 3, 0, 0, 1, 4
"d:\IDEWORK\lvmen\src\licensedcode\data\rules\unknown-license-reference_127.yml", "YAML", 0, 0, 0, 5, 0, 0, 1, 6
"d:\IDEWORK\lvmen\src\licensedcode\data\rules\unknown-license-reference_128.yml", "YAML", 0, 0, 0, 5, 0, 0, 1, 6
"d:\IDEWORK\lvmen\src\licensedcode\data\rules\unknown-license-reference_129.yml", "YAML", 0, 0, 0, 5, 0, 0, 1, 6
"d:\IDEWORK\lvmen\src\licensedcode\data\rules\unknown-license-reference_13.yml", "YAML", 0, 0, 0, 5, 0, 0, 1, 6
"d:\IDEWORK\lvmen\src\licensedcode\data\rules\unknown-license-reference_130.yml", "YAML", 0, 0, 0, 5, 0, 0, 1, 6
"d:\IDEWORK\lvmen\src\licensedcode\data\rules\unknown-license-reference_131.yml", "YAML", 0, 0, 0, 5, 0, 0, 1, 6
"d:\IDEWORK\lvmen\src\licensedcode\data\rules\unknown-license-reference_132.yml", "YAML", 0, 0, 0, 5, 0, 0, 1, 6
"d:\IDEWORK\lvmen\src\licensedcode\data\rules\unknown-license-reference_133.yml", "YAML", 0, 0, 0, 5, 0, 0, 1, 6
"d:\IDEWORK\lvmen\src\licensedcode\data\rules\unknown-license-reference_134.yml", "YAML", 0, 0, 0, 5, 0, 0, 1, 6
"d:\IDEWORK\lvmen\src\licensedcode\data\rules\unknown-license-reference_135.yml", "YAML", 0, 0, 0, 5, 0, 0, 1, 6
"d:\IDEWORK\lvmen\src\licensedcode\data\rules\unknown-license-reference_136.yml", "YAML", 0, 0, 0, 5, 0, 0, 1, 6
"d:\IDEWORK\lvmen\src\licensedcode\data\rules\unknown-license-reference_137.yml", "YAML", 0, 0, 0, 5, 0, 0, 1, 6
"d:\IDEWORK\lvmen\src\licensedcode\data\rules\unknown-license-reference_138.yml", "YAML", 0, 0, 0, 5, 0, 0, 1, 6
"d:\IDEWORK\lvmen\src\licensedcode\data\rules\unknown-license-reference_139.yml", "YAML", 0, 0, 0, 5, 0, 0, 1, 6
"d:\IDEWORK\lvmen\src\licensedcode\data\rules\unknown-license-reference_14.yml", "YAML", 0, 0, 0, 5, 0, 0, 1, 6
"d:\IDEWORK\lvmen\src\licensedcode\data\rules\unknown-license-reference_140.yml", "YAML", 0, 0, 0, 3, 0, 0, 1, 4
"d:\IDEWORK\lvmen\src\licensedcode\data\rules\unknown-license-reference_141.yml", "YAML", 0, 0, 0, 5, 0, 0, 1, 6
"d:\IDEWORK\lvmen\src\licensedcode\data\rules\unknown-license-reference_142.yml", "YAML", 0, 0, 0, 5, 0, 0, 1, 6
"d:\IDEWORK\lvmen\src\licensedcode\data\rules\unknown-license-reference_143.yml", "YAML", 0, 0, 0, 5, 0, 0, 1, 6
"d:\IDEWORK\lvmen\src\licensedcode\data\rules\unknown-license-reference_144.yml", "YAML", 0, 0, 0, 5, 0, 0, 1, 6
"d:\IDEWORK\lvmen\src\licensedcode\data\rules\unknown-license-reference_145.yml", "YAML", 0, 0, 0, 5, 0, 0, 1, 6
"d:\IDEWORK\lvmen\src\licensedcode\data\rules\unknown-license-reference_146.yml", "YAML", 0, 0, 0, 5, 0, 0, 1, 6
"d:\IDEWORK\lvmen\src\licensedcode\data\rules\unknown-license-reference_147.yml", "YAML", 0, 0, 0, 5, 0, 0, 1, 6
"d:\IDEWORK\lvmen\src\licensedcode\data\rules\unknown-license-reference_148.yml", "YAML", 0, 0, 0, 5, 0, 0, 1, 6
"d:\IDEWORK\lvmen\src\licensedcode\data\rules\unknown-license-reference_149.yml", "YAML", 0, 0, 0, 5, 0, 0, 1, 6
"d:\IDEWORK\lvmen\src\licensedcode\data\rules\unknown-license-reference_15.yml", "YAML", 0, 0, 0, 5, 0, 0, 1, 6
"d:\IDEWORK\lvmen\src\licensedcode\data\rules\unknown-license-reference_150.yml", "YAML", 0, 0, 0, 5, 0, 0, 1, 6
"d:\IDEWORK\lvmen\src\licensedcode\data\rules\unknown-license-reference_151.yml", "YAML", 0, 0, 0, 5, 0, 0, 1, 6
"d:\IDEWORK\lvmen\src\licensedcode\data\rules\unknown-license-reference_152.yml", "YAML", 0, 0, 0, 5, 0, 0, 1, 6
"d:\IDEWORK\lvmen\src\licensedcode\data\rules\unknown-license-reference_153.yml", "YAML", 0, 0, 0, 5, 0, 0, 1, 6
"d:\IDEWORK\lvmen\src\licensedcode\data\rules\unknown-license-reference_154.yml", "YAML", 0, 0, 0, 5, 0, 0, 1, 6
"d:\IDEWORK\lvmen\src\licensedcode\data\rules\unknown-license-reference_155.yml", "YAML", 0, 0, 0, 5, 0, 0, 1, 6
"d:\IDEWORK\lvmen\src\licensedcode\data\rules\unknown-license-reference_156.yml", "YAML", 0, 0, 0, 5, 0, 0, 1, 6
"d:\IDEWORK\lvmen\src\licensedcode\data\rules\unknown-license-reference_157.yml", "YAML", 0, 0, 0, 5, 0, 0, 1, 6
"d:\IDEWORK\lvmen\src\licensedcode\data\rules\unknown-license-reference_158.yml", "YAML", 0, 0, 0, 5, 0, 0, 1, 6
"d:\IDEWORK\lvmen\src\licensedcode\data\rules\unknown-license-reference_159.yml", "YAML", 0, 0, 0, 5, 0, 0, 1, 6
"d:\IDEWORK\lvmen\src\licensedcode\data\rules\unknown-license-reference_16.yml", "YAML", 0, 0, 0, 5, 0, 0, 1, 6
"d:\IDEWORK\lvmen\src\licensedcode\data\rules\unknown-license-reference_160.yml", "YAML", 0, 0, 0, 5, 0, 0, 1, 6
"d:\IDEWORK\lvmen\src\licensedcode\data\rules\unknown-license-reference_161.yml", "YAML", 0, 0, 0, 5, 0, 0, 1, 6
"d:\IDEWORK\lvmen\src\licensedcode\data\rules\unknown-license-reference_162.yml", "YAML", 0, 0, 0, 5, 0, 0, 1, 6
"d:\IDEWORK\lvmen\src\licensedcode\data\rules\unknown-license-reference_163.yml", "YAML", 0, 0, 0, 5, 0, 0, 1, 6
"d:\IDEWORK\lvmen\src\licensedcode\data\rules\unknown-license-reference_164.yml", "YAML", 0, 0, 0, 5, 0, 0, 1, 6
"d:\IDEWORK\lvmen\src\licensedcode\data\rules\unknown-license-reference_165.yml", "YAML", 0, 0, 0, 5, 0, 0, 1, 6
"d:\IDEWORK\lvmen\src\licensedcode\data\rules\unknown-license-reference_166.yml", "YAML", 0, 0, 0, 5, 0, 0, 1, 6
"d:\IDEWORK\lvmen\src\licensedcode\data\rules\unknown-license-reference_167.yml", "YAML", 0, 0, 0, 5, 0, 0, 1, 6
"d:\IDEWORK\lvmen\src\licensedcode\data\rules\unknown-license-reference_168.yml", "YAML", 0, 0, 0, 5, 0, 0, 1, 6
"d:\IDEWORK\lvmen\src\licensedcode\data\rules\unknown-license-reference_169.yml", "YAML", 0, 0, 0, 5, 0, 0, 1, 6
"d:\IDEWORK\lvmen\src\licensedcode\data\rules\unknown-license-reference_17.yml", "YAML", 0, 0, 0, 5, 0, 0, 1, 6
"d:\IDEWORK\lvmen\src\licensedcode\data\rules\unknown-license-reference_170.yml", "YAML", 0, 0, 0, 3, 0, 0, 1, 4
"d:\IDEWORK\lvmen\src\licensedcode\data\rules\unknown-license-reference_171.yml", "YAML", 0, 0, 0, 5, 0, 0, 1, 6
"d:\IDEWORK\lvmen\src\licensedcode\data\rules\unknown-license-reference_172.yml", "YAML", 0, 0, 0, 5, 0, 0, 1, 6
"d:\IDEWORK\lvmen\src\licensedcode\data\rules\unknown-license-reference_173.yml", "YAML", 0, 0, 0, 5, 0, 0, 1, 6
"d:\IDEWORK\lvmen\src\licensedcode\data\rules\unknown-license-reference_174.yml", "YAML", 0, 0, 0, 5, 0, 0, 1, 6
"d:\IDEWORK\lvmen\src\licensedcode\data\rules\unknown-license-reference_175.yml", "YAML", 0, 0, 0, 5, 0, 0, 1, 6
"d:\IDEWORK\lvmen\src\licensedcode\data\rules\unknown-license-reference_176.yml", "YAML", 0, 0, 0, 5, 0, 0, 1, 6
"d:\IDEWORK\lvmen\src\licensedcode\data\rules\unknown-license-reference_177.yml", "YAML", 0, 0, 0, 5, 0, 0, 1, 6
"d:\IDEWORK\lvmen\src\licensedcode\data\rules\unknown-license-reference_178.yml", "YAML", 0, 0, 0, 5, 0, 0, 1, 6
"d:\IDEWORK\lvmen\src\licensedcode\data\rules\unknown-license-reference_179.yml", "YAML", 0, 0, 0, 5, 0, 0, 1, 6
"d:\IDEWORK\lvmen\src\licensedcode\data\rules\unknown-license-reference_18.yml", "YAML", 0, 0, 0, 5, 0, 0, 1, 6
"d:\IDEWORK\lvmen\src\licensedcode\data\rules\unknown-license-reference_180.yml", "YAML", 0, 0, 0, 5, 0, 0, 1, 6
"d:\IDEWORK\lvmen\src\licensedcode\data\rules\unknown-license-reference_181.yml", "YAML", 0, 0, 0, 5, 0, 0, 1, 6
"d:\IDEWORK\lvmen\src\licensedcode\data\rules\unknown-license-reference_182.yml", "YAML", 0, 0, 0, 5, 0, 0, 1, 6
"d:\IDEWORK\lvmen\src\licensedcode\data\rules\unknown-license-reference_183.yml", "YAML", 0, 0, 0, 5, 0, 0, 1, 6
"d:\IDEWORK\lvmen\src\licensedcode\data\rules\unknown-license-reference_184.yml", "YAML", 0, 0, 0, 5, 0, 0, 1, 6
"d:\IDEWORK\lvmen\src\licensedcode\data\rules\unknown-license-reference_185.yml", "YAML", 0, 0, 0, 5, 0, 0, 1, 6
"d:\IDEWORK\lvmen\src\licensedcode\data\rules\unknown-license-reference_186.yml", "YAML", 0, 0, 0, 5, 0, 0, 1, 6
"d:\IDEWORK\lvmen\src\licensedcode\data\rules\unknown-license-reference_187.yml", "YAML", 0, 0, 0, 5, 0, 0, 1, 6
"d:\IDEWORK\lvmen\src\licensedcode\data\rules\unknown-license-reference_188.yml", "YAML", 0, 0, 0, 5, 0, 0, 1, 6
"d:\IDEWORK\lvmen\src\licensedcode\data\rules\unknown-license-reference_189.yml", "YAML", 0, 0, 0, 5, 0, 0, 1, 6
"d:\IDEWORK\lvmen\src\licensedcode\data\rules\unknown-license-reference_19.yml", "YAML", 0, 0, 0, 5, 0, 0, 1, 6
"d:\IDEWORK\lvmen\src\licensedcode\data\rules\unknown-license-reference_190.yml", "YAML", 0, 0, 0, 5, 0, 0, 1, 6
"d:\IDEWORK\lvmen\src\licensedcode\data\rules\unknown-license-reference_191.yml", "YAML", 0, 0, 0, 5, 0, 0, 1, 6
"d:\IDEWORK\lvmen\src\licensedcode\data\rules\unknown-license-reference_192.yml", "YAML", 0, 0, 0, 5, 0, 0, 1, 6
"d:\IDEWORK\lvmen\src\licensedcode\data\rules\unknown-license-reference_193.yml", "YAML", 0, 0, 0, 5, 0, 0, 1, 6
"d:\IDEWORK\lvmen\src\licensedcode\data\rules\unknown-license-reference_194.yml", "YAML", 0, 0, 0, 5, 0, 0, 1, 6
"d:\IDEWORK\lvmen\src\licensedcode\data\rules\unknown-license-reference_195.yml", "YAML", 0, 0, 0, 5, 0, 0, 1, 6
"d:\IDEWORK\lvmen\src\licensedcode\data\rules\unknown-license-reference_196.yml", "YAML", 0, 0, 0, 5, 0, 0, 1, 6
"d:\IDEWORK\lvmen\src\licensedcode\data\rules\unknown-license-reference_197.yml", "YAML", 0, 0, 0, 5, 0, 0, 1, 6
"d:\IDEWORK\lvmen\src\licensedcode\data\rules\unknown-license-reference_198.yml", "YAML", 0, 0, 0, 5, 0, 0, 1, 6
"d:\IDEWORK\lvmen\src\licensedcode\data\rules\unknown-license-reference_199.yml", "YAML", 0, 0, 0, 5, 0, 0, 1, 6
"d:\IDEWORK\lvmen\src\licensedcode\data\rules\unknown-license-reference_2.yml", "YAML", 0, 0, 0, 5, 0, 0, 1, 6
"d:\IDEWORK\lvmen\src\licensedcode\data\rules\unknown-license-reference_20.yml", "YAML", 0, 0, 0, 5, 0, 0, 1, 6
"d:\IDEWORK\lvmen\src\licensedcode\data\rules\unknown-license-reference_200.yml", "YAML", 0, 0, 0, 5, 0, 0, 1, 6
"d:\IDEWORK\lvmen\src\licensedcode\data\rules\unknown-license-reference_201.yml", "YAML", 0, 0, 0, 5, 0, 0, 1, 6
"d:\IDEWORK\lvmen\src\licensedcode\data\rules\unknown-license-reference_202.yml", "YAML", 0, 0, 0, 5, 0, 0, 1, 6
"d:\IDEWORK\lvmen\src\licensedcode\data\rules\unknown-license-reference_203.yml", "YAML", 0, 0, 0, 5, 0, 0, 1, 6
"d:\IDEWORK\lvmen\src\licensedcode\data\rules\unknown-license-reference_204.yml", "YAML", 0, 0, 0, 5, 0, 0, 1, 6
"d:\IDEWORK\lvmen\src\licensedcode\data\rules\unknown-license-reference_205.yml", "YAML", 0, 0, 0, 5, 0, 0, 1, 6
"d:\IDEWORK\lvmen\src\licensedcode\data\rules\unknown-license-reference_206.yml", "YAML", 0, 0, 0, 5, 0, 0, 1, 6
"d:\IDEWORK\lvmen\src\licensedcode\data\rules\unknown-license-reference_207.yml", "YAML", 0, 0, 0, 5, 0, 0, 1, 6
"d:\IDEWORK\lvmen\src\licensedcode\data\rules\unknown-license-reference_208.yml", "YAML", 0, 0, 0, 3, 0, 0, 1, 4
"d:\IDEWORK\lvmen\src\licensedcode\data\rules\unknown-license-reference_209.yml", "YAML", 0, 0, 0, 3, 0, 0, 1, 4
"d:\IDEWORK\lvmen\src\licensedcode\data\rules\unknown-license-reference_21.yml", "YAML", 0, 0, 0, 3, 0, 0, 1, 4
"d:\IDEWORK\lvmen\src\licensedcode\data\rules\unknown-license-reference_210.yml", "YAML", 0, 0, 0, 5, 0, 0, 1, 6
"d:\IDEWORK\lvmen\src\licensedcode\data\rules\unknown-license-reference_211.yml", "YAML", 0, 0, 0, 3, 0, 0, 1, 4
"d:\IDEWORK\lvmen\src\licensedcode\data\rules\unknown-license-reference_212.yml", "YAML", 0, 0, 0, 3, 0, 0, 1, 4
"d:\IDEWORK\lvmen\src\licensedcode\data\rules\unknown-license-reference_213.yml", "YAML", 0, 0, 0, 3, 0, 0, 1, 4
"d:\IDEWORK\lvmen\src\licensedcode\data\rules\unknown-license-reference_214.yml", "YAML", 0, 0, 0, 3, 0, 0, 1, 4
"d:\IDEWORK\lvmen\src\licensedcode\data\rules\unknown-license-reference_215.yml", "YAML", 0, 0, 0, 3, 0, 0, 1, 4
"d:\IDEWORK\lvmen\src\licensedcode\data\rules\unknown-license-reference_216.yml", "YAML", 0, 0, 0, 3, 0, 0, 1, 4
"d:\IDEWORK\lvmen\src\licensedcode\data\rules\unknown-license-reference_217.yml", "YAML", 0, 0, 0, 3, 0, 0, 1, 4
"d:\IDEWORK\lvmen\src\licensedcode\data\rules\unknown-license-reference_218.yml", "YAML", 0, 0, 0, 5, 0, 0, 1, 6
"d:\IDEWORK\lvmen\src\licensedcode\data\rules\unknown-license-reference_219.yml", "YAML", 0, 0, 0, 5, 0, 0, 1, 6
"d:\IDEWORK\lvmen\src\licensedcode\data\rules\unknown-license-reference_22.yml", "YAML", 0, 0, 0, 5, 0, 0, 1, 6
"d:\IDEWORK\lvmen\src\licensedcode\data\rules\unknown-license-reference_220.yml", "YAML", 0, 0, 0, 5, 0, 0, 1, 6
"d:\IDEWORK\lvmen\src\licensedcode\data\rules\unknown-license-reference_221.yml", "YAML", 0, 0, 0, 5, 0, 0, 1, 6
"d:\IDEWORK\lvmen\src\licensedcode\data\rules\unknown-license-reference_222.yml", "YAML", 0, 0, 0, 3, 0, 0, 1, 4
"d:\IDEWORK\lvmen\src\licensedcode\data\rules\unknown-license-reference_223.yml", "YAML", 0, 0, 0, 3, 0, 0, 1, 4
"d:\IDEWORK\lvmen\src\licensedcode\data\rules\unknown-license-reference_224.yml", "YAML", 0, 0, 0, 5, 0, 0, 1, 6
"d:\IDEWORK\lvmen\src\licensedcode\data\rules\unknown-license-reference_225.yml", "YAML", 0, 0, 0, 5, 0, 0, 1, 6
"d:\IDEWORK\lvmen\src\licensedcode\data\rules\unknown-license-reference_226.yml", "YAML", 0, 0, 0, 3, 0, 0, 1, 4
"d:\IDEWORK\lvmen\src\licensedcode\data\rules\unknown-license-reference_227.yml", "YAML", 0, 0, 0, 4, 0, 0, 1, 5
"d:\IDEWORK\lvmen\src\licensedcode\data\rules\unknown-license-reference_228.yml", "YAML", 0, 0, 0, 5, 0, 0, 1, 6
"d:\IDEWORK\lvmen\src\licensedcode\data\rules\unknown-license-reference_229.yml", "YAML", 0, 0, 0, 3, 0, 0, 1, 4
"d:\IDEWORK\lvmen\src\licensedcode\data\rules\unknown-license-reference_23.yml", "YAML", 0, 0, 0, 5, 0, 0, 1, 6
"d:\IDEWORK\lvmen\src\licensedcode\data\rules\unknown-license-reference_230.yml", "YAML", 0, 0, 0, 3, 0, 0, 1, 4
"d:\IDEWORK\lvmen\src\licensedcode\data\rules\unknown-license-reference_231.yml", "YAML", 0, 0, 0, 3, 0, 0, 1, 4
"d:\IDEWORK\lvmen\src\licensedcode\data\rules\unknown-license-reference_232.yml", "YAML", 0, 0, 0, 5, 0, 0, 1, 6
"d:\IDEWORK\lvmen\src\licensedcode\data\rules\unknown-license-reference_233.yml", "YAML", 0, 0, 0, 5, 0, 0, 1, 6
"d:\IDEWORK\lvmen\src\licensedcode\data\rules\unknown-license-reference_234.yml", "YAML", 0, 0, 0, 5, 0, 0, 1, 6
"d:\IDEWORK\lvmen\src\licensedcode\data\rules\unknown-license-reference_235.yml", "YAML", 0, 0, 0, 3, 0, 0, 1, 4
"d:\IDEWORK\lvmen\src\licensedcode\data\rules\unknown-license-reference_236.yml", "YAML", 0, 0, 0, 5, 0, 0, 1, 6
"d:\IDEWORK\lvmen\src\licensedcode\data\rules\unknown-license-reference_237.yml", "YAML", 0, 0, 0, 5, 0, 0, 1, 6
"d:\IDEWORK\lvmen\src\licensedcode\data\rules\unknown-license-reference_238.yml", "YAML", 0, 0, 0, 3, 0, 0, 1, 4
"d:\IDEWORK\lvmen\src\licensedcode\data\rules\unknown-license-reference_239.yml", "YAML", 0, 0, 0, 3, 0, 0, 1, 4
"d:\IDEWORK\lvmen\src\licensedcode\data\rules\unknown-license-reference_24.yml", "YAML", 0, 0, 0, 5, 0, 0, 1, 6
"d:\IDEWORK\lvmen\src\licensedcode\data\rules\unknown-license-reference_240.yml", "YAML", 0, 0, 0, 3, 0, 0, 1, 4
"d:\IDEWORK\lvmen\src\licensedcode\data\rules\unknown-license-reference_241.yml", "YAML", 0, 0, 0, 3, 0, 0, 1, 4
"d:\IDEWORK\lvmen\src\licensedcode\data\rules\unknown-license-reference_242.yml", "YAML", 0, 0, 0, 3, 0, 0, 1, 4
"d:\IDEWORK\lvmen\src\licensedcode\data\rules\unknown-license-reference_243.yml", "YAML", 0, 0, 0, 3, 0, 0, 1, 4
"d:\IDEWORK\lvmen\src\licensedcode\data\rules\unknown-license-reference_244.yml", "YAML", 0, 0, 0, 3, 0, 0, 1, 4
"d:\IDEWORK\lvmen\src\licensedcode\data\rules\unknown-license-reference_245.yml", "YAML", 0, 0, 0, 3, 0, 0, 1, 4
"d:\IDEWORK\lvmen\src\licensedcode\data\rules\unknown-license-reference_246.yml", "YAML", 0, 0, 0, 3, 0, 0, 1, 4
"d:\IDEWORK\lvmen\src\licensedcode\data\rules\unknown-license-reference_247.yml", "YAML", 0, 0, 0, 3, 0, 0, 1, 4
"d:\IDEWORK\lvmen\src\licensedcode\data\rules\unknown-license-reference_248.yml", "YAML", 0, 0, 0, 3, 0, 0, 1, 4
"d:\IDEWORK\lvmen\src\licensedcode\data\rules\unknown-license-reference_249.yml", "YAML", 0, 0, 0, 3, 0, 0, 1, 4
"d:\IDEWORK\lvmen\src\licensedcode\data\rules\unknown-license-reference_25.yml", "YAML", 0, 0, 0, 5, 0, 0, 1, 6
"d:\IDEWORK\lvmen\src\licensedcode\data\rules\unknown-license-reference_250.yml", "YAML", 0, 0, 0, 3, 0, 0, 1, 4
"d:\IDEWORK\lvmen\src\licensedcode\data\rules\unknown-license-reference_251.yml", "YAML", 0, 0, 0, 5, 0, 0, 1, 6
"d:\IDEWORK\lvmen\src\licensedcode\data\rules\unknown-license-reference_252.yml", "YAML", 0, 0, 0, 5, 0, 0, 1, 6
"d:\IDEWORK\lvmen\src\licensedcode\data\rules\unknown-license-reference_253.yml", "YAML", 0, 0, 0, 5, 0, 0, 1, 6
"d:\IDEWORK\lvmen\src\licensedcode\data\rules\unknown-license-reference_254.yml", "YAML", 0, 0, 0, 5, 0, 0, 1, 6
"d:\IDEWORK\lvmen\src\licensedcode\data\rules\unknown-license-reference_255.yml", "YAML", 0, 0, 0, 3, 0, 0, 1, 4
"d:\IDEWORK\lvmen\src\licensedcode\data\rules\unknown-license-reference_256.yml", "YAML", 0, 0, 0, 3, 0, 0, 1, 4
"d:\IDEWORK\lvmen\src\licensedcode\data\rules\unknown-license-reference_257.yml", "YAML", 0, 0, 0, 3, 0, 0, 1, 4
"d:\IDEWORK\lvmen\src\licensedcode\data\rules\unknown-license-reference_258.yml", "YAML", 0, 0, 0, 3, 0, 0, 1, 4
"d:\IDEWORK\lvmen\src\licensedcode\data\rules\unknown-license-reference_259.yml", "YAML", 0, 0, 0, 5, 0, 0, 1, 6
"d:\IDEWORK\lvmen\src\licensedcode\data\rules\unknown-license-reference_26.yml", "YAML", 0, 0, 0, 5, 0, 0, 1, 6
"d:\IDEWORK\lvmen\src\licensedcode\data\rules\unknown-license-reference_260.yml", "YAML", 0, 0, 0, 3, 0, 0, 1, 4
"d:\IDEWORK\lvmen\src\licensedcode\data\rules\unknown-license-reference_261.yml", "YAML", 0, 0, 0, 3, 0, 0, 1, 4
"d:\IDEWORK\lvmen\src\licensedcode\data\rules\unknown-license-reference_262.yml", "YAML", 0, 0, 0, 6, 0, 0, 1, 7
"d:\IDEWORK\lvmen\src\licensedcode\data\rules\unknown-license-reference_263.yml", "YAML", 0, 0, 0, 3, 0, 0, 1, 4
"d:\IDEWORK\lvmen\src\licensedcode\data\rules\unknown-license-reference_264.yml", "YAML", 0, 0, 0, 3, 0, 0, 1, 4
"d:\IDEWORK\lvmen\src\licensedcode\data\rules\unknown-license-reference_265.yml", "YAML", 0, 0, 0, 6, 0, 0, 1, 7
"d:\IDEWORK\lvmen\src\licensedcode\data\rules\unknown-license-reference_266.yml", "YAML", 0, 0, 0, 6, 0, 0, 1, 7
"d:\IDEWORK\lvmen\src\licensedcode\data\rules\unknown-license-reference_267.yml", "YAML", 0, 0, 0, 7, 0, 0, 1, 8
"d:\IDEWORK\lvmen\src\licensedcode\data\rules\unknown-license-reference_268.yml", "YAML", 0, 0, 0, 3, 0, 0, 1, 4
"d:\IDEWORK\lvmen\src\licensedcode\data\rules\unknown-license-reference_269.yml", "YAML", 0, 0, 0, 3, 0, 0, 1, 4
"d:\IDEWORK\lvmen\src\licensedcode\data\rules\unknown-license-reference_27.yml", "YAML", 0, 0, 0, 5, 0, 0, 1, 6
"d:\IDEWORK\lvmen\src\licensedcode\data\rules\unknown-license-reference_270.yml", "YAML", 0, 0, 0, 3, 0, 0, 1, 4
"d:\IDEWORK\lvmen\src\licensedcode\data\rules\unknown-license-reference_271.yml", "YAML", 0, 0, 0, 3, 0, 0, 1, 4
"d:\IDEWORK\lvmen\src\licensedcode\data\rules\unknown-license-reference_272.yml", "YAML", 0, 0, 0, 3, 0, 0, 1, 4
"d:\IDEWORK\lvmen\src\licensedcode\data\rules\unknown-license-reference_273.yml", "YAML", 0, 0, 0, 3, 0, 0, 1, 4
"d:\IDEWORK\lvmen\src\licensedcode\data\rules\unknown-license-reference_274.yml", "YAML", 0, 0, 0, 3, 0, 0, 1, 4
"d:\IDEWORK\lvmen\src\licensedcode\data\rules\unknown-license-reference_275.yml", "YAML", 0, 0, 0, 7, 0, 0, 1, 8
"d:\IDEWORK\lvmen\src\licensedcode\data\rules\unknown-license-reference_276.yml", "YAML", 0, 0, 0, 8, 0, 0, 1, 9
"d:\IDEWORK\lvmen\src\licensedcode\data\rules\unknown-license-reference_277.yml", "YAML", 0, 0, 0, 5, 0, 0, 1, 6
"d:\IDEWORK\lvmen\src\licensedcode\data\rules\unknown-license-reference_278.yml", "YAML", 0, 0, 0, 5, 0, 0, 1, 6
"d:\IDEWORK\lvmen\src\licensedcode\data\rules\unknown-license-reference_279.yml", "YAML", 0, 0, 0, 7, 0, 0, 1, 8
"d:\IDEWORK\lvmen\src\licensedcode\data\rules\unknown-license-reference_28.yml", "YAML", 0, 0, 0, 5, 0, 0, 1, 6
"d:\IDEWORK\lvmen\src\licensedcode\data\rules\unknown-license-reference_280.yml", "YAML", 0, 0, 0, 5, 0, 0, 1, 6
"d:\IDEWORK\lvmen\src\licensedcode\data\rules\unknown-license-reference_281.yml", "YAML", 0, 0, 0, 5, 0, 0, 1, 6
"d:\IDEWORK\lvmen\src\licensedcode\data\rules\unknown-license-reference_282.yml", "YAML", 0, 0, 0, 5, 0, 0, 1, 6
"d:\IDEWORK\lvmen\src\licensedcode\data\rules\unknown-license-reference_283.yml", "YAML", 0, 0, 0, 5, 0, 0, 1, 6
"d:\IDEWORK\lvmen\src\licensedcode\data\rules\unknown-license-reference_284.yml", "YAML", 0, 0, 0, 5, 0, 0, 1, 6
"d:\IDEWORK\lvmen\src\licensedcode\data\rules\unknown-license-reference_285.yml", "YAML", 0, 0, 0, 5, 0, 0, 1, 6
"d:\IDEWORK\lvmen\src\licensedcode\data\rules\unknown-license-reference_286.yml", "YAML", 0, 0, 0, 5, 0, 0, 1, 6
"d:\IDEWORK\lvmen\src\licensedcode\data\rules\unknown-license-reference_287.yml", "YAML", 0, 0, 0, 5, 0, 0, 1, 6
"d:\IDEWORK\lvmen\src\licensedcode\data\rules\unknown-license-reference_288.yml", "YAML", 0, 0, 0, 3, 0, 0, 1, 4
"d:\IDEWORK\lvmen\src\licensedcode\data\rules\unknown-license-reference_289.yml", "YAML", 0, 0, 0, 6, 0, 0, 1, 7
"d:\IDEWORK\lvmen\src\licensedcode\data\rules\unknown-license-reference_29.yml", "YAML", 0, 0, 0, 5, 0, 0, 1, 6
"d:\IDEWORK\lvmen\src\licensedcode\data\rules\unknown-license-reference_290.yml", "YAML", 0, 0, 0, 5, 0, 0, 1, 6
"d:\IDEWORK\lvmen\src\licensedcode\data\rules\unknown-license-reference_291.yml", "YAML", 0, 0, 0, 3, 0, 0, 1, 4
"d:\IDEWORK\lvmen\src\licensedcode\data\rules\unknown-license-reference_292.yml", "YAML", 0, 0, 0, 5, 0, 0, 1, 6
"d:\IDEWORK\lvmen\src\licensedcode\data\rules\unknown-license-reference_293.yml", "YAML", 0, 0, 0, 4, 0, 0, 1, 5
"d:\IDEWORK\lvmen\src\licensedcode\data\rules\unknown-license-reference_294.yml", "YAML", 0, 0, 0, 3, 0, 0, 1, 4
"d:\IDEWORK\lvmen\src\licensedcode\data\rules\unknown-license-reference_295.yml", "YAML", 0, 0, 0, 3, 0, 0, 1, 4
"d:\IDEWORK\lvmen\src\licensedcode\data\rules\unknown-license-reference_296.yml", "YAML", 0, 0, 0, 5, 0, 0, 1, 6
"d:\IDEWORK\lvmen\src\licensedcode\data\rules\unknown-license-reference_297.yml", "YAML", 0, 0, 0, 5, 0, 0, 1, 6
"d:\IDEWORK\lvmen\src\licensedcode\data\rules\unknown-license-reference_298.yml", "YAML", 0, 0, 0, 5, 0, 0, 1, 6
"d:\IDEWORK\lvmen\src\licensedcode\data\rules\unknown-license-reference_299.yml", "YAML", 0, 0, 0, 5, 0, 0, 1, 6
"d:\IDEWORK\lvmen\src\licensedcode\data\rules\unknown-license-reference_3.yml", "YAML", 0, 0, 0, 5, 0, 0, 1, 6
"d:\IDEWORK\lvmen\src\licensedcode\data\rules\unknown-license-reference_30.yml", "YAML", 0, 0, 0, 5, 0, 0, 1, 6
"d:\IDEWORK\lvmen\src\licensedcode\data\rules\unknown-license-reference_300.yml", "YAML", 0, 0, 0, 5, 0, 0, 1, 6
"d:\IDEWORK\lvmen\src\licensedcode\data\rules\unknown-license-reference_301.yml", "YAML", 0, 0, 0, 3, 0, 0, 1, 4
"d:\IDEWORK\lvmen\src\licensedcode\data\rules\unknown-license-reference_302.yml", "YAML", 0, 0, 0, 3, 0, 0, 1, 4
"d:\IDEWORK\lvmen\src\licensedcode\data\rules\unknown-license-reference_303.yml", "YAML", 0, 0, 0, 5, 0, 0, 1, 6
"d:\IDEWORK\lvmen\src\licensedcode\data\rules\unknown-license-reference_304.yml", "YAML", 0, 0, 0, 3, 0, 0, 1, 4
"d:\IDEWORK\lvmen\src\licensedcode\data\rules\unknown-license-reference_305.yml", "YAML", 0, 0, 0, 3, 0, 0, 1, 4
"d:\IDEWORK\lvmen\src\licensedcode\data\rules\unknown-license-reference_306.yml", "YAML", 0, 0, 0, 5, 0, 0, 1, 6
"d:\IDEWORK\lvmen\src\licensedcode\data\rules\unknown-license-reference_307.yml", "YAML", 0, 0, 0, 3, 0, 0, 1, 4
"d:\IDEWORK\lvmen\src\licensedcode\data\rules\unknown-license-reference_308.yml", "YAML", 0, 0, 0, 5, 0, 0, 1, 6
"d:\IDEWORK\lvmen\src\licensedcode\data\rules\unknown-license-reference_309.yml", "YAML", 0, 0, 0, 3, 0, 0, 1, 4
"d:\IDEWORK\lvmen\src\licensedcode\data\rules\unknown-license-reference_31.yml", "YAML", 0, 0, 0, 5, 0, 0, 1, 6
"d:\IDEWORK\lvmen\src\licensedcode\data\rules\unknown-license-reference_310.yml", "YAML", 0, 0, 0, 3, 0, 0, 1, 4
"d:\IDEWORK\lvmen\src\licensedcode\data\rules\unknown-license-reference_311.yml", "YAML", 0, 0, 0, 2, 0, 0, 1, 3
"d:\IDEWORK\lvmen\src\licensedcode\data\rules\unknown-license-reference_312.yml", "YAML", 0, 0, 0, 3, 0, 0, 1, 4
"d:\IDEWORK\lvmen\src\licensedcode\data\rules\unknown-license-reference_313.yml", "YAML", 0, 0, 0, 6, 0, 0, 1, 7
"d:\IDEWORK\lvmen\src\licensedcode\data\rules\unknown-license-reference_314.yml", "YAML", 0, 0, 0, 2, 0, 0, 1, 3
"d:\IDEWORK\lvmen\src\licensedcode\data\rules\unknown-license-reference_315.yml", "YAML", 0, 0, 0, 4, 0, 0, 1, 5
"d:\IDEWORK\lvmen\src\licensedcode\data\rules\unknown-license-reference_316.yml", "YAML", 0, 0, 0, 5, 0, 0, 1, 6
"d:\IDEWORK\lvmen\src\licensedcode\data\rules\unknown-license-reference_317.yml", "YAML", 0, 0, 0, 3, 0, 0, 1, 4
"d:\IDEWORK\lvmen\src\licensedcode\data\rules\unknown-license-reference_318.yml", "YAML", 0, 0, 0, 3, 0, 0, 1, 4
"d:\IDEWORK\lvmen\src\licensedcode\data\rules\unknown-license-reference_319.yml", "YAML", 0, 0, 0, 3, 0, 0, 1, 4
"d:\IDEWORK\lvmen\src\licensedcode\data\rules\unknown-license-reference_32.yml", "YAML", 0, 0, 0, 5, 0, 0, 1, 6
"d:\IDEWORK\lvmen\src\licensedcode\data\rules\unknown-license-reference_320.yml", "YAML", 0, 0, 0, 5, 0, 0, 1, 6
"d:\IDEWORK\lvmen\src\licensedcode\data\rules\unknown-license-reference_321.yml", "YAML", 0, 0, 0, 3, 0, 0, 1, 4
"d:\IDEWORK\lvmen\src\licensedcode\data\rules\unknown-license-reference_322.yml", "YAML", 0, 0, 0, 5, 0, 0, 1, 6
"d:\IDEWORK\lvmen\src\licensedcode\data\rules\unknown-license-reference_33.yml", "YAML", 0, 0, 0, 5, 0, 0, 1, 6
"d:\IDEWORK\lvmen\src\licensedcode\data\rules\unknown-license-reference_34.yml", "YAML", 0, 0, 0, 4, 0, 0, 1, 5
"d:\IDEWORK\lvmen\src\licensedcode\data\rules\unknown-license-reference_35.yml", "YAML", 0, 0, 0, 6, 0, 0, 1, 7
"d:\IDEWORK\lvmen\src\licensedcode\data\rules\unknown-license-reference_36.yml", "YAML", 0, 0, 0, 4, 0, 0, 1, 5
"d:\IDEWORK\lvmen\src\licensedcode\data\rules\unknown-license-reference_366.yml", "YAML", 0, 0, 0, 6, 0, 0, 1, 7
"d:\IDEWORK\lvmen\src\licensedcode\data\rules\unknown-license-reference_37.yml", "YAML", 0, 0, 0, 6, 0, 0, 1, 7
"d:\IDEWORK\lvmen\src\licensedcode\data\rules\unknown-license-reference_38.yml", "YAML", 0, 0, 0, 5, 0, 0, 1, 6
"d:\IDEWORK\lvmen\src\licensedcode\data\rules\unknown-license-reference_39.yml", "YAML", 0, 0, 0, 5, 0, 0, 1, 6
"d:\IDEWORK\lvmen\src\licensedcode\data\rules\unknown-license-reference_4.yml", "YAML", 0, 0, 0, 4, 0, 0, 1, 5
"d:\IDEWORK\lvmen\src\licensedcode\data\rules\unknown-license-reference_40.yml", "YAML", 0, 0, 0, 6, 0, 0, 1, 7
"d:\IDEWORK\lvmen\src\licensedcode\data\rules\unknown-license-reference_41.yml", "YAML", 0, 0, 0, 5, 0, 0, 1, 6
"d:\IDEWORK\lvmen\src\licensedcode\data\rules\unknown-license-reference_42.yml", "YAML", 0, 0, 0, 5, 0, 0, 1, 6
"d:\IDEWORK\lvmen\src\licensedcode\data\rules\unknown-license-reference_43.yml", "YAML", 0, 0, 0, 5, 0, 0, 1, 6
"d:\IDEWORK\lvmen\src\licensedcode\data\rules\unknown-license-reference_44.yml", "YAML", 0, 0, 0, 5, 0, 0, 1, 6
"d:\IDEWORK\lvmen\src\licensedcode\data\rules\unknown-license-reference_45.yml", "YAML", 0, 0, 0, 3, 0, 0, 1, 4
"d:\IDEWORK\lvmen\src\licensedcode\data\rules\unknown-license-reference_46.yml", "YAML", 0, 0, 0, 6, 0, 0, 1, 7
"d:\IDEWORK\lvmen\src\licensedcode\data\rules\unknown-license-reference_47.yml", "YAML", 0, 0, 0, 5, 0, 0, 1, 6
"d:\IDEWORK\lvmen\src\licensedcode\data\rules\unknown-license-reference_48.yml", "YAML", 0, 0, 0, 3, 0, 0, 1, 4
"d:\IDEWORK\lvmen\src\licensedcode\data\rules\unknown-license-reference_49.yml", "YAML", 0, 0, 0, 5, 0, 0, 1, 6
"d:\IDEWORK\lvmen\src\licensedcode\data\rules\unknown-license-reference_5.yml", "YAML", 0, 0, 0, 5, 0, 0, 1, 6
"d:\IDEWORK\lvmen\src\licensedcode\data\rules\unknown-license-reference_50.yml", "YAML", 0, 0, 0, 3, 0, 0, 1, 4
"d:\IDEWORK\lvmen\src\licensedcode\data\rules\unknown-license-reference_51.yml", "YAML", 0, 0, 0, 5, 0, 0, 1, 6
"d:\IDEWORK\lvmen\src\licensedcode\data\rules\unknown-license-reference_52.yml", "YAML", 0, 0, 0, 3, 0, 0, 1, 4
"d:\IDEWORK\lvmen\src\licensedcode\data\rules\unknown-license-reference_53.yml", "YAML", 0, 0, 0, 5, 0, 0, 1, 6
"d:\IDEWORK\lvmen\src\licensedcode\data\rules\unknown-license-reference_54.yml", "YAML", 0, 0, 0, 5, 0, 0, 1, 6
"d:\IDEWORK\lvmen\src\licensedcode\data\rules\unknown-license-reference_55.yml", "YAML", 0, 0, 0, 5, 0, 0, 1, 6
"d:\IDEWORK\lvmen\src\licensedcode\data\rules\unknown-license-reference_558.yml", "YAML", 0, 0, 0, 5, 0, 0, 1, 6
"d:\IDEWORK\lvmen\src\licensedcode\data\rules\unknown-license-reference_56.yml", "YAML", 0, 0, 0, 3, 0, 0, 1, 4
"d:\IDEWORK\lvmen\src\licensedcode\data\rules\unknown-license-reference_57.yml", "YAML", 0, 0, 0, 6, 0, 0, 1, 7
"d:\IDEWORK\lvmen\src\licensedcode\data\rules\unknown-license-reference_58.yml", "YAML", 0, 0, 0, 3, 0, 0, 1, 4
"d:\IDEWORK\lvmen\src\licensedcode\data\rules\unknown-license-reference_59.yml", "YAML", 0, 0, 0, 3, 0, 0, 1, 4
"d:\IDEWORK\lvmen\src\licensedcode\data\rules\unknown-license-reference_6.yml", "YAML", 0, 0, 0, 5, 0, 0, 1, 6
"d:\IDEWORK\lvmen\src\licensedcode\data\rules\unknown-license-reference_60.yml", "YAML", 0, 0, 0, 3, 0, 0, 1, 4
"d:\IDEWORK\lvmen\src\licensedcode\data\rules\unknown-license-reference_61.yml", "YAML", 0, 0, 0, 4, 0, 0, 1, 5
"d:\IDEWORK\lvmen\src\licensedcode\data\rules\unknown-license-reference_62.yml", "YAML", 0, 0, 0, 3, 0, 0, 1, 4
"d:\IDEWORK\lvmen\src\licensedcode\data\rules\unknown-license-reference_63.yml", "YAML", 0, 0, 0, 5, 0, 0, 1, 6
"d:\IDEWORK\lvmen\src\licensedcode\data\rules\unknown-license-reference_64.yml", "YAML", 0, 0, 0, 3, 0, 0, 1, 4
"d:\IDEWORK\lvmen\src\licensedcode\data\rules\unknown-license-reference_65.yml", "YAML", 0, 0, 0, 6, 0, 0, 1, 7
"d:\IDEWORK\lvmen\src\licensedcode\data\rules\unknown-license-reference_66.yml", "YAML", 0, 0, 0, 3, 0, 0, 1, 4
"d:\IDEWORK\lvmen\src\licensedcode\data\rules\unknown-license-reference_67.yml", "YAML", 0, 0, 0, 4, 0, 0, 1, 5
"d:\IDEWORK\lvmen\src\licensedcode\data\rules\unknown-license-reference_68.yml", "YAML", 0, 0, 0, 3, 0, 0, 1, 4
"d:\IDEWORK\lvmen\src\licensedcode\data\rules\unknown-license-reference_69.yml", "YAML", 0, 0, 0, 3, 0, 0, 1, 4
"d:\IDEWORK\lvmen\src\licensedcode\data\rules\unknown-license-reference_7.yml", "YAML", 0, 0, 0, 5, 0, 0, 1, 6
"d:\IDEWORK\lvmen\src\licensedcode\data\rules\unknown-license-reference_70.yml", "YAML", 0, 0, 0, 5, 0, 0, 1, 6
"d:\IDEWORK\lvmen\src\licensedcode\data\rules\unknown-license-reference_700.yml", "YAML", 0, 0, 0, 5, 0, 0, 1, 6
"d:\IDEWORK\lvmen\src\licensedcode\data\rules\unknown-license-reference_71.yml", "YAML", 0, 0, 0, 5, 0, 0, 1, 6
"d:\IDEWORK\lvmen\src\licensedcode\data\rules\unknown-license-reference_72.yml", "YAML", 0, 0, 0, 5, 0, 0, 1, 6
"d:\IDEWORK\lvmen\src\licensedcode\data\rules\unknown-license-reference_73.yml", "YAML", 0, 0, 0, 5, 0, 0, 1, 6
"d:\IDEWORK\lvmen\src\licensedcode\data\rules\unknown-license-reference_74.yml", "YAML", 0, 0, 0, 5, 0, 0, 1, 6
"d:\IDEWORK\lvmen\src\licensedcode\data\rules\unknown-license-reference_75.yml", "YAML", 0, 0, 0, 5, 0, 0, 1, 6
"d:\IDEWORK\lvmen\src\licensedcode\data\rules\unknown-license-reference_76.yml", "YAML", 0, 0, 0, 3, 0, 0, 1, 4
"d:\IDEWORK\lvmen\src\licensedcode\data\rules\unknown-license-reference_77.yml", "YAML", 0, 0, 0, 3, 0, 0, 1, 4
"d:\IDEWORK\lvmen\src\licensedcode\data\rules\unknown-license-reference_78.yml", "YAML", 0, 0, 0, 3, 0, 0, 1, 4
"d:\IDEWORK\lvmen\src\licensedcode\data\rules\unknown-license-reference_79.yml", "YAML", 0, 0, 0, 5, 0, 0, 1, 6
"d:\IDEWORK\lvmen\src\licensedcode\data\rules\unknown-license-reference_8.yml", "YAML", 0, 0, 0, 5, 0, 0, 1, 6
"d:\IDEWORK\lvmen\src\licensedcode\data\rules\unknown-license-reference_80.yml", "YAML", 0, 0, 0, 5, 0, 0, 1, 6
"d:\IDEWORK\lvmen\src\licensedcode\data\rules\unknown-license-reference_81.yml", "YAML", 0, 0, 0, 5, 0, 0, 1, 6
"d:\IDEWORK\lvmen\src\licensedcode\data\rules\unknown-license-reference_82.yml", "YAML", 0, 0, 0, 5, 0, 0, 1, 6
"d:\IDEWORK\lvmen\src\licensedcode\data\rules\unknown-license-reference_83.yml", "YAML", 0, 0, 0, 5, 0, 0, 1, 6
"d:\IDEWORK\lvmen\src\licensedcode\data\rules\unknown-license-reference_84.yml", "YAML", 0, 0, 0, 5, 0, 0, 1, 6
"d:\IDEWORK\lvmen\src\licensedcode\data\rules\unknown-license-reference_85.yml", "YAML", 0, 0, 0, 5, 0, 0, 1, 6
"d:\IDEWORK\lvmen\src\licensedcode\data\rules\unknown-license-reference_86.yml", "YAML", 0, 0, 0, 5, 0, 0, 1, 6
"d:\IDEWORK\lvmen\src\licensedcode\data\rules\unknown-license-reference_87.yml", "YAML", 0, 0, 0, 3, 0, 0, 1, 4
"d:\IDEWORK\lvmen\src\licensedcode\data\rules\unknown-license-reference_88.yml", "YAML", 0, 0, 0, 5, 0, 0, 1, 6
"d:\IDEWORK\lvmen\src\licensedcode\data\rules\unknown-license-reference_89.yml", "YAML", 0, 0, 0, 3, 0, 0, 1, 4
"d:\IDEWORK\lvmen\src\licensedcode\data\rules\unknown-license-reference_9.yml", "YAML", 0, 0, 0, 5, 0, 0, 1, 6
"d:\IDEWORK\lvmen\src\licensedcode\data\rules\unknown-license-reference_90.yml", "YAML", 0, 0, 0, 5, 0, 0, 1, 6
"d:\IDEWORK\lvmen\src\licensedcode\data\rules\unknown-license-reference_91.yml", "YAML", 0, 0, 0, 5, 0, 0, 1, 6
"d:\IDEWORK\lvmen\src\licensedcode\data\rules\unknown-license-reference_92.yml", "YAML", 0, 0, 0, 5, 0, 0, 1, 6
"d:\IDEWORK\lvmen\src\licensedcode\data\rules\unknown-license-reference_93.yml", "YAML", 0, 0, 0, 5, 0, 0, 1, 6
"d:\IDEWORK\lvmen\src\licensedcode\data\rules\unknown-license-reference_94.yml", "YAML", 0, 0, 0, 5, 0, 0, 1, 6
"d:\IDEWORK\lvmen\src\licensedcode\data\rules\unknown-license-reference_95.yml", "YAML", 0, 0, 0, 5, 0, 0, 1, 6
"d:\IDEWORK\lvmen\src\licensedcode\data\rules\unknown-license-reference_96.yml", "YAML", 0, 0, 0, 5, 0, 0, 1, 6
"d:\IDEWORK\lvmen\src\licensedcode\data\rules\unknown-license-reference_97.yml", "YAML", 0, 0, 0, 5, 0, 0, 1, 6
"d:\IDEWORK\lvmen\src\licensedcode\data\rules\unknown-license-reference_98.yml", "YAML", 0, 0, 0, 5, 0, 0, 1, 6
"d:\IDEWORK\lvmen\src\licensedcode\data\rules\unknown-license-reference_99.yml", "YAML", 0, 0, 0, 5, 0, 0, 1, 6
"d:\IDEWORK\lvmen\src\licensedcode\data\rules\unknown-license-reference_and_apache-2.0_and_proprietary-license_1.yml", "YAML", 0, 0, 0, 10, 0, 0, 1, 11
"d:\IDEWORK\lvmen\src\licensedcode\data\rules\unknown-license-reference_and_trademark-notice_1.yml", "YAML", 0, 0, 0, 6, 0, 0, 1, 7
"d:\IDEWORK\lvmen\src\licensedcode\data\rules\unknown-license-reference_batelle.yml", "YAML", 0, 0, 0, 5, 0, 0, 1, 6
"d:\IDEWORK\lvmen\src\licensedcode\data\rules\unknown-license-reference_dual-licensed.yml", "YAML", 0, 0, 0, 3, 0, 0, 1, 4
"d:\IDEWORK\lvmen\src\licensedcode\data\rules\unknown-license-reference_not-a-license_259.yml", "YAML", 0, 0, 0, 3, 0, 0, 1, 4
"d:\IDEWORK\lvmen\src\licensedcode\data\rules\unknown-license-reference_nuget_url_115.yml", "YAML", 0, 0, 0, 5, 0, 0, 1, 6
"d:\IDEWORK\lvmen\src\licensedcode\data\rules\unknown-license-reference_nuget_url_13.yml", "YAML", 0, 0, 0, 5, 0, 0, 1, 6
"d:\IDEWORK\lvmen\src\licensedcode\data\rules\unknown-license-reference_nuget_url_172.yml", "YAML", 0, 0, 0, 5, 0, 0, 1, 6
"d:\IDEWORK\lvmen\src\licensedcode\data\rules\unknown-license-reference_nuget_url_220.yml", "YAML", 0, 0, 0, 5, 0, 0, 1, 6
"d:\IDEWORK\lvmen\src\licensedcode\data\rules\unknown-license-reference_nuget_url_24.yml", "YAML", 0, 0, 0, 3, 0, 0, 1, 4
"d:\IDEWORK\lvmen\src\licensedcode\data\rules\unknown-license-reference_nuget_url_249.yml", "YAML", 0, 0, 0, 5, 0, 0, 1, 6
"d:\IDEWORK\lvmen\src\licensedcode\data\rules\unknown-license-reference_nuget_url_25.yml", "YAML", 0, 0, 0, 3, 0, 0, 1, 4
"d:\IDEWORK\lvmen\src\licensedcode\data\rules\unknown-license-reference_nuget_url_251.yml", "YAML", 0, 0, 0, 5, 0, 0, 1, 6
"d:\IDEWORK\lvmen\src\licensedcode\data\rules\unknown-license-reference_nuget_url_252.yml", "YAML", 0, 0, 0, 5, 0, 0, 1, 6
"d:\IDEWORK\lvmen\src\licensedcode\data\rules\unknown-license-reference_nuget_url_258.yml", "YAML", 0, 0, 0, 5, 0, 0, 1, 6
"d:\IDEWORK\lvmen\src\licensedcode\data\rules\unknown-license-reference_nuget_url_361.yml", "YAML", 0, 0, 0, 5, 0, 0, 1, 6
"d:\IDEWORK\lvmen\src\licensedcode\data\rules\unknown-license-reference_nuget_url_365.yml", "YAML", 0, 0, 0, 5, 0, 0, 1, 6
"d:\IDEWORK\lvmen\src\licensedcode\data\rules\unknown-license-reference_nuget_url_419.yml", "YAML", 0, 0, 0, 5, 0, 0, 1, 6
"d:\IDEWORK\lvmen\src\licensedcode\data\rules\unknown-license-reference_nuget_url_420.yml", "YAML", 0, 0, 0, 5, 0, 0, 1, 6
"d:\IDEWORK\lvmen\src\licensedcode\data\rules\unknown-license-reference_nuget_url_422.yml", "YAML", 0, 0, 0, 5, 0, 0, 1, 6
"d:\IDEWORK\lvmen\src\licensedcode\data\rules\unknown-license-reference_nuget_url_96.yml", "YAML", 0, 0, 0, 5, 0, 0, 1, 6
"d:\IDEWORK\lvmen\src\licensedcode\data\rules\unknown-license-reference_see-license_1.yml", "YAML", 0, 0, 0, 7, 0, 0, 1, 8
"d:\IDEWORK\lvmen\src\licensedcode\data\rules\unknown-license-reference_see-license_2.yml", "YAML", 0, 0, 0, 5, 0, 0, 1, 6
"d:\IDEWORK\lvmen\src\licensedcode\data\rules\unknown-license-reference_see_license_at_end.yml", "YAML", 0, 0, 0, 5, 0, 0, 1, 6
"d:\IDEWORK\lvmen\src\licensedcode\data\rules\unknown-license-reference_unknown_29.yml", "YAML", 0, 0, 0, 5, 0, 0, 1, 6
"d:\IDEWORK\lvmen\src\licensedcode\data\rules\unknown-license-reference_unknown_58.yml", "YAML", 0, 0, 0, 5, 0, 0, 1, 6
"d:\IDEWORK\lvmen\src\licensedcode\data\rules\unknown-license-reference_unknown_61.yml", "YAML", 0, 0, 0, 5, 0, 0, 1, 6
"d:\IDEWORK\lvmen\src\licensedcode\data\rules\unknown_1.yml", "YAML", 0, 0, 0, 4, 0, 0, 1, 5
"d:\IDEWORK\lvmen\src\licensedcode\data\rules\unknown_10.yml", "YAML", 0, 0, 0, 4, 0, 0, 1, 5
"d:\IDEWORK\lvmen\src\licensedcode\data\rules\unknown_11.yml", "YAML", 0, 0, 0, 3, 0, 0, 1, 4
"d:\IDEWORK\lvmen\src\licensedcode\data\rules\unknown_12.yml", "YAML", 0, 0, 0, 4, 0, 0, 1, 5
"d:\IDEWORK\lvmen\src\licensedcode\data\rules\unknown_14.yml", "YAML", 0, 0, 0, 4, 0, 0, 1, 5
"d:\IDEWORK\lvmen\src\licensedcode\data\rules\unknown_15.yml", "YAML", 0, 0, 0, 4, 0, 0, 1, 5
"d:\IDEWORK\lvmen\src\licensedcode\data\rules\unknown_17.yml", "YAML", 0, 0, 0, 5, 0, 0, 1, 6
"d:\IDEWORK\lvmen\src\licensedcode\data\rules\unknown_18.yml", "YAML", 0, 0, 0, 3, 0, 0, 1, 4
"d:\IDEWORK\lvmen\src\licensedcode\data\rules\unknown_2.yml", "YAML", 0, 0, 0, 3, 0, 0, 1, 4
"d:\IDEWORK\lvmen\src\licensedcode\data\rules\unknown_22.yml", "YAML", 0, 0, 0, 3, 0, 0, 1, 4
"d:\IDEWORK\lvmen\src\licensedcode\data\rules\unknown_23.yml", "YAML", 0, 0, 0, 6, 0, 0, 1, 7
"d:\IDEWORK\lvmen\src\licensedcode\data\rules\unknown_24.yml", "YAML", 0, 0, 0, 3, 0, 0, 1, 4
"d:\IDEWORK\lvmen\src\licensedcode\data\rules\unknown_3.yml", "YAML", 0, 0, 0, 4, 0, 0, 1, 5
"d:\IDEWORK\lvmen\src\licensedcode\data\rules\unknown_32.yml", "YAML", 0, 0, 0, 4, 0, 0, 1, 5
"d:\IDEWORK\lvmen\src\licensedcode\data\rules\unknown_35.yml", "YAML", 0, 0, 0, 3, 0, 0, 1, 4
"d:\IDEWORK\lvmen\src\licensedcode\data\rules\unknown_36.yml", "YAML", 0, 0, 0, 3, 0, 0, 1, 4
"d:\IDEWORK\lvmen\src\licensedcode\data\rules\unknown_4.yml", "YAML", 0, 0, 0, 5, 0, 0, 1, 6
"d:\IDEWORK\lvmen\src\licensedcode\data\rules\unknown_44.yml", "YAML", 0, 0, 0, 4, 0, 0, 1, 5
"d:\IDEWORK\lvmen\src\licensedcode\data\rules\unknown_45.yml", "YAML", 0, 0, 0, 4, 0, 0, 1, 5
"d:\IDEWORK\lvmen\src\licensedcode\data\rules\unknown_47.yml", "YAML", 0, 0, 0, 5, 0, 0, 1, 6
"d:\IDEWORK\lvmen\src\licensedcode\data\rules\unknown_48.yml", "YAML", 0, 0, 0, 5, 0, 0, 1, 6
"d:\IDEWORK\lvmen\src\licensedcode\data\rules\unknown_49.yml", "YAML", 0, 0, 0, 5, 0, 0, 1, 6
"d:\IDEWORK\lvmen\src\licensedcode\data\rules\unknown_5.yml", "YAML", 0, 0, 0, 4, 0, 0, 1, 5
"d:\IDEWORK\lvmen\src\licensedcode\data\rules\unknown_50.yml", "YAML", 0, 0, 0, 3, 0, 0, 1, 4
"d:\IDEWORK\lvmen\src\licensedcode\data\rules\unknown_54.yml", "YAML", 0, 0, 0, 3, 0, 0, 1, 4
"d:\IDEWORK\lvmen\src\licensedcode\data\rules\unknown_55.yml", "YAML", 0, 0, 0, 3, 0, 0, 1, 4
"d:\IDEWORK\lvmen\src\licensedcode\data\rules\unknown_56.yml", "YAML", 0, 0, 0, 3, 0, 0, 1, 4
"d:\IDEWORK\lvmen\src\licensedcode\data\rules\unknown_6.yml", "YAML", 0, 0, 0, 6, 0, 0, 2, 8
"d:\IDEWORK\lvmen\src\licensedcode\data\rules\unknown_7.yml", "YAML", 0, 0, 0, 3, 0, 0, 1, 4
"d:\IDEWORK\lvmen\src\licensedcode\data\rules\unknown_71.yml", "YAML", 0, 0, 0, 3, 0, 0, 1, 4
"d:\IDEWORK\lvmen\src\licensedcode\data\rules\unknown_8.yml", "YAML", 0, 0, 0, 3, 0, 0, 1, 4
"d:\IDEWORK\lvmen\src\licensedcode\data\rules\unknown_9.yml", "YAML", 0, 0, 0, 3, 0, 0, 1, 4
"d:\IDEWORK\lvmen\src\licensedcode\data\rules\unknown_and_gpl-2.0-plus_1.yml", "YAML", 0, 0, 0, 3, 0, 0, 1, 4
"d:\IDEWORK\lvmen\src\licensedcode\data\rules\unknown_and_gpl-2.0-plus_or_lgpl-2.0-plus_1.yml", "YAML", 0, 0, 0, 3, 0, 0, 1, 4
"d:\IDEWORK\lvmen\src\licensedcode\data\rules\unknown_free_1.yml", "YAML", 0, 0, 0, 3, 0, 0, 1, 4
"d:\IDEWORK\lvmen\src\licensedcode\data\rules\unknown_free_2.yml", "YAML", 0, 0, 0, 3, 0, 0, 1, 4
"d:\IDEWORK\lvmen\src\licensedcode\data\rules\unknown_french_1.yml", "YAML", 0, 0, 0, 5, 0, 0, 1, 6
"d:\IDEWORK\lvmen\src\licensedcode\data\rules\unknown_german_1.yml", "YAML", 0, 0, 0, 4, 0, 0, 1, 5
"d:\IDEWORK\lvmen\src\licensedcode\data\rules\unknown_gpl-3.0_15.yml", "YAML", 0, 0, 0, 3, 0, 0, 1, 4
"d:\IDEWORK\lvmen\src\licensedcode\data\rules\unknown_kernel.yml", "YAML", 0, 0, 0, 4, 0, 0, 1, 5
"d:\IDEWORK\lvmen\src\licensedcode\data\rules\unknown_kernel10.yml", "YAML", 0, 0, 0, 4, 0, 0, 1, 5
"d:\IDEWORK\lvmen\src\licensedcode\data\rules\unknown_kernel11.yml", "YAML", 0, 0, 0, 4, 0, 0, 1, 5
"d:\IDEWORK\lvmen\src\licensedcode\data\rules\unknown_kernel12.yml", "YAML", 0, 0, 0, 5, 0, 0, 1, 6
"d:\IDEWORK\lvmen\src\licensedcode\data\rules\unknown_kernel13.yml", "YAML", 0, 0, 0, 5, 0, 0, 1, 6
"d:\IDEWORK\lvmen\src\licensedcode\data\rules\unknown_kernel2.yml", "YAML", 0, 0, 0, 3, 0, 0, 1, 4
"d:\IDEWORK\lvmen\src\licensedcode\data\rules\unknown_kernel3.yml", "YAML", 0, 0, 0, 4, 0, 0, 1, 5
"d:\IDEWORK\lvmen\src\licensedcode\data\rules\unknown_kernel4.yml", "YAML", 0, 0, 0, 3, 0, 0, 1, 4
"d:\IDEWORK\lvmen\src\licensedcode\data\rules\unknown_kernel6.yml", "YAML", 0, 0, 0, 4, 0, 0, 1, 5
"d:\IDEWORK\lvmen\src\licensedcode\data\rules\unknown_kernel7.yml", "YAML", 0, 0, 0, 4, 0, 0, 1, 5
"d:\IDEWORK\lvmen\src\licensedcode\data\rules\unknown_kernel9.yml", "YAML", 0, 0, 0, 4, 0, 0, 1, 5
"d:\IDEWORK\lvmen\src\licensedcode\data\rules\unknown_kernel_and_bsd-new.yml", "YAML", 0, 0, 0, 3, 0, 0, 1, 4
"d:\IDEWORK\lvmen\src\licensedcode\data\rules\unknown_kernel_and_bsd-new_and_gpl-2.0.yml", "YAML", 0, 0, 0, 2, 0, 0, 1, 3
"d:\IDEWORK\lvmen\src\licensedcode\data\rules\unknown_kernel_and_gpl-2.0-plus.yml", "YAML", 0, 0, 0, 4, 0, 0, 1, 5
"d:\IDEWORK\lvmen\src\licensedcode\data\rules\unknown_kernel_and_gpl-2.0-plus2.yml", "YAML", 0, 0, 0, 6, 0, 0, 1, 7
"d:\IDEWORK\lvmen\src\licensedcode\data\rules\unknown_kernel_and_gpl-2.0-plus3.yml", "YAML", 0, 0, 0, 4, 0, 0, 1, 5
"d:\IDEWORK\lvmen\src\licensedcode\data\rules\unknown_kernel_and_gpl-2.0-plus6.yml", "YAML", 0, 0, 0, 2, 0, 0, 1, 3
"d:\IDEWORK\lvmen\src\licensedcode\data\rules\unknown_kernel_and_gpl-2.0.yml", "YAML", 0, 0, 0, 3, 0, 0, 1, 4
"d:\IDEWORK\lvmen\src\licensedcode\data\rules\unknown_kernel_and_gpl-2.0_1.yml", "YAML", 0, 0, 0, 2, 0, 0, 1, 3
"d:\IDEWORK\lvmen\src\licensedcode\data\rules\unknown_kernel_and_gpl-2.0_2.yml", "YAML", 0, 0, 0, 6, 0, 0, 1, 7
"d:\IDEWORK\lvmen\src\licensedcode\data\rules\unknown_license_other_12.yml", "YAML", 0, 0, 0, 3, 0, 0, 1, 4
"d:\IDEWORK\lvmen\src\licensedcode\data\rules\unknown_no_perm.yml", "YAML", 0, 0, 0, 3, 0, 0, 1, 4
"d:\IDEWORK\lvmen\src\licensedcode\data\rules\unknown_not_gpl-2.0_193.yml", "YAML", 0, 0, 0, 6, 0, 0, 1, 7
"d:\IDEWORK\lvmen\src\licensedcode\data\rules\unknown_or_proprietary-license_1.yml", "YAML", 0, 0, 0, 3, 0, 0, 1, 4
"d:\IDEWORK\lvmen\src\licensedcode\data\rules\unlicense_1.yml", "YAML", 0, 0, 0, 6, 0, 0, 1, 7
"d:\IDEWORK\lvmen\src\licensedcode\data\rules\unlicense_10.yml", "YAML", 0, 0, 0, 5, 0, 0, 1, 6
"d:\IDEWORK\lvmen\src\licensedcode\data\rules\unlicense_11.yml", "YAML", 0, 0, 0, 5, 0, 0, 1, 6
"d:\IDEWORK\lvmen\src\licensedcode\data\rules\unlicense_12.yml", "YAML", 0, 0, 0, 5, 0, 0, 1, 6
"d:\IDEWORK\lvmen\src\licensedcode\data\rules\unlicense_13.yml", "YAML", 0, 0, 0, 5, 0, 0, 1, 6
"d:\IDEWORK\lvmen\src\licensedcode\data\rules\unlicense_14.yml", "YAML", 0, 0, 0, 5, 0, 0, 1, 6
"d:\IDEWORK\lvmen\src\licensedcode\data\rules\unlicense_15.yml", "YAML", 0, 0, 0, 5, 0, 0, 1, 6
"d:\IDEWORK\lvmen\src\licensedcode\data\rules\unlicense_16.yml", "YAML", 0, 0, 0, 3, 0, 0, 1, 4
"d:\IDEWORK\lvmen\src\licensedcode\data\rules\unlicense_17.yml", "YAML", 0, 0, 0, 5, 0, 0, 1, 6
"d:\IDEWORK\lvmen\src\licensedcode\data\rules\unlicense_18.yml", "YAML", 0, 0, 0, 7, 0, 0, 1, 8
"d:\IDEWORK\lvmen\src\licensedcode\data\rules\unlicense_19.yml", "YAML", 0, 0, 0, 7, 0, 0, 1, 8
"d:\IDEWORK\lvmen\src\licensedcode\data\rules\unlicense_2.yml", "YAML", 0, 0, 0, 5, 0, 0, 1, 6
"d:\IDEWORK\lvmen\src\licensedcode\data\rules\unlicense_20.yml", "YAML", 0, 0, 0, 7, 0, 0, 1, 8
"d:\IDEWORK\lvmen\src\licensedcode\data\rules\unlicense_21.yml", "YAML", 0, 0, 0, 5, 0, 0, 1, 6
"d:\IDEWORK\lvmen\src\licensedcode\data\rules\unlicense_22.yml", "YAML", 0, 0, 0, 5, 0, 0, 1, 6
"d:\IDEWORK\lvmen\src\licensedcode\data\rules\unlicense_23.yml", "YAML", 0, 0, 0, 3, 0, 0, 1, 4
"d:\IDEWORK\lvmen\src\licensedcode\data\rules\unlicense_24.yml", "YAML", 0, 0, 0, 5, 0, 0, 1, 6
"d:\IDEWORK\lvmen\src\licensedcode\data\rules\unlicense_25.yml", "YAML", 0, 0, 0, 5, 0, 0, 1, 6
"d:\IDEWORK\lvmen\src\licensedcode\data\rules\unlicense_26.yml", "YAML", 0, 0, 0, 3, 0, 0, 1, 4
"d:\IDEWORK\lvmen\src\licensedcode\data\rules\unlicense_27.yml", "YAML", 0, 0, 0, 3, 0, 0, 1, 4
"d:\IDEWORK\lvmen\src\licensedcode\data\rules\unlicense_28.yml", "YAML", 0, 0, 0, 5, 0, 0, 1, 6
"d:\IDEWORK\lvmen\src\licensedcode\data\rules\unlicense_29.yml", "YAML", 0, 0, 0, 5, 0, 0, 1, 6
"d:\IDEWORK\lvmen\src\licensedcode\data\rules\unlicense_3.yml", "YAML", 0, 0, 0, 6, 0, 0, 1, 7
"d:\IDEWORK\lvmen\src\licensedcode\data\rules\unlicense_30.yml", "YAML", 0, 0, 0, 5, 0, 0, 1, 6
"d:\IDEWORK\lvmen\src\licensedcode\data\rules\unlicense_31.yml", "YAML", 0, 0, 0, 5, 0, 0, 1, 6
"d:\IDEWORK\lvmen\src\licensedcode\data\rules\unlicense_32.yml", "YAML", 0, 0, 0, 3, 0, 0, 1, 4
"d:\IDEWORK\lvmen\src\licensedcode\data\rules\unlicense_4.yml", "YAML", 0, 0, 0, 6, 0, 0, 1, 7
"d:\IDEWORK\lvmen\src\licensedcode\data\rules\unlicense_5.yml", "YAML", 0, 0, 0, 5, 0, 0, 1, 6
"d:\IDEWORK\lvmen\src\licensedcode\data\rules\unlicense_6.yml", "YAML", 0, 0, 0, 3, 0, 0, 1, 4
"d:\IDEWORK\lvmen\src\licensedcode\data\rules\unlicense_7.yml", "YAML", 0, 0, 0, 5, 0, 0, 1, 6
"d:\IDEWORK\lvmen\src\licensedcode\data\rules\unlicense_8.yml", "YAML", 0, 0, 0, 4, 0, 0, 1, 5
"d:\IDEWORK\lvmen\src\licensedcode\data\rules\unlicense_9.yml", "YAML", 0, 0, 0, 5, 0, 0, 1, 6
"d:\IDEWORK\lvmen\src\licensedcode\data\rules\unlicense_and_unknown-license-reference_1.yml", "YAML", 0, 0, 0, 5, 0, 0, 1, 6
"d:\IDEWORK\lvmen\src\licensedcode\data\rules\unlicense_nuget_url_1.yml", "YAML", 0, 0, 0, 5, 0, 0, 1, 6
"d:\IDEWORK\lvmen\src\licensedcode\data\rules\unlicense_nuget_url_2.yml", "YAML", 0, 0, 0, 5, 0, 0, 1, 6
"d:\IDEWORK\lvmen\src\licensedcode\data\rules\unlicense_nuget_url_3.yml", "YAML", 0, 0, 0, 5, 0, 0, 1, 6
"d:\IDEWORK\lvmen\src\licensedcode\data\rules\unlicense_url_1.yml", "YAML", 0, 0, 0, 5, 0, 0, 1, 6
"d:\IDEWORK\lvmen\src\licensedcode\data\rules\unlicense_url_2.yml", "YAML", 0, 0, 0, 5, 0, 0, 1, 6
"d:\IDEWORK\lvmen\src\licensedcode\data\rules\unlicense_url_badge.yml", "YAML", 0, 0, 0, 6, 0, 0, 1, 7
"d:\IDEWORK\lvmen\src\licensedcode\data\rules\unpublished-source_1.yml", "YAML", 0, 0, 0, 2, 0, 0, 1, 3
"d:\IDEWORK\lvmen\src\licensedcode\data\rules\unpublished-source_2.yml", "YAML", 0, 0, 0, 2, 0, 0, 1, 3
"d:\IDEWORK\lvmen\src\licensedcode\data\rules\unpublished-source_3.yml", "YAML", 0, 0, 0, 2, 0, 0, 1, 3
"d:\IDEWORK\lvmen\src\licensedcode\data\rules\unpublished-source_4.yml", "YAML", 0, 0, 0, 3, 0, 0, 1, 4
"d:\IDEWORK\lvmen\src\licensedcode\data\rules\unrar_1.yml", "YAML", 0, 0, 0, 3, 0, 0, 1, 4
"d:\IDEWORK\lvmen\src\licensedcode\data\rules\unrar_2.yml", "YAML", 0, 0, 0, 3, 0, 0, 1, 4
"d:\IDEWORK\lvmen\src\licensedcode\data\rules\uofu-rfpl.yml", "YAML", 0, 0, 0, 5, 0, 0, 1, 6
"d:\IDEWORK\lvmen\src\licensedcode\data\rules\uoi-ncsa_1.yml", "YAML", 0, 0, 0, 5, 0, 0, 1, 6
"d:\IDEWORK\lvmen\src\licensedcode\data\rules\uoi-ncsa_10.yml", "YAML", 0, 0, 0, 6, 0, 0, 1, 7
"d:\IDEWORK\lvmen\src\licensedcode\data\rules\uoi-ncsa_11.yml", "YAML", 0, 0, 0, 3, 0, 0, 1, 4
"d:\IDEWORK\lvmen\src\licensedcode\data\rules\uoi-ncsa_12.yml", "YAML", 0, 0, 0, 3, 0, 0, 1, 4
"d:\IDEWORK\lvmen\src\licensedcode\data\rules\uoi-ncsa_13.yml", "YAML", 0, 0, 0, 5, 0, 0, 1, 6
"d:\IDEWORK\lvmen\src\licensedcode\data\rules\uoi-ncsa_14.yml", "YAML", 0, 0, 0, 4, 0, 0, 1, 5
"d:\IDEWORK\lvmen\src\licensedcode\data\rules\uoi-ncsa_15.yml", "YAML", 0, 0, 0, 6, 0, 0, 1, 7
"d:\IDEWORK\lvmen\src\licensedcode\data\rules\uoi-ncsa_16.yml", "YAML", 0, 0, 0, 3, 0, 0, 1, 4
"d:\IDEWORK\lvmen\src\licensedcode\data\rules\uoi-ncsa_17.yml", "YAML", 0, 0, 0, 3, 0, 0, 1, 4
"d:\IDEWORK\lvmen\src\licensedcode\data\rules\uoi-ncsa_18.yml", "YAML", 0, 0, 0, 4, 0, 0, 1, 5
"d:\IDEWORK\lvmen\src\licensedcode\data\rules\uoi-ncsa_19.yml", "YAML", 0, 0, 0, 5, 0, 0, 1, 6
"d:\IDEWORK\lvmen\src\licensedcode\data\rules\uoi-ncsa_2.yml", "YAML", 0, 0, 0, 5, 0, 0, 1, 6
"d:\IDEWORK\lvmen\src\licensedcode\data\rules\uoi-ncsa_20.yml", "YAML", 0, 0, 0, 4, 0, 0, 1, 5
"d:\IDEWORK\lvmen\src\licensedcode\data\rules\uoi-ncsa_21.yml", "YAML", 0, 0, 0, 5, 0, 0, 1, 6
"d:\IDEWORK\lvmen\src\licensedcode\data\rules\uoi-ncsa_22.yml", "YAML", 0, 0, 0, 5, 0, 0, 1, 6
"d:\IDEWORK\lvmen\src\licensedcode\data\rules\uoi-ncsa_23.yml", "YAML", 0, 0, 0, 4, 0, 0, 1, 5
"d:\IDEWORK\lvmen\src\licensedcode\data\rules\uoi-ncsa_24.yml", "YAML", 0, 0, 0, 2, 0, 0, 1, 3
"d:\IDEWORK\lvmen\src\licensedcode\data\rules\uoi-ncsa_25.yml", "YAML", 0, 0, 0, 3, 0, 0, 1, 4
"d:\IDEWORK\lvmen\src\licensedcode\data\rules\uoi-ncsa_26.yml", "YAML", 0, 0, 0, 3, 0, 0, 1, 4
"d:\IDEWORK\lvmen\src\licensedcode\data\rules\uoi-ncsa_27.yml", "YAML", 0, 0, 0, 4, 0, 0, 1, 5
"d:\IDEWORK\lvmen\src\licensedcode\data\rules\uoi-ncsa_28.yml", "YAML", 0, 0, 0, 4, 0, 0, 1, 5
"d:\IDEWORK\lvmen\src\licensedcode\data\rules\uoi-ncsa_29.yml", "YAML", 0, 0, 0, 5, 0, 0, 1, 6
"d:\IDEWORK\lvmen\src\licensedcode\data\rules\uoi-ncsa_3.yml", "YAML", 0, 0, 0, 4, 0, 0, 1, 5
"d:\IDEWORK\lvmen\src\licensedcode\data\rules\uoi-ncsa_30.yml", "YAML", 0, 0, 0, 3, 0, 0, 1, 4
"d:\IDEWORK\lvmen\src\licensedcode\data\rules\uoi-ncsa_31.yml", "YAML", 0, 0, 0, 5, 0, 0, 1, 6
"d:\IDEWORK\lvmen\src\licensedcode\data\rules\uoi-ncsa_32.yml", "YAML", 0, 0, 0, 4, 0, 0, 1, 5
"d:\IDEWORK\lvmen\src\licensedcode\data\rules\uoi-ncsa_33.yml", "YAML", 0, 0, 0, 3, 0, 0, 1, 4
"d:\IDEWORK\lvmen\src\licensedcode\data\rules\uoi-ncsa_34.yml", "YAML", 0, 0, 0, 3, 0, 0, 1, 4
"d:\IDEWORK\lvmen\src\licensedcode\data\rules\uoi-ncsa_35.yml", "YAML", 0, 0, 0, 3, 0, 0, 1, 4
"d:\IDEWORK\lvmen\src\licensedcode\data\rules\uoi-ncsa_36.yml", "YAML", 0, 0, 0, 3, 0, 0, 1, 4
"d:\IDEWORK\lvmen\src\licensedcode\data\rules\uoi-ncsa_37.yml", "YAML", 0, 0, 0, 5, 0, 0, 1, 6
"d:\IDEWORK\lvmen\src\licensedcode\data\rules\uoi-ncsa_38.yml", "YAML", 0, 0, 0, 3, 0, 0, 1, 4
"d:\IDEWORK\lvmen\src\licensedcode\data\rules\uoi-ncsa_39.yml", "YAML", 0, 0, 0, 5, 0, 0, 1, 6
"d:\IDEWORK\lvmen\src\licensedcode\data\rules\uoi-ncsa_4.yml", "YAML", 0, 0, 0, 3, 0, 0, 1, 4
"d:\IDEWORK\lvmen\src\licensedcode\data\rules\uoi-ncsa_40.yml", "YAML", 0, 0, 0, 3, 0, 0, 1, 4
"d:\IDEWORK\lvmen\src\licensedcode\data\rules\uoi-ncsa_41.yml", "YAML", 0, 0, 0, 3, 0, 0, 1, 4
"d:\IDEWORK\lvmen\src\licensedcode\data\rules\uoi-ncsa_42.yml", "YAML", 0, 0, 0, 3, 0, 0, 1, 4
"d:\IDEWORK\lvmen\src\licensedcode\data\rules\uoi-ncsa_43.yml", "YAML", 0, 0, 0, 3, 0, 0, 1, 4
"d:\IDEWORK\lvmen\src\licensedcode\data\rules\uoi-ncsa_5.yml", "YAML", 0, 0, 0, 5, 0, 0, 1, 6
"d:\IDEWORK\lvmen\src\licensedcode\data\rules\uoi-ncsa_544.yml", "YAML", 0, 0, 0, 3, 0, 0, 1, 4
"d:\IDEWORK\lvmen\src\licensedcode\data\rules\uoi-ncsa_6.yml", "YAML", 0, 0, 0, 3, 0, 0, 1, 4
"d:\IDEWORK\lvmen\src\licensedcode\data\rules\uoi-ncsa_7.yml", "YAML", 0, 0, 0, 5, 0, 0, 1, 6
"d:\IDEWORK\lvmen\src\licensedcode\data\rules\uoi-ncsa_8.yml", "YAML", 0, 0, 0, 3, 0, 0, 1, 4
"d:\IDEWORK\lvmen\src\licensedcode\data\rules\uoi-ncsa_9.yml", "YAML", 0, 0, 0, 3, 0, 0, 1, 4
"d:\IDEWORK\lvmen\src\licensedcode\data\rules\uoi-ncsa_and_mit-old-style-no-advert.yml", "YAML", 0, 0, 0, 7, 0, 0, 1, 8
"d:\IDEWORK\lvmen\src\licensedcode\data\rules\uoi-ncsa_and_other.yml", "YAML", 0, 0, 0, 13, 0, 0, 2, 15
"d:\IDEWORK\lvmen\src\licensedcode\data\rules\uoi-ncsa_and_unknown-license-reference_1.yml", "YAML", 0, 0, 0, 3, 0, 0, 1, 4
"d:\IDEWORK\lvmen\src\licensedcode\data\rules\uoi-ncsa_and_unknown-license-reference_2.yml", "YAML", 0, 0, 0, 3, 0, 0, 1, 4
"d:\IDEWORK\lvmen\src\licensedcode\data\rules\uoi-ncsa_or_mit_1.yml", "YAML", 0, 0, 0, 2, 0, 0, 1, 3
"d:\IDEWORK\lvmen\src\licensedcode\data\rules\uoi-ncsa_or_mit_2.yml", "YAML", 0, 0, 0, 5, 0, 0, 1, 6
"d:\IDEWORK\lvmen\src\licensedcode\data\rules\uoi-ncsa_or_mit_3.yml", "YAML", 0, 0, 0, 4, 0, 0, 1, 5
"d:\IDEWORK\lvmen\src\licensedcode\data\rules\uoi-ncsa_or_mit_4.yml", "YAML", 0, 0, 0, 2, 0, 0, 1, 3
"d:\IDEWORK\lvmen\src\licensedcode\data\rules\uoi-ncsa_or_mit_5.yml", "YAML", 0, 0, 0, 3, 0, 0, 1, 4
"d:\IDEWORK\lvmen\src\licensedcode\data\rules\uoi-ncsa_or_mit_and_generic-cla_1.yml", "YAML", 0, 0, 0, 3, 0, 0, 1, 4
"d:\IDEWORK\lvmen\src\licensedcode\data\rules\uoi-ncsa_or_mit_and_generic-cla_2.yml", "YAML", 0, 0, 0, 3, 0, 0, 1, 4
"d:\IDEWORK\lvmen\src\licensedcode\data\rules\uoi-ncsa_url_1.yml", "YAML", 0, 0, 0, 5, 0, 0, 1, 6
"d:\IDEWORK\lvmen\src\licensedcode\data\rules\uoi-ncsa_url_2.yml", "YAML", 0, 0, 0, 5, 0, 0, 1, 6
"d:\IDEWORK\lvmen\src\licensedcode\data\rules\uoi-ncsa_url_glc_202.yml", "YAML", 0, 0, 0, 5, 0, 0, 1, 6
"d:\IDEWORK\lvmen\src\licensedcode\data\rules\uoi-ncsa_url_glc_203.yml", "YAML", 0, 0, 0, 5, 0, 0, 1, 6
"d:\IDEWORK\lvmen\src\licensedcode\data\rules\upl-1.0_1.yml", "YAML", 0, 0, 0, 4, 0, 0, 1, 5
"d:\IDEWORK\lvmen\src\licensedcode\data\rules\upl-1.0_10.yml", "YAML", 0, 0, 0, 5, 0, 0, 1, 6
"d:\IDEWORK\lvmen\src\licensedcode\data\rules\upl-1.0_11.yml", "YAML", 0, 0, 0, 5, 0, 0, 1, 6
"d:\IDEWORK\lvmen\src\licensedcode\data\rules\upl-1.0_12.yml", "YAML", 0, 0, 0, 5, 0, 0, 1, 6
"d:\IDEWORK\lvmen\src\licensedcode\data\rules\upl-1.0_13.yml", "YAML", 0, 0, 0, 5, 0, 0, 1, 6
"d:\IDEWORK\lvmen\src\licensedcode\data\rules\upl-1.0_14.yml", "YAML", 0, 0, 0, 5, 0, 0, 1, 6
"d:\IDEWORK\lvmen\src\licensedcode\data\rules\upl-1.0_2.yml", "YAML", 0, 0, 0, 3, 0, 0, 1, 4
"d:\IDEWORK\lvmen\src\licensedcode\data\rules\upl-1.0_3.yml", "YAML", 0, 0, 0, 5, 0, 0, 1, 6
"d:\IDEWORK\lvmen\src\licensedcode\data\rules\upl-1.0_4.yml", "YAML", 0, 0, 0, 5, 0, 0, 1, 6
"d:\IDEWORK\lvmen\src\licensedcode\data\rules\upl-1.0_5.yml", "YAML", 0, 0, 0, 3, 0, 0, 1, 4
"d:\IDEWORK\lvmen\src\licensedcode\data\rules\upl-1.0_6.yml", "YAML", 0, 0, 0, 5, 0, 0, 1, 6
"d:\IDEWORK\lvmen\src\licensedcode\data\rules\upl-1.0_7.yml", "YAML", 0, 0, 0, 5, 0, 0, 1, 6
"d:\IDEWORK\lvmen\src\licensedcode\data\rules\upl-1.0_8.yml", "YAML", 0, 0, 0, 8, 0, 0, 1, 9
"d:\IDEWORK\lvmen\src\licensedcode\data\rules\upl-1.0_9.yml", "YAML", 0, 0, 0, 3, 0, 0, 1, 4
"d:\IDEWORK\lvmen\src\licensedcode\data\rules\upl-1.0_or_apache-2.0_1.yml", "YAML", 0, 0, 0, 8, 0, 0, 1, 9
"d:\IDEWORK\lvmen\src\licensedcode\data\rules\upl-1.0_or_apache-2.0_2.yml", "YAML", 0, 0, 0, 8, 0, 0, 1, 9
"d:\IDEWORK\lvmen\src\licensedcode\data\rules\upl-1.0_url_1.yml", "YAML", 0, 0, 0, 5, 0, 0, 1, 6
"d:\IDEWORK\lvmen\src\licensedcode\data\rules\upl-1.0_url_2.yml", "YAML", 0, 0, 0, 5, 0, 0, 1, 6
"d:\IDEWORK\lvmen\src\licensedcode\data\rules\upl-1.0_url_glc_110.yml", "YAML", 0, 0, 0, 5, 0, 0, 1, 6
"d:\IDEWORK\lvmen\src\licensedcode\data\rules\upl-1.0_url_glc_111.yml", "YAML", 0, 0, 0, 5, 0, 0, 1, 6
"d:\IDEWORK\lvmen\src\licensedcode\data\rules\us-govt-public-domain_1.yml", "YAML", 0, 0, 0, 3, 0, 0, 1, 4
"d:\IDEWORK\lvmen\src\licensedcode\data\rules\us-govt-public-domain_10.yml", "YAML", 0, 0, 0, 5, 0, 0, 1, 6
"d:\IDEWORK\lvmen\src\licensedcode\data\rules\us-govt-public-domain_11.yml", "YAML", 0, 0, 0, 5, 0, 0, 1, 6
"d:\IDEWORK\lvmen\src\licensedcode\data\rules\us-govt-public-domain_12.yml", "YAML", 0, 0, 0, 3, 0, 0, 1, 4
"d:\IDEWORK\lvmen\src\licensedcode\data\rules\us-govt-public-domain_13.yml", "YAML", 0, 0, 0, 3, 0, 0, 1, 4
"d:\IDEWORK\lvmen\src\licensedcode\data\rules\us-govt-public-domain_14.yml", "YAML", 0, 0, 0, 3, 0, 0, 1, 4
"d:\IDEWORK\lvmen\src\licensedcode\data\rules\us-govt-public-domain_15.yml", "YAML", 0, 0, 0, 3, 0, 0, 1, 4
"d:\IDEWORK\lvmen\src\licensedcode\data\rules\us-govt-public-domain_16.yml", "YAML", 0, 0, 0, 3, 0, 0, 1, 4
"d:\IDEWORK\lvmen\src\licensedcode\data\rules\us-govt-public-domain_17.yml", "YAML", 0, 0, 0, 3, 0, 0, 1, 4
"d:\IDEWORK\lvmen\src\licensedcode\data\rules\us-govt-public-domain_18.yml", "YAML", 0, 0, 0, 4, 0, 0, 1, 5
"d:\IDEWORK\lvmen\src\licensedcode\data\rules\us-govt-public-domain_19.yml", "YAML", 0, 0, 0, 3, 0, 0, 1, 4
"d:\IDEWORK\lvmen\src\licensedcode\data\rules\us-govt-public-domain_2.yml", "YAML", 0, 0, 0, 4, 0, 0, 1, 5
"d:\IDEWORK\lvmen\src\licensedcode\data\rules\us-govt-public-domain_20.yml", "YAML", 0, 0, 0, 3, 0, 0, 1, 4
"d:\IDEWORK\lvmen\src\licensedcode\data\rules\us-govt-public-domain_21.yml", "YAML", 0, 0, 0, 6, 0, 0, 1, 7
"d:\IDEWORK\lvmen\src\licensedcode\data\rules\us-govt-public-domain_22.yml", "YAML", 0, 0, 0, 3, 0, 0, 1, 4
"d:\IDEWORK\lvmen\src\licensedcode\data\rules\us-govt-public-domain_23.yml", "YAML", 0, 0, 0, 3, 0, 0, 1, 4
"d:\IDEWORK\lvmen\src\licensedcode\data\rules\us-govt-public-domain_24.yml", "YAML", 0, 0, 0, 4, 0, 0, 1, 5
"d:\IDEWORK\lvmen\src\licensedcode\data\rules\us-govt-public-domain_25.yml", "YAML", 0, 0, 0, 4, 0, 0, 1, 5
"d:\IDEWORK\lvmen\src\licensedcode\data\rules\us-govt-public-domain_26.yml", "YAML", 0, 0, 0, 4, 0, 0, 1, 5
"d:\IDEWORK\lvmen\src\licensedcode\data\rules\us-govt-public-domain_3.yml", "YAML", 0, 0, 0, 3, 0, 0, 1, 4
"d:\IDEWORK\lvmen\src\licensedcode\data\rules\us-govt-public-domain_4.yml", "YAML", 0, 0, 0, 3, 0, 0, 1, 4
"d:\IDEWORK\lvmen\src\licensedcode\data\rules\us-govt-public-domain_5.yml", "YAML", 0, 0, 0, 3, 0, 0, 1, 4
"d:\IDEWORK\lvmen\src\licensedcode\data\rules\us-govt-public-domain_6.yml", "YAML", 0, 0, 0, 2, 0, 0, 1, 3
"d:\IDEWORK\lvmen\src\licensedcode\data\rules\us-govt-public-domain_7.yml", "YAML", 0, 0, 0, 3, 0, 0, 1, 4
"d:\IDEWORK\lvmen\src\licensedcode\data\rules\us-govt-public-domain_8.yml", "YAML", 0, 0, 0, 3, 0, 0, 1, 4
"d:\IDEWORK\lvmen\src\licensedcode\data\rules\us-govt-public-domain_9.yml", "YAML", 0, 0, 0, 3, 0, 0, 1, 4
"d:\IDEWORK\lvmen\src\licensedcode\data\rules\us-govt-public-domain_and_bsd-3-clause-fda_1.yml", "YAML", 0, 0, 0, 3, 0, 0, 1, 4
"d:\IDEWORK\lvmen\src\licensedcode\data\rules\us-govt-public-domain_and_gpl-2.0-plus_1.yml", "YAML", 0, 0, 0, 5, 0, 0, 1, 6
"d:\IDEWORK\lvmen\src\licensedcode\data\rules\us-govt-public-domain_and_gpl-2.0-plus_2.yml", "YAML", 0, 0, 0, 5, 0, 0, 1, 6
"d:\IDEWORK\lvmen\src\licensedcode\data\rules\us-govt-public-domain_and_mit.yml", "YAML", 0, 0, 0, 4, 0, 0, 1, 5
"d:\IDEWORK\lvmen\src\licensedcode\data\rules\us-govt-public-domain_and_mit_1.yml", "YAML", 0, 0, 0, 3, 0, 0, 1, 4
"d:\IDEWORK\lvmen\src\licensedcode\data\rules\us-govt-public-domain_and_mit_2.yml", "YAML", 0, 0, 0, 3, 0, 0, 1, 4
"d:\IDEWORK\lvmen\src\licensedcode\data\rules\us-govt-public-domain_and_other-permissive_1.yml", "YAML", 0, 0, 0, 4, 0, 0, 1, 5
"d:\IDEWORK\lvmen\src\licensedcode\data\rules\us-govt-public-domain_and_warranty-disclaimer_1.yml", "YAML", 0, 0, 0, 10, 0, 0, 1, 11
"d:\IDEWORK\lvmen\src\licensedcode\data\rules\us-govt-public-domain_or_cc0-1.0_1.yml", "YAML", 0, 0, 0, 3, 0, 0, 1, 4
"d:\IDEWORK\lvmen\src\licensedcode\data\rules\us-govt-public-domain_or_cc0-1.0_2.yml", "YAML", 0, 0, 0, 3, 0, 0, 1, 4
"d:\IDEWORK\lvmen\src\licensedcode\data\rules\us-govt-public-domain_or_cc0-1.0_3.yml", "YAML", 0, 0, 0, 5, 0, 0, 1, 6
"d:\IDEWORK\lvmen\src\licensedcode\data\rules\us-govt-public-domain_or_cc0-1.0_4.yml", "YAML", 0, 0, 0, 5, 0, 0, 1, 6
"d:\IDEWORK\lvmen\src\licensedcode\data\rules\us-govt-public-domain_or_cc0-1.0_and_warranty-disclaimer_and_gpl-3.0-plus_1.yml", "YAML", 0, 0, 0, 11, 0, 0, 1, 12
"d:\IDEWORK\lvmen\src\licensedcode\data\rules\us-govt-public-domain_or_cc0-1.0_and_warranty-disclaimer_and_gpl-3.0-plus_2.yml", "YAML", 0, 0, 0, 11, 0, 0, 1, 12
"d:\IDEWORK\lvmen\src\licensedcode\data\rules\us-govt-unlimited-rights_1.yml", "YAML", 0, 0, 0, 2, 0, 0, 1, 3
"d:\IDEWORK\lvmen\src\licensedcode\data\rules\verbatim-manual_1.yml", "YAML", 0, 0, 0, 3, 0, 0, 1, 4
"d:\IDEWORK\lvmen\src\licensedcode\data\rules\verisign.yml", "YAML", 0, 0, 0, 5, 0, 0, 1, 6
"d:\IDEWORK\lvmen\src\licensedcode\data\rules\vhfpl-1.1_1.yml", "YAML", 0, 0, 0, 5, 0, 0, 1, 6
"d:\IDEWORK\lvmen\src\licensedcode\data\rules\vhfpl-1.1_10.yml", "YAML", 0, 0, 0, 5, 0, 0, 1, 6
"d:\IDEWORK\lvmen\src\licensedcode\data\rules\vhfpl-1.1_2.yml", "YAML", 0, 0, 0, 3, 0, 0, 1, 4
"d:\IDEWORK\lvmen\src\licensedcode\data\rules\vhfpl-1.1_3.yml", "YAML", 0, 0, 0, 3, 0, 0, 1, 4
"d:\IDEWORK\lvmen\src\licensedcode\data\rules\vhfpl-1.1_4.yml", "YAML", 0, 0, 0, 3, 0, 0, 1, 4
"d:\IDEWORK\lvmen\src\licensedcode\data\rules\vhfpl-1.1_5.yml", "YAML", 0, 0, 0, 3, 0, 0, 1, 4
"d:\IDEWORK\lvmen\src\licensedcode\data\rules\vhfpl-1.1_6.yml", "YAML", 0, 0, 0, 3, 0, 0, 1, 4
"d:\IDEWORK\lvmen\src\licensedcode\data\rules\vhfpl-1.1_7.yml", "YAML", 0, 0, 0, 3, 0, 0, 1, 4
"d:\IDEWORK\lvmen\src\licensedcode\data\rules\vhfpl-1.1_8.yml", "YAML", 0, 0, 0, 3, 0, 0, 1, 4
"d:\IDEWORK\lvmen\src\licensedcode\data\rules\vhfpl-1.1_9.yml", "YAML", 0, 0, 0, 5, 0, 0, 1, 6
"d:\IDEWORK\lvmen\src\licensedcode\data\rules\vim.SPDX.yml", "YAML", 0, 0, 0, 9, 0, 0, 1, 10
"d:\IDEWORK\lvmen\src\licensedcode\data\rules\vim_1.yml", "YAML", 0, 0, 0, 3, 0, 0, 1, 4
"d:\IDEWORK\lvmen\src\licensedcode\data\rules\vim_10.yml", "YAML", 0, 0, 0, 3, 0, 0, 1, 4
"d:\IDEWORK\lvmen\src\licensedcode\data\rules\vim_11.yml", "YAML", 0, 0, 0, 3, 0, 0, 1, 4
"d:\IDEWORK\lvmen\src\licensedcode\data\rules\vim_12.yml", "YAML", 0, 0, 0, 3, 0, 0, 1, 4
"d:\IDEWORK\lvmen\src\licensedcode\data\rules\vim_13.yml", "YAML", 0, 0, 0, 3, 0, 0, 1, 4
"d:\IDEWORK\lvmen\src\licensedcode\data\rules\vim_14.yml", "YAML", 0, 0, 0, 3, 0, 0, 1, 4
"d:\IDEWORK\lvmen\src\licensedcode\data\rules\vim_15.yml", "YAML", 0, 0, 0, 3, 0, 0, 1, 4
"d:\IDEWORK\lvmen\src\licensedcode\data\rules\vim_16.yml", "YAML", 0, 0, 0, 3, 0, 0, 1, 4
"d:\IDEWORK\lvmen\src\licensedcode\data\rules\vim_17.yml", "YAML", 0, 0, 0, 3, 0, 0, 1, 4
"d:\IDEWORK\lvmen\src\licensedcode\data\rules\vim_18.yml", "YAML", 0, 0, 0, 3, 0, 0, 1, 4
"d:\IDEWORK\lvmen\src\licensedcode\data\rules\vim_19.yml", "YAML", 0, 0, 0, 3, 0, 0, 1, 4
"d:\IDEWORK\lvmen\src\licensedcode\data\rules\vim_2.yml", "YAML", 0, 0, 0, 3, 0, 0, 1, 4
"d:\IDEWORK\lvmen\src\licensedcode\data\rules\vim_20.yml", "YAML", 0, 0, 0, 5, 0, 0, 1, 6
"d:\IDEWORK\lvmen\src\licensedcode\data\rules\vim_21.yml", "YAML", 0, 0, 0, 3, 0, 0, 1, 4
"d:\IDEWORK\lvmen\src\licensedcode\data\rules\vim_22.yml", "YAML", 0, 0, 0, 3, 0, 0, 1, 4
"d:\IDEWORK\lvmen\src\licensedcode\data\rules\vim_23.yml", "YAML", 0, 0, 0, 3, 0, 0, 1, 4
"d:\IDEWORK\lvmen\src\licensedcode\data\rules\vim_24.yml", "YAML", 0, 0, 0, 7, 0, 0, 1, 8
"d:\IDEWORK\lvmen\src\licensedcode\data\rules\vim_25.yml", "YAML", 0, 0, 0, 3, 0, 0, 1, 4
"d:\IDEWORK\lvmen\src\licensedcode\data\rules\vim_26.yml", "YAML", 0, 0, 0, 3, 0, 0, 1, 4
"d:\IDEWORK\lvmen\src\licensedcode\data\rules\vim_27.yml", "YAML", 0, 0, 0, 3, 0, 0, 1, 4
"d:\IDEWORK\lvmen\src\licensedcode\data\rules\vim_28.yml", "YAML", 0, 0, 0, 3, 0, 0, 1, 4
"d:\IDEWORK\lvmen\src\licensedcode\data\rules\vim_3.yml", "YAML", 0, 0, 0, 3, 0, 0, 1, 4
"d:\IDEWORK\lvmen\src\licensedcode\data\rules\vim_4.yml", "YAML", 0, 0, 0, 3, 0, 0, 1, 4
"d:\IDEWORK\lvmen\src\licensedcode\data\rules\vim_5.yml", "YAML", 0, 0, 0, 3, 0, 0, 1, 4
"d:\IDEWORK\lvmen\src\licensedcode\data\rules\vim_6.yml", "YAML", 0, 0, 0, 3, 0, 0, 1, 4
"d:\IDEWORK\lvmen\src\licensedcode\data\rules\vim_7.yml", "YAML", 0, 0, 0, 3, 0, 0, 1, 4
"d:\IDEWORK\lvmen\src\licensedcode\data\rules\vim_8.yml", "YAML", 0, 0, 0, 3, 0, 0, 1, 4
"d:\IDEWORK\lvmen\src\licensedcode\data\rules\vim_9.yml", "YAML", 0, 0, 0, 3, 0, 0, 1, 4
"d:\IDEWORK\lvmen\src\licensedcode\data\rules\vim_url_1.yml", "YAML", 0, 0, 0, 5, 0, 0, 1, 6
"d:\IDEWORK\lvmen\src\licensedcode\data\rules\vim_url_2.yml", "YAML", 0, 0, 0, 5, 0, 0, 1, 6
"d:\IDEWORK\lvmen\src\licensedcode\data\rules\visual-idiot_1.yml", "YAML", 0, 0, 0, 5, 0, 0, 1, 6
"d:\IDEWORK\lvmen\src\licensedcode\data\rules\visual-idiot_2.yml", "YAML", 0, 0, 0, 6, 0, 0, 1, 7
"d:\IDEWORK\lvmen\src\licensedcode\data\rules\visual-idiot_3.yml", "YAML", 0, 0, 0, 6, 0, 0, 1, 7
"d:\IDEWORK\lvmen\src\licensedcode\data\rules\visual-idiot_4.yml", "YAML", 0, 0, 0, 3, 0, 0, 1, 4
"d:\IDEWORK\lvmen\src\licensedcode\data\rules\visual-idiot_5.yml", "YAML", 0, 0, 0, 5, 0, 0, 1, 6
"d:\IDEWORK\lvmen\src\licensedcode\data\rules\visual-idiot_6.yml", "YAML", 0, 0, 0, 5, 0, 0, 1, 6
"d:\IDEWORK\lvmen\src\licensedcode\data\rules\visual-idiot_7.yml", "YAML", 0, 0, 0, 3, 0, 0, 1, 4
"d:\IDEWORK\lvmen\src\licensedcode\data\rules\volatility-vsl-v1.0_1.yml", "YAML", 0, 0, 0, 4, 0, 0, 1, 5
"d:\IDEWORK\lvmen\src\licensedcode\data\rules\volatility-vsl-v1.0_2.yml", "YAML", 0, 0, 0, 3, 0, 0, 1, 4
"d:\IDEWORK\lvmen\src\licensedcode\data\rules\volatility-vsl-v1.0_3.yml", "YAML", 0, 0, 0, 5, 0, 0, 1, 6
"d:\IDEWORK\lvmen\src\licensedcode\data\rules\vostrom_url_1.yml", "YAML", 0, 0, 0, 5, 0, 0, 1, 6
"d:\IDEWORK\lvmen\src\licensedcode\data\rules\vostrom_url_2.yml", "YAML", 0, 0, 0, 5, 0, 0, 1, 6
"d:\IDEWORK\lvmen\src\licensedcode\data\rules\vovida-1.0_1.yml", "YAML", 0, 0, 0, 10, 0, 0, 1, 11
"d:\IDEWORK\lvmen\src\licensedcode\data\rules\vovida-1.0_2.yml", "YAML", 0, 0, 0, 8, 0, 0, 1, 9
"d:\IDEWORK\lvmen\src\licensedcode\data\rules\vs10x-code-map.yml", "YAML", 0, 0, 0, 5, 0, 0, 1, 6
"d:\IDEWORK\lvmen\src\licensedcode\data\rules\vsl-1.0.SPDX.yml", "YAML", 0, 0, 0, 10, 0, 0, 1, 11
"d:\IDEWORK\lvmen\src\licensedcode\data\rules\vsl-1.0.yml", "YAML", 0, 0, 0, 5, 0, 0, 1, 6
"d:\IDEWORK\lvmen\src\licensedcode\data\rules\vsl-1.0_1.yml", "YAML", 0, 0, 0, 5, 0, 0, 1, 6
"d:\IDEWORK\lvmen\src\licensedcode\data\rules\vsl-1.0_3.yml", "YAML", 0, 0, 0, 5, 0, 0, 1, 6
"d:\IDEWORK\lvmen\src\licensedcode\data\rules\vsl-1.0_4.yml", "YAML", 0, 0, 0, 3, 0, 0, 1, 4
"d:\IDEWORK\lvmen\src\licensedcode\data\rules\vsl-1.0_5.yml", "YAML", 0, 0, 0, 3, 0, 0, 1, 4
"d:\IDEWORK\lvmen\src\licensedcode\data\rules\vsl-1.0_url_1.yml", "YAML", 0, 0, 0, 5, 0, 0, 1, 6
"d:\IDEWORK\lvmen\src\licensedcode\data\rules\vsl-1.0_url_2.yml", "YAML", 0, 0, 0, 5, 0, 0, 1, 6
"d:\IDEWORK\lvmen\src\licensedcode\data\rules\vsl-1.0_url_glc_240.yml", "YAML", 0, 0, 0, 5, 0, 0, 1, 6
"d:\IDEWORK\lvmen\src\licensedcode\data\rules\vsl-1.0_url_glc_241.yml", "YAML", 0, 0, 0, 5, 0, 0, 1, 6
"d:\IDEWORK\lvmen\src\licensedcode\data\rules\vuforia-2013-07-29.yml", "YAML", 0, 0, 0, 7, 0, 0, 1, 8
"d:\IDEWORK\lvmen\src\licensedcode\data\rules\w3c-docs-19990405_1.yml", "YAML", 0, 0, 0, 13, 0, 0, 1, 14
"d:\IDEWORK\lvmen\src\licensedcode\data\rules\w3c-docs-19990405_2.yml", "YAML", 0, 0, 0, 13, 0, 0, 1, 14
"d:\IDEWORK\lvmen\src\licensedcode\data\rules\w3c-docs-19990405_3.yml", "YAML", 0, 0, 0, 3, 0, 0, 1, 4
"d:\IDEWORK\lvmen\src\licensedcode\data\rules\w3c-documentation.yml", "YAML", 0, 0, 0, 3, 0, 0, 1, 4
"d:\IDEWORK\lvmen\src\licensedcode\data\rules\w3c-documentation2.yml", "YAML", 0, 0, 0, 3, 0, 0, 1, 4
"d:\IDEWORK\lvmen\src\licensedcode\data\rules\w3c-software-19980720_1.yml", "YAML", 0, 0, 0, 20, 0, 0, 1, 21
"d:\IDEWORK\lvmen\src\licensedcode\data\rules\w3c-software-19980720_10.yml", "YAML", 0, 0, 0, 8, 0, 0, 1, 9
"d:\IDEWORK\lvmen\src\licensedcode\data\rules\w3c-software-19980720_11.yml", "YAML", 0, 0, 0, 13, 0, 0, 1, 14
"d:\IDEWORK\lvmen\src\licensedcode\data\rules\w3c-software-19980720_12.yml", "YAML", 0, 0, 0, 13, 0, 0, 1, 14
"d:\IDEWORK\lvmen\src\licensedcode\data\rules\w3c-software-19980720_2.yml", "YAML", 0, 0, 0, 2, 0, 0, 1, 3
"d:\IDEWORK\lvmen\src\licensedcode\data\rules\w3c-software-19980720_3.yml", "YAML", 0, 0, 0, 4, 0, 0, 1, 5
"d:\IDEWORK\lvmen\src\licensedcode\data\rules\w3c-software-19980720_4.yml", "YAML", 0, 0, 0, 4, 0, 0, 1, 5
"d:\IDEWORK\lvmen\src\licensedcode\data\rules\w3c-software-19980720_5.yml", "YAML", 0, 0, 0, 5, 0, 0, 1, 6
"d:\IDEWORK\lvmen\src\licensedcode\data\rules\w3c-software-19980720_6.yml", "YAML", 0, 0, 0, 12, 0, 0, 1, 13
"d:\IDEWORK\lvmen\src\licensedcode\data\rules\w3c-software-19980720_7.yml", "YAML", 0, 0, 0, 12, 0, 0, 1, 13
"d:\IDEWORK\lvmen\src\licensedcode\data\rules\w3c-software-19980720_8.yml", "YAML", 0, 0, 0, 4, 0, 0, 1, 5
"d:\IDEWORK\lvmen\src\licensedcode\data\rules\w3c-software-19980720_9.yml", "YAML", 0, 0, 0, 6, 0, 0, 1, 7
"d:\IDEWORK\lvmen\src\licensedcode\data\rules\w3c-software-19980720_url_1.yml", "YAML", 0, 0, 0, 5, 0, 0, 1, 6
"d:\IDEWORK\lvmen\src\licensedcode\data\rules\w3c-software-19980720_url_2.yml", "YAML", 0, 0, 0, 5, 0, 0, 1, 6
"d:\IDEWORK\lvmen\src\licensedcode\data\rules\w3c-software-20021231.yml", "YAML", 0, 0, 0, 6, 0, 0, 1, 7
"d:\IDEWORK\lvmen\src\licensedcode\data\rules\w3c-software-20021231_1.yml", "YAML", 0, 0, 0, 6, 0, 0, 1, 7
"d:\IDEWORK\lvmen\src\licensedcode\data\rules\w3c-software-20021231_2.yml", "YAML", 0, 0, 0, 4, 0, 0, 1, 5
"d:\IDEWORK\lvmen\src\licensedcode\data\rules\w3c-software-20021231_3.yml", "YAML", 0, 0, 0, 4, 0, 0, 1, 5
"d:\IDEWORK\lvmen\src\licensedcode\data\rules\w3c-software-20021231_4.yml", "YAML", 0, 0, 0, 4, 0, 0, 1, 5
"d:\IDEWORK\lvmen\src\licensedcode\data\rules\w3c-software-20021231_5.yml", "YAML", 0, 0, 0, 5, 0, 0, 1, 6
"d:\IDEWORK\lvmen\src\licensedcode\data\rules\w3c-software-20021231_6.yml", "YAML", 0, 0, 0, 6, 0, 0, 1, 7
"d:\IDEWORK\lvmen\src\licensedcode\data\rules\w3c-software-20021231_fulltext.yml", "YAML", 0, 0, 0, 4, 0, 0, 1, 5
"d:\IDEWORK\lvmen\src\licensedcode\data\rules\w3c-software-doc-20150513_1.yml", "YAML", 0, 0, 0, 5, 0, 0, 1, 6
"d:\IDEWORK\lvmen\src\licensedcode\data\rules\w3c-software-doc-20150513_2.yml", "YAML", 0, 0, 0, 5, 0, 0, 1, 6
"d:\IDEWORK\lvmen\src\licensedcode\data\rules\w3c-software-doc-20150513_3.yml", "YAML", 0, 0, 0, 5, 0, 0, 1, 6
"d:\IDEWORK\lvmen\src\licensedcode\data\rules\w3c-software-doc-20150513_4.yml", "YAML", 0, 0, 0, 5, 0, 0, 1, 6
"d:\IDEWORK\lvmen\src\licensedcode\data\rules\w3c-software-doc-20150513_5.yml", "YAML", 0, 0, 0, 3, 0, 0, 1, 4
"d:\IDEWORK\lvmen\src\licensedcode\data\rules\w3c-software-doc-20150513_6.yml", "YAML", 0, 0, 0, 5, 0, 0, 1, 6
"d:\IDEWORK\lvmen\src\licensedcode\data\rules\w3c-software-doc-20150513_7.yml", "YAML", 0, 0, 0, 7, 0, 0, 1, 8
"d:\IDEWORK\lvmen\src\licensedcode\data\rules\w3c-software-doc-20150513_url_1.yml", "YAML", 0, 0, 0, 5, 0, 0, 1, 6
"d:\IDEWORK\lvmen\src\licensedcode\data\rules\w3c-software-doc-20150513_url_2.yml", "YAML", 0, 0, 0, 5, 0, 0, 1, 6
"d:\IDEWORK\lvmen\src\licensedcode\data\rules\w3c_1.yml", "YAML", 0, 0, 0, 10, 0, 0, 1, 11
"d:\IDEWORK\lvmen\src\licensedcode\data\rules\w3c_10.yml", "YAML", 0, 0, 0, 4, 0, 0, 1, 5
"d:\IDEWORK\lvmen\src\licensedcode\data\rules\w3c_11.yml", "YAML", 0, 0, 0, 4, 0, 0, 1, 5
"d:\IDEWORK\lvmen\src\licensedcode\data\rules\w3c_12.yml", "YAML", 0, 0, 0, 2, 0, 0, 1, 3
"d:\IDEWORK\lvmen\src\licensedcode\data\rules\w3c_13.yml", "YAML", 0, 0, 0, 3, 0, 0, 1, 4
"d:\IDEWORK\lvmen\src\licensedcode\data\rules\w3c_14.yml", "YAML", 0, 0, 0, 2, 0, 0, 1, 3
"d:\IDEWORK\lvmen\src\licensedcode\data\rules\w3c_15.yml", "YAML", 0, 0, 0, 4, 0, 0, 1, 5
"d:\IDEWORK\lvmen\src\licensedcode\data\rules\w3c_16.yml", "YAML", 0, 0, 0, 5, 0, 0, 1, 6
"d:\IDEWORK\lvmen\src\licensedcode\data\rules\w3c_17.yml", "YAML", 0, 0, 0, 3, 0, 0, 1, 4
"d:\IDEWORK\lvmen\src\licensedcode\data\rules\w3c_18.yml", "YAML", 0, 0, 0, 5, 0, 0, 1, 6
"d:\IDEWORK\lvmen\src\licensedcode\data\rules\w3c_19.yml", "YAML", 0, 0, 0, 3, 0, 0, 1, 4
"d:\IDEWORK\lvmen\src\licensedcode\data\rules\w3c_2.yml", "YAML", 0, 0, 0, 6, 0, 0, 1, 7
"d:\IDEWORK\lvmen\src\licensedcode\data\rules\w3c_20.yml", "YAML", 0, 0, 0, 3, 0, 0, 1, 4
"d:\IDEWORK\lvmen\src\licensedcode\data\rules\w3c_21.yml", "YAML", 0, 0, 0, 3, 0, 0, 1, 4
"d:\IDEWORK\lvmen\src\licensedcode\data\rules\w3c_22.yml", "YAML", 0, 0, 0, 3, 0, 0, 1, 4
"d:\IDEWORK\lvmen\src\licensedcode\data\rules\w3c_23.yml", "YAML", 0, 0, 0, 6, 0, 0, 1, 7
"d:\IDEWORK\lvmen\src\licensedcode\data\rules\w3c_3.yml", "YAML", 0, 0, 0, 8, 0, 0, 1, 9
"d:\IDEWORK\lvmen\src\licensedcode\data\rules\w3c_4.yml", "YAML", 0, 0, 0, 5, 0, 0, 1, 6
"d:\IDEWORK\lvmen\src\licensedcode\data\rules\w3c_5.yml", "YAML", 0, 0, 0, 5, 0, 0, 1, 6
"d:\IDEWORK\lvmen\src\licensedcode\data\rules\w3c_6.yml", "YAML", 0, 0, 0, 14, 0, 0, 1, 15
"d:\IDEWORK\lvmen\src\licensedcode\data\rules\w3c_7.yml", "YAML", 0, 0, 0, 3, 0, 0, 1, 4
"d:\IDEWORK\lvmen\src\licensedcode\data\rules\w3c_8.yml", "YAML", 0, 0, 0, 5, 0, 0, 1, 6
"d:\IDEWORK\lvmen\src\licensedcode\data\rules\w3c_9.yml", "YAML", 0, 0, 0, 6, 0, 0, 1, 7
"d:\IDEWORK\lvmen\src\licensedcode\data\rules\w3c_and_w3c-documentation_1.yml", "YAML", 0, 0, 0, 5, 0, 0, 1, 6
"d:\IDEWORK\lvmen\src\licensedcode\data\rules\w3c_and_w3c-documentation_2.yml", "YAML", 0, 0, 0, 3, 0, 0, 1, 4
"d:\IDEWORK\lvmen\src\licensedcode\data\rules\w3c_or_html5_1.yml", "YAML", 0, 0, 0, 5, 0, 0, 1, 6
"d:\IDEWORK\lvmen\src\licensedcode\data\rules\w3c_reference_1.yml", "YAML", 0, 0, 0, 3, 0, 0, 1, 4
"d:\IDEWORK\lvmen\src\licensedcode\data\rules\w3c_url_1.yml", "YAML", 0, 0, 0, 5, 0, 0, 1, 6
"d:\IDEWORK\lvmen\src\licensedcode\data\rules\w3c_url_glc_242.yml", "YAML", 0, 0, 0, 5, 0, 0, 1, 6
"d:\IDEWORK\lvmen\src\licensedcode\data\rules\w3c_url_glc_243.yml", "YAML", 0, 0, 0, 5, 0, 0, 1, 6
"d:\IDEWORK\lvmen\src\licensedcode\data\rules\warranty-disclaimer.yml", "YAML", 0, 0, 0, 2, 0, 0, 1, 3
"d:\IDEWORK\lvmen\src\licensedcode\data\rules\warranty-disclaimer_1.yml", "YAML", 0, 0, 0, 2, 0, 0, 1, 3
"d:\IDEWORK\lvmen\src\licensedcode\data\rules\warranty-disclaimer_10.yml", "YAML", 0, 0, 0, 3, 0, 0, 1, 4
"d:\IDEWORK\lvmen\src\licensedcode\data\rules\warranty-disclaimer_11.yml", "YAML", 0, 0, 0, 3, 0, 0, 1, 4
"d:\IDEWORK\lvmen\src\licensedcode\data\rules\warranty-disclaimer_12.yml", "YAML", 0, 0, 0, 3, 0, 0, 1, 4
"d:\IDEWORK\lvmen\src\licensedcode\data\rules\warranty-disclaimer_13.yml", "YAML", 0, 0, 0, 2, 0, 0, 1, 3
"d:\IDEWORK\lvmen\src\licensedcode\data\rules\warranty-disclaimer_14.yml", "YAML", 0, 0, 0, 3, 0, 0, 1, 4
"d:\IDEWORK\lvmen\src\licensedcode\data\rules\warranty-disclaimer_15.yml", "YAML", 0, 0, 0, 3, 0, 0, 1, 4
"d:\IDEWORK\lvmen\src\licensedcode\data\rules\warranty-disclaimer_16.yml", "YAML", 0, 0, 0, 3, 0, 0, 1, 4
"d:\IDEWORK\lvmen\src\licensedcode\data\rules\warranty-disclaimer_17.yml", "YAML", 0, 0, 0, 2, 0, 0, 1, 3
"d:\IDEWORK\lvmen\src\licensedcode\data\rules\warranty-disclaimer_18.yml", "YAML", 0, 0, 0, 3, 0, 0, 1, 4
"d:\IDEWORK\lvmen\src\licensedcode\data\rules\warranty-disclaimer_19.yml", "YAML", 0, 0, 0, 3, 0, 0, 1, 4
"d:\IDEWORK\lvmen\src\licensedcode\data\rules\warranty-disclaimer_2.yml", "YAML", 0, 0, 0, 2, 0, 0, 1, 3
"d:\IDEWORK\lvmen\src\licensedcode\data\rules\warranty-disclaimer_20.yml", "YAML", 0, 0, 0, 3, 0, 0, 1, 4
"d:\IDEWORK\lvmen\src\licensedcode\data\rules\warranty-disclaimer_21.yml", "YAML", 0, 0, 0, 3, 0, 0, 1, 4
"d:\IDEWORK\lvmen\src\licensedcode\data\rules\warranty-disclaimer_22.yml", "YAML", 0, 0, 0, 3, 0, 0, 1, 4
"d:\IDEWORK\lvmen\src\licensedcode\data\rules\warranty-disclaimer_23.yml", "YAML", 0, 0, 0, 3, 0, 0, 1, 4
"d:\IDEWORK\lvmen\src\licensedcode\data\rules\warranty-disclaimer_24.yml", "YAML", 0, 0, 0, 3, 0, 0, 1, 4
"d:\IDEWORK\lvmen\src\licensedcode\data\rules\warranty-disclaimer_25.yml", "YAML", 0, 0, 0, 3, 0, 0, 1, 4
"d:\IDEWORK\lvmen\src\licensedcode\data\rules\warranty-disclaimer_26.yml", "YAML", 0, 0, 0, 3, 0, 0, 1, 4
"d:\IDEWORK\lvmen\src\licensedcode\data\rules\warranty-disclaimer_27.yml", "YAML", 0, 0, 0, 3, 0, 0, 1, 4
"d:\IDEWORK\lvmen\src\licensedcode\data\rules\warranty-disclaimer_28.yml", "YAML", 0, 0, 0, 3, 0, 0, 1, 4
"d:\IDEWORK\lvmen\src\licensedcode\data\rules\warranty-disclaimer_29.yml", "YAML", 0, 0, 0, 3, 0, 0, 1, 4
"d:\IDEWORK\lvmen\src\licensedcode\data\rules\warranty-disclaimer_3.yml", "YAML", 0, 0, 0, 3, 0, 0, 1, 4
"d:\IDEWORK\lvmen\src\licensedcode\data\rules\warranty-disclaimer_30.yml", "YAML", 0, 0, 0, 4, 0, 0, 1, 5
"d:\IDEWORK\lvmen\src\licensedcode\data\rules\warranty-disclaimer_31.yml", "YAML", 0, 0, 0, 3, 0, 0, 1, 4
"d:\IDEWORK\lvmen\src\licensedcode\data\rules\warranty-disclaimer_32.yml", "YAML", 0, 0, 0, 3, 0, 0, 1, 4
"d:\IDEWORK\lvmen\src\licensedcode\data\rules\warranty-disclaimer_33.yml", "YAML", 0, 0, 0, 5, 0, 0, 1, 6
"d:\IDEWORK\lvmen\src\licensedcode\data\rules\warranty-disclaimer_34.yml", "YAML", 0, 0, 0, 3, 0, 0, 1, 4
"d:\IDEWORK\lvmen\src\licensedcode\data\rules\warranty-disclaimer_35.yml", "YAML", 0, 0, 0, 3, 0, 0, 1, 4
"d:\IDEWORK\lvmen\src\licensedcode\data\rules\warranty-disclaimer_36.yml", "YAML", 0, 0, 0, 3, 0, 0, 1, 4
"d:\IDEWORK\lvmen\src\licensedcode\data\rules\warranty-disclaimer_37.yml", "YAML", 0, 0, 0, 3, 0, 0, 1, 4
"d:\IDEWORK\lvmen\src\licensedcode\data\rules\warranty-disclaimer_38.yml", "YAML", 0, 0, 0, 3, 0, 0, 1, 4
"d:\IDEWORK\lvmen\src\licensedcode\data\rules\warranty-disclaimer_39.yml", "YAML", 0, 0, 0, 4, 0, 0, 1, 5
"d:\IDEWORK\lvmen\src\licensedcode\data\rules\warranty-disclaimer_4.yml", "YAML", 0, 0, 0, 2, 0, 0, 1, 3
"d:\IDEWORK\lvmen\src\licensedcode\data\rules\warranty-disclaimer_40.yml", "YAML", 0, 0, 0, 3, 0, 0, 1, 4
"d:\IDEWORK\lvmen\src\licensedcode\data\rules\warranty-disclaimer_41.yml", "YAML", 0, 0, 0, 3, 0, 0, 1, 4
"d:\IDEWORK\lvmen\src\licensedcode\data\rules\warranty-disclaimer_42.yml", "YAML", 0, 0, 0, 3, 0, 0, 1, 4
"d:\IDEWORK\lvmen\src\licensedcode\data\rules\warranty-disclaimer_43.yml", "YAML", 0, 0, 0, 3, 0, 0, 1, 4
"d:\IDEWORK\lvmen\src\licensedcode\data\rules\warranty-disclaimer_44.yml", "YAML", 0, 0, 0, 3, 0, 0, 1, 4
"d:\IDEWORK\lvmen\src\licensedcode\data\rules\warranty-disclaimer_45.yml", "YAML", 0, 0, 0, 3, 0, 0, 1, 4
"d:\IDEWORK\lvmen\src\licensedcode\data\rules\warranty-disclaimer_46.yml", "YAML", 0, 0, 0, 3, 0, 0, 1, 4
"d:\IDEWORK\lvmen\src\licensedcode\data\rules\warranty-disclaimer_47.yml", "YAML", 0, 0, 0, 3, 0, 0, 1, 4
"d:\IDEWORK\lvmen\src\licensedcode\data\rules\warranty-disclaimer_48.yml", "YAML", 0, 0, 0, 3, 0, 0, 1, 4
"d:\IDEWORK\lvmen\src\licensedcode\data\rules\warranty-disclaimer_49.yml", "YAML", 0, 0, 0, 3, 0, 0, 1, 4
"d:\IDEWORK\lvmen\src\licensedcode\data\rules\warranty-disclaimer_5.yml", "YAML", 0, 0, 0, 2, 0, 0, 1, 3
"d:\IDEWORK\lvmen\src\licensedcode\data\rules\warranty-disclaimer_50.yml", "YAML", 0, 0, 0, 3, 0, 0, 1, 4
"d:\IDEWORK\lvmen\src\licensedcode\data\rules\warranty-disclaimer_51.yml", "YAML", 0, 0, 0, 3, 0, 0, 1, 4
"d:\IDEWORK\lvmen\src\licensedcode\data\rules\warranty-disclaimer_52.yml", "YAML", 0, 0, 0, 3, 0, 0, 1, 4
"d:\IDEWORK\lvmen\src\licensedcode\data\rules\warranty-disclaimer_53.yml", "YAML", 0, 0, 0, 3, 0, 0, 1, 4
"d:\IDEWORK\lvmen\src\licensedcode\data\rules\warranty-disclaimer_54.yml", "YAML", 0, 0, 0, 4, 0, 0, 1, 5
"d:\IDEWORK\lvmen\src\licensedcode\data\rules\warranty-disclaimer_55.yml", "YAML", 0, 0, 0, 3, 0, 0, 1, 4
"d:\IDEWORK\lvmen\src\licensedcode\data\rules\warranty-disclaimer_56.yml", "YAML", 0, 0, 0, 3, 0, 0, 1, 4
"d:\IDEWORK\lvmen\src\licensedcode\data\rules\warranty-disclaimer_57.yml", "YAML", 0, 0, 0, 3, 0, 0, 1, 4
"d:\IDEWORK\lvmen\src\licensedcode\data\rules\warranty-disclaimer_58.yml", "YAML", 0, 0, 0, 4, 0, 0, 1, 5
"d:\IDEWORK\lvmen\src\licensedcode\data\rules\warranty-disclaimer_59.yml", "YAML", 0, 0, 0, 3, 0, 0, 1, 4
"d:\IDEWORK\lvmen\src\licensedcode\data\rules\warranty-disclaimer_6.yml", "YAML", 0, 0, 0, 2, 0, 0, 1, 3
"d:\IDEWORK\lvmen\src\licensedcode\data\rules\warranty-disclaimer_60.yml", "YAML", 0, 0, 0, 3, 0, 0, 1, 4
"d:\IDEWORK\lvmen\src\licensedcode\data\rules\warranty-disclaimer_61.yml", "YAML", 0, 0, 0, 5, 0, 0, 1, 6
"d:\IDEWORK\lvmen\src\licensedcode\data\rules\warranty-disclaimer_62.yml", "YAML", 0, 0, 0, 3, 0, 0, 1, 4
"d:\IDEWORK\lvmen\src\licensedcode\data\rules\warranty-disclaimer_63.yml", "YAML", 0, 0, 0, 3, 0, 0, 1, 4
"d:\IDEWORK\lvmen\src\licensedcode\data\rules\warranty-disclaimer_64.yml", "YAML", 0, 0, 0, 3, 0, 0, 1, 4
"d:\IDEWORK\lvmen\src\licensedcode\data\rules\warranty-disclaimer_65.yml", "YAML", 0, 0, 0, 3, 0, 0, 1, 4
"d:\IDEWORK\lvmen\src\licensedcode\data\rules\warranty-disclaimer_66.yml", "YAML", 0, 0, 0, 3, 0, 0, 1, 4
"d:\IDEWORK\lvmen\src\licensedcode\data\rules\warranty-disclaimer_67.yml", "YAML", 0, 0, 0, 3, 0, 0, 1, 4
"d:\IDEWORK\lvmen\src\licensedcode\data\rules\warranty-disclaimer_68.yml", "YAML", 0, 0, 0, 3, 0, 0, 1, 4
"d:\IDEWORK\lvmen\src\licensedcode\data\rules\warranty-disclaimer_69.yml", "YAML", 0, 0, 0, 3, 0, 0, 1, 4
"d:\IDEWORK\lvmen\src\licensedcode\data\rules\warranty-disclaimer_7.yml", "YAML", 0, 0, 0, 2, 0, 0, 1, 3
"d:\IDEWORK\lvmen\src\licensedcode\data\rules\warranty-disclaimer_70.yml", "YAML", 0, 0, 0, 3, 0, 0, 1, 4
"d:\IDEWORK\lvmen\src\licensedcode\data\rules\warranty-disclaimer_71.yml", "YAML", 0, 0, 0, 2, 0, 0, 1, 3
"d:\IDEWORK\lvmen\src\licensedcode\data\rules\warranty-disclaimer_72.yml", "YAML", 0, 0, 0, 2, 0, 0, 1, 3
"d:\IDEWORK\lvmen\src\licensedcode\data\rules\warranty-disclaimer_73.yml", "YAML", 0, 0, 0, 2, 0, 0, 1, 3
"d:\IDEWORK\lvmen\src\licensedcode\data\rules\warranty-disclaimer_74.yml", "YAML", 0, 0, 0, 3, 0, 0, 1, 4
"d:\IDEWORK\lvmen\src\licensedcode\data\rules\warranty-disclaimer_75.yml", "YAML", 0, 0, 0, 2, 0, 0, 1, 3
"d:\IDEWORK\lvmen\src\licensedcode\data\rules\warranty-disclaimer_76.yml", "YAML", 0, 0, 0, 3, 0, 0, 1, 4
"d:\IDEWORK\lvmen\src\licensedcode\data\rules\warranty-disclaimer_77.yml", "YAML", 0, 0, 0, 3, 0, 0, 1, 4
"d:\IDEWORK\lvmen\src\licensedcode\data\rules\warranty-disclaimer_78.yml", "YAML", 0, 0, 0, 3, 0, 0, 1, 4
"d:\IDEWORK\lvmen\src\licensedcode\data\rules\warranty-disclaimer_8.yml", "YAML", 0, 0, 0, 4, 0, 0, 1, 5
"d:\IDEWORK\lvmen\src\licensedcode\data\rules\warranty-disclaimer_9.yml", "YAML", 0, 0, 0, 2, 0, 0, 1, 3
"d:\IDEWORK\lvmen\src\licensedcode\data\rules\warranty-disclaimer_and_unknown-license-reference_1.yml", "YAML", 0, 0, 0, 6, 0, 0, 1, 7
"d:\IDEWORK\lvmen\src\licensedcode\data\rules\warranty-disclaimer_draeger.yml", "YAML", 0, 0, 0, 3, 0, 0, 1, 4
"d:\IDEWORK\lvmen\src\licensedcode\data\rules\warranty-disclaimer_french_1.yml", "YAML", 0, 0, 0, 5, 0, 0, 1, 6
"d:\IDEWORK\lvmen\src\licensedcode\data\rules\warranty-disclaimer_mit_58.yml", "YAML", 0, 0, 0, 3, 0, 0, 1, 4
"d:\IDEWORK\lvmen\src\licensedcode\data\rules\warranty-disclaimer_not_unknown_1.yml", "YAML", 0, 0, 0, 3, 0, 0, 1, 4
"d:\IDEWORK\lvmen\src\licensedcode\data\rules\warranty-disclaimer_unknown_46.yml", "YAML", 0, 0, 0, 3, 0, 0, 1, 4
"d:\IDEWORK\lvmen\src\licensedcode\data\rules\whistle.yml", "YAML", 0, 0, 0, 11, 0, 0, 1, 12
"d:\IDEWORK\lvmen\src\licensedcode\data\rules\wifi-alliance.yml", "YAML", 0, 0, 0, 4, 0, 0, 1, 5
"d:\IDEWORK\lvmen\src\licensedcode\data\rules\wince-50-shared-source.yml", "YAML", 0, 0, 0, 5, 0, 0, 1, 6
"d:\IDEWORK\lvmen\src\licensedcode\data\rules\wingo.yml", "YAML", 0, 0, 0, 5, 0, 0, 1, 6
"d:\IDEWORK\lvmen\src\licensedcode\data\rules\wingo_1.yml", "YAML", 0, 0, 0, 5, 0, 0, 1, 6
"d:\IDEWORK\lvmen\src\licensedcode\data\rules\wordnet_1.yml", "YAML", 0, 0, 0, 6, 0, 0, 1, 7
"d:\IDEWORK\lvmen\src\licensedcode\data\rules\wordnet_2.yml", "YAML", 0, 0, 0, 4, 0, 0, 1, 5
"d:\IDEWORK\lvmen\src\licensedcode\data\rules\wordnet_3.yml", "YAML", 0, 0, 0, 7, 0, 0, 1, 8
"d:\IDEWORK\lvmen\src\licensedcode\data\rules\wordnet_4.yml", "YAML", 0, 0, 0, 8, 0, 0, 2, 10
"d:\IDEWORK\lvmen\src\licensedcode\data\rules\wordnet_and_public-domain_and_other-permissive_1.yml", "YAML", 0, 0, 0, 9, 0, 0, 2, 11
"d:\IDEWORK\lvmen\src\licensedcode\data\rules\wordnet_and_public-domain_and_other-permissive_2.yml", "YAML", 0, 0, 0, 5, 0, 0, 1, 6
"d:\IDEWORK\lvmen\src\licensedcode\data\rules\wrox.yml", "YAML", 0, 0, 0, 5, 0, 0, 1, 6
"d:\IDEWORK\lvmen\src\licensedcode\data\rules\ws-addressing-spec_1.yml", "YAML", 0, 0, 0, 9, 0, 0, 1, 10
"d:\IDEWORK\lvmen\src\licensedcode\data\rules\wsuipa_url_1.yml", "YAML", 0, 0, 0, 5, 0, 0, 1, 6
"d:\IDEWORK\lvmen\src\licensedcode\data\rules\wsuipa_url_2.yml", "YAML", 0, 0, 0, 5, 0, 0, 1, 6
"d:\IDEWORK\lvmen\src\licensedcode\data\rules\wtfpl-1.0.yml", "YAML", 0, 0, 0, 5, 0, 0, 1, 6
"d:\IDEWORK\lvmen\src\licensedcode\data\rules\wtfpl-1.0_1.yml", "YAML", 0, 0, 0, 5, 0, 0, 1, 6
"d:\IDEWORK\lvmen\src\licensedcode\data\rules\wtfpl-1.0_2.yml", "YAML", 0, 0, 0, 5, 0, 0, 1, 6
"d:\IDEWORK\lvmen\src\licensedcode\data\rules\wtfpl-2.0.SPDX.yml", "YAML", 0, 0, 0, 10, 0, 0, 1, 11
"d:\IDEWORK\lvmen\src\licensedcode\data\rules\wtfpl-2.0.yml", "YAML", 0, 0, 0, 5, 0, 0, 1, 6
"d:\IDEWORK\lvmen\src\licensedcode\data\rules\wtfpl-2.0_1.yml", "YAML", 0, 0, 0, 5, 0, 0, 1, 6
"d:\IDEWORK\lvmen\src\licensedcode\data\rules\wtfpl-2.0_10.yml", "YAML", 0, 0, 0, 5, 0, 0, 1, 6
"d:\IDEWORK\lvmen\src\licensedcode\data\rules\wtfpl-2.0_11.yml", "YAML", 0, 0, 0, 5, 0, 0, 1, 6
"d:\IDEWORK\lvmen\src\licensedcode\data\rules\wtfpl-2.0_12.yml", "YAML", 0, 0, 0, 5, 0, 0, 1, 6
"d:\IDEWORK\lvmen\src\licensedcode\data\rules\wtfpl-2.0_13.yml", "YAML", 0, 0, 0, 3, 0, 0, 1, 4
"d:\IDEWORK\lvmen\src\licensedcode\data\rules\wtfpl-2.0_14.yml", "YAML", 0, 0, 0, 5, 0, 0, 1, 6
"d:\IDEWORK\lvmen\src\licensedcode\data\rules\wtfpl-2.0_15.yml", "YAML", 0, 0, 0, 3, 0, 0, 1, 4
"d:\IDEWORK\lvmen\src\licensedcode\data\rules\wtfpl-2.0_16.yml", "YAML", 0, 0, 0, 5, 0, 0, 1, 6
"d:\IDEWORK\lvmen\src\licensedcode\data\rules\wtfpl-2.0_17.yml", "YAML", 0, 0, 0, 5, 0, 0, 1, 6
"d:\IDEWORK\lvmen\src\licensedcode\data\rules\wtfpl-2.0_18.yml", "YAML", 0, 0, 0, 3, 0, 0, 1, 4
"d:\IDEWORK\lvmen\src\licensedcode\data\rules\wtfpl-2.0_19.yml", "YAML", 0, 0, 0, 3, 0, 0, 1, 4
"d:\IDEWORK\lvmen\src\licensedcode\data\rules\wtfpl-2.0_2.yml", "YAML", 0, 0, 0, 5, 0, 0, 1, 6
"d:\IDEWORK\lvmen\src\licensedcode\data\rules\wtfpl-2.0_20.yml", "YAML", 0, 0, 0, 3, 0, 0, 1, 4
"d:\IDEWORK\lvmen\src\licensedcode\data\rules\wtfpl-2.0_21.yml", "YAML", 0, 0, 0, 3, 0, 0, 1, 4
"d:\IDEWORK\lvmen\src\licensedcode\data\rules\wtfpl-2.0_22.yml", "YAML", 0, 0, 0, 5, 0, 0, 1, 6
"d:\IDEWORK\lvmen\src\licensedcode\data\rules\wtfpl-2.0_23.yml", "YAML", 0, 0, 0, 5, 0, 0, 1, 6
"d:\IDEWORK\lvmen\src\licensedcode\data\rules\wtfpl-2.0_24.yml", "YAML", 0, 0, 0, 3, 0, 0, 1, 4
"d:\IDEWORK\lvmen\src\licensedcode\data\rules\wtfpl-2.0_25.yml", "YAML", 0, 0, 0, 3, 0, 0, 1, 4
"d:\IDEWORK\lvmen\src\licensedcode\data\rules\wtfpl-2.0_26.yml", "YAML", 0, 0, 0, 5, 0, 0, 1, 6
"d:\IDEWORK\lvmen\src\licensedcode\data\rules\wtfpl-2.0_27.yml", "YAML", 0, 0, 0, 5, 0, 0, 1, 6
"d:\IDEWORK\lvmen\src\licensedcode\data\rules\wtfpl-2.0_28.yml", "YAML", 0, 0, 0, 11, 0, 0, 1, 12
"d:\IDEWORK\lvmen\src\licensedcode\data\rules\wtfpl-2.0_29.yml", "YAML", 0, 0, 0, 3, 0, 0, 1, 4
"d:\IDEWORK\lvmen\src\licensedcode\data\rules\wtfpl-2.0_3.yml", "YAML", 0, 0, 0, 12, 0, 0, 1, 13
"d:\IDEWORK\lvmen\src\licensedcode\data\rules\wtfpl-2.0_30.yml", "YAML", 0, 0, 0, 5, 0, 0, 2, 7
"d:\IDEWORK\lvmen\src\licensedcode\data\rules\wtfpl-2.0_31.yml", "YAML", 0, 0, 0, 5, 0, 0, 2, 7
"d:\IDEWORK\lvmen\src\licensedcode\data\rules\wtfpl-2.0_32.yml", "YAML", 0, 0, 0, 5, 0, 0, 2, 7
"d:\IDEWORK\lvmen\src\licensedcode\data\rules\wtfpl-2.0_33.yml", "YAML", 0, 0, 0, 5, 0, 0, 2, 7
"d:\IDEWORK\lvmen\src\licensedcode\data\rules\wtfpl-2.0_4.yml", "YAML", 0, 0, 0, 2, 0, 0, 1, 3
"d:\IDEWORK\lvmen\src\licensedcode\data\rules\wtfpl-2.0_5.yml", "YAML", 0, 0, 0, 2, 0, 0, 1, 3
"d:\IDEWORK\lvmen\src\licensedcode\data\rules\wtfpl-2.0_6.yml", "YAML", 0, 0, 0, 5, 0, 0, 1, 6
"d:\IDEWORK\lvmen\src\licensedcode\data\rules\wtfpl-2.0_7.yml", "YAML", 0, 0, 0, 7, 0, 0, 1, 8
"d:\IDEWORK\lvmen\src\licensedcode\data\rules\wtfpl-2.0_8.yml", "YAML", 0, 0, 0, 3, 0, 0, 1, 4
"d:\IDEWORK\lvmen\src\licensedcode\data\rules\wtfpl-2.0_9.yml", "YAML", 0, 0, 0, 4, 0, 0, 1, 5
"d:\IDEWORK\lvmen\src\licensedcode\data\rules\wtfpl-2.0_notice.yml", "YAML", 0, 0, 0, 4, 0, 0, 1, 5
"d:\IDEWORK\lvmen\src\licensedcode\data\rules\wtfpl-2.0_or_mit_1.yml", "YAML", 0, 0, 0, 3, 0, 0, 1, 4
"d:\IDEWORK\lvmen\src\licensedcode\data\rules\wtfpl-2.0_or_mit_2.yml", "YAML", 0, 0, 0, 7, 0, 0, 2, 9
"d:\IDEWORK\lvmen\src\licensedcode\data\rules\wtfpl-2.0_url_1.yml", "YAML", 0, 0, 0, 5, 0, 0, 1, 6
"d:\IDEWORK\lvmen\src\licensedcode\data\rules\wtfpl-2.0_url_2.yml", "YAML", 0, 0, 0, 5, 0, 0, 1, 6
"d:\IDEWORK\lvmen\src\licensedcode\data\rules\wxwidgets.yml", "YAML", 0, 0, 0, 5, 0, 0, 1, 6
"d:\IDEWORK\lvmen\src\licensedcode\data\rules\wxwindows-exception-3.1_url_1.yml", "YAML", 0, 0, 0, 5, 0, 0, 1, 6
"d:\IDEWORK\lvmen\src\licensedcode\data\rules\wxwindows-exception-3.1_url_2.yml", "YAML", 0, 0, 0, 5, 0, 0, 1, 6
"d:\IDEWORK\lvmen\src\licensedcode\data\rules\wxwindows_1.yml", "YAML", 0, 0, 0, 3, 0, 0, 1, 4
"d:\IDEWORK\lvmen\src\licensedcode\data\rules\wxwindows_10.yml", "YAML", 0, 0, 0, 3, 0, 0, 1, 4
"d:\IDEWORK\lvmen\src\licensedcode\data\rules\wxwindows_11.yml", "YAML", 0, 0, 0, 3, 0, 0, 1, 4
"d:\IDEWORK\lvmen\src\licensedcode\data\rules\wxwindows_12.yml", "YAML", 0, 0, 0, 3, 0, 0, 1, 4
"d:\IDEWORK\lvmen\src\licensedcode\data\rules\wxwindows_13.yml", "YAML", 0, 0, 0, 3, 0, 0, 1, 4
"d:\IDEWORK\lvmen\src\licensedcode\data\rules\wxwindows_14.yml", "YAML", 0, 0, 0, 3, 0, 0, 1, 4
"d:\IDEWORK\lvmen\src\licensedcode\data\rules\wxwindows_15.yml", "YAML", 0, 0, 0, 2, 0, 0, 1, 3
"d:\IDEWORK\lvmen\src\licensedcode\data\rules\wxwindows_16.yml", "YAML", 0, 0, 0, 7, 0, 0, 1, 8
"d:\IDEWORK\lvmen\src\licensedcode\data\rules\wxwindows_17.yml", "YAML", 0, 0, 0, 3, 0, 0, 1, 4
"d:\IDEWORK\lvmen\src\licensedcode\data\rules\wxwindows_2.yml", "YAML", 0, 0, 0, 9, 0, 0, 1, 10
"d:\IDEWORK\lvmen\src\licensedcode\data\rules\wxwindows_3.yml", "YAML", 0, 0, 0, 5, 0, 0, 1, 6
"d:\IDEWORK\lvmen\src\licensedcode\data\rules\wxwindows_4.yml", "YAML", 0, 0, 0, 2, 0, 0, 1, 3
"d:\IDEWORK\lvmen\src\licensedcode\data\rules\wxwindows_5.yml", "YAML", 0, 0, 0, 3, 0, 0, 1, 4
"d:\IDEWORK\lvmen\src\licensedcode\data\rules\wxwindows_6.yml", "YAML", 0, 0, 0, 3, 0, 0, 1, 4
"d:\IDEWORK\lvmen\src\licensedcode\data\rules\wxwindows_7.yml", "YAML", 0, 0, 0, 3, 0, 0, 1, 4
"d:\IDEWORK\lvmen\src\licensedcode\data\rules\wxwindows_8.yml", "YAML", 0, 0, 0, 3, 0, 0, 1, 4
"d:\IDEWORK\lvmen\src\licensedcode\data\rules\wxwindows_9.yml", "YAML", 0, 0, 0, 3, 0, 0, 1, 4
"d:\IDEWORK\lvmen\src\licensedcode\data\rules\x11-adobe-dec_1.yml", "YAML", 0, 0, 0, 2, 0, 0, 1, 3
"d:\IDEWORK\lvmen\src\licensedcode\data\rules\x11-bitstream_1.yml", "YAML", 0, 0, 0, 4, 0, 0, 1, 5
"d:\IDEWORK\lvmen\src\licensedcode\data\rules\x11-bitstream_2.yml", "YAML", 0, 0, 0, 3, 0, 0, 1, 4
"d:\IDEWORK\lvmen\src\licensedcode\data\rules\x11-bitstream_3.yml", "YAML", 0, 0, 0, 3, 0, 0, 1, 4
"d:\IDEWORK\lvmen\src\licensedcode\data\rules\x11-bitstream_4.yml", "YAML", 0, 0, 0, 6, 0, 0, 1, 7
"d:\IDEWORK\lvmen\src\licensedcode\data\rules\x11-dec1_1.yml", "YAML", 0, 0, 0, 2, 0, 0, 1, 3
"d:\IDEWORK\lvmen\src\licensedcode\data\rules\x11-dec1_2.yml", "YAML", 0, 0, 0, 2, 0, 0, 1, 3
"d:\IDEWORK\lvmen\src\licensedcode\data\rules\x11-dec1_3.yml", "YAML", 0, 0, 0, 4, 0, 0, 1, 5
"d:\IDEWORK\lvmen\src\licensedcode\data\rules\x11-doc.yml", "YAML", 0, 0, 0, 2, 0, 0, 1, 3
"d:\IDEWORK\lvmen\src\licensedcode\data\rules\x11-doc_1.yml", "YAML", 0, 0, 0, 4, 0, 0, 1, 5
"d:\IDEWORK\lvmen\src\licensedcode\data\rules\x11-fsf_1.yml", "YAML", 0, 0, 0, 4, 0, 0, 1, 5
"d:\IDEWORK\lvmen\src\licensedcode\data\rules\x11-fsf_2.yml", "YAML", 0, 0, 0, 5, 0, 0, 1, 6
"d:\IDEWORK\lvmen\src\licensedcode\data\rules\x11-fsf_3.yml", "YAML", 0, 0, 0, 4, 0, 0, 1, 5
"d:\IDEWORK\lvmen\src\licensedcode\data\rules\x11-fsf_4.yml", "YAML", 0, 0, 0, 3, 0, 0, 1, 4
"d:\IDEWORK\lvmen\src\licensedcode\data\rules\x11-fsf_5.yml", "YAML", 0, 0, 0, 4, 0, 0, 1, 5
"d:\IDEWORK\lvmen\src\licensedcode\data\rules\x11-fsf_6.yml", "YAML", 0, 0, 0, 3, 0, 0, 1, 4
"d:\IDEWORK\lvmen\src\licensedcode\data\rules\x11-fsf_7.yml", "YAML", 0, 0, 0, 2, 0, 0, 1, 3
"d:\IDEWORK\lvmen\src\licensedcode\data\rules\x11-hanson2.yml", "YAML", 0, 0, 0, 3, 0, 0, 1, 4
"d:\IDEWORK\lvmen\src\licensedcode\data\rules\x11-hanson_1.yml", "YAML", 0, 0, 0, 4, 0, 0, 1, 5
"d:\IDEWORK\lvmen\src\licensedcode\data\rules\x11-keith-packard.yml", "YAML", 0, 0, 0, 2, 0, 0, 1, 3
"d:\IDEWORK\lvmen\src\licensedcode\data\rules\x11-keith-packard2.yml", "YAML", 0, 0, 0, 3, 0, 0, 1, 4
"d:\IDEWORK\lvmen\src\licensedcode\data\rules\x11-keith-packard3.yml", "YAML", 0, 0, 0, 2, 0, 0, 1, 3
"d:\IDEWORK\lvmen\src\licensedcode\data\rules\x11-keith-packard4.yml", "YAML", 0, 0, 0, 2, 0, 0, 1, 3
"d:\IDEWORK\lvmen\src\licensedcode\data\rules\x11-keith-packard5.yml", "YAML", 0, 0, 0, 3, 0, 0, 1, 4
"d:\IDEWORK\lvmen\src\licensedcode\data\rules\x11-keith-packard6.yml", "YAML", 0, 0, 0, 2, 0, 0, 1, 3
"d:\IDEWORK\lvmen\src\licensedcode\data\rules\x11-keith-packard7.yml", "YAML", 0, 0, 0, 3, 0, 0, 1, 4
"d:\IDEWORK\lvmen\src\licensedcode\data\rules\x11-keith-packard8.yml", "YAML", 0, 0, 0, 2, 0, 0, 1, 3
"d:\IDEWORK\lvmen\src\licensedcode\data\rules\x11-keith-packard_1.yml", "YAML", 0, 0, 0, 2, 0, 0, 1, 3
"d:\IDEWORK\lvmen\src\licensedcode\data\rules\x11-keith-packard_10.yml", "YAML", 0, 0, 0, 4, 0, 0, 1, 5
"d:\IDEWORK\lvmen\src\licensedcode\data\rules\x11-keith-packard_11.yml", "YAML", 0, 0, 0, 4, 0, 0, 1, 5
"d:\IDEWORK\lvmen\src\licensedcode\data\rules\x11-keith-packard_12.yml", "YAML", 0, 0, 0, 2, 0, 0, 1, 3
"d:\IDEWORK\lvmen\src\licensedcode\data\rules\x11-keith-packard_13.yml", "YAML", 0, 0, 0, 4, 0, 0, 1, 5
"d:\IDEWORK\lvmen\src\licensedcode\data\rules\x11-keith-packard_14.yml", "YAML", 0, 0, 0, 4, 0, 0, 1, 5
"d:\IDEWORK\lvmen\src\licensedcode\data\rules\x11-keith-packard_15.yml", "YAML", 0, 0, 0, 4, 0, 0, 1, 5
"d:\IDEWORK\lvmen\src\licensedcode\data\rules\x11-keith-packard_16.yml", "YAML", 0, 0, 0, 4, 0, 0, 1, 5
"d:\IDEWORK\lvmen\src\licensedcode\data\rules\x11-keith-packard_17.yml", "YAML", 0, 0, 0, 4, 0, 0, 1, 5
"d:\IDEWORK\lvmen\src\licensedcode\data\rules\x11-keith-packard_18.yml", "YAML", 0, 0, 0, 4, 0, 0, 1, 5
"d:\IDEWORK\lvmen\src\licensedcode\data\rules\x11-keith-packard_19.yml", "YAML", 0, 0, 0, 4, 0, 0, 1, 5
"d:\IDEWORK\lvmen\src\licensedcode\data\rules\x11-keith-packard_2.yml", "YAML", 0, 0, 0, 4, 0, 0, 1, 5
"d:\IDEWORK\lvmen\src\licensedcode\data\rules\x11-keith-packard_20.yml", "YAML", 0, 0, 0, 4, 0, 0, 1, 5
"d:\IDEWORK\lvmen\src\licensedcode\data\rules\x11-keith-packard_21.yml", "YAML", 0, 0, 0, 4, 0, 0, 1, 5
"d:\IDEWORK\lvmen\src\licensedcode\data\rules\x11-keith-packard_22.yml", "YAML", 0, 0, 0, 4, 0, 0, 1, 5
"d:\IDEWORK\lvmen\src\licensedcode\data\rules\x11-keith-packard_23.yml", "YAML", 0, 0, 0, 3, 0, 0, 1, 4
"d:\IDEWORK\lvmen\src\licensedcode\data\rules\x11-keith-packard_24.yml", "YAML", 0, 0, 0, 4, 0, 0, 1, 5
"d:\IDEWORK\lvmen\src\licensedcode\data\rules\x11-keith-packard_25.yml", "YAML", 0, 0, 0, 4, 0, 0, 1, 5
"d:\IDEWORK\lvmen\src\licensedcode\data\rules\x11-keith-packard_26.yml", "YAML", 0, 0, 0, 4, 0, 0, 1, 5
"d:\IDEWORK\lvmen\src\licensedcode\data\rules\x11-keith-packard_27.yml", "YAML", 0, 0, 0, 4, 0, 0, 1, 5
"d:\IDEWORK\lvmen\src\licensedcode\data\rules\x11-keith-packard_3.yml", "YAML", 0, 0, 0, 3, 0, 0, 1, 4
"d:\IDEWORK\lvmen\src\licensedcode\data\rules\x11-keith-packard_4.yml", "YAML", 0, 0, 0, 4, 0, 0, 1, 5
"d:\IDEWORK\lvmen\src\licensedcode\data\rules\x11-keith-packard_5.yml", "YAML", 0, 0, 0, 4, 0, 0, 1, 5
"d:\IDEWORK\lvmen\src\licensedcode\data\rules\x11-keith-packard_6.yml", "YAML", 0, 0, 0, 3, 0, 0, 1, 4
"d:\IDEWORK\lvmen\src\licensedcode\data\rules\x11-keith-packard_7.yml", "YAML", 0, 0, 0, 3, 0, 0, 1, 4
"d:\IDEWORK\lvmen\src\licensedcode\data\rules\x11-keith-packard_8.yml", "YAML", 0, 0, 0, 4, 0, 0, 1, 5
"d:\IDEWORK\lvmen\src\licensedcode\data\rules\x11-keith-packard_9.yml", "YAML", 0, 0, 0, 4, 0, 0, 1, 5
"d:\IDEWORK\lvmen\src\licensedcode\data\rules\x11-keith-packard_historical-sell-variant_6.yml", "YAML", 0, 0, 0, 2, 0, 0, 1, 3
"d:\IDEWORK\lvmen\src\licensedcode\data\rules\x11-keith-packard_historical-sell-variant_7.yml", "YAML", 0, 0, 0, 2, 0, 0, 1, 3
"d:\IDEWORK\lvmen\src\licensedcode\data\rules\x11-keith-packard_historical-sell-variant_9.yml", "YAML", 0, 0, 0, 2, 0, 0, 1, 3
"d:\IDEWORK\lvmen\src\licensedcode\data\rules\x11-keith-packard_not_mit.yml", "YAML", 0, 0, 0, 3, 0, 0, 1, 4
"d:\IDEWORK\lvmen\src\licensedcode\data\rules\x11-keith-packard_original.yml", "YAML", 0, 0, 0, 2, 0, 0, 1, 3
"d:\IDEWORK\lvmen\src\licensedcode\data\rules\x11-keith-packard_url_1.yml", "YAML", 0, 0, 0, 5, 0, 0, 1, 6
"d:\IDEWORK\lvmen\src\licensedcode\data\rules\x11-keith-packard_url_2.yml", "YAML", 0, 0, 0, 5, 0, 0, 1, 6
"d:\IDEWORK\lvmen\src\licensedcode\data\rules\x11-lucent.yml", "YAML", 0, 0, 0, 2, 0, 0, 1, 3
"d:\IDEWORK\lvmen\src\licensedcode\data\rules\x11-lucent_1.yml", "YAML", 0, 0, 0, 2, 0, 0, 1, 3
"d:\IDEWORK\lvmen\src\licensedcode\data\rules\x11-lucent_2.yml", "YAML", 0, 0, 0, 2, 0, 0, 1, 3
"d:\IDEWORK\lvmen\src\licensedcode\data\rules\x11-lucent_3.yml", "YAML", 0, 0, 0, 2, 0, 0, 1, 3
"d:\IDEWORK\lvmen\src\licensedcode\data\rules\x11-lucent_4.yml", "YAML", 0, 0, 0, 7, 0, 0, 1, 8
"d:\IDEWORK\lvmen\src\licensedcode\data\rules\x11-lucent_or_lucent-pl.yml", "YAML", 0, 0, 0, 7, 0, 0, 1, 8
"d:\IDEWORK\lvmen\src\licensedcode\data\rules\x11-opengroup_1.yml", "YAML", 0, 0, 0, 3, 0, 0, 2, 5
"d:\IDEWORK\lvmen\src\licensedcode\data\rules\x11-opengroup_2.yml", "YAML", 0, 0, 0, 5, 0, 0, 2, 7
"d:\IDEWORK\lvmen\src\licensedcode\data\rules\x11-opengroup_3.yml", "YAML", 0, 0, 0, 6, 0, 0, 1, 7
"d:\IDEWORK\lvmen\src\licensedcode\data\rules\x11-opengroup_4.yml", "YAML", 0, 0, 0, 3, 0, 0, 2, 5
"d:\IDEWORK\lvmen\src\licensedcode\data\rules\x11-opengroup_5.yml", "YAML", 0, 0, 0, 3, 0, 0, 1, 4
"d:\IDEWORK\lvmen\src\licensedcode\data\rules\x11-opengroup_6.yml", "YAML", 0, 0, 0, 3, 0, 0, 2, 5
"d:\IDEWORK\lvmen\src\licensedcode\data\rules\x11-opengroup_7.yml", "YAML", 0, 0, 0, 5, 0, 0, 1, 6
"d:\IDEWORK\lvmen\src\licensedcode\data\rules\x11-opengroup_8.yml", "YAML", 0, 0, 0, 5, 0, 0, 1, 6
"d:\IDEWORK\lvmen\src\licensedcode\data\rules\x11-opengroup_9.yml", "YAML", 0, 0, 0, 4, 0, 0, 1, 5
"d:\IDEWORK\lvmen\src\licensedcode\data\rules\x11-opengroup_not_mit_1.yml", "YAML", 0, 0, 0, 3, 0, 0, 1, 4
"d:\IDEWORK\lvmen\src\licensedcode\data\rules\x11-opengroup_not_mit_2.yml", "YAML", 0, 0, 0, 3, 0, 0, 1, 4
"d:\IDEWORK\lvmen\src\licensedcode\data\rules\x11-opengroup_not_mit_3.yml", "YAML", 0, 0, 0, 3, 0, 0, 1, 4
"d:\IDEWORK\lvmen\src\licensedcode\data\rules\x11-stanford_1.yml", "YAML", 0, 0, 0, 3, 0, 0, 1, 4
"d:\IDEWORK\lvmen\src\licensedcode\data\rules\x11-tiff_1.yml", "YAML", 0, 0, 0, 3, 0, 0, 1, 4
"d:\IDEWORK\lvmen\src\licensedcode\data\rules\x11-tiff_2.yml", "YAML", 0, 0, 0, 2, 0, 0, 1, 3
"d:\IDEWORK\lvmen\src\licensedcode\data\rules\x11-tiff_3.yml", "YAML", 0, 0, 0, 2, 0, 0, 1, 3
"d:\IDEWORK\lvmen\src\licensedcode\data\rules\x11-tiff_4.yml", "YAML", 0, 0, 0, 3, 0, 0, 1, 4
"d:\IDEWORK\lvmen\src\licensedcode\data\rules\x11-tiff_5.yml", "YAML", 0, 0, 0, 3, 0, 0, 1, 4
"d:\IDEWORK\lvmen\src\licensedcode\data\rules\x11-tiff_6.yml", "YAML", 0, 0, 0, 4, 0, 0, 1, 5
"d:\IDEWORK\lvmen\src\licensedcode\data\rules\x11-tiff_7.yml", "YAML", 0, 0, 0, 3, 0, 0, 1, 4
"d:\IDEWORK\lvmen\src\licensedcode\data\rules\x11-tiff_8.yml", "YAML", 0, 0, 0, 3, 0, 0, 1, 4
"d:\IDEWORK\lvmen\src\licensedcode\data\rules\x11-tiff_url_1.yml", "YAML", 0, 0, 0, 5, 0, 0, 1, 6
"d:\IDEWORK\lvmen\src\licensedcode\data\rules\x11-tiff_url_2.yml", "YAML", 0, 0, 0, 5, 0, 0, 1, 6
"d:\IDEWORK\lvmen\src\licensedcode\data\rules\x11-x11r5_1.yml", "YAML", 0, 0, 0, 2, 0, 0, 1, 3
"d:\IDEWORK\lvmen\src\licensedcode\data\rules\x11-x11r5_2.yml", "YAML", 0, 0, 0, 2, 0, 0, 1, 3
"d:\IDEWORK\lvmen\src\licensedcode\data\rules\x11-xconsortium_1.yml", "YAML", 0, 0, 0, 4, 0, 0, 2, 6
"d:\IDEWORK\lvmen\src\licensedcode\data\rules\x11-xconsortium_10.yml", "YAML", 0, 0, 0, 3, 0, 0, 1, 4
"d:\IDEWORK\lvmen\src\licensedcode\data\rules\x11-xconsortium_11.yml", "YAML", 0, 0, 0, 3, 0, 0, 1, 4
"d:\IDEWORK\lvmen\src\licensedcode\data\rules\x11-xconsortium_12.yml", "YAML", 0, 0, 0, 4, 0, 0, 1, 5
"d:\IDEWORK\lvmen\src\licensedcode\data\rules\x11-xconsortium_13.yml", "YAML", 0, 0, 0, 3, 0, 0, 1, 4
"d:\IDEWORK\lvmen\src\licensedcode\data\rules\x11-xconsortium_14.yml", "YAML", 0, 0, 0, 3, 0, 0, 1, 4
"d:\IDEWORK\lvmen\src\licensedcode\data\rules\x11-xconsortium_15.yml", "YAML", 0, 0, 0, 3, 0, 0, 1, 4
"d:\IDEWORK\lvmen\src\licensedcode\data\rules\x11-xconsortium_16.yml", "YAML", 0, 0, 0, 3, 0, 0, 1, 4
"d:\IDEWORK\lvmen\src\licensedcode\data\rules\x11-xconsortium_17.yml", "YAML", 0, 0, 0, 6, 0, 0, 1, 7
"d:\IDEWORK\lvmen\src\licensedcode\data\rules\x11-xconsortium_18.yml", "YAML", 0, 0, 0, 6, 0, 0, 1, 7
"d:\IDEWORK\lvmen\src\licensedcode\data\rules\x11-xconsortium_19.yml", "YAML", 0, 0, 0, 4, 0, 0, 1, 5
"d:\IDEWORK\lvmen\src\licensedcode\data\rules\x11-xconsortium_2.yml", "YAML", 0, 0, 0, 3, 0, 0, 1, 4
"d:\IDEWORK\lvmen\src\licensedcode\data\rules\x11-xconsortium_20.yml", "YAML", 0, 0, 0, 4, 0, 0, 1, 5
"d:\IDEWORK\lvmen\src\licensedcode\data\rules\x11-xconsortium_21.yml", "YAML", 0, 0, 0, 3, 0, 0, 1, 4
"d:\IDEWORK\lvmen\src\licensedcode\data\rules\x11-xconsortium_22.yml", "YAML", 0, 0, 0, 5, 0, 0, 1, 6
"d:\IDEWORK\lvmen\src\licensedcode\data\rules\x11-xconsortium_23.yml", "YAML", 0, 0, 0, 4, 0, 0, 1, 5
"d:\IDEWORK\lvmen\src\licensedcode\data\rules\x11-xconsortium_24.yml", "YAML", 0, 0, 0, 4, 0, 0, 1, 5
"d:\IDEWORK\lvmen\src\licensedcode\data\rules\x11-xconsortium_25.yml", "YAML", 0, 0, 0, 4, 0, 0, 1, 5
"d:\IDEWORK\lvmen\src\licensedcode\data\rules\x11-xconsortium_26.yml", "YAML", 0, 0, 0, 4, 0, 0, 1, 5
"d:\IDEWORK\lvmen\src\licensedcode\data\rules\x11-xconsortium_27.yml", "YAML", 0, 0, 0, 4, 0, 0, 1, 5
"d:\IDEWORK\lvmen\src\licensedcode\data\rules\x11-xconsortium_28.yml", "YAML", 0, 0, 0, 3, 0, 0, 1, 4
"d:\IDEWORK\lvmen\src\licensedcode\data\rules\x11-xconsortium_29.yml", "YAML", 0, 0, 0, 3, 0, 0, 1, 4
"d:\IDEWORK\lvmen\src\licensedcode\data\rules\x11-xconsortium_3.yml", "YAML", 0, 0, 0, 3, 0, 0, 1, 4
"d:\IDEWORK\lvmen\src\licensedcode\data\rules\x11-xconsortium_30.yml", "YAML", 0, 0, 0, 3, 0, 0, 1, 4
"d:\IDEWORK\lvmen\src\licensedcode\data\rules\x11-xconsortium_4.yml", "YAML", 0, 0, 0, 3, 0, 0, 1, 4
"d:\IDEWORK\lvmen\src\licensedcode\data\rules\x11-xconsortium_5.yml", "YAML", 0, 0, 0, 8, 0, 0, 1, 9
"d:\IDEWORK\lvmen\src\licensedcode\data\rules\x11-xconsortium_6.yml", "YAML", 0, 0, 0, 8, 0, 0, 1, 9
"d:\IDEWORK\lvmen\src\licensedcode\data\rules\x11-xconsortium_7.yml", "YAML", 0, 0, 0, 3, 0, 0, 1, 4
"d:\IDEWORK\lvmen\src\licensedcode\data\rules\x11-xconsortium_8.yml", "YAML", 0, 0, 0, 4, 0, 0, 1, 5
"d:\IDEWORK\lvmen\src\licensedcode\data\rules\x11-xconsortium_9.yml", "YAML", 0, 0, 0, 3, 0, 0, 1, 4
"d:\IDEWORK\lvmen\src\licensedcode\data\rules\x11-xconsortium_and_x11-keith-packard_and_historical_and_other-permissive_1.yml", "YAML", 0, 0, 0, 5, 0, 0, 1, 6
"d:\IDEWORK\lvmen\src\licensedcode\data\rules\x11-xconsortium_url_1.yml", "YAML", 0, 0, 0, 5, 0, 0, 1, 6
"d:\IDEWORK\lvmen\src\licensedcode\data\rules\x11-xconsortium_url_2.yml", "YAML", 0, 0, 0, 5, 0, 0, 1, 6
"d:\IDEWORK\lvmen\src\licensedcode\data\rules\x11-xconsortium_veillard_1.yml", "YAML", 0, 0, 0, 3, 0, 0, 1, 4
"d:\IDEWORK\lvmen\src\licensedcode\data\rules\x11-xconsortium_veillard_2.yml", "YAML", 0, 0, 0, 3, 0, 0, 1, 4
"d:\IDEWORK\lvmen\src\licensedcode\data\rules\x11_1.yml", "YAML", 0, 0, 0, 5, 0, 0, 1, 6
"d:\IDEWORK\lvmen\src\licensedcode\data\rules\x11_10.yml", "YAML", 0, 0, 0, 5, 0, 0, 1, 6
"d:\IDEWORK\lvmen\src\licensedcode\data\rules\x11_11.yml", "YAML", 0, 0, 0, 4, 0, 0, 1, 5
"d:\IDEWORK\lvmen\src\licensedcode\data\rules\x11_12.yml", "YAML", 0, 0, 0, 5, 0, 0, 1, 6
"d:\IDEWORK\lvmen\src\licensedcode\data\rules\x11_13.yml", "YAML", 0, 0, 0, 5, 0, 0, 1, 6
"d:\IDEWORK\lvmen\src\licensedcode\data\rules\x11_14.yml", "YAML", 0, 0, 0, 3, 0, 0, 1, 4
"d:\IDEWORK\lvmen\src\licensedcode\data\rules\x11_15.yml", "YAML", 0, 0, 0, 3, 0, 0, 1, 4
"d:\IDEWORK\lvmen\src\licensedcode\data\rules\x11_2.yml", "YAML", 0, 0, 0, 3, 0, 0, 1, 4
"d:\IDEWORK\lvmen\src\licensedcode\data\rules\x11_3.yml", "YAML", 0, 0, 0, 3, 0, 0, 1, 4
"d:\IDEWORK\lvmen\src\licensedcode\data\rules\x11_4.yml", "YAML", 0, 0, 0, 3, 0, 0, 1, 4
"d:\IDEWORK\lvmen\src\licensedcode\data\rules\x11_5.yml", "YAML", 0, 0, 0, 5, 0, 0, 1, 6
"d:\IDEWORK\lvmen\src\licensedcode\data\rules\x11_6.yml", "YAML", 0, 0, 0, 5, 0, 0, 1, 6
"d:\IDEWORK\lvmen\src\licensedcode\data\rules\x11_7.yml", "YAML", 0, 0, 0, 3, 0, 0, 1, 4
"d:\IDEWORK\lvmen\src\licensedcode\data\rules\x11_8.yml", "YAML", 0, 0, 0, 3, 0, 0, 1, 4
"d:\IDEWORK\lvmen\src\licensedcode\data\rules\x11_9.yml", "YAML", 0, 0, 0, 3, 0, 0, 1, 4
"d:\IDEWORK\lvmen\src\licensedcode\data\rules\x11_and_other-permissive_1.yml", "YAML", 0, 0, 0, 4, 0, 0, 1, 5
"d:\IDEWORK\lvmen\src\licensedcode\data\rules\x11_and_other-permissive_2.yml", "YAML", 0, 0, 0, 9, 0, 0, 1, 10
"d:\IDEWORK\lvmen\src\licensedcode\data\rules\x11_and_other-permissive_3.yml", "YAML", 0, 0, 0, 11, 0, 0, 1, 12
"d:\IDEWORK\lvmen\src\licensedcode\data\rules\x11_danse.yml", "YAML", 0, 0, 0, 3, 0, 0, 1, 4
"d:\IDEWORK\lvmen\src\licensedcode\data\rules\x11_danse2.yml", "YAML", 0, 0, 0, 4, 0, 0, 1, 5
"d:\IDEWORK\lvmen\src\licensedcode\data\rules\x11_ibm-icu_4.yml", "YAML", 0, 0, 0, 3, 0, 0, 1, 4
"d:\IDEWORK\lvmen\src\licensedcode\data\rules\x11_ibm-icu_5.yml", "YAML", 0, 0, 0, 3, 0, 0, 1, 4
"d:\IDEWORK\lvmen\src\licensedcode\data\rules\x11_ibm-icu_6.yml", "YAML", 0, 0, 0, 3, 0, 0, 1, 4
"d:\IDEWORK\lvmen\src\licensedcode\data\rules\x11_nuget_url_1.yml", "YAML", 0, 0, 0, 5, 0, 0, 1, 6
"d:\IDEWORK\lvmen\src\licensedcode\data\rules\x11_url_1.yml", "YAML", 0, 0, 0, 5, 0, 0, 1, 6
"d:\IDEWORK\lvmen\src\licensedcode\data\rules\x11_url_2.yml", "YAML", 0, 0, 0, 5, 0, 0, 1, 6
"d:\IDEWORK\lvmen\src\licensedcode\data\rules\xfree86-1.0.yml", "YAML", 0, 0, 0, 5, 0, 0, 1, 6
"d:\IDEWORK\lvmen\src\licensedcode\data\rules\xfree86-1.0_1.yml", "YAML", 0, 0, 0, 3, 0, 0, 1, 4
"d:\IDEWORK\lvmen\src\licensedcode\data\rules\xfree86-1.0_2.yml", "YAML", 0, 0, 0, 3, 0, 0, 1, 4
"d:\IDEWORK\lvmen\src\licensedcode\data\rules\xfree86-1.0_3.yml", "YAML", 0, 0, 0, 3, 0, 0, 1, 4
"d:\IDEWORK\lvmen\src\licensedcode\data\rules\xfree86-1.0_4.yml", "YAML", 0, 0, 0, 3, 0, 0, 1, 4
"d:\IDEWORK\lvmen\src\licensedcode\data\rules\xfree86-1.0_5.yml", "YAML", 0, 0, 0, 3, 0, 0, 1, 4
"d:\IDEWORK\lvmen\src\licensedcode\data\rules\xfree86-1.0_6.yml", "YAML", 0, 0, 0, 3, 0, 0, 1, 4
"d:\IDEWORK\lvmen\src\licensedcode\data\rules\xfree86-1.0_7.yml", "YAML", 0, 0, 0, 3, 0, 0, 1, 4
"d:\IDEWORK\lvmen\src\licensedcode\data\rules\xfree86-1.1.SPDX.yml", "YAML", 0, 0, 0, 8, 0, 0, 1, 9
"d:\IDEWORK\lvmen\src\licensedcode\data\rules\xfree86-1.1_1.yml", "YAML", 0, 0, 0, 3, 0, 0, 1, 4
"d:\IDEWORK\lvmen\src\licensedcode\data\rules\xfree86-1.1_2.yml", "YAML", 0, 0, 0, 5, 0, 0, 1, 6
"d:\IDEWORK\lvmen\src\licensedcode\data\rules\xfree86-1.1_3.yml", "YAML", 0, 0, 0, 8, 0, 0, 2, 10
"d:\IDEWORK\lvmen\src\licensedcode\data\rules\xfree86-1.1_4.yml", "YAML", 0, 0, 0, 8, 0, 0, 1, 9
"d:\IDEWORK\lvmen\src\licensedcode\data\rules\xfree86-1.1_5.yml", "YAML", 0, 0, 0, 3, 0, 0, 1, 4
"d:\IDEWORK\lvmen\src\licensedcode\data\rules\xfree86-1.1_6.yml", "YAML", 0, 0, 0, 3, 0, 0, 1, 4
"d:\IDEWORK\lvmen\src\licensedcode\data\rules\xfree86-1.1_7.yml", "YAML", 0, 0, 0, 3, 0, 0, 1, 4
"d:\IDEWORK\lvmen\src\licensedcode\data\rules\xfree86-1.1_url_1.yml", "YAML", 0, 0, 0, 5, 0, 0, 1, 6
"d:\IDEWORK\lvmen\src\licensedcode\data\rules\xfree86-1.1_url_2.yml", "YAML", 0, 0, 0, 5, 0, 0, 1, 6
"d:\IDEWORK\lvmen\src\licensedcode\data\rules\xilinx-2016_1.yml", "YAML", 0, 0, 0, 2, 0, 0, 1, 3
"d:\IDEWORK\lvmen\src\licensedcode\data\rules\xilinx-2016_2.yml", "YAML", 0, 0, 0, 2, 0, 0, 1, 3
"d:\IDEWORK\lvmen\src\licensedcode\data\rules\xilinx-2016_4.yml", "YAML", 0, 0, 0, 2, 0, 0, 1, 3
"d:\IDEWORK\lvmen\src\licensedcode\data\rules\xinetd.SPDX.yml", "YAML", 0, 0, 0, 14, 0, 0, 1, 15
"d:\IDEWORK\lvmen\src\licensedcode\data\rules\xinetd_url_1.yml", "YAML", 0, 0, 0, 5, 0, 0, 1, 6
"d:\IDEWORK\lvmen\src\licensedcode\data\rules\xinetd_url_2.yml", "YAML", 0, 0, 0, 5, 0, 0, 1, 6
"d:\IDEWORK\lvmen\src\licensedcode\data\rules\xmldb-1.0.yml", "YAML", 0, 0, 0, 5, 0, 0, 1, 6
"d:\IDEWORK\lvmen\src\licensedcode\data\rules\xmldb-1.0_3.yml", "YAML", 0, 0, 0, 5, 0, 0, 1, 6
"d:\IDEWORK\lvmen\src\licensedcode\data\rules\xnet.yml", "YAML", 0, 0, 0, 5, 0, 0, 1, 6
"d:\IDEWORK\lvmen\src\licensedcode\data\rules\xnet_1.yml", "YAML", 0, 0, 0, 3, 0, 0, 1, 4
"d:\IDEWORK\lvmen\src\licensedcode\data\rules\xnet_2.yml", "YAML", 0, 0, 0, 5, 0, 0, 1, 6
"d:\IDEWORK\lvmen\src\licensedcode\data\rules\xnet_3.yml", "YAML", 0, 0, 0, 5, 0, 0, 1, 6
"d:\IDEWORK\lvmen\src\licensedcode\data\rules\xnet_4.yml", "YAML", 0, 0, 0, 5, 0, 0, 1, 6
"d:\IDEWORK\lvmen\src\licensedcode\data\rules\xnet_5.yml", "YAML", 0, 0, 0, 5, 0, 0, 1, 6
"d:\IDEWORK\lvmen\src\licensedcode\data\rules\xnet_url_1.yml", "YAML", 0, 0, 0, 5, 0, 0, 1, 6
"d:\IDEWORK\lvmen\src\licensedcode\data\rules\xnet_url_2.yml", "YAML", 0, 0, 0, 5, 0, 0, 1, 6
"d:\IDEWORK\lvmen\src\licensedcode\data\rules\xskat_url_1.yml", "YAML", 0, 0, 0, 5, 0, 0, 1, 6
"d:\IDEWORK\lvmen\src\licensedcode\data\rules\xskat_url_2.yml", "YAML", 0, 0, 0, 5, 0, 0, 1, 6
"d:\IDEWORK\lvmen\src\licensedcode\data\rules\yensdesign.yml", "YAML", 0, 0, 0, 5, 0, 0, 1, 6
"d:\IDEWORK\lvmen\src\licensedcode\data\rules\ypl-1.0.yml", "YAML", 0, 0, 0, 5, 0, 0, 1, 6
"d:\IDEWORK\lvmen\src\licensedcode\data\rules\ypl-1.0_1.yml", "YAML", 0, 0, 0, 5, 0, 0, 1, 6
"d:\IDEWORK\lvmen\src\licensedcode\data\rules\ypl-1.0_2.yml", "YAML", 0, 0, 0, 5, 0, 0, 1, 6
"d:\IDEWORK\lvmen\src\licensedcode\data\rules\ypl-1.0_3.yml", "YAML", 0, 0, 0, 3, 0, 0, 1, 4
"d:\IDEWORK\lvmen\src\licensedcode\data\rules\ypl-1.0_url_1.yml", "YAML", 0, 0, 0, 5, 0, 0, 1, 6
"d:\IDEWORK\lvmen\src\licensedcode\data\rules\ypl-1.0_url_2.yml", "YAML", 0, 0, 0, 5, 0, 0, 1, 6
"d:\IDEWORK\lvmen\src\licensedcode\data\rules\ypl-1.1.yml", "YAML", 0, 0, 0, 5, 0, 0, 1, 6
"d:\IDEWORK\lvmen\src\licensedcode\data\rules\ypl-1.1_url_1.yml", "YAML", 0, 0, 0, 5, 0, 0, 1, 6
"d:\IDEWORK\lvmen\src\licensedcode\data\rules\ypl-1.1_url_2.yml", "YAML", 0, 0, 0, 5, 0, 0, 1, 6
"d:\IDEWORK\lvmen\src\licensedcode\data\rules\zed_url_1.yml", "YAML", 0, 0, 0, 5, 0, 0, 1, 6
"d:\IDEWORK\lvmen\src\licensedcode\data\rules\zed_url_2.yml", "YAML", 0, 0, 0, 5, 0, 0, 1, 6
"d:\IDEWORK\lvmen\src\licensedcode\data\rules\zend-2.0_1.yml", "YAML", 0, 0, 0, 10, 0, 0, 1, 11
"d:\IDEWORK\lvmen\src\licensedcode\data\rules\zend-2.0_2.yml", "YAML", 0, 0, 0, 6, 0, 0, 1, 7
"d:\IDEWORK\lvmen\src\licensedcode\data\rules\zend-2.0_3.yml", "YAML", 0, 0, 0, 11, 0, 0, 1, 12
"d:\IDEWORK\lvmen\src\licensedcode\data\rules\zend-2.0_url_1.yml", "YAML", 0, 0, 0, 5, 0, 0, 1, 6
"d:\IDEWORK\lvmen\src\licensedcode\data\rules\zend-2.0_url_2.yml", "YAML", 0, 0, 0, 5, 0, 0, 1, 6
"d:\IDEWORK\lvmen\src\licensedcode\data\rules\zeromq-exception-lgpl-3.0_1.yml", "YAML", 0, 0, 0, 3, 0, 0, 1, 4
"d:\IDEWORK\lvmen\src\licensedcode\data\rules\zeromq-exception-lgpl-3.0_2.yml", "YAML", 0, 0, 0, 2, 0, 0, 1, 3
"d:\IDEWORK\lvmen\src\licensedcode\data\rules\zeromq-exception-lgpl-3.0_3.yml", "YAML", 0, 0, 0, 4, 0, 0, 1, 5
"d:\IDEWORK\lvmen\src\licensedcode\data\rules\zeromq-exception-lgpl-3.0_4.yml", "YAML", 0, 0, 0, 4, 0, 0, 1, 5
"d:\IDEWORK\lvmen\src\licensedcode\data\rules\zeromq-exception-lgpl-3.0_5.yml", "YAML", 0, 0, 0, 2, 0, 0, 1, 3
"d:\IDEWORK\lvmen\src\licensedcode\data\rules\zeusbench_1.yml", "YAML", 0, 0, 0, 3, 0, 0, 1, 4
"d:\IDEWORK\lvmen\src\licensedcode\data\rules\zeusbench_2.yml", "YAML", 0, 0, 0, 3, 0, 0, 1, 4
"d:\IDEWORK\lvmen\src\licensedcode\data\rules\zi-labone-proprietary.yml", "YAML", 0, 0, 0, 9, 0, 0, 1, 10
"d:\IDEWORK\lvmen\src\licensedcode\data\rules\zimbra-1.2_1.yml", "YAML", 0, 0, 0, 10, 0, 0, 1, 11
"d:\IDEWORK\lvmen\src\licensedcode\data\rules\zimbra-1.2_2.yml", "YAML", 0, 0, 0, 6, 0, 0, 1, 7
"d:\IDEWORK\lvmen\src\licensedcode\data\rules\zimbra-1.3.yml", "YAML", 0, 0, 0, 5, 0, 0, 1, 6
"d:\IDEWORK\lvmen\src\licensedcode\data\rules\zimbra-1.3_url_1.yml", "YAML", 0, 0, 0, 5, 0, 0, 1, 6
"d:\IDEWORK\lvmen\src\licensedcode\data\rules\zimbra-1.3_url_2.yml", "YAML", 0, 0, 0, 5, 0, 0, 1, 6
"d:\IDEWORK\lvmen\src\licensedcode\data\rules\zimbra-1.4_url_1.yml", "YAML", 0, 0, 0, 5, 0, 0, 1, 6
"d:\IDEWORK\lvmen\src\licensedcode\data\rules\zimbra-1.4_url_2.yml", "YAML", 0, 0, 0, 5, 0, 0, 1, 6
"d:\IDEWORK\lvmen\src\licensedcode\data\rules\zlib-acknowledgement.SPDX.yml", "YAML", 0, 0, 0, 13, 0, 0, 1, 14
"d:\IDEWORK\lvmen\src\licensedcode\data\rules\zlib-acknowledgement_nunit.yml", "YAML", 0, 0, 0, 3, 0, 0, 2, 5
"d:\IDEWORK\lvmen\src\licensedcode\data\rules\zlib-acknowledgement_nunit2.yml", "YAML", 0, 0, 0, 4, 0, 0, 2, 6
"d:\IDEWORK\lvmen\src\licensedcode\data\rules\zlib-acknowledgement_url_1.yml", "YAML", 0, 0, 0, 5, 0, 0, 1, 6
"d:\IDEWORK\lvmen\src\licensedcode\data\rules\zlib-acknowledgement_url_2.yml", "YAML", 0, 0, 0, 5, 0, 0, 1, 6
"d:\IDEWORK\lvmen\src\licensedcode\data\rules\zlib.yml", "YAML", 0, 0, 0, 5, 0, 0, 1, 6
"d:\IDEWORK\lvmen\src\licensedcode\data\rules\zlib_1.yml", "YAML", 0, 0, 0, 5, 0, 0, 1, 6
"d:\IDEWORK\lvmen\src\licensedcode\data\rules\zlib_10.yml", "YAML", 0, 0, 0, 7, 0, 0, 1, 8
"d:\IDEWORK\lvmen\src\licensedcode\data\rules\zlib_11.yml", "YAML", 0, 0, 0, 2, 0, 0, 1, 3
"d:\IDEWORK\lvmen\src\licensedcode\data\rules\zlib_12.yml", "YAML", 0, 0, 0, 2, 0, 0, 1, 3
"d:\IDEWORK\lvmen\src\licensedcode\data\rules\zlib_13.yml", "YAML", 0, 0, 0, 3, 0, 0, 1, 4
"d:\IDEWORK\lvmen\src\licensedcode\data\rules\zlib_14.yml", "YAML", 0, 0, 0, 3, 0, 0, 1, 4
"d:\IDEWORK\lvmen\src\licensedcode\data\rules\zlib_15.yml", "YAML", 0, 0, 0, 5, 0, 0, 1, 6
"d:\IDEWORK\lvmen\src\licensedcode\data\rules\zlib_16.yml", "YAML", 0, 0, 0, 4, 0, 0, 1, 5
"d:\IDEWORK\lvmen\src\licensedcode\data\rules\zlib_17.yml", "YAML", 0, 0, 0, 6, 0, 0, 1, 7
"d:\IDEWORK\lvmen\src\licensedcode\data\rules\zlib_18.yml", "YAML", 0, 0, 0, 4, 0, 0, 1, 5
"d:\IDEWORK\lvmen\src\licensedcode\data\rules\zlib_19.yml", "YAML", 0, 0, 0, 2, 0, 0, 1, 3
"d:\IDEWORK\lvmen\src\licensedcode\data\rules\zlib_2.yml", "YAML", 0, 0, 0, 7, 0, 0, 1, 8
"d:\IDEWORK\lvmen\src\licensedcode\data\rules\zlib_20.yml", "YAML", 0, 0, 0, 3, 0, 0, 1, 4
"d:\IDEWORK\lvmen\src\licensedcode\data\rules\zlib_21.yml", "YAML", 0, 0, 0, 3, 0, 0, 1, 4
"d:\IDEWORK\lvmen\src\licensedcode\data\rules\zlib_22.yml", "YAML", 0, 0, 0, 3, 0, 0, 1, 4
"d:\IDEWORK\lvmen\src\licensedcode\data\rules\zlib_23.yml", "YAML", 0, 0, 0, 3, 0, 0, 3, 6
"d:\IDEWORK\lvmen\src\licensedcode\data\rules\zlib_24.yml", "YAML", 0, 0, 0, 3, 0, 0, 1, 4
"d:\IDEWORK\lvmen\src\licensedcode\data\rules\zlib_25.yml", "YAML", 0, 0, 0, 3, 0, 0, 2, 5
"d:\IDEWORK\lvmen\src\licensedcode\data\rules\zlib_26.yml", "YAML", 0, 0, 0, 4, 0, 0, 1, 5
"d:\IDEWORK\lvmen\src\licensedcode\data\rules\zlib_27.yml", "YAML", 0, 0, 0, 3, 0, 0, 1, 4
"d:\IDEWORK\lvmen\src\licensedcode\data\rules\zlib_28.yml", "YAML", 0, 0, 0, 3, 0, 0, 1, 4
"d:\IDEWORK\lvmen\src\licensedcode\data\rules\zlib_29.yml", "YAML", 0, 0, 0, 2, 0, 0, 1, 3
"d:\IDEWORK\lvmen\src\licensedcode\data\rules\zlib_3.yml", "YAML", 0, 0, 0, 5, 0, 0, 1, 6
"d:\IDEWORK\lvmen\src\licensedcode\data\rules\zlib_30.yml", "YAML", 0, 0, 0, 3, 0, 0, 1, 4
"d:\IDEWORK\lvmen\src\licensedcode\data\rules\zlib_31.yml", "YAML", 0, 0, 0, 3, 0, 0, 1, 4
"d:\IDEWORK\lvmen\src\licensedcode\data\rules\zlib_32.yml", "YAML", 0, 0, 0, 4, 0, 0, 1, 5
"d:\IDEWORK\lvmen\src\licensedcode\data\rules\zlib_33.yml", "YAML", 0, 0, 0, 4, 0, 0, 1, 5
"d:\IDEWORK\lvmen\src\licensedcode\data\rules\zlib_34.yml", "YAML", 0, 0, 0, 5, 0, 0, 1, 6
"d:\IDEWORK\lvmen\src\licensedcode\data\rules\zlib_35.yml", "YAML", 0, 0, 0, 5, 0, 0, 1, 6
"d:\IDEWORK\lvmen\src\licensedcode\data\rules\zlib_36.yml", "YAML", 0, 0, 0, 3, 0, 0, 1, 4
"d:\IDEWORK\lvmen\src\licensedcode\data\rules\zlib_37.yml", "YAML", 0, 0, 0, 3, 0, 0, 1, 4
"d:\IDEWORK\lvmen\src\licensedcode\data\rules\zlib_38.yml", "YAML", 0, 0, 0, 5, 0, 0, 1, 6
"d:\IDEWORK\lvmen\src\licensedcode\data\rules\zlib_39.yml", "YAML", 0, 0, 0, 10, 0, 0, 1, 11
"d:\IDEWORK\lvmen\src\licensedcode\data\rules\zlib_4.yml", "YAML", 0, 0, 0, 2, 0, 0, 1, 3
"d:\IDEWORK\lvmen\src\licensedcode\data\rules\zlib_40.yml", "YAML", 0, 0, 0, 5, 0, 0, 1, 6
"d:\IDEWORK\lvmen\src\licensedcode\data\rules\zlib_41.yml", "YAML", 0, 0, 0, 3, 0, 0, 1, 4
"d:\IDEWORK\lvmen\src\licensedcode\data\rules\zlib_42.yml", "YAML", 0, 0, 0, 5, 0, 0, 1, 6
"d:\IDEWORK\lvmen\src\licensedcode\data\rules\zlib_43.yml", "YAML", 0, 0, 0, 3, 0, 0, 1, 4
"d:\IDEWORK\lvmen\src\licensedcode\data\rules\zlib_44.yml", "YAML", 0, 0, 0, 3, 0, 0, 1, 4
"d:\IDEWORK\lvmen\src\licensedcode\data\rules\zlib_45.yml", "YAML", 0, 0, 0, 3, 0, 0, 1, 4
"d:\IDEWORK\lvmen\src\licensedcode\data\rules\zlib_46.yml", "YAML", 0, 0, 0, 5, 0, 0, 1, 6
"d:\IDEWORK\lvmen\src\licensedcode\data\rules\zlib_47.yml", "YAML", 0, 0, 0, 5, 0, 0, 1, 6
"d:\IDEWORK\lvmen\src\licensedcode\data\rules\zlib_48.yml", "YAML", 0, 0, 0, 3, 0, 0, 1, 4
"d:\IDEWORK\lvmen\src\licensedcode\data\rules\zlib_49.yml", "YAML", 0, 0, 0, 3, 0, 0, 1, 4
"d:\IDEWORK\lvmen\src\licensedcode\data\rules\zlib_5.yml", "YAML", 0, 0, 0, 6, 0, 0, 1, 7
"d:\IDEWORK\lvmen\src\licensedcode\data\rules\zlib_50.yml", "YAML", 0, 0, 0, 3, 0, 0, 1, 4
"d:\IDEWORK\lvmen\src\licensedcode\data\rules\zlib_51.yml", "YAML", 0, 0, 0, 5, 0, 0, 1, 6
"d:\IDEWORK\lvmen\src\licensedcode\data\rules\zlib_52.yml", "YAML", 0, 0, 0, 3, 0, 0, 1, 4
"d:\IDEWORK\lvmen\src\licensedcode\data\rules\zlib_53.yml", "YAML", 0, 0, 0, 6, 0, 0, 1, 7
"d:\IDEWORK\lvmen\src\licensedcode\data\rules\zlib_54.yml", "YAML", 0, 0, 0, 5, 0, 0, 1, 6
"d:\IDEWORK\lvmen\src\licensedcode\data\rules\zlib_55.yml", "YAML", 0, 0, 0, 3, 0, 0, 1, 4
"d:\IDEWORK\lvmen\src\licensedcode\data\rules\zlib_56.yml", "YAML", 0, 0, 0, 3, 0, 0, 1, 4
"d:\IDEWORK\lvmen\src\licensedcode\data\rules\zlib_57.yml", "YAML", 0, 0, 0, 3, 0, 0, 1, 4
"d:\IDEWORK\lvmen\src\licensedcode\data\rules\zlib_58.yml", "YAML", 0, 0, 0, 5, 0, 0, 1, 6
"d:\IDEWORK\lvmen\src\licensedcode\data\rules\zlib_59.yml", "YAML", 0, 0, 0, 3, 0, 0, 1, 4
"d:\IDEWORK\lvmen\src\licensedcode\data\rules\zlib_6.yml", "YAML", 0, 0, 0, 5, 0, 0, 1, 6
"d:\IDEWORK\lvmen\src\licensedcode\data\rules\zlib_60.yml", "YAML", 0, 0, 0, 5, 0, 0, 1, 6
"d:\IDEWORK\lvmen\src\licensedcode\data\rules\zlib_61.yml", "YAML", 0, 0, 0, 5, 0, 0, 1, 6
"d:\IDEWORK\lvmen\src\licensedcode\data\rules\zlib_62.yml", "YAML", 0, 0, 0, 5, 0, 0, 1, 6
"d:\IDEWORK\lvmen\src\licensedcode\data\rules\zlib_63.yml", "YAML", 0, 0, 0, 3, 0, 0, 1, 4
"d:\IDEWORK\lvmen\src\licensedcode\data\rules\zlib_64.yml", "YAML", 0, 0, 0, 5, 0, 0, 2, 7
"d:\IDEWORK\lvmen\src\licensedcode\data\rules\zlib_65.yml", "YAML", 0, 0, 0, 5, 0, 0, 1, 6
"d:\IDEWORK\lvmen\src\licensedcode\data\rules\zlib_66.yml", "YAML", 0, 0, 0, 3, 0, 0, 1, 4
"d:\IDEWORK\lvmen\src\licensedcode\data\rules\zlib_67.yml", "YAML", 0, 0, 0, 7, 0, 0, 1, 8
"d:\IDEWORK\lvmen\src\licensedcode\data\rules\zlib_68.yml", "YAML", 0, 0, 0, 7, 0, 0, 1, 8
"d:\IDEWORK\lvmen\src\licensedcode\data\rules\zlib_69.yml", "YAML", 0, 0, 0, 3, 0, 0, 1, 4
"d:\IDEWORK\lvmen\src\licensedcode\data\rules\zlib_7.yml", "YAML", 0, 0, 0, 4, 0, 0, 2, 6
"d:\IDEWORK\lvmen\src\licensedcode\data\rules\zlib_70.yml", "YAML", 0, 0, 0, 3, 0, 0, 1, 4
"d:\IDEWORK\lvmen\src\licensedcode\data\rules\zlib_71.yml", "YAML", 0, 0, 0, 8, 0, 0, 1, 9
"d:\IDEWORK\lvmen\src\licensedcode\data\rules\zlib_72.yml", "YAML", 0, 0, 0, 7, 0, 0, 1, 8
"d:\IDEWORK\lvmen\src\licensedcode\data\rules\zlib_73.yml", "YAML", 0, 0, 0, 7, 0, 0, 1, 8
"d:\IDEWORK\lvmen\src\licensedcode\data\rules\zlib_74.yml", "YAML", 0, 0, 0, 5, 0, 0, 1, 6
"d:\IDEWORK\lvmen\src\licensedcode\data\rules\zlib_75.yml", "YAML", 0, 0, 0, 3, 0, 0, 1, 4
"d:\IDEWORK\lvmen\src\licensedcode\data\rules\zlib_76.yml", "YAML", 0, 0, 0, 3, 0, 0, 1, 4
"d:\IDEWORK\lvmen\src\licensedcode\data\rules\zlib_77.yml", "YAML", 0, 0, 0, 4, 0, 0, 1, 5
"d:\IDEWORK\lvmen\src\licensedcode\data\rules\zlib_78.yml", "YAML", 0, 0, 0, 5, 0, 0, 2, 7
"d:\IDEWORK\lvmen\src\licensedcode\data\rules\zlib_79.yml", "YAML", 0, 0, 0, 6, 0, 0, 1, 7
"d:\IDEWORK\lvmen\src\licensedcode\data\rules\zlib_8.yml", "YAML", 0, 0, 0, 4, 0, 0, 1, 5
"d:\IDEWORK\lvmen\src\licensedcode\data\rules\zlib_80.yml", "YAML", 0, 0, 0, 4, 0, 0, 1, 5
"d:\IDEWORK\lvmen\src\licensedcode\data\rules\zlib_81.yml", "YAML", 0, 0, 0, 5, 0, 0, 2, 7
"d:\IDEWORK\lvmen\src\licensedcode\data\rules\zlib_82.yml", "YAML", 0, 0, 0, 5, 0, 0, 1, 6
"d:\IDEWORK\lvmen\src\licensedcode\data\rules\zlib_83.yml", "YAML", 0, 0, 0, 3, 0, 0, 1, 4
"d:\IDEWORK\lvmen\src\licensedcode\data\rules\zlib_84.yml", "YAML", 0, 0, 0, 3, 0, 0, 1, 4
"d:\IDEWORK\lvmen\src\licensedcode\data\rules\zlib_85.yml", "YAML", 0, 0, 0, 3, 0, 0, 1, 4
"d:\IDEWORK\lvmen\src\licensedcode\data\rules\zlib_86.yml", "YAML", 0, 0, 0, 3, 0, 0, 1, 4
"d:\IDEWORK\lvmen\src\licensedcode\data\rules\zlib_87.yml", "YAML", 0, 0, 0, 3, 0, 0, 1, 4
"d:\IDEWORK\lvmen\src\licensedcode\data\rules\zlib_88.yml", "YAML", 0, 0, 0, 3, 0, 0, 1, 4
"d:\IDEWORK\lvmen\src\licensedcode\data\rules\zlib_89.yml", "YAML", 0, 0, 0, 5, 0, 0, 1, 6
"d:\IDEWORK\lvmen\src\licensedcode\data\rules\zlib_9.yml", "YAML", 0, 0, 0, 5, 0, 0, 1, 6
"d:\IDEWORK\lvmen\src\licensedcode\data\rules\zlib_90.yml", "YAML", 0, 0, 0, 2, 0, 0, 1, 3
"d:\IDEWORK\lvmen\src\licensedcode\data\rules\zlib_and_ijg_and_libpng_1.yml", "YAML", 0, 0, 0, 8, 0, 0, 1, 9
"d:\IDEWORK\lvmen\src\licensedcode\data\rules\zlib_and_mit_1.yml", "YAML", 0, 0, 0, 5, 0, 0, 1, 6
"d:\IDEWORK\lvmen\src\licensedcode\data\rules\zlib_blast.yml", "YAML", 0, 0, 0, 6, 0, 0, 1, 7
"d:\IDEWORK\lvmen\src\licensedcode\data\rules\zlib_nuget_url_1.yml", "YAML", 0, 0, 0, 5, 0, 0, 1, 6
"d:\IDEWORK\lvmen\src\licensedcode\data\rules\zlib_ref.yml", "YAML", 0, 0, 0, 6, 0, 0, 1, 7
"d:\IDEWORK\lvmen\src\licensedcode\data\rules\zlib_url_1.yml", "YAML", 0, 0, 0, 5, 0, 0, 1, 6
"d:\IDEWORK\lvmen\src\licensedcode\data\rules\zlib_url_2.yml", "YAML", 0, 0, 0, 5, 0, 0, 1, 6
"d:\IDEWORK\lvmen\src\licensedcode\data\rules\zlib_url_badge.yml", "YAML", 0, 0, 0, 6, 0, 0, 1, 7
"d:\IDEWORK\lvmen\src\licensedcode\data\rules\zlib_variant.yml", "YAML", 0, 0, 0, 2, 0, 0, 1, 3
"d:\IDEWORK\lvmen\src\licensedcode\data\rules\zpl-1.0_1.yml", "YAML", 0, 0, 0, 3, 0, 0, 1, 4
"d:\IDEWORK\lvmen\src\licensedcode\data\rules\zpl-1.1.SPDX.yml", "YAML", 0, 0, 0, 12, 0, 0, 1, 13
"d:\IDEWORK\lvmen\src\licensedcode\data\rules\zpl-1.1_1.yml", "YAML", 0, 0, 0, 5, 0, 0, 1, 6
"d:\IDEWORK\lvmen\src\licensedcode\data\rules\zpl-1.1_2.yml", "YAML", 0, 0, 0, 7, 0, 0, 1, 8
"d:\IDEWORK\lvmen\src\licensedcode\data\rules\zpl-1.1_4.yml", "YAML", 0, 0, 0, 3, 0, 0, 1, 4
"d:\IDEWORK\lvmen\src\licensedcode\data\rules\zpl-1.1_and_other-permissive_1.yml", "YAML", 0, 0, 0, 7, 0, 0, 1, 8
"d:\IDEWORK\lvmen\src\licensedcode\data\rules\zpl-1.1_url_1.yml", "YAML", 0, 0, 0, 5, 0, 0, 1, 6
"d:\IDEWORK\lvmen\src\licensedcode\data\rules\zpl-1.1_url_2.yml", "YAML", 0, 0, 0, 5, 0, 0, 1, 6
"d:\IDEWORK\lvmen\src\licensedcode\data\rules\zpl-2.0.SPDX.yml", "YAML", 0, 0, 0, 10, 0, 0, 1, 11
"d:\IDEWORK\lvmen\src\licensedcode\data\rules\zpl-2.0.yml", "YAML", 0, 0, 0, 5, 0, 0, 1, 6
"d:\IDEWORK\lvmen\src\licensedcode\data\rules\zpl-2.0_1.yml", "YAML", 0, 0, 0, 3, 0, 0, 1, 4
"d:\IDEWORK\lvmen\src\licensedcode\data\rules\zpl-2.0_2.yml", "YAML", 0, 0, 0, 5, 0, 0, 1, 6
"d:\IDEWORK\lvmen\src\licensedcode\data\rules\zpl-2.0_3.yml", "YAML", 0, 0, 0, 5, 0, 0, 1, 6
"d:\IDEWORK\lvmen\src\licensedcode\data\rules\zpl-2.0_4.yml", "YAML", 0, 0, 0, 3, 0, 0, 1, 4
"d:\IDEWORK\lvmen\src\licensedcode\data\rules\zpl-2.0_5.yml", "YAML", 0, 0, 0, 5, 0, 0, 1, 6
"d:\IDEWORK\lvmen\src\licensedcode\data\rules\zpl-2.0_6.yml", "YAML", 0, 0, 0, 5, 0, 0, 1, 6
"d:\IDEWORK\lvmen\src\licensedcode\data\rules\zpl-2.0_url_1.yml", "YAML", 0, 0, 0, 5, 0, 0, 1, 6
"d:\IDEWORK\lvmen\src\licensedcode\data\rules\zpl-2.0_url_2.yml", "YAML", 0, 0, 0, 5, 0, 0, 1, 6
"d:\IDEWORK\lvmen\src\licensedcode\data\rules\zpl-2.0_url_glc_114.yml", "YAML", 0, 0, 0, 5, 0, 0, 1, 6
"d:\IDEWORK\lvmen\src\licensedcode\data\rules\zpl-2.1.SPDX.yml", "YAML", 0, 0, 0, 4, 0, 0, 1, 5
"d:\IDEWORK\lvmen\src\licensedcode\data\rules\zpl-2.1.yml", "YAML", 0, 0, 0, 2, 0, 0, 1, 3
"d:\IDEWORK\lvmen\src\licensedcode\data\rules\zpl-2.1_1.yml", "YAML", 0, 0, 0, 3, 0, 0, 1, 4
"d:\IDEWORK\lvmen\src\licensedcode\data\rules\zpl-2.1_10.yml", "YAML", 0, 0, 0, 3, 0, 0, 1, 4
"d:\IDEWORK\lvmen\src\licensedcode\data\rules\zpl-2.1_2.yml", "YAML", 0, 0, 0, 5, 0, 0, 1, 6
"d:\IDEWORK\lvmen\src\licensedcode\data\rules\zpl-2.1_3.yml", "YAML", 0, 0, 0, 5, 0, 0, 1, 6
"d:\IDEWORK\lvmen\src\licensedcode\data\rules\zpl-2.1_4.yml", "YAML", 0, 0, 0, 3, 0, 0, 1, 4
"d:\IDEWORK\lvmen\src\licensedcode\data\rules\zpl-2.1_5.yml", "YAML", 0, 0, 0, 2, 0, 0, 1, 3
"d:\IDEWORK\lvmen\src\licensedcode\data\rules\zpl-2.1_6.yml", "YAML", 0, 0, 0, 2, 0, 0, 1, 3
"d:\IDEWORK\lvmen\src\licensedcode\data\rules\zpl-2.1_7.yml", "YAML", 0, 0, 0, 5, 0, 0, 1, 6
"d:\IDEWORK\lvmen\src\licensedcode\data\rules\zpl-2.1_8.yml", "YAML", 0, 0, 0, 5, 0, 0, 1, 6
"d:\IDEWORK\lvmen\src\licensedcode\data\rules\zpl-2.1_9.yml", "YAML", 0, 0, 0, 3, 0, 0, 1, 4
"d:\IDEWORK\lvmen\src\licensedcode\data\rules\zpl-2.1_url_1.yml", "YAML", 0, 0, 0, 5, 0, 0, 1, 6
"d:\IDEWORK\lvmen\src\licensedcode\data\rules\zpl-2.1_url_2.yml", "YAML", 0, 0, 0, 5, 0, 0, 1, 6
"d:\IDEWORK\lvmen\src\licensedcode\data\rules\zsh_1.yml", "YAML", 0, 0, 0, 3, 0, 0, 1, 4
"d:\IDEWORK\lvmen\src\licensedcode\data\rules\zveno-research.yml", "YAML", 0, 0, 0, 5, 0, 0, 1, 6
"d:\IDEWORK\lvmen\src\licensedcode\dmp.py", "Python", 558, 0, 0, 0, 0, 88, 160, 806
"d:\IDEWORK\lvmen\src\licensedcode\index.py", "Python", 708, 0, 0, 0, 0, 163, 194, 1065
"d:\IDEWORK\lvmen\src\licensedcode\legalese.py", "Python", 4443, 0, 0, 0, 0, 11, 6, 4460
"d:\IDEWORK\lvmen\src\licensedcode\match.py", "Python", 1420, 0, 0, 0, 0, 167, 252, 1839
"d:\IDEWORK\lvmen\src\licensedcode\match_aho.py", "Python", 192, 0, 0, 0, 0, 24, 56, 272
"d:\IDEWORK\lvmen\src\licensedcode\match_hash.py", "Python", 51, 0, 0, 0, 0, 10, 18, 79
"d:\IDEWORK\lvmen\src\licensedcode\match_seq.py", "Python", 84, 0, 0, 0, 0, 13, 39, 136
"d:\IDEWORK\lvmen\src\licensedcode\match_set.py", "Python", 339, 0, 0, 0, 0, 50, 110, 499
"d:\IDEWORK\lvmen\src\licensedcode\match_spdx_lid.py", "Python", 268, 0, 0, 0, 0, 50, 75, 393
"d:\IDEWORK\lvmen\src\licensedcode\models.py", "Python", 1226, 0, 0, 0, 0, 129, 301, 1656
"d:\IDEWORK\lvmen\src\licensedcode\query.py", "Python", 679, 0, 0, 0, 0, 94, 152, 925
"d:\IDEWORK\lvmen\src\licensedcode\seq.py", "Python", 119, 0, 0, 0, 0, 23, 35, 177
"d:\IDEWORK\lvmen\src\licensedcode\spans.py", "Python", 366, 0, 0, 0, 0, 33, 69, 468
"d:\IDEWORK\lvmen\src\licensedcode\stopwords.py", "Python", 102, 0, 0, 0, 0, 34, 20, 156
"d:\IDEWORK\lvmen\src\licensedcode\tokenize.py", "Python", 181, 0, 0, 0, 0, 20, 48, 249
"d:\IDEWORK\lvmen\src\licensedcode\tracing.py", "Python", 44, 0, 0, 0, 0, 8, 14, 66
"d:\IDEWORK\lvmen\src\main.py", "Python", 115, 0, 0, 0, 0, 5, 20, 140
"d:\IDEWORK\lvmen\src\scancode\__init__.py", "Python", 0, 0, 0, 0, 0, 0, 1, 1
"d:\IDEWORK\lvmen\src\scancode\api.py", "Python", 167, 0, 0, 0, 0, 57, 42, 266
"d:\IDEWORK\lvmen\src\scancode\lockfile.py", "Python", 17, 0, 0, 0, 0, 8, 9, 34
"d:\IDEWORK\lvmen\src\scancode_config.py", "Python", 96, 0, 0, 0, 0, 52, 29, 177
"d:\IDEWORK\lvmen\src\textcode\__init__.py", "Python", 0, 0, 0, 0, 0, 0, 1, 1
"d:\IDEWORK\lvmen\src\textcode\analysis.py", "Python", 222, 0, 0, 0, 0, 35, 54, 311
"d:\IDEWORK\lvmen\src\textcode\markup.py", "Python", 64, 0, 0, 0, 0, 20, 29, 113
"d:\IDEWORK\lvmen\src\textcode\pdf.py", "Python", 34, 0, 0, 0, 0, 8, 6, 48
"d:\IDEWORK\lvmen\src\textcode\sfdb.py", "Python", 18, 0, 0, 0, 0, 8, 4, 30
"d:\IDEWORK\lvmen\src\textcode\strings.py", "Python", 217, 0, 0, 0, 0, 26, 57, 300
"Total", "-", 17040, 11, 5, 147293, 1, 1978, 37683, 204011